PokerStars Zoom Hand #195021908842:  Hold'em No Limit ($0.10/$0.25) - 2018/12/29 2:29:04 UTC [2018/12/28 21:29:04 ET]
Table 'Hydra' 6-max Seat #1 is the button
Seat 1: river plate9 ($48.24 in chips) 
Seat 2: altum15a ($101.20 in chips) 
Seat 3: SantiagoWeight ($25 in chips) 
Seat 4: RandomWalk77 ($37.66 in chips) 
Seat 5: ducsip ($32.67 in chips) 
Seat 6: crescendo34 ($50.03 in chips) 
altum15a: posts small blind $0.10
SantiagoWeight: posts big blind $0.25
*** HOLE CARDS ***
Dealt to SantiagoWeight [Kd 8d]
RandomWalk77: folds 
ducsip: raises $0.25 to $0.50
crescendo34: folds 
river plate9: folds 
altum15a: folds 
SantiagoWeight: calls $0.25
*** FLOP *** [As Ac Qh]
SantiagoWeight: checks 
ducsip: bets $0.25
SantiagoWeight: calls $0.25
*** TURN *** [As Ac Qh] [Ts]
SantiagoWeight: checks 
ducsip: checks 
*** RIVER *** [As Ac Qh Ts] [Js]
SantiagoWeight: bets $1
ducsip: folds 
Uncalled bet ($1) returned to SantiagoWeight
SantiagoWeight collected $1.53 from pot
SantiagoWeight: doesn't show hand 
*** SUMMARY ***
Total pot $1.60 | Rake $0.07 
Board [As Ac Qh Ts Js]
Seat 1: river plate9 (button) folded before Flop (didn't bet)
Seat 2: altum15a (small blind) folded before Flop
Seat 3: SantiagoWeight (big blind) collected ($1.53)
Seat 4: RandomWalk77 folded before Flop (didn't bet)
Seat 5: ducsip folded on the River
Seat 6: crescendo34 folded before Flop (didn't bet)



PokerStars Zoom Hand #195021932855:  Hold'em No Limit ($0.10/$0.25) - 2018/12/29 2:30:06 UTC [2018/12/28 21:30:06 ET]
Table 'Hydra' 6-max Seat #1 is the button
Seat 1: maximus25203 ($27.24 in chips) 
Seat 2: SantiagoWeight ($25.78 in chips) 
Seat 3: oleg77552 ($60.25 in chips) 
Seat 4: RandomWalk77 ($50.17 in chips) 
Seat 5: Bujan 07 ($16.91 in chips) 
Seat 6: cobra2846 ($54.51 in chips) 
SantiagoWeight: posts small blind $0.10
oleg77552: posts big blind $0.25
*** HOLE CARDS ***
Dealt to SantiagoWeight [7h 7c]
RandomWalk77: folds 
Bujan 07: folds 
cobra2846: folds 
maximus25203: folds 
SantiagoWeight: raises $0.50 to $0.75
oleg77552: calls $0.50
*** FLOP *** [Ac Ah 2d]
SantiagoWeight: bets $0.50
oleg77552: folds 
Uncalled bet ($0.50) returned to SantiagoWeight
SantiagoWeight collected $1.43 from pot
SantiagoWeight: doesn't show hand 
*** SUMMARY ***
Total pot $1.50 | Rake $0.07 
Board [Ac Ah 2d]
Seat 1: maximus25203 (button) folded before Flop (didn't bet)
Seat 2: SantiagoWeight (small blind) collected ($1.43)
Seat 3: oleg77552 (big blind) folded on the Flop
Seat 4: RandomWalk77 folded before Flop (didn't bet)
Seat 5: Bujan 07 folded before Flop (didn't bet)
Seat 6: cobra2846 folded before Flop (didn't bet)



PokerStars Zoom Hand #195022012485:  Hold'em No Limit ($0.10/$0.25) - 2018/12/29 2:33:31 UTC [2018/12/28 21:33:31 ET]
Table 'Hydra' 6-max Seat #1 is the button
Seat 1: SantiagoWeight ($26.46 in chips) 
Seat 2: steveblockx ($17.56 in chips) 
Seat 3: LupiGonzales ($24.09 in chips) 
Seat 4: rush.pp ($48.18 in chips) 
Seat 5: ongravity ($32.67 in chips) 
Seat 6: lionheart470 ($30.79 in chips) 
steveblockx: posts small blind $0.10
LupiGonzales: posts big blind $0.25
*** HOLE CARDS ***
Dealt to SantiagoWeight [6c Kc]
rush.pp: folds 
ongravity: folds 
lionheart470: folds 
SantiagoWeight: raises $0.25 to $0.50
steveblockx: calls $0.40
LupiGonzales: raises $1.22 to $1.72
SantiagoWeight: folds 
steveblockx: folds 
Uncalled bet ($1.22) returned to LupiGonzales
LupiGonzales collected $1.50 from pot
LupiGonzales: doesn't show hand 
*** SUMMARY ***
Total pot $1.50 | Rake $0 
Seat 1: SantiagoWeight (button) folded before Flop
Seat 2: steveblockx (small blind) folded before Flop
Seat 3: LupiGonzales (big blind) collected ($1.50)
Seat 4: rush.pp folded before Flop (didn't bet)
Seat 5: ongravity folded before Flop (didn't bet)
Seat 6: lionheart470 folded before Flop (didn't bet)



PokerStars Zoom Hand #195022023410:  Hold'em No Limit ($0.10/$0.25) - 2018/12/29 2:34:00 UTC [2018/12/28 21:34:00 ET]
Table 'Hydra' 6-max Seat #1 is the button
Seat 1: LupiGonzales ($22.14 in chips) 
Seat 2: rush.pp ($33 in chips) 
Seat 3: mariopork ($35.52 in chips) 
Seat 4: Rollout2018 ($19.32 in chips) 
Seat 5: AngelicDiana ($76.74 in chips) 
Seat 6: SantiagoWeight ($25.96 in chips) 
rush.pp: posts small blind $0.10
mariopork: posts big blind $0.25
*** HOLE CARDS ***
Dealt to SantiagoWeight [4h 2s]
Rollout2018: folds 
AngelicDiana: folds 
SantiagoWeight: folds 
LupiGonzales: raises $0.25 to $0.50
rush.pp: folds 
mariopork: calls $0.25
*** FLOP *** [3h 3s 7c]
mariopork: checks 
LupiGonzales: bets $0.85
mariopork: calls $0.85
*** TURN *** [3h 3s 7c] [6h]
mariopork: checks 
LupiGonzales: bets $2.16
mariopork: folds 
Uncalled bet ($2.16) returned to LupiGonzales
LupiGonzales collected $2.67 from pot
LupiGonzales: doesn't show hand 
*** SUMMARY ***
Total pot $2.80 | Rake $0.13 
Board [3h 3s 7c 6h]
Seat 1: LupiGonzales (button) collected ($2.67)
Seat 2: rush.pp (small blind) folded before Flop
Seat 3: mariopork (big blind) folded on the Turn
Seat 4: Rollout2018 folded before Flop (didn't bet)
Seat 5: AngelicDiana folded before Flop (didn't bet)
Seat 6: SantiagoWeight folded before Flop (didn't bet)



PokerStars Zoom Hand #195022027627:  Hold'em No Limit ($0.10/$0.25) - 2018/12/29 2:34:11 UTC [2018/12/28 21:34:11 ET]
Table 'Hydra' 6-max Seat #1 is the button
Seat 1: mattmoney8 ($13.48 in chips) 
Seat 2: negreanuNya ($25 in chips) 
Seat 3: Becks Baker ($25 in chips) 
Seat 4: ckriszee ($78.01 in chips) 
Seat 5: SantiagoWeight ($25.96 in chips) 
Seat 6: aa1421b ($17.80 in chips) 
negreanuNya: posts small blind $0.10
Becks Baker: posts big blind $0.25
*** HOLE CARDS ***
Dealt to SantiagoWeight [8h Kh]
ckriszee: folds 
SantiagoWeight: raises $0.40 to $0.65
aa1421b: folds 
mattmoney8: calls $0.65
negreanuNya: folds 
Becks Baker: folds 
*** FLOP *** [2d 5h Ac]
SantiagoWeight: bets $0.50
mattmoney8: calls $0.50
*** TURN *** [2d 5h Ac] [Jc]
SantiagoWeight: checks 
mattmoney8: bets $2.50
SantiagoWeight: folds 
Uncalled bet ($2.50) returned to mattmoney8
mattmoney8 collected $2.53 from pot
mattmoney8: doesn't show hand 
*** SUMMARY ***
Total pot $2.65 | Rake $0.12 
Board [2d 5h Ac Jc]
Seat 1: mattmoney8 (button) collected ($2.53)
Seat 2: negreanuNya (small blind) folded before Flop
Seat 3: Becks Baker (big blind) folded before Flop
Seat 4: ckriszee folded before Flop (didn't bet)
Seat 5: SantiagoWeight folded on the Turn
Seat 6: aa1421b folded before Flop (didn't bet)



PokerStars Zoom Hand #195022061401:  Hold'em No Limit ($0.10/$0.25) - 2018/12/29 2:35:40 UTC [2018/12/28 21:35:40 ET]
Table 'Hydra' 6-max Seat #1 is the button
Seat 1: nhanminhtri ($25 in chips) 
Seat 2: Xa4_88 ($39.51 in chips) 
Seat 3: pfunkolstar ($38.26 in chips) 
Seat 4: SantiagoWeight ($24.56 in chips) 
Seat 5: Z3rbinatti ($63.01 in chips) 
Seat 6: tightpokerAA ($33.55 in chips) 
Xa4_88: posts small blind $0.10
pfunkolstar: posts big blind $0.25
*** HOLE CARDS ***
Dealt to SantiagoWeight [3h Js]
SantiagoWeight: folds 
Z3rbinatti: folds 
tightpokerAA: folds 
nhanminhtri: folds 
Xa4_88: folds 
Uncalled bet ($0.15) returned to pfunkolstar
pfunkolstar collected $0.20 from pot
pfunkolstar: doesn't show hand 
*** SUMMARY ***
Total pot $0.20 | Rake $0 
Seat 1: nhanminhtri (button) folded before Flop (didn't bet)
Seat 2: Xa4_88 (small blind) folded before Flop
Seat 3: pfunkolstar (big blind) collected ($0.20)
Seat 4: SantiagoWeight folded before Flop (didn't bet)
Seat 5: Z3rbinatti folded before Flop (didn't bet)
Seat 6: tightpokerAA folded before Flop (didn't bet)



PokerStars Zoom Hand #195022063333:  Hold'em No Limit ($0.10/$0.25) - 2018/12/29 2:35:44 UTC [2018/12/28 21:35:44 ET]
Table 'Hydra' 6-max Seat #1 is the button
Seat 1: SantiagoWeight ($24.56 in chips) 
Seat 2: Lacoste_jj ($72.97 in chips) 
Seat 3: 6a6JI0 ($41.85 in chips) 
Seat 4: LupiGonzales ($23.28 in chips) 
Seat 5: anorectal ($55.40 in chips) 
Seat 6: kounoupiss ($136.99 in chips) 
Lacoste_jj: posts small blind $0.10
6a6JI0: posts big blind $0.25
*** HOLE CARDS ***
Dealt to SantiagoWeight [Jh 7h]
LupiGonzales: folds 
anorectal: folds 
kounoupiss: folds 
SantiagoWeight: raises $0.25 to $0.50
Lacoste_jj: folds 
6a6JI0: folds 
Uncalled bet ($0.25) returned to SantiagoWeight
SantiagoWeight collected $0.60 from pot
SantiagoWeight: doesn't show hand 
*** SUMMARY ***
Total pot $0.60 | Rake $0 
Seat 1: SantiagoWeight (button) collected ($0.60)
Seat 2: Lacoste_jj (small blind) folded before Flop
Seat 3: 6a6JI0 (big blind) folded before Flop
Seat 4: LupiGonzales folded before Flop (didn't bet)
Seat 5: anorectal folded before Flop (didn't bet)
Seat 6: kounoupiss folded before Flop (didn't bet)



PokerStars Zoom Hand #195022053721:  Hold'em No Limit ($0.10/$0.25) - 2018/12/29 2:35:19 UTC [2018/12/28 21:35:19 ET]
Table 'Hydra' 6-max Seat #1 is the button
Seat 1: FrommyBu ($27.69 in chips) 
Seat 2: HonourMan23 ($25.04 in chips) 
Seat 3: SantiagoWeight ($24.81 in chips) 
Seat 4: houstor65 ($13.90 in chips) 
Seat 5: davidhw888 ($19.35 in chips) 
Seat 6: yobbos ($58.78 in chips) 
HonourMan23: posts small blind $0.10
SantiagoWeight: posts big blind $0.25
*** HOLE CARDS ***
Dealt to SantiagoWeight [5c 7c]
houstor65: raises $0.60 to $0.85
davidhw888: calls $0.85
yobbos: folds 
FrommyBu: folds 
HonourMan23: folds 
SantiagoWeight: folds 
*** FLOP *** [Ks As 5s]
houstor65: checks 
davidhw888: bets $0.98
houstor65: calls $0.98
*** TURN *** [Ks As 5s] [Ts]
houstor65: checks 
davidhw888: checks 
*** RIVER *** [Ks As 5s Ts] [Qs]
houstor65: bets $1.92
davidhw888: raises $15.60 to $17.52 and is all-in
houstor65: folds 
Uncalled bet ($15.60) returned to davidhw888
davidhw888 collected $7.50 from pot
davidhw888: doesn't show hand 
*** SUMMARY ***
Total pot $7.85 | Rake $0.35 
Board [Ks As 5s Ts Qs]
Seat 1: FrommyBu (button) folded before Flop (didn't bet)
Seat 2: HonourMan23 (small blind) folded before Flop
Seat 3: SantiagoWeight (big blind) folded before Flop
Seat 4: houstor65 folded on the River
Seat 5: davidhw888 collected ($7.50)
Seat 6: yobbos folded before Flop (didn't bet)



PokerStars Zoom Hand #195022069152:  Hold'em No Limit ($0.10/$0.25) - 2018/12/29 2:35:59 UTC [2018/12/28 21:35:59 ET]
Table 'Hydra' 6-max Seat #1 is the button
Seat 1: FrommyBu ($42.45 in chips) 
Seat 2: SantiagoWeight ($24.91 in chips) 
Seat 3: mariopork ($31.15 in chips) 
Seat 4: kounoupiss ($136.74 in chips) 
Seat 5: ducepot15 ($28.68 in chips) 
Seat 6: svents ($71.54 in chips) 
SantiagoWeight: posts small blind $0.10
mariopork: posts big blind $0.25
*** HOLE CARDS ***
Dealt to SantiagoWeight [2s 4c]
kounoupiss: folds 
ducepot15: folds 
svents: folds 
FrommyBu: folds 
SantiagoWeight: folds 
Uncalled bet ($0.15) returned to mariopork
mariopork collected $0.20 from pot
mariopork: doesn't show hand 
*** SUMMARY ***
Total pot $0.20 | Rake $0 
Seat 1: FrommyBu (button) folded before Flop (didn't bet)
Seat 2: SantiagoWeight (small blind) folded before Flop
Seat 3: mariopork (big blind) collected ($0.20)
Seat 4: kounoupiss folded before Flop (didn't bet)
Seat 5: ducepot15 folded before Flop (didn't bet)
Seat 6: svents folded before Flop (didn't bet)



PokerStars Zoom Hand #195022078556:  Hold'em No Limit ($0.10/$0.25) - 2018/12/29 2:36:24 UTC [2018/12/28 21:36:24 ET]
Table 'Hydra' 6-max Seat #1 is the button
Seat 1: aloominat ($28.89 in chips) 
Seat 2: bfh26 ($26.47 in chips) 
Seat 3: tightpokerAA ($29.22 in chips) 
Seat 4: SantiagoWeight ($24.81 in chips) 
Seat 5: Lacoste_jj ($73.65 in chips) 
Seat 6: zhang1zhang ($28.40 in chips) 
bfh26: posts small blind $0.10
tightpokerAA: posts big blind $0.25
*** HOLE CARDS ***
Dealt to SantiagoWeight [6h 8d]
SantiagoWeight: folds 
Lacoste_jj: folds 
zhang1zhang: folds 
aloominat: folds 
bfh26: folds 
Uncalled bet ($0.15) returned to tightpokerAA
tightpokerAA collected $0.20 from pot
tightpokerAA: doesn't show hand 
*** SUMMARY ***
Total pot $0.20 | Rake $0 
Seat 1: aloominat (button) folded before Flop (didn't bet)
Seat 2: bfh26 (small blind) folded before Flop
Seat 3: tightpokerAA (big blind) collected ($0.20)
Seat 4: SantiagoWeight folded before Flop (didn't bet)
Seat 5: Lacoste_jj folded before Flop (didn't bet)
Seat 6: zhang1zhang folded before Flop (didn't bet)



PokerStars Zoom Hand #195022081609:  Hold'em No Limit ($0.10/$0.25) - 2018/12/29 2:36:31 UTC [2018/12/28 21:36:31 ET]
Table 'Hydra' 6-max Seat #1 is the button
Seat 1: ongravity ($98.16 in chips) 
Seat 2: rush.pp ($107.35 in chips) 
Seat 3: zhang1zhang ($28.40 in chips) 
Seat 4: SantiagoWeight ($24.81 in chips) 
Seat 5: allin969 ($30.70 in chips) 
Seat 6: aa1421b ($18.52 in chips) 
rush.pp: posts small blind $0.10
zhang1zhang: posts big blind $0.25
*** HOLE CARDS ***
Dealt to SantiagoWeight [8s 5s]
SantiagoWeight: folds 
allin969: raises $0.25 to $0.50
aa1421b: folds 
ongravity: folds 
rush.pp: folds 
zhang1zhang: folds 
Uncalled bet ($0.25) returned to allin969
allin969 collected $0.60 from pot
allin969: doesn't show hand 
*** SUMMARY ***
Total pot $0.60 | Rake $0 
Seat 1: ongravity (button) folded before Flop (didn't bet)
Seat 2: rush.pp (small blind) folded before Flop
Seat 3: zhang1zhang (big blind) folded before Flop
Seat 4: SantiagoWeight folded before Flop (didn't bet)
Seat 5: allin969 collected ($0.60)
Seat 6: aa1421b folded before Flop (didn't bet)



PokerStars Zoom Hand #195022073884:  Hold'em No Limit ($0.10/$0.25) - 2018/12/29 2:36:11 UTC [2018/12/28 21:36:11 ET]
Table 'Hydra' 6-max Seat #1 is the button
Seat 1: ARTBIL ($39.68 in chips) 
Seat 2: LupiGonzales ($23.38 in chips) 
Seat 3: svents ($18.17 in chips) 
Seat 4: river plate9 ($23.12 in chips) 
Seat 5: Mrs Flush25 ($59.02 in chips) 
Seat 6: SantiagoWeight ($24.81 in chips) 
LupiGonzales: posts small blind $0.10
svents: posts big blind $0.25
*** HOLE CARDS ***
Dealt to SantiagoWeight [Kh 9c]
river plate9: raises $0.25 to $0.50
Mrs Flush25: folds 
SantiagoWeight: folds 
ARTBIL: folds 
LupiGonzales: folds 
svents: calls $0.25
*** FLOP *** [3c 9s Ks]
svents: checks 
river plate9: bets $1
svents: calls $1
*** TURN *** [3c 9s Ks] [Tc]
svents: checks 
river plate9: bets $2.50
svents: folds 
Uncalled bet ($2.50) returned to river plate9
river plate9 collected $2.96 from pot
river plate9: doesn't show hand 
*** SUMMARY ***
Total pot $3.10 | Rake $0.14 
Board [3c 9s Ks Tc]
Seat 1: ARTBIL (button) folded before Flop (didn't bet)
Seat 2: LupiGonzales (small blind) folded before Flop
Seat 3: svents (big blind) folded on the Turn
Seat 4: river plate9 collected ($2.96)
Seat 5: Mrs Flush25 folded before Flop (didn't bet)
Seat 6: SantiagoWeight folded before Flop (didn't bet)



PokerStars Zoom Hand #195022084321:  Hold'em No Limit ($0.10/$0.25) - 2018/12/29 2:36:39 UTC [2018/12/28 21:36:39 ET]
Table 'Hydra' 6-max Seat #1 is the button
Seat 1: Cryptoz91 ($25 in chips) 
Seat 2: LupiGonzales ($23.03 in chips) 
Seat 3: SantiagoWeight ($24.81 in chips) 
Seat 4: ckriszee ($81.45 in chips) 
Seat 5: zdenekstavic ($33.73 in chips) 
Seat 6: Butch030 ($124.21 in chips) 
LupiGonzales: posts small blind $0.10
SantiagoWeight: posts big blind $0.25
*** HOLE CARDS ***
Dealt to SantiagoWeight [Td 3h]
ckriszee: folds 
zdenekstavic: raises $0.25 to $0.50
Butch030: folds 
Cryptoz91: folds 
LupiGonzales: folds 
SantiagoWeight: folds 
Uncalled bet ($0.25) returned to zdenekstavic
zdenekstavic collected $0.60 from pot
zdenekstavic: doesn't show hand 
*** SUMMARY ***
Total pot $0.60 | Rake $0 
Seat 1: Cryptoz91 (button) folded before Flop (didn't bet)
Seat 2: LupiGonzales (small blind) folded before Flop
Seat 3: SantiagoWeight (big blind) folded before Flop
Seat 4: ckriszee folded before Flop (didn't bet)
Seat 5: zdenekstavic collected ($0.60)
Seat 6: Butch030 folded before Flop (didn't bet)



PokerStars Zoom Hand #195022092870:  Hold'em No Limit ($0.10/$0.25) - 2018/12/29 2:37:01 UTC [2018/12/28 21:37:01 ET]
Table 'Hydra' 6-max Seat #1 is the button
Seat 1: SantiagoWeight ($24.56 in chips) 
Seat 2: Butch030 ($123.96 in chips) 
Seat 3: pfunkolstar ($38.61 in chips) 
Seat 4: svents ($16.67 in chips) 
Seat 5: Chellabro ($11.05 in chips) 
Seat 6: ducepot15 ($30.50 in chips) 
Butch030: posts small blind $0.10
pfunkolstar: posts big blind $0.25
*** HOLE CARDS ***
Dealt to SantiagoWeight [2h 8s]
svents: raises $0.30 to $0.55
Chellabro: folds 
ducepot15: folds 
SantiagoWeight has timed out
SantiagoWeight: folds 
Butch030: folds 
pfunkolstar: folds 
Uncalled bet ($0.30) returned to svents
svents collected $0.60 from pot
svents: doesn't show hand 
*** SUMMARY ***
Total pot $0.60 | Rake $0 
Seat 1: SantiagoWeight (button) folded before Flop (didn't bet)
Seat 2: Butch030 (small blind) folded before Flop
Seat 3: pfunkolstar (big blind) folded before Flop
Seat 4: svents collected ($0.60)
Seat 5: Chellabro folded before Flop (didn't bet)
Seat 6: ducepot15 folded before Flop (didn't bet)



PokerStars Zoom Hand #195022105361:  Hold'em No Limit ($0.10/$0.25) - 2018/12/29 2:37:33 UTC [2018/12/28 21:37:33 ET]
Table 'Hydra' 6-max Seat #1 is the button
Seat 1: Lehared ($32.61 in chips) 
Seat 2: SantiagoWeight ($24.56 in chips) 
Seat 3: TiltalaMalta ($34.32 in chips) 
Seat 4: MISTAAJ ($21.46 in chips) 
Seat 5: maximus25203 ($25.83 in chips) 
Seat 6: yobbos ($25 in chips) 
SantiagoWeight: posts small blind $0.10
TiltalaMalta: posts big blind $0.25
*** HOLE CARDS ***
Dealt to SantiagoWeight [2c 6s]
MISTAAJ: folds 
maximus25203: folds 
yobbos: folds 
Lehared: folds 
SantiagoWeight: folds 
Uncalled bet ($0.15) returned to TiltalaMalta
TiltalaMalta collected $0.20 from pot
TiltalaMalta: doesn't show hand 
*** SUMMARY ***
Total pot $0.20 | Rake $0 
Seat 1: Lehared (button) folded before Flop (didn't bet)
Seat 2: SantiagoWeight (small blind) folded before Flop
Seat 3: TiltalaMalta (big blind) collected ($0.20)
Seat 4: MISTAAJ folded before Flop (didn't bet)
Seat 5: maximus25203 folded before Flop (didn't bet)
Seat 6: yobbos folded before Flop (didn't bet)



PokerStars Zoom Hand #195022109204:  Hold'em No Limit ($0.10/$0.25) - 2018/12/29 2:37:42 UTC [2018/12/28 21:37:42 ET]
Table 'Hydra' 6-max Seat #1 is the button
Seat 1: ChungkingExp ($25 in chips) 
Seat 2: samioattila ($32.50 in chips) 
Seat 3: Flippay ($25 in chips) 
Seat 4: BeastNBieber ($69.76 in chips) 
Seat 5: needluck89 ($94.76 in chips) 
Seat 6: SantiagoWeight ($24.46 in chips) 
samioattila: posts small blind $0.10
Flippay: posts big blind $0.25
*** HOLE CARDS ***
Dealt to SantiagoWeight [8c 5c]
BeastNBieber: raises $0.50 to $0.75
needluck89: folds 
SantiagoWeight: folds 
ChungkingExp: folds 
samioattila: folds 
Flippay: folds 
Uncalled bet ($0.50) returned to BeastNBieber
BeastNBieber collected $0.60 from pot
BeastNBieber: doesn't show hand 
*** SUMMARY ***
Total pot $0.60 | Rake $0 
Seat 1: ChungkingExp (button) folded before Flop (didn't bet)
Seat 2: samioattila (small blind) folded before Flop
Seat 3: Flippay (big blind) folded before Flop
Seat 4: BeastNBieber collected ($0.60)
Seat 5: needluck89 folded before Flop (didn't bet)
Seat 6: SantiagoWeight folded before Flop (didn't bet)



PokerStars Zoom Hand #195022121633:  Hold'em No Limit ($0.10/$0.25) - 2018/12/29 2:38:14 UTC [2018/12/28 21:38:14 ET]
Table 'Hydra' 6-max Seat #1 is the button
Seat 1: Z3rbinatti ($116.32 in chips) 
Seat 2: needluck89 ($74.91 in chips) 
Seat 3: nathan_eeg ($36.30 in chips) 
Seat 4: ducsip ($18.04 in chips) 
Seat 5: SantiagoWeight ($24.46 in chips) 
Seat 6: Taran0001 ($12.44 in chips) 
needluck89: posts small blind $0.10
nathan_eeg: posts big blind $0.25
*** HOLE CARDS ***
Dealt to SantiagoWeight [Tc 6c]
ducsip: folds 
SantiagoWeight: folds 
Taran0001: folds 
Z3rbinatti: folds 
needluck89: folds 
Uncalled bet ($0.15) returned to nathan_eeg
nathan_eeg collected $0.20 from pot
nathan_eeg: doesn't show hand 
*** SUMMARY ***
Total pot $0.20 | Rake $0 
Seat 1: Z3rbinatti (button) folded before Flop (didn't bet)
Seat 2: needluck89 (small blind) folded before Flop
Seat 3: nathan_eeg (big blind) collected ($0.20)
Seat 4: ducsip folded before Flop (didn't bet)
Seat 5: SantiagoWeight folded before Flop (didn't bet)
Seat 6: Taran0001 folded before Flop (didn't bet)



PokerStars Zoom Hand #195022117324:  Hold'em No Limit ($0.10/$0.25) - 2018/12/29 2:38:03 UTC [2018/12/28 21:38:03 ET]
Table 'Hydra' 6-max Seat #1 is the button
Seat 1: MarcoA12 ($15.08 in chips) 
Seat 2: lbautista91 ($97.32 in chips) 
Seat 3: JohnGemini88 ($47.66 in chips) 
Seat 4: ducepot15 ($30.40 in chips) 
Seat 5: SantiagoWeight ($24.46 in chips) 
Seat 6: TiltalaMalta ($34.32 in chips) 
lbautista91: posts small blind $0.10
JohnGemini88: posts big blind $0.25
*** HOLE CARDS ***
Dealt to SantiagoWeight [3h Qh]
ducepot15: folds 
SantiagoWeight: folds 
TiltalaMalta: folds 
MarcoA12: raises $0.60 to $0.85
lbautista91: folds 
JohnGemini88: folds 
Uncalled bet ($0.60) returned to MarcoA12
MarcoA12 collected $0.60 from pot
MarcoA12: doesn't show hand 
*** SUMMARY ***
Total pot $0.60 | Rake $0 
Seat 1: MarcoA12 (button) collected ($0.60)
Seat 2: lbautista91 (small blind) folded before Flop
Seat 3: JohnGemini88 (big blind) folded before Flop
Seat 4: ducepot15 folded before Flop (didn't bet)
Seat 5: SantiagoWeight folded before Flop (didn't bet)
Seat 6: TiltalaMalta folded before Flop (didn't bet)



PokerStars Zoom Hand #195022125528:  Hold'em No Limit ($0.10/$0.25) - 2018/12/29 2:38:24 UTC [2018/12/28 21:38:24 ET]
Table 'Hydra' 6-max Seat #1 is the button
Seat 1: pioneer577 ($16.89 in chips) 
Seat 2: Bujan 07 ($24.52 in chips) 
Seat 3: SantiagoWeight ($24.46 in chips) 
Seat 4: $lope$tyle ($24.22 in chips) 
Seat 5: samioattila ($53.58 in chips) 
Seat 6: Becks Baker ($25.73 in chips) 
Bujan 07: posts small blind $0.10
SantiagoWeight: posts big blind $0.25
*** HOLE CARDS ***
Dealt to SantiagoWeight [8d As]
$lope$tyle: folds 
samioattila: folds 
Becks Baker: folds 
pioneer577: folds 
Bujan 07: folds 
Uncalled bet ($0.15) returned to SantiagoWeight
SantiagoWeight collected $0.20 from pot
SantiagoWeight: doesn't show hand 
*** SUMMARY ***
Total pot $0.20 | Rake $0 
Seat 1: pioneer577 (button) folded before Flop (didn't bet)
Seat 2: Bujan 07 (small blind) folded before Flop
Seat 3: SantiagoWeight (big blind) collected ($0.20)
Seat 4: $lope$tyle folded before Flop (didn't bet)
Seat 5: samioattila folded before Flop (didn't bet)
Seat 6: Becks Baker folded before Flop (didn't bet)



PokerStars Zoom Hand #195022129852:  Hold'em No Limit ($0.10/$0.25) - 2018/12/29 2:38:36 UTC [2018/12/28 21:38:36 ET]
Table 'Hydra' 6-max Seat #1 is the button
Seat 1: Dr.Jekyll197 ($32.99 in chips) 
Seat 2: SantiagoWeight ($24.56 in chips) 
Seat 3: KFD363 ($17.64 in chips) 
Seat 4: reetskeet ($28.39 in chips) 
Seat 5: mariopork ($32.26 in chips) 
Seat 6: bestitest542 ($100.12 in chips) 
SantiagoWeight: posts small blind $0.10
KFD363: posts big blind $0.25
*** HOLE CARDS ***
Dealt to SantiagoWeight [Qh 4d]
reetskeet: folds 
mariopork: raises $0.50 to $0.75
bestitest542: calls $0.75
Dr.Jekyll197: folds 
SantiagoWeight: folds 
KFD363: folds 
*** FLOP *** [5s 4h 9h]
mariopork: checks 
bestitest542: checks 
*** TURN *** [5s 4h 9h] [Qs]
mariopork: checks 
bestitest542: checks 
*** RIVER *** [5s 4h 9h Qs] [8d]
mariopork: bets $0.73
bestitest542: raises $0.73 to $1.46
mariopork: calls $0.73
*** SHOW DOWN ***
bestitest542: shows [4s 8s] (two pair, Eights and Fours)
mariopork: mucks hand 
bestitest542 collected $4.56 from pot
*** SUMMARY ***
Total pot $4.77 | Rake $0.21 
Board [5s 4h 9h Qs 8d]
Seat 1: Dr.Jekyll197 (button) folded before Flop (didn't bet)
Seat 2: SantiagoWeight (small blind) folded before Flop
Seat 3: KFD363 (big blind) folded before Flop
Seat 4: reetskeet folded before Flop (didn't bet)
Seat 5: mariopork mucked [Kc 9c]
Seat 6: bestitest542 showed [4s 8s] and won ($4.56) with two pair, Eights and Fours



PokerStars Zoom Hand #195022136563:  Hold'em No Limit ($0.10/$0.25) - 2018/12/29 2:38:52 UTC [2018/12/28 21:38:52 ET]
Table 'Hydra' 6-max Seat #1 is the button
Seat 1: SantiagoWeight ($24.46 in chips) 
Seat 2: FrommyBu ($42.51 in chips) 
Seat 3: BIGPAIN14 ($69.54 in chips) 
Seat 4: samioattila ($53.93 in chips) 
Seat 5: rush.pp ($35.60 in chips) 
Seat 6: TiltalaMalta ($33.97 in chips) 
FrommyBu: posts small blind $0.10
BIGPAIN14: posts big blind $0.25
*** HOLE CARDS ***
Dealt to SantiagoWeight [5d Td]
samioattila: folds 
rush.pp: folds 
TiltalaMalta: folds 
SantiagoWeight: raises $0.25 to $0.50
FrommyBu: raises $1.90 to $2.40
BIGPAIN14: folds 
SantiagoWeight: folds 
Uncalled bet ($1.90) returned to FrommyBu
FrommyBu collected $1.25 from pot
FrommyBu: doesn't show hand 
*** SUMMARY ***
Total pot $1.25 | Rake $0 
Seat 1: SantiagoWeight (button) folded before Flop
Seat 2: FrommyBu (small blind) collected ($1.25)
Seat 3: BIGPAIN14 (big blind) folded before Flop
Seat 4: samioattila folded before Flop (didn't bet)
Seat 5: rush.pp folded before Flop (didn't bet)
Seat 6: TiltalaMalta folded before Flop (didn't bet)



PokerStars Zoom Hand #195022148926:  Hold'em No Limit ($0.10/$0.25) - 2018/12/29 2:39:24 UTC [2018/12/28 21:39:24 ET]
Table 'Hydra' 6-max Seat #1 is the button
Seat 1: lbautista91 ($28.72 in chips) 
Seat 2: thedemise69 ($5.33 in chips) 
Seat 3: Party4Arthy ($47.83 in chips) 
Seat 4: NightHunter2018 ($36.03 in chips) 
Seat 5: SantiagoWeight ($23.96 in chips) 
Seat 6: meettokill ($25 in chips) 
thedemise69: posts small blind $0.10
Party4Arthy: posts big blind $0.25
*** HOLE CARDS ***
Dealt to SantiagoWeight [Td 7c]
NightHunter2018: folds 
SantiagoWeight: folds 
meettokill: folds 
lbautista91: folds 
thedemise69: folds 
Uncalled bet ($0.15) returned to Party4Arthy
Party4Arthy collected $0.20 from pot
Party4Arthy: doesn't show hand 
*** SUMMARY ***
Total pot $0.20 | Rake $0 
Seat 1: lbautista91 (button) folded before Flop (didn't bet)
Seat 2: thedemise69 (small blind) folded before Flop
Seat 3: Party4Arthy (big blind) collected ($0.20)
Seat 4: NightHunter2018 folded before Flop (didn't bet)
Seat 5: SantiagoWeight folded before Flop (didn't bet)
Seat 6: meettokill folded before Flop (didn't bet)



PokerStars Zoom Hand #195022142340:  Hold'em No Limit ($0.10/$0.25) - 2018/12/29 2:39:07 UTC [2018/12/28 21:39:07 ET]
Table 'Hydra' 6-max Seat #1 is the button
Seat 1: ChungkingExp ($25 in chips) 
Seat 2: bestitest542 ($102.47 in chips) 
Seat 3: tightpokerAA ($28.38 in chips) 
Seat 4: stavro88 ($27.28 in chips) 
Seat 5: HonourMan23 ($23.99 in chips) 
Seat 6: SantiagoWeight ($23.96 in chips) 
bestitest542: posts small blind $0.10
tightpokerAA: posts big blind $0.25
*** HOLE CARDS ***
Dealt to SantiagoWeight [Js 6h]
stavro88: calls $0.25
HonourMan23: folds 
SantiagoWeight: folds 
ChungkingExp: folds 
bestitest542: calls $0.15
tightpokerAA: checks 
*** FLOP *** [4d 5d Th]
bestitest542: bets $0.36
tightpokerAA: folds 
stavro88: calls $0.36
*** TURN *** [4d 5d Th] [7d]
bestitest542: bets $1.40
stavro88: calls $1.40
*** RIVER *** [4d 5d Th 7d] [Qc]
bestitest542: bets $4.08
stavro88: calls $4.08
*** SHOW DOWN ***
bestitest542: shows [8h 8d] (a pair of Eights)
stavro88: shows [8s Ts] (a pair of Tens)
stavro88 collected $11.87 from pot
*** SUMMARY ***
Total pot $12.43 | Rake $0.56 
Board [4d 5d Th 7d Qc]
Seat 1: ChungkingExp (button) folded before Flop (didn't bet)
Seat 2: bestitest542 (small blind) showed [8h 8d] and lost with a pair of Eights
Seat 3: tightpokerAA (big blind) folded on the Flop
Seat 4: stavro88 showed [8s Ts] and won ($11.87) with a pair of Tens
Seat 5: HonourMan23 folded before Flop (didn't bet)
Seat 6: SantiagoWeight folded before Flop (didn't bet)



PokerStars Zoom Hand #195022173665:  Hold'em No Limit ($0.10/$0.25) - 2018/12/29 2:40:28 UTC [2018/12/28 21:40:28 ET]
Table 'Hydra' 6-max Seat #1 is the button
Seat 1: Z3rbinatti ($114.63 in chips) 
Seat 2: satisfhy_you ($25.85 in chips) 
Seat 3: samioattila ($55.23 in chips) 
Seat 4: SantiagoWeight ($23.96 in chips) 
Seat 5: steveblockx ($25.16 in chips) 
Seat 6: KAOS914 ($29.55 in chips) 
satisfhy_you: posts small blind $0.10
samioattila: posts big blind $0.25
*** HOLE CARDS ***
Dealt to SantiagoWeight [5c Kd]
SantiagoWeight: folds 
steveblockx: folds 
KAOS914: folds 
Z3rbinatti: folds 
satisfhy_you: folds 
Uncalled bet ($0.15) returned to samioattila
samioattila collected $0.20 from pot
samioattila: doesn't show hand 
*** SUMMARY ***
Total pot $0.20 | Rake $0 
Seat 1: Z3rbinatti (button) folded before Flop (didn't bet)
Seat 2: satisfhy_you (small blind) folded before Flop
Seat 3: samioattila (big blind) collected ($0.20)
Seat 4: SantiagoWeight folded before Flop (didn't bet)
Seat 5: steveblockx folded before Flop (didn't bet)
Seat 6: KAOS914 folded before Flop (didn't bet)



PokerStars Zoom Hand #195022182928:  Hold'em No Limit ($0.10/$0.25) - 2018/12/29 2:40:52 UTC [2018/12/28 21:40:52 ET]
Table 'Hydra' 6-max Seat #1 is the button
Seat 1: kounoupiss ($130.60 in chips) 
Seat 2: tightpokerAA ($31.94 in chips) 
Seat 3: SantiagoWeight ($25 in chips) 
Seat 4: svents ($161.17 in chips) 
Seat 5: samioattila ($55.23 in chips) 
Seat 6: altum15a ($108.05 in chips) 
tightpokerAA: posts small blind $0.10
SantiagoWeight: posts big blind $0.25
*** HOLE CARDS ***
Dealt to SantiagoWeight [2h 5s]
svents: folds 
samioattila: folds 
altum15a: raises $0.25 to $0.50
kounoupiss: folds 
tightpokerAA: folds 
SantiagoWeight: folds 
Uncalled bet ($0.25) returned to altum15a
altum15a collected $0.60 from pot
*** SUMMARY ***
Total pot $0.60 | Rake $0 
Seat 1: kounoupiss (button) folded before Flop (didn't bet)
Seat 2: tightpokerAA (small blind) folded before Flop
Seat 3: SantiagoWeight (big blind) folded before Flop
Seat 4: svents folded before Flop (didn't bet)
Seat 5: samioattila folded before Flop (didn't bet)
Seat 6: altum15a collected ($0.60)



PokerStars Zoom Hand #195022179792:  Hold'em No Limit ($0.10/$0.25) - 2018/12/29 2:40:45 UTC [2018/12/28 21:40:45 ET]
Table 'Hydra' 6-max Seat #1 is the button
Seat 1: SantiagoWeight ($25 in chips) 
Seat 2: idontnownow ($29.74 in chips) 
Seat 3: Z3rbinatti ($89.67 in chips) 
Seat 4: reggiedogg31 ($113.17 in chips) 
Seat 5: thedemise69 ($5.86 in chips) 
Seat 6: BIGPAIN14 ($64.30 in chips) 
idontnownow: posts small blind $0.10
Z3rbinatti: posts big blind $0.25
*** HOLE CARDS ***
Dealt to SantiagoWeight [3s 9d]
reggiedogg31: folds 
thedemise69: raises $0.50 to $0.75
BIGPAIN14: calls $0.75
SantiagoWeight: folds 
idontnownow: raises $2.25 to $3
Z3rbinatti: folds 
thedemise69: folds 
BIGPAIN14: calls $2.25
*** FLOP *** [Jd 5d 2s]
idontnownow: bets $5.25
BIGPAIN14: folds 
Uncalled bet ($5.25) returned to idontnownow
idontnownow collected $6.68 from pot
idontnownow: doesn't show hand 
*** SUMMARY ***
Total pot $7 | Rake $0.32 
Board [Jd 5d 2s]
Seat 1: SantiagoWeight (button) folded before Flop (didn't bet)
Seat 2: idontnownow (small blind) collected ($6.68)
Seat 3: Z3rbinatti (big blind) folded before Flop
Seat 4: reggiedogg31 folded before Flop (didn't bet)
Seat 5: thedemise69 folded before Flop
Seat 6: BIGPAIN14 folded on the Flop



PokerStars Zoom Hand #195022187554:  Hold'em No Limit ($0.10/$0.25) - 2018/12/29 2:41:04 UTC [2018/12/28 21:41:04 ET]
Table 'Hydra' 6-max Seat #1 is the button
Seat 1: kscorp22 ($12.85 in chips) 
Seat 2: reggiedogg31 ($112.92 in chips) 
Seat 3: Mrs Flush25 ($64.79 in chips) 
Seat 4: SantiagoWeight ($24.75 in chips) 
Seat 5: FrommyBu ($48.99 in chips) 
Seat 6: nadal335 ($29.01 in chips) 
reggiedogg31: posts small blind $0.10
Mrs Flush25: posts big blind $0.25
*** HOLE CARDS ***
Dealt to SantiagoWeight [3h Kd]
SantiagoWeight: folds 
FrommyBu: folds 
nadal335: folds 
kscorp22: folds 
reggiedogg31: folds 
Uncalled bet ($0.15) returned to Mrs Flush25
Mrs Flush25 collected $0.20 from pot
Mrs Flush25: doesn't show hand 
*** SUMMARY ***
Total pot $0.20 | Rake $0 
Seat 1: kscorp22 (button) folded before Flop (didn't bet)
Seat 2: reggiedogg31 (small blind) folded before Flop
Seat 3: Mrs Flush25 (big blind) collected ($0.20)
Seat 4: SantiagoWeight folded before Flop (didn't bet)
Seat 5: FrommyBu folded before Flop (didn't bet)
Seat 6: nadal335 folded before Flop (didn't bet)



PokerStars Zoom Hand #195022192970:  Hold'em No Limit ($0.10/$0.25) - 2018/12/29 2:41:19 UTC [2018/12/28 21:41:19 ET]
Table 'Hydra' 6-max Seat #1 is the button
Seat 1: Z3rbinatti ($89.32 in chips) 
Seat 2: SantiagoWeight ($24.75 in chips) 
Seat 3: allin969 ($33.91 in chips) 
Seat 4: nhanminhtri ($26.30 in chips) 
Seat 5: FrommyBu ($48.99 in chips) 
Seat 6: osa126 ($26.54 in chips) 
SantiagoWeight: posts small blind $0.10
allin969: posts big blind $0.25
*** HOLE CARDS ***
Dealt to SantiagoWeight [8s As]
nhanminhtri: folds 
FrommyBu: folds 
osa126: folds 
Z3rbinatti: raises $0.37 to $0.62
SantiagoWeight: raises $1.63 to $2.25
allin969: folds 
Z3rbinatti: folds 
Uncalled bet ($1.63) returned to SantiagoWeight
SantiagoWeight collected $1.49 from pot
SantiagoWeight: doesn't show hand 
*** SUMMARY ***
Total pot $1.49 | Rake $0 
Seat 1: Z3rbinatti (button) folded before Flop
Seat 2: SantiagoWeight (small blind) collected ($1.49)
Seat 3: allin969 (big blind) folded before Flop
Seat 4: nhanminhtri folded before Flop (didn't bet)
Seat 5: FrommyBu folded before Flop (didn't bet)
Seat 6: osa126 folded before Flop (didn't bet)



PokerStars Zoom Hand #195022201862:  Hold'em No Limit ($0.10/$0.25) - 2018/12/29 2:41:42 UTC [2018/12/28 21:41:42 ET]
Table 'Hydra' 6-max Seat #1 is the button
Seat 1: Z3rbinatti ($138.95 in chips) 
Seat 2: Mrs_Squeeze ($25 in chips) 
Seat 3: kounoupiss ($83.73 in chips) 
Seat 4: Ryoji1029 ($44.60 in chips) 
Seat 5: nathan_eeg ($20.45 in chips) 
Seat 6: SantiagoWeight ($25.62 in chips) 
Mrs_Squeeze: posts small blind $0.10
kounoupiss: posts big blind $0.25
*** HOLE CARDS ***
Dealt to SantiagoWeight [Th 7h]
Ryoji1029: raises $0.50 to $0.75
nathan_eeg: folds 
SantiagoWeight: folds 
Z3rbinatti: folds 
Mrs_Squeeze: folds 
kounoupiss: folds 
Uncalled bet ($0.50) returned to Ryoji1029
Ryoji1029 collected $0.60 from pot
Ryoji1029: doesn't show hand 
*** SUMMARY ***
Total pot $0.60 | Rake $0 
Seat 1: Z3rbinatti (button) folded before Flop (didn't bet)
Seat 2: Mrs_Squeeze (small blind) folded before Flop
Seat 3: kounoupiss (big blind) folded before Flop
Seat 4: Ryoji1029 collected ($0.60)
Seat 5: nathan_eeg folded before Flop (didn't bet)
Seat 6: SantiagoWeight folded before Flop (didn't bet)



PokerStars Zoom Hand #195022208476:  Hold'em No Limit ($0.10/$0.25) - 2018/12/29 2:41:59 UTC [2018/12/28 21:41:59 ET]
Table 'Hydra' 6-max Seat #1 is the button
Seat 1: winwinboy ($25 in chips) 
Seat 2: aa1421b ($12.42 in chips) 
Seat 3: SantiagoWeight ($25.62 in chips) 
Seat 4: kounoupiss ($83.38 in chips) 
Seat 5: KAOS914 ($29.55 in chips) 
Seat 6: ckriszee ($60.97 in chips) 
aa1421b: posts small blind $0.10
SantiagoWeight: posts big blind $0.25
*** HOLE CARDS ***
Dealt to SantiagoWeight [8d Ks]
kounoupiss: folds 
KAOS914: folds 
ckriszee: folds 
winwinboy: folds 
aa1421b: folds 
Uncalled bet ($0.15) returned to SantiagoWeight
SantiagoWeight collected $0.20 from pot
SantiagoWeight: doesn't show hand 
*** SUMMARY ***
Total pot $0.20 | Rake $0 
Seat 1: winwinboy (button) folded before Flop (didn't bet)
Seat 2: aa1421b (small blind) folded before Flop
Seat 3: SantiagoWeight (big blind) collected ($0.20)
Seat 4: kounoupiss folded before Flop (didn't bet)
Seat 5: KAOS914 folded before Flop (didn't bet)
Seat 6: ckriszee folded before Flop (didn't bet)



PokerStars Zoom Hand #195022214316:  Hold'em No Limit ($0.10/$0.25) - 2018/12/29 2:42:13 UTC [2018/12/28 21:42:13 ET]
Table 'Hydra' 6-max Seat #1 is the button
Seat 1: benddo ($55.65 in chips) 
Seat 2: kounoupiss ($83.38 in chips) 
Seat 3: ongravity ($23.90 in chips) 
Seat 4: ivann14 ($30.41 in chips) 
Seat 5: SantiagoWeight ($25.72 in chips) 
Seat 6: FrommyBu ($25 in chips) 
kounoupiss: posts small blind $0.10
ongravity: posts big blind $0.25
*** HOLE CARDS ***
Dealt to SantiagoWeight [Jc Qs]
ivann14: raises $0.50 to $0.75
SantiagoWeight: folds 
FrommyBu: folds 
benddo: folds 
kounoupiss: folds 
ongravity: folds 
Uncalled bet ($0.50) returned to ivann14
ivann14 collected $0.60 from pot
ivann14: doesn't show hand 
*** SUMMARY ***
Total pot $0.60 | Rake $0 
Seat 1: benddo (button) folded before Flop (didn't bet)
Seat 2: kounoupiss (small blind) folded before Flop
Seat 3: ongravity (big blind) folded before Flop
Seat 4: ivann14 collected ($0.60)
Seat 5: SantiagoWeight folded before Flop (didn't bet)
Seat 6: FrommyBu folded before Flop (didn't bet)



PokerStars Zoom Hand #195022220881:  Hold'em No Limit ($0.10/$0.25) - 2018/12/29 2:42:31 UTC [2018/12/28 21:42:31 ET]
Table 'Hydra' 6-max Seat #1 is the button
Seat 1: SantiagoWeight ($25.62 in chips) 
Seat 2: franco373513 ($8.61 in chips) 
Seat 3: Raptor1964 ($20.85 in chips) 
Seat 4: hoodbya!r ($10.64 in chips) 
Seat 5: samioattila ($54.89 in chips) 
Seat 6: benddo ($55.40 in chips) 
franco373513: posts small blind $0.10
Raptor1964: posts big blind $0.25
*** HOLE CARDS ***
Dealt to SantiagoWeight [Kc 9c]
hoodbya!r: raises $0.50 to $0.75
samioattila: folds 
benddo: raises $1.85 to $2.60
SantiagoWeight: folds 
franco373513: folds 
Raptor1964: folds 
hoodbya!r: folds 
Uncalled bet ($1.85) returned to benddo
benddo collected $1.85 from pot
benddo: doesn't show hand 
*** SUMMARY ***
Total pot $1.85 | Rake $0 
Seat 1: SantiagoWeight (button) folded before Flop (didn't bet)
Seat 2: franco373513 (small blind) folded before Flop
Seat 3: Raptor1964 (big blind) folded before Flop
Seat 4: hoodbya!r folded before Flop
Seat 5: samioattila folded before Flop (didn't bet)
Seat 6: benddo collected ($1.85)



PokerStars Zoom Hand #195022218159:  Hold'em No Limit ($0.10/$0.25) - 2018/12/29 2:42:23 UTC [2018/12/28 21:42:23 ET]
Table 'Hydra' 6-max Seat #1 is the button
Seat 1: ongravity ($25 in chips) 
Seat 2: SantiagoWeight ($25.72 in chips) 
Seat 3: SapientiAA ($25 in chips) 
Seat 4: nathan_eeg ($20.45 in chips) 
Seat 5: negreanuNya ($39.28 in chips) 
Seat 6: ChungkingExp ($25.75 in chips) 
SantiagoWeight: posts small blind $0.10
SapientiAA: posts big blind $0.25
*** HOLE CARDS ***
Dealt to SantiagoWeight [Ts 8d]
nathan_eeg: folds 
negreanuNya: folds 
ChungkingExp: folds 
ongravity: raises $0.50 to $0.75
SantiagoWeight: folds 
SapientiAA: folds 
Uncalled bet ($0.50) returned to ongravity
ongravity collected $0.60 from pot
ongravity: doesn't show hand 
*** SUMMARY ***
Total pot $0.60 | Rake $0 
Seat 1: ongravity (button) collected ($0.60)
Seat 2: SantiagoWeight (small blind) folded before Flop
Seat 3: SapientiAA (big blind) folded before Flop
Seat 4: nathan_eeg folded before Flop (didn't bet)
Seat 5: negreanuNya folded before Flop (didn't bet)
Seat 6: ChungkingExp folded before Flop (didn't bet)



PokerStars Zoom Hand #195022226609:  Hold'em No Limit ($0.10/$0.25) - 2018/12/29 2:42:45 UTC [2018/12/28 21:42:45 ET]
Table 'Hydra' 6-max Seat #1 is the button
Seat 1: BIGPAIN14 ($57.70 in chips) 
Seat 2: Only1Table ($19.15 in chips) 
Seat 3: Raptor fair ($17.64 in chips) 
Seat 4: SantiagoWeight ($25.62 in chips) 
Seat 5: Lehared ($45.54 in chips) 
Seat 6: nadal335 ($28.31 in chips) 
Only1Table: posts small blind $0.10
Raptor fair: posts big blind $0.25
*** HOLE CARDS ***
Dealt to SantiagoWeight [Qs Qd]
SantiagoWeight: raises $0.50 to $0.75
Lehared: folds 
nadal335: folds 
BIGPAIN14: folds 
Only1Table: folds 
Raptor fair: folds 
Uncalled bet ($0.50) returned to SantiagoWeight
SantiagoWeight collected $0.60 from pot
SantiagoWeight: doesn't show hand 
*** SUMMARY ***
Total pot $0.60 | Rake $0 
Seat 1: BIGPAIN14 (button) folded before Flop (didn't bet)
Seat 2: Only1Table (small blind) folded before Flop
Seat 3: Raptor fair (big blind) folded before Flop
Seat 4: SantiagoWeight collected ($0.60)
Seat 5: Lehared folded before Flop (didn't bet)
Seat 6: nadal335 folded before Flop (didn't bet)



PokerStars Zoom Hand #195022234250:  Hold'em No Limit ($0.10/$0.25) - 2018/12/29 2:43:05 UTC [2018/12/28 21:43:05 ET]
Table 'Hydra' 6-max Seat #1 is the button
Seat 1: nadal335 ($104.53 in chips) 
Seat 2: kounoupiss ($129.75 in chips) 
Seat 3: ongravity ($24.61 in chips) 
Seat 4: Parsam5 ($29.60 in chips) 
Seat 5: Z3rbinatti ($56.70 in chips) 
Seat 6: SantiagoWeight ($25.97 in chips) 
kounoupiss: posts small blind $0.10
ongravity: posts big blind $0.25
*** HOLE CARDS ***
Dealt to SantiagoWeight [Ts Td]
Parsam5: folds 
Z3rbinatti: folds 
SantiagoWeight: raises $0.35 to $0.60
nadal335: folds 
kounoupiss: folds 
ongravity: calls $0.35
*** FLOP *** [9h Tc Ac]
ongravity: checks 
SantiagoWeight: bets $1.24
ongravity: calls $1.24
*** TURN *** [9h Tc Ac] [5s]
ongravity: checks 
SantiagoWeight: bets $4
ongravity: calls $4
*** RIVER *** [9h Tc Ac 5s] [6d]
ongravity: checks 
SantiagoWeight: bets $20.13 and is all-in
ongravity: calls $18.77 and is all-in
Uncalled bet ($1.36) returned to SantiagoWeight
*** SHOW DOWN ***
SantiagoWeight: shows [Ts Td] (three of a kind, Tens)
ongravity: shows [Kd 9c] (a pair of Nines)
SantiagoWeight collected $47.32 from pot
*** SUMMARY ***
Total pot $49.32 | Rake $2 
Board [9h Tc Ac 5s 6d]
Seat 1: nadal335 (button) folded before Flop (didn't bet)
Seat 2: kounoupiss (small blind) folded before Flop
Seat 3: ongravity (big blind) showed [Kd 9c] and lost with a pair of Nines
Seat 4: Parsam5 folded before Flop (didn't bet)
Seat 5: Z3rbinatti folded before Flop (didn't bet)
Seat 6: SantiagoWeight showed [Ts Td] and won ($47.32) with three of a kind, Tens



PokerStars Zoom Hand #195022260297:  Hold'em No Limit ($0.10/$0.25) - 2018/12/29 2:44:13 UTC [2018/12/28 21:44:13 ET]
Table 'Hydra' 6-max Seat #1 is the button
Seat 1: ChungkingExp ($25 in chips) 
Seat 2: Cryptoz91 ($55.59 in chips) 
Seat 3: SantiagoWeight ($48.68 in chips) 
Seat 4: Raptor1964 ($26.93 in chips) 
Seat 5: ivann14 ($25.97 in chips) 
Seat 6: sleapyjoe ($16.57 in chips) 
Cryptoz91: posts small blind $0.10
SantiagoWeight: posts big blind $0.25
*** HOLE CARDS ***
Dealt to SantiagoWeight [3h 3c]
Raptor1964: folds 
ivann14: raises $0.25 to $0.50
sleapyjoe: folds 
ChungkingExp: folds 
Cryptoz91: folds 
SantiagoWeight: calls $0.25
*** FLOP *** [6s 4s 5c]
SantiagoWeight: checks 
ivann14: bets $0.50
SantiagoWeight: calls $0.50
*** TURN *** [6s 4s 5c] [Kh]
SantiagoWeight: checks 
ivann14: bets $1.25
SantiagoWeight: calls $1.25
*** RIVER *** [6s 4s 5c Kh] [Tc]
SantiagoWeight: checks 
ivann14: checks 
*** SHOW DOWN ***
SantiagoWeight: shows [3h 3c] (a pair of Threes)
ivann14: shows [Ad 6d] (a pair of Sixes)
ivann14 collected $4.39 from pot
*** SUMMARY ***
Total pot $4.60 | Rake $0.21 
Board [6s 4s 5c Kh Tc]
Seat 1: ChungkingExp (button) folded before Flop (didn't bet)
Seat 2: Cryptoz91 (small blind) folded before Flop
Seat 3: SantiagoWeight (big blind) showed [3h 3c] and lost with a pair of Threes
Seat 4: Raptor1964 folded before Flop (didn't bet)
Seat 5: ivann14 showed [Ad 6d] and won ($4.39) with a pair of Sixes
Seat 6: sleapyjoe folded before Flop (didn't bet)



PokerStars Zoom Hand #195022289793:  Hold'em No Limit ($0.10/$0.25) - 2018/12/29 2:45:30 UTC [2018/12/28 21:45:30 ET]
Table 'Hydra' 6-max Seat #1 is the button
Seat 1: Xa4_88 ($53.16 in chips) 
Seat 2: Z3rbinatti ($55.75 in chips) 
Seat 3: allin969 ($34.74 in chips) 
Seat 4: SantiagoWeight ($46.43 in chips) 
Seat 5: Parsam5 ($67.31 in chips) 
Seat 6: idontnownow ($39.36 in chips) 
Z3rbinatti: posts small blind $0.10
allin969: posts big blind $0.25
*** HOLE CARDS ***
Dealt to SantiagoWeight [9c 7d]
SantiagoWeight: folds 
Parsam5: folds 
idontnownow: folds 
Xa4_88: folds 
Z3rbinatti: raises $0.37 to $0.62
allin969: folds 
Uncalled bet ($0.37) returned to Z3rbinatti
Z3rbinatti collected $0.50 from pot
Z3rbinatti: doesn't show hand 
*** SUMMARY ***
Total pot $0.50 | Rake $0 
Seat 1: Xa4_88 (button) folded before Flop (didn't bet)
Seat 2: Z3rbinatti (small blind) collected ($0.50)
Seat 3: allin969 (big blind) folded before Flop
Seat 4: SantiagoWeight folded before Flop (didn't bet)
Seat 5: Parsam5 folded before Flop (didn't bet)
Seat 6: idontnownow folded before Flop (didn't bet)



PokerStars Zoom Hand #195022279490:  Hold'em No Limit ($0.10/$0.25) - 2018/12/29 2:45:03 UTC [2018/12/28 21:45:03 ET]
Table 'Hydra' 6-max Seat #1 is the button
Seat 1: SantiagoWeight ($46.43 in chips) 
Seat 2: tightpokerAA ($26.71 in chips) 
Seat 3: glennsterr ($25.62 in chips) 
Seat 4: samioattila ($40.47 in chips) 
Seat 5: ivann14 ($28.11 in chips) 
Seat 6: HansMSM ($32.02 in chips) 
tightpokerAA: posts small blind $0.10
glennsterr: posts big blind $0.25
*** HOLE CARDS ***
Dealt to SantiagoWeight [5s Kd]
samioattila: folds 
ivann14: raises $0.25 to $0.50
HansMSM: raises $1.15 to $1.65
SantiagoWeight: folds 
tightpokerAA: folds 
glennsterr: calls $1.40
ivann14: calls $1.15
*** FLOP *** [9c 3c 2s]
glennsterr: checks 
ivann14: checks 
HansMSM: bets $1.59
glennsterr: calls $1.59
ivann14: calls $1.59
*** TURN *** [9c 3c 2s] [Js]
glennsterr: checks 
ivann14: checks 
HansMSM: checks 
*** RIVER *** [9c 3c 2s Js] [3h]
glennsterr: checks 
ivann14: checks 
HansMSM: checks 
*** SHOW DOWN ***
glennsterr: shows [Ac Ah] (two pair, Aces and Threes)
ivann14: mucks hand 
HansMSM: mucks hand 
glennsterr collected $9.38 from pot
*** SUMMARY ***
Total pot $9.82 | Rake $0.44 
Board [9c 3c 2s Js 3h]
Seat 1: SantiagoWeight (button) folded before Flop (didn't bet)
Seat 2: tightpokerAA (small blind) folded before Flop
Seat 3: glennsterr (big blind) showed [Ac Ah] and won ($9.38) with two pair, Aces and Threes
Seat 4: samioattila folded before Flop (didn't bet)
Seat 5: ivann14 mucked [7d 9d]
Seat 6: HansMSM mucked [9s Ad]



PokerStars Zoom Hand #195022290888:  Hold'em No Limit ($0.10/$0.25) - 2018/12/29 2:45:33 UTC [2018/12/28 21:45:33 ET]
Table 'Hydra' 6-max Seat #1 is the button
Seat 1: aloominat ($26.90 in chips) 
Seat 2: SantiagoWeight ($46.43 in chips) 
Seat 3: benddo ($81.66 in chips) 
Seat 4: oleg77552 ($60.66 in chips) 
Seat 5: negreanuNya ($37.89 in chips) 
Seat 6: moderi ($23.65 in chips) 
SantiagoWeight: posts small blind $0.10
benddo: posts big blind $0.25
*** HOLE CARDS ***
Dealt to SantiagoWeight [As Jd]
oleg77552: folds 
negreanuNya: folds 
moderi: calls $0.25
aloominat: folds 
SantiagoWeight: raises $1 to $1.25
benddo: calls $1
moderi: calls $1
*** FLOP *** [Kc 8h 2s]
SantiagoWeight: bets $2.60
benddo: folds 
moderi: calls $2.60
*** TURN *** [Kc 8h 2s] [4h]
SantiagoWeight: bets $4.75
moderi: folds 
Uncalled bet ($4.75) returned to SantiagoWeight
SantiagoWeight collected $8.55 from pot
SantiagoWeight: doesn't show hand 
*** SUMMARY ***
Total pot $8.95 | Rake $0.40 
Board [Kc 8h 2s 4h]
Seat 1: aloominat (button) folded before Flop (didn't bet)
Seat 2: SantiagoWeight (small blind) collected ($8.55)
Seat 3: benddo (big blind) folded on the Flop
Seat 4: oleg77552 folded before Flop (didn't bet)
Seat 5: negreanuNya folded before Flop (didn't bet)
Seat 6: moderi folded on the Turn



PokerStars Zoom Hand #195022324042:  Hold'em No Limit ($0.10/$0.25) - 2018/12/29 2:47:00 UTC [2018/12/28 21:47:00 ET]
Table 'Hydra' 6-max Seat #1 is the button
Seat 1: zhang1zhang ($42.31 in chips) 
Seat 2: ARTBIL ($19.20 in chips) 
Seat 3: Becks Baker ($23.46 in chips) 
Seat 4: nhanminhtri ($26.02 in chips) 
Seat 5: HansMSM ($25.93 in chips) 
Seat 6: SantiagoWeight ($51.13 in chips) 
ARTBIL: posts small blind $0.10
Becks Baker: posts big blind $0.25
*** HOLE CARDS ***
Dealt to SantiagoWeight [Qh 9c]
nhanminhtri: folds 
HansMSM: folds 
SantiagoWeight: raises $0.35 to $0.60
zhang1zhang: folds 
ARTBIL: folds 
Becks Baker: calls $0.35
*** FLOP *** [4s 4d 6s]
Becks Baker: checks 
SantiagoWeight: bets $0.25
Becks Baker: calls $0.25
*** TURN *** [4s 4d 6s] [9s]
Becks Baker: checks 
SantiagoWeight: bets $1.50
Becks Baker: calls $1.50
*** RIVER *** [4s 4d 6s 9s] [Tc]
Becks Baker: checks 
SantiagoWeight: bets $2.50
Becks Baker: folds 
Uncalled bet ($2.50) returned to SantiagoWeight
SantiagoWeight collected $4.58 from pot
SantiagoWeight: doesn't show hand 
*** SUMMARY ***
Total pot $4.80 | Rake $0.22 
Board [4s 4d 6s 9s Tc]
Seat 1: zhang1zhang (button) folded before Flop (didn't bet)
Seat 2: ARTBIL (small blind) folded before Flop
Seat 3: Becks Baker (big blind) folded on the River
Seat 4: nhanminhtri folded before Flop (didn't bet)
Seat 5: HansMSM folded before Flop (didn't bet)
Seat 6: SantiagoWeight collected ($4.58)



PokerStars Zoom Hand #195022433326:  Hold'em No Limit ($0.10/$0.25) - 2018/12/29 2:51:29 UTC [2018/12/28 21:51:29 ET]
Table 'Hydra' 6-max Seat #1 is the button
Seat 1: ryanking99 ($36.22 in chips) 
Seat 2: zdenekstavic ($15.79 in chips) 
Seat 3: SantiagoWeight ($53.36 in chips) 
Seat 4: ARTBIL ($21.52 in chips) 
Seat 5: TQNYMQNTANA ($25 in chips) 
Seat 6: Indiaan1625 ($25.11 in chips) 
zdenekstavic: posts small blind $0.10
SantiagoWeight: posts big blind $0.25
*** HOLE CARDS ***
Dealt to SantiagoWeight [Ks 2h]
ARTBIL: folds 
TQNYMQNTANA: folds 
Indiaan1625: raises $0.60 to $0.85
ryanking99: folds 
zdenekstavic: calls $0.75
SantiagoWeight: folds 
*** FLOP *** [5s Jc As]
zdenekstavic: checks 
Indiaan1625: bets $1.86
zdenekstavic: calls $1.86
*** TURN *** [5s Jc As] [6c]
zdenekstavic: checks 
Indiaan1625: checks 
*** RIVER *** [5s Jc As 6c] [Kd]
zdenekstavic: checks 
Indiaan1625: checks 
*** SHOW DOWN ***
zdenekstavic: shows [4s 3s] (high card Ace)
Indiaan1625: shows [7d Jd] (a pair of Jacks)
Indiaan1625 collected $5.41 from pot
*** SUMMARY ***
Total pot $5.67 | Rake $0.26 
Board [5s Jc As 6c Kd]
Seat 1: ryanking99 (button) folded before Flop (didn't bet)
Seat 2: zdenekstavic (small blind) showed [4s 3s] and lost with high card Ace
Seat 3: SantiagoWeight (big blind) folded before Flop
Seat 4: ARTBIL folded before Flop (didn't bet)
Seat 5: TQNYMQNTANA folded before Flop (didn't bet)
Seat 6: Indiaan1625 showed [7d Jd] and won ($5.41) with a pair of Jacks



PokerStars Zoom Hand #195022438167:  Hold'em No Limit ($0.10/$0.25) - 2018/12/29 2:51:43 UTC [2018/12/28 21:51:43 ET]
Table 'Hydra' 6-max Seat #1 is the button
Seat 1: charis _rush ($13.26 in chips) 
Seat 2: Z3rbinatti ($111.93 in chips) 
Seat 3: Becks Baker ($18.64 in chips) 
Seat 4: TQNYMQNTANA ($32.32 in chips) 
Seat 5: SantiagoWeight ($53.11 in chips) 
Seat 6: winwinboy ($25 in chips) 
Z3rbinatti: posts small blind $0.10
Becks Baker: posts big blind $0.25
*** HOLE CARDS ***
Dealt to SantiagoWeight [Qc Jd]
TQNYMQNTANA: folds 
SantiagoWeight: raises $0.37 to $0.62
winwinboy: folds 
charis _rush: folds 
Z3rbinatti: folds 
Becks Baker: folds 
Uncalled bet ($0.37) returned to SantiagoWeight
SantiagoWeight collected $0.60 from pot
SantiagoWeight: doesn't show hand 
*** SUMMARY ***
Total pot $0.60 | Rake $0 
Seat 1: charis _rush (button) folded before Flop (didn't bet)
Seat 2: Z3rbinatti (small blind) folded before Flop
Seat 3: Becks Baker (big blind) folded before Flop
Seat 4: TQNYMQNTANA folded before Flop (didn't bet)
Seat 5: SantiagoWeight collected ($0.60)
Seat 6: winwinboy folded before Flop (didn't bet)



PokerStars Zoom Hand #195022429580:  Hold'em No Limit ($0.10/$0.25) - 2018/12/29 2:51:20 UTC [2018/12/28 21:51:20 ET]
Table 'Hydra' 6-max Seat #1 is the button
Seat 1: anorectal ($50.29 in chips) 
Seat 2: idontnownow ($69.05 in chips) 
Seat 3: profihblbau ($24.94 in chips) 
Seat 4: will82777 ($21.67 in chips) 
Seat 5: SantiagoWeight ($53.36 in chips) 
Seat 6: Lehared ($45.12 in chips) 
idontnownow: posts small blind $0.10
profihblbau: posts big blind $0.25
*** HOLE CARDS ***
Dealt to SantiagoWeight [Js 5d]
will82777: folds 
SantiagoWeight: folds 
Lehared: folds 
anorectal: raises $0.35 to $0.60
idontnownow: calls $0.50
profihblbau: calls $0.35
*** FLOP *** [7d 8c 2h]
idontnownow: checks 
profihblbau: checks 
anorectal: checks 
*** TURN *** [7d 8c 2h] [6c]
idontnownow: checks 
profihblbau: bets $0.25
anorectal: folds 
idontnownow: folds 
Uncalled bet ($0.25) returned to profihblbau
profihblbau collected $1.72 from pot
profihblbau: doesn't show hand 
*** SUMMARY ***
Total pot $1.80 | Rake $0.08 
Board [7d 8c 2h 6c]
Seat 1: anorectal (button) folded on the Turn
Seat 2: idontnownow (small blind) folded on the Turn
Seat 3: profihblbau (big blind) collected ($1.72)
Seat 4: will82777 folded before Flop (didn't bet)
Seat 5: SantiagoWeight folded before Flop (didn't bet)
Seat 6: Lehared folded before Flop (didn't bet)



PokerStars Zoom Hand #195022445980:  Hold'em No Limit ($0.10/$0.25) - 2018/12/29 2:52:04 UTC [2018/12/28 21:52:04 ET]
Table 'Hydra' 6-max Seat #1 is the button
Seat 1: SantiagoWeight ($53.46 in chips) 
Seat 2: stavro88 ($35.21 in chips) 
Seat 3: Dbakunwaves ($49.03 in chips) 
Seat 4: Z3rbinatti ($143.31 in chips) 
Seat 5: kounoupiss ($83.24 in chips) 
Seat 6: !P0K3RM3T4L! ($28.69 in chips) 
stavro88: posts small blind $0.10
Dbakunwaves: posts big blind $0.25
*** HOLE CARDS ***
Dealt to SantiagoWeight [8c Kd]
Z3rbinatti: folds 
kounoupiss: raises $0.50 to $0.75
!P0K3RM3T4L!: folds 
SantiagoWeight: folds 
stavro88: calls $0.65
Dbakunwaves: calls $0.50
*** FLOP *** [9c Jd Qs]
stavro88: checks 
Dbakunwaves: checks 
kounoupiss: checks 
*** TURN *** [9c Jd Qs] [Ks]
stavro88: checks 
Dbakunwaves: checks 
kounoupiss: checks 
*** RIVER *** [9c Jd Qs Ks] [7h]
stavro88: checks 
Dbakunwaves: bets $2
kounoupiss: folds 
stavro88: folds 
Uncalled bet ($2) returned to Dbakunwaves
Dbakunwaves collected $2.15 from pot
Dbakunwaves: doesn't show hand 
*** SUMMARY ***
Total pot $2.25 | Rake $0.10 
Board [9c Jd Qs Ks 7h]
Seat 1: SantiagoWeight (button) folded before Flop (didn't bet)
Seat 2: stavro88 (small blind) folded on the River
Seat 3: Dbakunwaves (big blind) collected ($2.15)
Seat 4: Z3rbinatti folded before Flop (didn't bet)
Seat 5: kounoupiss folded on the River
Seat 6: !P0K3RM3T4L! folded before Flop (didn't bet)



PokerStars Zoom Hand #195022467362:  Hold'em No Limit ($0.10/$0.25) - 2018/12/29 2:53:00 UTC [2018/12/28 21:53:00 ET]
Table 'Hydra' 6-max Seat #1 is the button
Seat 1: KrishnaRadha ($30.50 in chips) 
Seat 2: SantiagoWeight ($53.46 in chips) 
Seat 3: anorectal ($50.01 in chips) 
Seat 4: TDAK1509 ($25.75 in chips) 
Seat 5: Chrimmpam ($19.72 in chips) 
Seat 6: franco373513 ($27.95 in chips) 
SantiagoWeight: posts small blind $0.10
anorectal: posts big blind $0.25
*** HOLE CARDS ***
Dealt to SantiagoWeight [Qs 8h]
TDAK1509: folds 
Chrimmpam: folds 
franco373513: folds 
KrishnaRadha: raises $0.25 to $0.50
SantiagoWeight: folds 
anorectal: folds 
Uncalled bet ($0.25) returned to KrishnaRadha
KrishnaRadha collected $0.60 from pot
KrishnaRadha: doesn't show hand 
*** SUMMARY ***
Total pot $0.60 | Rake $0 
Seat 1: KrishnaRadha (button) collected ($0.60)
Seat 2: SantiagoWeight (small blind) folded before Flop
Seat 3: anorectal (big blind) folded before Flop
Seat 4: TDAK1509 folded before Flop (didn't bet)
Seat 5: Chrimmpam folded before Flop (didn't bet)
Seat 6: franco373513 folded before Flop (didn't bet)



PokerStars Zoom Hand #195022456183:  Hold'em No Limit ($0.10/$0.25) - 2018/12/29 2:52:30 UTC [2018/12/28 21:52:30 ET]
Table 'Hydra' 6-max Seat #1 is the button
Seat 1: mihai_f1986 ($24.30 in chips) 
Seat 2: nadal335 ($106.16 in chips) 
Seat 3: ckriszee ($25 in chips) 
Seat 4: LOBO_AA ($25 in chips) 
Seat 5: satisfhy_you ($35.76 in chips) 
Seat 6: SantiagoWeight ($53.46 in chips) 
nadal335: posts small blind $0.10
ckriszee: posts big blind $0.25
*** HOLE CARDS ***
Dealt to SantiagoWeight [6h 9s]
LOBO_AA has timed out
LOBO_AA: folds 
satisfhy_you: folds 
SantiagoWeight: folds 
mihai_f1986: folds 
nadal335: raises $0.50 to $0.75
ckriszee: calls $0.50
*** FLOP *** [Ad 8d Ac]
nadal335: bets $0.72
ckriszee: calls $0.72
*** TURN *** [Ad 8d Ac] [Js]
nadal335: checks 
ckriszee: checks 
*** RIVER *** [Ad 8d Ac Js] [5d]
nadal335: bets $0.25
ckriszee: calls $0.25
*** SHOW DOWN ***
nadal335: shows [8c Qc] (two pair, Aces and Eights)
ckriszee: mucks hand 
nadal335 collected $3.29 from pot
*** SUMMARY ***
Total pot $3.44 | Rake $0.15 
Board [Ad 8d Ac Js 5d]
Seat 1: mihai_f1986 (button) folded before Flop (didn't bet)
Seat 2: nadal335 (small blind) showed [8c Qc] and won ($3.29) with two pair, Aces and Eights
Seat 3: ckriszee (big blind) mucked [Kc 5c]
Seat 4: LOBO_AA folded before Flop (didn't bet)
Seat 5: satisfhy_you folded before Flop (didn't bet)
Seat 6: SantiagoWeight folded before Flop (didn't bet)



PokerStars Zoom Hand #195022473275:  Hold'em No Limit ($0.10/$0.25) - 2018/12/29 2:53:17 UTC [2018/12/28 21:53:17 ET]
Table 'Hydra' 6-max Seat #1 is the button
Seat 1: SantiagoWeight ($53.36 in chips) 
Seat 2: callmanic ($27.72 in chips) 
Seat 3: SDCMan ($25.25 in chips) 
Seat 4: Parsam5 ($66.11 in chips) 
Seat 5: Baboscrubx ($25.64 in chips) 
Seat 6: tightpokerAA ($24.65 in chips) 
callmanic: posts small blind $0.10
SDCMan: posts big blind $0.25
*** HOLE CARDS ***
Dealt to SantiagoWeight [Ac 2c]
Parsam5: folds 
Baboscrubx: folds 
tightpokerAA: folds 
SantiagoWeight: raises $0.30 to $0.55
callmanic: raises $1.35 to $1.90
SDCMan: raises $4.10 to $6
SantiagoWeight: folds 
callmanic: raises $21.72 to $27.72 and is all-in
SDCMan: calls $19.25 and is all-in
Uncalled bet ($2.47) returned to callmanic
*** FLOP *** [6c Qd Jd]
*** TURN *** [6c Qd Jd] [9c]
*** RIVER *** [6c Qd Jd 9c] [Th]
*** SHOW DOWN ***
callmanic: shows [Kh Ah] (a straight, Ten to Ace)
SDCMan: shows [Js Jh] (three of a kind, Jacks)
callmanic collected $49.05 from pot
*** SUMMARY ***
Total pot $51.05 | Rake $2 
Board [6c Qd Jd 9c Th]
Seat 1: SantiagoWeight (button) folded before Flop
Seat 2: callmanic (small blind) showed [Kh Ah] and won ($49.05) with a straight, Ten to Ace
Seat 3: SDCMan (big blind) showed [Js Jh] and lost with three of a kind, Jacks
Seat 4: Parsam5 folded before Flop (didn't bet)
Seat 5: Baboscrubx folded before Flop (didn't bet)
Seat 6: tightpokerAA folded before Flop (didn't bet)



PokerStars Zoom Hand #195022490756:  Hold'em No Limit ($0.10/$0.25) - 2018/12/29 2:54:04 UTC [2018/12/28 21:54:04 ET]
Table 'Hydra' 6-max Seat #1 is the button
Seat 1: yobbos ($50.67 in chips) 
Seat 2: Xa4_88 ($60.87 in chips) 
Seat 3: svents ($53.43 in chips) 
Seat 4: SantiagoWeight ($52.81 in chips) 
Seat 5: Cryptoz91 ($31.78 in chips) 
Seat 6: ivann14 ($27.63 in chips) 
Xa4_88: posts small blind $0.10
svents: posts big blind $0.25
*** HOLE CARDS ***
Dealt to SantiagoWeight [Ts 3d]
SantiagoWeight: folds 
Cryptoz91: folds 
ivann14: raises $0.38 to $0.63
yobbos: raises $1.37 to $2
Xa4_88: folds 
svents: folds 
ivann14: folds 
Uncalled bet ($1.37) returned to yobbos
yobbos collected $1.61 from pot
yobbos: doesn't show hand 
*** SUMMARY ***
Total pot $1.61 | Rake $0 
Seat 1: yobbos (button) collected ($1.61)
Seat 2: Xa4_88 (small blind) folded before Flop
Seat 3: svents (big blind) folded before Flop
Seat 4: SantiagoWeight folded before Flop (didn't bet)
Seat 5: Cryptoz91 folded before Flop (didn't bet)
Seat 6: ivann14 folded before Flop



PokerStars Zoom Hand #195022494985:  Hold'em No Limit ($0.10/$0.25) - 2018/12/29 2:54:15 UTC [2018/12/28 21:54:15 ET]
Table 'Hydra' 6-max Seat #1 is the button
Seat 1: Cryptoz91 ($50.47 in chips) 
Seat 2: zhang1zhang ($34.53 in chips) 
Seat 3: SantiagoWeight ($52.81 in chips) 
Seat 4: FoldureAces ($25.02 in chips) 
Seat 5: Becks Baker ($27.05 in chips) 
Seat 6: winwinboy ($25 in chips) 
zhang1zhang: posts small blind $0.10
SantiagoWeight: posts big blind $0.25
*** HOLE CARDS ***
Dealt to SantiagoWeight [Jc 9c]
FoldureAces: folds 
Becks Baker: folds 
winwinboy: folds 
Cryptoz91: raises $0.37 to $0.62
zhang1zhang: folds 
SantiagoWeight: calls $0.37
*** FLOP *** [7s 4c 2s]
SantiagoWeight: checks 
Cryptoz91: bets $0.41
SantiagoWeight: calls $0.41
*** TURN *** [7s 4c 2s] [6s]
SantiagoWeight: checks 
Cryptoz91: bets $1.57
SantiagoWeight: folds 
Uncalled bet ($1.57) returned to Cryptoz91
Cryptoz91 collected $2.06 from pot
Cryptoz91: doesn't show hand 
*** SUMMARY ***
Total pot $2.16 | Rake $0.10 
Board [7s 4c 2s 6s]
Seat 1: Cryptoz91 (button) collected ($2.06)
Seat 2: zhang1zhang (small blind) folded before Flop
Seat 3: SantiagoWeight (big blind) folded on the Turn
Seat 4: FoldureAces folded before Flop (didn't bet)
Seat 5: Becks Baker folded before Flop (didn't bet)
Seat 6: winwinboy folded before Flop (didn't bet)



PokerStars Zoom Hand #195022533753:  Hold'em No Limit ($0.10/$0.25) - 2018/12/29 2:56:08 UTC [2018/12/28 21:56:08 ET]
Table 'Hydra' 6-max Seat #1 is the button
Seat 1: kounoupiss ($145.14 in chips) 
Seat 2: SantiagoWeight ($51.78 in chips) 
Seat 3: Xa4_88 ($56.57 in chips) 
Seat 4: zhang1zhang ($32.08 in chips) 
Seat 5: SirSatan001 ($44.25 in chips) 
Seat 6: !P0K3RM3T4L! ($27.24 in chips) 
SantiagoWeight: posts small blind $0.10
Xa4_88: posts big blind $0.25
*** HOLE CARDS ***
Dealt to SantiagoWeight [Kc Tc]
zhang1zhang: raises $0.50 to $0.75
SirSatan001: folds 
!P0K3RM3T4L!: folds 
kounoupiss: calls $0.75
SantiagoWeight: folds 
Xa4_88: folds 
*** FLOP *** [5d Ad 7d]
zhang1zhang: checks 
kounoupiss: checks 
*** TURN *** [5d Ad 7d] [Kd]
zhang1zhang: bets $1.18
kounoupiss: folds 
Uncalled bet ($1.18) returned to zhang1zhang
zhang1zhang collected $1.77 from pot
zhang1zhang: doesn't show hand 
*** SUMMARY ***
Total pot $1.85 | Rake $0.08 
Board [5d Ad 7d Kd]
Seat 1: kounoupiss (button) folded on the Turn
Seat 2: SantiagoWeight (small blind) folded before Flop
Seat 3: Xa4_88 (big blind) folded before Flop
Seat 4: zhang1zhang collected ($1.77)
Seat 5: SirSatan001 folded before Flop (didn't bet)
Seat 6: !P0K3RM3T4L! folded before Flop (didn't bet)



PokerStars Zoom Hand #195022544685:  Hold'em No Limit ($0.10/$0.25) - 2018/12/29 2:56:41 UTC [2018/12/28 21:56:41 ET]
Table 'Hydra' 6-max Seat #1 is the button
Seat 1: SantiagoWeight ($51.68 in chips) 
Seat 2: davidhw888 ($38.40 in chips) 
Seat 3: cpt.peep ($35.20 in chips) 
Seat 4: call me??107 ($18.08 in chips) 
Seat 5: MarcoA12 ($23.65 in chips) 
Seat 6: paulieGB ($35.32 in chips) 
davidhw888: posts small blind $0.10
cpt.peep: posts big blind $0.25
*** HOLE CARDS ***
Dealt to SantiagoWeight [2s 5s]
call me??107: folds 
MarcoA12: folds 
paulieGB: folds 
SantiagoWeight: folds 
davidhw888: folds 
Uncalled bet ($0.15) returned to cpt.peep
cpt.peep collected $0.20 from pot
cpt.peep: doesn't show hand 
*** SUMMARY ***
Total pot $0.20 | Rake $0 
Seat 1: SantiagoWeight (button) folded before Flop (didn't bet)
Seat 2: davidhw888 (small blind) folded before Flop
Seat 3: cpt.peep (big blind) collected ($0.20)
Seat 4: call me??107 folded before Flop (didn't bet)
Seat 5: MarcoA12 folded before Flop (didn't bet)
Seat 6: paulieGB folded before Flop (didn't bet)



PokerStars Zoom Hand #195022543355:  Hold'em No Limit ($0.10/$0.25) - 2018/12/29 2:56:37 UTC [2018/12/28 21:56:37 ET]
Table 'Hydra' 6-max Seat #1 is the button
Seat 1: Lehared ($88.25 in chips) 
Seat 2: _BluDeeN_ ($24.75 in chips) 
Seat 3: nadal335 ($45.45 in chips) 
Seat 4: SantiagoWeight ($51.68 in chips) 
Seat 5: mihai_f1986 ($32.65 in chips) 
Seat 6: svents ($151.27 in chips) 
_BluDeeN_: posts small blind $0.10
nadal335: posts big blind $0.25
*** HOLE CARDS ***
Dealt to SantiagoWeight [Kh Td]
SantiagoWeight: folds 
mihai_f1986: folds 
svents: folds 
Lehared: folds 
_BluDeeN_: folds 
Uncalled bet ($0.15) returned to nadal335
nadal335 collected $0.20 from pot
nadal335: doesn't show hand 
*** SUMMARY ***
Total pot $0.20 | Rake $0 
Seat 1: Lehared (button) folded before Flop (didn't bet)
Seat 2: _BluDeeN_ (small blind) folded before Flop
Seat 3: nadal335 (big blind) collected ($0.20)
Seat 4: SantiagoWeight folded before Flop (didn't bet)
Seat 5: mihai_f1986 folded before Flop (didn't bet)
Seat 6: svents folded before Flop (didn't bet)



PokerStars Zoom Hand #195022546308:  Hold'em No Limit ($0.10/$0.25) - 2018/12/29 2:56:46 UTC [2018/12/28 21:56:46 ET]
Table 'Hydra' 6-max Seat #1 is the button
Seat 1: benddo ($82.06 in chips) 
Seat 2: mihai_f1986 ($32.40 in chips) 
Seat 3: FrommyBu ($31.43 in chips) 
Seat 4: davidhw888 ($38.30 in chips) 
Seat 5: samioattila ($82.65 in chips) 
Seat 6: SantiagoWeight ($51.68 in chips) 
mihai_f1986: posts small blind $0.10
FrommyBu: posts big blind $0.25
*** HOLE CARDS ***
Dealt to SantiagoWeight [As 5h]
davidhw888: folds 
samioattila: folds 
SantiagoWeight: folds 
benddo: raises $0.50 to $0.75
mihai_f1986: folds 
FrommyBu: folds 
Uncalled bet ($0.50) returned to benddo
benddo collected $0.60 from pot
benddo: doesn't show hand 
*** SUMMARY ***
Total pot $0.60 | Rake $0 
Seat 1: benddo (button) collected ($0.60)
Seat 2: mihai_f1986 (small blind) folded before Flop
Seat 3: FrommyBu (big blind) folded before Flop
Seat 4: davidhw888 folded before Flop (didn't bet)
Seat 5: samioattila folded before Flop (didn't bet)
Seat 6: SantiagoWeight folded before Flop (didn't bet)



PokerStars Zoom Hand #195022554675:  Hold'em No Limit ($0.10/$0.25) - 2018/12/29 2:57:12 UTC [2018/12/28 21:57:12 ET]
Table 'Hydra' 6-max Seat #1 is the button
Seat 1: 1ownYourUsd ($24.45 in chips) 
Seat 2: GrandmasterY ($25.10 in chips) 
Seat 3: SantiagoWeight ($51.68 in chips) 
Seat 4: _BluDeeN_ ($24.65 in chips) 
Seat 5: anorectal ($60.53 in chips) 
Seat 6: pokerpienda ($33.64 in chips) 
GrandmasterY: posts small blind $0.10
SantiagoWeight: posts big blind $0.25
*** HOLE CARDS ***
Dealt to SantiagoWeight [4h 7h]
_BluDeeN_: folds 
anorectal: folds 
pokerpienda: folds 
1ownYourUsd: folds 
GrandmasterY: folds 
Uncalled bet ($0.15) returned to SantiagoWeight
SantiagoWeight collected $0.20 from pot
SantiagoWeight: doesn't show hand 
*** SUMMARY ***
Total pot $0.20 | Rake $0 
Seat 1: 1ownYourUsd (button) folded before Flop (didn't bet)
Seat 2: GrandmasterY (small blind) folded before Flop
Seat 3: SantiagoWeight (big blind) collected ($0.20)
Seat 4: _BluDeeN_ folded before Flop (didn't bet)
Seat 5: anorectal folded before Flop (didn't bet)
Seat 6: pokerpienda folded before Flop (didn't bet)



PokerStars Zoom Hand #195022550519:  Hold'em No Limit ($0.10/$0.25) - 2018/12/29 2:56:59 UTC [2018/12/28 21:56:59 ET]
Table 'Hydra' 6-max Seat #1 is the button
Seat 1: nadal335 ($45.55 in chips) 
Seat 2: Aldo1913 ($25 in chips) 
Seat 3: anorectal ($58.30 in chips) 
Seat 4: nhanminhtri ($38.83 in chips) 
Seat 5: SantiagoWeight ($51.68 in chips) 
Seat 6: paulieGB ($35.22 in chips) 
Aldo1913: posts small blind $0.10
anorectal: posts big blind $0.25
*** HOLE CARDS ***
Dealt to SantiagoWeight [6c 4c]
nhanminhtri: folds 
SantiagoWeight: folds 
paulieGB: folds 
nadal335: folds 
Aldo1913: raises $0.50 to $0.75
anorectal: calls $0.50
*** FLOP *** [Ah 3h As]
Aldo1913: bets $0.75
anorectal: calls $0.75
*** TURN *** [Ah 3h As] [5h]
Aldo1913: checks 
anorectal: bets $2.29
Aldo1913: folds 
Uncalled bet ($2.29) returned to anorectal
anorectal collected $2.86 from pot
anorectal: doesn't show hand 
*** SUMMARY ***
Total pot $3 | Rake $0.14 
Board [Ah 3h As 5h]
Seat 1: nadal335 (button) folded before Flop (didn't bet)
Seat 2: Aldo1913 (small blind) folded on the Turn
Seat 3: anorectal (big blind) collected ($2.86)
Seat 4: nhanminhtri folded before Flop (didn't bet)
Seat 5: SantiagoWeight folded before Flop (didn't bet)
Seat 6: paulieGB folded before Flop (didn't bet)



PokerStars Zoom Hand #195022530589:  Hold'em No Limit ($0.10/$0.25) - 2018/12/29 2:55:57 UTC [2018/12/28 21:55:57 ET]
Table 'Hydra' 6-max Seat #1 is the button
Seat 1: HansMSM ($31.11 in chips) 
Seat 2: naxizzle ($139.54 in chips) 
Seat 3: Tisho1234 ($14.15 in chips) 
Seat 4: benddo ($45.46 in chips) 
Seat 5: SantiagoWeight ($51.78 in chips) 
Seat 6: ludisima ($53.48 in chips) 
naxizzle: posts small blind $0.10
Tisho1234: posts big blind $0.25
*** HOLE CARDS ***
Dealt to SantiagoWeight [8s Th]
benddo: raises $0.50 to $0.75
SantiagoWeight: folds 
ludisima: folds 
HansMSM: calls $0.75
naxizzle: calls $0.65
Tisho1234: calls $0.50
*** FLOP *** [6s 6d 2d]
naxizzle: checks 
Tisho1234: checks 
benddo: checks 
HansMSM: bets $0.94
naxizzle: calls $0.94
Tisho1234: calls $0.94
benddo: calls $0.94
*** TURN *** [6s 6d 2d] [4h]
naxizzle: checks 
Tisho1234: checks 
benddo: checks 
HansMSM: checks 
*** RIVER *** [6s 6d 2d 4h] [9h]
naxizzle: bets $5
Tisho1234: raises $7.46 to $12.46 and is all-in
benddo: folds 
HansMSM: folds 
naxizzle: calls $7.46
*** SHOW DOWN ***
Tisho1234: shows [4c 4s] (a full house, Fours full of Sixes)
naxizzle: shows [7d 9d] (two pair, Nines and Sixes)
Tisho1234 collected $30.25 from pot
*** SUMMARY ***
Total pot $31.68 | Rake $1.43 
Board [6s 6d 2d 4h 9h]
Seat 1: HansMSM (button) folded on the River
Seat 2: naxizzle (small blind) showed [7d 9d] and lost with two pair, Nines and Sixes
Seat 3: Tisho1234 (big blind) showed [4c 4s] and won ($30.25) with a full house, Fours full of Sixes
Seat 4: benddo folded on the River
Seat 5: SantiagoWeight folded before Flop (didn't bet)
Seat 6: ludisima folded before Flop (didn't bet)



PokerStars Zoom Hand #195022560007:  Hold'em No Limit ($0.10/$0.25) - 2018/12/29 2:57:30 UTC [2018/12/28 21:57:30 ET]
Table 'Hydra' 6-max Seat #1 is the button
Seat 1: BärbärKush ($25 in chips) 
Seat 2: Jack123985 ($25 in chips) 
Seat 3: ARTBIL ($28.43 in chips) 
Seat 4: mojsza1 ($26.38 in chips) 
Seat 5: rim975 ($10.66 in chips) 
Seat 6: SantiagoWeight ($51.78 in chips) 
Jack123985: posts small blind $0.10
ARTBIL: posts big blind $0.25
*** HOLE CARDS ***
Dealt to SantiagoWeight [5s 7s]
mojsza1: folds 
rim975: folds 
SantiagoWeight: raises $0.30 to $0.55
BärbärKush: folds 
Jack123985: folds 
ARTBIL: calls $0.30
*** FLOP *** [6s Jd Ad]
ARTBIL: checks 
SantiagoWeight: bets $1.15
ARTBIL: folds 
Uncalled bet ($1.15) returned to SantiagoWeight
SantiagoWeight collected $1.15 from pot
SantiagoWeight: doesn't show hand 
*** SUMMARY ***
Total pot $1.20 | Rake $0.05 
Board [6s Jd Ad]
Seat 1: BärbärKush (button) folded before Flop (didn't bet)
Seat 2: Jack123985 (small blind) folded before Flop
Seat 3: ARTBIL (big blind) folded on the Flop
Seat 4: mojsza1 folded before Flop (didn't bet)
Seat 5: rim975 folded before Flop (didn't bet)
Seat 6: SantiagoWeight collected ($1.15)



PokerStars Zoom Hand #195022575590:  Hold'em No Limit ($0.10/$0.25) - 2018/12/29 2:58:18 UTC [2018/12/28 21:58:18 ET]
Table 'Hydra' 6-max Seat #1 is the button
Seat 1: benddo ($70.93 in chips) 
Seat 2: SantiagoWeight ($52.38 in chips) 
Seat 3: RandomWalk77 ($48.48 in chips) 
Seat 4: Cryptoz91 ($25 in chips) 
Seat 5: samioattila ($82.30 in chips) 
Seat 6: HansMSM ($29.17 in chips) 
SantiagoWeight: posts small blind $0.10
RandomWalk77: posts big blind $0.25
*** HOLE CARDS ***
Dealt to SantiagoWeight [Jd 7c]
Cryptoz91: raises $0.37 to $0.62
samioattila: folds 
HansMSM: folds 
benddo: folds 
SantiagoWeight: folds 
RandomWalk77: folds 
Uncalled bet ($0.37) returned to Cryptoz91
Cryptoz91 collected $0.60 from pot
Cryptoz91: doesn't show hand 
*** SUMMARY ***
Total pot $0.60 | Rake $0 
Seat 1: benddo (button) folded before Flop (didn't bet)
Seat 2: SantiagoWeight (small blind) folded before Flop
Seat 3: RandomWalk77 (big blind) folded before Flop
Seat 4: Cryptoz91 collected ($0.60)
Seat 5: samioattila folded before Flop (didn't bet)
Seat 6: HansMSM folded before Flop (didn't bet)



PokerStars Zoom Hand #195022583109:  Hold'em No Limit ($0.10/$0.25) - 2018/12/29 2:58:43 UTC [2018/12/28 21:58:43 ET]
Table 'Hydra' 6-max Seat #1 is the button
Seat 1: BIGPAIN14 ($64.73 in chips) 
Seat 2: qing328 ($24 in chips) 
Seat 3: mariopork ($30.53 in chips) 
Seat 4: SantiagoWeight ($52.28 in chips) 
Seat 5: RandomWalk77 ($48.13 in chips) 
Seat 6: winwinboy ($25.95 in chips) 
qing328: posts small blind $0.10
mariopork: posts big blind $0.25
*** HOLE CARDS ***
Dealt to SantiagoWeight [Kc Ac]
SantiagoWeight: raises $0.50 to $0.75
RandomWalk77: folds 
winwinboy: folds 
BIGPAIN14: folds 
qing328: folds 
mariopork: folds 
Uncalled bet ($0.50) returned to SantiagoWeight
SantiagoWeight collected $0.60 from pot
SantiagoWeight: doesn't show hand 
*** SUMMARY ***
Total pot $0.60 | Rake $0 
Seat 1: BIGPAIN14 (button) folded before Flop (didn't bet)
Seat 2: qing328 (small blind) folded before Flop
Seat 3: mariopork (big blind) folded before Flop
Seat 4: SantiagoWeight collected ($0.60)
Seat 5: RandomWalk77 folded before Flop (didn't bet)
Seat 6: winwinboy folded before Flop (didn't bet)



PokerStars Zoom Hand #195022592205:  Hold'em No Limit ($0.10/$0.25) - 2018/12/29 2:59:12 UTC [2018/12/28 21:59:12 ET]
Table 'Hydra' 6-max Seat #1 is the button
Seat 1: benddo ($70.93 in chips) 
Seat 2: Dr.Jekyll197 ($15.61 in chips) 
Seat 3: SantiagoWeight ($52.63 in chips) 
Seat 4: Party4Arthy ($58.55 in chips) 
Seat 5: winwinboy ($31.64 in chips) 
Seat 6: samioattila ($50.16 in chips) 
Dr.Jekyll197: posts small blind $0.10
SantiagoWeight: posts big blind $0.25
*** HOLE CARDS ***
Dealt to SantiagoWeight [2h Ad]
Party4Arthy: folds 
winwinboy: folds 
samioattila: folds 
benddo: folds 
Dr.Jekyll197: folds 
Uncalled bet ($0.15) returned to SantiagoWeight
SantiagoWeight collected $0.20 from pot
SantiagoWeight: doesn't show hand 
*** SUMMARY ***
Total pot $0.20 | Rake $0 
Seat 1: benddo (button) folded before Flop (didn't bet)
Seat 2: Dr.Jekyll197 (small blind) folded before Flop
Seat 3: SantiagoWeight (big blind) collected ($0.20)
Seat 4: Party4Arthy folded before Flop (didn't bet)
Seat 5: winwinboy folded before Flop (didn't bet)
Seat 6: samioattila folded before Flop (didn't bet)



PokerStars Zoom Hand #195022598559:  Hold'em No Limit ($0.10/$0.25) - 2018/12/29 2:59:32 UTC [2018/12/28 21:59:32 ET]
Table 'Hydra' 6-max Seat #1 is the button
Seat 1: SantiagoWeight ($52.73 in chips) 
Seat 2: ryanking99 ($29.01 in chips) 
Seat 3: simytis ($33.83 in chips) 
Seat 4: davidhw888 ($39.48 in chips) 
Seat 5: duo5002 ($40.95 in chips) 
Seat 6: samioattila ($79.42 in chips) 
ryanking99: posts small blind $0.10
simytis: posts big blind $0.25
*** HOLE CARDS ***
Dealt to SantiagoWeight [4c Kc]
davidhw888: raises $0.25 to $0.50
duo5002: folds 
samioattila: folds 
SantiagoWeight: folds 
ryanking99: folds 
simytis: folds 
Uncalled bet ($0.25) returned to davidhw888
davidhw888 collected $0.60 from pot
davidhw888: doesn't show hand 
*** SUMMARY ***
Total pot $0.60 | Rake $0 
Seat 1: SantiagoWeight (button) folded before Flop (didn't bet)
Seat 2: ryanking99 (small blind) folded before Flop
Seat 3: simytis (big blind) folded before Flop
Seat 4: davidhw888 collected ($0.60)
Seat 5: duo5002 folded before Flop (didn't bet)
Seat 6: samioattila folded before Flop (didn't bet)



PokerStars Zoom Hand #195022589028:  Hold'em No Limit ($0.10/$0.25) - 2018/12/29 2:59:01 UTC [2018/12/28 21:59:01 ET]
Table 'Hydra' 6-max Seat #1 is the button
Seat 1: ryanking99 ($41.70 in chips) 
Seat 2: tightpokerAA ($24.75 in chips) 
Seat 3: Ryoji1029 ($12.17 in chips) 
Seat 4: anlu0803 ($24.30 in chips) 
Seat 5: SantiagoWeight ($52.63 in chips) 
Seat 6: MarcoA12 ($22.93 in chips) 
tightpokerAA: posts small blind $0.10
Ryoji1029: posts big blind $0.25
*** HOLE CARDS ***
Dealt to SantiagoWeight [As 3d]
anlu0803: folds 
SantiagoWeight: folds 
MarcoA12: raises $1 to $1.25
ryanking99: folds 
tightpokerAA: folds 
Ryoji1029: calls $1
*** FLOP *** [Jh 5h Jd]
Ryoji1029: checks 
MarcoA12: checks 
*** TURN *** [Jh 5h Jd] [7h]
Ryoji1029: bets $0.75
MarcoA12: calls $0.75
*** RIVER *** [Jh 5h Jd 7h] [4h]
Ryoji1029: checks 
MarcoA12: bets $2
Ryoji1029: folds 
Uncalled bet ($2) returned to MarcoA12
MarcoA12 collected $3.92 from pot
MarcoA12: doesn't show hand 
*** SUMMARY ***
Total pot $4.10 | Rake $0.18 
Board [Jh 5h Jd 7h 4h]
Seat 1: ryanking99 (button) folded before Flop (didn't bet)
Seat 2: tightpokerAA (small blind) folded before Flop
Seat 3: Ryoji1029 (big blind) folded on the River
Seat 4: anlu0803 folded before Flop (didn't bet)
Seat 5: SantiagoWeight folded before Flop (didn't bet)
Seat 6: MarcoA12 collected ($3.92)



PokerStars Zoom Hand #195022596666:  Hold'em No Limit ($0.10/$0.25) - 2018/12/29 2:59:25 UTC [2018/12/28 21:59:25 ET]
Table 'Hydra' 6-max Seat #1 is the button
Seat 1: Baboscrubx ($25 in chips) 
Seat 2: ivann14 ($26.71 in chips) 
Seat 3: Rollout2018 ($16.96 in chips) 
Seat 4: SantiagoWeight ($52.73 in chips) 
Seat 5: mistdog ($29.08 in chips) 
Seat 6: zdena102 ($54.36 in chips) 
ivann14: posts small blind $0.10
Rollout2018: posts big blind $0.25
*** HOLE CARDS ***
Dealt to SantiagoWeight [5h 3d]
SantiagoWeight: folds 
mistdog: folds 
zdena102: folds 
Baboscrubx: raises $0.35 to $0.60
ivann14: folds 
Rollout2018: calls $0.35
*** FLOP *** [4d 8d Qd]
Rollout2018: checks 
Baboscrubx: bets $0.42
Rollout2018: folds 
Uncalled bet ($0.42) returned to Baboscrubx
Baboscrubx collected $1.24 from pot
Baboscrubx: doesn't show hand 
*** SUMMARY ***
Total pot $1.30 | Rake $0.06 
Board [4d 8d Qd]
Seat 1: Baboscrubx (button) collected ($1.24)
Seat 2: ivann14 (small blind) folded before Flop
Seat 3: Rollout2018 (big blind) folded on the Flop
Seat 4: SantiagoWeight folded before Flop (didn't bet)
Seat 5: mistdog folded before Flop (didn't bet)
Seat 6: zdena102 folded before Flop (didn't bet)



PokerStars Zoom Hand #195022602419:  Hold'em No Limit ($0.10/$0.25) - 2018/12/29 2:59:44 UTC [2018/12/28 21:59:44 ET]
Table 'Hydra' 6-max Seat #1 is the button
Seat 1: BärbärKush ($37.84 in chips) 
Seat 2: mayadelrey ($24.41 in chips) 
Seat 3: nathan_eeg ($18.96 in chips) 
Seat 4: SantiagoWeight ($52.73 in chips) 
Seat 5: Mrs_Squeeze ($20.78 in chips) 
Seat 6: mariopork ($42 in chips) 
mayadelrey: posts small blind $0.10
nathan_eeg: posts big blind $0.25
*** HOLE CARDS ***
Dealt to SantiagoWeight [Ah As]
SantiagoWeight: raises $0.50 to $0.75
Mrs_Squeeze: calls $0.75
mariopork: folds 
BärbärKush: folds 
mayadelrey: folds 
nathan_eeg: calls $0.50
*** FLOP *** [4s 6h 3h]
nathan_eeg: checks 
SantiagoWeight: checks 
Mrs_Squeeze: bets $1.12
nathan_eeg: calls $1.12
SantiagoWeight: raises $3.88 to $5
Mrs_Squeeze: calls $3.88
nathan_eeg: calls $3.88
*** TURN *** [4s 6h 3h] [Kc]
nathan_eeg: checks 
SantiagoWeight: checks 
Mrs_Squeeze: checks 
*** RIVER *** [4s 6h 3h Kc] [4h]
nathan_eeg: checks 
SantiagoWeight: checks 
Mrs_Squeeze: checks 
*** SHOW DOWN ***
nathan_eeg: shows [8h Qh] (a flush, Queen high)
SantiagoWeight: mucks hand 
Mrs_Squeeze: mucks hand 
nathan_eeg collected $16.57 from pot
*** SUMMARY ***
Total pot $17.35 | Rake $0.78 
Board [4s 6h 3h Kc 4h]
Seat 1: BärbärKush (button) folded before Flop (didn't bet)
Seat 2: mayadelrey (small blind) folded before Flop
Seat 3: nathan_eeg (big blind) showed [8h Qh] and won ($16.57) with a flush, Queen high
Seat 4: SantiagoWeight mucked [Ah As]
Seat 5: Mrs_Squeeze mucked [9c 9d]
Seat 6: mariopork folded before Flop (didn't bet)



PokerStars Zoom Hand #195022646547:  Hold'em No Limit ($0.10/$0.25) - 2018/12/29 3:01:54 UTC [2018/12/28 22:01:54 ET]
Table 'Hydra' 6-max Seat #1 is the button
Seat 1: Mrs_Squeeze ($19.25 in chips) 
Seat 2: SantiagoWeight ($46.98 in chips) 
Seat 3: mayadelrey ($21.96 in chips) 
Seat 4: pokerpienda ($12.22 in chips) 
Seat 5: Baboscrubx ($31.20 in chips) 
Seat 6: qing328 ($23.15 in chips) 
SantiagoWeight: posts small blind $0.10
mayadelrey: posts big blind $0.25
*** HOLE CARDS ***
Dealt to SantiagoWeight [Ah 3d]
pokerpienda: folds 
Baboscrubx: folds 
qing328: folds 
Mrs_Squeeze: folds 
SantiagoWeight: raises $0.37 to $0.62
mayadelrey: folds 
Uncalled bet ($0.37) returned to SantiagoWeight
SantiagoWeight collected $0.50 from pot
SantiagoWeight: doesn't show hand 
*** SUMMARY ***
Total pot $0.50 | Rake $0 
Seat 1: Mrs_Squeeze (button) folded before Flop (didn't bet)
Seat 2: SantiagoWeight (small blind) collected ($0.50)
Seat 3: mayadelrey (big blind) folded before Flop
Seat 4: pokerpienda folded before Flop (didn't bet)
Seat 5: Baboscrubx folded before Flop (didn't bet)
Seat 6: qing328 folded before Flop (didn't bet)



PokerStars Zoom Hand #195022654942:  Hold'em No Limit ($0.10/$0.25) - 2018/12/29 3:02:16 UTC [2018/12/28 22:02:16 ET]
Table 'Hydra' 6-max Seat #1 is the button
Seat 1: mariopork ($32.46 in chips) 
Seat 2: deaglepro ($49.09 in chips) 
Seat 3: samioattila ($51.72 in chips) 
Seat 4: SantiagoWeight ($47.23 in chips) 
Seat 5: ttshead ($25.54 in chips) 
Seat 6: aa1421b ($25.24 in chips) 
deaglepro: posts small blind $0.10
samioattila: posts big blind $0.25
*** HOLE CARDS ***
Dealt to SantiagoWeight [2s 4s]
SantiagoWeight: folds 
ttshead: folds 
aa1421b: folds 
mariopork: raises $0.37 to $0.62
deaglepro: raises $2.38 to $3
samioattila: folds 
mariopork: calls $2.38
*** FLOP *** [9d 4c 9h]
deaglepro: bets $5.97
mariopork: folds 
Uncalled bet ($5.97) returned to deaglepro
deaglepro collected $5.97 from pot
deaglepro: doesn't show hand 
*** SUMMARY ***
Total pot $6.25 | Rake $0.28 
Board [9d 4c 9h]
Seat 1: mariopork (button) folded on the Flop
Seat 2: deaglepro (small blind) collected ($5.97)
Seat 3: samioattila (big blind) folded before Flop
Seat 4: SantiagoWeight folded before Flop (didn't bet)
Seat 5: ttshead folded before Flop (didn't bet)
Seat 6: aa1421b folded before Flop (didn't bet)



PokerStars Zoom Hand #195022656374:  Hold'em No Limit ($0.10/$0.25) - 2018/12/29 3:02:21 UTC [2018/12/28 22:02:21 ET]
Table 'Hydra' 6-max Seat #1 is the button
Seat 1: !P0K3RM3T4L! ($27.97 in chips) 
Seat 2: Bujan 07 ($13.81 in chips) 
Seat 3: anlu0803 ($23.82 in chips) 
Seat 4: Buntar017 ($112.13 in chips) 
Seat 5: AngelicDiana ($77.26 in chips) 
Seat 6: SantiagoWeight ($47.23 in chips) 
Bujan 07: posts small blind $0.10
anlu0803: posts big blind $0.25
*** HOLE CARDS ***
Dealt to SantiagoWeight [Js Qs]
Buntar017: calls $0.25
AngelicDiana: folds 
SantiagoWeight: raises $0.75 to $1
!P0K3RM3T4L!: folds 
Bujan 07: folds 
anlu0803: folds 
Buntar017: calls $0.75
*** FLOP *** [Jd 7c 2d]
Buntar017: bets $1
SantiagoWeight: calls $1
*** TURN *** [Jd 7c 2d] [6h]
Buntar017: bets $2
SantiagoWeight: calls $2
*** RIVER *** [Jd 7c 2d 6h] [9d]
Buntar017: bets $0.25
SantiagoWeight: calls $0.25
*** SHOW DOWN ***
Buntar017: shows [7h Qc] (a pair of Sevens)
SantiagoWeight: shows [Js Qs] (a pair of Jacks)
SantiagoWeight collected $8.45 from pot
*** SUMMARY ***
Total pot $8.85 | Rake $0.40 
Board [Jd 7c 2d 6h 9d]
Seat 1: !P0K3RM3T4L! (button) folded before Flop (didn't bet)
Seat 2: Bujan 07 (small blind) folded before Flop
Seat 3: anlu0803 (big blind) folded before Flop
Seat 4: Buntar017 showed [7h Qc] and lost with a pair of Sevens
Seat 5: AngelicDiana folded before Flop (didn't bet)
Seat 6: SantiagoWeight showed [Js Qs] and won ($8.45) with a pair of Jacks



PokerStars Zoom Hand #195022674827:  Hold'em No Limit ($0.10/$0.25) - 2018/12/29 3:03:10 UTC [2018/12/28 22:03:10 ET]
Table 'Hydra' 6-max Seat #1 is the button
Seat 1: TQNYMQNTANA ($25.53 in chips) 
Seat 2: samioattila ($47.89 in chips) 
Seat 3: SantiagoWeight ($51.43 in chips) 
Seat 4: Slim Wolfie ($25 in chips) 
Seat 5: Alehan-ev ($25 in chips) 
Seat 6: Buntar017 ($107.88 in chips) 
samioattila: posts small blind $0.10
SantiagoWeight: posts big blind $0.25
*** HOLE CARDS ***
Dealt to SantiagoWeight [Kd 8d]
Slim Wolfie: folds 
Alehan-ev: folds 
Buntar017: raises $0.50 to $0.75
TQNYMQNTANA: folds 
samioattila: folds 
SantiagoWeight: folds 
Uncalled bet ($0.50) returned to Buntar017
Buntar017 collected $0.60 from pot
Buntar017: doesn't show hand 
*** SUMMARY ***
Total pot $0.60 | Rake $0 
Seat 1: TQNYMQNTANA (button) folded before Flop (didn't bet)
Seat 2: samioattila (small blind) folded before Flop
Seat 3: SantiagoWeight (big blind) folded before Flop
Seat 4: Slim Wolfie folded before Flop (didn't bet)
Seat 5: Alehan-ev folded before Flop (didn't bet)
Seat 6: Buntar017 collected ($0.60)



PokerStars Zoom Hand #195022680712:  Hold'em No Limit ($0.10/$0.25) - 2018/12/29 3:03:26 UTC [2018/12/28 22:03:26 ET]
Table 'Hydra' 6-max Seat #1 is the button
Seat 1: davidhw888 ($44.39 in chips) 
Seat 2: SantiagoWeight ($51.18 in chips) 
Seat 3: Dbakunwaves ($53.28 in chips) 
Seat 4: tightpokerAA ($35.12 in chips) 
Seat 5: samioattila ($51.72 in chips) 
Seat 6: AngelicDiana ($76.39 in chips) 
SantiagoWeight: posts small blind $0.10
Dbakunwaves: posts big blind $0.25
*** HOLE CARDS ***
Dealt to SantiagoWeight [6s Ah]
tightpokerAA: folds 
samioattila: raises $0.55 to $0.80
AngelicDiana: folds 
davidhw888: folds 
SantiagoWeight: folds 
Dbakunwaves: calls $0.55
*** FLOP *** [Ts 3h 9d]
Dbakunwaves: checks 
samioattila: checks 
*** TURN *** [Ts 3h 9d] [2s]
Dbakunwaves: bets $1.50
samioattila: folds 
Uncalled bet ($1.50) returned to Dbakunwaves
Dbakunwaves collected $1.62 from pot
Dbakunwaves: doesn't show hand 
*** SUMMARY ***
Total pot $1.70 | Rake $0.08 
Board [Ts 3h 9d 2s]
Seat 1: davidhw888 (button) folded before Flop (didn't bet)
Seat 2: SantiagoWeight (small blind) folded before Flop
Seat 3: Dbakunwaves (big blind) collected ($1.62)
Seat 4: tightpokerAA folded before Flop (didn't bet)
Seat 5: samioattila folded on the Turn
Seat 6: AngelicDiana folded before Flop (didn't bet)



PokerStars Zoom Hand #195022685426:  Hold'em No Limit ($0.10/$0.25) - 2018/12/29 3:03:40 UTC [2018/12/28 22:03:40 ET]
Table 'Hydra' 6-max Seat #1 is the button
Seat 1: SantiagoWeight ($51.08 in chips) 
Seat 2: armandopinga ($138.92 in chips) 
Seat 3: tightpokerAA ($35.94 in chips) 
Seat 4: TQNYMQNTANA ($25.18 in chips) 
Seat 5: ludisima ($52.37 in chips) 
Seat 6: qing328 ($22.20 in chips) 
armandopinga: posts small blind $0.10
tightpokerAA: posts big blind $0.25
*** HOLE CARDS ***
Dealt to SantiagoWeight [8h 6d]
TQNYMQNTANA: raises $0.50 to $0.75
ludisima: calls $0.75
qing328: folds 
SantiagoWeight: folds 
armandopinga: folds 
tightpokerAA: folds 
*** FLOP *** [9d 6c 3c]
TQNYMQNTANA: bets $1
ludisima: folds 
Uncalled bet ($1) returned to TQNYMQNTANA
TQNYMQNTANA collected $1.77 from pot
TQNYMQNTANA: doesn't show hand 
*** SUMMARY ***
Total pot $1.85 | Rake $0.08 
Board [9d 6c 3c]
Seat 1: SantiagoWeight (button) folded before Flop (didn't bet)
Seat 2: armandopinga (small blind) folded before Flop
Seat 3: tightpokerAA (big blind) folded before Flop
Seat 4: TQNYMQNTANA collected ($1.77)
Seat 5: ludisima folded on the Flop
Seat 6: qing328 folded before Flop (didn't bet)



PokerStars Zoom Hand #195022691299:  Hold'em No Limit ($0.10/$0.25) - 2018/12/29 3:03:55 UTC [2018/12/28 22:03:55 ET]
Table 'Hydra' 6-max Seat #1 is the button
Seat 1: SantiagoWeight ($51.08 in chips) 
Seat 2: samioattila ($47.89 in chips) 
Seat 3: nathan_eeg ($29.38 in chips) 
Seat 4: cankum ($39.80 in chips) 
Seat 5: yobbos ($139.11 in chips) 
Seat 6: _BluDeeN_ ($25.39 in chips) 
samioattila: posts small blind $0.10
nathan_eeg: posts big blind $0.25
*** HOLE CARDS ***
Dealt to SantiagoWeight [5c 2h]
cankum: folds 
yobbos: raises $0.50 to $0.75
_BluDeeN_: folds 
SantiagoWeight: folds 
samioattila: folds 
nathan_eeg: folds 
Uncalled bet ($0.50) returned to yobbos
yobbos collected $0.60 from pot
yobbos: doesn't show hand 
*** SUMMARY ***
Total pot $0.60 | Rake $0 
Seat 1: SantiagoWeight (button) folded before Flop (didn't bet)
Seat 2: samioattila (small blind) folded before Flop
Seat 3: nathan_eeg (big blind) folded before Flop
Seat 4: cankum folded before Flop (didn't bet)
Seat 5: yobbos collected ($0.60)
Seat 6: _BluDeeN_ folded before Flop (didn't bet)



PokerStars Zoom Hand #195022687644:  Hold'em No Limit ($0.10/$0.25) - 2018/12/29 3:03:45 UTC [2018/12/28 22:03:45 ET]
Table 'Hydra' 6-max Seat #1 is the button
Seat 1: meettokill ($28.48 in chips) 
Seat 2: osa126 ($25.45 in chips) 
Seat 3: Slim Wolfie ($25 in chips) 
Seat 4: idontnownow ($68.80 in chips) 
Seat 5: qing328 ($22.20 in chips) 
Seat 6: SantiagoWeight ($51.08 in chips) 
osa126: posts small blind $0.10
Slim Wolfie: posts big blind $0.25
*** HOLE CARDS ***
Dealt to SantiagoWeight [Kd 8d]
idontnownow: raises $0.25 to $0.50
qing328: folds 
SantiagoWeight: folds 
meettokill: folds 
osa126: calls $0.40
Slim Wolfie: calls $0.25
*** FLOP *** [3h 3s 6s]
osa126: checks 
Slim Wolfie: checks 
idontnownow: bets $1.25
osa126: folds 
Slim Wolfie: folds 
Uncalled bet ($1.25) returned to idontnownow
idontnownow collected $1.43 from pot
idontnownow: doesn't show hand 
*** SUMMARY ***
Total pot $1.50 | Rake $0.07 
Board [3h 3s 6s]
Seat 1: meettokill (button) folded before Flop (didn't bet)
Seat 2: osa126 (small blind) folded on the Flop
Seat 3: Slim Wolfie (big blind) folded on the Flop
Seat 4: idontnownow collected ($1.43)
Seat 5: qing328 folded before Flop (didn't bet)
Seat 6: SantiagoWeight folded before Flop (didn't bet)



PokerStars Zoom Hand #195022694213:  Hold'em No Limit ($0.10/$0.25) - 2018/12/29 3:04:03 UTC [2018/12/28 22:04:03 ET]
Table 'Hydra' 6-max Seat #1 is the button
Seat 1: !P0K3RM3T4L! ($49.61 in chips) 
Seat 2: gabrielle674 ($18.67 in chips) 
Seat 3: negreanuNya ($27.06 in chips) 
Seat 4: assassin0875 ($186.12 in chips) 
Seat 5: simytis ($37.45 in chips) 
Seat 6: SantiagoWeight ($51.08 in chips) 
gabrielle674: posts small blind $0.10
negreanuNya: posts big blind $0.25
*** HOLE CARDS ***
Dealt to SantiagoWeight [Jd 4c]
assassin0875: folds 
simytis: folds 
SantiagoWeight: folds 
!P0K3RM3T4L!: folds 
gabrielle674: raises $0.50 to $0.75
negreanuNya: folds 
Uncalled bet ($0.50) returned to gabrielle674
gabrielle674 collected $0.50 from pot
gabrielle674: doesn't show hand 
*** SUMMARY ***
Total pot $0.50 | Rake $0 
Seat 1: !P0K3RM3T4L! (button) folded before Flop (didn't bet)
Seat 2: gabrielle674 (small blind) collected ($0.50)
Seat 3: negreanuNya (big blind) folded before Flop
Seat 4: assassin0875 folded before Flop (didn't bet)
Seat 5: simytis folded before Flop (didn't bet)
Seat 6: SantiagoWeight folded before Flop (didn't bet)



PokerStars Zoom Hand #195022698228:  Hold'em No Limit ($0.10/$0.25) - 2018/12/29 3:04:15 UTC [2018/12/28 22:04:15 ET]
Table 'Hydra' 6-max Seat #1 is the button
Seat 1: benddo ($59.42 in chips) 
Seat 2: samioattila ($50.67 in chips) 
Seat 3: SantiagoWeight ($51.08 in chips) 
Seat 4: Parsam5 ($58.21 in chips) 
Seat 5: zekoxxx ($20.58 in chips) 
Seat 6: Chrimmpam ($16 in chips) 
samioattila: posts small blind $0.10
SantiagoWeight: posts big blind $0.25
*** HOLE CARDS ***
Dealt to SantiagoWeight [7s 7h]
Parsam5: folds 
zekoxxx: calls $0.25
Chrimmpam: raises $0.85 to $1.10
benddo: folds 
samioattila: folds 
SantiagoWeight: calls $0.85
zekoxxx: calls $0.85
*** FLOP *** [Th 3d 4s]
SantiagoWeight: checks 
zekoxxx: checks 
Chrimmpam: checks 
*** TURN *** [Th 3d 4s] [9h]
SantiagoWeight: checks 
zekoxxx: bets $1.63
Chrimmpam: calls $1.63
SantiagoWeight: folds 
*** RIVER *** [Th 3d 4s 9h] [As]
zekoxxx: checks 
Chrimmpam: bets $6.25
zekoxxx: folds 
Uncalled bet ($6.25) returned to Chrimmpam
Chrimmpam collected $6.36 from pot
Chrimmpam: doesn't show hand 
*** SUMMARY ***
Total pot $6.66 | Rake $0.30 
Board [Th 3d 4s 9h As]
Seat 1: benddo (button) folded before Flop (didn't bet)
Seat 2: samioattila (small blind) folded before Flop
Seat 3: SantiagoWeight (big blind) folded on the Turn
Seat 4: Parsam5 folded before Flop (didn't bet)
Seat 5: zekoxxx folded on the River
Seat 6: Chrimmpam collected ($6.36)



PokerStars Zoom Hand #195022720522:  Hold'em No Limit ($0.10/$0.25) - 2018/12/29 3:05:15 UTC [2018/12/28 22:05:15 ET]
Table 'Hydra' 6-max Seat #1 is the button
Seat 1: trillerGTO ($22.59 in chips) 
Seat 2: Rollout2018 ($14.63 in chips) 
Seat 3: MeDoubleJ ($25 in chips) 
Seat 4: Jack123985 ($29.55 in chips) 
Seat 5: SantiagoWeight ($49.98 in chips) 
Seat 6: Lehared ($117.06 in chips) 
Rollout2018: posts small blind $0.10
MeDoubleJ: posts big blind $0.25
*** HOLE CARDS ***
Dealt to SantiagoWeight [Qd 6d]
Jack123985: folds 
SantiagoWeight: folds 
Lehared: folds 
trillerGTO: raises $0.37 to $0.62
Rollout2018: folds 
MeDoubleJ: folds 
Uncalled bet ($0.37) returned to trillerGTO
trillerGTO collected $0.60 from pot
trillerGTO: doesn't show hand 
*** SUMMARY ***
Total pot $0.60 | Rake $0 
Seat 1: trillerGTO (button) collected ($0.60)
Seat 2: Rollout2018 (small blind) folded before Flop
Seat 3: MeDoubleJ (big blind) folded before Flop
Seat 4: Jack123985 folded before Flop (didn't bet)
Seat 5: SantiagoWeight folded before Flop (didn't bet)
Seat 6: Lehared folded before Flop (didn't bet)



PokerStars Zoom Hand #195022728506:  Hold'em No Limit ($0.10/$0.25) - 2018/12/29 3:05:38 UTC [2018/12/28 22:05:38 ET]
Table 'Hydra' 6-max Seat #1 is the button
Seat 1: HansMSM ($41.94 in chips) 
Seat 2: SantiagoWeight ($49.98 in chips) 
Seat 3: trillerGTO ($22.94 in chips) 
Seat 4: nhanminhtri ($36.08 in chips) 
Seat 5: Chrimmpam ($22.20 in chips) 
Seat 6: nadal335 ($67.83 in chips) 
SantiagoWeight: posts small blind $0.10
trillerGTO: posts big blind $0.25
*** HOLE CARDS ***
Dealt to SantiagoWeight [5s 2s]
nhanminhtri: folds 
Chrimmpam: folds 
nadal335: folds 
HansMSM: folds 
SantiagoWeight: folds 
Uncalled bet ($0.15) returned to trillerGTO
trillerGTO collected $0.20 from pot
*** SUMMARY ***
Total pot $0.20 | Rake $0 
Seat 1: HansMSM (button) folded before Flop (didn't bet)
Seat 2: SantiagoWeight (small blind) folded before Flop
Seat 3: trillerGTO (big blind) collected ($0.20)
Seat 4: nhanminhtri folded before Flop (didn't bet)
Seat 5: Chrimmpam folded before Flop (didn't bet)
Seat 6: nadal335 folded before Flop (didn't bet)



PokerStars Zoom Hand #195022722987:  Hold'em No Limit ($0.10/$0.25) - 2018/12/29 3:05:22 UTC [2018/12/28 22:05:22 ET]
Table 'Hydra' 6-max Seat #1 is the button
Seat 1: davidhw888 ($16.16 in chips) 
Seat 2: Jack123985 ($29.55 in chips) 
Seat 3: nathan_eeg ($28.88 in chips) 
Seat 4: SantiagoWeight ($49.98 in chips) 
Seat 5: naxizzle ($120.55 in chips) 
Seat 6: ckriszee ($26.28 in chips) 
Jack123985: posts small blind $0.10
nathan_eeg: posts big blind $0.25
*** HOLE CARDS ***
Dealt to SantiagoWeight [2h Ad]
SantiagoWeight: folds 
naxizzle: folds 
ckriszee: folds 
davidhw888: folds 
Jack123985: raises $0.50 to $0.75
nathan_eeg: calls $0.50
*** FLOP *** [5d 3s 7c]
Jack123985: bets $0.80
nathan_eeg: raises $1.30 to $2.10
Jack123985: folds 
Uncalled bet ($1.30) returned to nathan_eeg
nathan_eeg collected $2.96 from pot
nathan_eeg: doesn't show hand 
*** SUMMARY ***
Total pot $3.10 | Rake $0.14 
Board [5d 3s 7c]
Seat 1: davidhw888 (button) folded before Flop (didn't bet)
Seat 2: Jack123985 (small blind) folded on the Flop
Seat 3: nathan_eeg (big blind) collected ($2.96)
Seat 4: SantiagoWeight folded before Flop (didn't bet)
Seat 5: naxizzle folded before Flop (didn't bet)
Seat 6: ckriszee folded before Flop (didn't bet)



PokerStars Zoom Hand #195022738015:  Hold'em No Limit ($0.10/$0.25) - 2018/12/29 3:06:03 UTC [2018/12/28 22:06:03 ET]
Table 'Hydra' 6-max Seat #1 is the button
Seat 1: benddo ($68.83 in chips) 
Seat 2: nhanminhtri ($30.70 in chips) 
Seat 3: Parsam5 ($55.41 in chips) 
Seat 4: SapientiAA ($25.39 in chips) 
Seat 5: SantiagoWeight ($49.88 in chips) 
Seat 6: zhang1zhang ($52.71 in chips) 
nhanminhtri: posts small blind $0.10
Parsam5: posts big blind $0.25
*** HOLE CARDS ***
Dealt to SantiagoWeight [Th Js]
SapientiAA: raises $0.25 to $0.50
SantiagoWeight: folds 
zhang1zhang: folds 
benddo: folds 
nhanminhtri: folds 
Parsam5: folds 
Uncalled bet ($0.25) returned to SapientiAA
SapientiAA collected $0.60 from pot
SapientiAA: doesn't show hand 
*** SUMMARY ***
Total pot $0.60 | Rake $0 
Seat 1: benddo (button) folded before Flop (didn't bet)
Seat 2: nhanminhtri (small blind) folded before Flop
Seat 3: Parsam5 (big blind) folded before Flop
Seat 4: SapientiAA collected ($0.60)
Seat 5: SantiagoWeight folded before Flop (didn't bet)
Seat 6: zhang1zhang folded before Flop (didn't bet)



PokerStars Zoom Hand #195022740943:  Hold'em No Limit ($0.10/$0.25) - 2018/12/29 3:06:12 UTC [2018/12/28 22:06:12 ET]
Table 'Hydra' 6-max Seat #1 is the button
Seat 1: samioattila ($47.79 in chips) 
Seat 2: armandopinga ($138.57 in chips) 
Seat 3: river plate9 ($25 in chips) 
Seat 4: TDAK1509 ($60.13 in chips) 
Seat 5: SantiagoWeight ($49.88 in chips) 
Seat 6: negreanuNya ($25 in chips) 
armandopinga: posts small blind $0.10
river plate9: posts big blind $0.25
*** HOLE CARDS ***
Dealt to SantiagoWeight [4s 7d]
TDAK1509: folds 
SantiagoWeight: folds 
negreanuNya: folds 
samioattila: folds 
armandopinga: raises $0.75 to $1
river plate9: folds 
Uncalled bet ($0.75) returned to armandopinga
armandopinga collected $0.50 from pot
armandopinga: doesn't show hand 
*** SUMMARY ***
Total pot $0.50 | Rake $0 
Seat 1: samioattila (button) folded before Flop (didn't bet)
Seat 2: armandopinga (small blind) collected ($0.50)
Seat 3: river plate9 (big blind) folded before Flop
Seat 4: TDAK1509 folded before Flop (didn't bet)
Seat 5: SantiagoWeight folded before Flop (didn't bet)
Seat 6: negreanuNya folded before Flop (didn't bet)



PokerStars Zoom Hand #195022752619:  Hold'em No Limit ($0.10/$0.25) - 2018/12/29 3:06:43 UTC [2018/12/28 22:06:43 ET]
Table 'Hydra' 6-max Seat #1 is the button
Seat 1: SantiagoWeight ($49.63 in chips) 
Seat 2: ttshead ($21.32 in chips) 
Seat 3: Actarusqc ($31.58 in chips) 
Seat 4: davidhw888 ($28.47 in chips) 
Seat 5: Akkana ($22.20 in chips) 
Seat 6: SapientiAA ($25.06 in chips) 
ttshead: posts small blind $0.10
Actarusqc: posts big blind $0.25
*** HOLE CARDS ***
Dealt to SantiagoWeight [9c Kd]
davidhw888: folds 
Akkana: folds 
SapientiAA: folds 
SantiagoWeight: raises $0.30 to $0.55
ttshead: folds 
Actarusqc: folds 
Uncalled bet ($0.30) returned to SantiagoWeight
SantiagoWeight collected $0.60 from pot
SantiagoWeight: doesn't show hand 
*** SUMMARY ***
Total pot $0.60 | Rake $0 
Seat 1: SantiagoWeight (button) collected ($0.60)
Seat 2: ttshead (small blind) folded before Flop
Seat 3: Actarusqc (big blind) folded before Flop
Seat 4: davidhw888 folded before Flop (didn't bet)
Seat 5: Akkana folded before Flop (didn't bet)
Seat 6: SapientiAA folded before Flop (didn't bet)



PokerStars Zoom Hand #195022745699:  Hold'em No Limit ($0.10/$0.25) - 2018/12/29 3:06:25 UTC [2018/12/28 22:06:25 ET]
Table 'Hydra' 6-max Seat #1 is the button
Seat 1: jeffwalker23 ($40.56 in chips) 
Seat 2: river plate9 ($24.75 in chips) 
Seat 3: SantiagoWeight ($49.88 in chips) 
Seat 4: anorectal ($65.72 in chips) 
Seat 5: nhanminhtri ($34.01 in chips) 
Seat 6: benddo ($68.48 in chips) 
river plate9: posts small blind $0.10
SantiagoWeight: posts big blind $0.25
*** HOLE CARDS ***
Dealt to SantiagoWeight [As 6d]
anorectal: folds 
nhanminhtri: folds 
benddo: folds 
jeffwalker23: raises $0.50 to $0.75
river plate9: calls $0.65
SantiagoWeight: folds 
*** FLOP *** [7c 9d 2c]
river plate9: checks 
jeffwalker23: checks 
*** TURN *** [7c 9d 2c] [7h]
river plate9: checks 
jeffwalker23: checks 
*** RIVER *** [7c 9d 2c 7h] [7s]
river plate9: checks 
jeffwalker23: checks 
*** SHOW DOWN ***
river plate9: shows [Th Ks] (three of a kind, Sevens)
jeffwalker23: shows [Kh Jh] (three of a kind, Sevens - King+Jack kicker)
jeffwalker23 collected $1.67 from pot
*** SUMMARY ***
Total pot $1.75 | Rake $0.08 
Board [7c 9d 2c 7h 7s]
Seat 1: jeffwalker23 (button) showed [Kh Jh] and won ($1.67) with three of a kind, Sevens
Seat 2: river plate9 (small blind) showed [Th Ks] and lost with three of a kind, Sevens
Seat 3: SantiagoWeight (big blind) folded before Flop
Seat 4: anorectal folded before Flop (didn't bet)
Seat 5: nhanminhtri folded before Flop (didn't bet)
Seat 6: benddo folded before Flop (didn't bet)



PokerStars Zoom Hand #195022756680:  Hold'em No Limit ($0.10/$0.25) - 2018/12/29 3:06:55 UTC [2018/12/28 22:06:55 ET]
Table 'Hydra' 6-max Seat #1 is the button
Seat 1: Actarusqc ($31.33 in chips) 
Seat 2: tightpokerAA ($31.38 in chips) 
Seat 3: TQNYMQNTANA ($31.44 in chips) 
Seat 4: Baboscrubx ($39.31 in chips) 
Seat 5: benddo ($68.83 in chips) 
Seat 6: SantiagoWeight ($49.98 in chips) 
tightpokerAA: posts small blind $0.10
TQNYMQNTANA: posts big blind $0.25
*** HOLE CARDS ***
Dealt to SantiagoWeight [6d Th]
Baboscrubx: folds 
benddo: folds 
SantiagoWeight: folds 
Actarusqc: calls $0.25
tightpokerAA: raises $0.75 to $1
TQNYMQNTANA: calls $0.75
Actarusqc: calls $0.75
*** FLOP *** [8s 2s 6s]
tightpokerAA: checks 
TQNYMQNTANA: checks 
Actarusqc: checks 
*** TURN *** [8s 2s 6s] [8h]
tightpokerAA: checks 
TQNYMQNTANA: checks 
Actarusqc: checks 
*** RIVER *** [8s 2s 6s 8h] [5h]
tightpokerAA: checks 
TQNYMQNTANA: checks 
Actarusqc: checks 
*** SHOW DOWN ***
tightpokerAA: shows [4c Ac] (a pair of Eights)
TQNYMQNTANA: mucks hand 
Actarusqc: mucks hand 
tightpokerAA collected $2.86 from pot
*** SUMMARY ***
Total pot $3 | Rake $0.14 
Board [8s 2s 6s 8h 5h]
Seat 1: Actarusqc (button) mucked [Ts Qc]
Seat 2: tightpokerAA (small blind) showed [4c Ac] and won ($2.86) with a pair of Eights
Seat 3: TQNYMQNTANA (big blind) mucked [Kd Qs]
Seat 4: Baboscrubx folded before Flop (didn't bet)
Seat 5: benddo folded before Flop (didn't bet)
Seat 6: SantiagoWeight folded before Flop (didn't bet)



PokerStars Zoom Hand #195022761071:  Hold'em No Limit ($0.10/$0.25) - 2018/12/29 3:07:06 UTC [2018/12/28 22:07:06 ET]
Table 'Hydra' 6-max Seat #1 is the button
Seat 1: Nutselas ($27.62 in chips) 
Seat 2: yobbos ($51.85 in chips) 
Seat 3: idontnownow ($68.73 in chips) 
Seat 4: SantiagoWeight ($49.98 in chips) 
Seat 5: MISTAAJ ($29.66 in chips) 
Seat 6: !P0K3RM3T4L! ($48.56 in chips) 
yobbos: posts small blind $0.10
idontnownow: posts big blind $0.25
*** HOLE CARDS ***
Dealt to SantiagoWeight [Ts 7d]
SantiagoWeight: folds 
MISTAAJ: folds 
!P0K3RM3T4L!: raises $0.45 to $0.70
Nutselas: folds 
yobbos: folds 
idontnownow: calls $0.45
*** FLOP *** [Td 3s 3d]
idontnownow: bets $0.50
!P0K3RM3T4L!: folds 
Uncalled bet ($0.50) returned to idontnownow
idontnownow collected $1.43 from pot
idontnownow: doesn't show hand 
*** SUMMARY ***
Total pot $1.50 | Rake $0.07 
Board [Td 3s 3d]
Seat 1: Nutselas (button) folded before Flop (didn't bet)
Seat 2: yobbos (small blind) folded before Flop
Seat 3: idontnownow (big blind) collected ($1.43)
Seat 4: SantiagoWeight folded before Flop (didn't bet)
Seat 5: MISTAAJ folded before Flop (didn't bet)
Seat 6: !P0K3RM3T4L! folded on the Flop



PokerStars Zoom Hand #195022770440:  Hold'em No Limit ($0.10/$0.25) - 2018/12/29 3:07:32 UTC [2018/12/28 22:07:32 ET]
Table 'Hydra' 6-max Seat #1 is the button
Seat 1: Parsam5 ($67.52 in chips) 
Seat 2: benddo ($74.59 in chips) 
Seat 3: franco373513 ($12.13 in chips) 
Seat 4: SantiagoWeight ($49.88 in chips) 
Seat 5: Lehared ($58.60 in chips) 
Seat 6: mariopork ($27.30 in chips) 
benddo: posts small blind $0.10
franco373513: posts big blind $0.25
*** HOLE CARDS ***
Dealt to SantiagoWeight [5h 2h]
SantiagoWeight: folds 
Lehared: folds 
mariopork: folds 
Parsam5: raises $0.50 to $0.75
benddo: calls $0.65
franco373513: folds 
*** FLOP *** [6c Td Ad]
benddo: checks 
Parsam5: checks 
*** TURN *** [6c Td Ad] [7d]
benddo: bets $1
Parsam5: folds 
Uncalled bet ($1) returned to benddo
benddo collected $1.67 from pot
benddo: doesn't show hand 
*** SUMMARY ***
Total pot $1.75 | Rake $0.08 
Board [6c Td Ad 7d]
Seat 1: Parsam5 (button) folded on the Turn
Seat 2: benddo (small blind) collected ($1.67)
Seat 3: franco373513 (big blind) folded before Flop
Seat 4: SantiagoWeight folded before Flop (didn't bet)
Seat 5: Lehared folded before Flop (didn't bet)
Seat 6: mariopork folded before Flop (didn't bet)



PokerStars Zoom Hand #195022776880:  Hold'em No Limit ($0.10/$0.25) - 2018/12/29 3:07:50 UTC [2018/12/28 22:07:50 ET]
Table 'Hydra' 6-max Seat #1 is the button
Seat 1: ryanking99 ($41.99 in chips) 
Seat 2: SeniorInv ($8.58 in chips) 
Seat 3: SantiagoWeight ($49.88 in chips) 
Seat 4: ckriszee ($25.10 in chips) 
Seat 5: BMB8888 ($18.80 in chips) 
Seat 6: benddo ($54.23 in chips) 
SeniorInv: posts small blind $0.10
SantiagoWeight: posts big blind $0.25
*** HOLE CARDS ***
Dealt to SantiagoWeight [6s Th]
ckriszee: folds 
BMB8888: folds 
benddo: folds 
ryanking99: folds 
SeniorInv: folds 
Uncalled bet ($0.15) returned to SantiagoWeight
SantiagoWeight collected $0.20 from pot
SantiagoWeight: doesn't show hand 
*** SUMMARY ***
Total pot $0.20 | Rake $0 
Seat 1: ryanking99 (button) folded before Flop (didn't bet)
Seat 2: SeniorInv (small blind) folded before Flop
Seat 3: SantiagoWeight (big blind) collected ($0.20)
Seat 4: ckriszee folded before Flop (didn't bet)
Seat 5: BMB8888 folded before Flop (didn't bet)
Seat 6: benddo folded before Flop (didn't bet)



PokerStars Zoom Hand #195022765064:  Hold'em No Limit ($0.10/$0.25) - 2018/12/29 3:07:18 UTC [2018/12/28 22:07:18 ET]
Table 'Hydra' 6-max Seat #1 is the button
Seat 1: zdenekstavic ($25.96 in chips) 
Seat 2: SantiagoWeight ($49.98 in chips) 
Seat 3: tightpokerAA ($36.14 in chips) 
Seat 4: Chrimmpam ($23.29 in chips) 
Seat 5: benddo ($54.23 in chips) 
Seat 6: donmarc777 ($33.76 in chips) 
SantiagoWeight: posts small blind $0.10
tightpokerAA: posts big blind $0.25
*** HOLE CARDS ***
Dealt to SantiagoWeight [2h Qs]
Chrimmpam: folds 
benddo: folds 
donmarc777: raises $0.25 to $0.50
zdenekstavic: folds 
SantiagoWeight: folds 
tightpokerAA: calls $0.25
*** FLOP *** [Qd 4d 6c]
tightpokerAA: checks 
donmarc777: bets $0.50
tightpokerAA: calls $0.50
*** TURN *** [Qd 4d 6c] [9c]
tightpokerAA: checks 
donmarc777: checks 
*** RIVER *** [Qd 4d 6c 9c] [5d]
tightpokerAA: bets $1.25
donmarc777: calls $1.25
*** SHOW DOWN ***
tightpokerAA: shows [4s 4h] (three of a kind, Fours)
donmarc777: mucks hand 
tightpokerAA collected $4.39 from pot
*** SUMMARY ***
Total pot $4.60 | Rake $0.21 
Board [Qd 4d 6c 9c 5d]
Seat 1: zdenekstavic (button) folded before Flop (didn't bet)
Seat 2: SantiagoWeight (small blind) folded before Flop
Seat 3: tightpokerAA (big blind) showed [4s 4h] and won ($4.39) with three of a kind, Fours
Seat 4: Chrimmpam folded before Flop (didn't bet)
Seat 5: benddo folded before Flop (didn't bet)
Seat 6: donmarc777 mucked [As 6s]



PokerStars Zoom Hand #195022771859:  Hold'em No Limit ($0.10/$0.25) - 2018/12/29 3:07:36 UTC [2018/12/28 22:07:36 ET]
Table 'Hydra' 6-max Seat #1 is the button
Seat 1: SantiagoWeight ($49.88 in chips) 
Seat 2: ujustgotpawned ($33.09 in chips) 
Seat 3: samioattila ($33.25 in chips) 
Seat 4: ckriszee ($29.69 in chips) 
Seat 5: Rollout2018 ($12.83 in chips) 
Seat 6: reggiedogg31 ($111.39 in chips) 
ujustgotpawned: posts small blind $0.10
samioattila: posts big blind $0.25
*** HOLE CARDS ***
Dealt to SantiagoWeight [Jh 8s]
ckriszee: folds 
Rollout2018: folds 
reggiedogg31: raises $0.50 to $0.75
SantiagoWeight: folds 
ujustgotpawned: calls $0.65
samioattila: folds 
*** FLOP *** [6c As 7d]
ujustgotpawned: bets $0.50
reggiedogg31: calls $0.50
*** TURN *** [6c As 7d] [6s]
ujustgotpawned: bets $0.25
reggiedogg31: calls $0.25
*** RIVER *** [6c As 7d 6s] [Jd]
ujustgotpawned: bets $0.25
reggiedogg31: calls $0.25
*** SHOW DOWN ***
ujustgotpawned: shows [8h 7h] (two pair, Sevens and Sixes)
reggiedogg31: shows [Kh Ks] (two pair, Kings and Sixes)
reggiedogg31 collected $3.58 from pot
*** SUMMARY ***
Total pot $3.75 | Rake $0.17 
Board [6c As 7d 6s Jd]
Seat 1: SantiagoWeight (button) folded before Flop (didn't bet)
Seat 2: ujustgotpawned (small blind) showed [8h 7h] and lost with two pair, Sevens and Sixes
Seat 3: samioattila (big blind) folded before Flop
Seat 4: ckriszee folded before Flop (didn't bet)
Seat 5: Rollout2018 folded before Flop (didn't bet)
Seat 6: reggiedogg31 showed [Kh Ks] and won ($3.58) with two pair, Kings and Sixes



PokerStars Zoom Hand #195022781210:  Hold'em No Limit ($0.10/$0.25) - 2018/12/29 3:08:02 UTC [2018/12/28 22:08:02 ET]
Table 'Hydra' 6-max Seat #1 is the button
Seat 1: Lehared ($77.57 in chips) 
Seat 2: nhanminhtri ($32.36 in chips) 
Seat 3: SirSatan001 ($44.42 in chips) 
Seat 4: samioattila ($49.72 in chips) 
Seat 5: Meulenn89 ($27.51 in chips) 
Seat 6: SantiagoWeight ($49.98 in chips) 
nhanminhtri: posts small blind $0.10
SirSatan001: posts big blind $0.25
*** HOLE CARDS ***
Dealt to SantiagoWeight [Qs 8h]
samioattila: folds 
Meulenn89: folds 
SantiagoWeight: raises $0.30 to $0.55
Lehared: folds 
nhanminhtri: folds 
SirSatan001: folds 
Uncalled bet ($0.30) returned to SantiagoWeight
SantiagoWeight collected $0.60 from pot
SantiagoWeight: doesn't show hand 
*** SUMMARY ***
Total pot $0.60 | Rake $0 
Seat 1: Lehared (button) folded before Flop (didn't bet)
Seat 2: nhanminhtri (small blind) folded before Flop
Seat 3: SirSatan001 (big blind) folded before Flop
Seat 4: samioattila folded before Flop (didn't bet)
Seat 5: Meulenn89 folded before Flop (didn't bet)
Seat 6: SantiagoWeight collected ($0.60)



PokerStars Zoom Hand #195022785486:  Hold'em No Limit ($0.10/$0.25) - 2018/12/29 3:08:15 UTC [2018/12/28 22:08:15 ET]
Table 'Hydra' 6-max Seat #1 is the button
Seat 1: mayadelrey ($21.05 in chips) 
Seat 2: HansMSM ($43.26 in chips) 
Seat 3: Dbakunwaves ($89.18 in chips) 
Seat 4: sigaro010 ($53.89 in chips) 
Seat 5: SantiagoWeight ($50.33 in chips) 
Seat 6: gamoniusz ($44.75 in chips) 
HansMSM: posts small blind $0.10
Dbakunwaves: posts big blind $0.25
*** HOLE CARDS ***
Dealt to SantiagoWeight [5d Tc]
sigaro010: folds 
SantiagoWeight: folds 
gamoniusz: folds 
mayadelrey: raises $0.50 to $0.75
HansMSM: folds 
Dbakunwaves: calls $0.50
*** FLOP *** [As 7h Ts]
Dbakunwaves: checks 
mayadelrey: bets $1.50
Dbakunwaves: folds 
Uncalled bet ($1.50) returned to mayadelrey
mayadelrey collected $1.53 from pot
mayadelrey: doesn't show hand 
*** SUMMARY ***
Total pot $1.60 | Rake $0.07 
Board [As 7h Ts]
Seat 1: mayadelrey (button) collected ($1.53)
Seat 2: HansMSM (small blind) folded before Flop
Seat 3: Dbakunwaves (big blind) folded on the Flop
Seat 4: sigaro010 folded before Flop (didn't bet)
Seat 5: SantiagoWeight folded before Flop (didn't bet)
Seat 6: gamoniusz folded before Flop (didn't bet)



PokerStars Zoom Hand #195022790102:  Hold'em No Limit ($0.10/$0.25) - 2018/12/29 3:08:28 UTC [2018/12/28 22:08:28 ET]
Table 'Hydra' 6-max Seat #1 is the button
Seat 1: Gf Chipz ($17.95 in chips) 
Seat 2: SantiagoWeight ($50.33 in chips) 
Seat 3: benddo ($54.58 in chips) 
Seat 4: Akkana ($21.60 in chips) 
Seat 5: GrandmasterY ($27.92 in chips) 
Seat 6: tightpokerAA ($32.99 in chips) 
SantiagoWeight: posts small blind $0.10
benddo: posts big blind $0.25
*** HOLE CARDS ***
Dealt to SantiagoWeight [Jh Ac]
Akkana: folds 
GrandmasterY: folds 
tightpokerAA: folds 
Gf Chipz: folds 
SantiagoWeight: raises $0.50 to $0.75
benddo: calls $0.50
*** FLOP *** [3h 6h Jc]
SantiagoWeight: bets $0.95
benddo: calls $0.95
*** TURN *** [3h 6h Jc] [7d]
SantiagoWeight: bets $3
benddo: calls $3
*** RIVER *** [3h 6h Jc 7d] [5c]
SantiagoWeight: checks 
benddo: checks 
*** SHOW DOWN ***
SantiagoWeight: shows [Jh Ac] (a pair of Jacks)
benddo: mucks hand 
SantiagoWeight collected $8.98 from pot
*** SUMMARY ***
Total pot $9.40 | Rake $0.42 
Board [3h 6h Jc 7d 5c]
Seat 1: Gf Chipz (button) folded before Flop (didn't bet)
Seat 2: SantiagoWeight (small blind) showed [Jh Ac] and won ($8.98) with a pair of Jacks
Seat 3: benddo (big blind) mucked [Ts Jd]
Seat 4: Akkana folded before Flop (didn't bet)
Seat 5: GrandmasterY folded before Flop (didn't bet)
Seat 6: tightpokerAA folded before Flop (didn't bet)



PokerStars Zoom Hand #195022824771:  Hold'em No Limit ($0.10/$0.25) - 2018/12/29 3:10:04 UTC [2018/12/28 22:10:04 ET]
Table 'Hydra' 6-max Seat #1 is the button
Seat 1: Nutselas ($29.53 in chips) 
Seat 2: reggiedogg31 ($112.02 in chips) 
Seat 3: SantiagoWeight ($54.61 in chips) 
Seat 4: Rollout2018 ($13.24 in chips) 
Seat 5: naxizzle ($127.18 in chips) 
Seat 6: zbuci ($42 in chips) 
reggiedogg31: posts small blind $0.10
SantiagoWeight: posts big blind $0.25
*** HOLE CARDS ***
Dealt to SantiagoWeight [Kd Ac]
Rollout2018: folds 
naxizzle: calls $0.25
zbuci: calls $0.25
Nutselas: folds 
reggiedogg31: calls $0.15
SantiagoWeight: raises $1.55 to $1.80
naxizzle: folds 
zbuci: folds 
reggiedogg31: folds 
Uncalled bet ($1.55) returned to SantiagoWeight
SantiagoWeight collected $1 from pot
SantiagoWeight: doesn't show hand 
*** SUMMARY ***
Total pot $1 | Rake $0 
Seat 1: Nutselas (button) folded before Flop (didn't bet)
Seat 2: reggiedogg31 (small blind) folded before Flop
Seat 3: SantiagoWeight (big blind) collected ($1)
Seat 4: Rollout2018 folded before Flop (didn't bet)
Seat 5: naxizzle folded before Flop
Seat 6: zbuci folded before Flop



PokerStars Zoom Hand #195022836859:  Hold'em No Limit ($0.10/$0.25) - 2018/12/29 3:10:38 UTC [2018/12/28 22:10:38 ET]
Table 'Hydra' 6-max Seat #1 is the button
Seat 1: armandopinga ($148.01 in chips) 
Seat 2: djambat ($24.37 in chips) 
Seat 3: MISTAAJ ($38.35 in chips) 
Seat 4: SantiagoWeight ($55.36 in chips) 
Seat 5: zbuci ($41.75 in chips) 
Seat 6: SirSatan001 ($39.25 in chips) 
djambat: posts small blind $0.10
MISTAAJ: posts big blind $0.25
*** HOLE CARDS ***
Dealt to SantiagoWeight [Kd Qd]
SantiagoWeight: raises $0.42 to $0.67
zbuci: folds 
SirSatan001: calls $0.67
armandopinga: calls $0.67
djambat: folds 
MISTAAJ: folds 
*** FLOP *** [Kh 6d 7d]
SantiagoWeight: bets $1.50
SirSatan001: calls $1.50
armandopinga: calls $1.50
*** TURN *** [Kh 6d 7d] [Jh]
SantiagoWeight: bets $7.86
SirSatan001: raises $7.86 to $15.72
armandopinga: raises $130.12 to $145.84 and is all-in
SantiagoWeight: calls $45.33 and is all-in
SirSatan001: calls $21.36 and is all-in
Uncalled bet ($92.65) returned to armandopinga
*** RIVER *** [Kh 6d 7d Jh] [Jc]
*** SHOW DOWN ***
SantiagoWeight: shows [Kd Qd] (two pair, Kings and Jacks)
armandopinga: shows [7h 7s] (a full house, Sevens full of Jacks)
armandopinga collected $32.22 from side pot
SirSatan001: shows [Jd Ks] (a full house, Jacks full of Kings)
SirSatan001 collected $116.10 from main pot
*** SUMMARY ***
Total pot $150.32 Main pot $116.10. Side pot $32.22. | Rake $2 
Board [Kh 6d 7d Jh Jc]
Seat 1: armandopinga (button) showed [7h 7s] and won ($32.22) with a full house, Sevens full of Jacks
Seat 2: djambat (small blind) folded before Flop
Seat 3: MISTAAJ (big blind) folded before Flop
Seat 4: SantiagoWeight showed [Kd Qd] and lost with two pair, Kings and Jacks
Seat 5: zbuci folded before Flop (didn't bet)
Seat 6: SirSatan001 showed [Jd Ks] and won ($116.10) with a full house, Jacks full of Kings



PokerStars Zoom Hand #195022872426:  Hold'em No Limit ($0.10/$0.25) - 2018/12/29 3:12:19 UTC [2018/12/28 22:12:19 ET]
Table 'Hydra' 6-max Seat #1 is the button
Seat 1: nhanminhtri ($36.56 in chips) 
Seat 2: SantiagoWeight ($25 in chips) 
Seat 3: yobbos ($53.33 in chips) 
Seat 4: zbuci ($40.55 in chips) 
Seat 5: osa126 ($30.09 in chips) 
Seat 6: benddo ($108.75 in chips) 
SantiagoWeight: posts small blind $0.10
yobbos: posts big blind $0.25
*** HOLE CARDS ***
Dealt to SantiagoWeight [8h 5d]
zbuci: folds 
osa126: folds 
benddo: folds 
nhanminhtri: folds 
SantiagoWeight: folds 
Uncalled bet ($0.15) returned to yobbos
yobbos collected $0.20 from pot
yobbos: doesn't show hand 
*** SUMMARY ***
Total pot $0.20 | Rake $0 
Seat 1: nhanminhtri (button) folded before Flop (didn't bet)
Seat 2: SantiagoWeight (small blind) folded before Flop
Seat 3: yobbos (big blind) collected ($0.20)
Seat 4: zbuci folded before Flop (didn't bet)
Seat 5: osa126 folded before Flop (didn't bet)
Seat 6: benddo folded before Flop (didn't bet)



PokerStars Zoom Hand #195022875950:  Hold'em No Limit ($0.10/$0.25) - 2018/12/29 3:12:29 UTC [2018/12/28 22:12:29 ET]
Table 'Hydra' 6-max Seat #1 is the button
Seat 1: Rollout2018 ($11.04 in chips) 
Seat 2: Lehared ($110.41 in chips) 
Seat 3: Parsam5 ($66.41 in chips) 
Seat 4: negreanuNya ($25 in chips) 
Seat 5: Xp0Hb ($26.16 in chips) 
Seat 6: SantiagoWeight ($24.90 in chips) 
Lehared: posts small blind $0.10
Parsam5: posts big blind $0.25
*** HOLE CARDS ***
Dealt to SantiagoWeight [6c 5s]
negreanuNya: folds 
Xp0Hb: folds 
SantiagoWeight: folds 
Rollout2018: folds 
Lehared: raises $0.50 to $0.75
Parsam5: folds 
Uncalled bet ($0.50) returned to Lehared
Lehared collected $0.50 from pot
Lehared: doesn't show hand 
*** SUMMARY ***
Total pot $0.50 | Rake $0 
Seat 1: Rollout2018 (button) folded before Flop (didn't bet)
Seat 2: Lehared (small blind) collected ($0.50)
Seat 3: Parsam5 (big blind) folded before Flop
Seat 4: negreanuNya folded before Flop (didn't bet)
Seat 5: Xp0Hb folded before Flop (didn't bet)
Seat 6: SantiagoWeight folded before Flop (didn't bet)



PokerStars Zoom Hand #195022878801:  Hold'em No Limit ($0.10/$0.25) - 2018/12/29 3:12:37 UTC [2018/12/28 22:12:37 ET]
Table 'Hydra' 6-max Seat #1 is the button
Seat 1: SantiagoWeight ($24.90 in chips) 
Seat 2: tightpokerAA ($29.35 in chips) 
Seat 3: stavro88 ($27.48 in chips) 
Seat 4: Gf Chipz ($16.40 in chips) 
Seat 5: cankum ($53.03 in chips) 
Seat 6: nhanminhtri ($36.46 in chips) 
tightpokerAA: posts small blind $0.10
stavro88: posts big blind $0.25
*** HOLE CARDS ***
Dealt to SantiagoWeight [7h 9d]
Gf Chipz: folds 
cankum: folds 
nhanminhtri: raises $0.37 to $0.62
SantiagoWeight: folds 
tightpokerAA: folds 
stavro88: calls $0.37
*** FLOP *** [7s 7c 7d]
stavro88: checks 
nhanminhtri: bets $0.75
stavro88: calls $0.75
*** TURN *** [7s 7c 7d] [Qc]
stavro88: checks 
nhanminhtri: checks 
*** RIVER *** [7s 7c 7d Qc] [2c]
stavro88: bets $2.75
nhanminhtri: calls $2.75
*** SHOW DOWN ***
stavro88: shows [Jd Ac] (three of a kind, Sevens)
nhanminhtri: shows [Qs Js] (a full house, Sevens full of Queens)
nhanminhtri collected $7.96 from pot
*** SUMMARY ***
Total pot $8.34 | Rake $0.38 
Board [7s 7c 7d Qc 2c]
Seat 1: SantiagoWeight (button) folded before Flop (didn't bet)
Seat 2: tightpokerAA (small blind) folded before Flop
Seat 3: stavro88 (big blind) showed [Jd Ac] and lost with three of a kind, Sevens
Seat 4: Gf Chipz folded before Flop (didn't bet)
Seat 5: cankum folded before Flop (didn't bet)
Seat 6: nhanminhtri showed [Qs Js] and won ($7.96) with a full house, Sevens full of Queens



PokerStars Zoom Hand #195022881983:  Hold'em No Limit ($0.10/$0.25) - 2018/12/29 3:12:47 UTC [2018/12/28 22:12:47 ET]
Table 'Hydra' 6-max Seat #1 is the button
Seat 1: negreanuNya ($31.81 in chips) 
Seat 2: Akkana ($11.06 in chips) 
Seat 3: SantiagoWeight ($24.90 in chips) 
Seat 4: Basebob ($25.99 in chips) 
Seat 5: MileVoliD49 ($59.76 in chips) 
Seat 6: yobbos ($126.67 in chips) 
Akkana: posts small blind $0.10
SantiagoWeight: posts big blind $0.25
*** HOLE CARDS ***
Dealt to SantiagoWeight [8s 6c]
Basebob: folds 
MileVoliD49: folds 
yobbos: folds 
negreanuNya: raises $0.35 to $0.60
Akkana: folds 
SantiagoWeight: folds 
Uncalled bet ($0.35) returned to negreanuNya
negreanuNya collected $0.60 from pot
negreanuNya: doesn't show hand 
*** SUMMARY ***
Total pot $0.60 | Rake $0 
Seat 1: negreanuNya (button) collected ($0.60)
Seat 2: Akkana (small blind) folded before Flop
Seat 3: SantiagoWeight (big blind) folded before Flop
Seat 4: Basebob folded before Flop (didn't bet)
Seat 5: MileVoliD49 folded before Flop (didn't bet)
Seat 6: yobbos folded before Flop (didn't bet)



PokerStars Zoom Hand #195022891833:  Hold'em No Limit ($0.10/$0.25) - 2018/12/29 3:13:15 UTC [2018/12/28 22:13:15 ET]
Table 'Hydra' 6-max Seat #1 is the button
Seat 1: BnanaBread13 ($26.09 in chips) 
Seat 2: Akkana ($10.96 in chips) 
Seat 3: jamma8631 ($22.66 in chips) 
Seat 4: benddo ($48.36 in chips) 
Seat 5: SantiagoWeight ($24.65 in chips) 
Seat 6: nadal335 ($24.68 in chips) 
Akkana: posts small blind $0.10
jamma8631: posts big blind $0.25
*** HOLE CARDS ***
Dealt to SantiagoWeight [4h 4c]
benddo: folds 
SantiagoWeight: raises $0.37 to $0.62
nadal335: folds 
BnanaBread13: folds 
Akkana: folds 
jamma8631: calls $0.37
*** FLOP *** [5s 3h Ad]
jamma8631: checks 
SantiagoWeight: bets $0.32
jamma8631: calls $0.32
*** TURN *** [5s 3h Ad] [7s]
jamma8631: checks 
SantiagoWeight: bets $2.27
jamma8631: calls $2.27
*** RIVER *** [5s 3h Ad 7s] [2s]
jamma8631: checks 
SantiagoWeight: bets $21.44 and is all-in
jamma8631: folds 
Uncalled bet ($21.44) returned to SantiagoWeight
SantiagoWeight collected $6.23 from pot
SantiagoWeight: doesn't show hand 
*** SUMMARY ***
Total pot $6.52 | Rake $0.29 
Board [5s 3h Ad 7s 2s]
Seat 1: BnanaBread13 (button) folded before Flop (didn't bet)
Seat 2: Akkana (small blind) folded before Flop
Seat 3: jamma8631 (big blind) folded on the River
Seat 4: benddo folded before Flop (didn't bet)
Seat 5: SantiagoWeight collected ($6.23)
Seat 6: nadal335 folded before Flop (didn't bet)



PokerStars Zoom Hand #195022916190:  Hold'em No Limit ($0.10/$0.25) - 2018/12/29 3:14:23 UTC [2018/12/28 22:14:23 ET]
Table 'Hydra' 6-max Seat #1 is the button
Seat 1: SantiagoWeight ($27.67 in chips) 
Seat 2: nadal335 ($20.74 in chips) 
Seat 3: Baboscrubx ($35.43 in chips) 
Seat 4: Lehared ($65.52 in chips) 
Seat 5: Slim Wolfie ($36.80 in chips) 
Seat 6: Sirfredulrik ($26.72 in chips) 
nadal335: posts small blind $0.10
Baboscrubx: posts big blind $0.25
*** HOLE CARDS ***
Dealt to SantiagoWeight [6s 4s]
Lehared: folds 
Slim Wolfie: raises $0.37 to $0.62
Sirfredulrik: folds 
SantiagoWeight: folds 
nadal335: folds 
Baboscrubx: folds 
Uncalled bet ($0.37) returned to Slim Wolfie
Slim Wolfie collected $0.60 from pot
Slim Wolfie: doesn't show hand 
*** SUMMARY ***
Total pot $0.60 | Rake $0 
Seat 1: SantiagoWeight (button) folded before Flop (didn't bet)
Seat 2: nadal335 (small blind) folded before Flop
Seat 3: Baboscrubx (big blind) folded before Flop
Seat 4: Lehared folded before Flop (didn't bet)
Seat 5: Slim Wolfie collected ($0.60)
Seat 6: Sirfredulrik folded before Flop (didn't bet)



PokerStars Zoom Hand #195022914745:  Hold'em No Limit ($0.10/$0.25) - 2018/12/29 3:14:19 UTC [2018/12/28 22:14:19 ET]
Table 'Hydra' 6-max Seat #1 is the button
Seat 1: Lehared ($52.76 in chips) 
Seat 2: BnanaBread13 ($25.09 in chips) 
Seat 3: mariopork ($34.70 in chips) 
Seat 4: TQNYMQNTANA ($26.27 in chips) 
Seat 5: SantiagoWeight ($27.67 in chips) 
Seat 6: Akkana ($10.61 in chips) 
BnanaBread13: posts small blind $0.10
mariopork: posts big blind $0.25
*** HOLE CARDS ***
Dealt to SantiagoWeight [Qs 7d]
TQNYMQNTANA: folds 
SantiagoWeight: folds 
Akkana: raises $0.25 to $0.50
Lehared: folds 
BnanaBread13: raises $1.75 to $2.25
mariopork: folds 
Akkana: calls $1.75
*** FLOP *** [8d Jh Ad]
BnanaBread13: bets $3
Akkana: calls $3
*** TURN *** [8d Jh Ad] [3d]
BnanaBread13: checks 
Akkana: bets $5.36 and is all-in
BnanaBread13: calls $5.36
*** RIVER *** [8d Jh Ad 3d] [5d]
*** SHOW DOWN ***
BnanaBread13: shows [Td Kd] (a flush, Ace high)
Akkana: shows [Ah Th] (a pair of Aces)
BnanaBread13 collected $20.50 from pot
*** SUMMARY ***
Total pot $21.47 | Rake $0.97 
Board [8d Jh Ad 3d 5d]
Seat 1: Lehared (button) folded before Flop (didn't bet)
Seat 2: BnanaBread13 (small blind) showed [Td Kd] and won ($20.50) with a flush, Ace high
Seat 3: mariopork (big blind) folded before Flop
Seat 4: TQNYMQNTANA folded before Flop (didn't bet)
Seat 5: SantiagoWeight folded before Flop (didn't bet)
Seat 6: Akkana showed [Ah Th] and lost with a pair of Aces



PokerStars Zoom Hand #195022922493:  Hold'em No Limit ($0.10/$0.25) - 2018/12/29 3:14:42 UTC [2018/12/28 22:14:42 ET]
Table 'Hydra' 6-max Seat #1 is the button
Seat 1: Bujan 07 ($23.81 in chips) 
Seat 2: stavro88 ($26.29 in chips) 
Seat 3: SantiagoWeight ($27.67 in chips) 
Seat 4: gift-cloud9 ($25.10 in chips) 
Seat 5: Lehared ($65.27 in chips) 
Seat 6: PITS316 ($24.65 in chips) 
stavro88: posts small blind $0.10
SantiagoWeight: posts big blind $0.25
*** HOLE CARDS ***
Dealt to SantiagoWeight [2h 8d]
gift-cloud9: folds 
Lehared: raises $0.37 to $0.62
PITS316: folds 
Bujan 07: folds 
stavro88: folds 
SantiagoWeight: folds 
Uncalled bet ($0.37) returned to Lehared
Lehared collected $0.60 from pot
Lehared: doesn't show hand 
*** SUMMARY ***
Total pot $0.60 | Rake $0 
Seat 1: Bujan 07 (button) folded before Flop (didn't bet)
Seat 2: stavro88 (small blind) folded before Flop
Seat 3: SantiagoWeight (big blind) folded before Flop
Seat 4: gift-cloud9 folded before Flop (didn't bet)
Seat 5: Lehared collected ($0.60)
Seat 6: PITS316 folded before Flop (didn't bet)



PokerStars Zoom Hand #195022919299:  Hold'em No Limit ($0.10/$0.25) - 2018/12/29 3:14:32 UTC [2018/12/28 22:14:32 ET]
Table 'Hydra' 6-max Seat #1 is the button
Seat 1: aa1421b ($32.69 in chips) 
Seat 2: Lehared ($112.01 in chips) 
Seat 3: !P0K3RM3T4L! ($27.36 in chips) 
Seat 4: nhanminhtri ($38.05 in chips) 
Seat 5: assassin0875 ($191.77 in chips) 
Seat 6: SantiagoWeight ($27.67 in chips) 
Lehared: posts small blind $0.10
!P0K3RM3T4L!: posts big blind $0.25
*** HOLE CARDS ***
Dealt to SantiagoWeight [2c Ks]
nhanminhtri: raises $0.50 to $0.75
assassin0875: folds 
SantiagoWeight: folds 
aa1421b: folds 
Lehared: folds 
!P0K3RM3T4L!: calls $0.50
*** FLOP *** [6d Js Jc]
!P0K3RM3T4L!: checks 
nhanminhtri: bets $0.84
!P0K3RM3T4L!: folds 
Uncalled bet ($0.84) returned to nhanminhtri
nhanminhtri collected $1.53 from pot
nhanminhtri: doesn't show hand 
*** SUMMARY ***
Total pot $1.60 | Rake $0.07 
Board [6d Js Jc]
Seat 1: aa1421b (button) folded before Flop (didn't bet)
Seat 2: Lehared (small blind) folded before Flop
Seat 3: !P0K3RM3T4L! (big blind) folded on the Flop
Seat 4: nhanminhtri collected ($1.53)
Seat 5: assassin0875 folded before Flop (didn't bet)
Seat 6: SantiagoWeight folded before Flop (didn't bet)



PokerStars Zoom Hand #195022932051:  Hold'em No Limit ($0.10/$0.25) - 2018/12/29 3:15:08 UTC [2018/12/28 22:15:08 ET]
Table 'Hydra' 6-max Seat #1 is the button
Seat 1: franco373513 ($12.80 in chips) 
Seat 2: G ster24 ($38.51 in chips) 
Seat 3: Parsam5 ($64.36 in chips) 
Seat 4: Nutselas ($25 in chips) 
Seat 5: SantiagoWeight ($27.32 in chips) 
Seat 6: negreanuNya ($25 in chips) 
G ster24: posts small blind $0.10
Parsam5: posts big blind $0.25
*** HOLE CARDS ***
Dealt to SantiagoWeight [8c Qs]
Nutselas: folds 
SantiagoWeight: folds 
negreanuNya: folds 
franco373513: folds 
G ster24: folds 
Uncalled bet ($0.15) returned to Parsam5
Parsam5 collected $0.20 from pot
Parsam5: doesn't show hand 
*** SUMMARY ***
Total pot $0.20 | Rake $0 
Seat 1: franco373513 (button) folded before Flop (didn't bet)
Seat 2: G ster24 (small blind) folded before Flop
Seat 3: Parsam5 (big blind) collected ($0.20)
Seat 4: Nutselas folded before Flop (didn't bet)
Seat 5: SantiagoWeight folded before Flop (didn't bet)
Seat 6: negreanuNya folded before Flop (didn't bet)



PokerStars Zoom Hand #195022929996:  Hold'em No Limit ($0.10/$0.25) - 2018/12/29 3:15:02 UTC [2018/12/28 22:15:02 ET]
Table 'Hydra' 6-max Seat #1 is the button
Seat 1: river plate9 ($24 in chips) 
Seat 2: SantiagoWeight ($27.42 in chips) 
Seat 3: Akkana ($10.28 in chips) 
Seat 4: Lehared ($65.62 in chips) 
Seat 5: BnanaBread13 ($25 in chips) 
Seat 6: seba6688 ($12.16 in chips) 
SantiagoWeight: posts small blind $0.10
Akkana: posts big blind $0.25
*** HOLE CARDS ***
Dealt to SantiagoWeight [3d Qh]
Lehared: folds 
BnanaBread13: folds 
seba6688: folds 
river plate9: raises $0.25 to $0.50
SantiagoWeight: folds 
Akkana: folds 
Uncalled bet ($0.25) returned to river plate9
river plate9 collected $0.60 from pot
river plate9: doesn't show hand 
*** SUMMARY ***
Total pot $0.60 | Rake $0 
Seat 1: river plate9 (button) collected ($0.60)
Seat 2: SantiagoWeight (small blind) folded before Flop
Seat 3: Akkana (big blind) folded before Flop
Seat 4: Lehared folded before Flop (didn't bet)
Seat 5: BnanaBread13 folded before Flop (didn't bet)
Seat 6: seba6688 folded before Flop (didn't bet)



PokerStars Zoom Hand #195022933786:  Hold'em No Limit ($0.10/$0.25) - 2018/12/29 3:15:14 UTC [2018/12/28 22:15:14 ET]
Table 'Hydra' 6-max Seat #1 is the button
Seat 1: CAPTAINSKA ($29.92 in chips) 
Seat 2: Sirfredulrik ($26.37 in chips) 
Seat 3: gingdog ($11.44 in chips) 
Seat 4: ivann14 ($86.32 in chips) 
Seat 5: Paasinha ($26.27 in chips) 
Seat 6: SantiagoWeight ($27.32 in chips) 
Sirfredulrik: posts small blind $0.10
gingdog: posts big blind $0.25
*** HOLE CARDS ***
Dealt to SantiagoWeight [7h Ts]
ivann14: folds 
Paasinha: raises $0.75 to $1
SantiagoWeight: folds 
CAPTAINSKA: calls $1
Sirfredulrik: folds 
gingdog: calls $0.75
*** FLOP *** [Jc Kh 2d]
gingdog: checks 
Paasinha: bets $1.33
CAPTAINSKA: folds 
gingdog: folds 
Uncalled bet ($1.33) returned to Paasinha
Paasinha collected $2.96 from pot
Paasinha: doesn't show hand 
*** SUMMARY ***
Total pot $3.10 | Rake $0.14 
Board [Jc Kh 2d]
Seat 1: CAPTAINSKA (button) folded on the Flop
Seat 2: Sirfredulrik (small blind) folded before Flop
Seat 3: gingdog (big blind) folded on the Flop
Seat 4: ivann14 folded before Flop (didn't bet)
Seat 5: Paasinha collected ($2.96)
Seat 6: SantiagoWeight folded before Flop (didn't bet)



PokerStars Zoom Hand #195022938957:  Hold'em No Limit ($0.10/$0.25) - 2018/12/29 3:15:28 UTC [2018/12/28 22:15:28 ET]
Table 'Hydra' 6-max Seat #1 is the button
Seat 1: nadal335 ($31.45 in chips) 
Seat 2: jeffwalker23 ($42.44 in chips) 
Seat 3: jfgodtheg ($36.13 in chips) 
Seat 4: SantiagoWeight ($27.32 in chips) 
Seat 5: petanquemeis ($31.05 in chips) 
Seat 6: Baboscrubx ($31.76 in chips) 
jeffwalker23: posts small blind $0.10
jfgodtheg: posts big blind $0.25
*** HOLE CARDS ***
Dealt to SantiagoWeight [5s Jc]
SantiagoWeight: folds 
petanquemeis: folds 
Baboscrubx: folds 
nadal335: folds 
jeffwalker23: folds 
Uncalled bet ($0.15) returned to jfgodtheg
jfgodtheg collected $0.20 from pot
jfgodtheg: doesn't show hand 
*** SUMMARY ***
Total pot $0.20 | Rake $0 
Seat 1: nadal335 (button) folded before Flop (didn't bet)
Seat 2: jeffwalker23 (small blind) folded before Flop
Seat 3: jfgodtheg (big blind) collected ($0.20)
Seat 4: SantiagoWeight folded before Flop (didn't bet)
Seat 5: petanquemeis folded before Flop (didn't bet)
Seat 6: Baboscrubx folded before Flop (didn't bet)



PokerStars Zoom Hand #195022937228:  Hold'em No Limit ($0.10/$0.25) - 2018/12/29 3:15:24 UTC [2018/12/28 22:15:24 ET]
Table 'Hydra' 6-max Seat #1 is the button
Seat 1: Nutselas ($28.44 in chips) 
Seat 2: TQNYMQNTANA ($25.52 in chips) 
Seat 3: Josip1119 ($20 in chips) 
Seat 4: SantiagoWeight ($27.32 in chips) 
Seat 5: mistdog ($29.45 in chips) 
Seat 6: will82777 ($32.08 in chips) 
TQNYMQNTANA: posts small blind $0.10
Josip1119: posts big blind $0.25
*** HOLE CARDS ***
Dealt to SantiagoWeight [7s 6s]
SantiagoWeight: folds 
mistdog: folds 
will82777: raises $0.37 to $0.62
Nutselas: folds 
TQNYMQNTANA: folds 
Josip1119: raises $0.71 to $1.33
will82777: calls $0.71
*** FLOP *** [As 7h 8s]
Josip1119: bets $1.40
will82777: calls $1.40
*** TURN *** [As 7h 8s] [5h]
Josip1119: bets $2.81
will82777: folds 
Uncalled bet ($2.81) returned to Josip1119
Josip1119 collected $5.31 from pot
Josip1119: doesn't show hand 
*** SUMMARY ***
Total pot $5.56 | Rake $0.25 
Board [As 7h 8s 5h]
Seat 1: Nutselas (button) folded before Flop (didn't bet)
Seat 2: TQNYMQNTANA (small blind) folded before Flop
Seat 3: Josip1119 (big blind) collected ($5.31)
Seat 4: SantiagoWeight folded before Flop (didn't bet)
Seat 5: mistdog folded before Flop (didn't bet)
Seat 6: will82777 folded on the Turn



PokerStars Zoom Hand #195022945726:  Hold'em No Limit ($0.10/$0.25) - 2018/12/29 3:15:47 UTC [2018/12/28 22:15:47 ET]
Table 'Hydra' 6-max Seat #1 is the button
Seat 1: SantiagoWeight ($27.32 in chips) 
Seat 2: anorectal ($55.85 in chips) 
Seat 3: djambat ($71.11 in chips) 
Seat 4: yobbos ($34.24 in chips) 
Seat 5: _BluDeeN_ ($41.17 in chips) 
Seat 6: mayadelrey ($22.96 in chips) 
anorectal: posts small blind $0.10
djambat: posts big blind $0.25
*** HOLE CARDS ***
Dealt to SantiagoWeight [9c As]
yobbos: raises $0.50 to $0.75
_BluDeeN_: folds 
mayadelrey: raises $0.75 to $1.50
SantiagoWeight: folds 
anorectal: folds 
djambat: folds 
yobbos: calls $0.75
*** FLOP *** [3d 3c Kd]
yobbos: checks 
mayadelrey: checks 
*** TURN *** [3d 3c Kd] [2c]
yobbos: bets $1.09
mayadelrey: calls $1.09
*** RIVER *** [3d 3c Kd 2c] [8h]
yobbos: checks 
mayadelrey: bets $3.50
yobbos: folds 
Uncalled bet ($3.50) returned to mayadelrey
mayadelrey collected $5.28 from pot
mayadelrey: doesn't show hand 
*** SUMMARY ***
Total pot $5.53 | Rake $0.25 
Board [3d 3c Kd 2c 8h]
Seat 1: SantiagoWeight (button) folded before Flop (didn't bet)
Seat 2: anorectal (small blind) folded before Flop
Seat 3: djambat (big blind) folded before Flop
Seat 4: yobbos folded on the River
Seat 5: _BluDeeN_ folded before Flop (didn't bet)
Seat 6: mayadelrey collected ($5.28)



PokerStars Zoom Hand #195022953349:  Hold'em No Limit ($0.10/$0.25) - 2018/12/29 3:16:09 UTC [2018/12/28 22:16:09 ET]
Table 'Hydra' 6-max Seat #1 is the button
Seat 1: Ars_cube ($13.72 in chips) 
Seat 2: anorectal ($47.64 in chips) 
Seat 3: SantiagoWeight ($27.32 in chips) 
Seat 4: TQNYMQNTANA ($79.31 in chips) 
Seat 5: franco373513 ($15.54 in chips) 
Seat 6: miru877 ($24.65 in chips) 
anorectal: posts small blind $0.10
SantiagoWeight: posts big blind $0.25
*** HOLE CARDS ***
Dealt to SantiagoWeight [Qd 9s]
TQNYMQNTANA: raises $0.50 to $0.75
franco373513: folds 
miru877: folds 
Ars_cube: calls $0.75
anorectal: folds 
SantiagoWeight: folds 
*** FLOP *** [Js Tc 2h]
TQNYMQNTANA: checks 
Ars_cube: bets $1.25
TQNYMQNTANA: calls $1.25
*** TURN *** [Js Tc 2h] [7d]
TQNYMQNTANA: checks 
Ars_cube: bets $2.25
TQNYMQNTANA: calls $2.25
*** RIVER *** [Js Tc 2h 7d] [Kh]
TQNYMQNTANA: bets $4.50
Ars_cube: raises $4.97 to $9.47 and is all-in
TQNYMQNTANA: calls $4.97
*** SHOW DOWN ***
Ars_cube: shows [Kd Jc] (two pair, Kings and Jacks)
TQNYMQNTANA: shows [Ts Th] (three of a kind, Tens)
TQNYMQNTANA collected $26.54 from pot
*** SUMMARY ***
Total pot $27.79 | Rake $1.25 
Board [Js Tc 2h 7d Kh]
Seat 1: Ars_cube (button) showed [Kd Jc] and lost with two pair, Kings and Jacks
Seat 2: anorectal (small blind) folded before Flop
Seat 3: SantiagoWeight (big blind) folded before Flop
Seat 4: TQNYMQNTANA showed [Ts Th] and won ($26.54) with three of a kind, Tens
Seat 5: franco373513 folded before Flop (didn't bet)
Seat 6: miru877 folded before Flop (didn't bet)



PokerStars Zoom Hand #195022956543:  Hold'em No Limit ($0.10/$0.25) - 2018/12/29 3:16:18 UTC [2018/12/28 22:16:18 ET]
Table 'Hydra' 6-max Seat #1 is the button
Seat 1: mariopork ($36.55 in chips) 
Seat 2: SantiagoWeight ($27.07 in chips) 
Seat 3: BirreteX ($25.25 in chips) 
Seat 4: TQNYMQNTANA ($25 in chips) 
Seat 5: negreanuNya ($25 in chips) 
Seat 6: moderi ($30.77 in chips) 
SantiagoWeight: posts small blind $0.10
BirreteX: posts big blind $0.25
*** HOLE CARDS ***
Dealt to SantiagoWeight [Kc 6d]
TQNYMQNTANA: folds 
negreanuNya: folds 
moderi: calls $0.25
mariopork: raises $0.75 to $1
SantiagoWeight: folds 
BirreteX: folds 
moderi: calls $0.75
*** FLOP *** [4h Th 2h]
moderi: checks 
mariopork: bets $0.74
moderi: folds 
Uncalled bet ($0.74) returned to mariopork
mariopork collected $2.24 from pot
mariopork: doesn't show hand 
*** SUMMARY ***
Total pot $2.35 | Rake $0.11 
Board [4h Th 2h]
Seat 1: mariopork (button) collected ($2.24)
Seat 2: SantiagoWeight (small blind) folded before Flop
Seat 3: BirreteX (big blind) folded before Flop
Seat 4: TQNYMQNTANA folded before Flop (didn't bet)
Seat 5: negreanuNya folded before Flop (didn't bet)
Seat 6: moderi folded on the Flop



PokerStars Zoom Hand #195022963960:  Hold'em No Limit ($0.10/$0.25) - 2018/12/29 3:16:40 UTC [2018/12/28 22:16:40 ET]
Table 'Hydra' 6-max Seat #1 is the button
Seat 1: donmarc777 ($27.09 in chips) 
Seat 2: PITS316 ($21.40 in chips) 
Seat 3: SeniorInv ($7.38 in chips) 
Seat 4: SantiagoWeight ($26.97 in chips) 
Seat 5: !P0K3RM3T4L! ($26.07 in chips) 
Seat 6: sZCzpNtheKot ($25 in chips) 
PITS316: posts small blind $0.10
SeniorInv: posts big blind $0.25
*** HOLE CARDS ***
Dealt to SantiagoWeight [5d Jh]
SantiagoWeight: folds 
!P0K3RM3T4L!: raises $0.35 to $0.60
sZCzpNtheKot: folds 
donmarc777: calls $0.60
PITS316: folds 
SeniorInv: raises $6.78 to $7.38 and is all-in
!P0K3RM3T4L!: folds 
donmarc777: calls $6.78
*** FLOP *** [Th Ac Jc]
*** TURN *** [Th Ac Jc] [6c]
*** RIVER *** [Th Ac Jc 6c] [6d]
*** SHOW DOWN ***
SeniorInv: shows [9d 9c] (two pair, Nines and Sixes)
donmarc777: shows [7d Td] (two pair, Tens and Sixes)
donmarc777 collected $14.76 from pot
*** SUMMARY ***
Total pot $15.46 | Rake $0.70 
Board [Th Ac Jc 6c 6d]
Seat 1: donmarc777 (button) showed [7d Td] and won ($14.76) with two pair, Tens and Sixes
Seat 2: PITS316 (small blind) folded before Flop
Seat 3: SeniorInv (big blind) showed [9d 9c] and lost with two pair, Nines and Sixes
Seat 4: SantiagoWeight folded before Flop (didn't bet)
Seat 5: !P0K3RM3T4L! folded before Flop
Seat 6: sZCzpNtheKot folded before Flop (didn't bet)



PokerStars Zoom Hand #195022967106:  Hold'em No Limit ($0.10/$0.25) - 2018/12/29 3:16:48 UTC [2018/12/28 22:16:48 ET]
Table 'Hydra' 6-max Seat #1 is the button
Seat 1: reademenweep ($23.07 in chips) 
Seat 2: SantiagoWeight ($26.97 in chips) 
Seat 3: ivann14 ($31.04 in chips) 
Seat 4: yobbos ($118.70 in chips) 
Seat 5: !P0K3RM3T4L! ($25.14 in chips) 
Seat 6: G ster24 ($34.91 in chips) 
SantiagoWeight: posts small blind $0.10
ivann14: posts big blind $0.25
*** HOLE CARDS ***
Dealt to SantiagoWeight [7h Kh]
yobbos: folds 
!P0K3RM3T4L!: folds 
G ster24: folds 
reademenweep: calls $0.25
SantiagoWeight: calls $0.15
ivann14: raises $1 to $1.25
reademenweep: calls $1
SantiagoWeight: folds 
*** FLOP *** [8s Kd 2h]
ivann14: bets $0.87
reademenweep: folds 
Uncalled bet ($0.87) returned to ivann14
ivann14 collected $2.63 from pot
ivann14: doesn't show hand 
*** SUMMARY ***
Total pot $2.75 | Rake $0.12 
Board [8s Kd 2h]
Seat 1: reademenweep (button) folded on the Flop
Seat 2: SantiagoWeight (small blind) folded before Flop
Seat 3: ivann14 (big blind) collected ($2.63)
Seat 4: yobbos folded before Flop (didn't bet)
Seat 5: !P0K3RM3T4L! folded before Flop (didn't bet)
Seat 6: G ster24 folded before Flop (didn't bet)



PokerStars Zoom Hand #195022965705:  Hold'em No Limit ($0.10/$0.25) - 2018/12/29 3:16:44 UTC [2018/12/28 22:16:44 ET]
Table 'Hydra' 6-max Seat #1 is the button
Seat 1: SantiagoWeight ($26.97 in chips) 
Seat 2: TQNYMQNTANA ($25 in chips) 
Seat 3: nhanminhtri ($30.02 in chips) 
Seat 4: Josip1119 ($21.83 in chips) 
Seat 5: negreanuNya ($25.88 in chips) 
Seat 6: gift-cloud9 ($25 in chips) 
TQNYMQNTANA: posts small blind $0.10
nhanminhtri: posts big blind $0.25
*** HOLE CARDS ***
Dealt to SantiagoWeight [4d 2s]
Josip1119: folds 
negreanuNya: folds 
gift-cloud9: folds 
SantiagoWeight: folds 
TQNYMQNTANA: folds 
Uncalled bet ($0.15) returned to nhanminhtri
nhanminhtri collected $0.20 from pot
nhanminhtri: doesn't show hand 
*** SUMMARY ***
Total pot $0.20 | Rake $0 
Seat 1: SantiagoWeight (button) folded before Flop (didn't bet)
Seat 2: TQNYMQNTANA (small blind) folded before Flop
Seat 3: nhanminhtri (big blind) collected ($0.20)
Seat 4: Josip1119 folded before Flop (didn't bet)
Seat 5: negreanuNya folded before Flop (didn't bet)
Seat 6: gift-cloud9 folded before Flop (didn't bet)



PokerStars Zoom Hand #195022972706:  Hold'em No Limit ($0.10/$0.25) - 2018/12/29 3:17:05 UTC [2018/12/28 22:17:05 ET]
Table 'Hydra' 6-max Seat #1 is the button
Seat 1: assassin0875 ($187.37 in chips) 
Seat 2: Gongyong ($25 in chips) 
Seat 3: Bujan 07 ($21.11 in chips) 
Seat 4: SantiagoWeight ($26.72 in chips) 
Seat 5: miru877 ($24.65 in chips) 
Seat 6: ckriszee ($78.07 in chips) 
Gongyong: posts small blind $0.10
Bujan 07: posts big blind $0.25
*** HOLE CARDS ***
Dealt to SantiagoWeight [7c 5d]
SantiagoWeight: folds 
miru877: folds 
ckriszee: folds 
assassin0875: folds 
Gongyong: folds 
Uncalled bet ($0.15) returned to Bujan 07
Bujan 07 collected $0.20 from pot
Bujan 07: doesn't show hand 
*** SUMMARY ***
Total pot $0.20 | Rake $0 
Seat 1: assassin0875 (button) folded before Flop (didn't bet)
Seat 2: Gongyong (small blind) folded before Flop
Seat 3: Bujan 07 (big blind) collected ($0.20)
Seat 4: SantiagoWeight folded before Flop (didn't bet)
Seat 5: miru877 folded before Flop (didn't bet)
Seat 6: ckriszee folded before Flop (didn't bet)



PokerStars Zoom Hand #195022974810:  Hold'em No Limit ($0.10/$0.25) - 2018/12/29 3:17:11 UTC [2018/12/28 22:17:11 ET]
Table 'Hydra' 6-max Seat #1 is the button
Seat 1: river plate9 ($18.70 in chips) 
Seat 2: nhanminhtri ($30.12 in chips) 
Seat 3: allin969 ($38.91 in chips) 
Seat 4: ivann14 ($86.52 in chips) 
Seat 5: Acetime74 ($12.56 in chips) 
Seat 6: SantiagoWeight ($26.72 in chips) 
nhanminhtri: posts small blind $0.10
allin969: posts big blind $0.25
*** HOLE CARDS ***
Dealt to SantiagoWeight [Kd 8d]
ivann14: folds 
Acetime74: folds 
SantiagoWeight: raises $0.30 to $0.55
river plate9: folds 
nhanminhtri: calls $0.45
allin969: folds 
*** FLOP *** [Jh 2s Ts]
nhanminhtri: checks 
SantiagoWeight: bets $0.86
nhanminhtri: calls $0.86
*** TURN *** [Jh 2s Ts] [Js]
nhanminhtri: checks 
SantiagoWeight: checks 
*** RIVER *** [Jh 2s Ts Js] [2c]
nhanminhtri: bets $2.20
SantiagoWeight: folds 
Uncalled bet ($2.20) returned to nhanminhtri
nhanminhtri collected $2.93 from pot
nhanminhtri: doesn't show hand 
*** SUMMARY ***
Total pot $3.07 | Rake $0.14 
Board [Jh 2s Ts Js 2c]
Seat 1: river plate9 (button) folded before Flop (didn't bet)
Seat 2: nhanminhtri (small blind) collected ($2.93)
Seat 3: allin969 (big blind) folded before Flop
Seat 4: ivann14 folded before Flop (didn't bet)
Seat 5: Acetime74 folded before Flop (didn't bet)
Seat 6: SantiagoWeight folded on the River



PokerStars Zoom Hand #195022993891:  Hold'em No Limit ($0.10/$0.25) - 2018/12/29 3:18:05 UTC [2018/12/28 22:18:05 ET]
Table 'Hydra' 6-max Seat #1 is the button
Seat 1: river plate9 ($15.91 in chips) 
Seat 2: davidhw888 ($29.27 in chips) 
Seat 3: SantiagoWeight ($25.31 in chips) 
Seat 4: KrishnaRadha ($30.91 in chips) 
Seat 5: Xp0Hb ($27.26 in chips) 
Seat 6: Actarusqc ($48.43 in chips) 
davidhw888: posts small blind $0.10
SantiagoWeight: posts big blind $0.25
*** HOLE CARDS ***
Dealt to SantiagoWeight [2d 9h]
KrishnaRadha: folds 
Xp0Hb: folds 
Actarusqc: folds 
river plate9: raises $0.25 to $0.50
davidhw888: folds 
SantiagoWeight: folds 
Uncalled bet ($0.25) returned to river plate9
river plate9 collected $0.60 from pot
river plate9: doesn't show hand 
*** SUMMARY ***
Total pot $0.60 | Rake $0 
Seat 1: river plate9 (button) collected ($0.60)
Seat 2: davidhw888 (small blind) folded before Flop
Seat 3: SantiagoWeight (big blind) folded before Flop
Seat 4: KrishnaRadha folded before Flop (didn't bet)
Seat 5: Xp0Hb folded before Flop (didn't bet)
Seat 6: Actarusqc folded before Flop (didn't bet)



PokerStars Zoom Hand #195022998370:  Hold'em No Limit ($0.10/$0.25) - 2018/12/29 3:18:18 UTC [2018/12/28 22:18:18 ET]
Table 'Hydra' 6-max Seat #1 is the button
Seat 1: abbi555 ($25.70 in chips) 
Seat 2: ivann14 ($75.52 in chips) 
Seat 3: sZCzpNtheKot ($25 in chips) 
Seat 4: osa126 ($29.90 in chips) 
Seat 5: Dr.Jekyll197 ($36.96 in chips) 
Seat 6: SantiagoWeight ($25.06 in chips) 
ivann14: posts small blind $0.10
sZCzpNtheKot: posts big blind $0.25
*** HOLE CARDS ***
Dealt to SantiagoWeight [5h Js]
osa126: folds 
Dr.Jekyll197: folds 
SantiagoWeight: folds 
abbi555: folds 
ivann14: raises $0.50 to $0.75
sZCzpNtheKot: raises $1.50 to $2.25
ivann14: raises $3.75 to $6
sZCzpNtheKot: folds 
Uncalled bet ($3.75) returned to ivann14
ivann14 collected $4.50 from pot
ivann14: doesn't show hand 
*** SUMMARY ***
Total pot $4.50 | Rake $0 
Seat 1: abbi555 (button) folded before Flop (didn't bet)
Seat 2: ivann14 (small blind) collected ($4.50)
Seat 3: sZCzpNtheKot (big blind) folded before Flop
Seat 4: osa126 folded before Flop (didn't bet)
Seat 5: Dr.Jekyll197 folded before Flop (didn't bet)
Seat 6: SantiagoWeight folded before Flop (didn't bet)



PokerStars Zoom Hand #195022999810:  Hold'em No Limit ($0.10/$0.25) - 2018/12/29 3:18:22 UTC [2018/12/28 22:18:22 ET]
Table 'Hydra' 6-max Seat #1 is the button
Seat 1: Dr.Jekyll197 ($36.96 in chips) 
Seat 2: watchout101 ($14.30 in chips) 
Seat 3: Meulenn89 ($23.08 in chips) 
Seat 4: Jack123985 ($25 in chips) 
Seat 5: SantiagoWeight ($25.06 in chips) 
Seat 6: HansMSM ($25 in chips) 
watchout101: posts small blind $0.10
Meulenn89: posts big blind $0.25
*** HOLE CARDS ***
Dealt to SantiagoWeight [8s 7d]
Jack123985: folds 
SantiagoWeight: folds 
HansMSM: folds 
Dr.Jekyll197: raises $0.37 to $0.62
watchout101: calls $0.52
Meulenn89: calls $0.37
*** FLOP *** [4h 4s Jd]
watchout101: checks 
Meulenn89: checks 
Dr.Jekyll197: bets $1.19
watchout101: calls $1.19
Meulenn89: calls $1.19
*** TURN *** [4h 4s Jd] [5d]
watchout101: checks 
Meulenn89: checks 
Dr.Jekyll197: checks 
*** RIVER *** [4h 4s Jd 5d] [8d]
watchout101: bets $2.50
Meulenn89: folds 
Dr.Jekyll197: folds 
Uncalled bet ($2.50) returned to watchout101
watchout101 collected $5.19 from pot
watchout101: doesn't show hand 
*** SUMMARY ***
Total pot $5.43 | Rake $0.24 
Board [4h 4s Jd 5d 8d]
Seat 1: Dr.Jekyll197 (button) folded on the River
Seat 2: watchout101 (small blind) collected ($5.19)
Seat 3: Meulenn89 (big blind) folded on the River
Seat 4: Jack123985 folded before Flop (didn't bet)
Seat 5: SantiagoWeight folded before Flop (didn't bet)
Seat 6: HansMSM folded before Flop (didn't bet)



PokerStars Zoom Hand #195023003225:  Hold'em No Limit ($0.10/$0.25) - 2018/12/29 3:18:32 UTC [2018/12/28 22:18:32 ET]
Table 'Hydra' 6-max Seat #1 is the button
Seat 1: zdenekstavic ($51.23 in chips) 
Seat 2: SantiagoWeight ($25.06 in chips) 
Seat 3: TDAK1509 ($61.03 in chips) 
Seat 4: !P0K3RM3T4L! ($66.59 in chips) 
Seat 5: Xander_B88 ($22.50 in chips) 
Seat 6: TQNYMQNTANA ($94.27 in chips) 
SantiagoWeight: posts small blind $0.10
TDAK1509: posts big blind $0.25
*** HOLE CARDS ***
Dealt to SantiagoWeight [Ks Tc]
!P0K3RM3T4L!: raises $0.35 to $0.60
Xander_B88: calls $0.60
TQNYMQNTANA: folds 
zdenekstavic: folds 
SantiagoWeight: folds 
TDAK1509: folds 
*** FLOP *** [6c 3s Kd]
!P0K3RM3T4L!: checks 
Xander_B88: bets $1
!P0K3RM3T4L!: folds 
Uncalled bet ($1) returned to Xander_B88
Xander_B88 collected $1.48 from pot
Xander_B88: doesn't show hand 
*** SUMMARY ***
Total pot $1.55 | Rake $0.07 
Board [6c 3s Kd]
Seat 1: zdenekstavic (button) folded before Flop (didn't bet)
Seat 2: SantiagoWeight (small blind) folded before Flop
Seat 3: TDAK1509 (big blind) folded before Flop
Seat 4: !P0K3RM3T4L! folded on the Flop
Seat 5: Xander_B88 collected ($1.48)
Seat 6: TQNYMQNTANA folded before Flop (didn't bet)



PokerStars Zoom Hand #195023010905:  Hold'em No Limit ($0.10/$0.25) - 2018/12/29 3:18:54 UTC [2018/12/28 22:18:54 ET]
Table 'Hydra' 6-max Seat #1 is the button
Seat 1: SantiagoWeight ($24.96 in chips) 
Seat 2: gift-cloud9 ($25.89 in chips) 
Seat 3: BirreteX ($25 in chips) 
Seat 4: reggiedogg31 ($114.99 in chips) 
Seat 5: Acetime74 ($11.44 in chips) 
Seat 6: ryanking99 ($16.85 in chips) 
gift-cloud9: posts small blind $0.10
BirreteX: posts big blind $0.25
*** HOLE CARDS ***
Dealt to SantiagoWeight [8h 3d]
reggiedogg31: folds 
Acetime74: raises $0.50 to $0.75
ryanking99: folds 
SantiagoWeight: folds 
gift-cloud9: folds 
BirreteX: folds 
Uncalled bet ($0.50) returned to Acetime74
Acetime74 collected $0.60 from pot
Acetime74: doesn't show hand 
*** SUMMARY ***
Total pot $0.60 | Rake $0 
Seat 1: SantiagoWeight (button) folded before Flop (didn't bet)
Seat 2: gift-cloud9 (small blind) folded before Flop
Seat 3: BirreteX (big blind) folded before Flop
Seat 4: reggiedogg31 folded before Flop (didn't bet)
Seat 5: Acetime74 collected ($0.60)
Seat 6: ryanking99 folded before Flop (didn't bet)



PokerStars Zoom Hand #195023014399:  Hold'em No Limit ($0.10/$0.25) - 2018/12/29 3:19:04 UTC [2018/12/28 22:19:04 ET]
Table 'Hydra' 6-max Seat #1 is the button
Seat 1: Gf Chipz ($12.81 in chips) 
Seat 2: river plate9 ($25 in chips) 
Seat 3: deaglepro ($55.52 in chips) 
Seat 4: pfunkolstar ($25 in chips) 
Seat 5: SantiagoWeight ($24.96 in chips) 
Seat 6: KrishnaRadha ($33.78 in chips) 
river plate9: posts small blind $0.10
deaglepro: posts big blind $0.25
*** HOLE CARDS ***
Dealt to SantiagoWeight [3s 4s]
pfunkolstar: folds 
SantiagoWeight: folds 
KrishnaRadha: folds 
Gf Chipz: folds 
river plate9: folds 
Uncalled bet ($0.15) returned to deaglepro
deaglepro collected $0.20 from pot
deaglepro: doesn't show hand 
*** SUMMARY ***
Total pot $0.20 | Rake $0 
Seat 1: Gf Chipz (button) folded before Flop (didn't bet)
Seat 2: river plate9 (small blind) folded before Flop
Seat 3: deaglepro (big blind) collected ($0.20)
Seat 4: pfunkolstar folded before Flop (didn't bet)
Seat 5: SantiagoWeight folded before Flop (didn't bet)
Seat 6: KrishnaRadha folded before Flop (didn't bet)



PokerStars Zoom Hand #195023016789:  Hold'em No Limit ($0.10/$0.25) - 2018/12/29 3:19:11 UTC [2018/12/28 22:19:11 ET]
Table 'Hydra' 6-max Seat #1 is the button
Seat 1: gift-cloud9 ($25.89 in chips) 
Seat 2: pfunkolstar ($25 in chips) 
Seat 3: SantiagoWeight ($24.96 in chips) 
Seat 4: franco373513 ($14.42 in chips) 
Seat 5: MileVoliD49 ($73.49 in chips) 
Seat 6: kopasz221 ($35.79 in chips) 
pfunkolstar: posts small blind $0.10
SantiagoWeight: posts big blind $0.25
*** HOLE CARDS ***
Dealt to SantiagoWeight [Kc Ac]
franco373513: folds 
MileVoliD49: folds 
kopasz221: raises $0.50 to $0.75
gift-cloud9: folds 
pfunkolstar: folds 
SantiagoWeight: raises $2.45 to $3.20
kopasz221: calls $2.45
*** FLOP *** [9c 7h Ah]
SantiagoWeight: bets $5.80
kopasz221: calls $5.80
*** TURN *** [9c 7h Ah] [Ts]
SantiagoWeight: bets $15.96 and is all-in
kopasz221: calls $15.96
*** RIVER *** [9c 7h Ah Ts] [4h]
*** SHOW DOWN ***
SantiagoWeight: shows [Kc Ac] (a pair of Aces)
kopasz221: shows [Th Td] (three of a kind, Tens)
kopasz221 collected $48.02 from pot
*** SUMMARY ***
Total pot $50.02 | Rake $2 
Board [9c 7h Ah Ts 4h]
Seat 1: gift-cloud9 (button) folded before Flop (didn't bet)
Seat 2: pfunkolstar (small blind) folded before Flop
Seat 3: SantiagoWeight (big blind) showed [Kc Ac] and lost with a pair of Aces
Seat 4: franco373513 folded before Flop (didn't bet)
Seat 5: MileVoliD49 folded before Flop (didn't bet)
Seat 6: kopasz221 showed [Th Td] and won ($48.02) with three of a kind, Tens



PokerStars Zoom Hand #195023038370:  Hold'em No Limit ($0.10/$0.25) - 2018/12/29 3:20:14 UTC [2018/12/28 22:20:14 ET]
Table 'Hydra' 6-max Seat #1 is the button
Seat 1: BMB8888 ($59.04 in chips) 
Seat 2: BnanaBread13 ($25 in chips) 
Seat 3: TQNYMQNTANA ($108.13 in chips) 
Seat 4: SantiagoWeight ($25 in chips) 
Seat 5: yobbos ($26.97 in chips) 
Seat 6: anlu0803 ($24.75 in chips) 
BnanaBread13: posts small blind $0.10
TQNYMQNTANA: posts big blind $0.25
*** HOLE CARDS ***
Dealt to SantiagoWeight [6d Jh]
SantiagoWeight: folds 
yobbos: folds 
anlu0803: folds 
BMB8888: folds 
BnanaBread13: raises $0.50 to $0.75
TQNYMQNTANA: folds 
Uncalled bet ($0.50) returned to BnanaBread13
BnanaBread13 collected $0.50 from pot
BnanaBread13: doesn't show hand 
*** SUMMARY ***
Total pot $0.50 | Rake $0 
Seat 1: BMB8888 (button) folded before Flop (didn't bet)
Seat 2: BnanaBread13 (small blind) collected ($0.50)
Seat 3: TQNYMQNTANA (big blind) folded before Flop
Seat 4: SantiagoWeight folded before Flop (didn't bet)
Seat 5: yobbos folded before Flop (didn't bet)
Seat 6: anlu0803 folded before Flop (didn't bet)



PokerStars Zoom Hand #195023039383:  Hold'em No Limit ($0.10/$0.25) - 2018/12/29 3:20:17 UTC [2018/12/28 22:20:17 ET]
Table 'Hydra' 6-max Seat #1 is the button
Seat 1: meettokill ($28.46 in chips) 
Seat 2: rim975 ($17.62 in chips) 
Seat 3: Meulenn89 ($20.47 in chips) 
Seat 4: Looooser #1 ($19.90 in chips) 
Seat 5: SantiagoWeight ($25 in chips) 
Seat 6: Unclesmoll ($11.10 in chips) 
rim975: posts small blind $0.10
Meulenn89: posts big blind $0.25
*** HOLE CARDS ***
Dealt to SantiagoWeight [2s 4s]
Looooser #1: calls $0.25
SantiagoWeight: folds 
Unclesmoll: raises $0.50 to $0.75
meettokill: folds 
rim975: folds 
Meulenn89: folds 
Looooser #1: raises $1.85 to $2.60
Unclesmoll: calls $1.85
*** FLOP *** [3s 9d Qc]
Looooser #1: bets $5.30
Unclesmoll: folds 
Uncalled bet ($5.30) returned to Looooser #1
Looooser #1 collected $5.30 from pot
Looooser #1: doesn't show hand 
*** SUMMARY ***
Total pot $5.55 | Rake $0.25 
Board [3s 9d Qc]
Seat 1: meettokill (button) folded before Flop (didn't bet)
Seat 2: rim975 (small blind) folded before Flop
Seat 3: Meulenn89 (big blind) folded before Flop
Seat 4: Looooser #1 collected ($5.30)
Seat 5: SantiagoWeight folded before Flop (didn't bet)
Seat 6: Unclesmoll folded on the Flop



PokerStars Zoom Hand #195023041123:  Hold'em No Limit ($0.10/$0.25) - 2018/12/29 3:20:22 UTC [2018/12/28 22:20:22 ET]
Table 'Hydra' 6-max Seat #1 is the button
Seat 1: gamnai88 ($9.95 in chips) 
Seat 2: Chrimmpam ($47.65 in chips) 
Seat 3: deaglepro ($61.59 in chips) 
Seat 4: pfunkolstar ($25.35 in chips) 
Seat 5: Josip1119 ($15.86 in chips) 
Seat 6: SantiagoWeight ($25 in chips) 
Chrimmpam: posts small blind $0.10
deaglepro: posts big blind $0.25
*** HOLE CARDS ***
Dealt to SantiagoWeight [Ac Qd]
pfunkolstar: folds 
Josip1119: raises $0.50 to $0.75
SantiagoWeight: raises $1.35 to $2.10
gamnai88: folds 
Chrimmpam: calls $2
deaglepro: folds 
Josip1119: raises $6.22 to $8.32
SantiagoWeight: raises $6.68 to $15
Chrimmpam: folds 
Josip1119: calls $6.68
*** FLOP *** [7s 9s 3s]
Josip1119: bets $0.86 and is all-in
SantiagoWeight: calls $0.86
*** FIRST TURN *** [7s 9s 3s] [7c]
*** FIRST RIVER *** [7s 9s 3s 7c] [Jc]
*** SECOND TURN *** [7s 9s 3s] [Qc]
*** SECOND RIVER *** [7s 9s 3s Qc] [4c]
*** FIRST SHOW DOWN ***
Josip1119: shows [Kh Ad] (a pair of Sevens)
SantiagoWeight: shows [Ac Qd] (a pair of Sevens - lower kicker)
Josip1119 collected $16.27 from pot
*** SECOND SHOW DOWN ***
Josip1119: shows [Kh Ad] (high card Ace)
SantiagoWeight: shows [Ac Qd] (a pair of Queens)
SantiagoWeight collected $16.27 from pot
*** SUMMARY ***
Total pot $34.07 | Rake $1.53 
Hand was run twice
FIRST Board [7s 9s 3s 7c Jc]
SECOND Board [7s 9s 3s Qc 4c]
Seat 1: gamnai88 (button) folded before Flop (didn't bet)
Seat 2: Chrimmpam (small blind) folded before Flop
Seat 3: deaglepro (big blind) folded before Flop
Seat 4: pfunkolstar folded before Flop (didn't bet)
Seat 5: Josip1119 showed [Kh Ad] and won ($16.27) with a pair of Sevens, and lost with high card Ace
Seat 6: SantiagoWeight showed [Ac Qd] and lost with a pair of Sevens, and won ($16.27) with a pair of Queens



PokerStars Zoom Hand #195023056213:  Hold'em No Limit ($0.10/$0.25) - 2018/12/29 3:21:06 UTC [2018/12/28 22:21:06 ET]
Table 'Hydra' 6-max Seat #1 is the button
Seat 1: Chrimmpam ($22.18 in chips) 
Seat 2: SantiagoWeight ($25.41 in chips) 
Seat 3: ivann14 ($87.55 in chips) 
Seat 4: Josip1119 ($16.27 in chips) 
Seat 5: gift-cloud9 ($39.10 in chips) 
Seat 6: Baboscrubx ($30.56 in chips) 
SantiagoWeight: posts small blind $0.10
ivann14: posts big blind $0.25
*** HOLE CARDS ***
Dealt to SantiagoWeight [7d 6d]
Josip1119: raises $0.50 to $0.75
gift-cloud9: folds 
Baboscrubx: folds 
Chrimmpam: folds 
SantiagoWeight: folds 
ivann14: folds 
Uncalled bet ($0.50) returned to Josip1119
Josip1119 collected $0.60 from pot
Josip1119: doesn't show hand 
*** SUMMARY ***
Total pot $0.60 | Rake $0 
Seat 1: Chrimmpam (button) folded before Flop (didn't bet)
Seat 2: SantiagoWeight (small blind) folded before Flop
Seat 3: ivann14 (big blind) folded before Flop
Seat 4: Josip1119 collected ($0.60)
Seat 5: gift-cloud9 folded before Flop (didn't bet)
Seat 6: Baboscrubx folded before Flop (didn't bet)



PokerStars Zoom Hand #195023059310:  Hold'em No Limit ($0.10/$0.25) - 2018/12/29 3:21:15 UTC [2018/12/28 22:21:15 ET]
Table 'Hydra' 6-max Seat #1 is the button
Seat 1: SantiagoWeight ($25.31 in chips) 
Seat 2: TQNYMQNTANA ($108.90 in chips) 
Seat 3: kevinwelsk ($25.18 in chips) 
Seat 4: abbi555 ($26.11 in chips) 
Seat 5: miru877 ($26.01 in chips) 
Seat 6: Pardaroxon ($25 in chips) 
TQNYMQNTANA: posts small blind $0.10
kevinwelsk: posts big blind $0.25
*** HOLE CARDS ***
Dealt to SantiagoWeight [Ad Tc]
abbi555: folds 
miru877: folds 
Pardaroxon: folds 
SantiagoWeight: raises $0.30 to $0.55
TQNYMQNTANA: folds 
kevinwelsk: calls $0.30
*** FLOP *** [Ah 9d 2d]
kevinwelsk: checks 
SantiagoWeight: bets $0.77
kevinwelsk: calls $0.77
*** TURN *** [Ah 9d 2d] [5c]
kevinwelsk: checks 
SantiagoWeight: bets $1.75
kevinwelsk: calls $1.75
*** RIVER *** [Ah 9d 2d 5c] [Ts]
kevinwelsk: checks 
SantiagoWeight: bets $9.40
kevinwelsk: folds 
Uncalled bet ($9.40) returned to SantiagoWeight
SantiagoWeight collected $5.96 from pot
SantiagoWeight: doesn't show hand 
*** SUMMARY ***
Total pot $6.24 | Rake $0.28 
Board [Ah 9d 2d 5c Ts]
Seat 1: SantiagoWeight (button) collected ($5.96)
Seat 2: TQNYMQNTANA (small blind) folded before Flop
Seat 3: kevinwelsk (big blind) folded on the River
Seat 4: abbi555 folded before Flop (didn't bet)
Seat 5: miru877 folded before Flop (didn't bet)
Seat 6: Pardaroxon folded before Flop (didn't bet)



PokerStars Zoom Hand #195023087465:  Hold'em No Limit ($0.10/$0.25) - 2018/12/29 3:22:37 UTC [2018/12/28 22:22:37 ET]
Table 'Hydra' 6-max Seat #1 is the button
Seat 1: Pardaroxon ($25 in chips) 
Seat 2: franco373513 ($10.87 in chips) 
Seat 3: GrandmasterY ($31.95 in chips) 
Seat 4: SantiagoWeight ($28.20 in chips) 
Seat 5: pfunkolstar ($25 in chips) 
Seat 6: Baboscrubx ($35.38 in chips) 
franco373513: posts small blind $0.10
GrandmasterY: posts big blind $0.25
*** HOLE CARDS ***
Dealt to SantiagoWeight [8d Kh]
SantiagoWeight: folds 
pfunkolstar: folds 
Baboscrubx: folds 
Pardaroxon: folds 
franco373513: folds 
Uncalled bet ($0.15) returned to GrandmasterY
GrandmasterY collected $0.20 from pot
GrandmasterY: doesn't show hand 
*** SUMMARY ***
Total pot $0.20 | Rake $0 
Seat 1: Pardaroxon (button) folded before Flop (didn't bet)
Seat 2: franco373513 (small blind) folded before Flop
Seat 3: GrandmasterY (big blind) collected ($0.20)
Seat 4: SantiagoWeight folded before Flop (didn't bet)
Seat 5: pfunkolstar folded before Flop (didn't bet)
Seat 6: Baboscrubx folded before Flop (didn't bet)



PokerStars Zoom Hand #195023089207:  Hold'em No Limit ($0.10/$0.25) - 2018/12/29 3:22:42 UTC [2018/12/28 22:22:42 ET]
Table 'Hydra' 6-max Seat #1 is the button
Seat 1: kevinwelsk ($22.01 in chips) 
Seat 2: Lehared ($53.31 in chips) 
Seat 3: SantiagoWeight ($28.20 in chips) 
Seat 4: 1ownYourUsd ($34.78 in chips) 
Seat 5: HansMSM ($67.40 in chips) 
Seat 6: nhanminhtri ($25 in chips) 
Lehared: posts small blind $0.10
SantiagoWeight: posts big blind $0.25
*** HOLE CARDS ***
Dealt to SantiagoWeight [Qs 8h]
1ownYourUsd: folds 
HansMSM: folds 
nhanminhtri: folds 
kevinwelsk: folds 
Lehared: folds 
Uncalled bet ($0.15) returned to SantiagoWeight
SantiagoWeight collected $0.20 from pot
SantiagoWeight: doesn't show hand 
*** SUMMARY ***
Total pot $0.20 | Rake $0 
Seat 1: kevinwelsk (button) folded before Flop (didn't bet)
Seat 2: Lehared (small blind) folded before Flop
Seat 3: SantiagoWeight (big blind) collected ($0.20)
Seat 4: 1ownYourUsd folded before Flop (didn't bet)
Seat 5: HansMSM folded before Flop (didn't bet)
Seat 6: nhanminhtri folded before Flop (didn't bet)



PokerStars Zoom Hand #195023091925:  Hold'em No Limit ($0.10/$0.25) - 2018/12/29 3:22:50 UTC [2018/12/28 22:22:50 ET]
Table 'Hydra' 6-max Seat #1 is the button
Seat 1: Lehared ($49.80 in chips) 
Seat 2: anlu0803 ($22.15 in chips) 
Seat 3: qing328 ($24.90 in chips) 
Seat 4: ivann14 ($86.85 in chips) 
Seat 5: SantiagoWeight ($28.30 in chips) 
Seat 6: TDAK1509 ($65.76 in chips) 
anlu0803: posts small blind $0.10
qing328: posts big blind $0.25
*** HOLE CARDS ***
Dealt to SantiagoWeight [8c 7h]
ivann14: folds 
SantiagoWeight: folds 
TDAK1509: raises $0.37 to $0.62
Lehared: folds 
anlu0803: folds 
qing328: folds 
Uncalled bet ($0.37) returned to TDAK1509
TDAK1509 collected $0.60 from pot
TDAK1509: doesn't show hand 
*** SUMMARY ***
Total pot $0.60 | Rake $0 
Seat 1: Lehared (button) folded before Flop (didn't bet)
Seat 2: anlu0803 (small blind) folded before Flop
Seat 3: qing328 (big blind) folded before Flop
Seat 4: ivann14 folded before Flop (didn't bet)
Seat 5: SantiagoWeight folded before Flop (didn't bet)
Seat 6: TDAK1509 collected ($0.60)



PokerStars Zoom Hand #195023094643:  Hold'em No Limit ($0.10/$0.25) - 2018/12/29 3:22:58 UTC [2018/12/28 22:22:58 ET]
Table 'Hydra' 6-max Seat #1 is the button
Seat 1: Chrimmpam ($20.58 in chips) 
Seat 2: SantiagoWeight ($28.30 in chips) 
Seat 3: HonourMan23 ($30.72 in chips) 
Seat 4: Lehared ($53.21 in chips) 
Seat 5: HansMSM ($67.40 in chips) 
Seat 6: ttshead ($61.98 in chips) 
SantiagoWeight: posts small blind $0.10
HonourMan23: posts big blind $0.25
*** HOLE CARDS ***
Dealt to SantiagoWeight [3c Ac]
Lehared: folds 
HansMSM: folds 
ttshead: raises $0.43 to $0.68
Chrimmpam: folds 
SantiagoWeight: folds 
HonourMan23: folds 
Uncalled bet ($0.43) returned to ttshead
ttshead collected $0.60 from pot
ttshead: doesn't show hand 
*** SUMMARY ***
Total pot $0.60 | Rake $0 
Seat 1: Chrimmpam (button) folded before Flop (didn't bet)
Seat 2: SantiagoWeight (small blind) folded before Flop
Seat 3: HonourMan23 (big blind) folded before Flop
Seat 4: Lehared folded before Flop (didn't bet)
Seat 5: HansMSM folded before Flop (didn't bet)
Seat 6: ttshead collected ($0.60)



PokerStars Zoom Hand #195023102765:  Hold'em No Limit ($0.10/$0.25) - 2018/12/29 3:23:22 UTC [2018/12/28 22:23:22 ET]
Table 'Hydra' 6-max Seat #1 is the button
Seat 1: negreanuNya ($25 in chips) 
Seat 2: angipoker ($12.91 in chips) 
Seat 3: SantiagoWeight ($28.20 in chips) 
Seat 4: gift-cloud9 ($28.47 in chips) 
Seat 5: call me??107 ($42.36 in chips) 
Seat 6: miru877 ($26.19 in chips) 
angipoker: posts small blind $0.10
SantiagoWeight: posts big blind $0.25
*** HOLE CARDS ***
Dealt to SantiagoWeight [Ad 4d]
gift-cloud9: folds 
call me??107: folds 
miru877: raises $0.50 to $0.75
negreanuNya: folds 
angipoker: folds 
SantiagoWeight: calls $0.50
*** FLOP *** [Ac 2s 7d]
SantiagoWeight: checks 
miru877: bets $0.50
SantiagoWeight: calls $0.50
*** TURN *** [Ac 2s 7d] [6h]
SantiagoWeight: checks 
miru877: checks 
*** RIVER *** [Ac 2s 7d 6h] [7c]
SantiagoWeight: checks 
miru877: checks 
*** SHOW DOWN ***
SantiagoWeight: shows [Ad 4d] (two pair, Aces and Sevens)
miru877: mucks hand 
SantiagoWeight collected $2.48 from pot
*** SUMMARY ***
Total pot $2.60 | Rake $0.12 
Board [Ac 2s 7d 6h 7c]
Seat 1: negreanuNya (button) folded before Flop (didn't bet)
Seat 2: angipoker (small blind) folded before Flop
Seat 3: SantiagoWeight (big blind) showed [Ad 4d] and won ($2.48) with two pair, Aces and Sevens
Seat 4: gift-cloud9 folded before Flop (didn't bet)
Seat 5: call me??107 folded before Flop (didn't bet)
Seat 6: miru877 mucked [Qs Jc]



PokerStars Zoom Hand #195023101035:  Hold'em No Limit ($0.10/$0.25) - 2018/12/29 3:23:17 UTC [2018/12/28 22:23:17 ET]
Table 'Hydra' 6-max Seat #1 is the button
Seat 1: SantiagoWeight ($28.20 in chips) 
Seat 2: yobbos ($25.10 in chips) 
Seat 3: HansMSM ($67.40 in chips) 
Seat 4: gift-cloud9 ($28.47 in chips) 
Seat 5: MileVoliD49 ($73.76 in chips) 
Seat 6: nhanminhtri ($28.96 in chips) 
yobbos: posts small blind $0.10
HansMSM: posts big blind $0.25
*** HOLE CARDS ***
Dealt to SantiagoWeight [2c 3h]
gift-cloud9: folds 
MileVoliD49: raises $0.25 to $0.50
nhanminhtri: folds 
SantiagoWeight: folds 
yobbos: folds 
HansMSM: calls $0.25
*** FLOP *** [4c 4d 6h]
HansMSM: checks 
MileVoliD49: bets $0.75
HansMSM: calls $0.75
*** TURN *** [4c 4d 6h] [9d]
HansMSM: checks 
MileVoliD49: bets $0.75
HansMSM: calls $0.75
*** RIVER *** [4c 4d 6h 9d] [5d]
HansMSM: checks 
MileVoliD49: bets $4
HansMSM: folds 
Uncalled bet ($4) returned to MileVoliD49
MileVoliD49 collected $3.92 from pot
MileVoliD49: doesn't show hand 
*** SUMMARY ***
Total pot $4.10 | Rake $0.18 
Board [4c 4d 6h 9d 5d]
Seat 1: SantiagoWeight (button) folded before Flop (didn't bet)
Seat 2: yobbos (small blind) folded before Flop
Seat 3: HansMSM (big blind) folded on the River
Seat 4: gift-cloud9 folded before Flop (didn't bet)
Seat 5: MileVoliD49 collected ($3.92)
Seat 6: nhanminhtri folded before Flop (didn't bet)



PokerStars Zoom Hand #195023126439:  Hold'em No Limit ($0.10/$0.25) - 2018/12/29 3:24:19 UTC [2018/12/28 22:24:19 ET]
Table 'Hydra' 6-max Seat #1 is the button
Seat 1: Unclesmoll ($4.42 in chips) 
Seat 2: miru877 ($24.24 in chips) 
Seat 3: abbi555 ($27.25 in chips) 
Seat 4: deaglepro ($57.74 in chips) 
Seat 5: Chrimmpam ($22.84 in chips) 
Seat 6: SantiagoWeight ($29.43 in chips) 
miru877: posts small blind $0.10
abbi555: posts big blind $0.25
*** HOLE CARDS ***
Dealt to SantiagoWeight [Td Qh]
deaglepro: folds 
Chrimmpam: folds 
SantiagoWeight: raises $0.30 to $0.55
Unclesmoll: raises $1.45 to $2
miru877: folds 
abbi555: folds 
SantiagoWeight: folds 
Uncalled bet ($1.45) returned to Unclesmoll
Unclesmoll collected $1.45 from pot
Unclesmoll: doesn't show hand 
*** SUMMARY ***
Total pot $1.45 | Rake $0 
Seat 1: Unclesmoll (button) collected ($1.45)
Seat 2: miru877 (small blind) folded before Flop
Seat 3: abbi555 (big blind) folded before Flop
Seat 4: deaglepro folded before Flop (didn't bet)
Seat 5: Chrimmpam folded before Flop (didn't bet)
Seat 6: SantiagoWeight folded before Flop



PokerStars Zoom Hand #195023143149:  Hold'em No Limit ($0.10/$0.25) - 2018/12/29 3:25:09 UTC [2018/12/28 22:25:09 ET]
Table 'Hydra' 6-max Seat #1 is the button
Seat 1: G ster24 ($25.71 in chips) 
Seat 2: reademenweep ($19.15 in chips) 
Seat 3: aldoalb0207 ($63.79 in chips) 
Seat 4: anlu0803 ($18.70 in chips) 
Seat 5: Viiiru ($31.12 in chips) 
Seat 6: SantiagoWeight ($28.88 in chips) 
reademenweep: posts small blind $0.10
aldoalb0207: posts big blind $0.25
*** HOLE CARDS ***
Dealt to SantiagoWeight [Ah 4c]
anlu0803: folds 
Viiiru: folds 
SantiagoWeight: folds 
G ster24: folds 
reademenweep: folds 
Uncalled bet ($0.15) returned to aldoalb0207
aldoalb0207 collected $0.20 from pot
aldoalb0207: doesn't show hand 
*** SUMMARY ***
Total pot $0.20 | Rake $0 
Seat 1: G ster24 (button) folded before Flop (didn't bet)
Seat 2: reademenweep (small blind) folded before Flop
Seat 3: aldoalb0207 (big blind) collected ($0.20)
Seat 4: anlu0803 folded before Flop (didn't bet)
Seat 5: Viiiru folded before Flop (didn't bet)
Seat 6: SantiagoWeight folded before Flop (didn't bet)



PokerStars Zoom Hand #195023140801:  Hold'em No Limit ($0.10/$0.25) - 2018/12/29 3:25:02 UTC [2018/12/28 22:25:02 ET]
Table 'Hydra' 6-max Seat #1 is the button
Seat 1: river plate9 ($39.95 in chips) 
Seat 2: allin969 ($74.30 in chips) 
Seat 3: Josip1119 ($8.47 in chips) 
Seat 4: nadal335 ($25 in chips) 
Seat 5: SantiagoWeight ($28.88 in chips) 
Seat 6: reademenweep ($19.15 in chips) 
allin969: posts small blind $0.10
Josip1119: posts big blind $0.25
*** HOLE CARDS ***
Dealt to SantiagoWeight [3d 4c]
nadal335: folds 
SantiagoWeight: folds 
reademenweep: folds 
river plate9: folds 
allin969: raises $0.50 to $0.75
Josip1119: folds 
Uncalled bet ($0.50) returned to allin969
allin969 collected $0.50 from pot
allin969: doesn't show hand 
*** SUMMARY ***
Total pot $0.50 | Rake $0 
Seat 1: river plate9 (button) folded before Flop (didn't bet)
Seat 2: allin969 (small blind) collected ($0.50)
Seat 3: Josip1119 (big blind) folded before Flop
Seat 4: nadal335 folded before Flop (didn't bet)
Seat 5: SantiagoWeight folded before Flop (didn't bet)
Seat 6: reademenweep folded before Flop (didn't bet)



PokerStars Zoom Hand #195023146161:  Hold'em No Limit ($0.10/$0.25) - 2018/12/29 3:25:18 UTC [2018/12/28 22:25:18 ET]
Table 'Hydra' 6-max Seat #1 is the button
Seat 1: christulio ($13.95 in chips) 
Seat 2: SantiagoWeight ($28.88 in chips) 
Seat 3: Renner32 ($26.92 in chips) 
Seat 4: miru877 ($24.30 in chips) 
Seat 5: G ster24 ($25.71 in chips) 
Seat 6: GrandmasterY ($25 in chips) 
SantiagoWeight: posts small blind $0.10
Renner32: posts big blind $0.25
*** HOLE CARDS ***
Dealt to SantiagoWeight [9d Jd]
miru877: folds 
G ster24: folds 
GrandmasterY: folds 
christulio: raises $0.25 to $0.50
SantiagoWeight: raises $1.50 to $2
Renner32: folds 
christulio: calls $1.50
*** FLOP *** [9s Kc Ac]
SantiagoWeight: bets $1.02
christulio: raises $1.02 to $2.04
SantiagoWeight: folds 
Uncalled bet ($1.02) returned to christulio
christulio collected $6.01 from pot
christulio: doesn't show hand 
*** SUMMARY ***
Total pot $6.29 | Rake $0.28 
Board [9s Kc Ac]
Seat 1: christulio (button) collected ($6.01)
Seat 2: SantiagoWeight (small blind) folded on the Flop
Seat 3: Renner32 (big blind) folded before Flop
Seat 4: miru877 folded before Flop (didn't bet)
Seat 5: G ster24 folded before Flop (didn't bet)
Seat 6: GrandmasterY folded before Flop (didn't bet)



PokerStars Zoom Hand #195023157961:  Hold'em No Limit ($0.10/$0.25) - 2018/12/29 3:25:54 UTC [2018/12/28 22:25:54 ET]
Table 'Hydra' 6-max Seat #1 is the button
Seat 1: SantiagoWeight ($25.86 in chips) 
Seat 2: Nutselas ($29.63 in chips) 
Seat 3: christulio ($16.94 in chips) 
Seat 4: Chrimmpam ($21.14 in chips) 
Seat 5: nhanminhtri ($25 in chips) 
Seat 6: kyracarmen ($54.88 in chips) 
Nutselas: posts small blind $0.10
christulio: posts big blind $0.25
*** HOLE CARDS ***
Dealt to SantiagoWeight [Jd Kh]
Chrimmpam: folds 
nhanminhtri: folds 
kyracarmen: folds 
SantiagoWeight: raises $0.30 to $0.55
Nutselas: folds 
christulio: raises $0.30 to $0.85
SantiagoWeight: calls $0.30
*** FLOP *** [3c As Ks]
christulio: bets $0.75
SantiagoWeight: calls $0.75
*** TURN *** [3c As Ks] [8c]
christulio: bets $1.50
SantiagoWeight: folds 
Uncalled bet ($1.50) returned to christulio
christulio collected $3.15 from pot
christulio: doesn't show hand 
*** SUMMARY ***
Total pot $3.30 | Rake $0.15 
Board [3c As Ks 8c]
Seat 1: SantiagoWeight (button) folded on the Turn
Seat 2: Nutselas (small blind) folded before Flop
Seat 3: christulio (big blind) collected ($3.15)
Seat 4: Chrimmpam folded before Flop (didn't bet)
Seat 5: nhanminhtri folded before Flop (didn't bet)
Seat 6: kyracarmen folded before Flop (didn't bet)



PokerStars Zoom Hand #195023176394:  Hold'em No Limit ($0.10/$0.25) - 2018/12/29 3:26:50 UTC [2018/12/28 22:26:50 ET]
Table 'Hydra' 6-max Seat #1 is the button
Seat 1: Party4Arthy ($77.23 in chips) 
Seat 2: negreanuNya ($41.81 in chips) 
Seat 3: IceAgeDream7 ($23.14 in chips) 
Seat 4: miru877 ($24.05 in chips) 
Seat 5: SantiagoWeight ($24.26 in chips) 
Seat 6: Lehared ($48.01 in chips) 
negreanuNya: posts small blind $0.10
IceAgeDream7: posts big blind $0.25
*** HOLE CARDS ***
Dealt to SantiagoWeight [6s Ac]
miru877: folds 
SantiagoWeight: folds 
Lehared: raises $0.37 to $0.62
Party4Arthy: folds 
negreanuNya: folds 
IceAgeDream7: folds 
Uncalled bet ($0.37) returned to Lehared
Lehared collected $0.60 from pot
Lehared: doesn't show hand 
*** SUMMARY ***
Total pot $0.60 | Rake $0 
Seat 1: Party4Arthy (button) folded before Flop (didn't bet)
Seat 2: negreanuNya (small blind) folded before Flop
Seat 3: IceAgeDream7 (big blind) folded before Flop
Seat 4: miru877 folded before Flop (didn't bet)
Seat 5: SantiagoWeight folded before Flop (didn't bet)
Seat 6: Lehared collected ($0.60)



PokerStars Zoom Hand #195023177740:  Hold'em No Limit ($0.10/$0.25) - 2018/12/29 3:26:54 UTC [2018/12/28 22:26:54 ET]
Table 'Hydra' 6-max Seat #1 is the button
Seat 1: golf7287 ($25.32 in chips) 
Seat 2: Bujan 07 ($19.29 in chips) 
Seat 3: SantiagoWeight ($24.26 in chips) 
Seat 4: zbuci ($30.07 in chips) 
Seat 5: yobbos ($25 in chips) 
Seat 6: !P0K3RM3T4L! ($26.38 in chips) 
Bujan 07: posts small blind $0.10
SantiagoWeight: posts big blind $0.25
*** HOLE CARDS ***
Dealt to SantiagoWeight [6s 2h]
zbuci: folds 
yobbos: raises $0.50 to $0.75
!P0K3RM3T4L!: folds 
golf7287: folds 
Bujan 07: calls $0.65
SantiagoWeight: folds 
*** FLOP *** [3d Kd 3c]
Bujan 07: checks 
yobbos: bets $0.57
Bujan 07: folds 
Uncalled bet ($0.57) returned to yobbos
yobbos collected $1.67 from pot
yobbos: doesn't show hand 
*** SUMMARY ***
Total pot $1.75 | Rake $0.08 
Board [3d Kd 3c]
Seat 1: golf7287 (button) folded before Flop (didn't bet)
Seat 2: Bujan 07 (small blind) folded on the Flop
Seat 3: SantiagoWeight (big blind) folded before Flop
Seat 4: zbuci folded before Flop (didn't bet)
Seat 5: yobbos collected ($1.67)
Seat 6: !P0K3RM3T4L! folded before Flop (didn't bet)



PokerStars Zoom Hand #195023183293:  Hold'em No Limit ($0.10/$0.25) - 2018/12/29 3:27:11 UTC [2018/12/28 22:27:11 ET]
Table 'Hydra' 6-max Seat #1 is the button
Seat 1: zdenekstavic ($44.76 in chips) 
Seat 2: SantiagoWeight ($24.01 in chips) 
Seat 3: naxizzle ($140.05 in chips) 
Seat 4: negreanuNya ($25 in chips) 
Seat 5: mistdog ($47.35 in chips) 
Seat 6: BirreteX ($27.36 in chips) 
SantiagoWeight: posts small blind $0.10
naxizzle: posts big blind $0.25
*** HOLE CARDS ***
Dealt to SantiagoWeight [7s Th]
negreanuNya: folds 
mistdog: folds 
BirreteX: folds 
zdenekstavic: folds 
SantiagoWeight: folds 
Uncalled bet ($0.15) returned to naxizzle
naxizzle collected $0.20 from pot
naxizzle: doesn't show hand 
*** SUMMARY ***
Total pot $0.20 | Rake $0 
Seat 1: zdenekstavic (button) folded before Flop (didn't bet)
Seat 2: SantiagoWeight (small blind) folded before Flop
Seat 3: naxizzle (big blind) collected ($0.20)
Seat 4: negreanuNya folded before Flop (didn't bet)
Seat 5: mistdog folded before Flop (didn't bet)
Seat 6: BirreteX folded before Flop (didn't bet)



PokerStars Zoom Hand #195023184575:  Hold'em No Limit ($0.10/$0.25) - 2018/12/29 3:27:15 UTC [2018/12/28 22:27:15 ET]
Table 'Hydra' 6-max Seat #1 is the button
Seat 1: SantiagoWeight ($23.91 in chips) 
Seat 2: deaglepro ($51.56 in chips) 
Seat 3: KeySssi ($25.25 in chips) 
Seat 4: GrandmasterY ($25.35 in chips) 
Seat 5: zdenekstavic ($44.76 in chips) 
Seat 6: yobbos ($65.71 in chips) 
deaglepro: posts small blind $0.10
KeySssi: posts big blind $0.25
*** HOLE CARDS ***
Dealt to SantiagoWeight [7h 6c]
GrandmasterY: raises $0.50 to $0.75
zdenekstavic: folds 
yobbos: folds 
SantiagoWeight: folds 
deaglepro: calls $0.65
KeySssi: folds 
*** FLOP *** [Td 3h 3s]
deaglepro: checks 
GrandmasterY: bets $0.67
deaglepro: folds 
Uncalled bet ($0.67) returned to GrandmasterY
GrandmasterY collected $1.67 from pot
GrandmasterY: doesn't show hand 
*** SUMMARY ***
Total pot $1.75 | Rake $0.08 
Board [Td 3h 3s]
Seat 1: SantiagoWeight (button) folded before Flop (didn't bet)
Seat 2: deaglepro (small blind) folded on the Flop
Seat 3: KeySssi (big blind) folded before Flop
Seat 4: GrandmasterY collected ($1.67)
Seat 5: zdenekstavic folded before Flop (didn't bet)
Seat 6: yobbos folded before Flop (didn't bet)



PokerStars Zoom Hand #195023181653:  Hold'em No Limit ($0.10/$0.25) - 2018/12/29 3:27:06 UTC [2018/12/28 22:27:06 ET]
Table 'Hydra' 6-max Seat #1 is the button
Seat 1: sigaro010 ($43.60 in chips) 
Seat 2: yobbos ($131.68 in chips) 
Seat 3: Dr.Jekyll197 ($34.66 in chips) 
Seat 4: SantiagoWeight ($24.01 in chips) 
Seat 5: angipoker ($12.50 in chips) 
Seat 6: !P0K3RM3T4L! ($61.60 in chips) 
yobbos: posts small blind $0.10
Dr.Jekyll197: posts big blind $0.25
*** HOLE CARDS ***
Dealt to SantiagoWeight [5d 6d]
SantiagoWeight: folds 
angipoker: folds 
!P0K3RM3T4L!: folds 
sigaro010: folds 
yobbos: raises $0.37 to $0.62
Dr.Jekyll197: raises $1.13 to $1.75
yobbos: calls $1.13
*** FLOP *** [5h 4h Kh]
yobbos: checks 
Dr.Jekyll197: bets $2.23
yobbos: calls $2.23
*** TURN *** [5h 4h Kh] [Qs]
yobbos: checks 
Dr.Jekyll197: bets $3.80
yobbos: folds 
Uncalled bet ($3.80) returned to Dr.Jekyll197
Dr.Jekyll197 collected $7.60 from pot
Dr.Jekyll197: doesn't show hand 
*** SUMMARY ***
Total pot $7.96 | Rake $0.36 
Board [5h 4h Kh Qs]
Seat 1: sigaro010 (button) folded before Flop (didn't bet)
Seat 2: yobbos (small blind) folded on the Turn
Seat 3: Dr.Jekyll197 (big blind) collected ($7.60)
Seat 4: SantiagoWeight folded before Flop (didn't bet)
Seat 5: angipoker folded before Flop (didn't bet)
Seat 6: !P0K3RM3T4L! folded before Flop (didn't bet)



PokerStars Zoom Hand #195023187567:  Hold'em No Limit ($0.10/$0.25) - 2018/12/29 3:27:24 UTC [2018/12/28 22:27:24 ET]
Table 'Hydra' 6-max Seat #1 is the button
Seat 1: gift-cloud9 ($31.13 in chips) 
Seat 2: naxizzle ($140.15 in chips) 
Seat 3: GQwang ($22.01 in chips) 
Seat 4: Mandu_xiii ($25.35 in chips) 
Seat 5: Renner32 ($27.25 in chips) 
Seat 6: SantiagoWeight ($23.91 in chips) 
naxizzle: posts small blind $0.10
GQwang: posts big blind $0.25
*** HOLE CARDS ***
Dealt to SantiagoWeight [5c 5s]
Mandu_xiii: folds 
Renner32: folds 
SantiagoWeight: raises $0.30 to $0.55
gift-cloud9: folds 
naxizzle: calls $0.45
GQwang: calls $0.30
*** FLOP *** [Td Kc 4s]
naxizzle: checks 
GQwang: checks 
SantiagoWeight: checks 
*** TURN *** [Td Kc 4s] [3d]
naxizzle: bets $1.50
GQwang: calls $1.50
SantiagoWeight: folds 
*** RIVER *** [Td Kc 4s 3d] [8h]
naxizzle: bets $4.50
GQwang: calls $4.50
*** SHOW DOWN ***
naxizzle: shows [Qc Kd] (a pair of Kings)
GQwang: mucks hand 
naxizzle collected $13.04 from pot
*** SUMMARY ***
Total pot $13.65 | Rake $0.61 
Board [Td Kc 4s 3d 8h]
Seat 1: gift-cloud9 (button) folded before Flop (didn't bet)
Seat 2: naxizzle (small blind) showed [Qc Kd] and won ($13.04) with a pair of Kings
Seat 3: GQwang (big blind) mucked [Jc Ks]
Seat 4: Mandu_xiii folded before Flop (didn't bet)
Seat 5: Renner32 folded before Flop (didn't bet)
Seat 6: SantiagoWeight folded on the Turn



PokerStars Zoom Hand #195023200145:  Hold'em No Limit ($0.10/$0.25) - 2018/12/29 3:28:02 UTC [2018/12/28 22:28:02 ET]
Table 'Hydra' 6-max Seat #1 is the button
Seat 1: nadal335 ($23.75 in chips) 
Seat 2: G ster24 ($26.48 in chips) 
Seat 3: ttshead ($66.38 in chips) 
Seat 4: SantiagoWeight ($23.36 in chips) 
Seat 5: TQNYMQNTANA ($28.03 in chips) 
Seat 6: sigaro010 ($43.85 in chips) 
G ster24: posts small blind $0.10
ttshead: posts big blind $0.25
*** HOLE CARDS ***
Dealt to SantiagoWeight [Qc Jc]
SantiagoWeight: raises $0.42 to $0.67
TQNYMQNTANA: folds 
sigaro010: folds 
nadal335: folds 
G ster24: folds 
ttshead: calls $0.42
*** FLOP *** [Qh 4c Jh]
ttshead: checks 
SantiagoWeight: bets $1.38
ttshead: folds 
Uncalled bet ($1.38) returned to SantiagoWeight
SantiagoWeight collected $1.38 from pot
SantiagoWeight: doesn't show hand 
*** SUMMARY ***
Total pot $1.44 | Rake $0.06 
Board [Qh 4c Jh]
Seat 1: nadal335 (button) folded before Flop (didn't bet)
Seat 2: G ster24 (small blind) folded before Flop
Seat 3: ttshead (big blind) folded on the Flop
Seat 4: SantiagoWeight collected ($1.38)
Seat 5: TQNYMQNTANA folded before Flop (didn't bet)
Seat 6: sigaro010 folded before Flop (didn't bet)



PokerStars Zoom Hand #195023207471:  Hold'em No Limit ($0.10/$0.25) - 2018/12/29 3:28:24 UTC [2018/12/28 22:28:24 ET]
Table 'Hydra' 6-max Seat #1 is the button
Seat 1: Gf Chipz ($24.76 in chips) 
Seat 2: osa126 ($30.46 in chips) 
Seat 3: Lehared ($107.17 in chips) 
Seat 4: KrishnaRadha ($8.58 in chips) 
Seat 5: SantiagoWeight ($25 in chips) 
Seat 6: !P0K3RM3T4L! ($25.49 in chips) 
osa126: posts small blind $0.10
Lehared: posts big blind $0.25
*** HOLE CARDS ***
Dealt to SantiagoWeight [7s Kh]
KrishnaRadha: folds 
SantiagoWeight: folds 
!P0K3RM3T4L!: folds 
Gf Chipz: raises $0.75 to $1
osa126: folds 
Lehared: folds 
Uncalled bet ($0.75) returned to Gf Chipz
Gf Chipz collected $0.60 from pot
Gf Chipz: doesn't show hand 
*** SUMMARY ***
Total pot $0.60 | Rake $0 
Seat 1: Gf Chipz (button) collected ($0.60)
Seat 2: osa126 (small blind) folded before Flop
Seat 3: Lehared (big blind) folded before Flop
Seat 4: KrishnaRadha folded before Flop (didn't bet)
Seat 5: SantiagoWeight folded before Flop (didn't bet)
Seat 6: !P0K3RM3T4L! folded before Flop (didn't bet)



PokerStars Zoom Hand #195023210157:  Hold'em No Limit ($0.10/$0.25) - 2018/12/29 3:28:32 UTC [2018/12/28 22:28:32 ET]
Table 'Hydra' 6-max Seat #1 is the button
Seat 1: Chrimmpam ($24.05 in chips) 
Seat 2: yobbos ($25 in chips) 
Seat 3: SantiagoWeight ($25 in chips) 
Seat 4: rim975 ($9.75 in chips) 
Seat 5: nhanminhtri ($25.25 in chips) 
Seat 6: BnanaBread13 ($25 in chips) 
yobbos: posts small blind $0.10
SantiagoWeight: posts big blind $0.25
*** HOLE CARDS ***
Dealt to SantiagoWeight [Kd 3s]
rim975: folds 
nhanminhtri: folds 
BnanaBread13: raises $0.37 to $0.62
Chrimmpam: calls $0.62
yobbos: folds 
SantiagoWeight: folds 
*** FLOP *** [7s Tc Kc]
BnanaBread13: checks 
Chrimmpam: bets $0.75
BnanaBread13: folds 
Uncalled bet ($0.75) returned to Chrimmpam
Chrimmpam collected $1.52 from pot
Chrimmpam: doesn't show hand 
*** SUMMARY ***
Total pot $1.59 | Rake $0.07 
Board [7s Tc Kc]
Seat 1: Chrimmpam (button) collected ($1.52)
Seat 2: yobbos (small blind) folded before Flop
Seat 3: SantiagoWeight (big blind) folded before Flop
Seat 4: rim975 folded before Flop (didn't bet)
Seat 5: nhanminhtri folded before Flop (didn't bet)
Seat 6: BnanaBread13 folded on the Flop



PokerStars Zoom Hand #195023214846:  Hold'em No Limit ($0.10/$0.25) - 2018/12/29 3:28:46 UTC [2018/12/28 22:28:46 ET]
Table 'Hydra' 6-max Seat #1 is the button
Seat 1: BMB8888 ($47.14 in chips) 
Seat 2: cankum ($29.92 in chips) 
Seat 3: Doomdigidoom ($17 in chips) 
Seat 4: Dr.Jekyll197 ($38.53 in chips) 
Seat 5: papuStin ($21.57 in chips) 
Seat 6: SantiagoWeight ($24.75 in chips) 
cankum: posts small blind $0.10
Doomdigidoom: posts big blind $0.25
*** HOLE CARDS ***
Dealt to SantiagoWeight [5c 3d]
Dr.Jekyll197: folds 
papuStin: folds 
SantiagoWeight: folds 
BMB8888: calls $0.25
cankum: raises $1 to $1.25
Doomdigidoom: folds 
BMB8888: calls $1
*** FLOP *** [6s Jc Ad]
cankum: checks 
BMB8888: bets $0.50
cankum: calls $0.50
*** TURN *** [6s Jc Ad] [Js]
cankum: checks 
BMB8888: bets $0.50
cankum: calls $0.50
*** RIVER *** [6s Jc Ad Js] [Ks]
cankum: checks 
BMB8888: bets $0.50
cankum: raises $4.75 to $5.25
BMB8888: calls $4.75
*** SHOW DOWN ***
cankum: shows [Kc Kd] (a full house, Kings full of Jacks)
BMB8888: mucks hand 
cankum collected $14.56 from pot
*** SUMMARY ***
Total pot $15.25 | Rake $0.69 
Board [6s Jc Ad Js Ks]
Seat 1: BMB8888 (button) mucked [9d Ah]
Seat 2: cankum (small blind) showed [Kc Kd] and won ($14.56) with a full house, Kings full of Jacks
Seat 3: Doomdigidoom (big blind) folded before Flop
Seat 4: Dr.Jekyll197 folded before Flop (didn't bet)
Seat 5: papuStin folded before Flop (didn't bet)
Seat 6: SantiagoWeight folded before Flop (didn't bet)



PokerStars Zoom Hand #195023216193:  Hold'em No Limit ($0.10/$0.25) - 2018/12/29 3:28:50 UTC [2018/12/28 22:28:50 ET]
Table 'Hydra' 6-max Seat #1 is the button
Seat 1: pfunkolstar ($30.21 in chips) 
Seat 2: SantiagoWeight ($24.75 in chips) 
Seat 3: nadal335 ($76.50 in chips) 
Seat 4: gingdog ($19.98 in chips) 
Seat 5: deaglepro ($51.60 in chips) 
Seat 6: Ushite209 ($24.65 in chips) 
SantiagoWeight: posts small blind $0.10
nadal335: posts big blind $0.25
*** HOLE CARDS ***
Dealt to SantiagoWeight [6h 7h]
gingdog: folds 
deaglepro: folds 
Ushite209: raises $0.37 to $0.62
pfunkolstar: folds 
SantiagoWeight: raises $1.58 to $2.20
nadal335: folds 
Ushite209: calls $1.58
*** FLOP *** [As 2c Td]
SantiagoWeight: bets $1.11
Ushite209: calls $1.11
*** TURN *** [As 2c Td] [4d]
SantiagoWeight: checks 
Ushite209: checks 
*** RIVER *** [As 2c Td 4d] [Qh]
SantiagoWeight: bets $7.87
Ushite209: calls $7.87
*** SHOW DOWN ***
SantiagoWeight: shows [6h 7h] (high card Ace)
Ushite209: shows [Ad Js] (a pair of Aces)
Ushite209 collected $21.59 from pot
*** SUMMARY ***
Total pot $22.61 | Rake $1.02 
Board [As 2c Td 4d Qh]
Seat 1: pfunkolstar (button) folded before Flop (didn't bet)
Seat 2: SantiagoWeight (small blind) showed [6h 7h] and lost with high card Ace
Seat 3: nadal335 (big blind) folded before Flop
Seat 4: gingdog folded before Flop (didn't bet)
Seat 5: deaglepro folded before Flop (didn't bet)
Seat 6: Ushite209 showed [Ad Js] and won ($21.59) with a pair of Aces



PokerStars Zoom Hand #195023243127:  Hold'em No Limit ($0.10/$0.25) - 2018/12/29 3:30:11 UTC [2018/12/28 22:30:11 ET]
Table 'Hydra' 6-max Seat #1 is the button
Seat 1: SantiagoWeight ($13.57 in chips) 
Seat 2: zxlazy ($14.62 in chips) 
Seat 3: franco373513 ($12.59 in chips) 
Seat 4: ckriszee ($27.44 in chips) 
Seat 5: Ushite209 ($35.06 in chips) 
Seat 6: gift-cloud9 ($31.06 in chips) 
zxlazy: posts small blind $0.10
franco373513: posts big blind $0.25
*** HOLE CARDS ***
Dealt to SantiagoWeight [7c 7h]
ckriszee: raises $0.35 to $0.60
Ushite209: folds 
gift-cloud9: calls $0.60
SantiagoWeight: calls $0.60
zxlazy: folds 
franco373513: calls $0.35
*** FLOP *** [Jc Qh Qs]
franco373513: checks 
ckriszee: checks 
gift-cloud9: bets $1.40
SantiagoWeight: folds 
franco373513: calls $1.40
ckriszee: folds 
*** TURN *** [Jc Qh Qs] [Qd]
franco373513: checks 
gift-cloud9: checks 
*** RIVER *** [Jc Qh Qs Qd] [8s]
franco373513: bets $10.59 and is all-in
gift-cloud9: calls $10.59
*** SHOW DOWN ***
franco373513: shows [Jh Qc] (four of a kind, Queens)
gift-cloud9: shows [Td Tc] (a full house, Queens full of Tens)
franco373513 collected $25.29 from pot
*** SUMMARY ***
Total pot $26.48 | Rake $1.19 
Board [Jc Qh Qs Qd 8s]
Seat 1: SantiagoWeight (button) folded on the Flop
Seat 2: zxlazy (small blind) folded before Flop
Seat 3: franco373513 (big blind) showed [Jh Qc] and won ($25.29) with four of a kind, Queens
Seat 4: ckriszee folded on the Flop
Seat 5: Ushite209 folded before Flop (didn't bet)
Seat 6: gift-cloud9 showed [Td Tc] and lost with a full house, Queens full of Tens



PokerStars Zoom Hand #195023262819:  Hold'em No Limit ($0.10/$0.25) - 2018/12/29 3:31:10 UTC [2018/12/28 22:31:10 ET]
Table 'Hydra' 6-max Seat #1 is the button
Seat 1: ttshead ($64.15 in chips) 
Seat 2: TQNYMQNTANA ($25.68 in chips) 
Seat 3: angipoker ($12.50 in chips) 
Seat 4: Josip1119 ($29.09 in chips) 
Seat 5: SantiagoWeight ($22.72 in chips) 
Seat 6: nadal335 ($75.45 in chips) 
TQNYMQNTANA: posts small blind $0.10
angipoker: posts big blind $0.25
*** HOLE CARDS ***
Dealt to SantiagoWeight [Kh 8h]
Josip1119: folds 
SantiagoWeight: raises $0.37 to $0.62
nadal335: calls $0.62
ttshead: folds 
TQNYMQNTANA: folds 
angipoker: folds 
*** FLOP *** [5d 4h 2s]
SantiagoWeight: checks 
nadal335: bets $1
SantiagoWeight: folds 
Uncalled bet ($1) returned to nadal335
nadal335 collected $1.52 from pot
nadal335: doesn't show hand 
*** SUMMARY ***
Total pot $1.59 | Rake $0.07 
Board [5d 4h 2s]
Seat 1: ttshead (button) folded before Flop (didn't bet)
Seat 2: TQNYMQNTANA (small blind) folded before Flop
Seat 3: angipoker (big blind) folded before Flop
Seat 4: Josip1119 folded before Flop (didn't bet)
Seat 5: SantiagoWeight folded on the Flop
Seat 6: nadal335 collected ($1.52)



PokerStars Zoom Hand #195023253209:  Hold'em No Limit ($0.10/$0.25) - 2018/12/29 3:30:41 UTC [2018/12/28 22:30:41 ET]
Table 'Hydra' 6-max Seat #1 is the button
Seat 1: winwinboy ($29.51 in chips) 
Seat 2: Dr.Jekyll197 ($37.58 in chips) 
Seat 3: SantiagoWeight ($22.97 in chips) 
Seat 4: alex3d1985 ($51.63 in chips) 
Seat 5: sZCzpNtheKot ($27.15 in chips) 
Seat 6: miru877 ($25.43 in chips) 
Dr.Jekyll197: posts small blind $0.10
SantiagoWeight: posts big blind $0.25
*** HOLE CARDS ***
Dealt to SantiagoWeight [Ad 3c]
alex3d1985: folds 
sZCzpNtheKot: folds 
miru877: raises $0.50 to $0.75
winwinboy: calls $0.75
Dr.Jekyll197: folds 
SantiagoWeight: folds 
*** FLOP *** [9s 5d Kc]
miru877: checks 
winwinboy: bets $0.75
miru877: calls $0.75
*** TURN *** [9s 5d Kc] [4s]
miru877: checks 
winwinboy: checks 
*** RIVER *** [9s 5d Kc 4s] [7h]
miru877: checks 
winwinboy: checks 
*** SHOW DOWN ***
miru877: shows [8h 8s] (a pair of Eights)
winwinboy: mucks hand 
miru877 collected $3.20 from pot
*** SUMMARY ***
Total pot $3.35 | Rake $0.15 
Board [9s 5d Kc 4s 7h]
Seat 1: winwinboy (button) mucked [Qh Tc]
Seat 2: Dr.Jekyll197 (small blind) folded before Flop
Seat 3: SantiagoWeight (big blind) folded before Flop
Seat 4: alex3d1985 folded before Flop (didn't bet)
Seat 5: sZCzpNtheKot folded before Flop (didn't bet)
Seat 6: miru877 showed [8h 8s] and won ($3.20) with a pair of Eights



PokerStars Zoom Hand #195023276791:  Hold'em No Limit ($0.10/$0.25) - 2018/12/29 3:31:52 UTC [2018/12/28 22:31:52 ET]
Table 'Hydra' 6-max Seat #1 is the button
Seat 1: Viiiru ($33.56 in chips) 
Seat 2: ryanking99 ($49.10 in chips) 
Seat 3: mariopork ($43.16 in chips) 
Seat 4: SantiagoWeight ($22.10 in chips) 
Seat 5: keenakeena73 ($26.94 in chips) 
Seat 6: Baboscrubx ($32.37 in chips) 
ryanking99: posts small blind $0.10
mariopork: posts big blind $0.25
*** HOLE CARDS ***
Dealt to SantiagoWeight [Ad 9d]
SantiagoWeight: raises $0.42 to $0.67
keenakeena73: folds 
Baboscrubx: folds 
Viiiru: folds 
ryanking99: folds 
mariopork: folds 
Uncalled bet ($0.42) returned to SantiagoWeight
SantiagoWeight collected $0.60 from pot
SantiagoWeight: doesn't show hand 
*** SUMMARY ***
Total pot $0.60 | Rake $0 
Seat 1: Viiiru (button) folded before Flop (didn't bet)
Seat 2: ryanking99 (small blind) folded before Flop
Seat 3: mariopork (big blind) folded before Flop
Seat 4: SantiagoWeight collected ($0.60)
Seat 5: keenakeena73 folded before Flop (didn't bet)
Seat 6: Baboscrubx folded before Flop (didn't bet)



PokerStars Zoom Hand #195023287495:  Hold'em No Limit ($0.10/$0.25) - 2018/12/29 3:32:24 UTC [2018/12/28 22:32:24 ET]
Table 'Hydra' 6-max Seat #1 is the button
Seat 1: _BluDeeN_ ($24 in chips) 
Seat 2: SantiagoWeight ($22.45 in chips) 
Seat 3: sZCzpNtheKot ($27.70 in chips) 
Seat 4: Nutselas ($30.16 in chips) 
Seat 5: Chrimmpam ($19.20 in chips) 
Seat 6: Viiiru ($33.21 in chips) 
SantiagoWeight: posts small blind $0.10
sZCzpNtheKot: posts big blind $0.25
*** HOLE CARDS ***
Dealt to SantiagoWeight [Kc 5c]
Nutselas: folds 
Chrimmpam: folds 
Viiiru: raises $0.37 to $0.62
_BluDeeN_: folds 
SantiagoWeight: folds 
sZCzpNtheKot: folds 
Uncalled bet ($0.37) returned to Viiiru
Viiiru collected $0.60 from pot
Viiiru: doesn't show hand 
*** SUMMARY ***
Total pot $0.60 | Rake $0 
Seat 1: _BluDeeN_ (button) folded before Flop (didn't bet)
Seat 2: SantiagoWeight (small blind) folded before Flop
Seat 3: sZCzpNtheKot (big blind) folded before Flop
Seat 4: Nutselas folded before Flop (didn't bet)
Seat 5: Chrimmpam folded before Flop (didn't bet)
Seat 6: Viiiru collected ($0.60)



PokerStars Zoom Hand #195023282897:  Hold'em No Limit ($0.10/$0.25) - 2018/12/29 3:32:10 UTC [2018/12/28 22:32:10 ET]
Table 'Hydra' 6-max Seat #1 is the button
Seat 1: zbuci ($31.49 in chips) 
Seat 2: yobbos ($136.86 in chips) 
Seat 3: !P0K3RM3T4L! ($60.89 in chips) 
Seat 4: zhang1zhang ($31.08 in chips) 
Seat 5: mayadelrey ($67.24 in chips) 
Seat 6: SantiagoWeight ($22.45 in chips) 
yobbos: posts small blind $0.10
!P0K3RM3T4L!: posts big blind $0.25
*** HOLE CARDS ***
Dealt to SantiagoWeight [Ts 3s]
zhang1zhang: raises $0.50 to $0.75
mayadelrey: folds 
SantiagoWeight: folds 
zbuci: folds 
yobbos: calls $0.65
!P0K3RM3T4L!: calls $0.50
*** FLOP *** [Td 3d 8s]
yobbos: checks 
!P0K3RM3T4L!: checks 
zhang1zhang: bets $1.43
yobbos: folds 
!P0K3RM3T4L!: folds 
Uncalled bet ($1.43) returned to zhang1zhang
zhang1zhang collected $2.15 from pot
zhang1zhang: doesn't show hand 
*** SUMMARY ***
Total pot $2.25 | Rake $0.10 
Board [Td 3d 8s]
Seat 1: zbuci (button) folded before Flop (didn't bet)
Seat 2: yobbos (small blind) folded on the Flop
Seat 3: !P0K3RM3T4L! (big blind) folded on the Flop
Seat 4: zhang1zhang collected ($2.15)
Seat 5: mayadelrey folded before Flop (didn't bet)
Seat 6: SantiagoWeight folded before Flop (didn't bet)



PokerStars Zoom Hand #195023292529:  Hold'em No Limit ($0.10/$0.25) - 2018/12/29 3:32:39 UTC [2018/12/28 22:32:39 ET]
Table 'Hydra' 6-max Seat #1 is the button
Seat 1: deaglepro ($58.52 in chips) 
Seat 2: _BluDeeN_ ($35.92 in chips) 
Seat 3: assassin0875 ($181.24 in chips) 
Seat 4: SantiagoWeight ($22.35 in chips) 
Seat 5: Nutselas ($30.06 in chips) 
Seat 6: yobbos ($69.53 in chips) 
_BluDeeN_: posts small blind $0.10
assassin0875: posts big blind $0.25
*** HOLE CARDS ***
Dealt to SantiagoWeight [Jc 5c]
SantiagoWeight: folds 
Nutselas: folds 
yobbos: raises $0.37 to $0.62
deaglepro: raises $1.59 to $2.21
_BluDeeN_: folds 
assassin0875: folds 
yobbos: folds 
Uncalled bet ($1.59) returned to deaglepro
deaglepro collected $1.59 from pot
deaglepro: doesn't show hand 
*** SUMMARY ***
Total pot $1.59 | Rake $0 
Seat 1: deaglepro (button) collected ($1.59)
Seat 2: _BluDeeN_ (small blind) folded before Flop
Seat 3: assassin0875 (big blind) folded before Flop
Seat 4: SantiagoWeight folded before Flop (didn't bet)
Seat 5: Nutselas folded before Flop (didn't bet)
Seat 6: yobbos folded before Flop



PokerStars Zoom Hand #195023294211:  Hold'em No Limit ($0.10/$0.25) - 2018/12/29 3:32:44 UTC [2018/12/28 22:32:44 ET]
Table 'Hydra' 6-max Seat #1 is the button
Seat 1: SantiagoWeight ($22.35 in chips) 
Seat 2: negreanuNya ($33.32 in chips) 
Seat 3: mariopork ($42.81 in chips) 
Seat 4: HonourMan23 ($38.02 in chips) 
Seat 5: zdena102 ($14.36 in chips) 
Seat 6: miru877 ($27.13 in chips) 
negreanuNya: posts small blind $0.10
mariopork: posts big blind $0.25
*** HOLE CARDS ***
Dealt to SantiagoWeight [9h Ts]
HonourMan23: folds 
zdena102: folds 
miru877: folds 
SantiagoWeight: raises $0.30 to $0.55
negreanuNya: folds 
mariopork: raises $2.15 to $2.70
SantiagoWeight: folds 
Uncalled bet ($2.15) returned to mariopork
mariopork collected $1.20 from pot
*** SUMMARY ***
Total pot $1.20 | Rake $0 
Seat 1: SantiagoWeight (button) folded before Flop
Seat 2: negreanuNya (small blind) folded before Flop
Seat 3: mariopork (big blind) collected ($1.20)
Seat 4: HonourMan23 folded before Flop (didn't bet)
Seat 5: zdena102 folded before Flop (didn't bet)
Seat 6: miru877 folded before Flop (didn't bet)



PokerStars Zoom Hand #195023306827:  Hold'em No Limit ($0.10/$0.25) - 2018/12/29 3:33:22 UTC [2018/12/28 22:33:22 ET]
Table 'Hydra' 6-max Seat #1 is the button
Seat 1: !P0K3RM3T4L! ($60.04 in chips) 
Seat 2: Baboscrubx ($36.28 in chips) 
Seat 3: SantiagoWeight ($24.45 in chips) 
Seat 4: Renner32 ($25.98 in chips) 
Seat 5: MoMoney2612 ($25.85 in chips) 
Seat 6: FSK78 ($33.89 in chips) 
Baboscrubx: posts small blind $0.10
SantiagoWeight: posts big blind $0.25
*** HOLE CARDS ***
Dealt to SantiagoWeight [3h Qc]
Renner32: folds 
MoMoney2612: folds 
FSK78: raises $0.77 to $1.02
!P0K3RM3T4L!: folds 
Baboscrubx: folds 
SantiagoWeight: folds 
Uncalled bet ($0.77) returned to FSK78
FSK78 collected $0.60 from pot
*** SUMMARY ***
Total pot $0.60 | Rake $0 
Seat 1: !P0K3RM3T4L! (button) folded before Flop (didn't bet)
Seat 2: Baboscrubx (small blind) folded before Flop
Seat 3: SantiagoWeight (big blind) folded before Flop
Seat 4: Renner32 folded before Flop (didn't bet)
Seat 5: MoMoney2612 folded before Flop (didn't bet)
Seat 6: FSK78 collected ($0.60)



PokerStars Zoom Hand #195023310823:  Hold'em No Limit ($0.10/$0.25) - 2018/12/29 3:33:34 UTC [2018/12/28 22:33:34 ET]
Table 'Hydra' 6-max Seat #1 is the button
Seat 1: Viiiru ($27.16 in chips) 
Seat 2: trttt74 ($7.05 in chips) 
Seat 3: zdenekstavic ($41.30 in chips) 
Seat 4: ttshead ($63.64 in chips) 
Seat 5: SantiagoWeight ($24.20 in chips) 
Seat 6: kyracarmen ($51.30 in chips) 
trttt74: posts small blind $0.10
zdenekstavic: posts big blind $0.25
*** HOLE CARDS ***
Dealt to SantiagoWeight [Ah 7h]
ttshead: folds 
SantiagoWeight: raises $0.37 to $0.62
kyracarmen: folds 
Viiiru: folds 
trttt74: folds 
zdenekstavic: calls $0.37
*** FLOP *** [8s Ac 7d]
zdenekstavic: checks 
SantiagoWeight: bets $0.60
zdenekstavic: calls $0.60
*** TURN *** [8s Ac 7d] [Th]
zdenekstavic: checks 
SantiagoWeight: bets $1.90
zdenekstavic: calls $1.90
*** RIVER *** [8s Ac 7d Th] [4s]
zdenekstavic: checks 
SantiagoWeight: bets $7.10
zdenekstavic said, "rettardd?"
zdenekstavic: folds 
Uncalled bet ($7.10) returned to SantiagoWeight
SantiagoWeight collected $6.05 from pot
SantiagoWeight: doesn't show hand 
SantiagoWeight said, "lol"
*** SUMMARY ***
Total pot $6.34 | Rake $0.29 
Board [8s Ac 7d Th 4s]
Seat 1: Viiiru (button) folded before Flop (didn't bet)
Seat 2: trttt74 (small blind) folded before Flop
Seat 3: zdenekstavic (big blind) folded on the River
Seat 4: ttshead folded before Flop (didn't bet)
Seat 5: SantiagoWeight collected ($6.05)
Seat 6: kyracarmen folded before Flop (didn't bet)



PokerStars Zoom Hand #195023335390:  Hold'em No Limit ($0.10/$0.25) - 2018/12/29 3:34:48 UTC [2018/12/28 22:34:48 ET]
Table 'Hydra' 6-max Seat #1 is the button
Seat 1: SantiagoWeight ($27.03 in chips) 
Seat 2: Baboscrubx ($33.33 in chips) 
Seat 3: river plate9 ($19.65 in chips) 
Seat 4: GrandmasterY ($25 in chips) 
Seat 5: fishnm2018 ($25 in chips) 
Seat 6: yobbos ($28.47 in chips) 
Baboscrubx: posts small blind $0.10
river plate9: posts big blind $0.25
*** HOLE CARDS ***
Dealt to SantiagoWeight [8s Jh]
GrandmasterY: raises $0.50 to $0.75
fishnm2018: folds 
yobbos: folds 
SantiagoWeight: folds 
Baboscrubx: folds 
river plate9: folds 
Uncalled bet ($0.50) returned to GrandmasterY
GrandmasterY collected $0.60 from pot
GrandmasterY: doesn't show hand 
*** SUMMARY ***
Total pot $0.60 | Rake $0 
Seat 1: SantiagoWeight (button) folded before Flop (didn't bet)
Seat 2: Baboscrubx (small blind) folded before Flop
Seat 3: river plate9 (big blind) folded before Flop
Seat 4: GrandmasterY collected ($0.60)
Seat 5: fishnm2018 folded before Flop (didn't bet)
Seat 6: yobbos folded before Flop (didn't bet)



PokerStars Zoom Hand #195023331398:  Hold'em No Limit ($0.10/$0.25) - 2018/12/29 3:34:36 UTC [2018/12/28 22:34:36 ET]
Table 'Hydra' 6-max Seat #1 is the button
Seat 1: river plate9 ($22.68 in chips) 
Seat 2: SantiagoWeight ($27.13 in chips) 
Seat 3: donmarc777 ($29.02 in chips) 
Seat 4: gannelinn ($32.94 in chips) 
Seat 5: miru877 ($27.13 in chips) 
Seat 6: Chrimmpam ($20.99 in chips) 
SantiagoWeight: posts small blind $0.10
donmarc777: posts big blind $0.25
*** HOLE CARDS ***
Dealt to SantiagoWeight [9c Th]
gannelinn: raises $0.87 to $1.12
miru877: folds 
Chrimmpam: calls $1.12
river plate9: folds 
SantiagoWeight: folds 
donmarc777: folds 
*** FLOP *** [Kc As Js]
gannelinn: bets $1.73
Chrimmpam: calls $1.73
*** TURN *** [Kc As Js] [Jh]
gannelinn: bets $4.05
Chrimmpam: calls $4.05
*** RIVER *** [Kc As Js Jh] [8d]
gannelinn: bets $9.46
Chrimmpam: calls $9.46
*** SHOW DOWN ***
gannelinn: shows [Ac 4d] (two pair, Aces and Jacks)
Chrimmpam: shows [9d Ad] (two pair, Aces and Jacks)
gannelinn collected $15.79 from pot
Chrimmpam collected $15.79 from pot
*** SUMMARY ***
Total pot $33.07 | Rake $1.49 
Board [Kc As Js Jh 8d]
Seat 1: river plate9 (button) folded before Flop (didn't bet)
Seat 2: SantiagoWeight (small blind) folded before Flop
Seat 3: donmarc777 (big blind) folded before Flop
Seat 4: gannelinn showed [Ac 4d] and won ($15.79) with two pair, Aces and Jacks
Seat 5: miru877 folded before Flop (didn't bet)
Seat 6: Chrimmpam showed [9d Ad] and won ($15.79) with two pair, Aces and Jacks



PokerStars Zoom Hand #195023342017:  Hold'em No Limit ($0.10/$0.25) - 2018/12/29 3:35:08 UTC [2018/12/28 22:35:08 ET]
Table 'Hydra' 6-max Seat #1 is the button
Seat 1: nadal335 ($58.29 in chips) 
Seat 2: SunMiXaMiXS ($12.79 in chips) 
Seat 3: Actarusqc ($17.65 in chips) 
Seat 4: SantiagoWeight ($27.03 in chips) 
Seat 5: Slim Wolfie ($33.72 in chips) 
Seat 6: angipoker ($13.30 in chips) 
SunMiXaMiXS: posts small blind $0.10
Actarusqc: posts big blind $0.25
*** HOLE CARDS ***
Dealt to SantiagoWeight [Kc Kh]
SantiagoWeight: raises $0.42 to $0.67
Slim Wolfie: folds 
angipoker: folds 
nadal335: folds 
SunMiXaMiXS: folds 
Actarusqc: folds 
Uncalled bet ($0.42) returned to SantiagoWeight
SantiagoWeight collected $0.60 from pot
SantiagoWeight: doesn't show hand 
*** SUMMARY ***
Total pot $0.60 | Rake $0 
Seat 1: nadal335 (button) folded before Flop (didn't bet)
Seat 2: SunMiXaMiXS (small blind) folded before Flop
Seat 3: Actarusqc (big blind) folded before Flop
Seat 4: SantiagoWeight collected ($0.60)
Seat 5: Slim Wolfie folded before Flop (didn't bet)
Seat 6: angipoker folded before Flop (didn't bet)



PokerStars Zoom Hand #195023338147:  Hold'em No Limit ($0.10/$0.25) - 2018/12/29 3:34:56 UTC [2018/12/28 22:34:56 ET]
Table 'Hydra' 6-max Seat #1 is the button
Seat 1: Slim Wolfie ($33.72 in chips) 
Seat 2: mariopork ($44.14 in chips) 
Seat 3: davidhw888 ($53.98 in chips) 
Seat 4: ckriszee ($42.19 in chips) 
Seat 5: Baboscrubx ($25.40 in chips) 
Seat 6: SantiagoWeight ($27.03 in chips) 
mariopork: posts small blind $0.10
davidhw888: posts big blind $0.25
*** HOLE CARDS ***
Dealt to SantiagoWeight [3h 5c]
ckriszee: raises $0.35 to $0.60
Baboscrubx: folds 
SantiagoWeight: folds 
Slim Wolfie: folds 
mariopork: raises $2.60 to $3.20
davidhw888: folds 
ckriszee: folds 
Uncalled bet ($2.60) returned to mariopork
mariopork collected $1.45 from pot
mariopork: doesn't show hand 
*** SUMMARY ***
Total pot $1.45 | Rake $0 
Seat 1: Slim Wolfie (button) folded before Flop (didn't bet)
Seat 2: mariopork (small blind) collected ($1.45)
Seat 3: davidhw888 (big blind) folded before Flop
Seat 4: ckriszee folded before Flop
Seat 5: Baboscrubx folded before Flop (didn't bet)
Seat 6: SantiagoWeight folded before Flop (didn't bet)



PokerStars Zoom Hand #195023345641:  Hold'em No Limit ($0.10/$0.25) - 2018/12/29 3:35:19 UTC [2018/12/28 22:35:19 ET]
Table 'Hydra' 6-max Seat #1 is the button
Seat 1: ryanking99 ($22.40 in chips) 
Seat 2: golf7287 ($34.06 in chips) 
Seat 3: SantiagoWeight ($27.38 in chips) 
Seat 4: ivann14 ($85.07 in chips) 
Seat 5: Chrimmpam ($19.59 in chips) 
Seat 6: Actarusqc ($17.30 in chips) 
golf7287: posts small blind $0.10
SantiagoWeight: posts big blind $0.25
*** HOLE CARDS ***
Dealt to SantiagoWeight [7c Jd]
ivann14: folds 
Chrimmpam: folds 
Actarusqc: calls $0.25
ryanking99: folds 
golf7287: folds 
SantiagoWeight: checks 
*** FLOP *** [4d 8h 2c]
SantiagoWeight: checks 
Actarusqc: bets $0.50
SantiagoWeight: folds 
Uncalled bet ($0.50) returned to Actarusqc
Actarusqc collected $0.57 from pot
*** SUMMARY ***
Total pot $0.60 | Rake $0.03 
Board [4d 8h 2c]
Seat 1: ryanking99 (button) folded before Flop (didn't bet)
Seat 2: golf7287 (small blind) folded before Flop
Seat 3: SantiagoWeight (big blind) folded on the Flop
Seat 4: ivann14 folded before Flop (didn't bet)
Seat 5: Chrimmpam folded before Flop (didn't bet)
Seat 6: Actarusqc collected ($0.57)



PokerStars Zoom Hand #195023365738:  Hold'em No Limit ($0.10/$0.25) - 2018/12/29 3:36:20 UTC [2018/12/28 22:36:20 ET]
Table 'Hydra' 6-max Seat #1 is the button
Seat 1: Lehared ($35.88 in chips) 
Seat 2: KeySssi ($26.36 in chips) 
Seat 3: denisss1801 ($15 in chips) 
Seat 4: Baboscrubx ($33.78 in chips) 
Seat 5: negreanuNya ($29.70 in chips) 
Seat 6: SantiagoWeight ($27.13 in chips) 
KeySssi: posts small blind $0.10
denisss1801: posts big blind $0.25
*** HOLE CARDS ***
Dealt to SantiagoWeight [Ks 5d]
Baboscrubx: folds 
negreanuNya: folds 
SantiagoWeight: folds 
Lehared: folds 
KeySssi: raises $0.50 to $0.75
denisss1801: folds 
Uncalled bet ($0.50) returned to KeySssi
KeySssi collected $0.50 from pot
KeySssi: doesn't show hand 
*** SUMMARY ***
Total pot $0.50 | Rake $0 
Seat 1: Lehared (button) folded before Flop (didn't bet)
Seat 2: KeySssi (small blind) collected ($0.50)
Seat 3: denisss1801 (big blind) folded before Flop
Seat 4: Baboscrubx folded before Flop (didn't bet)
Seat 5: negreanuNya folded before Flop (didn't bet)
Seat 6: SantiagoWeight folded before Flop (didn't bet)



PokerStars Zoom Hand #195023369575:  Hold'em No Limit ($0.10/$0.25) - 2018/12/29 3:36:32 UTC [2018/12/28 22:36:32 ET]
Table 'Hydra' 6-max Seat #1 is the button
Seat 1: graysonai ($25.38 in chips) 
Seat 2: deaglepro ($64.71 in chips) 
Seat 3: Jack123985 ($31.10 in chips) 
Seat 4: SantiagoWeight ($27.13 in chips) 
Seat 5: cankum ($25 in chips) 
Seat 6: pirosiky ($52.65 in chips) 
deaglepro: posts small blind $0.10
Jack123985: posts big blind $0.25
*** HOLE CARDS ***
Dealt to SantiagoWeight [3d 2c]
SantiagoWeight: folds 
cankum: folds 
pirosiky: folds 
graysonai: raises $0.30 to $0.55
deaglepro: folds 
Jack123985: folds 
Uncalled bet ($0.30) returned to graysonai
graysonai collected $0.60 from pot
graysonai: doesn't show hand 
*** SUMMARY ***
Total pot $0.60 | Rake $0 
Seat 1: graysonai (button) collected ($0.60)
Seat 2: deaglepro (small blind) folded before Flop
Seat 3: Jack123985 (big blind) folded before Flop
Seat 4: SantiagoWeight folded before Flop (didn't bet)
Seat 5: cankum folded before Flop (didn't bet)
Seat 6: pirosiky folded before Flop (didn't bet)



PokerStars Zoom Hand #195023359816:  Hold'em No Limit ($0.10/$0.25) - 2018/12/29 3:36:02 UTC [2018/12/28 22:36:02 ET]
Table 'Hydra' 6-max Seat #1 is the button
Seat 1: alex3d1985 ($45.35 in chips) 
Seat 2: Bujan 07 ($9.85 in chips) 
Seat 3: G ster24 ($19.66 in chips) 
Seat 4: GrandmasterY ($44.25 in chips) 
Seat 5: SantiagoWeight ($27.13 in chips) 
Seat 6: yobbos ($136.42 in chips) 
Bujan 07: posts small blind $0.10
G ster24: posts big blind $0.25
*** HOLE CARDS ***
Dealt to SantiagoWeight [9d 7s]
GrandmasterY: calls $0.25
SantiagoWeight: folds 
yobbos: folds 
alex3d1985: raises $0.50 to $0.75
Bujan 07: calls $0.65
G ster24: calls $0.50
GrandmasterY: folds 
*** FLOP *** [2c Ts Ad]
Bujan 07: bets $0.75
G ster24: raises $0.75 to $1.50
alex3d1985: folds 
Bujan 07: calls $0.75
*** TURN *** [2c Ts Ad] [8d]
Bujan 07: checks 
G ster24: bets $17.41 and is all-in
Bujan 07: folds 
Uncalled bet ($17.41) returned to G ster24
G ster24 collected $5.25 from pot
G ster24: doesn't show hand 
*** SUMMARY ***
Total pot $5.50 | Rake $0.25 
Board [2c Ts Ad 8d]
Seat 1: alex3d1985 (button) folded on the Flop
Seat 2: Bujan 07 (small blind) folded on the Turn
Seat 3: G ster24 (big blind) collected ($5.25)
Seat 4: GrandmasterY folded before Flop
Seat 5: SantiagoWeight folded before Flop (didn't bet)
Seat 6: yobbos folded before Flop (didn't bet)



PokerStars Zoom Hand #195023371215:  Hold'em No Limit ($0.10/$0.25) - 2018/12/29 3:36:37 UTC [2018/12/28 22:36:37 ET]
Table 'Hydra' 6-max Seat #1 is the button
Seat 1: deaglepro ($64.61 in chips) 
Seat 2: SantiagoWeight ($27.13 in chips) 
Seat 3: Slim Wolfie ($31.87 in chips) 
Seat 4: HansMSM ($25 in chips) 
Seat 5: pfunkolstar ($27.16 in chips) 
Seat 6: yobbos ($70.64 in chips) 
SantiagoWeight: posts small blind $0.10
Slim Wolfie: posts big blind $0.25
*** HOLE CARDS ***
Dealt to SantiagoWeight [Jd Td]
HansMSM: folds 
pfunkolstar: folds 
yobbos: raises $0.37 to $0.62
deaglepro: calls $0.62
SantiagoWeight: calls $0.52
Slim Wolfie: folds 
*** FLOP *** [5c Ah 4s]
SantiagoWeight: checks 
yobbos: checks 
deaglepro: checks 
*** TURN *** [5c Ah 4s] [5s]
SantiagoWeight: checks 
yobbos: bets $0.69
deaglepro: folds 
SantiagoWeight: folds 
Uncalled bet ($0.69) returned to yobbos
yobbos collected $2.02 from pot
yobbos: doesn't show hand 
*** SUMMARY ***
Total pot $2.11 | Rake $0.09 
Board [5c Ah 4s 5s]
Seat 1: deaglepro (button) folded on the Turn
Seat 2: SantiagoWeight (small blind) folded on the Turn
Seat 3: Slim Wolfie (big blind) folded before Flop
Seat 4: HansMSM folded before Flop (didn't bet)
Seat 5: pfunkolstar folded before Flop (didn't bet)
Seat 6: yobbos collected ($2.02)



PokerStars Zoom Hand #195023388150:  Hold'em No Limit ($0.10/$0.25) - 2018/12/29 3:37:29 UTC [2018/12/28 22:37:29 ET]
Table 'Hydra' 6-max Seat #1 is the button
Seat 1: HansMSM ($25 in chips) 
Seat 2: cankum ($25 in chips) 
Seat 3: SantiagoWeight ($26.51 in chips) 
Seat 4: G ster24 ($22.56 in chips) 
Seat 5: negreanuNya ($38.67 in chips) 
Seat 6: fishnm2018 ($20.09 in chips) 
cankum: posts small blind $0.10
SantiagoWeight: posts big blind $0.25
*** HOLE CARDS ***
Dealt to SantiagoWeight [6c Qc]
G ster24: folds 
negreanuNya: raises $0.45 to $0.70
fishnm2018: raises $1.75 to $2.45
HansMSM: folds 
cankum: folds 
SantiagoWeight: folds 
negreanuNya: calls $1.75
*** FLOP *** [8c 5c 9h]
negreanuNya: checks 
fishnm2018: bets $2.51
negreanuNya: folds 
Uncalled bet ($2.51) returned to fishnm2018
fishnm2018 collected $5.01 from pot
fishnm2018: doesn't show hand 
*** SUMMARY ***
Total pot $5.25 | Rake $0.24 
Board [8c 5c 9h]
Seat 1: HansMSM (button) folded before Flop (didn't bet)
Seat 2: cankum (small blind) folded before Flop
Seat 3: SantiagoWeight (big blind) folded before Flop
Seat 4: G ster24 folded before Flop (didn't bet)
Seat 5: negreanuNya folded on the Flop
Seat 6: fishnm2018 collected ($5.01)



PokerStars Zoom Hand #195023391441:  Hold'em No Limit ($0.10/$0.25) - 2018/12/29 3:37:39 UTC [2018/12/28 22:37:39 ET]
Table 'Hydra' 6-max Seat #1 is the button
Seat 1: SantiagoWeight ($26.26 in chips) 
Seat 2: G ster24 ($22.56 in chips) 
Seat 3: Xp0Hb ($26.48 in chips) 
Seat 4: alex3d1985 ($44.25 in chips) 
Seat 5: ttshead ($66.93 in chips) 
Seat 6: numbernine5 ($58.33 in chips) 
G ster24: posts small blind $0.10
Xp0Hb: posts big blind $0.25
*** HOLE CARDS ***
Dealt to SantiagoWeight [2h 2s]
alex3d1985: folds 
ttshead: folds 
numbernine5: folds 
SantiagoWeight: raises $0.30 to $0.55
G ster24: raises $1.35 to $1.90
Xp0Hb: folds 
SantiagoWeight: calls $1.35
*** FLOP *** [8c 4c Qd]
G ster24: bets $3.87
SantiagoWeight: folds 
Uncalled bet ($3.87) returned to G ster24
G ster24 collected $3.87 from pot
*** SUMMARY ***
Total pot $4.05 | Rake $0.18 
Board [8c 4c Qd]
Seat 1: SantiagoWeight (button) folded on the Flop
Seat 2: G ster24 (small blind) collected ($3.87)
Seat 3: Xp0Hb (big blind) folded before Flop
Seat 4: alex3d1985 folded before Flop (didn't bet)
Seat 5: ttshead folded before Flop (didn't bet)
Seat 6: numbernine5 folded before Flop (didn't bet)



PokerStars Zoom Hand #195023403622:  Hold'em No Limit ($0.10/$0.25) - 2018/12/29 3:38:17 UTC [2018/12/28 22:38:17 ET]
Table 'Hydra' 6-max Seat #1 is the button
Seat 1: simsis20 ($12.15 in chips) 
Seat 2: pfunkolstar ($26.91 in chips) 
Seat 3: miba16 ($27.79 in chips) 
Seat 4: 1ownYourUsd ($43.51 in chips) 
Seat 5: SantiagoWeight ($24.36 in chips) 
Seat 6: _BluDeeN_ ($52.78 in chips) 
pfunkolstar: posts small blind $0.10
miba16: posts big blind $0.25
*** HOLE CARDS ***
Dealt to SantiagoWeight [Ah 5s]
1ownYourUsd: folds 
SantiagoWeight: folds 
_BluDeeN_: folds 
simsis20: raises $0.50 to $0.75
pfunkolstar: folds 
miba16: folds 
Uncalled bet ($0.50) returned to simsis20
simsis20 collected $0.60 from pot
simsis20: doesn't show hand 
*** SUMMARY ***
Total pot $0.60 | Rake $0 
Seat 1: simsis20 (button) collected ($0.60)
Seat 2: pfunkolstar (small blind) folded before Flop
Seat 3: miba16 (big blind) folded before Flop
Seat 4: 1ownYourUsd folded before Flop (didn't bet)
Seat 5: SantiagoWeight folded before Flop (didn't bet)
Seat 6: _BluDeeN_ folded before Flop (didn't bet)



PokerStars Zoom Hand #195023404933:  Hold'em No Limit ($0.10/$0.25) - 2018/12/29 3:38:21 UTC [2018/12/28 22:38:21 ET]
Table 'Hydra' 6-max Seat #1 is the button
Seat 1: TQNYMQNTANA ($28.13 in chips) 
Seat 2: yobbos ($71.69 in chips) 
Seat 3: Rollout2018 ($41.08 in chips) 
Seat 4: Basebob ($25.14 in chips) 
Seat 5: !P0K3RM3T4L! ($46.20 in chips) 
Seat 6: SantiagoWeight ($24.36 in chips) 
yobbos: posts small blind $0.10
Rollout2018: posts big blind $0.25
*** HOLE CARDS ***
Dealt to SantiagoWeight [Kh 2h]
Basebob: folds 
!P0K3RM3T4L!: folds 
SantiagoWeight: raises $0.30 to $0.55
TQNYMQNTANA: raises $1.70 to $2.25
yobbos: folds 
Rollout2018: folds 
SantiagoWeight: folds 
Uncalled bet ($1.70) returned to TQNYMQNTANA
TQNYMQNTANA collected $1.45 from pot
TQNYMQNTANA: doesn't show hand 
*** SUMMARY ***
Total pot $1.45 | Rake $0 
Seat 1: TQNYMQNTANA (button) collected ($1.45)
Seat 2: yobbos (small blind) folded before Flop
Seat 3: Rollout2018 (big blind) folded before Flop
Seat 4: Basebob folded before Flop (didn't bet)
Seat 5: !P0K3RM3T4L! folded before Flop (didn't bet)
Seat 6: SantiagoWeight folded before Flop



PokerStars Zoom Hand #195023414566:  Hold'em No Limit ($0.10/$0.25) - 2018/12/29 3:38:51 UTC [2018/12/28 22:38:51 ET]
Table 'Hydra' 6-max Seat #1 is the button
Seat 1: zdenekstavic ($37.32 in chips) 
Seat 2: SantiagoWeight ($23.81 in chips) 
Seat 3: Lehared ($64.84 in chips) 
Seat 4: miru877 ($57.16 in chips) 
Seat 5: HansMSM ($25.25 in chips) 
Seat 6: mayadelrey ($68.28 in chips) 
SantiagoWeight: posts small blind $0.10
Lehared: posts big blind $0.25
*** HOLE CARDS ***
Dealt to SantiagoWeight [5h 7s]
miru877: folds 
HansMSM: raises $0.45 to $0.70
mayadelrey: folds 
zdenekstavic: folds 
SantiagoWeight: folds 
Lehared: folds 
Uncalled bet ($0.45) returned to HansMSM
HansMSM collected $0.60 from pot
HansMSM: doesn't show hand 
*** SUMMARY ***
Total pot $0.60 | Rake $0 
Seat 1: zdenekstavic (button) folded before Flop (didn't bet)
Seat 2: SantiagoWeight (small blind) folded before Flop
Seat 3: Lehared (big blind) folded before Flop
Seat 4: miru877 folded before Flop (didn't bet)
Seat 5: HansMSM collected ($0.60)
Seat 6: mayadelrey folded before Flop (didn't bet)



PokerStars Zoom Hand #195023416600:  Hold'em No Limit ($0.10/$0.25) - 2018/12/29 3:38:57 UTC [2018/12/28 22:38:57 ET]
Table 'Hydra' 6-max Seat #1 is the button
Seat 1: angipoker ($12.50 in chips) 
Seat 2: Nutselas ($39.45 in chips) 
Seat 3: Theo Heisman ($10.09 in chips) 
Seat 4: SantiagoWeight ($23.71 in chips) 
Seat 5: CrazieFreddy ($15.62 in chips) 
Seat 6: _BluDeeN_ ($27.77 in chips) 
Nutselas: posts small blind $0.10
Theo Heisman: posts big blind $0.25
*** HOLE CARDS ***
Dealt to SantiagoWeight [9s 5s]
SantiagoWeight: folds 
CrazieFreddy: calls $0.25
_BluDeeN_: raises $0.50 to $0.75
angipoker: folds 
Nutselas: folds 
Theo Heisman: folds 
CrazieFreddy: calls $0.50
*** FLOP *** [Ad 7c Ts]
CrazieFreddy: checks 
_BluDeeN_: checks 
*** TURN *** [Ad 7c Ts] [9c]
CrazieFreddy: checks 
_BluDeeN_: checks 
*** RIVER *** [Ad 7c Ts 9c] [Ks]
CrazieFreddy: checks 
_BluDeeN_: checks 
*** SHOW DOWN ***
CrazieFreddy: shows [Qc 8c] (high card Ace)
_BluDeeN_: shows [3s 3c] (a pair of Threes)
_BluDeeN_ collected $1.77 from pot
*** SUMMARY ***
Total pot $1.85 | Rake $0.08 
Board [Ad 7c Ts 9c Ks]
Seat 1: angipoker (button) folded before Flop (didn't bet)
Seat 2: Nutselas (small blind) folded before Flop
Seat 3: Theo Heisman (big blind) folded before Flop
Seat 4: SantiagoWeight folded before Flop (didn't bet)
Seat 5: CrazieFreddy showed [Qc 8c] and lost with high card Ace
Seat 6: _BluDeeN_ showed [3s 3c] and won ($1.77) with a pair of Threes



PokerStars Zoom Hand #195023413300:  Hold'em No Limit ($0.10/$0.25) - 2018/12/29 3:38:47 UTC [2018/12/28 22:38:47 ET]
Table 'Hydra' 6-max Seat #1 is the button
Seat 1: SantiagoWeight ($23.81 in chips) 
Seat 2: negreanuNya ($29.10 in chips) 
Seat 3: qing328 ($27.72 in chips) 
Seat 4: IceAgeDream7 ($27.23 in chips) 
Seat 5: razil_999 ($24.49 in chips) 
Seat 6: HonourMan23 ($66.12 in chips) 
negreanuNya: posts small blind $0.10
qing328: posts big blind $0.25
*** HOLE CARDS ***
Dealt to SantiagoWeight [Jd 3c]
IceAgeDream7: raises $0.50 to $0.75
razil_999: folds 
HonourMan23: calls $0.75
SantiagoWeight: folds 
negreanuNya: folds 
qing328: folds 
*** FLOP *** [4c 2c 7h]
IceAgeDream7: bets $1
HonourMan23: raises $2.07 to $3.07
IceAgeDream7: raises $5.68 to $8.75
HonourMan23: raises $18.31 to $27.06
IceAgeDream7: calls $17.73 and is all-in
Uncalled bet ($0.58) returned to HonourMan23
*** TURN *** [4c 2c 7h] [9c]
*** RIVER *** [4c 2c 7h 9c] [Tc]
*** SHOW DOWN ***
IceAgeDream7: shows [Qs Qc] (a flush, Queen high)
HonourMan23: shows [Ac 5c] (a flush, Ace high)
HonourMan23 collected $52.81 from pot
*** SUMMARY ***
Total pot $54.81 | Rake $2 
Board [4c 2c 7h 9c Tc]
Seat 1: SantiagoWeight (button) folded before Flop (didn't bet)
Seat 2: negreanuNya (small blind) folded before Flop
Seat 3: qing328 (big blind) folded before Flop
Seat 4: IceAgeDream7 showed [Qs Qc] and lost with a flush, Queen high
Seat 5: razil_999 folded before Flop (didn't bet)
Seat 6: HonourMan23 showed [Ac 5c] and won ($52.81) with a flush, Ace high



PokerStars Zoom Hand #195023425623:  Hold'em No Limit ($0.10/$0.25) - 2018/12/29 3:39:25 UTC [2018/12/28 22:39:25 ET]
Table 'Hydra' 6-max Seat #1 is the button
Seat 1: pfunkolstar ($25.11 in chips) 
Seat 2: ryanking99 ($24.33 in chips) 
Seat 3: Basebob ($37.49 in chips) 
Seat 4: franco373513 ($20.90 in chips) 
Seat 5: sigaro010 ($89.51 in chips) 
Seat 6: SantiagoWeight ($23.46 in chips) 
ryanking99: posts small blind $0.10
Basebob: posts big blind $0.25
*** HOLE CARDS ***
Dealt to SantiagoWeight [8h Ad]
franco373513: calls $0.25
sigaro010: folds 
SantiagoWeight: folds 
pfunkolstar: raises $0.75 to $1
ryanking99: folds 
Basebob: folds 
franco373513: calls $0.75
*** FLOP *** [9d 2c 4d]
franco373513: checks 
pfunkolstar: bets $1.46
franco373513: folds 
Uncalled bet ($1.46) returned to pfunkolstar
pfunkolstar collected $2.24 from pot
pfunkolstar: doesn't show hand 
*** SUMMARY ***
Total pot $2.35 | Rake $0.11 
Board [9d 2c 4d]
Seat 1: pfunkolstar (button) collected ($2.24)
Seat 2: ryanking99 (small blind) folded before Flop
Seat 3: Basebob (big blind) folded before Flop
Seat 4: franco373513 folded on the Flop
Seat 5: sigaro010 folded before Flop (didn't bet)
Seat 6: SantiagoWeight folded before Flop (didn't bet)



PokerStars Zoom Hand #195023417896:  Hold'em No Limit ($0.10/$0.25) - 2018/12/29 3:39:01 UTC [2018/12/28 22:39:01 ET]
Table 'Hydra' 6-max Seat #1 is the button
Seat 1: golf7287 ($28.42 in chips) 
Seat 2: Viiiru ($31.36 in chips) 
Seat 3: SantiagoWeight ($23.71 in chips) 
Seat 4: ivann14 ($73.19 in chips) 
Seat 5: Mrs_Squeeze ($12.07 in chips) 
Seat 6: zbuci ($29.37 in chips) 
Viiiru: posts small blind $0.10
SantiagoWeight: posts big blind $0.25
*** HOLE CARDS ***
Dealt to SantiagoWeight [7s 2d]
ivann14: folds 
Mrs_Squeeze: folds 
zbuci: folds 
golf7287: raises $0.37 to $0.62
Viiiru: raises $1.63 to $2.25
SantiagoWeight: folds 
golf7287: calls $1.63
*** FLOP *** [3d Th 4s]
Viiiru: checks 
golf7287: bets $2.75
Viiiru: calls $2.75
*** TURN *** [3d Th 4s] [9s]
Viiiru: checks 
golf7287: checks 
*** RIVER *** [3d Th 4s 9s] [Qc]
Viiiru: bets $4.90
golf7287: calls $4.90
*** SHOW DOWN ***
Viiiru: shows [Qh Ah] (a pair of Queens)
golf7287: shows [Kd Kh] (a pair of Kings)
golf7287 collected $19.15 from pot
*** SUMMARY ***
Total pot $20.05 | Rake $0.90 
Board [3d Th 4s 9s Qc]
Seat 1: golf7287 (button) showed [Kd Kh] and won ($19.15) with a pair of Kings
Seat 2: Viiiru (small blind) showed [Qh Ah] and lost with a pair of Queens
Seat 3: SantiagoWeight (big blind) folded before Flop
Seat 4: ivann14 folded before Flop (didn't bet)
Seat 5: Mrs_Squeeze folded before Flop (didn't bet)
Seat 6: zbuci folded before Flop (didn't bet)



PokerStars Zoom Hand #195023437552:  Hold'em No Limit ($0.10/$0.25) - 2018/12/29 3:40:02 UTC [2018/12/28 22:40:02 ET]
Table 'Hydra' 6-max Seat #1 is the button
Seat 1: franco373513 ($19.80 in chips) 
Seat 2: SantiagoWeight ($23.21 in chips) 
Seat 3: Albratros2 ($22.53 in chips) 
Seat 4: Nutselas ($27.52 in chips) 
Seat 5: Theo Heisman ($8.99 in chips) 
Seat 6: Boew_75 ($24.25 in chips) 
SantiagoWeight: posts small blind $0.10
Albratros2: posts big blind $0.25
*** HOLE CARDS ***
Dealt to SantiagoWeight [Qs 4s]
Nutselas: folds 
Theo Heisman: folds 
Boew_75: folds 
franco373513: folds 
SantiagoWeight: folds 
Uncalled bet ($0.15) returned to Albratros2
Albratros2 collected $0.20 from pot
*** SUMMARY ***
Total pot $0.20 | Rake $0 
Seat 1: franco373513 (button) folded before Flop (didn't bet)
Seat 2: SantiagoWeight (small blind) folded before Flop
Seat 3: Albratros2 (big blind) collected ($0.20)
Seat 4: Nutselas folded before Flop (didn't bet)
Seat 5: Theo Heisman folded before Flop (didn't bet)
Seat 6: Boew_75 folded before Flop (didn't bet)



PokerStars Zoom Hand #195023431401:  Hold'em No Limit ($0.10/$0.25) - 2018/12/29 3:39:43 UTC [2018/12/28 22:39:43 ET]
Table 'Hydra' 6-max Seat #1 is the button
Seat 1: negreanuNya ($35.62 in chips) 
Seat 2: nhanminhtri ($25.46 in chips) 
Seat 3: MoMoney2612 ($26.95 in chips) 
Seat 4: _BluDeeN_ ($28.79 in chips) 
Seat 5: SantiagoWeight ($23.46 in chips) 
Seat 6: miru877 ($28.38 in chips) 
nhanminhtri: posts small blind $0.10
MoMoney2612: posts big blind $0.25
*** HOLE CARDS ***
Dealt to SantiagoWeight [5h Kh]
_BluDeeN_: raises $0.50 to $0.75
SantiagoWeight: folds 
miru877: folds 
negreanuNya: folds 
nhanminhtri: calls $0.65
MoMoney2612: folds 
*** FLOP *** [8c Qd 6s]
nhanminhtri: checks 
_BluDeeN_: checks 
*** TURN *** [8c Qd 6s] [6d]
nhanminhtri: checks 
_BluDeeN_: bets $1.25
nhanminhtri: calls $1.25
*** RIVER *** [8c Qd 6s 6d] [3d]
nhanminhtri: checks 
_BluDeeN_: checks 
*** SHOW DOWN ***
nhanminhtri: shows [8s As] (two pair, Eights and Sixes)
_BluDeeN_: mucks hand 
nhanminhtri collected $4.06 from pot
*** SUMMARY ***
Total pot $4.25 | Rake $0.19 
Board [8c Qd 6s 6d 3d]
Seat 1: negreanuNya (button) folded before Flop (didn't bet)
Seat 2: nhanminhtri (small blind) showed [8s As] and won ($4.06) with two pair, Eights and Sixes
Seat 3: MoMoney2612 (big blind) folded before Flop
Seat 4: _BluDeeN_ mucked [4s 4h]
Seat 5: SantiagoWeight folded before Flop (didn't bet)
Seat 6: miru877 folded before Flop (didn't bet)



PokerStars Zoom Hand #195023433977:  Hold'em No Limit ($0.10/$0.25) - 2018/12/29 3:39:51 UTC [2018/12/28 22:39:51 ET]
Table 'Hydra' 6-max Seat #1 is the button
Seat 1: mariopork ($34.14 in chips) 
Seat 2: ColinCaine ($18.52 in chips) 
Seat 3: Pardaroxon ($25 in chips) 
Seat 4: 1ownYourUsd ($41.74 in chips) 
Seat 5: SantiagoWeight ($23.46 in chips) 
Seat 6: Actarusqc ($15.12 in chips) 
ColinCaine: posts small blind $0.10
Pardaroxon: posts big blind $0.25
*** HOLE CARDS ***
Dealt to SantiagoWeight [6s Jh]
1ownYourUsd: raises $0.50 to $0.75
SantiagoWeight: folds 
Actarusqc: calls $0.75
mariopork: calls $0.75
ColinCaine: folds 
Pardaroxon: folds 
*** FLOP *** [5s Jc 8d]
1ownYourUsd: bets $1.75
Actarusqc: calls $1.75
mariopork: folds 
*** TURN *** [5s Jc 8d] [Jd]
1ownYourUsd: checks 
Actarusqc: checks 
*** RIVER *** [5s Jc 8d Jd] [5c]
1ownYourUsd: checks 
Actarusqc: checks 
*** SHOW DOWN ***
1ownYourUsd: shows [9h 8h] (two pair, Jacks and Eights)
Actarusqc: mucks hand 
1ownYourUsd collected $5.83 from pot
*** SUMMARY ***
Total pot $6.10 | Rake $0.27 
Board [5s Jc 8d Jd 5c]
Seat 1: mariopork (button) folded on the Flop
Seat 2: ColinCaine (small blind) folded before Flop
Seat 3: Pardaroxon (big blind) folded before Flop
Seat 4: 1ownYourUsd showed [9h 8h] and won ($5.83) with two pair, Jacks and Eights
Seat 5: SantiagoWeight folded before Flop (didn't bet)
Seat 6: Actarusqc mucked [Ks Qs]



PokerStars Zoom Hand #195023435293:  Hold'em No Limit ($0.10/$0.25) - 2018/12/29 3:39:55 UTC [2018/12/28 22:39:55 ET]
Table 'Hydra' 6-max Seat #1 is the button
Seat 1: Lehared ($28.78 in chips) 
Seat 2: lovintalbi ($25.32 in chips) 
Seat 3: SantiagoWeight ($23.46 in chips) 
Seat 4: zbuci ($29.02 in chips) 
Seat 5: jamma8631 ($5.43 in chips) 
Seat 6: Theo Heisman ($8.99 in chips) 
lovintalbi: posts small blind $0.10
SantiagoWeight: posts big blind $0.25
*** HOLE CARDS ***
Dealt to SantiagoWeight [3d 4c]
zbuci: raises $0.50 to $0.75
jamma8631: folds 
Theo Heisman: folds 
Lehared: calls $0.75
lovintalbi: calls $0.65
SantiagoWeight: folds 
*** FLOP *** [6h 5c 7c]
lovintalbi: checks 
zbuci: checks 
Lehared: bets $1.84
lovintalbi: calls $1.84
zbuci: folds 
*** TURN *** [6h 5c 7c] [Jc]
lovintalbi: checks 
Lehared: bets $4.54
lovintalbi: folds 
Uncalled bet ($4.54) returned to Lehared
Lehared collected $5.90 from pot
Lehared: doesn't show hand 
*** SUMMARY ***
Total pot $6.18 | Rake $0.28 
Board [6h 5c 7c Jc]
Seat 1: Lehared (button) collected ($5.90)
Seat 2: lovintalbi (small blind) folded on the Turn
Seat 3: SantiagoWeight (big blind) folded before Flop
Seat 4: zbuci folded on the Flop
Seat 5: jamma8631 folded before Flop (didn't bet)
Seat 6: Theo Heisman folded before Flop (didn't bet)



PokerStars Zoom Hand #195023443300:  Hold'em No Limit ($0.10/$0.25) - 2018/12/29 3:40:20 UTC [2018/12/28 22:40:20 ET]
Table 'Hydra' 6-max Seat #1 is the button
Seat 1: SantiagoWeight ($23.11 in chips) 
Seat 2: Bujan 07 ($11.88 in chips) 
Seat 3: HansMSM ($75.42 in chips) 
Seat 4: denisss1801 ($21.96 in chips) 
Seat 5: yobbos ($117.85 in chips) 
Seat 6: fishnm2018 ($20.56 in chips) 
Bujan 07: posts small blind $0.10
HansMSM: posts big blind $0.25
*** HOLE CARDS ***
Dealt to SantiagoWeight [7d 8d]
denisss1801: folds 
yobbos: raises $0.50 to $0.75
fishnm2018: folds 
SantiagoWeight: calls $0.75
Bujan 07: folds 
HansMSM: calls $0.50
*** FLOP *** [Kd 2d 4s]
HansMSM: checks 
yobbos: checks 
SantiagoWeight: bets $1.49
HansMSM: folds 
yobbos: folds 
Uncalled bet ($1.49) returned to SantiagoWeight
SantiagoWeight collected $2.24 from pot
SantiagoWeight: doesn't show hand 
*** SUMMARY ***
Total pot $2.35 | Rake $0.11 
Board [Kd 2d 4s]
Seat 1: SantiagoWeight (button) collected ($2.24)
Seat 2: Bujan 07 (small blind) folded before Flop
Seat 3: HansMSM (big blind) folded on the Flop
Seat 4: denisss1801 folded before Flop (didn't bet)
Seat 5: yobbos folded on the Flop
Seat 6: fishnm2018 folded before Flop (didn't bet)



PokerStars Zoom Hand #195023464124:  Hold'em No Limit ($0.10/$0.25) - 2018/12/29 3:41:25 UTC [2018/12/28 22:41:25 ET]
Table 'Hydra' 6-max Seat #1 is the button
Seat 1: call me??107 ($19.75 in chips) 
Seat 2: landromede ($22.14 in chips) 
Seat 3: gaffer31 ($30.63 in chips) 
Seat 4: !P0K3RM3T4L! ($64.39 in chips) 
Seat 5: Dbakunwaves ($118.23 in chips) 
Seat 6: SantiagoWeight ($24.60 in chips) 
landromede: posts small blind $0.10
gaffer31: posts big blind $0.25
*** HOLE CARDS ***
Dealt to SantiagoWeight [9s Kh]
!P0K3RM3T4L!: folds 
Dbakunwaves: raises $0.75 to $1
SantiagoWeight: folds 
call me??107: calls $1
landromede: folds 
gaffer31: calls $0.75
*** FLOP *** [2c 6d Ts]
gaffer31: bets $1.50
Dbakunwaves: folds 
call me??107: calls $1.50
*** TURN *** [2c 6d Ts] [2d]
gaffer31: checks 
call me??107: checks 
*** RIVER *** [2c 6d Ts 2d] [Th]
gaffer31: checks 
call me??107: bets $5.83
gaffer31: folds 
Uncalled bet ($5.83) returned to call me??107
call me??107 collected $5.83 from pot
call me??107: doesn't show hand 
*** SUMMARY ***
Total pot $6.10 | Rake $0.27 
Board [2c 6d Ts 2d Th]
Seat 1: call me??107 (button) collected ($5.83)
Seat 2: landromede (small blind) folded before Flop
Seat 3: gaffer31 (big blind) folded on the River
Seat 4: !P0K3RM3T4L! folded before Flop (didn't bet)
Seat 5: Dbakunwaves folded on the Flop
Seat 6: SantiagoWeight folded before Flop (didn't bet)



PokerStars Zoom Hand #195023469150:  Hold'em No Limit ($0.10/$0.25) - 2018/12/29 3:41:41 UTC [2018/12/28 22:41:41 ET]
Table 'Hydra' 6-max Seat #1 is the button
Seat 1: negreanuNya ($28.53 in chips) 
Seat 2: pfunkolstar ($25 in chips) 
Seat 3: ckriszee ($42.17 in chips) 
Seat 4: SantiagoWeight ($24.60 in chips) 
Seat 5: jamma8631 ($5.65 in chips) 
Seat 6: MoMoney2612 ($27.53 in chips) 
pfunkolstar: posts small blind $0.10
ckriszee: posts big blind $0.25
*** HOLE CARDS ***
Dealt to SantiagoWeight [6s 7d]
SantiagoWeight: folds 
jamma8631: calls $0.25
MoMoney2612: folds 
negreanuNya: raises $0.70 to $0.95
pfunkolstar: folds 
ckriszee: folds 
jamma8631: calls $0.70
*** FLOP *** [5c Td 4h]
jamma8631: checks 
negreanuNya: bets $1.20
jamma8631: calls $1.20
*** TURN *** [5c Td 4h] [3c]
jamma8631: checks 
negreanuNya: bets $5.99
jamma8631: folds 
Uncalled bet ($5.99) returned to negreanuNya
negreanuNya collected $4.44 from pot
negreanuNya: doesn't show hand 
*** SUMMARY ***
Total pot $4.65 | Rake $0.21 
Board [5c Td 4h 3c]
Seat 1: negreanuNya (button) collected ($4.44)
Seat 2: pfunkolstar (small blind) folded before Flop
Seat 3: ckriszee (big blind) folded before Flop
Seat 4: SantiagoWeight folded before Flop (didn't bet)
Seat 5: jamma8631 folded on the Turn
Seat 6: MoMoney2612 folded before Flop (didn't bet)



PokerStars Zoom Hand #195023461305:  Hold'em No Limit ($0.10/$0.25) - 2018/12/29 3:41:16 UTC [2018/12/28 22:41:16 ET]
Table 'Hydra' 6-max Seat #1 is the button
Seat 1: zdenekstavic ($44.16 in chips) 
Seat 2: nhanminhtri ($36.41 in chips) 
Seat 3: ivann14 ($83.37 in chips) 
Seat 4: SantiagoWeight ($24.60 in chips) 
Seat 5: assassin0875 ($172.27 in chips) 
Seat 6: Mastermimo ($20.52 in chips) 
nhanminhtri: posts small blind $0.10
ivann14: posts big blind $0.25
*** HOLE CARDS ***
Dealt to SantiagoWeight [3c 4s]
SantiagoWeight: folds 
assassin0875: folds 
Mastermimo: folds 
zdenekstavic: calls $0.25
nhanminhtri: folds 
ivann14: raises $0.75 to $1
zdenekstavic: calls $0.75
*** FLOP *** [5h Jd 6h]
ivann14: checks 
zdenekstavic: checks 
*** TURN *** [5h Jd 6h] [8d]
ivann14: checks 
zdenekstavic: bets $1.25
ivann14: folds 
Uncalled bet ($1.25) returned to zdenekstavic
zdenekstavic collected $2.01 from pot
zdenekstavic: doesn't show hand 
*** SUMMARY ***
Total pot $2.10 | Rake $0.09 
Board [5h Jd 6h 8d]
Seat 1: zdenekstavic (button) collected ($2.01)
Seat 2: nhanminhtri (small blind) folded before Flop
Seat 3: ivann14 (big blind) folded on the Turn
Seat 4: SantiagoWeight folded before Flop (didn't bet)
Seat 5: assassin0875 folded before Flop (didn't bet)
Seat 6: Mastermimo folded before Flop (didn't bet)



PokerStars Zoom Hand #195023471378:  Hold'em No Limit ($0.10/$0.25) - 2018/12/29 3:41:48 UTC [2018/12/28 22:41:48 ET]
Table 'Hydra' 6-max Seat #1 is the button
Seat 1: TDAK1509 ($45.81 in chips) 
Seat 2: SantiagoWeight ($24.60 in chips) 
Seat 3: KeySssi ($25 in chips) 
Seat 4: HansMSM ($74.57 in chips) 
Seat 5: allin969 ($64.21 in chips) 
Seat 6: aldoalb0207 ($53.60 in chips) 
SantiagoWeight: posts small blind $0.10
KeySssi: posts big blind $0.25
*** HOLE CARDS ***
Dealt to SantiagoWeight [7h 9c]
HansMSM: folds 
allin969: folds 
aldoalb0207: calls $0.25
TDAK1509: folds 
SantiagoWeight: folds 
KeySssi: checks 
*** FLOP *** [3d 3s 2c]
KeySssi: checks 
aldoalb0207: checks 
*** TURN *** [3d 3s 2c] [5s]
KeySssi: bets $0.29
aldoalb0207: calls $0.29
*** RIVER *** [3d 3s 2c 5s] [Kd]
KeySssi: bets $0.75
aldoalb0207: raises $0.75 to $1.50
KeySssi: calls $0.75
*** SHOW DOWN ***
aldoalb0207: shows [5d Kc] (two pair, Kings and Fives)
KeySssi: mucks hand 
aldoalb0207 collected $3.99 from pot
*** SUMMARY ***
Total pot $4.18 | Rake $0.19 
Board [3d 3s 2c 5s Kd]
Seat 1: TDAK1509 (button) folded before Flop (didn't bet)
Seat 2: SantiagoWeight (small blind) folded before Flop
Seat 3: KeySssi (big blind) mucked [4s Kh]
Seat 4: HansMSM folded before Flop (didn't bet)
Seat 5: allin969 folded before Flop (didn't bet)
Seat 6: aldoalb0207 showed [5d Kc] and won ($3.99) with two pair, Kings and Fives



PokerStars Zoom Hand #195023475302:  Hold'em No Limit ($0.10/$0.25) - 2018/12/29 3:42:00 UTC [2018/12/28 22:42:00 ET]
Table 'Hydra' 6-max Seat #1 is the button
Seat 1: SantiagoWeight ($24.50 in chips) 
Seat 2: Lehared ($40.13 in chips) 
Seat 3: landromede ($21.94 in chips) 
Seat 4: mariopork ($25.65 in chips) 
Seat 5: TQNYMQNTANA ($27.06 in chips) 
Seat 6: sZCzpNtheKot ($25 in chips) 
Lehared: posts small blind $0.10
landromede: posts big blind $0.25
*** HOLE CARDS ***
Dealt to SantiagoWeight [3s 3c]
mariopork: folds 
TQNYMQNTANA: folds 
sZCzpNtheKot: folds 
SantiagoWeight: raises $0.30 to $0.55
Lehared: folds 
landromede: calls $0.30
*** FLOP *** [7d 9s 7s]
landromede: checks 
SantiagoWeight: bets $0.29
landromede: calls $0.29
*** TURN *** [7d 9s 7s] [8d]
landromede: checks 
SantiagoWeight: checks 
*** RIVER *** [7d 9s 7s 8d] [Jd]
landromede: bets $1.70
SantiagoWeight: folds 
Uncalled bet ($1.70) returned to landromede
landromede collected $1.70 from pot
*** SUMMARY ***
Total pot $1.78 | Rake $0.08 
Board [7d 9s 7s 8d Jd]
Seat 1: SantiagoWeight (button) folded on the River
Seat 2: Lehared (small blind) folded before Flop
Seat 3: landromede (big blind) collected ($1.70)
Seat 4: mariopork folded before Flop (didn't bet)
Seat 5: TQNYMQNTANA folded before Flop (didn't bet)
Seat 6: sZCzpNtheKot folded before Flop (didn't bet)



PokerStars Zoom Hand #195023492222:  Hold'em No Limit ($0.10/$0.25) - 2018/12/29 3:42:53 UTC [2018/12/28 22:42:53 ET]
Table 'Hydra' 6-max Seat #1 is the button
Seat 1: checho0231 ($16.50 in chips) 
Seat 2: Renner32 ($25.10 in chips) 
Seat 3: SantiagoWeight ($23.66 in chips) 
Seat 4: Chellabro ($39.53 in chips) 
Seat 5: Ovanes911 ($12.23 in chips) 
Seat 6: HansMSM ($74.22 in chips) 
Renner32: posts small blind $0.10
SantiagoWeight: posts big blind $0.25
*** HOLE CARDS ***
Dealt to SantiagoWeight [5s Qh]
Chellabro: folds 
Ovanes911: folds 
HansMSM: raises $0.45 to $0.70
checho0231: folds 
Renner32: folds 
SantiagoWeight: folds 
Uncalled bet ($0.45) returned to HansMSM
HansMSM collected $0.60 from pot
HansMSM: doesn't show hand 
*** SUMMARY ***
Total pot $0.60 | Rake $0 
Seat 1: checho0231 (button) folded before Flop (didn't bet)
Seat 2: Renner32 (small blind) folded before Flop
Seat 3: SantiagoWeight (big blind) folded before Flop
Seat 4: Chellabro folded before Flop (didn't bet)
Seat 5: Ovanes911 folded before Flop (didn't bet)
Seat 6: HansMSM collected ($0.60)



PokerStars Zoom Hand #195023497261:  Hold'em No Limit ($0.10/$0.25) - 2018/12/29 3:43:09 UTC [2018/12/28 22:43:09 ET]
Table 'Hydra' 6-max Seat #1 is the button
Seat 1: mariopork ($25 in chips) 
Seat 2: zdenekstavic ($44.42 in chips) 
Seat 3: _BluDeeN_ ($29.80 in chips) 
Seat 4: ttshead ($55.05 in chips) 
Seat 5: davidhw888 ($30.48 in chips) 
Seat 6: SantiagoWeight ($23.41 in chips) 
zdenekstavic: posts small blind $0.10
_BluDeeN_: posts big blind $0.25
*** HOLE CARDS ***
Dealt to SantiagoWeight [Th Ac]
ttshead: folds 
davidhw888: folds 
SantiagoWeight: raises $0.30 to $0.55
mariopork: folds 
zdenekstavic: folds 
_BluDeeN_: folds 
Uncalled bet ($0.30) returned to SantiagoWeight
SantiagoWeight collected $0.60 from pot
SantiagoWeight: doesn't show hand 
*** SUMMARY ***
Total pot $0.60 | Rake $0 
Seat 1: mariopork (button) folded before Flop (didn't bet)
Seat 2: zdenekstavic (small blind) folded before Flop
Seat 3: _BluDeeN_ (big blind) folded before Flop
Seat 4: ttshead folded before Flop (didn't bet)
Seat 5: davidhw888 folded before Flop (didn't bet)
Seat 6: SantiagoWeight collected ($0.60)



PokerStars Zoom Hand #195023508010:  Hold'em No Limit ($0.10/$0.25) - 2018/12/29 3:43:43 UTC [2018/12/28 22:43:43 ET]
Table 'Hydra' 6-max Seat #1 is the button
Seat 1: _BluDeeN_ ($29.45 in chips) 
Seat 2: negreanuNya ($29.10 in chips) 
Seat 3: Renner32 ($25.35 in chips) 
Seat 4: SantiagoWeight ($23.66 in chips) 
Seat 5: GrandmasterY ($27.79 in chips) 
Seat 6: Lehared ($40.48 in chips) 
negreanuNya: posts small blind $0.10
Renner32: posts big blind $0.25
*** HOLE CARDS ***
Dealt to SantiagoWeight [Td 4h]
SantiagoWeight: folds 
GrandmasterY: raises $0.50 to $0.75
Lehared: folds 
_BluDeeN_: folds 
negreanuNya: folds 
Renner32: folds 
Uncalled bet ($0.50) returned to GrandmasterY
GrandmasterY collected $0.60 from pot
GrandmasterY: doesn't show hand 
*** SUMMARY ***
Total pot $0.60 | Rake $0 
Seat 1: _BluDeeN_ (button) folded before Flop (didn't bet)
Seat 2: negreanuNya (small blind) folded before Flop
Seat 3: Renner32 (big blind) folded before Flop
Seat 4: SantiagoWeight folded before Flop (didn't bet)
Seat 5: GrandmasterY collected ($0.60)
Seat 6: Lehared folded before Flop (didn't bet)



PokerStars Zoom Hand #195023505469:  Hold'em No Limit ($0.10/$0.25) - 2018/12/29 3:43:35 UTC [2018/12/28 22:43:35 ET]
Table 'Hydra' 6-max Seat #1 is the button
Seat 1: ssrace ($33.13 in chips) 
Seat 2: davidhw888 ($50.82 in chips) 
Seat 3: numbernine5 ($60.35 in chips) 
Seat 4: SantiagoWeight ($23.66 in chips) 
Seat 5: lovintalbi ($30.31 in chips) 
Seat 6: playazhate ($25.35 in chips) 
davidhw888: posts small blind $0.10
numbernine5: posts big blind $0.25
*** HOLE CARDS ***
Dealt to SantiagoWeight [As 2d]
SantiagoWeight: folds 
lovintalbi: folds 
playazhate: raises $0.35 to $0.60
ssrace: folds 
davidhw888: folds 
numbernine5: calls $0.35
*** FLOP *** [5s 9h Qh]
numbernine5: checks 
playazhate: checks 
*** TURN *** [5s 9h Qh] [Jd]
numbernine5: bets $0.68
playazhate: raises $1.30 to $1.98
numbernine5: folds 
Uncalled bet ($1.30) returned to playazhate
playazhate collected $2.54 from pot
playazhate: doesn't show hand 
*** SUMMARY ***
Total pot $2.66 | Rake $0.12 
Board [5s 9h Qh Jd]
Seat 1: ssrace (button) folded before Flop (didn't bet)
Seat 2: davidhw888 (small blind) folded before Flop
Seat 3: numbernine5 (big blind) folded on the Turn
Seat 4: SantiagoWeight folded before Flop (didn't bet)
Seat 5: lovintalbi folded before Flop (didn't bet)
Seat 6: playazhate collected ($2.54)



PokerStars Zoom Hand #195023511875:  Hold'em No Limit ($0.10/$0.25) - 2018/12/29 3:43:55 UTC [2018/12/28 22:43:55 ET]
Table 'Hydra' 6-max Seat #1 is the button
Seat 1: alex3d1985 ($46.43 in chips) 
Seat 2: Fishnoobking ($20.72 in chips) 
Seat 3: SantiagoWeight ($23.66 in chips) 
Seat 4: Ovanes911 ($14.36 in chips) 
Seat 5: Unclesmoll ($10.45 in chips) 
Seat 6: negreanuNya ($31.37 in chips) 
Fishnoobking: posts small blind $0.10
SantiagoWeight: posts big blind $0.25
*** HOLE CARDS ***
Dealt to SantiagoWeight [5s 5d]
Ovanes911: folds 
Unclesmoll: folds 
negreanuNya: folds 
alex3d1985: raises $0.75 to $1
Fishnoobking: folds 
SantiagoWeight: calls $0.75
*** FLOP *** [2c 3c 5c]
SantiagoWeight: checks 
alex3d1985: bets $1.01
SantiagoWeight: raises $3.99 to $5
alex3d1985: folds 
Uncalled bet ($3.99) returned to SantiagoWeight
SantiagoWeight collected $3.93 from pot
SantiagoWeight: doesn't show hand 
*** SUMMARY ***
Total pot $4.12 | Rake $0.19 
Board [2c 3c 5c]
Seat 1: alex3d1985 (button) folded on the Flop
Seat 2: Fishnoobking (small blind) folded before Flop
Seat 3: SantiagoWeight (big blind) collected ($3.93)
Seat 4: Ovanes911 folded before Flop (didn't bet)
Seat 5: Unclesmoll folded before Flop (didn't bet)
Seat 6: negreanuNya folded before Flop (didn't bet)



PokerStars Zoom Hand #195023504197:  Hold'em No Limit ($0.10/$0.25) - 2018/12/29 3:43:31 UTC [2018/12/28 22:43:31 ET]
Table 'Hydra' 6-max Seat #1 is the button
Seat 1: Rollout2018 ($39.82 in chips) 
Seat 2: SantiagoWeight ($23.76 in chips) 
Seat 3: graysonai ($29.21 in chips) 
Seat 4: skePokerske ($17.37 in chips) 
Seat 5: miru877 ($60.72 in chips) 
Seat 6: checho0231 ($28.59 in chips) 
SantiagoWeight: posts small blind $0.10
graysonai: posts big blind $0.25
*** HOLE CARDS ***
Dealt to SantiagoWeight [9d 2c]
skePokerske: calls $0.25
miru877: folds 
checho0231: folds 
Rollout2018: folds 
SantiagoWeight: folds 
graysonai: checks 
*** FLOP *** [3h 9s 8d]
graysonai: checks 
skePokerske: bets $0.50
graysonai: calls $0.50
*** TURN *** [3h 9s 8d] [5d]
graysonai: checks 
skePokerske: checks 
*** RIVER *** [3h 9s 8d 5d] [Qh]
graysonai: bets $1.15
skePokerske: raises $3.83 to $4.98
graysonai: raises $23.48 to $28.46 and is all-in
skePokerske: calls $11.64 and is all-in
Uncalled bet ($11.84) returned to graysonai
*** SHOW DOWN ***
graysonai: shows [Ts Jh] (a straight, Eight to Queen)
skePokerske: shows [Jc Td] (a straight, Eight to Queen)
graysonai collected $16.64 from pot
skePokerske collected $16.63 from pot
*** SUMMARY ***
Total pot $34.84 | Rake $1.57 
Board [3h 9s 8d 5d Qh]
Seat 1: Rollout2018 (button) folded before Flop (didn't bet)
Seat 2: SantiagoWeight (small blind) folded before Flop
Seat 3: graysonai (big blind) showed [Ts Jh] and won ($16.64) with a straight, Eight to Queen
Seat 4: skePokerske showed [Jc Td] and won ($16.63) with a straight, Eight to Queen
Seat 5: miru877 folded before Flop (didn't bet)
Seat 6: checho0231 folded before Flop (didn't bet)



PokerStars Zoom Hand #195023524291:  Hold'em No Limit ($0.10/$0.25) - 2018/12/29 3:44:34 UTC [2018/12/28 22:44:34 ET]
Table 'Hydra' 6-max Seat #1 is the button
Seat 1: nhanminhtri ($34.26 in chips) 
Seat 2: !P0K3RM3T4L! ($89.83 in chips) 
Seat 3: pirosiky ($25 in chips) 
Seat 4: Basebob ($26.51 in chips) 
Seat 5: landromede ($22.87 in chips) 
Seat 6: SantiagoWeight ($25.58 in chips) 
!P0K3RM3T4L!: posts small blind $0.10
pirosiky: posts big blind $0.25
*** HOLE CARDS ***
Dealt to SantiagoWeight [6c 7c]
Basebob: folds 
landromede: folds 
SantiagoWeight: raises $0.30 to $0.55
nhanminhtri: folds 
!P0K3RM3T4L!: folds 
pirosiky: calls $0.30
*** FLOP *** [8h 5h Ks]
pirosiky: checks 
SantiagoWeight: bets $0.77
pirosiky: folds 
Uncalled bet ($0.77) returned to SantiagoWeight
SantiagoWeight collected $1.15 from pot
SantiagoWeight: doesn't show hand 
*** SUMMARY ***
Total pot $1.20 | Rake $0.05 
Board [8h 5h Ks]
Seat 1: nhanminhtri (button) folded before Flop (didn't bet)
Seat 2: !P0K3RM3T4L! (small blind) folded before Flop
Seat 3: pirosiky (big blind) folded on the Flop
Seat 4: Basebob folded before Flop (didn't bet)
Seat 5: landromede folded before Flop (didn't bet)
Seat 6: SantiagoWeight collected ($1.15)



PokerStars Zoom Hand #195023543029:  Hold'em No Limit ($0.10/$0.25) - 2018/12/29 3:45:17 UTC [2018/12/28 22:45:17 ET]
Table 'Hydra' 6-max Seat #1 is the button
Seat 1: Paasinha ($35.90 in chips) 
Seat 2: HansMSM ($71.20 in chips) 
Seat 3: Mandu_xiii ($28.67 in chips) 
Seat 4: HonourMan23 ($97.35 in chips) 
Seat 5: SantiagoWeight ($26.18 in chips) 
Seat 6: cankum ($71.50 in chips) 
HansMSM: posts small blind $0.10
Mandu_xiii: posts big blind $0.25
*** HOLE CARDS ***
Dealt to SantiagoWeight [5h Qd]
HonourMan23: folds 
SantiagoWeight: folds 
cankum: folds 
Paasinha: raises $0.50 to $0.75
HansMSM: raises $1.75 to $2.50
Mandu_xiii: folds 
Paasinha: folds 
Uncalled bet ($1.75) returned to HansMSM
HansMSM collected $1.75 from pot
HansMSM: doesn't show hand 
*** SUMMARY ***
Total pot $1.75 | Rake $0 
Seat 1: Paasinha (button) folded before Flop
Seat 2: HansMSM (small blind) collected ($1.75)
Seat 3: Mandu_xiii (big blind) folded before Flop
Seat 4: HonourMan23 folded before Flop (didn't bet)
Seat 5: SantiagoWeight folded before Flop (didn't bet)
Seat 6: cankum folded before Flop (didn't bet)



PokerStars Zoom Hand #195023522638:  Hold'em No Limit ($0.10/$0.25) - 2018/12/29 3:44:29 UTC [2018/12/28 22:44:29 ET]
Table 'Hydra' 6-max Seat #1 is the button
Seat 1: SantiagoWeight ($25.58 in chips) 
Seat 2: cankum ($71.60 in chips) 
Seat 3: yobbos ($27.48 in chips) 
Seat 4: Basebob ($26.51 in chips) 
Seat 5: Chrimmpam ($16.86 in chips) 
Seat 6: _BluDeeN_ ($31.42 in chips) 
cankum: posts small blind $0.10
yobbos: posts big blind $0.25
*** HOLE CARDS ***
Dealt to SantiagoWeight [4d 9h]
Basebob: folds 
Chrimmpam: folds 
_BluDeeN_: raises $0.50 to $0.75
SantiagoWeight: folds 
cankum: folds 
yobbos: calls $0.50
*** FLOP *** [Kc 2c 4h]
yobbos: checks 
_BluDeeN_: bets $1.25
yobbos: calls $1.25
*** TURN *** [Kc 2c 4h] [Kd]
yobbos: checks 
_BluDeeN_: bets $2.75
yobbos: calls $2.75
*** RIVER *** [Kc 2c 4h Kd] [4s]
yobbos: checks 
_BluDeeN_: checks 
*** SHOW DOWN ***
yobbos: shows [Jc Ac] (two pair, Kings and Fours)
_BluDeeN_: shows [Qc Ad] (two pair, Kings and Fours)
yobbos collected $4.59 from pot
_BluDeeN_ collected $4.58 from pot
*** SUMMARY ***
Total pot $9.60 | Rake $0.43 
Board [Kc 2c 4h Kd 4s]
Seat 1: SantiagoWeight (button) folded before Flop (didn't bet)
Seat 2: cankum (small blind) folded before Flop
Seat 3: yobbos (big blind) showed [Jc Ac] and won ($4.59) with two pair, Kings and Fours
Seat 4: Basebob folded before Flop (didn't bet)
Seat 5: Chrimmpam folded before Flop (didn't bet)
Seat 6: _BluDeeN_ showed [Qc Ad] and won ($4.58) with two pair, Kings and Fours



PokerStars Zoom Hand #195023549551:  Hold'em No Limit ($0.10/$0.25) - 2018/12/29 3:45:38 UTC [2018/12/28 22:45:38 ET]
Table 'Hydra' 6-max Seat #1 is the button
Seat 1: miru877 ($61.15 in chips) 
Seat 2: numbernine5 ($57.14 in chips) 
Seat 3: SantiagoWeight ($26.18 in chips) 
Seat 4: Slim Wolfie ($27.05 in chips) 
Seat 5: Mrs_Squeeze ($24.65 in chips) 
Seat 6: Chrimmpam ($22.54 in chips) 
numbernine5: posts small blind $0.10
SantiagoWeight: posts big blind $0.25
*** HOLE CARDS ***
Dealt to SantiagoWeight [Jc Kd]
Slim Wolfie: folds 
Mrs_Squeeze: folds 
Chrimmpam: raises $0.60 to $0.85
miru877: folds 
numbernine5: folds 
SantiagoWeight: folds 
Uncalled bet ($0.60) returned to Chrimmpam
Chrimmpam collected $0.60 from pot
Chrimmpam: doesn't show hand 
*** SUMMARY ***
Total pot $0.60 | Rake $0 
Seat 1: miru877 (button) folded before Flop (didn't bet)
Seat 2: numbernine5 (small blind) folded before Flop
Seat 3: SantiagoWeight (big blind) folded before Flop
Seat 4: Slim Wolfie folded before Flop (didn't bet)
Seat 5: Mrs_Squeeze folded before Flop (didn't bet)
Seat 6: Chrimmpam collected ($0.60)



PokerStars Zoom Hand #195023547993:  Hold'em No Limit ($0.10/$0.25) - 2018/12/29 3:45:33 UTC [2018/12/28 22:45:33 ET]
Table 'Hydra' 6-max Seat #1 is the button
Seat 1: Ovanes911 ($16.92 in chips) 
Seat 2: reggiedogg31 ($99.47 in chips) 
Seat 3: nhanminhtri ($25.99 in chips) 
Seat 4: SantiagoWeight ($26.18 in chips) 
Seat 5: miru877 ($28.27 in chips) 
Seat 6: pirosiky ($25 in chips) 
reggiedogg31: posts small blind $0.10
nhanminhtri: posts big blind $0.25
*** HOLE CARDS ***
Dealt to SantiagoWeight [9s 5h]
SantiagoWeight: folds 
miru877: folds 
pirosiky: folds 
Ovanes911: folds 
reggiedogg31: calls $0.15
nhanminhtri: checks 
*** FLOP *** [Kh Td 3c]
reggiedogg31: checks 
nhanminhtri: bets $0.48
reggiedogg31: folds 
Uncalled bet ($0.48) returned to nhanminhtri
nhanminhtri collected $0.48 from pot
nhanminhtri: doesn't show hand 
*** SUMMARY ***
Total pot $0.50 | Rake $0.02 
Board [Kh Td 3c]
Seat 1: Ovanes911 (button) folded before Flop (didn't bet)
Seat 2: reggiedogg31 (small blind) folded on the Flop
Seat 3: nhanminhtri (big blind) collected ($0.48)
Seat 4: SantiagoWeight folded before Flop (didn't bet)
Seat 5: miru877 folded before Flop (didn't bet)
Seat 6: pirosiky folded before Flop (didn't bet)



PokerStars Zoom Hand #195023555903:  Hold'em No Limit ($0.10/$0.25) - 2018/12/29 3:45:58 UTC [2018/12/28 22:45:58 ET]
Table 'Hydra' 6-max Seat #1 is the button
Seat 1: assassin0875 ($161.76 in chips) 
Seat 2: SantiagoWeight ($25.93 in chips) 
Seat 3: davidhw888 ($24.35 in chips) 
Seat 4: zbuci ($25.82 in chips) 
Seat 5: angipoker ($12.50 in chips) 
Seat 6: Pardaroxon ($50.91 in chips) 
SantiagoWeight: posts small blind $0.10
davidhw888: posts big blind $0.25
*** HOLE CARDS ***
Dealt to SantiagoWeight [8s 2d]
zbuci: folds 
angipoker: raises $0.37 to $0.62
Pardaroxon: folds 
assassin0875: folds 
SantiagoWeight: folds 
davidhw888: folds 
Uncalled bet ($0.37) returned to angipoker
angipoker collected $0.60 from pot
angipoker: doesn't show hand 
*** SUMMARY ***
Total pot $0.60 | Rake $0 
Seat 1: assassin0875 (button) folded before Flop (didn't bet)
Seat 2: SantiagoWeight (small blind) folded before Flop
Seat 3: davidhw888 (big blind) folded before Flop
Seat 4: zbuci folded before Flop (didn't bet)
Seat 5: angipoker collected ($0.60)
Seat 6: Pardaroxon folded before Flop (didn't bet)



PokerStars Zoom Hand #195023565687:  Hold'em No Limit ($0.10/$0.25) - 2018/12/29 3:46:29 UTC [2018/12/28 22:46:29 ET]
Table 'Hydra' 6-max Seat #1 is the button
Seat 1: SantiagoWeight ($25.83 in chips) 
Seat 2: angipoker ($12.85 in chips) 
Seat 3: 1ownYourUsd ($57.44 in chips) 
Seat 4: Fishnoobking ($19.72 in chips) 
Seat 5: Pardaroxon ($50.81 in chips) 
Seat 6: MoMoney2612 ($31.15 in chips) 
angipoker: posts small blind $0.10
1ownYourUsd: posts big blind $0.25
*** HOLE CARDS ***
Dealt to SantiagoWeight [3s 7s]
Fishnoobking: raises $0.50 to $0.75
Pardaroxon: folds 
MoMoney2612: folds 
SantiagoWeight: folds 
angipoker: folds 
1ownYourUsd: folds 
Uncalled bet ($0.50) returned to Fishnoobking
Fishnoobking collected $0.60 from pot
Fishnoobking: doesn't show hand 
*** SUMMARY ***
Total pot $0.60 | Rake $0 
Seat 1: SantiagoWeight (button) folded before Flop (didn't bet)
Seat 2: angipoker (small blind) folded before Flop
Seat 3: 1ownYourUsd (big blind) folded before Flop
Seat 4: Fishnoobking collected ($0.60)
Seat 5: Pardaroxon folded before Flop (didn't bet)
Seat 6: MoMoney2612 folded before Flop (didn't bet)



PokerStars Zoom Hand #195023564087:  Hold'em No Limit ($0.10/$0.25) - 2018/12/29 3:46:24 UTC [2018/12/28 22:46:24 ET]
Table 'Hydra' 6-max Seat #1 is the button
Seat 1: sigaro010 ($91.96 in chips) 
Seat 2: ssrace ($34.60 in chips) 
Seat 3: Renner32 ($25.22 in chips) 
Seat 4: crux1994 ($14.91 in chips) 
Seat 5: SantiagoWeight ($25.83 in chips) 
Seat 6: playazhate ($25 in chips) 
ssrace: posts small blind $0.10
Renner32: posts big blind $0.25
*** HOLE CARDS ***
Dealt to SantiagoWeight [Qc 8h]
crux1994: raises $0.50 to $0.75
SantiagoWeight: folds 
playazhate: folds 
sigaro010: folds 
ssrace: calls $0.65
Renner32: folds 
*** FLOP *** [4s 7h 5h]
ssrace: checks 
crux1994: checks 
*** TURN *** [4s 7h 5h] [3c]
ssrace: checks 
crux1994: bets $0.75
ssrace: calls $0.75
*** RIVER *** [4s 7h 5h 3c] [7s]
ssrace: checks 
crux1994: bets $2.50
ssrace: folds 
Uncalled bet ($2.50) returned to crux1994
crux1994 collected $3.10 from pot
crux1994: doesn't show hand 
*** SUMMARY ***
Total pot $3.25 | Rake $0.15 
Board [4s 7h 5h 3c 7s]
Seat 1: sigaro010 (button) folded before Flop (didn't bet)
Seat 2: ssrace (small blind) folded on the River
Seat 3: Renner32 (big blind) folded before Flop
Seat 4: crux1994 collected ($3.10)
Seat 5: SantiagoWeight folded before Flop (didn't bet)
Seat 6: playazhate folded before Flop (didn't bet)



PokerStars Zoom Hand #195023560669:  Hold'em No Limit ($0.10/$0.25) - 2018/12/29 3:46:13 UTC [2018/12/28 22:46:13 ET]
Table 'Hydra' 6-max Seat #1 is the button
Seat 1: SantiagoWeight ($25.83 in chips) 
Seat 2: miba16 ($24.75 in chips) 
Seat 3: Basebob ($26.06 in chips) 
Seat 4: xman141 ($40.47 in chips) 
Seat 5: G ster24 ($38.15 in chips) 
Seat 6: Rollout2018 ($39.47 in chips) 
miba16: posts small blind $0.10
Basebob: posts big blind $0.25
*** HOLE CARDS ***
Dealt to SantiagoWeight [9h 8c]
xman141: folds 
G ster24: folds 
Rollout2018: raises $0.50 to $0.75
SantiagoWeight: folds 
miba16: calls $0.65
Basebob: calls $0.50
*** FLOP *** [Jh Ad 3d]
miba16: bets $0.25
Basebob: calls $0.25
Rollout2018: raises $2 to $2.25
miba16: calls $2
Basebob: folds 
*** TURN *** [Jh Ad 3d] [2d]
miba16: checks 
Rollout2018: bets $3.34
miba16: folds 
Uncalled bet ($3.34) returned to Rollout2018
Rollout2018 collected $6.68 from pot
Rollout2018: doesn't show hand 
*** SUMMARY ***
Total pot $7 | Rake $0.32 
Board [Jh Ad 3d 2d]
Seat 1: SantiagoWeight (button) folded before Flop (didn't bet)
Seat 2: miba16 (small blind) folded on the Turn
Seat 3: Basebob (big blind) folded on the Flop
Seat 4: xman141 folded before Flop (didn't bet)
Seat 5: G ster24 folded before Flop (didn't bet)
Seat 6: Rollout2018 collected ($6.68)



PokerStars Zoom Hand #195023567499:  Hold'em No Limit ($0.10/$0.25) - 2018/12/29 3:46:35 UTC [2018/12/28 22:46:35 ET]
Table 'Hydra' 6-max Seat #1 is the button
Seat 1: Party4Arthy ($56.32 in chips) 
Seat 2: deaglepro ($71.61 in chips) 
Seat 3: winwinboy ($25 in chips) 
Seat 4: Lehared ($26.25 in chips) 
Seat 5: KeySssi ($25.95 in chips) 
Seat 6: SantiagoWeight ($25.83 in chips) 
deaglepro: posts small blind $0.10
winwinboy: posts big blind $0.25
*** HOLE CARDS ***
Dealt to SantiagoWeight [2s 4s]
Lehared: folds 
KeySssi: folds 
SantiagoWeight: folds 
Party4Arthy: raises $0.25 to $0.50
deaglepro: folds 
winwinboy: raises $1.10 to $1.60
Party4Arthy: calls $1.10
*** FLOP *** [4h Ks As]
winwinboy: bets $1.50
Party4Arthy: folds 
Uncalled bet ($1.50) returned to winwinboy
winwinboy collected $3.15 from pot
winwinboy: doesn't show hand 
*** SUMMARY ***
Total pot $3.30 | Rake $0.15 
Board [4h Ks As]
Seat 1: Party4Arthy (button) folded on the Flop
Seat 2: deaglepro (small blind) folded before Flop
Seat 3: winwinboy (big blind) collected ($3.15)
Seat 4: Lehared folded before Flop (didn't bet)
Seat 5: KeySssi folded before Flop (didn't bet)
Seat 6: SantiagoWeight folded before Flop (didn't bet)



PokerStars Zoom Hand #195023575069:  Hold'em No Limit ($0.10/$0.25) - 2018/12/29 3:46:59 UTC [2018/12/28 22:46:59 ET]
Table 'Hydra' 6-max Seat #1 is the button
Seat 1: Chrimmpam ($12.65 in chips) 
Seat 2: SantiagoWeight ($25.83 in chips) 
Seat 3: Fishnoobking ($19.97 in chips) 
Seat 4: ivann14 ($78.45 in chips) 
Seat 5: reademenweep ($13.78 in chips) 
Seat 6: miru877 ($23.39 in chips) 
SantiagoWeight: posts small blind $0.10
Fishnoobking: posts big blind $0.25
*** HOLE CARDS ***
Dealt to SantiagoWeight [2d Ac]
ivann14: folds 
reademenweep: raises $1.50 to $1.75
miru877: folds 
Chrimmpam: folds 
SantiagoWeight: folds 
Fishnoobking: folds 
Uncalled bet ($1.50) returned to reademenweep
reademenweep collected $0.60 from pot
reademenweep: doesn't show hand 
*** SUMMARY ***
Total pot $0.60 | Rake $0 
Seat 1: Chrimmpam (button) folded before Flop (didn't bet)
Seat 2: SantiagoWeight (small blind) folded before Flop
Seat 3: Fishnoobking (big blind) folded before Flop
Seat 4: ivann14 folded before Flop (didn't bet)
Seat 5: reademenweep collected ($0.60)
Seat 6: miru877 folded before Flop (didn't bet)



PokerStars Zoom Hand #195023582333:  Hold'em No Limit ($0.10/$0.25) - 2018/12/29 3:47:22 UTC [2018/12/28 22:47:22 ET]
Table 'Hydra' 6-max Seat #1 is the button
Seat 1: river plate9 ($25.66 in chips) 
Seat 2: ryanking99 ($36.68 in chips) 
Seat 3: SantiagoWeight ($25.73 in chips) 
Seat 4: Chrimmpam ($21.19 in chips) 
Seat 5: yobbos ($74.21 in chips) 
Seat 6: Pardaroxon ($50.56 in chips) 
ryanking99: posts small blind $0.10
SantiagoWeight: posts big blind $0.25
*** HOLE CARDS ***
Dealt to SantiagoWeight [9c Jc]
Chrimmpam: folds 
yobbos: raises $0.50 to $0.75
Pardaroxon: folds 
river plate9: folds 
ryanking99: calls $0.65
SantiagoWeight: calls $0.50
*** FLOP *** [As 2c 3c]
ryanking99: checks 
SantiagoWeight: checks 
yobbos: checks 
*** TURN *** [As 2c 3c] [8d]
ryanking99: bets $1.57
SantiagoWeight: calls $1.57
yobbos: calls $1.57
*** RIVER *** [As 2c 3c 8d] [4s]
ryanking99: checks 
SantiagoWeight: bets $8.20
yobbos: folds 
ryanking99: folds 
Uncalled bet ($8.20) returned to SantiagoWeight
SantiagoWeight collected $6.65 from pot
SantiagoWeight: doesn't show hand 
*** SUMMARY ***
Total pot $6.96 | Rake $0.31 
Board [As 2c 3c 8d 4s]
Seat 1: river plate9 (button) folded before Flop (didn't bet)
Seat 2: ryanking99 (small blind) folded on the River
Seat 3: SantiagoWeight (big blind) collected ($6.65)
Seat 4: Chrimmpam folded before Flop (didn't bet)
Seat 5: yobbos folded on the River
Seat 6: Pardaroxon folded before Flop (didn't bet)



PokerStars Zoom Hand #195023614959:  Hold'em No Limit ($0.10/$0.25) - 2018/12/29 3:49:07 UTC [2018/12/28 22:49:07 ET]
Table 'Hydra' 6-max Seat #1 is the button
Seat 1: ruiken ($32.74 in chips) 
Seat 2: SantiagoWeight ($30.06 in chips) 
Seat 3: ssrace ($33.37 in chips) 
Seat 4: ckriszee ($28.40 in chips) 
Seat 5: pRoma66 ($26.25 in chips) 
Seat 6: deaglepro ($73.24 in chips) 
SantiagoWeight: posts small blind $0.10
ssrace: posts big blind $0.25
*** HOLE CARDS ***
Dealt to SantiagoWeight [7d Jc]
ckriszee: folds 
pRoma66: folds 
deaglepro: folds 
ruiken: raises $0.50 to $0.75
SantiagoWeight: folds 
ssrace: folds 
Uncalled bet ($0.50) returned to ruiken
ruiken collected $0.60 from pot
ruiken: doesn't show hand 
*** SUMMARY ***
Total pot $0.60 | Rake $0 
Seat 1: ruiken (button) collected ($0.60)
Seat 2: SantiagoWeight (small blind) folded before Flop
Seat 3: ssrace (big blind) folded before Flop
Seat 4: ckriszee folded before Flop (didn't bet)
Seat 5: pRoma66 folded before Flop (didn't bet)
Seat 6: deaglepro folded before Flop (didn't bet)



PokerStars Zoom Hand #195023613975:  Hold'em No Limit ($0.10/$0.25) - 2018/12/29 3:49:04 UTC [2018/12/28 22:49:04 ET]
Table 'Hydra' 6-max Seat #1 is the button
Seat 1: reademenweep ($15.12 in chips) 
Seat 2: miru877 ($61.53 in chips) 
Seat 3: Chrimmpam ($23.16 in chips) 
Seat 4: donmarc777 ($89.14 in chips) 
Seat 5: SantiagoWeight ($30.06 in chips) 
Seat 6: davidhw888 ($25.64 in chips) 
miru877: posts small blind $0.10
Chrimmpam: posts big blind $0.25
*** HOLE CARDS ***
Dealt to SantiagoWeight [4s 8h]
donmarc777: folds 
SantiagoWeight: folds 
davidhw888: folds 
reademenweep: folds 
miru877: raises $0.50 to $0.75
Chrimmpam: calls $0.50
*** FLOP *** [Qc 3d Qd]
miru877: bets $0.47
Chrimmpam: raises $1.28 to $1.75
miru877: folds 
Uncalled bet ($1.28) returned to Chrimmpam
Chrimmpam collected $2.33 from pot
Chrimmpam: doesn't show hand 
*** SUMMARY ***
Total pot $2.44 | Rake $0.11 
Board [Qc 3d Qd]
Seat 1: reademenweep (button) folded before Flop (didn't bet)
Seat 2: miru877 (small blind) folded on the Flop
Seat 3: Chrimmpam (big blind) collected ($2.33)
Seat 4: donmarc777 folded before Flop (didn't bet)
Seat 5: SantiagoWeight folded before Flop (didn't bet)
Seat 6: davidhw888 folded before Flop (didn't bet)



PokerStars Zoom Hand #195023570646:  Hold'em No Limit ($0.10/$0.25) - 2018/12/29 3:46:45 UTC [2018/12/28 22:46:45 ET]
Table 'Hydra' 6-max Seat #1 is the button
Seat 1: mariopork ($72.46 in chips) 
Seat 2: davidhw888 ($24.10 in chips) 
Seat 3: river plate9 ($26.01 in chips) 
Seat 4: graysonai ($35.05 in chips) 
Seat 5: SantiagoWeight ($25.83 in chips) 
Seat 6: osa126 ($35.91 in chips) 
davidhw888: posts small blind $0.10
river plate9: posts big blind $0.25
*** HOLE CARDS ***
Dealt to SantiagoWeight [2d 2h]
graysonai: folds 
SantiagoWeight: folds 
osa126: raises $0.50 to $0.75
mariopork: raises $1.75 to $2.50
davidhw888: folds 
river plate9: folds 
osa126: calls $1.75
*** FLOP *** [5d As 3c]
osa126: checks 
mariopork: bets $1.69
osa126: calls $1.69
*** TURN *** [5d As 3c] [Kh]
osa126: checks 
mariopork: bets $6
osa126: calls $6
*** RIVER *** [5d As 3c Kh] [Ad]
osa126: checks 
mariopork: bets $16
osa126 said, "KK?"
mariopork said, "a"
osa126 said, "I have AQ"
mariopork said, "me too"
osa126 said, "you too"
osa126: folds 
Uncalled bet ($16) returned to mariopork
mariopork collected $19.80 from pot
mariopork: doesn't show hand 
*** SUMMARY ***
Total pot $20.73 | Rake $0.93 
Board [5d As 3c Kh Ad]
Seat 1: mariopork (button) collected ($19.80)
Seat 2: davidhw888 (small blind) folded before Flop
Seat 3: river plate9 (big blind) folded before Flop
Seat 4: graysonai folded before Flop (didn't bet)
Seat 5: SantiagoWeight folded before Flop (didn't bet)
Seat 6: osa126 folded on the River



PokerStars Zoom Hand #195023623968:  Hold'em No Limit ($0.10/$0.25) - 2018/12/29 3:49:36 UTC [2018/12/28 22:49:36 ET]
Table 'Hydra' 6-max Seat #1 is the button
Seat 1: 777jsmith ($10.11 in chips) 
Seat 2: aldoalb0207 ($44.63 in chips) 
Seat 3: gustavotaina ($12.15 in chips) 
Seat 4: winwinboy ($25.78 in chips) 
Seat 5: franco373513 ($14.22 in chips) 
Seat 6: SantiagoWeight ($29.96 in chips) 
aldoalb0207: posts small blind $0.10
gustavotaina: posts big blind $0.25
*** HOLE CARDS ***
Dealt to SantiagoWeight [Qs 8d]
winwinboy: folds 
franco373513: folds 
SantiagoWeight: folds 
777jsmith: calls $0.25
aldoalb0207: folds 
gustavotaina: checks 
*** FLOP *** [Kc Qh 5s]
gustavotaina: checks 
777jsmith: bets $0.29
gustavotaina: folds 
Uncalled bet ($0.29) returned to 777jsmith
777jsmith collected $0.57 from pot
777jsmith: doesn't show hand 
*** SUMMARY ***
Total pot $0.60 | Rake $0.03 
Board [Kc Qh 5s]
Seat 1: 777jsmith (button) collected ($0.57)
Seat 2: aldoalb0207 (small blind) folded before Flop
Seat 3: gustavotaina (big blind) folded on the Flop
Seat 4: winwinboy folded before Flop (didn't bet)
Seat 5: franco373513 folded before Flop (didn't bet)
Seat 6: SantiagoWeight folded before Flop (didn't bet)



PokerStars Zoom Hand #195023620241:  Hold'em No Limit ($0.10/$0.25) - 2018/12/29 3:49:24 UTC [2018/12/28 22:49:24 ET]
Table 'Hydra' 6-max Seat #1 is the button
Seat 1: SantiagoWeight ($29.96 in chips) 
Seat 2: reademenweep ($15.12 in chips) 
Seat 3: dithflo ($24.50 in chips) 
Seat 4: davidhw888 ($25.64 in chips) 
Seat 5: gaffer31 ($22.90 in chips) 
Seat 6: bwim ($23.65 in chips) 
reademenweep: posts small blind $0.10
dithflo: posts big blind $0.25
*** HOLE CARDS ***
Dealt to SantiagoWeight [5d Ah]
davidhw888: folds 
gaffer31: calls $0.25
bwim: folds 
SantiagoWeight: folds 
reademenweep: calls $0.15
dithflo: checks 
*** FLOP *** [Kd 9d Jd]
reademenweep: bets $0.75
dithflo: calls $0.75
gaffer31: folds 
*** TURN *** [Kd 9d Jd] [3h]
reademenweep: bets $0.75
dithflo: calls $0.75
*** RIVER *** [Kd 9d Jd 3h] [Ts]
reademenweep: bets $0.75
dithflo: calls $0.75
*** SHOW DOWN ***
reademenweep: shows [9s Js] (two pair, Jacks and Nines)
dithflo: mucks hand 
reademenweep collected $5.01 from pot
*** SUMMARY ***
Total pot $5.25 | Rake $0.24 
Board [Kd 9d Jd 3h Ts]
Seat 1: SantiagoWeight (button) folded before Flop (didn't bet)
Seat 2: reademenweep (small blind) showed [9s Js] and won ($5.01) with two pair, Jacks and Nines
Seat 3: dithflo (big blind) mucked [Jc 7d]
Seat 4: davidhw888 folded before Flop (didn't bet)
Seat 5: gaffer31 folded on the Flop
Seat 6: bwim folded before Flop (didn't bet)



PokerStars Zoom Hand #195023631008:  Hold'em No Limit ($0.10/$0.25) - 2018/12/29 3:49:59 UTC [2018/12/28 22:49:59 ET]
Table 'Hydra' 6-max Seat #1 is the button
Seat 1: gustavotaina ($11.90 in chips) 
Seat 2: Fishnoobking ($20.64 in chips) 
Seat 3: miru877 ($23.86 in chips) 
Seat 4: mariopork ($82.17 in chips) 
Seat 5: TDAK1509 ($37.44 in chips) 
Seat 6: SantiagoWeight ($29.71 in chips) 
Fishnoobking: posts small blind $0.10
miru877: posts big blind $0.25
*** HOLE CARDS ***
Dealt to SantiagoWeight [4c 6c]
mariopork: folds 
TDAK1509: folds 
SantiagoWeight: folds 
gustavotaina: folds 
Fishnoobking: folds 
Uncalled bet ($0.15) returned to miru877
miru877 collected $0.20 from pot
miru877: doesn't show hand 
*** SUMMARY ***
Total pot $0.20 | Rake $0 
Seat 1: gustavotaina (button) folded before Flop (didn't bet)
Seat 2: Fishnoobking (small blind) folded before Flop
Seat 3: miru877 (big blind) collected ($0.20)
Seat 4: mariopork folded before Flop (didn't bet)
Seat 5: TDAK1509 folded before Flop (didn't bet)
Seat 6: SantiagoWeight folded before Flop (didn't bet)



PokerStars Zoom Hand #195023625856:  Hold'em No Limit ($0.10/$0.25) - 2018/12/29 3:49:42 UTC [2018/12/28 22:49:42 ET]
Table 'Hydra' 6-max Seat #1 is the button
Seat 1: 88*SaaS*99 ($15.11 in chips) 
Seat 2: trttt74 ($29.76 in chips) 
Seat 3: SantiagoWeight ($29.96 in chips) 
Seat 4: mariopork ($26.58 in chips) 
Seat 5: fishnm2018 ($27.44 in chips) 
Seat 6: ryanking99 ($38.23 in chips) 
trttt74: posts small blind $0.10
SantiagoWeight: posts big blind $0.25
*** HOLE CARDS ***
Dealt to SantiagoWeight [Tc 2d]
mariopork: folds 
fishnm2018: folds 
ryanking99: raises $0.31 to $0.56
88*SaaS*99: folds 
trttt74: calls $0.46
SantiagoWeight: folds 
*** FLOP *** [8d 3s 9c]
trttt74: checks 
ryanking99: bets $1.44
trttt74: calls $1.44
*** TURN *** [8d 3s 9c] [2h]
trttt74: bets $1.76
ryanking99: calls $1.76
*** RIVER *** [8d 3s 9c 2h] [Qs]
trttt74: checks 
ryanking99: checks 
*** SHOW DOWN ***
trttt74: shows [Ts Qc] (a pair of Queens)
ryanking99: mucks hand 
trttt74 collected $7.42 from pot
*** SUMMARY ***
Total pot $7.77 | Rake $0.35 
Board [8d 3s 9c 2h Qs]
Seat 1: 88*SaaS*99 (button) folded before Flop (didn't bet)
Seat 2: trttt74 (small blind) showed [Ts Qc] and won ($7.42) with a pair of Queens
Seat 3: SantiagoWeight (big blind) folded before Flop
Seat 4: mariopork folded before Flop (didn't bet)
Seat 5: fishnm2018 folded before Flop (didn't bet)
Seat 6: ryanking99 mucked [Js Jd]



PokerStars Zoom Hand #195023634958:  Hold'em No Limit ($0.10/$0.25) - 2018/12/29 3:50:12 UTC [2018/12/28 22:50:12 ET]
Table 'Hydra' 6-max Seat #1 is the button
Seat 1: Mrs_Squeeze ($18.34 in chips) 
Seat 2: TDAK1509 ($37.44 in chips) 
Seat 3: river plate9 ($26.68 in chips) 
Seat 4: Renner32 ($23.38 in chips) 
Seat 5: SantiagoWeight ($29.71 in chips) 
Seat 6: Pardaroxon ($50.76 in chips) 
TDAK1509: posts small blind $0.10
river plate9: posts big blind $0.25
*** HOLE CARDS ***
Dealt to SantiagoWeight [Qd 3c]
Renner32: folds 
SantiagoWeight: folds 
Pardaroxon: folds 
Mrs_Squeeze: folds 
TDAK1509: raises $0.50 to $0.75
river plate9: calls $0.50
*** FLOP *** [6c Ks 6d]
TDAK1509: bets $0.75
river plate9: folds 
Uncalled bet ($0.75) returned to TDAK1509
TDAK1509 collected $1.43 from pot
TDAK1509: doesn't show hand 
*** SUMMARY ***
Total pot $1.50 | Rake $0.07 
Board [6c Ks 6d]
Seat 1: Mrs_Squeeze (button) folded before Flop (didn't bet)
Seat 2: TDAK1509 (small blind) collected ($1.43)
Seat 3: river plate9 (big blind) folded on the Flop
Seat 4: Renner32 folded before Flop (didn't bet)
Seat 5: SantiagoWeight folded before Flop (didn't bet)
Seat 6: Pardaroxon folded before Flop (didn't bet)



PokerStars Zoom Hand #195023637106:  Hold'em No Limit ($0.10/$0.25) - 2018/12/29 3:50:19 UTC [2018/12/28 22:50:19 ET]
Table 'Hydra' 6-max Seat #1 is the button
Seat 1: miru877 ($60.31 in chips) 
Seat 2: Pardaroxon ($50.76 in chips) 
Seat 3: golf7287 ($32.65 in chips) 
Seat 4: SantiagoWeight ($29.71 in chips) 
Seat 5: 777jsmith ($10.08 in chips) 
Seat 6: anorectal ($25 in chips) 
Pardaroxon: posts small blind $0.10
golf7287: posts big blind $0.25
*** HOLE CARDS ***
Dealt to SantiagoWeight [Jh Ac]
SantiagoWeight: raises $0.42 to $0.67
777jsmith: folds 
anorectal: folds 
miru877: raises $1.69 to $2.36
Pardaroxon: folds 
golf7287: folds 
SantiagoWeight: folds 
Uncalled bet ($1.69) returned to miru877
miru877 collected $1.69 from pot
*** SUMMARY ***
Total pot $1.69 | Rake $0 
Seat 1: miru877 (button) collected ($1.69)
Seat 2: Pardaroxon (small blind) folded before Flop
Seat 3: golf7287 (big blind) folded before Flop
Seat 4: SantiagoWeight folded before Flop
Seat 5: 777jsmith folded before Flop (didn't bet)
Seat 6: anorectal folded before Flop (didn't bet)



PokerStars Zoom Hand #195023646982:  Hold'em No Limit ($0.10/$0.25) - 2018/12/29 3:50:51 UTC [2018/12/28 22:50:51 ET]
Table 'Hydra' 6-max Seat #1 is the button
Seat 1: SantiagoWeight ($28.94 in chips) 
Seat 2: Chrimmpam ($20.37 in chips) 
Seat 3: nhanminhtri ($25 in chips) 
Seat 4: Pardaroxon ($50.41 in chips) 
Seat 5: osa126 ($61.25 in chips) 
Seat 6: Lehared ($25 in chips) 
Chrimmpam: posts small blind $0.10
nhanminhtri: posts big blind $0.25
*** HOLE CARDS ***
Dealt to SantiagoWeight [Jh 3h]
Pardaroxon: folds 
osa126: folds 
Lehared: folds 
SantiagoWeight has timed out
SantiagoWeight: folds 
Chrimmpam: folds 
Uncalled bet ($0.15) returned to nhanminhtri
nhanminhtri collected $0.20 from pot
nhanminhtri: doesn't show hand 
*** SUMMARY ***
Total pot $0.20 | Rake $0 
Seat 1: SantiagoWeight (button) folded before Flop (didn't bet)
Seat 2: Chrimmpam (small blind) folded before Flop
Seat 3: nhanminhtri (big blind) collected ($0.20)
Seat 4: Pardaroxon folded before Flop (didn't bet)
Seat 5: osa126 folded before Flop (didn't bet)
Seat 6: Lehared folded before Flop (didn't bet)



PokerStars Zoom Hand #195023654929:  Hold'em No Limit ($0.10/$0.25) - 2018/12/29 3:51:17 UTC [2018/12/28 22:51:17 ET]
Table 'Hydra' 6-max Seat #1 is the button
Seat 1: Lehared ($60.32 in chips) 
Seat 2: Viiiru ($70.84 in chips) 
Seat 3: reademenweep ($17.98 in chips) 
Seat 4: landromede ($16.86 in chips) 
Seat 5: SantiagoWeight ($28.94 in chips) 
Seat 6: CrazieFreddy ($14.55 in chips) 
Viiiru: posts small blind $0.10
reademenweep: posts big blind $0.25
*** HOLE CARDS ***
Dealt to SantiagoWeight [Td Qd]
landromede: folds 
SantiagoWeight: raises $0.37 to $0.62
CrazieFreddy: folds 
Lehared: folds 
Viiiru: folds 
reademenweep: calls $0.37
*** FLOP *** [Th 5d 2h]
reademenweep: checks 
SantiagoWeight: bets $0.85
reademenweep: folds 
Uncalled bet ($0.85) returned to SantiagoWeight
SantiagoWeight collected $1.28 from pot
SantiagoWeight: doesn't show hand 
*** SUMMARY ***
Total pot $1.34 | Rake $0.06 
Board [Th 5d 2h]
Seat 1: Lehared (button) folded before Flop (didn't bet)
Seat 2: Viiiru (small blind) folded before Flop
Seat 3: reademenweep (big blind) folded on the Flop
Seat 4: landromede folded before Flop (didn't bet)
Seat 5: SantiagoWeight collected ($1.28)
Seat 6: CrazieFreddy folded before Flop (didn't bet)



PokerStars Zoom Hand #195023643574:  Hold'em No Limit ($0.10/$0.25) - 2018/12/29 3:50:40 UTC [2018/12/28 22:50:40 ET]
Table 'Hydra' 6-max Seat #1 is the button
Seat 1: miba16 ($26.31 in chips) 
Seat 2: SantiagoWeight ($29.04 in chips) 
Seat 3: fishnm2018 ($27.09 in chips) 
Seat 4: lovintalbi ($59.09 in chips) 
Seat 5: nhanminhtri ($28.45 in chips) 
Seat 6: Chrimmpam ($15.01 in chips) 
SantiagoWeight: posts small blind $0.10
fishnm2018: posts big blind $0.25
*** HOLE CARDS ***
Dealt to SantiagoWeight [5d As]
lovintalbi: folds 
nhanminhtri: folds 
Chrimmpam: raises $0.60 to $0.85
miba16: calls $0.85
SantiagoWeight: folds 
fishnm2018: raises $2.65 to $3.50
Chrimmpam: calls $2.65
miba16: calls $2.65
*** FLOP *** [Jd Qs 9s]
fishnm2018: checks 
Chrimmpam: checks 
miba16: checks 
*** TURN *** [Jd Qs 9s] [2c]
fishnm2018: checks 
Chrimmpam: checks 
miba16: checks 
*** RIVER *** [Jd Qs 9s 2c] [5h]
fishnm2018: bets $10.12
Chrimmpam: folds 
miba16 is disconnected 
miba16: folds 
Uncalled bet ($10.12) returned to fishnm2018
fishnm2018 collected $10.12 from pot
fishnm2018: doesn't show hand 
*** SUMMARY ***
Total pot $10.60 | Rake $0.48 
Board [Jd Qs 9s 2c 5h]
Seat 1: miba16 (button) folded on the River
Seat 2: SantiagoWeight (small blind) folded before Flop
Seat 3: fishnm2018 (big blind) collected ($10.12)
Seat 4: lovintalbi folded before Flop (didn't bet)
Seat 5: nhanminhtri folded before Flop (didn't bet)
Seat 6: Chrimmpam folded on the River



PokerStars Zoom Hand #195023663217:  Hold'em No Limit ($0.10/$0.25) - 2018/12/29 3:51:44 UTC [2018/12/28 22:51:44 ET]
Table 'Hydra' 6-max Seat #1 is the button
Seat 1: naxizzle ($115.30 in chips) 
Seat 2: HansMSM ($66.33 in chips) 
Seat 3: osa126 ($25 in chips) 
Seat 4: SantiagoWeight ($29.60 in chips) 
Seat 5: sigaro010 ($95.77 in chips) 
Seat 6: golf7287 ($30.40 in chips) 
HansMSM: posts small blind $0.10
osa126: posts big blind $0.25
*** HOLE CARDS ***
Dealt to SantiagoWeight [6s 2s]
SantiagoWeight: folds 
sigaro010: raises $0.50 to $0.75
golf7287: folds 
naxizzle: folds 
HansMSM: folds 
osa126: calls $0.50
*** FLOP *** [7s Jd 3s]
osa126: checks 
sigaro010: checks 
*** TURN *** [7s Jd 3s] [8c]
osa126: bets $1.02
sigaro010: calls $1.02
*** RIVER *** [7s Jd 3s 8c] [5c]
osa126: checks 
sigaro010: bets $1
osa126: calls $1
*** SHOW DOWN ***
sigaro010: shows [Jc Qc] (a pair of Jacks)
osa126: shows [Kd Js] (a pair of Jacks - King kicker)
osa126 collected $5.39 from pot
*** SUMMARY ***
Total pot $5.64 | Rake $0.25 
Board [7s Jd 3s 8c 5c]
Seat 1: naxizzle (button) folded before Flop (didn't bet)
Seat 2: HansMSM (small blind) folded before Flop
Seat 3: osa126 (big blind) showed [Kd Js] and won ($5.39) with a pair of Jacks
Seat 4: SantiagoWeight folded before Flop (didn't bet)
Seat 5: sigaro010 showed [Jc Qc] and lost with a pair of Jacks
Seat 6: golf7287 folded before Flop (didn't bet)



PokerStars Zoom Hand #195023665348:  Hold'em No Limit ($0.10/$0.25) - 2018/12/29 3:51:51 UTC [2018/12/28 22:51:51 ET]
Table 'Hydra' 6-max Seat #1 is the button
Seat 1: ColinCaine ($7.71 in chips) 
Seat 2: yobbos ($46.88 in chips) 
Seat 3: SantiagoWeight ($29.60 in chips) 
Seat 4: donmarc777 ($85.29 in chips) 
Seat 5: MileVoliD49 ($32.73 in chips) 
Seat 6: franco373513 ($13.31 in chips) 
yobbos: posts small blind $0.10
SantiagoWeight: posts big blind $0.25
*** HOLE CARDS ***
Dealt to SantiagoWeight [7s 8s]
donmarc777: folds 
MileVoliD49: folds 
franco373513: folds 
ColinCaine: folds 
yobbos: raises $0.37 to $0.62
SantiagoWeight: calls $0.37
*** FLOP *** [Ts 2c 8h]
yobbos: bets $0.59
SantiagoWeight: calls $0.59
*** TURN *** [Ts 2c 8h] [8c]
yobbos: bets $0.79
SantiagoWeight: calls $0.79
*** RIVER *** [Ts 2c 8h 8c] [Ah]
yobbos: checks 
SantiagoWeight: bets $1.30
yobbos: calls $1.30
*** SHOW DOWN ***
SantiagoWeight: shows [7s 8s] (three of a kind, Eights)
yobbos: mucks hand 
SantiagoWeight collected $6.30 from pot
*** SUMMARY ***
Total pot $6.60 | Rake $0.30 
Board [Ts 2c 8h 8c Ah]
Seat 1: ColinCaine (button) folded before Flop (didn't bet)
Seat 2: yobbos (small blind) mucked [9d Qh]
Seat 3: SantiagoWeight (big blind) showed [7s 8s] and won ($6.30) with three of a kind, Eights
Seat 4: donmarc777 folded before Flop (didn't bet)
Seat 5: MileVoliD49 folded before Flop (didn't bet)
Seat 6: franco373513 folded before Flop (didn't bet)



PokerStars Zoom Hand #195023684817:  Hold'em No Limit ($0.10/$0.25) - 2018/12/29 3:52:55 UTC [2018/12/28 22:52:55 ET]
Table 'Hydra' 6-max Seat #1 is the button
Seat 1: nhanminhtri ($35.90 in chips) 
Seat 2: SantiagoWeight ($32.60 in chips) 
Seat 3: ckriszee ($33.85 in chips) 
Seat 4: yobbos ($43.58 in chips) 
Seat 5: naxizzle ($115.73 in chips) 
Seat 6: trttt74 ($23.54 in chips) 
SantiagoWeight: posts small blind $0.10
ckriszee: posts big blind $0.25
*** HOLE CARDS ***
Dealt to SantiagoWeight [Qd 6h]
yobbos: raises $0.50 to $0.75
naxizzle: folds 
trttt74: folds 
nhanminhtri: folds 
SantiagoWeight: folds 
ckriszee: folds 
Uncalled bet ($0.50) returned to yobbos
yobbos collected $0.60 from pot
yobbos: doesn't show hand 
*** SUMMARY ***
Total pot $0.60 | Rake $0 
Seat 1: nhanminhtri (button) folded before Flop (didn't bet)
Seat 2: SantiagoWeight (small blind) folded before Flop
Seat 3: ckriszee (big blind) folded before Flop
Seat 4: yobbos collected ($0.60)
Seat 5: naxizzle folded before Flop (didn't bet)
Seat 6: trttt74 folded before Flop (didn't bet)



PokerStars Zoom Hand #195023686919:  Hold'em No Limit ($0.10/$0.25) - 2018/12/29 3:53:02 UTC [2018/12/28 22:53:02 ET]
Table 'Hydra' 6-max Seat #1 is the button
Seat 1: fracar189 ($43.60 in chips) 
Seat 2: pirosiky ($25 in chips) 
Seat 3: zbuci ($22.70 in chips) 
Seat 4: Fobos113 ($23.80 in chips) 
Seat 5: G ster24 ($39.51 in chips) 
Seat 6: SantiagoWeight ($32.50 in chips) 
pirosiky: posts small blind $0.10
zbuci: posts big blind $0.25
*** HOLE CARDS ***
Dealt to SantiagoWeight [Ts 9s]
Fobos113: folds 
G ster24: folds 
SantiagoWeight: raises $0.30 to $0.55
fracar189: raises $1.45 to $2
pirosiky: folds 
zbuci: folds 
SantiagoWeight: calls $1.45
*** FLOP *** [9d 7c 5h]
SantiagoWeight: checks 
fracar189: bets $4.25
SantiagoWeight: calls $4.25
*** TURN *** [9d 7c 5h] [Kc]
SantiagoWeight: checks 
fracar189: bets $12.25
SantiagoWeight: folds 
Uncalled bet ($12.25) returned to fracar189
fracar189 collected $12.27 from pot
*** SUMMARY ***
Total pot $12.85 | Rake $0.58 
Board [9d 7c 5h Kc]
Seat 1: fracar189 (button) collected ($12.27)
Seat 2: pirosiky (small blind) folded before Flop
Seat 3: zbuci (big blind) folded before Flop
Seat 4: Fobos113 folded before Flop (didn't bet)
Seat 5: G ster24 folded before Flop (didn't bet)
Seat 6: SantiagoWeight folded on the Turn



PokerStars Zoom Hand #195023705555:  Hold'em No Limit ($0.10/$0.25) - 2018/12/29 3:54:03 UTC [2018/12/28 22:54:03 ET]
Table 'Hydra' 6-max Seat #1 is the button
Seat 1: ssrace ($37.07 in chips) 
Seat 2: ineedmoeny ($25.64 in chips) 
Seat 3: Chrimmpam ($19.67 in chips) 
Seat 4: SantiagoWeight ($26.25 in chips) 
Seat 5: miru877 ($24.65 in chips) 
Seat 6: razil_999 ($27.83 in chips) 
ineedmoeny: posts small blind $0.10
Chrimmpam: posts big blind $0.25
*** HOLE CARDS ***
Dealt to SantiagoWeight [5h Kc]
SantiagoWeight: folds 
miru877: folds 
razil_999: folds 
ssrace: folds 
ineedmoeny: folds 
Uncalled bet ($0.15) returned to Chrimmpam
Chrimmpam collected $0.20 from pot
Chrimmpam: doesn't show hand 
*** SUMMARY ***
Total pot $0.20 | Rake $0 
Seat 1: ssrace (button) folded before Flop (didn't bet)
Seat 2: ineedmoeny (small blind) folded before Flop
Seat 3: Chrimmpam (big blind) collected ($0.20)
Seat 4: SantiagoWeight folded before Flop (didn't bet)
Seat 5: miru877 folded before Flop (didn't bet)
Seat 6: razil_999 folded before Flop (didn't bet)



PokerStars Zoom Hand #195023702452:  Hold'em No Limit ($0.10/$0.25) - 2018/12/29 3:53:53 UTC [2018/12/28 22:53:53 ET]
Table 'Hydra' 6-max Seat #1 is the button
Seat 1: SantiagoWeight ($26.25 in chips) 
Seat 2: bwim ($24.85 in chips) 
Seat 3: Guard poker ($25 in chips) 
Seat 4: tariko1980 ($20.90 in chips) 
Seat 5: Albratros2 ($29.37 in chips) 
Seat 6: 2poiRiver ($29.55 in chips) 
bwim: posts small blind $0.10
Guard poker: posts big blind $0.25
*** HOLE CARDS ***
Dealt to SantiagoWeight [Js 4d]
tariko1980: calls $0.25
Albratros2: folds 
2poiRiver: folds 
SantiagoWeight: folds 
bwim: folds 
Guard poker: checks 
*** FLOP *** [7h Ad Kc]
Guard poker: bets $0.25
tariko1980: calls $0.25
*** TURN *** [7h Ad Kc] [Tc]
Guard poker: checks 
tariko1980: checks 
*** RIVER *** [7h Ad Kc Tc] [3d]
Guard poker: checks 
tariko1980: checks 
*** SHOW DOWN ***
Guard poker: shows [5s Qc] (high card Ace)
tariko1980: shows [8h 8d] (a pair of Eights)
tariko1980 collected $1.05 from pot
*** SUMMARY ***
Total pot $1.10 | Rake $0.05 
Board [7h Ad Kc Tc 3d]
Seat 1: SantiagoWeight (button) folded before Flop (didn't bet)
Seat 2: bwim (small blind) folded before Flop
Seat 3: Guard poker (big blind) showed [5s Qc] and lost with high card Ace
Seat 4: tariko1980 showed [8h 8d] and won ($1.05) with a pair of Eights
Seat 5: Albratros2 folded before Flop (didn't bet)
Seat 6: 2poiRiver folded before Flop (didn't bet)



PokerStars Zoom Hand #195023707664:  Hold'em No Limit ($0.10/$0.25) - 2018/12/29 3:54:10 UTC [2018/12/28 22:54:10 ET]
Table 'Hydra' 6-max Seat #1 is the button
Seat 1: bwim ($25.10 in chips) 
Seat 2: Lehared ($25.42 in chips) 
Seat 3: MileVoliD49 ($30.88 in chips) 
Seat 4: KAllUSTA ($23.02 in chips) 
Seat 5: SantiagoWeight ($26.25 in chips) 
Seat 6: river plate9 ($28.84 in chips) 
Lehared: posts small blind $0.10
MileVoliD49: posts big blind $0.25
*** HOLE CARDS ***
Dealt to SantiagoWeight [6h 6s]
KAllUSTA: folds 
SantiagoWeight: raises $0.37 to $0.62
river plate9: folds 
bwim: folds 
Lehared: folds 
MileVoliD49: folds 
Uncalled bet ($0.37) returned to SantiagoWeight
SantiagoWeight collected $0.60 from pot
SantiagoWeight: doesn't show hand 
*** SUMMARY ***
Total pot $0.60 | Rake $0 
Seat 1: bwim (button) folded before Flop (didn't bet)
Seat 2: Lehared (small blind) folded before Flop
Seat 3: MileVoliD49 (big blind) folded before Flop
Seat 4: KAllUSTA folded before Flop (didn't bet)
Seat 5: SantiagoWeight collected ($0.60)
Seat 6: river plate9 folded before Flop (didn't bet)



PokerStars Zoom Hand #195023713957:  Hold'em No Limit ($0.10/$0.25) - 2018/12/29 3:54:31 UTC [2018/12/28 22:54:31 ET]
Table 'Hydra' 6-max Seat #1 is the button
Seat 1: miba16 ($44.55 in chips) 
Seat 2: Fishnoobking ($23.77 in chips) 
Seat 3: 666erkan ($21.33 in chips) 
Seat 4: SantiagoWeight ($26.60 in chips) 
Seat 5: pirosiky ($25.75 in chips) 
Seat 6: xman141 ($38.97 in chips) 
Fishnoobking: posts small blind $0.10
666erkan: posts big blind $0.25
*** HOLE CARDS ***
Dealt to SantiagoWeight [8c 5s]
SantiagoWeight: folds 
pirosiky: folds 
xman141: folds 
miba16: folds 
Fishnoobking: raises $0.50 to $0.75
666erkan: calls $0.50
*** FLOP *** [7c 9c 9h]
Fishnoobking: bets $1
666erkan: folds 
Uncalled bet ($1) returned to Fishnoobking
Fishnoobking collected $1.43 from pot
Fishnoobking: doesn't show hand 
*** SUMMARY ***
Total pot $1.50 | Rake $0.07 
Board [7c 9c 9h]
Seat 1: miba16 (button) folded before Flop (didn't bet)
Seat 2: Fishnoobking (small blind) collected ($1.43)
Seat 3: 666erkan (big blind) folded on the Flop
Seat 4: SantiagoWeight folded before Flop (didn't bet)
Seat 5: pirosiky folded before Flop (didn't bet)
Seat 6: xman141 folded before Flop (didn't bet)



PokerStars Zoom Hand #195023720586:  Hold'em No Limit ($0.10/$0.25) - 2018/12/29 3:54:53 UTC [2018/12/28 22:54:53 ET]
Table 'Hydra' 6-max Seat #1 is the button
Seat 1: Party4Arthy ($62.85 in chips) 
Seat 2: _BluDeeN_ ($40.80 in chips) 
Seat 3: yobbos ($77.42 in chips) 
Seat 4: Chrimmpam ($20.87 in chips) 
Seat 5: --LeGaaNs-- ($77.59 in chips) 
Seat 6: SantiagoWeight ($26.35 in chips) 
_BluDeeN_: posts small blind $0.10
yobbos: posts big blind $0.25
*** HOLE CARDS ***
Dealt to SantiagoWeight [5d 3c]
Chrimmpam: folds 
--LeGaaNs--: folds 
SantiagoWeight: folds 
Party4Arthy: folds 
_BluDeeN_: folds 
Uncalled bet ($0.15) returned to yobbos
yobbos collected $0.20 from pot
yobbos: doesn't show hand 
*** SUMMARY ***
Total pot $0.20 | Rake $0 
Seat 1: Party4Arthy (button) folded before Flop (didn't bet)
Seat 2: _BluDeeN_ (small blind) folded before Flop
Seat 3: yobbos (big blind) collected ($0.20)
Seat 4: Chrimmpam folded before Flop (didn't bet)
Seat 5: --LeGaaNs-- folded before Flop (didn't bet)
Seat 6: SantiagoWeight folded before Flop (didn't bet)



PokerStars Zoom Hand #195023717247:  Hold'em No Limit ($0.10/$0.25) - 2018/12/29 3:54:42 UTC [2018/12/28 22:54:42 ET]
Table 'Hydra' 6-max Seat #1 is the button
Seat 1: lovintalbi ($26.05 in chips) 
Seat 2: 88*SaaS*99 ($12.29 in chips) 
Seat 3: SantiagoWeight ($26.60 in chips) 
Seat 4: Ovanes911 ($25 in chips) 
Seat 5: DUDA3553 ($26.12 in chips) 
Seat 6: --LeGaaNs-- ($77.59 in chips) 
88*SaaS*99: posts small blind $0.10
SantiagoWeight: posts big blind $0.25
*** HOLE CARDS ***
Dealt to SantiagoWeight [6h 5d]
Ovanes911: folds 
DUDA3553: raises $0.50 to $0.75
--LeGaaNs--: folds 
lovintalbi: folds 
88*SaaS*99: calls $0.65
SantiagoWeight: folds 
*** FLOP *** [2d 2c 9h]
88*SaaS*99: checks 
DUDA3553: checks 
*** TURN *** [2d 2c 9h] [Kh]
88*SaaS*99: checks 
DUDA3553: checks 
*** RIVER *** [2d 2c 9h Kh] [5s]
88*SaaS*99: bets $0.75
DUDA3553: raises $0.75 to $1.50
88*SaaS*99: calls $0.75
*** SHOW DOWN ***
DUDA3553: shows [Ad Kc] (two pair, Kings and Deuces)
88*SaaS*99: mucks hand 
DUDA3553 collected $4.54 from pot
*** SUMMARY ***
Total pot $4.75 | Rake $0.21 
Board [2d 2c 9h Kh 5s]
Seat 1: lovintalbi (button) folded before Flop (didn't bet)
Seat 2: 88*SaaS*99 (small blind) mucked [4c Ah]
Seat 3: SantiagoWeight (big blind) folded before Flop
Seat 4: Ovanes911 folded before Flop (didn't bet)
Seat 5: DUDA3553 showed [Ad Kc] and won ($4.54) with two pair, Kings and Deuces
Seat 6: --LeGaaNs-- folded before Flop (didn't bet)



PokerStars Zoom Hand #195023725620:  Hold'em No Limit ($0.10/$0.25) - 2018/12/29 3:55:10 UTC [2018/12/28 22:55:10 ET]
Table 'Hydra' 6-max Seat #1 is the button
Seat 1: Pardaroxon ($45.35 in chips) 
Seat 2: Jack123985 ($25.25 in chips) 
Seat 3: SantiagoWeight ($26.25 in chips) 
Seat 4: G ster24 ($36.19 in chips) 
Seat 5: kakashi_zion ($22.15 in chips) 
Seat 6: Bonen18 ($25.35 in chips) 
Jack123985: posts small blind $0.10
SantiagoWeight: posts big blind $0.25
*** HOLE CARDS ***
Dealt to SantiagoWeight [Kh Td]
G ster24: raises $0.60 to $0.85
kakashi_zion: folds 
Bonen18: raises $1.65 to $2.50
Pardaroxon: folds 
Jack123985: folds 
SantiagoWeight: folds 
G ster24: calls $1.65
*** FLOP *** [Ah 5s 9s]
G ster24: checks 
Bonen18: checks 
*** TURN *** [Ah 5s 9s] [Jc]
G ster24: bets $2.56
Bonen18: calls $2.56
*** RIVER *** [Ah 5s 9s Jc] [4c]
G ster24: bets $5
Bonen18: calls $5
*** SHOW DOWN ***
G ster24: shows [Ac Ks] (a pair of Aces)
Bonen18: shows [As Kc] (a pair of Aces)
G ster24 collected $9.78 from pot
Bonen18 collected $9.77 from pot
*** SUMMARY ***
Total pot $20.47 | Rake $0.92 
Board [Ah 5s 9s Jc 4c]
Seat 1: Pardaroxon (button) folded before Flop (didn't bet)
Seat 2: Jack123985 (small blind) folded before Flop
Seat 3: SantiagoWeight (big blind) folded before Flop
Seat 4: G ster24 showed [Ac Ks] and won ($9.78) with a pair of Aces
Seat 5: kakashi_zion folded before Flop (didn't bet)
Seat 6: Bonen18 showed [As Kc] and won ($9.77) with a pair of Aces



PokerStars Zoom Hand #195023721745:  Hold'em No Limit ($0.10/$0.25) - 2018/12/29 3:54:57 UTC [2018/12/28 22:54:57 ET]
Table 'Hydra' 6-max Seat #1 is the button
Seat 1: tagan7 ($20.81 in chips) 
Seat 2: SantiagoWeight ($26.35 in chips) 
Seat 3: aa1421b ($48.56 in chips) 
Seat 4: davidhw888 ($21.59 in chips) 
Seat 5: LLiarrr ($25 in chips) 
Seat 6: Xp0Hb ($43.17 in chips) 
SantiagoWeight: posts small blind $0.10
aa1421b: posts big blind $0.25
*** HOLE CARDS ***
Dealt to SantiagoWeight [6d 2h]
davidhw888: folds 
LLiarrr: folds 
Xp0Hb: raises $0.50 to $0.75
tagan7: folds 
SantiagoWeight: folds 
aa1421b: calls $0.50
*** FLOP *** [Ts Ah Kc]
aa1421b: checks 
Xp0Hb: bets $0.75
aa1421b: calls $0.75
*** TURN *** [Ts Ah Kc] [7h]
aa1421b: checks 
Xp0Hb: bets $1.50
aa1421b: calls $1.50
*** RIVER *** [Ts Ah Kc 7h] [3s]
aa1421b: checks 
Xp0Hb: bets $3
aa1421b: folds 
Uncalled bet ($3) returned to Xp0Hb
Xp0Hb collected $5.83 from pot
Xp0Hb: doesn't show hand 
*** SUMMARY ***
Total pot $6.10 | Rake $0.27 
Board [Ts Ah Kc 7h 3s]
Seat 1: tagan7 (button) folded before Flop (didn't bet)
Seat 2: SantiagoWeight (small blind) folded before Flop
Seat 3: aa1421b (big blind) folded on the River
Seat 4: davidhw888 folded before Flop (didn't bet)
Seat 5: LLiarrr folded before Flop (didn't bet)
Seat 6: Xp0Hb collected ($5.83)



PokerStars Zoom Hand #195023731982:  Hold'em No Limit ($0.10/$0.25) - 2018/12/29 3:55:34 UTC [2018/12/28 22:55:34 ET]
Table 'Hydra' 6-max Seat #1 is the button
Seat 1: miru877 ($63.23 in chips) 
Seat 2: _BluDeeN_ ($40.70 in chips) 
Seat 3: aldoalb0207 ($79.42 in chips) 
Seat 4: Dbakunwaves ($75.73 in chips) 
Seat 5: SantiagoWeight ($26 in chips) 
Seat 6: nhanminhtri ($25 in chips) 
_BluDeeN_: posts small blind $0.10
aldoalb0207: posts big blind $0.25
*** HOLE CARDS ***
Dealt to SantiagoWeight [3s Ac]
Dbakunwaves: folds 
SantiagoWeight: folds 
nhanminhtri: folds 
miru877: raises $0.50 to $0.75
_BluDeeN_: folds 
aldoalb0207: raises $0.50 to $1.25
miru877: folds 
Uncalled bet ($0.50) returned to aldoalb0207
aldoalb0207 collected $1.60 from pot
aldoalb0207: doesn't show hand 
*** SUMMARY ***
Total pot $1.60 | Rake $0 
Seat 1: miru877 (button) folded before Flop
Seat 2: _BluDeeN_ (small blind) folded before Flop
Seat 3: aldoalb0207 (big blind) collected ($1.60)
Seat 4: Dbakunwaves folded before Flop (didn't bet)
Seat 5: SantiagoWeight folded before Flop (didn't bet)
Seat 6: nhanminhtri folded before Flop (didn't bet)



PokerStars Zoom Hand #195023736555:  Hold'em No Limit ($0.10/$0.25) - 2018/12/29 3:55:51 UTC [2018/12/28 22:55:51 ET]
Table 'Hydra' 6-max Seat #1 is the button
Seat 1: reademenweep ($16.76 in chips) 
Seat 2: SantiagoWeight ($26 in chips) 
Seat 3: KeySssi ($25 in chips) 
Seat 4: _BluDeeN_ ($24.40 in chips) 
Seat 5: 666erkan ($20.13 in chips) 
Seat 6: Bonen18 ($29.38 in chips) 
SantiagoWeight: posts small blind $0.10
KeySssi: posts big blind $0.25
*** HOLE CARDS ***
Dealt to SantiagoWeight [8s Kd]
_BluDeeN_: folds 
666erkan: folds 
Bonen18: folds 
reademenweep: folds 
SantiagoWeight: raises $0.50 to $0.75
KeySssi: raises $1.50 to $2.25
SantiagoWeight: folds 
Uncalled bet ($1.50) returned to KeySssi
KeySssi collected $1.50 from pot
*** SUMMARY ***
Total pot $1.50 | Rake $0 
Seat 1: reademenweep (button) folded before Flop (didn't bet)
Seat 2: SantiagoWeight (small blind) folded before Flop
Seat 3: KeySssi (big blind) collected ($1.50)
Seat 4: _BluDeeN_ folded before Flop (didn't bet)
Seat 5: 666erkan folded before Flop (didn't bet)
Seat 6: Bonen18 folded before Flop (didn't bet)



PokerStars Zoom Hand #195023735482:  Hold'em No Limit ($0.10/$0.25) - 2018/12/29 3:55:47 UTC [2018/12/28 22:55:47 ET]
Table 'Hydra' 6-max Seat #1 is the button
Seat 1: mojsza1 ($35.26 in chips) 
Seat 2: Party4Arthy ($62.85 in chips) 
Seat 3: fracar189 ($1.44 in chips) 
Seat 4: mariopork ($41.03 in chips) 
Seat 5: Chrimmpam ($33.75 in chips) 
Seat 6: SantiagoWeight ($26 in chips) 
Party4Arthy: posts small blind $0.10
fracar189: posts big blind $0.25
*** HOLE CARDS ***
Dealt to SantiagoWeight [3c 9h]
mariopork: folds 
Chrimmpam: raises $0.60 to $0.85
SantiagoWeight: folds 
mojsza1: calls $0.85
Party4Arthy: folds 
fracar189: raises $0.59 to $1.44 and is all-in
Chrimmpam: calls $0.59
mojsza1: calls $0.59
*** FLOP *** [Ks Ts Qs]
Chrimmpam: bets $2
mojsza1: raises $4 to $6
Chrimmpam: raises $26.31 to $32.31 and is all-in
mojsza1: calls $26.31
*** TURN *** [Ks Ts Qs] [3h]
*** RIVER *** [Ks Ts Qs 3h] [5d]
*** SHOW DOWN ***
Chrimmpam: shows [7s As] (a flush, Ace high)
mojsza1: shows [Js Td] (a pair of Tens)
Chrimmpam collected $62.82 from side pot
fracar189: shows [6h 2h] (high card King)
Chrimmpam collected $4.22 from main pot
*** SUMMARY ***
Total pot $69.04 Main pot $4.22. Side pot $62.82. | Rake $2 
Board [Ks Ts Qs 3h 5d]
Seat 1: mojsza1 (button) showed [Js Td] and lost with a pair of Tens
Seat 2: Party4Arthy (small blind) folded before Flop
Seat 3: fracar189 (big blind) showed [6h 2h] and lost with high card King
Seat 4: mariopork folded before Flop (didn't bet)
Seat 5: Chrimmpam showed [7s As] and won ($67.04) with a flush, Ace high
Seat 6: SantiagoWeight folded before Flop (didn't bet)



PokerStars Zoom Hand #195023743583:  Hold'em No Limit ($0.10/$0.25) - 2018/12/29 3:56:17 UTC [2018/12/28 22:56:17 ET]
Table 'Hydra' 6-max Seat #1 is the button
Seat 1: SantiagoWeight ($25.25 in chips) 
Seat 2: Breedijkie ($28.83 in chips) 
Seat 3: Lehared ($79.01 in chips) 
Seat 4: allin969 ($22.85 in chips) 
Seat 5: gustavotaina ($4.62 in chips) 
Seat 6: reggiedogg31 ($89.01 in chips) 
Breedijkie: posts small blind $0.10
Lehared: posts big blind $0.25
*** HOLE CARDS ***
Dealt to SantiagoWeight [Jh 7s]
allin969: raises $0.25 to $0.50
gustavotaina: folds 
reggiedogg31: folds 
SantiagoWeight: folds 
Breedijkie: folds 
Lehared: folds 
Uncalled bet ($0.25) returned to allin969
allin969 collected $0.60 from pot
allin969: doesn't show hand 
*** SUMMARY ***
Total pot $0.60 | Rake $0 
Seat 1: SantiagoWeight (button) folded before Flop (didn't bet)
Seat 2: Breedijkie (small blind) folded before Flop
Seat 3: Lehared (big blind) folded before Flop
Seat 4: allin969 collected ($0.60)
Seat 5: gustavotaina folded before Flop (didn't bet)
Seat 6: reggiedogg31 folded before Flop (didn't bet)



PokerStars Zoom Hand #195023734082:  Hold'em No Limit ($0.10/$0.25) - 2018/12/29 3:55:42 UTC [2018/12/28 22:55:42 ET]
Table 'Hydra' 6-max Seat #1 is the button
Seat 1: davidhw888 ($21.59 in chips) 
Seat 2: nhanminhtri ($28.03 in chips) 
Seat 3: denisss1801 ($17.09 in chips) 
Seat 4: SantiagoWeight ($26 in chips) 
Seat 5: bwim ($27.06 in chips) 
Seat 6: Virus3232 ($25.34 in chips) 
nhanminhtri: posts small blind $0.10
denisss1801: posts big blind $0.25
*** HOLE CARDS ***
Dealt to SantiagoWeight [9s Th]
SantiagoWeight: folds 
bwim: raises $0.50 to $0.75
Virus3232: folds 
davidhw888: calls $0.75
nhanminhtri: folds 
denisss1801: calls $0.50
*** FLOP *** [Qd As 4h]
denisss1801: bets $0.25
bwim: calls $0.25
davidhw888: folds 
*** TURN *** [Qd As 4h] [6d]
denisss1801: checks 
bwim: checks 
*** RIVER *** [Qd As 4h 6d] [2c]
denisss1801: bets $0.25
bwim: calls $0.25
*** SHOW DOWN ***
denisss1801: shows [Ac 9d] (a pair of Aces)
bwim: mucks hand 
denisss1801 collected $3.20 from pot
*** SUMMARY ***
Total pot $3.35 | Rake $0.15 
Board [Qd As 4h 6d 2c]
Seat 1: davidhw888 (button) folded on the Flop
Seat 2: nhanminhtri (small blind) folded before Flop
Seat 3: denisss1801 (big blind) showed [Ac 9d] and won ($3.20) with a pair of Aces
Seat 4: SantiagoWeight folded before Flop (didn't bet)
Seat 5: bwim mucked [Qs Kd]
Seat 6: Virus3232 folded before Flop (didn't bet)



PokerStars Zoom Hand #195023730667:  Hold'em No Limit ($0.10/$0.25) - 2018/12/29 3:55:29 UTC [2018/12/28 22:55:29 ET]
Table 'Hydra' 6-max Seat #1 is the button
Seat 1: SantiagoWeight ($26 in chips) 
Seat 2: MileVoliD49 ($29.76 in chips) 
Seat 3: **HCL59** ($15.16 in chips) 
Seat 4: Nutselas ($25 in chips) 
Seat 5: Virus3232 ($33.59 in chips) 
Seat 6: hippo8529 ($15.41 in chips) 
MileVoliD49: posts small blind $0.10
**HCL59**: posts big blind $0.25
*** HOLE CARDS ***
Dealt to SantiagoWeight [4s 8s]
Nutselas: raises $0.50 to $0.75
Virus3232: folds 
hippo8529: raises $0.50 to $1.25
SantiagoWeight: folds 
MileVoliD49: folds 
**HCL59**: calls $1
Nutselas: calls $0.50
*** FLOP *** [Kc 7c 4c]
**HCL59**: checks 
Nutselas: checks 
hippo8529: bets $1.25
**HCL59**: folds 
Nutselas: calls $1.25
*** TURN *** [Kc 7c 4c] [2c]
Nutselas: checks 
hippo8529: bets $4
Nutselas: calls $4
*** RIVER *** [Kc 7c 4c 2c] [5c]
Nutselas: checks 
hippo8529: bets $2
Nutselas: calls $2
*** SHOW DOWN ***
hippo8529: shows [6d 8c] (a flush, King high)
Nutselas: shows [Jc Qd] (a flush, King high - Jack higher)
Nutselas collected $17.52 from pot
*** SUMMARY ***
Total pot $18.35 | Rake $0.83 
Board [Kc 7c 4c 2c 5c]
Seat 1: SantiagoWeight (button) folded before Flop (didn't bet)
Seat 2: MileVoliD49 (small blind) folded before Flop
Seat 3: **HCL59** (big blind) folded on the Flop
Seat 4: Nutselas showed [Jc Qd] and won ($17.52) with a flush, King high
Seat 5: Virus3232 folded before Flop (didn't bet)
Seat 6: hippo8529 showed [6d 8c] and lost with a flush, King high



PokerStars Zoom Hand #195023745564:  Hold'em No Limit ($0.10/$0.25) - 2018/12/29 3:56:24 UTC [2018/12/28 22:56:24 ET]
Table 'Hydra' 6-max Seat #1 is the button
Seat 1: ineedmoeny ($19.08 in chips) 
Seat 2: Lehared ($78.76 in chips) 
Seat 3: SantiagoWeight ($25.25 in chips) 
Seat 4: ssrace ($41.39 in chips) 
Seat 5: ivann14 ($63.74 in chips) 
Seat 6: mojsza1 ($20.37 in chips) 
Lehared: posts small blind $0.10
SantiagoWeight: posts big blind $0.25
*** HOLE CARDS ***
Dealt to SantiagoWeight [5c 7h]
ssrace: folds 
ivann14: folds 
mojsza1: folds 
ineedmoeny: raises $0.50 to $0.75
Lehared: folds 
SantiagoWeight: folds 
Uncalled bet ($0.50) returned to ineedmoeny
ineedmoeny collected $0.60 from pot
*** SUMMARY ***
Total pot $0.60 | Rake $0 
Seat 1: ineedmoeny (button) collected ($0.60)
Seat 2: Lehared (small blind) folded before Flop
Seat 3: SantiagoWeight (big blind) folded before Flop
Seat 4: ssrace folded before Flop (didn't bet)
Seat 5: ivann14 folded before Flop (didn't bet)
Seat 6: mojsza1 folded before Flop (didn't bet)



PokerStars Zoom Hand #195023752616:  Hold'em No Limit ($0.10/$0.25) - 2018/12/29 3:56:50 UTC [2018/12/28 22:56:50 ET]
Table 'Hydra' 6-max Seat #1 is the button
Seat 1: JLoveless17 ($25.03 in chips) 
Seat 2: _BluDeeN_ ($41.37 in chips) 
Seat 3: Guard poker ($25 in chips) 
Seat 4: Lehared ($25 in chips) 
Seat 5: SantiagoWeight ($25 in chips) 
Seat 6: mariopork ($34.28 in chips) 
_BluDeeN_: posts small blind $0.10
Guard poker: posts big blind $0.25
*** HOLE CARDS ***
Dealt to SantiagoWeight [7s 7d]
Lehared: folds 
SantiagoWeight: raises $0.37 to $0.62
mariopork: folds 
JLoveless17: calls $0.62
_BluDeeN_: folds 
Guard poker: folds 
*** FLOP *** [4d Qh 2d]
SantiagoWeight: bets $0.38
JLoveless17: calls $0.38
*** TURN *** [4d Qh 2d] [4s]
SantiagoWeight: checks 
JLoveless17: bets $0.75
SantiagoWeight: calls $0.75
*** RIVER *** [4d Qh 2d 4s] [8d]
SantiagoWeight: checks 
JLoveless17: bets $2.25
SantiagoWeight: folds 
Uncalled bet ($2.25) returned to JLoveless17
JLoveless17 collected $3.68 from pot
*** SUMMARY ***
Total pot $3.85 | Rake $0.17 
Board [4d Qh 2d 4s 8d]
Seat 1: JLoveless17 (button) collected ($3.68)
Seat 2: _BluDeeN_ (small blind) folded before Flop
Seat 3: Guard poker (big blind) folded before Flop
Seat 4: Lehared folded before Flop (didn't bet)
Seat 5: SantiagoWeight folded on the River
Seat 6: mariopork folded before Flop (didn't bet)



PokerStars Zoom Hand #195023774462:  Hold'em No Limit ($0.10/$0.25) - 2018/12/29 3:58:11 UTC [2018/12/28 22:58:11 ET]
Table 'Hydra' 6-max Seat #1 is the button
Seat 1: ivann14 ($71.75 in chips) 
Seat 2: winwinboy ($26.08 in chips) 
Seat 3: Trapduck ($25 in chips) 
Seat 4: anorectal ($38.43 in chips) 
Seat 5: dithflo ($18.87 in chips) 
Seat 6: SantiagoWeight ($23.25 in chips) 
winwinboy: posts small blind $0.10
Trapduck: posts big blind $0.25
*** HOLE CARDS ***
Dealt to SantiagoWeight [8s 6d]
anorectal: folds 
dithflo: folds 
SantiagoWeight: folds 
ivann14: raises $0.25 to $0.50
winwinboy: folds 
Trapduck: folds 
Uncalled bet ($0.25) returned to ivann14
ivann14 collected $0.60 from pot
ivann14: doesn't show hand 
*** SUMMARY ***
Total pot $0.60 | Rake $0 
Seat 1: ivann14 (button) collected ($0.60)
Seat 2: winwinboy (small blind) folded before Flop
Seat 3: Trapduck (big blind) folded before Flop
Seat 4: anorectal folded before Flop (didn't bet)
Seat 5: dithflo folded before Flop (didn't bet)
Seat 6: SantiagoWeight folded before Flop (didn't bet)



PokerStars Zoom Hand #195023777731:  Hold'em No Limit ($0.10/$0.25) - 2018/12/29 3:58:23 UTC [2018/12/28 22:58:23 ET]
Table 'Hydra' 6-max Seat #1 is the button
Seat 1: TQNYMQNTANA ($25 in chips) 
Seat 2: SantiagoWeight ($23.25 in chips) 
Seat 3: ivann14 ($64.87 in chips) 
Seat 4: Virus3232 ($31.57 in chips) 
Seat 5: ineedmoeny ($21.84 in chips) 
Seat 6: nadal335 ($26.31 in chips) 
SantiagoWeight: posts small blind $0.10
ivann14: posts big blind $0.25
*** HOLE CARDS ***
Dealt to SantiagoWeight [Ks 9d]
Virus3232: raises $0.60 to $0.85
ineedmoeny: folds 
nadal335: calls $0.85
TQNYMQNTANA: folds 
SantiagoWeight: folds 
ivann14: folds 
*** FLOP *** [Ad 4h 4s]
Virus3232: checks 
nadal335: checks 
*** TURN *** [Ad 4h 4s] [9h]
Virus3232: bets $1.50
nadal335: folds 
Uncalled bet ($1.50) returned to Virus3232
Virus3232 collected $1.96 from pot
Virus3232: doesn't show hand 
*** SUMMARY ***
Total pot $2.05 | Rake $0.09 
Board [Ad 4h 4s 9h]
Seat 1: TQNYMQNTANA (button) folded before Flop (didn't bet)
Seat 2: SantiagoWeight (small blind) folded before Flop
Seat 3: ivann14 (big blind) folded before Flop
Seat 4: Virus3232 collected ($1.96)
Seat 5: ineedmoeny folded before Flop (didn't bet)
Seat 6: nadal335 folded on the Turn



PokerStars Zoom Hand #195023776639:  Hold'em No Limit ($0.10/$0.25) - 2018/12/29 3:58:19 UTC [2018/12/28 22:58:19 ET]
Table 'Hydra' 6-max Seat #1 is the button
Seat 1: ineedmoeny ($21.84 in chips) 
Seat 2: pRoma66 ($18.97 in chips) 
Seat 3: gustavotaina ($6.67 in chips) 
Seat 4: nadal335 ($26.31 in chips) 
Seat 5: SantiagoWeight ($23.25 in chips) 
Seat 6: davidhw888 ($26.39 in chips) 
pRoma66: posts small blind $0.10
gustavotaina: posts big blind $0.25
*** HOLE CARDS ***
Dealt to SantiagoWeight [8h 6s]
nadal335: folds 
SantiagoWeight: folds 
davidhw888: raises $0.50 to $0.75
ineedmoeny: folds 
pRoma66: calls $0.65
gustavotaina: folds 
*** FLOP *** [Ks As Qh]
pRoma66: checks 
davidhw888: checks 
*** TURN *** [Ks As Qh] [5s]
pRoma66: checks 
davidhw888: bets $1.67
pRoma66: folds 
Uncalled bet ($1.67) returned to davidhw888
davidhw888 collected $1.67 from pot
davidhw888: doesn't show hand 
*** SUMMARY ***
Total pot $1.75 | Rake $0.08 
Board [Ks As Qh 5s]
Seat 1: ineedmoeny (button) folded before Flop (didn't bet)
Seat 2: pRoma66 (small blind) folded on the Turn
Seat 3: gustavotaina (big blind) folded before Flop
Seat 4: nadal335 folded before Flop (didn't bet)
Seat 5: SantiagoWeight folded before Flop (didn't bet)
Seat 6: davidhw888 collected ($1.67)



PokerStars Zoom Hand #195023780706:  Hold'em No Limit ($0.10/$0.25) - 2018/12/29 3:58:34 UTC [2018/12/28 22:58:34 ET]
Table 'Hydra' 6-max Seat #1 is the button
Seat 1: SantiagoWeight ($23.15 in chips) 
Seat 2: dithflo ($18.62 in chips) 
Seat 3: Bonen18 ($26.70 in chips) 
Seat 4: nhanminhtri ($25 in chips) 
Seat 5: qing328 ($24.65 in chips) 
Seat 6: LLiarrr ($25.94 in chips) 
dithflo: posts small blind $0.10
Bonen18: posts big blind $0.25
*** HOLE CARDS ***
Dealt to SantiagoWeight [5c 2h]
nhanminhtri: folds 
qing328: folds 
LLiarrr: raises $0.30 to $0.55
SantiagoWeight: folds 
dithflo: folds 
Bonen18: raises $1.45 to $2
LLiarrr: folds 
Uncalled bet ($1.45) returned to Bonen18
Bonen18 collected $1.20 from pot
Bonen18: doesn't show hand 
*** SUMMARY ***
Total pot $1.20 | Rake $0 
Seat 1: SantiagoWeight (button) folded before Flop (didn't bet)
Seat 2: dithflo (small blind) folded before Flop
Seat 3: Bonen18 (big blind) collected ($1.20)
Seat 4: nhanminhtri folded before Flop (didn't bet)
Seat 5: qing328 folded before Flop (didn't bet)
Seat 6: LLiarrr folded before Flop



PokerStars Zoom Hand #195023781789:  Hold'em No Limit ($0.10/$0.25) - 2018/12/29 3:58:38 UTC [2018/12/28 22:58:38 ET]
Table 'Hydra' 6-max Seat #1 is the button
Seat 1: GrandmasterY ($60.37 in chips) 
Seat 2: river plate9 ($32.14 in chips) 
Seat 3: miaozhuang ($19.75 in chips) 
Seat 4: SantiagoWeight ($23.15 in chips) 
Seat 5: dan_iasi ($39.53 in chips) 
Seat 6: Unclesmoll ($27.75 in chips) 
river plate9: posts small blind $0.10
miaozhuang: posts big blind $0.25
*** HOLE CARDS ***
Dealt to SantiagoWeight [7h Ad]
SantiagoWeight: folds 
dan_iasi: folds 
Unclesmoll: raises $0.50 to $0.75
GrandmasterY: folds 
river plate9: folds 
miaozhuang: calls $0.50
*** FLOP *** [Kd Qd 6c]
miaozhuang: bets $0.77
Unclesmoll: calls $0.77
*** TURN *** [Kd Qd 6c] [Qh]
miaozhuang: checks 
Unclesmoll: bets $3
miaozhuang: folds 
Uncalled bet ($3) returned to Unclesmoll
Unclesmoll collected $3 from pot
Unclesmoll: doesn't show hand 
*** SUMMARY ***
Total pot $3.14 | Rake $0.14 
Board [Kd Qd 6c Qh]
Seat 1: GrandmasterY (button) folded before Flop (didn't bet)
Seat 2: river plate9 (small blind) folded before Flop
Seat 3: miaozhuang (big blind) folded on the Turn
Seat 4: SantiagoWeight folded before Flop (didn't bet)
Seat 5: dan_iasi folded before Flop (didn't bet)
Seat 6: Unclesmoll collected ($3)



PokerStars Zoom Hand #195023789749:  Hold'em No Limit ($0.10/$0.25) - 2018/12/29 3:59:08 UTC [2018/12/28 22:59:08 ET]
Table 'Hydra' 6-max Seat #1 is the button
Seat 1: HonourMan23 ($77.14 in chips) 
Seat 2: ivann14 ($72.80 in chips) 
Seat 3: Lehared ($25.60 in chips) 
Seat 4: winwinboy ($25.30 in chips) 
Seat 5: anorectal ($31.41 in chips) 
Seat 6: SantiagoWeight ($22.90 in chips) 
ivann14: posts small blind $0.10
Lehared: posts big blind $0.25
*** HOLE CARDS ***
Dealt to SantiagoWeight [6h 5d]
winwinboy: folds 
anorectal: folds 
SantiagoWeight: folds 
HonourMan23: folds 
ivann14: folds 
Uncalled bet ($0.15) returned to Lehared
Lehared collected $0.20 from pot
Lehared: doesn't show hand 
*** SUMMARY ***
Total pot $0.20 | Rake $0 
Seat 1: HonourMan23 (button) folded before Flop (didn't bet)
Seat 2: ivann14 (small blind) folded before Flop
Seat 3: Lehared (big blind) collected ($0.20)
Seat 4: winwinboy folded before Flop (didn't bet)
Seat 5: anorectal folded before Flop (didn't bet)
Seat 6: SantiagoWeight folded before Flop (didn't bet)



PokerStars Zoom Hand #195023790814:  Hold'em No Limit ($0.10/$0.25) - 2018/12/29 3:59:12 UTC [2018/12/28 22:59:12 ET]
Table 'Hydra' 6-max Seat #1 is the button
Seat 1: gonih ($23.85 in chips) 
Seat 2: SantiagoWeight ($22.90 in chips) 
Seat 3: mariopork ($33.34 in chips) 
Seat 4: davidhw888 ($27.21 in chips) 
Seat 5: vigos king ($45.66 in chips) 
Seat 6: fishnm2018 ($29.95 in chips) 
SantiagoWeight: posts small blind $0.10
mariopork: posts big blind $0.25
*** HOLE CARDS ***
Dealt to SantiagoWeight [7c 5c]
davidhw888: folds 
vigos king: folds 
fishnm2018: raises $0.50 to $0.75
gonih: folds 
SantiagoWeight: folds 
mariopork: folds 
Uncalled bet ($0.50) returned to fishnm2018
fishnm2018 collected $0.60 from pot
fishnm2018: doesn't show hand 
*** SUMMARY ***
Total pot $0.60 | Rake $0 
Seat 1: gonih (button) folded before Flop (didn't bet)
Seat 2: SantiagoWeight (small blind) folded before Flop
Seat 3: mariopork (big blind) folded before Flop
Seat 4: davidhw888 folded before Flop (didn't bet)
Seat 5: vigos king folded before Flop (didn't bet)
Seat 6: fishnm2018 collected ($0.60)



PokerStars Zoom Hand #195023782856:  Hold'em No Limit ($0.10/$0.25) - 2018/12/29 3:58:42 UTC [2018/12/28 22:58:42 ET]
Table 'Hydra' 6-max Seat #1 is the button
Seat 1: Mandu_xiii ($25.98 in chips) 
Seat 2: mojsza1 ($20.47 in chips) 
Seat 3: SantiagoWeight ($23.15 in chips) 
Seat 4: qing328 ($24.65 in chips) 
Seat 5: Becks Baker ($33.40 in chips) 
Seat 6: dan_iasi ($39.53 in chips) 
mojsza1: posts small blind $0.10
SantiagoWeight: posts big blind $0.25
*** HOLE CARDS ***
Dealt to SantiagoWeight [Ad 6c]
qing328: folds 
Becks Baker: folds 
dan_iasi: raises $0.50 to $0.75
Mandu_xiii: folds 
mojsza1: calls $0.65
SantiagoWeight: folds 
*** FLOP *** [Kc 5h 2s]
mojsza1: bets $1.22
dan_iasi: calls $1.22
*** TURN *** [Kc 5h 2s] [9h]
mojsza1: checks 
dan_iasi: bets $2.12
mojsza1: calls $2.12
*** RIVER *** [Kc 5h 2s 9h] [4h]
mojsza1: checks 
dan_iasi: checks 
*** SHOW DOWN ***
mojsza1: shows [As 4s] (a pair of Fours)
dan_iasi: shows [Qs Kh] (a pair of Kings)
dan_iasi collected $8.05 from pot
*** SUMMARY ***
Total pot $8.43 | Rake $0.38 
Board [Kc 5h 2s 9h 4h]
Seat 1: Mandu_xiii (button) folded before Flop (didn't bet)
Seat 2: mojsza1 (small blind) showed [As 4s] and lost with a pair of Fours
Seat 3: SantiagoWeight (big blind) folded before Flop
Seat 4: qing328 folded before Flop (didn't bet)
Seat 5: Becks Baker folded before Flop (didn't bet)
Seat 6: dan_iasi showed [Qs Kh] and won ($8.05) with a pair of Kings



PokerStars Zoom Hand #195023795623:  Hold'em No Limit ($0.10/$0.25) - 2018/12/29 3:59:30 UTC [2018/12/28 22:59:30 ET]
Table 'Hydra' 6-max Seat #1 is the button
Seat 1: KeySssi ($25.31 in chips) 
Seat 2: Fobos113 ($24.75 in chips) 
Seat 3: GrandmasterY ($50.92 in chips) 
Seat 4: SantiagoWeight ($22.80 in chips) 
Seat 5: Virus3232 ($28.70 in chips) 
Seat 6: Xp0Hb ($47.19 in chips) 
Fobos113: posts small blind $0.10
GrandmasterY: posts big blind $0.25
*** HOLE CARDS ***
Dealt to SantiagoWeight [8c 5h]
SantiagoWeight: folds 
Virus3232: folds 
Xp0Hb: folds 
KeySssi: folds 
Fobos113 is disconnected 
Fobos113 is connected 
Fobos113 has timed out
Fobos113: folds 
Uncalled bet ($0.15) returned to GrandmasterY
GrandmasterY collected $0.20 from pot
GrandmasterY: doesn't show hand 
*** SUMMARY ***
Total pot $0.20 | Rake $0 
Seat 1: KeySssi (button) folded before Flop (didn't bet)
Seat 2: Fobos113 (small blind) folded before Flop
Seat 3: GrandmasterY (big blind) collected ($0.20)
Seat 4: SantiagoWeight folded before Flop (didn't bet)
Seat 5: Virus3232 folded before Flop (didn't bet)
Seat 6: Xp0Hb folded before Flop (didn't bet)



PokerStars Zoom Hand #195023801236:  Hold'em No Limit ($0.10/$0.25) - 2018/12/29 3:59:51 UTC [2018/12/28 22:59:51 ET]
Table 'Hydra' 6-max Seat #1 is the button
Seat 1: winwinboy ($25 in chips) 
Seat 2: dithflo ($18.27 in chips) 
Seat 3: SantiagoWeight ($22.80 in chips) 
Seat 4: naxizzle ($118.77 in chips) 
Seat 5: denisss1801 ($17.33 in chips) 
Seat 6: pirosiky ($71.84 in chips) 
dithflo: posts small blind $0.10
SantiagoWeight: posts big blind $0.25
*** HOLE CARDS ***
Dealt to SantiagoWeight [Js 7d]
naxizzle: calls $0.25
denisss1801: calls $0.25
pirosiky: folds 
winwinboy: folds 
dithflo: folds 
SantiagoWeight: checks 
*** FLOP *** [Qs 2s 4h]
SantiagoWeight: checks 
naxizzle: bets $0.75
denisss1801: folds 
SantiagoWeight: folds 
Uncalled bet ($0.75) returned to naxizzle
naxizzle collected $0.81 from pot
naxizzle: doesn't show hand 
*** SUMMARY ***
Total pot $0.85 | Rake $0.04 
Board [Qs 2s 4h]
Seat 1: winwinboy (button) folded before Flop (didn't bet)
Seat 2: dithflo (small blind) folded before Flop
Seat 3: SantiagoWeight (big blind) folded on the Flop
Seat 4: naxizzle collected ($0.81)
Seat 5: denisss1801 folded on the Flop
Seat 6: pirosiky folded before Flop (didn't bet)



PokerStars Zoom Hand #195023812363:  Hold'em No Limit ($0.10/$0.25) - 2018/12/29 4:00:32 UTC [2018/12/28 23:00:32 ET]
Table 'Hydra' 6-max Seat #1 is the button
Seat 1: RESTRICTED.CR17 ($25 in chips) 
Seat 2: davidhw888 ($16.32 in chips) 
Seat 3: miru877 ($28.38 in chips) 
Seat 4: nhanminhtri ($25.66 in chips) 
Seat 5: SantiagoWeight ($22.55 in chips) 
Seat 6: Jack123985 ($25.12 in chips) 
davidhw888: posts small blind $0.10
miru877: posts big blind $0.25
*** HOLE CARDS ***
Dealt to SantiagoWeight [2c 6d]
nhanminhtri: folds 
SantiagoWeight: folds 
Jack123985: folds 
RESTRICTED.CR17: folds 
davidhw888: folds 
Uncalled bet ($0.15) returned to miru877
miru877 collected $0.20 from pot
miru877: doesn't show hand 
*** SUMMARY ***
Total pot $0.20 | Rake $0 
Seat 1: RESTRICTED.CR17 (button) folded before Flop (didn't bet)
Seat 2: davidhw888 (small blind) folded before Flop
Seat 3: miru877 (big blind) collected ($0.20)
Seat 4: nhanminhtri folded before Flop (didn't bet)
Seat 5: SantiagoWeight folded before Flop (didn't bet)
Seat 6: Jack123985 folded before Flop (didn't bet)



PokerStars Zoom Hand #195023796965:  Hold'em No Limit ($0.10/$0.25) - 2018/12/29 3:59:35 UTC [2018/12/28 22:59:35 ET]
Table 'Hydra' 6-max Seat #1 is the button
Seat 1: SantiagoWeight ($22.80 in chips) 
Seat 2: Virus3232 ($26.40 in chips) 
Seat 3: HansMSM ($54.08 in chips) 
Seat 4: dithflo ($18.27 in chips) 
Seat 5: ruiken ($38.27 in chips) 
Seat 6: nhanminhtri ($25.48 in chips) 
Virus3232: posts small blind $0.10
HansMSM: posts big blind $0.25
*** HOLE CARDS ***
Dealt to SantiagoWeight [Tc 5c]
dithflo: folds 
ruiken: folds 
nhanminhtri: raises $0.37 to $0.62
SantiagoWeight: folds 
Virus3232: folds 
HansMSM: calls $0.37
*** FLOP *** [Td 4s 8c]
HansMSM: checks 
nhanminhtri: bets $0.75
HansMSM: calls $0.75
*** TURN *** [Td 4s 8c] [9h]
HansMSM: checks 
nhanminhtri: checks 
*** RIVER *** [Td 4s 8c 9h] [7c]
HansMSM: checks 
nhanminhtri: checks 
*** SHOW DOWN ***
HansMSM: shows [As 8s] (a pair of Eights)
nhanminhtri: mucks hand 
HansMSM collected $2.71 from pot
*** SUMMARY ***
Total pot $2.84 | Rake $0.13 
Board [Td 4s 8c 9h 7c]
Seat 1: SantiagoWeight (button) folded before Flop (didn't bet)
Seat 2: Virus3232 (small blind) folded before Flop
Seat 3: HansMSM (big blind) showed [As 8s] and won ($2.71) with a pair of Eights
Seat 4: dithflo folded before Flop (didn't bet)
Seat 5: ruiken folded before Flop (didn't bet)
Seat 6: nhanminhtri mucked [Ks Ah]



PokerStars Zoom Hand #195023814696:  Hold'em No Limit ($0.10/$0.25) - 2018/12/29 4:00:40 UTC [2018/12/28 23:00:40 ET]
Table 'Hydra' 6-max Seat #1 is the button
Seat 1: nadal335 ($35.40 in chips) 
Seat 2: SantiagoWeight ($22.55 in chips) 
Seat 3: dan_iasi ($25 in chips) 
Seat 4: trttt74 ($25.12 in chips) 
Seat 5: davidhw888 ($25.31 in chips) 
Seat 6: BRSOB79 ($27.26 in chips) 
SantiagoWeight: posts small blind $0.10
dan_iasi: posts big blind $0.25
*** HOLE CARDS ***
Dealt to SantiagoWeight [5d Qh]
trttt74: folds 
davidhw888: folds 
BRSOB79: folds 
nadal335: raises $0.50 to $0.75
SantiagoWeight: folds 
dan_iasi: calls $0.50
*** FLOP *** [4h Qd 7d]
dan_iasi: checks 
nadal335: bets $1
dan_iasi: folds 
Uncalled bet ($1) returned to nadal335
nadal335 collected $1.53 from pot
nadal335: doesn't show hand 
*** SUMMARY ***
Total pot $1.60 | Rake $0.07 
Board [4h Qd 7d]
Seat 1: nadal335 (button) collected ($1.53)
Seat 2: SantiagoWeight (small blind) folded before Flop
Seat 3: dan_iasi (big blind) folded on the Flop
Seat 4: trttt74 folded before Flop (didn't bet)
Seat 5: davidhw888 folded before Flop (didn't bet)
Seat 6: BRSOB79 folded before Flop (didn't bet)



PokerStars Zoom Hand #195023817867:  Hold'em No Limit ($0.10/$0.25) - 2018/12/29 4:00:51 UTC [2018/12/28 23:00:51 ET]
Table 'Hydra' 6-max Seat #1 is the button
Seat 1: Nutselas ($47 in chips) 
Seat 2: GrandmasterY ($37.72 in chips) 
Seat 3: mariopork ($85.49 in chips) 
Seat 4: MileVoliD49 ($33.94 in chips) 
Seat 5: TQNYMQNTANA ($25 in chips) 
Seat 6: SantiagoWeight ($24.90 in chips) 
GrandmasterY: posts small blind $0.10
mariopork: posts big blind $0.25
*** HOLE CARDS ***
Dealt to SantiagoWeight [Qh Ks]
MileVoliD49: folds 
TQNYMQNTANA: folds 
SantiagoWeight: raises $0.30 to $0.55
Nutselas: folds 
GrandmasterY: folds 
mariopork: calls $0.30
*** FLOP *** [8d Ac 4h]
mariopork: checks 
SantiagoWeight: bets $0.29
mariopork: calls $0.29
*** TURN *** [8d Ac 4h] [7c]
mariopork: checks 
SantiagoWeight: checks 
*** RIVER *** [8d Ac 4h 7c] [4d]
mariopork: bets $1.70
SantiagoWeight: folds 
Uncalled bet ($1.70) returned to mariopork
mariopork collected $1.70 from pot
*** SUMMARY ***
Total pot $1.78 | Rake $0.08 
Board [8d Ac 4h 7c 4d]
Seat 1: Nutselas (button) folded before Flop (didn't bet)
Seat 2: GrandmasterY (small blind) folded before Flop
Seat 3: mariopork (big blind) collected ($1.70)
Seat 4: MileVoliD49 folded before Flop (didn't bet)
Seat 5: TQNYMQNTANA folded before Flop (didn't bet)
Seat 6: SantiagoWeight folded on the River



PokerStars Zoom Hand #195023833942:  Hold'em No Limit ($0.10/$0.25) - 2018/12/29 4:01:46 UTC [2018/12/28 23:01:46 ET]
Table 'Hydra' 6-max Seat #1 is the button
Seat 1: SantiagoWeight ($24.06 in chips) 
Seat 2: river plate9 ($25.13 in chips) 
Seat 3: nhanminhtri ($25.35 in chips) 
Seat 4: MileVoliD49 ($33.59 in chips) 
Seat 5: Breedijkie ($37.31 in chips) 
Seat 6: DUDA3553 ($26.46 in chips) 
river plate9: posts small blind $0.10
nhanminhtri: posts big blind $0.25
*** HOLE CARDS ***
Dealt to SantiagoWeight [5h Ah]
MileVoliD49: raises $0.25 to $0.50
Breedijkie: folds 
DUDA3553: folds 
SantiagoWeight: calls $0.50
river plate9: raises $1.75 to $2.25
nhanminhtri: folds 
MileVoliD49: calls $1.75
SantiagoWeight: calls $1.75
*** FLOP *** [8d 3d Kc]
river plate9: bets $2.75
MileVoliD49: folds 
SantiagoWeight: folds 
Uncalled bet ($2.75) returned to river plate9
river plate9 collected $6.68 from pot
*** SUMMARY ***
Total pot $7 | Rake $0.32 
Board [8d 3d Kc]
Seat 1: SantiagoWeight (button) folded on the Flop
Seat 2: river plate9 (small blind) collected ($6.68)
Seat 3: nhanminhtri (big blind) folded before Flop
Seat 4: MileVoliD49 folded on the Flop
Seat 5: Breedijkie folded before Flop (didn't bet)
Seat 6: DUDA3553 folded before Flop (didn't bet)



PokerStars Zoom Hand #195023843959:  Hold'em No Limit ($0.10/$0.25) - 2018/12/29 4:02:20 UTC [2018/12/28 23:02:20 ET]
Table 'Hydra' 6-max Seat #1 is the button
Seat 1: osa126 ($25 in chips) 
Seat 2: zdenekstavic ($41.63 in chips) 
Seat 3: davidhw888 ($25.80 in chips) 
Seat 4: RESTRICTED.CR17 ($25.93 in chips) 
Seat 5: SantiagoWeight ($21.81 in chips) 
Seat 6: Chrimmpam ($14.43 in chips) 
zdenekstavic: posts small blind $0.10
davidhw888: posts big blind $0.25
*** HOLE CARDS ***
Dealt to SantiagoWeight [3s 2h]
RESTRICTED.CR17: folds 
SantiagoWeight: folds 
Chrimmpam: folds 
osa126: folds 
zdenekstavic: raises $0.25 to $0.50
davidhw888: folds 
Uncalled bet ($0.25) returned to zdenekstavic
zdenekstavic collected $0.50 from pot
zdenekstavic: doesn't show hand 
*** SUMMARY ***
Total pot $0.50 | Rake $0 
Seat 1: osa126 (button) folded before Flop (didn't bet)
Seat 2: zdenekstavic (small blind) collected ($0.50)
Seat 3: davidhw888 (big blind) folded before Flop
Seat 4: RESTRICTED.CR17 folded before Flop (didn't bet)
Seat 5: SantiagoWeight folded before Flop (didn't bet)
Seat 6: Chrimmpam folded before Flop (didn't bet)



PokerStars Zoom Hand #195023845459:  Hold'em No Limit ($0.10/$0.25) - 2018/12/29 4:02:25 UTC [2018/12/28 23:02:25 ET]
Table 'Hydra' 6-max Seat #1 is the button
Seat 1: alex3d1985 ($40.50 in chips) 
Seat 2: pkr_miracle ($17.63 in chips) 
Seat 3: osa126 ($25 in chips) 
Seat 4: mariopork ($34.44 in chips) 
Seat 5: ryanking99 ($26.05 in chips) 
Seat 6: SantiagoWeight ($21.81 in chips) 
pkr_miracle: posts small blind $0.10
osa126: posts big blind $0.25
*** HOLE CARDS ***
Dealt to SantiagoWeight [7d Kd]
mariopork: folds 
ryanking99: raises $0.60 to $0.85
SantiagoWeight: folds 
alex3d1985: folds 
pkr_miracle: calls $0.75
osa126: folds 
*** FLOP *** [Js 5h 3h]
pkr_miracle: checks 
ryanking99: bets $2.05
pkr_miracle: folds 
Uncalled bet ($2.05) returned to ryanking99
ryanking99 collected $1.86 from pot
ryanking99: doesn't show hand 
*** SUMMARY ***
Total pot $1.95 | Rake $0.09 
Board [Js 5h 3h]
Seat 1: alex3d1985 (button) folded before Flop (didn't bet)
Seat 2: pkr_miracle (small blind) folded on the Flop
Seat 3: osa126 (big blind) folded before Flop
Seat 4: mariopork folded before Flop (didn't bet)
Seat 5: ryanking99 collected ($1.86)
Seat 6: SantiagoWeight folded before Flop (didn't bet)



PokerStars Zoom Hand #195023850152:  Hold'em No Limit ($0.10/$0.25) - 2018/12/29 4:02:41 UTC [2018/12/28 23:02:41 ET]
Table 'Hydra' 6-max Seat #1 is the button
Seat 1: kiteboard26 ($24.03 in chips) 
Seat 2: athos 007 ($37.94 in chips) 
Seat 3: SantiagoWeight ($21.81 in chips) 
Seat 4: nhanminhtri ($30.04 in chips) 
Seat 5: landromede ($17.32 in chips) 
Seat 6: bigm2261 ($12.50 in chips) 
athos 007: posts small blind $0.10
SantiagoWeight: posts big blind $0.25
*** HOLE CARDS ***
Dealt to SantiagoWeight [8c 5h]
nhanminhtri: folds 
landromede: calls $0.25
bigm2261: folds 
kiteboard26: folds 
athos 007: folds 
SantiagoWeight: checks 
*** FLOP *** [Kd 3d 7d]
SantiagoWeight: checks 
landromede: checks 
*** TURN *** [Kd 3d 7d] [Ts]
SantiagoWeight: checks 
landromede: bets $0.29
SantiagoWeight: folds 
Uncalled bet ($0.29) returned to landromede
landromede collected $0.57 from pot
*** SUMMARY ***
Total pot $0.60 | Rake $0.03 
Board [Kd 3d 7d Ts]
Seat 1: kiteboard26 (button) folded before Flop (didn't bet)
Seat 2: athos 007 (small blind) folded before Flop
Seat 3: SantiagoWeight (big blind) folded on the Turn
Seat 4: nhanminhtri folded before Flop (didn't bet)
Seat 5: landromede collected ($0.57)
Seat 6: bigm2261 folded before Flop (didn't bet)



PokerStars Zoom Hand #195023858933:  Hold'em No Limit ($0.10/$0.25) - 2018/12/29 4:03:11 UTC [2018/12/28 23:03:11 ET]
Table 'Hydra' 6-max Seat #1 is the button
Seat 1: Nutselas ($33.92 in chips) 
Seat 2: dithflo ($15 in chips) 
Seat 3: ssrace ($41.57 in chips) 
Seat 4: SantiagoWeight ($21.56 in chips) 
Seat 5: G ster24 ($45.30 in chips) 
Seat 6: Ovanes911 ($19.10 in chips) 
dithflo: posts small blind $0.10
ssrace: posts big blind $0.25
*** HOLE CARDS ***
Dealt to SantiagoWeight [9h 5d]
SantiagoWeight: folds 
G ster24: folds 
Ovanes911: folds 
Nutselas: folds 
dithflo: folds 
Uncalled bet ($0.15) returned to ssrace
ssrace collected $0.20 from pot
ssrace: doesn't show hand 
*** SUMMARY ***
Total pot $0.20 | Rake $0 
Seat 1: Nutselas (button) folded before Flop (didn't bet)
Seat 2: dithflo (small blind) folded before Flop
Seat 3: ssrace (big blind) collected ($0.20)
Seat 4: SantiagoWeight folded before Flop (didn't bet)
Seat 5: G ster24 folded before Flop (didn't bet)
Seat 6: Ovanes911 folded before Flop (didn't bet)



PokerStars Zoom Hand #195023861032:  Hold'em No Limit ($0.10/$0.25) - 2018/12/29 4:03:18 UTC [2018/12/28 23:03:18 ET]
Table 'Hydra' 6-max Seat #1 is the button
Seat 1: Gonzalit0o ($25 in chips) 
Seat 2: SantiagoWeight ($21.56 in chips) 
Seat 3: KeySssi ($25.01 in chips) 
Seat 4: naxizzle ($121.95 in chips) 
Seat 5: Chrimmpam ($62.44 in chips) 
Seat 6: _BluDeeN_ ($59.98 in chips) 
SantiagoWeight: posts small blind $0.10
KeySssi: posts big blind $0.25
*** HOLE CARDS ***
Dealt to SantiagoWeight [Qd 9h]
naxizzle: folds 
Chrimmpam: raises $0.60 to $0.85
_BluDeeN_: folds 
Gonzalit0o: folds 
SantiagoWeight: folds 
KeySssi: folds 
Uncalled bet ($0.60) returned to Chrimmpam
Chrimmpam collected $0.60 from pot
Chrimmpam: doesn't show hand 
*** SUMMARY ***
Total pot $0.60 | Rake $0 
Seat 1: Gonzalit0o (button) folded before Flop (didn't bet)
Seat 2: SantiagoWeight (small blind) folded before Flop
Seat 3: KeySssi (big blind) folded before Flop
Seat 4: naxizzle folded before Flop (didn't bet)
Seat 5: Chrimmpam collected ($0.60)
Seat 6: _BluDeeN_ folded before Flop (didn't bet)



PokerStars Zoom Hand #195023865747:  Hold'em No Limit ($0.10/$0.25) - 2018/12/29 4:03:34 UTC [2018/12/28 23:03:34 ET]
Table 'Hydra' 6-max Seat #1 is the button
Seat 1: mariopork ($27.62 in chips) 
Seat 2: qing328 ($27.19 in chips) 
Seat 3: SantiagoWeight ($21.46 in chips) 
Seat 4: zdenekstavic ($41.25 in chips) 
Seat 5: osa126 ($65.55 in chips) 
Seat 6: yobbos ($122.63 in chips) 
qing328: posts small blind $0.10
SantiagoWeight: posts big blind $0.25
*** HOLE CARDS ***
Dealt to SantiagoWeight [Ad Ks]
zdenekstavic: folds 
osa126: raises $0.50 to $0.75
yobbos: folds 
mariopork: folds 
qing328: folds 
SantiagoWeight: raises $2.45 to $3.20
osa126: folds 
Uncalled bet ($2.45) returned to SantiagoWeight
SantiagoWeight collected $1.60 from pot
SantiagoWeight: doesn't show hand 
*** SUMMARY ***
Total pot $1.60 | Rake $0 
Seat 1: mariopork (button) folded before Flop (didn't bet)
Seat 2: qing328 (small blind) folded before Flop
Seat 3: SantiagoWeight (big blind) collected ($1.60)
Seat 4: zdenekstavic folded before Flop (didn't bet)
Seat 5: osa126 folded before Flop
Seat 6: yobbos folded before Flop (didn't bet)



PokerStars Zoom Hand #195023873240:  Hold'em No Limit ($0.10/$0.25) - 2018/12/29 4:03:59 UTC [2018/12/28 23:03:59 ET]
Table 'Hydra' 6-max Seat #1 is the button
Seat 1: yobbos ($146.60 in chips) 
Seat 2: Sco0oter ($24.40 in chips) 
Seat 3: vulcandog ($11.12 in chips) 
Seat 4: razil_999 ($31.41 in chips) 
Seat 5: SantiagoWeight ($22.31 in chips) 
Seat 6: t57571245 ($24.21 in chips) 
Sco0oter: posts small blind $0.10
vulcandog: posts big blind $0.25
*** HOLE CARDS ***
Dealt to SantiagoWeight [2d 9h]
razil_999: folds 
SantiagoWeight: folds 
t57571245: raises $0.50 to $0.75
yobbos: folds 
Sco0oter: folds 
vulcandog: folds 
Uncalled bet ($0.50) returned to t57571245
t57571245 collected $0.60 from pot
t57571245: doesn't show hand 
*** SUMMARY ***
Total pot $0.60 | Rake $0 
Seat 1: yobbos (button) folded before Flop (didn't bet)
Seat 2: Sco0oter (small blind) folded before Flop
Seat 3: vulcandog (big blind) folded before Flop
Seat 4: razil_999 folded before Flop (didn't bet)
Seat 5: SantiagoWeight folded before Flop (didn't bet)
Seat 6: t57571245 collected ($0.60)



PokerStars Zoom Hand #195023875604:  Hold'em No Limit ($0.10/$0.25) - 2018/12/29 4:04:07 UTC [2018/12/28 23:04:07 ET]
Table 'Hydra' 6-max Seat #1 is the button
Seat 1: SantiagoWeight ($22.31 in chips) 
Seat 2: Lehared ($71.96 in chips) 
Seat 3: nabechan814 ($25 in chips) 
Seat 4: zdenekstavic ($40.75 in chips) 
Seat 5: ColinCaine ($11.74 in chips) 
Seat 6: pRoma66 ($39.04 in chips) 
Lehared: posts small blind $0.10
nabechan814: posts big blind $0.25
*** HOLE CARDS ***
Dealt to SantiagoWeight [Ac Js]
zdenekstavic: folds 
ColinCaine: folds 
pRoma66: raises $0.50 to $0.75
SantiagoWeight: calls $0.75
Lehared: folds 
nabechan814: folds 
*** FLOP *** [Ts 3c 8s]
pRoma66: checks 
SantiagoWeight: bets $0.25
pRoma66: calls $0.25
*** TURN *** [Ts 3c 8s] [5c]
pRoma66: checks 
SantiagoWeight: bets $1.49
pRoma66: folds 
Uncalled bet ($1.49) returned to SantiagoWeight
SantiagoWeight collected $2.24 from pot
SantiagoWeight: doesn't show hand 
*** SUMMARY ***
Total pot $2.35 | Rake $0.11 
Board [Ts 3c 8s 5c]
Seat 1: SantiagoWeight (button) collected ($2.24)
Seat 2: Lehared (small blind) folded before Flop
Seat 3: nabechan814 (big blind) folded before Flop
Seat 4: zdenekstavic folded before Flop (didn't bet)
Seat 5: ColinCaine folded before Flop (didn't bet)
Seat 6: pRoma66 folded on the Turn



PokerStars Zoom Hand #195023894162:  Hold'em No Limit ($0.10/$0.25) - 2018/12/29 4:05:09 UTC [2018/12/28 23:05:09 ET]
Table 'Hydra' 6-max Seat #1 is the button
Seat 1: Virus3232 ($25 in chips) 
Seat 2: lovintalbi ($90.17 in chips) 
Seat 3: ivann14 ($25.25 in chips) 
Seat 4: vulcandog ($8.35 in chips) 
Seat 5: Bonen18 ($32.24 in chips) 
Seat 6: SantiagoWeight ($23.55 in chips) 
lovintalbi: posts small blind $0.10
ivann14: posts big blind $0.25
*** HOLE CARDS ***
Dealt to SantiagoWeight [Ac Td]
vulcandog: folds 
Bonen18: folds 
SantiagoWeight: raises $0.30 to $0.55
Virus3232: folds 
lovintalbi: folds 
ivann14: folds 
Uncalled bet ($0.30) returned to SantiagoWeight
SantiagoWeight collected $0.60 from pot
SantiagoWeight: doesn't show hand 
*** SUMMARY ***
Total pot $0.60 | Rake $0 
Seat 1: Virus3232 (button) folded before Flop (didn't bet)
Seat 2: lovintalbi (small blind) folded before Flop
Seat 3: ivann14 (big blind) folded before Flop
Seat 4: vulcandog folded before Flop (didn't bet)
Seat 5: Bonen18 folded before Flop (didn't bet)
Seat 6: SantiagoWeight collected ($0.60)



PokerStars Zoom Hand #195023897372:  Hold'em No Limit ($0.10/$0.25) - 2018/12/29 4:05:20 UTC [2018/12/28 23:05:20 ET]
Table 'Hydra' 6-max Seat #1 is the button
Seat 1: KeySssi ($25.75 in chips) 
Seat 2: Trapduck ($27.63 in chips) 
Seat 3: ColinCaine ($10.94 in chips) 
Seat 4: Lehared ($25.35 in chips) 
Seat 5: SantiagoWeight ($23.90 in chips) 
Seat 6: dan_iasi ($44.56 in chips) 
Trapduck: posts small blind $0.10
ColinCaine: posts big blind $0.25
*** HOLE CARDS ***
Dealt to SantiagoWeight [7h Tc]
Lehared: folds 
SantiagoWeight: folds 
dan_iasi: folds 
KeySssi: folds 
Trapduck: folds 
Uncalled bet ($0.15) returned to ColinCaine
ColinCaine collected $0.20 from pot
ColinCaine: doesn't show hand 
*** SUMMARY ***
Total pot $0.20 | Rake $0 
Seat 1: KeySssi (button) folded before Flop (didn't bet)
Seat 2: Trapduck (small blind) folded before Flop
Seat 3: ColinCaine (big blind) collected ($0.20)
Seat 4: Lehared folded before Flop (didn't bet)
Seat 5: SantiagoWeight folded before Flop (didn't bet)
Seat 6: dan_iasi folded before Flop (didn't bet)



PokerStars Zoom Hand #195023899659:  Hold'em No Limit ($0.10/$0.25) - 2018/12/29 4:05:28 UTC [2018/12/28 23:05:28 ET]
Table 'Hydra' 6-max Seat #1 is the button
Seat 1: t57571245 ($30.30 in chips) 
Seat 2: ssrace ($40.75 in chips) 
Seat 3: Gonzalit0o ($25 in chips) 
Seat 4: SantiagoWeight ($23.90 in chips) 
Seat 5: illwill514 ($26.32 in chips) 
Seat 6: TQNYMQNTANA ($25 in chips) 
ssrace: posts small blind $0.10
Gonzalit0o: posts big blind $0.25
*** HOLE CARDS ***
Dealt to SantiagoWeight [8s 9s]
SantiagoWeight: folds 
illwill514: folds 
TQNYMQNTANA: folds 
t57571245: folds 
ssrace: folds 
Uncalled bet ($0.15) returned to Gonzalit0o
Gonzalit0o collected $0.20 from pot
Gonzalit0o: doesn't show hand 
*** SUMMARY ***
Total pot $0.20 | Rake $0 
Seat 1: t57571245 (button) folded before Flop (didn't bet)
Seat 2: ssrace (small blind) folded before Flop
Seat 3: Gonzalit0o (big blind) collected ($0.20)
Seat 4: SantiagoWeight folded before Flop (didn't bet)
Seat 5: illwill514 folded before Flop (didn't bet)
Seat 6: TQNYMQNTANA folded before Flop (didn't bet)



PokerStars Zoom Hand #195023903587:  Hold'em No Limit ($0.10/$0.25) - 2018/12/29 4:05:41 UTC [2018/12/28 23:05:41 ET]
Table 'Hydra' 6-max Seat #1 is the button
Seat 1: SantiagoWeight ($23.90 in chips) 
Seat 2: Viiiru ($27.34 in chips) 
Seat 3: KeySssi ($25.35 in chips) 
Seat 4: Dbakunwaves ($50.92 in chips) 
Seat 5: Fobos113 ($11.22 in chips) 
Seat 6: mariopork ($47.60 in chips) 
Viiiru: posts small blind $0.10
KeySssi: posts big blind $0.25
*** HOLE CARDS ***
Dealt to SantiagoWeight [6d 6c]
Dbakunwaves: folds 
Fobos113: raises $0.50 to $0.75
mariopork: folds 
SantiagoWeight: calls $0.75
Viiiru: folds 
KeySssi: folds 
*** FLOP *** [Th 7h 3h]
Fobos113: bets $1
SantiagoWeight: folds 
Uncalled bet ($1) returned to Fobos113
Fobos113 collected $1.77 from pot
*** SUMMARY ***
Total pot $1.85 | Rake $0.08 
Board [Th 7h 3h]
Seat 1: SantiagoWeight (button) folded on the Flop
Seat 2: Viiiru (small blind) folded before Flop
Seat 3: KeySssi (big blind) folded before Flop
Seat 4: Dbakunwaves folded before Flop (didn't bet)
Seat 5: Fobos113 collected ($1.77)
Seat 6: mariopork folded before Flop (didn't bet)



PokerStars Zoom Hand #195023914804:  Hold'em No Limit ($0.10/$0.25) - 2018/12/29 4:06:19 UTC [2018/12/28 23:06:19 ET]
Table 'Hydra' 6-max Seat #1 is the button
Seat 1: reggiedogg31 ($92.67 in chips) 
Seat 2: Renner32 ($38.19 in chips) 
Seat 3: SantiagoWeight ($23.15 in chips) 
Seat 4: dan_iasi ($44.51 in chips) 
Seat 5: mariopork ($47.60 in chips) 
Seat 6: Mastermimo ($18.97 in chips) 
Renner32: posts small blind $0.10
SantiagoWeight: posts big blind $0.25
*** HOLE CARDS ***
Dealt to SantiagoWeight [9h 4h]
dan_iasi: folds 
mariopork: raises $0.50 to $0.75
Mastermimo: folds 
reggiedogg31: folds 
Renner32: folds 
SantiagoWeight: folds 
Uncalled bet ($0.50) returned to mariopork
mariopork collected $0.60 from pot
mariopork: doesn't show hand 
*** SUMMARY ***
Total pot $0.60 | Rake $0 
Seat 1: reggiedogg31 (button) folded before Flop (didn't bet)
Seat 2: Renner32 (small blind) folded before Flop
Seat 3: SantiagoWeight (big blind) folded before Flop
Seat 4: dan_iasi folded before Flop (didn't bet)
Seat 5: mariopork collected ($0.60)
Seat 6: Mastermimo folded before Flop (didn't bet)



PokerStars Zoom Hand #195023918316:  Hold'em No Limit ($0.10/$0.25) - 2018/12/29 4:06:31 UTC [2018/12/28 23:06:31 ET]
Table 'Hydra' 6-max Seat #1 is the button
Seat 1: osa126 ($63.84 in chips) 
Seat 2: SantiagoWeight ($22.90 in chips) 
Seat 3: Bonen18 ($28.32 in chips) 
Seat 4: river plate9 ($53.93 in chips) 
Seat 5: mariopork ($88.54 in chips) 
Seat 6: graysonai ($29.64 in chips) 
SantiagoWeight: posts small blind $0.10
Bonen18: posts big blind $0.25
*** HOLE CARDS ***
Dealt to SantiagoWeight [Qd 2d]
river plate9: raises $0.50 to $0.75
mariopork: folds 
graysonai: folds 
osa126: folds 
SantiagoWeight: folds 
Bonen18: folds 
Uncalled bet ($0.50) returned to river plate9
river plate9 collected $0.60 from pot
river plate9: doesn't show hand 
*** SUMMARY ***
Total pot $0.60 | Rake $0 
Seat 1: osa126 (button) folded before Flop (didn't bet)
Seat 2: SantiagoWeight (small blind) folded before Flop
Seat 3: Bonen18 (big blind) folded before Flop
Seat 4: river plate9 collected ($0.60)
Seat 5: mariopork folded before Flop (didn't bet)
Seat 6: graysonai folded before Flop (didn't bet)



PokerStars Zoom Hand #195023923931:  Hold'em No Limit ($0.10/$0.25) - 2018/12/29 4:06:50 UTC [2018/12/28 23:06:50 ET]
Table 'Hydra' 6-max Seat #1 is the button
Seat 1: Breedijkie ($36.45 in chips) 
Seat 2: hamen1990 ($24.67 in chips) 
Seat 3: Gonzalit0o ($30.63 in chips) 
Seat 4: Doomdigidoom ($35.77 in chips) 
Seat 5: SantiagoWeight ($22.80 in chips) 
Seat 6: naxizzle ($117.63 in chips) 
hamen1990: posts small blind $0.10
Gonzalit0o: posts big blind $0.25
*** HOLE CARDS ***
Dealt to SantiagoWeight [7s 6d]
Doomdigidoom: raises $0.50 to $0.75
SantiagoWeight: folds 
naxizzle: folds 
Breedijkie: folds 
hamen1990: folds 
Gonzalit0o: folds 
Uncalled bet ($0.50) returned to Doomdigidoom
Doomdigidoom collected $0.60 from pot
Doomdigidoom: doesn't show hand 
*** SUMMARY ***
Total pot $0.60 | Rake $0 
Seat 1: Breedijkie (button) folded before Flop (didn't bet)
Seat 2: hamen1990 (small blind) folded before Flop
Seat 3: Gonzalit0o (big blind) folded before Flop
Seat 4: Doomdigidoom collected ($0.60)
Seat 5: SantiagoWeight folded before Flop (didn't bet)
Seat 6: naxizzle folded before Flop (didn't bet)



PokerStars Zoom Hand #195023926877:  Hold'em No Limit ($0.10/$0.25) - 2018/12/29 4:07:00 UTC [2018/12/28 23:07:00 ET]
Table 'Hydra' 6-max Seat #1 is the button
Seat 1: clashwizard23 ($28.82 in chips) 
Seat 2: Guard poker ($25.64 in chips) 
Seat 3: BIGPAIN14 ($26.89 in chips) 
Seat 4: SantiagoWeight ($22.80 in chips) 
Seat 5: river plate9 ($31.97 in chips) 
Seat 6: LLiarrr ($47.75 in chips) 
Guard poker: posts small blind $0.10
BIGPAIN14: posts big blind $0.25
*** HOLE CARDS ***
Dealt to SantiagoWeight [3c 5c]
SantiagoWeight: folds 
river plate9: folds 
LLiarrr: folds 
clashwizard23: raises $0.50 to $0.75
Guard poker: folds 
BIGPAIN14: folds 
Uncalled bet ($0.50) returned to clashwizard23
clashwizard23 collected $0.60 from pot
clashwizard23: doesn't show hand 
*** SUMMARY ***
Total pot $0.60 | Rake $0 
Seat 1: clashwizard23 (button) collected ($0.60)
Seat 2: Guard poker (small blind) folded before Flop
Seat 3: BIGPAIN14 (big blind) folded before Flop
Seat 4: SantiagoWeight folded before Flop (didn't bet)
Seat 5: river plate9 folded before Flop (didn't bet)
Seat 6: LLiarrr folded before Flop (didn't bet)



PokerStars Zoom Hand #195023932213:  Hold'em No Limit ($0.10/$0.25) - 2018/12/29 4:07:18 UTC [2018/12/28 23:07:18 ET]
Table 'Hydra' 6-max Seat #1 is the button
Seat 1: SantiagoWeight ($25 in chips) 
Seat 2: sigaro010 ($43.07 in chips) 
Seat 3: razil_999 ($29.51 in chips) 
Seat 4: zdenekstavic ($40.20 in chips) 
Seat 5: _BluDeeN_ ($59.73 in chips) 
Seat 6: GrandmasterY ($32.37 in chips) 
sigaro010: posts small blind $0.10
razil_999: posts big blind $0.25
*** HOLE CARDS ***
Dealt to SantiagoWeight [5h Ts]
zdenekstavic: folds 
_BluDeeN_: folds 
GrandmasterY: raises $0.50 to $0.75
SantiagoWeight: folds 
sigaro010: folds 
razil_999: folds 
Uncalled bet ($0.50) returned to GrandmasterY
GrandmasterY collected $0.60 from pot
GrandmasterY: doesn't show hand 
*** SUMMARY ***
Total pot $0.60 | Rake $0 
Seat 1: SantiagoWeight (button) folded before Flop (didn't bet)
Seat 2: sigaro010 (small blind) folded before Flop
Seat 3: razil_999 (big blind) folded before Flop
Seat 4: zdenekstavic folded before Flop (didn't bet)
Seat 5: _BluDeeN_ folded before Flop (didn't bet)
Seat 6: GrandmasterY collected ($0.60)



PokerStars Zoom Hand #195023925098:  Hold'em No Limit ($0.10/$0.25) - 2018/12/29 4:06:54 UTC [2018/12/28 23:06:54 ET]
Table 'Hydra' 6-max Seat #1 is the button
Seat 1: nabechan814 ($25.09 in chips) 
Seat 2: HonourMan23 ($97.73 in chips) 
Seat 3: kiteboard26 ($27.28 in chips) 
Seat 4: mililser ($26.48 in chips) 
Seat 5: KeySssi ($25 in chips) 
Seat 6: SantiagoWeight ($22.80 in chips) 
HonourMan23: posts small blind $0.10
kiteboard26: posts big blind $0.25
*** HOLE CARDS ***
Dealt to SantiagoWeight [Qd 2h]
mililser: folds 
KeySssi: folds 
SantiagoWeight: folds 
nabechan814: raises $0.50 to $0.75
HonourMan23: folds 
kiteboard26: calls $0.50
*** FLOP *** [2c As 9h]
kiteboard26: checks 
nabechan814: bets $1.15
kiteboard26: calls $1.15
*** TURN *** [2c As 9h] [6s]
kiteboard26: checks 
nabechan814: bets $2.79
kiteboard26: calls $2.79
*** RIVER *** [2c As 9h 6s] [6c]
kiteboard26: checks 
nabechan814: checks 
*** SHOW DOWN ***
kiteboard26: shows [4s 2s] (two pair, Sixes and Deuces)
nabechan814: shows [Kd Ac] (two pair, Aces and Sixes)
nabechan814 collected $9.05 from pot
*** SUMMARY ***
Total pot $9.48 | Rake $0.43 
Board [2c As 9h 6s 6c]
Seat 1: nabechan814 (button) showed [Kd Ac] and won ($9.05) with two pair, Aces and Sixes
Seat 2: HonourMan23 (small blind) folded before Flop
Seat 3: kiteboard26 (big blind) showed [4s 2s] and lost with two pair, Sixes and Deuces
Seat 4: mililser folded before Flop (didn't bet)
Seat 5: KeySssi folded before Flop (didn't bet)
Seat 6: SantiagoWeight folded before Flop (didn't bet)



PokerStars Zoom Hand #195023934259:  Hold'em No Limit ($0.10/$0.25) - 2018/12/29 4:07:25 UTC [2018/12/28 23:07:25 ET]
Table 'Hydra' 6-max Seat #1 is the button
Seat 1: nadal335 ($61.50 in chips) 
Seat 2: SantiagoWeight ($25 in chips) 
Seat 3: Gonzalit0o ($25 in chips) 
Seat 4: Mastermimo ($18.62 in chips) 
Seat 5: ivann14 ($69.02 in chips) 
Seat 6: cankum ($48.75 in chips) 
SantiagoWeight: posts small blind $0.10
Gonzalit0o: posts big blind $0.25
*** HOLE CARDS ***
Dealt to SantiagoWeight [Jc Ah]
Mastermimo: calls $0.25
ivann14: folds 
cankum: raises $0.62 to $0.87
nadal335: folds 
SantiagoWeight: raises $2.23 to $3.10
Gonzalit0o: folds 
Mastermimo: folds 
cankum: folds 
Uncalled bet ($2.23) returned to SantiagoWeight
SantiagoWeight collected $2.24 from pot
SantiagoWeight: doesn't show hand 
*** SUMMARY ***
Total pot $2.24 | Rake $0 
Seat 1: nadal335 (button) folded before Flop (didn't bet)
Seat 2: SantiagoWeight (small blind) collected ($2.24)
Seat 3: Gonzalit0o (big blind) folded before Flop
Seat 4: Mastermimo folded before Flop
Seat 5: ivann14 folded before Flop (didn't bet)
Seat 6: cankum folded before Flop



PokerStars Zoom Hand #195023951544:  Hold'em No Limit ($0.10/$0.25) - 2018/12/29 4:08:24 UTC [2018/12/28 23:08:24 ET]
Table 'Hydra' 6-max Seat #1 is the button
Seat 1: Bonen18 ($25.25 in chips) 
Seat 2: NS123456 ($15.73 in chips) 
Seat 3: SantiagoWeight ($26.37 in chips) 
Seat 4: MileVoliD49 ($31.13 in chips) 
Seat 5: winwinboy ($25 in chips) 
Seat 6: dawwwid70 ($26.36 in chips) 
NS123456: posts small blind $0.10
SantiagoWeight: posts big blind $0.25
*** HOLE CARDS ***
Dealt to SantiagoWeight [4c 2c]
MileVoliD49: folds 
winwinboy: folds 
dawwwid70: folds 
Bonen18: folds 
NS123456: raises $0.37 to $0.62
SantiagoWeight: calls $0.37
*** FLOP *** [Qc 6d Kc]
NS123456: checks 
SantiagoWeight: bets $0.79
NS123456: calls $0.79
*** TURN *** [Qc 6d Kc] [9s]
NS123456: checks 
SantiagoWeight: bets $1.79
NS123456: folds 
Uncalled bet ($1.79) returned to SantiagoWeight
SantiagoWeight collected $2.69 from pot
SantiagoWeight: doesn't show hand 
*** SUMMARY ***
Total pot $2.82 | Rake $0.13 
Board [Qc 6d Kc 9s]
Seat 1: Bonen18 (button) folded before Flop (didn't bet)
Seat 2: NS123456 (small blind) folded on the Turn
Seat 3: SantiagoWeight (big blind) collected ($2.69)
Seat 4: MileVoliD49 folded before Flop (didn't bet)
Seat 5: winwinboy folded before Flop (didn't bet)
Seat 6: dawwwid70 folded before Flop (didn't bet)



PokerStars Zoom Hand #195023974548:  Hold'em No Limit ($0.10/$0.25) - 2018/12/29 4:09:43 UTC [2018/12/28 23:09:43 ET]
Table 'Hydra' 6-max Seat #1 is the button
Seat 1: razil_999 ($25.83 in chips) 
Seat 2: ivann14 ($69.22 in chips) 
Seat 3: trttt74 ($19.75 in chips) 
Seat 4: SantiagoWeight ($27.65 in chips) 
Seat 5: 1ownYourUsd ($79.10 in chips) 
Seat 6: RESTRICTED.CR17 ($29.98 in chips) 
ivann14: posts small blind $0.10
trttt74: posts big blind $0.25
*** HOLE CARDS ***
Dealt to SantiagoWeight [Js 9d]
SantiagoWeight: folds 
1ownYourUsd: folds 
RESTRICTED.CR17: folds 
razil_999: folds 
ivann14: folds 
Uncalled bet ($0.15) returned to trttt74
trttt74 collected $0.20 from pot
trttt74: doesn't show hand 
*** SUMMARY ***
Total pot $0.20 | Rake $0 
Seat 1: razil_999 (button) folded before Flop (didn't bet)
Seat 2: ivann14 (small blind) folded before Flop
Seat 3: trttt74 (big blind) collected ($0.20)
Seat 4: SantiagoWeight folded before Flop (didn't bet)
Seat 5: 1ownYourUsd folded before Flop (didn't bet)
Seat 6: RESTRICTED.CR17 folded before Flop (didn't bet)



PokerStars Zoom Hand #195023973425:  Hold'em No Limit ($0.10/$0.25) - 2018/12/29 4:09:39 UTC [2018/12/28 23:09:39 ET]
Table 'Hydra' 6-max Seat #1 is the button
Seat 1: ol_2face ($81.83 in chips) 
Seat 2: jfgodtheg ($27.30 in chips) 
Seat 3: nabechan814 ($21.75 in chips) 
Seat 4: SantiagoWeight ($27.65 in chips) 
Seat 5: Renner32 ($34.89 in chips) 
Seat 6: cheolbeom ($25 in chips) 
jfgodtheg: posts small blind $0.10
nabechan814: posts big blind $0.25
*** HOLE CARDS ***
Dealt to SantiagoWeight [Qc 2h]
SantiagoWeight: folds 
Renner32: raises $0.50 to $0.75
cheolbeom: folds 
ol_2face: folds 
jfgodtheg: calls $0.65
nabechan814: folds 
*** FLOP *** [Ah 5c 5h]
jfgodtheg: checks 
Renner32: bets $1
jfgodtheg: calls $1
*** TURN *** [Ah 5c 5h] [3d]
jfgodtheg: checks 
Renner32: bets $2
jfgodtheg: folds 
Uncalled bet ($2) returned to Renner32
Renner32 collected $3.58 from pot
Renner32: doesn't show hand 
*** SUMMARY ***
Total pot $3.75 | Rake $0.17 
Board [Ah 5c 5h 3d]
Seat 1: ol_2face (button) folded before Flop (didn't bet)
Seat 2: jfgodtheg (small blind) folded on the Turn
Seat 3: nabechan814 (big blind) folded before Flop
Seat 4: SantiagoWeight folded before Flop (didn't bet)
Seat 5: Renner32 collected ($3.58)
Seat 6: cheolbeom folded before Flop (didn't bet)



PokerStars Zoom Hand #195023977087:  Hold'em No Limit ($0.10/$0.25) - 2018/12/29 4:09:52 UTC [2018/12/28 23:09:52 ET]
Table 'Hydra' 6-max Seat #1 is the button
Seat 1: SantiagoWeight ($27.65 in chips) 
Seat 2: Becks Baker ($25.10 in chips) 
Seat 3: cankum ($25.27 in chips) 
Seat 4: tariko1980 ($28.54 in chips) 
Seat 5: ol_2face ($81.83 in chips) 
Seat 6: razil_999 ($25.83 in chips) 
Becks Baker: posts small blind $0.10
cankum: posts big blind $0.25
*** HOLE CARDS ***
Dealt to SantiagoWeight [As 4s]
tariko1980: folds 
ol_2face: folds 
razil_999: folds 
SantiagoWeight: raises $0.30 to $0.55
Becks Baker: raises $1.95 to $2.50
cankum: folds 
SantiagoWeight: folds 
Uncalled bet ($1.95) returned to Becks Baker
Becks Baker collected $1.35 from pot
Becks Baker: doesn't show hand 
*** SUMMARY ***
Total pot $1.35 | Rake $0 
Seat 1: SantiagoWeight (button) folded before Flop
Seat 2: Becks Baker (small blind) collected ($1.35)
Seat 3: cankum (big blind) folded before Flop
Seat 4: tariko1980 folded before Flop (didn't bet)
Seat 5: ol_2face folded before Flop (didn't bet)
Seat 6: razil_999 folded before Flop (didn't bet)



PokerStars Zoom Hand #195023989712:  Hold'em No Limit ($0.10/$0.25) - 2018/12/29 4:10:36 UTC [2018/12/28 23:10:36 ET]
Table 'Hydra' 6-max Seat #1 is the button
Seat 1: Party4Arthy ($37 in chips) 
Seat 2: SantiagoWeight ($27.10 in chips) 
Seat 3: deaglepro ($55.29 in chips) 
Seat 4: MileVoliD49 ($28.72 in chips) 
Seat 5: TQNYMQNTANA ($33.21 in chips) 
Seat 6: cankum ($48.37 in chips) 
SantiagoWeight: posts small blind $0.10
deaglepro: posts big blind $0.25
*** HOLE CARDS ***
Dealt to SantiagoWeight [Qd 2h]
MileVoliD49: folds 
TQNYMQNTANA: folds 
cankum: raises $0.37 to $0.62
Party4Arthy: folds 
SantiagoWeight: folds 
deaglepro: folds 
Uncalled bet ($0.37) returned to cankum
cankum collected $0.60 from pot
cankum: doesn't show hand 
*** SUMMARY ***
Total pot $0.60 | Rake $0 
Seat 1: Party4Arthy (button) folded before Flop (didn't bet)
Seat 2: SantiagoWeight (small blind) folded before Flop
Seat 3: deaglepro (big blind) folded before Flop
Seat 4: MileVoliD49 folded before Flop (didn't bet)
Seat 5: TQNYMQNTANA folded before Flop (didn't bet)
Seat 6: cankum collected ($0.60)



PokerStars Zoom Hand #195023984802:  Hold'em No Limit ($0.10/$0.25) - 2018/12/29 4:10:19 UTC [2018/12/28 23:10:19 ET]
Table 'Hydra' 6-max Seat #1 is the button
Seat 1: LLiarrr ($25 in chips) 
Seat 2: zbuci ($53.30 in chips) 
Seat 3: vulcandog ($27.96 in chips) 
Seat 4: KeySssi ($33.67 in chips) 
Seat 5: dan_iasi ($70.24 in chips) 
Seat 6: SantiagoWeight ($27.10 in chips) 
zbuci: posts small blind $0.10
vulcandog: posts big blind $0.25
*** HOLE CARDS ***
Dealt to SantiagoWeight [6d Jc]
KeySssi: folds 
dan_iasi: folds 
SantiagoWeight: folds 
LLiarrr: raises $0.30 to $0.55
zbuci: raises $1.35 to $1.90
vulcandog: folds 
LLiarrr: folds 
Uncalled bet ($1.35) returned to zbuci
zbuci collected $1.35 from pot
zbuci: doesn't show hand 
*** SUMMARY ***
Total pot $1.35 | Rake $0 
Seat 1: LLiarrr (button) folded before Flop
Seat 2: zbuci (small blind) collected ($1.35)
Seat 3: vulcandog (big blind) folded before Flop
Seat 4: KeySssi folded before Flop (didn't bet)
Seat 5: dan_iasi folded before Flop (didn't bet)
Seat 6: SantiagoWeight folded before Flop (didn't bet)



PokerStars Zoom Hand #195023990870:  Hold'em No Limit ($0.10/$0.25) - 2018/12/29 4:10:40 UTC [2018/12/28 23:10:40 ET]
Table 'Hydra' 6-max Seat #1 is the button
Seat 1: ssrace ($38.98 in chips) 
Seat 2: nhanminhtri ($25 in chips) 
Seat 3: TDAK1509 ($45.34 in chips) 
Seat 4: Ovanes911 ($73.12 in chips) 
Seat 5: SantiagoWeight ($27 in chips) 
Seat 6: cwreinbold ($38.20 in chips) 
nhanminhtri: posts small blind $0.10
TDAK1509: posts big blind $0.25
*** HOLE CARDS ***
Dealt to SantiagoWeight [7s Qd]
Ovanes911: folds 
SantiagoWeight: folds 
cwreinbold: folds 
ssrace: raises $0.50 to $0.75
nhanminhtri: folds 
TDAK1509: folds 
Uncalled bet ($0.50) returned to ssrace
ssrace collected $0.60 from pot
ssrace: doesn't show hand 
*** SUMMARY ***
Total pot $0.60 | Rake $0 
Seat 1: ssrace (button) collected ($0.60)
Seat 2: nhanminhtri (small blind) folded before Flop
Seat 3: TDAK1509 (big blind) folded before Flop
Seat 4: Ovanes911 folded before Flop (didn't bet)
Seat 5: SantiagoWeight folded before Flop (didn't bet)
Seat 6: cwreinbold folded before Flop (didn't bet)



PokerStars Zoom Hand #195023993206:  Hold'em No Limit ($0.10/$0.25) - 2018/12/29 4:10:48 UTC [2018/12/28 23:10:48 ET]
Table 'Hydra' 6-max Seat #1 is the button
Seat 1: trttt74 ($19.40 in chips) 
Seat 2: GrandmasterY ($58.48 in chips) 
Seat 3: SantiagoWeight ($27 in chips) 
Seat 4: mililser ($24.88 in chips) 
Seat 5: Rika_run ($25 in chips) 
Seat 6: Party4Arthy ($36.90 in chips) 
GrandmasterY: posts small blind $0.10
SantiagoWeight: posts big blind $0.25
*** HOLE CARDS ***
Dealt to SantiagoWeight [Tc 5h]
mililser: folds 
Rika_run: folds 
Party4Arthy: folds 
trttt74: raises $0.50 to $0.75
GrandmasterY: folds 
SantiagoWeight: folds 
Uncalled bet ($0.50) returned to trttt74
trttt74 collected $0.60 from pot
trttt74: doesn't show hand 
*** SUMMARY ***
Total pot $0.60 | Rake $0 
Seat 1: trttt74 (button) collected ($0.60)
Seat 2: GrandmasterY (small blind) folded before Flop
Seat 3: SantiagoWeight (big blind) folded before Flop
Seat 4: mililser folded before Flop (didn't bet)
Seat 5: Rika_run folded before Flop (didn't bet)
Seat 6: Party4Arthy folded before Flop (didn't bet)



PokerStars Zoom Hand #195024001576:  Hold'em No Limit ($0.10/$0.25) - 2018/12/29 4:11:06 UTC [2018/12/28 23:11:06 ET]
Table 'Hydra' 6-max Seat #1 is the button
Seat 1: dan_iasi ($55.38 in chips) 
Seat 2: --LeGaaNs-- ($78 in chips) 
Seat 3: vulcandog ($10.37 in chips) 
Seat 4: bigm2261 ($12.60 in chips) 
Seat 5: SantiagoWeight ($26.75 in chips) 
Seat 6: trttt74 ($19.75 in chips) 
--LeGaaNs--: posts small blind $0.10
vulcandog: posts big blind $0.25
*** HOLE CARDS ***
Dealt to SantiagoWeight [Jh Qc]
bigm2261: folds 
SantiagoWeight: raises $0.37 to $0.62
trttt74: folds 
dan_iasi: folds 
--LeGaaNs--: folds 
vulcandog: calls $0.37
*** FLOP *** [Qd 7s Th]
vulcandog: checks 
SantiagoWeight: bets $0.85
vulcandog: folds 
Uncalled bet ($0.85) returned to SantiagoWeight
SantiagoWeight collected $1.28 from pot
SantiagoWeight: doesn't show hand 
*** SUMMARY ***
Total pot $1.34 | Rake $0.06 
Board [Qd 7s Th]
Seat 1: dan_iasi (button) folded before Flop (didn't bet)
Seat 2: --LeGaaNs-- (small blind) folded before Flop
Seat 3: vulcandog (big blind) folded on the Flop
Seat 4: bigm2261 folded before Flop (didn't bet)
Seat 5: SantiagoWeight collected ($1.28)
Seat 6: trttt74 folded before Flop (didn't bet)



PokerStars Zoom Hand #195024011692:  Hold'em No Limit ($0.10/$0.25) - 2018/12/29 4:11:41 UTC [2018/12/28 23:11:41 ET]
Table 'Hydra' 6-max Seat #1 is the button
Seat 1: graysonai ($25.35 in chips) 
Seat 2: anlu0803 ($24.25 in chips) 
Seat 3: 666erkan ($11.18 in chips) 
Seat 4: Breedijkie ($51.17 in chips) 
Seat 5: Elapostador33 ($18.39 in chips) 
Seat 6: SantiagoWeight ($27.41 in chips) 
anlu0803: posts small blind $0.10
666erkan: posts big blind $0.25
*** HOLE CARDS ***
Dealt to SantiagoWeight [Ac Tc]
Breedijkie: folds 
Elapostador33: folds 
SantiagoWeight: raises $0.30 to $0.55
graysonai: folds 
anlu0803: calls $0.45
666erkan: calls $0.30
*** FLOP *** [Td 9s 6s]
anlu0803: checks 
666erkan: checks 
SantiagoWeight: bets $1.05
anlu0803: folds 
666erkan: folds 
Uncalled bet ($1.05) returned to SantiagoWeight
SantiagoWeight collected $1.58 from pot
SantiagoWeight: doesn't show hand 
*** SUMMARY ***
Total pot $1.65 | Rake $0.07 
Board [Td 9s 6s]
Seat 1: graysonai (button) folded before Flop (didn't bet)
Seat 2: anlu0803 (small blind) folded on the Flop
Seat 3: 666erkan (big blind) folded on the Flop
Seat 4: Breedijkie folded before Flop (didn't bet)
Seat 5: Elapostador33 folded before Flop (didn't bet)
Seat 6: SantiagoWeight collected ($1.58)



PokerStars Zoom Hand #195024021410:  Hold'em No Limit ($0.10/$0.25) - 2018/12/29 4:12:14 UTC [2018/12/28 23:12:14 ET]
Table 'Hydra' 6-max Seat #1 is the button
Seat 1: anlu0803 ($23.70 in chips) 
Seat 2: vigos king ($33.47 in chips) 
Seat 3: SantiagoWeight ($28.44 in chips) 
Seat 4: Viiiru ($25.81 in chips) 
Seat 5: 666erkan ($10.53 in chips) 
Seat 6: Bonen18 ($34.45 in chips) 
vigos king: posts small blind $0.10
SantiagoWeight: posts big blind $0.25
*** HOLE CARDS ***
Dealt to SantiagoWeight [9c 3s]
Viiiru: folds 
666erkan: folds 
Bonen18: raises $0.37 to $0.62
anlu0803: folds 
vigos king: calls $0.52
SantiagoWeight: folds 
*** FLOP *** [4s Th Jd]
vigos king: checks 
Bonen18: checks 
*** TURN *** [4s Th Jd] [5d]
vigos king: bets $1.05
Bonen18: calls $1.05
*** RIVER *** [4s Th Jd 5d] [Qd]
vigos king: checks 
Bonen18: checks 
*** SHOW DOWN ***
vigos king: shows [9s Ts] (a pair of Tens)
Bonen18: mucks hand 
vigos king collected $3.43 from pot
*** SUMMARY ***
Total pot $3.59 | Rake $0.16 
Board [4s Th Jd 5d Qd]
Seat 1: anlu0803 (button) folded before Flop (didn't bet)
Seat 2: vigos king (small blind) showed [9s Ts] and won ($3.43) with a pair of Tens
Seat 3: SantiagoWeight (big blind) folded before Flop
Seat 4: Viiiru folded before Flop (didn't bet)
Seat 5: 666erkan folded before Flop (didn't bet)
Seat 6: Bonen18 mucked [6s 6d]



PokerStars Zoom Hand #195024027546:  Hold'em No Limit ($0.10/$0.25) - 2018/12/29 4:12:35 UTC [2018/12/28 23:12:35 ET]
Table 'Hydra' 6-max Seat #1 is the button
Seat 1: Buntar017 ($13.28 in chips) 
Seat 2: SantiagoWeight ($28.19 in chips) 
Seat 3: 2poiRiver ($26.99 in chips) 
Seat 4: alex3d1985 ($45.09 in chips) 
Seat 5: Nutselas ($28.64 in chips) 
Seat 6: davidhw888 ($47.12 in chips) 
SantiagoWeight: posts small blind $0.10
2poiRiver: posts big blind $0.25
*** HOLE CARDS ***
Dealt to SantiagoWeight [3d 8h]
alex3d1985: folds 
Nutselas: folds 
davidhw888: folds 
Buntar017: folds 
SantiagoWeight: folds 
Uncalled bet ($0.15) returned to 2poiRiver
2poiRiver collected $0.20 from pot
2poiRiver: doesn't show hand 
*** SUMMARY ***
Total pot $0.20 | Rake $0 
Seat 1: Buntar017 (button) folded before Flop (didn't bet)
Seat 2: SantiagoWeight (small blind) folded before Flop
Seat 3: 2poiRiver (big blind) collected ($0.20)
Seat 4: alex3d1985 folded before Flop (didn't bet)
Seat 5: Nutselas folded before Flop (didn't bet)
Seat 6: davidhw888 folded before Flop (didn't bet)



PokerStars Zoom Hand #195024034511:  Hold'em No Limit ($0.10/$0.25) - 2018/12/29 4:12:59 UTC [2018/12/28 23:12:59 ET]
Table 'Hydra' 6-max Seat #1 is the button
Seat 1: Dbakunwaves ($51.60 in chips) 
Seat 2: franco373513 ($15.54 in chips) 
Seat 3: denisss1801 ($28.76 in chips) 
Seat 4: SantiagoWeight ($28.09 in chips) 
Seat 5: 2poiRiver ($27.09 in chips) 
Seat 6: dawwwid70 ($27.19 in chips) 
franco373513: posts small blind $0.10
denisss1801: posts big blind $0.25
*** HOLE CARDS ***
Dealt to SantiagoWeight [6c 2s]
SantiagoWeight: folds 
2poiRiver: folds 
dawwwid70: folds 
Dbakunwaves: folds 
franco373513: folds 
Uncalled bet ($0.15) returned to denisss1801
denisss1801 collected $0.20 from pot
denisss1801: doesn't show hand 
*** SUMMARY ***
Total pot $0.20 | Rake $0 
Seat 1: Dbakunwaves (button) folded before Flop (didn't bet)
Seat 2: franco373513 (small blind) folded before Flop
Seat 3: denisss1801 (big blind) collected ($0.20)
Seat 4: SantiagoWeight folded before Flop (didn't bet)
Seat 5: 2poiRiver folded before Flop (didn't bet)
Seat 6: dawwwid70 folded before Flop (didn't bet)



PokerStars Zoom Hand #195024025485:  Hold'em No Limit ($0.10/$0.25) - 2018/12/29 4:12:28 UTC [2018/12/28 23:12:28 ET]
Table 'Hydra' 6-max Seat #1 is the button
Seat 1: SantiagoWeight ($28.19 in chips) 
Seat 2: DUDA3553 ($23.59 in chips) 
Seat 3: anlu0803 ($23.70 in chips) 
Seat 4: TQNYMQNTANA ($36.07 in chips) 
Seat 5: hamen1990 ($25 in chips) 
Seat 6: GrandmasterY ($43.66 in chips) 
DUDA3553: posts small blind $0.10
anlu0803: posts big blind $0.25
*** HOLE CARDS ***
Dealt to SantiagoWeight [5h 6c]
TQNYMQNTANA: raises $0.50 to $0.75
hamen1990: folds 
GrandmasterY: folds 
SantiagoWeight: folds 
DUDA3553: calls $0.65
anlu0803: calls $0.50
*** FLOP *** [6h Qh 3d]
DUDA3553: checks 
anlu0803: checks 
TQNYMQNTANA: checks 
*** TURN *** [6h Qh 3d] [2c]
DUDA3553: checks 
anlu0803: bets $2.25
TQNYMQNTANA: calls $2.25
DUDA3553: folds 
*** RIVER *** [6h Qh 3d 2c] [Th]
anlu0803: checks 
TQNYMQNTANA: checks 
*** SHOW DOWN ***
anlu0803: shows [2s 2d] (three of a kind, Deuces)
TQNYMQNTANA: mucks hand 
anlu0803 collected $6.45 from pot
*** SUMMARY ***
Total pot $6.75 | Rake $0.30 
Board [6h Qh 3d 2c Th]
Seat 1: SantiagoWeight (button) folded before Flop (didn't bet)
Seat 2: DUDA3553 (small blind) folded on the Turn
Seat 3: anlu0803 (big blind) showed [2s 2d] and won ($6.45) with three of a kind, Deuces
Seat 4: TQNYMQNTANA mucked [7s 7c]
Seat 5: hamen1990 folded before Flop (didn't bet)
Seat 6: GrandmasterY folded before Flop (didn't bet)



PokerStars Zoom Hand #195024035699:  Hold'em No Limit ($0.10/$0.25) - 2018/12/29 4:13:03 UTC [2018/12/28 23:13:03 ET]
Table 'Hydra' 6-max Seat #1 is the button
Seat 1: davidhw888 ($46.87 in chips) 
Seat 2: qing328 ($25 in chips) 
Seat 3: SantiagoWeight ($28.09 in chips) 
Seat 4: reetskeet ($54.07 in chips) 
Seat 5: winwinboy ($28.27 in chips) 
Seat 6: cheolbeom ($30.43 in chips) 
qing328: posts small blind $0.10
SantiagoWeight: posts big blind $0.25
*** HOLE CARDS ***
Dealt to SantiagoWeight [9d Qc]
reetskeet: folds 
winwinboy: folds 
cheolbeom: folds 
davidhw888: folds 
qing328: folds 
Uncalled bet ($0.15) returned to SantiagoWeight
SantiagoWeight collected $0.20 from pot
SantiagoWeight: doesn't show hand 
*** SUMMARY ***
Total pot $0.20 | Rake $0 
Seat 1: davidhw888 (button) folded before Flop (didn't bet)
Seat 2: qing328 (small blind) folded before Flop
Seat 3: SantiagoWeight (big blind) collected ($0.20)
Seat 4: reetskeet folded before Flop (didn't bet)
Seat 5: winwinboy folded before Flop (didn't bet)
Seat 6: cheolbeom folded before Flop (didn't bet)



PokerStars Zoom Hand #195024039795:  Hold'em No Limit ($0.10/$0.25) - 2018/12/29 4:13:17 UTC [2018/12/28 23:13:17 ET]
Table 'Hydra' 6-max Seat #1 is the button
Seat 1: 666erkan ($20.10 in chips) 
Seat 2: SantiagoWeight ($28.19 in chips) 
Seat 3: MileVoliD49 ($27.95 in chips) 
Seat 4: trttt74 ($25.44 in chips) 
Seat 5: graysonai ($49.93 in chips) 
Seat 6: onhoang87 ($24.59 in chips) 
SantiagoWeight: posts small blind $0.10
MileVoliD49: posts big blind $0.25
*** HOLE CARDS ***
Dealt to SantiagoWeight [5s Qh]
trttt74: folds 
graysonai: folds 
onhoang87: folds 
666erkan: folds 
SantiagoWeight: folds 
Uncalled bet ($0.15) returned to MileVoliD49
MileVoliD49 collected $0.20 from pot
MileVoliD49: doesn't show hand 
*** SUMMARY ***
Total pot $0.20 | Rake $0 
Seat 1: 666erkan (button) folded before Flop (didn't bet)
Seat 2: SantiagoWeight (small blind) folded before Flop
Seat 3: MileVoliD49 (big blind) collected ($0.20)
Seat 4: trttt74 folded before Flop (didn't bet)
Seat 5: graysonai folded before Flop (didn't bet)
Seat 6: onhoang87 folded before Flop (didn't bet)



PokerStars Zoom Hand #195024042423:  Hold'em No Limit ($0.10/$0.25) - 2018/12/29 4:13:26 UTC [2018/12/28 23:13:26 ET]
Table 'Hydra' 6-max Seat #1 is the button
Seat 1: SantiagoWeight ($28.09 in chips) 
Seat 2: crashbuum ($22.74 in chips) 
Seat 3: qing328 ($24.44 in chips) 
Seat 4: buba de tuc ($18.68 in chips) 
Seat 5: ruiken ($26.11 in chips) 
Seat 6: mililser ($26.14 in chips) 
crashbuum: posts small blind $0.10
qing328: posts big blind $0.25
*** HOLE CARDS ***
Dealt to SantiagoWeight [7d Kc]
buba de tuc: folds 
ruiken: folds 
mililser: folds 
SantiagoWeight: raises $0.30 to $0.55
crashbuum: folds 
qing328: folds 
Uncalled bet ($0.30) returned to SantiagoWeight
SantiagoWeight collected $0.60 from pot
SantiagoWeight: doesn't show hand 
*** SUMMARY ***
Total pot $0.60 | Rake $0 
Seat 1: SantiagoWeight (button) collected ($0.60)
Seat 2: crashbuum (small blind) folded before Flop
Seat 3: qing328 (big blind) folded before Flop
Seat 4: buba de tuc folded before Flop (didn't bet)
Seat 5: ruiken folded before Flop (didn't bet)
Seat 6: mililser folded before Flop (didn't bet)



PokerStars Zoom Hand #195024047125:  Hold'em No Limit ($0.10/$0.25) - 2018/12/29 4:13:42 UTC [2018/12/28 23:13:42 ET]
Table 'Hydra' 6-max Seat #1 is the button
Seat 1: qing328 ($23.65 in chips) 
Seat 2: Renner32 ($34.57 in chips) 
Seat 3: Jameson11 ($19.30 in chips) 
Seat 4: mariopork ($89.74 in chips) 
Seat 5: KrishnaRadha ($34.29 in chips) 
Seat 6: SantiagoWeight ($28.44 in chips) 
Renner32: posts small blind $0.10
Jameson11: posts big blind $0.25
*** HOLE CARDS ***
Dealt to SantiagoWeight [2d 6d]
mariopork: raises $0.50 to $0.75
KrishnaRadha: folds 
SantiagoWeight: folds 
qing328: folds 
Renner32: folds 
Jameson11: folds 
Uncalled bet ($0.50) returned to mariopork
mariopork collected $0.60 from pot
mariopork: doesn't show hand 
*** SUMMARY ***
Total pot $0.60 | Rake $0 
Seat 1: qing328 (button) folded before Flop (didn't bet)
Seat 2: Renner32 (small blind) folded before Flop
Seat 3: Jameson11 (big blind) folded before Flop
Seat 4: mariopork collected ($0.60)
Seat 5: KrishnaRadha folded before Flop (didn't bet)
Seat 6: SantiagoWeight folded before Flop (didn't bet)



PokerStars Zoom Hand #195024028706:  Hold'em No Limit ($0.10/$0.25) - 2018/12/29 4:12:39 UTC [2018/12/28 23:12:39 ET]
Table 'Hydra' 6-max Seat #1 is the button
Seat 1: pirosiky ($67.33 in chips) 
Seat 2: kakashi_zion ($13.34 in chips) 
Seat 3: Lehared ($29.67 in chips) 
Seat 4: alex3d1985 ($45.09 in chips) 
Seat 5: Elapostador33 ($17.64 in chips) 
Seat 6: SantiagoWeight ($28.09 in chips) 
kakashi_zion: posts small blind $0.10
Lehared: posts big blind $0.25
*** HOLE CARDS ***
Dealt to SantiagoWeight [Ks 3c]
alex3d1985: folds 
Elapostador33: calls $0.25
SantiagoWeight: folds 
pirosiky: folds 
kakashi_zion: folds 
Lehared: checks 
*** FLOP *** [Ts 5d Jh]
Lehared: checks 
Elapostador33: bets $0.25
Lehared: calls $0.25
*** TURN *** [Ts 5d Jh] [6h]
Lehared: checks 
Elapostador33: bets $1
Lehared: folds 
Uncalled bet ($1) returned to Elapostador33
Elapostador33 collected $1.05 from pot
Elapostador33: doesn't show hand 
*** SUMMARY ***
Total pot $1.10 | Rake $0.05 
Board [Ts 5d Jh 6h]
Seat 1: pirosiky (button) folded before Flop (didn't bet)
Seat 2: kakashi_zion (small blind) folded before Flop
Seat 3: Lehared (big blind) folded on the Turn
Seat 4: alex3d1985 folded before Flop (didn't bet)
Seat 5: Elapostador33 collected ($1.05)
Seat 6: SantiagoWeight folded before Flop (didn't bet)



PokerStars Zoom Hand #195024050536:  Hold'em No Limit ($0.10/$0.25) - 2018/12/29 4:13:54 UTC [2018/12/28 23:13:54 ET]
Table 'Hydra' 6-max Seat #1 is the button
Seat 1: zdenekstavic ($43.57 in chips) 
Seat 2: ruiken ($22.40 in chips) 
Seat 3: TQNYMQNTANA ($29.54 in chips) 
Seat 4: SantiagoWeight ($28.44 in chips) 
Seat 5: athos 007 ($36.21 in chips) 
Seat 6: cheolbeom ($30.08 in chips) 
ruiken: posts small blind $0.10
TQNYMQNTANA: posts big blind $0.25
*** HOLE CARDS ***
Dealt to SantiagoWeight [5h 5c]
SantiagoWeight: raises $0.42 to $0.67
athos 007: calls $0.67
cheolbeom: folds 
zdenekstavic: folds 
ruiken: folds 
TQNYMQNTANA: folds 
*** FLOP *** [3s 4s 4c]
SantiagoWeight: bets $0.40
athos 007: calls $0.40
*** TURN *** [3s 4s 4c] [2d]
SantiagoWeight: bets $1.80
athos 007: folds 
Uncalled bet ($1.80) returned to SantiagoWeight
SantiagoWeight collected $2.38 from pot
SantiagoWeight: doesn't show hand 
*** SUMMARY ***
Total pot $2.49 | Rake $0.11 
Board [3s 4s 4c 2d]
Seat 1: zdenekstavic (button) folded before Flop (didn't bet)
Seat 2: ruiken (small blind) folded before Flop
Seat 3: TQNYMQNTANA (big blind) folded before Flop
Seat 4: SantiagoWeight collected ($2.38)
Seat 5: athos 007 folded on the Turn
Seat 6: cheolbeom folded before Flop (didn't bet)



PokerStars Zoom Hand #195024059263:  Hold'em No Limit ($0.10/$0.25) - 2018/12/29 4:14:24 UTC [2018/12/28 23:14:24 ET]
Table 'Hydra' 6-max Seat #1 is the button
Seat 1: Unclesmoll ($16.13 in chips) 
Seat 2: davidhw888 ($50.67 in chips) 
Seat 3: alex3d1985 ($16.26 in chips) 
Seat 4: jfgodtheg ($23.19 in chips) 
Seat 5: SantiagoWeight ($29.75 in chips) 
Seat 6: vigos king ($34.51 in chips) 
davidhw888: posts small blind $0.10
alex3d1985: posts big blind $0.25
*** HOLE CARDS ***
Dealt to SantiagoWeight [Ks Td]
jfgodtheg: raises $0.60 to $0.85
SantiagoWeight: folds 
vigos king: folds 
Unclesmoll: folds 
davidhw888: calls $0.75
alex3d1985: calls $0.60
*** FLOP *** [Th 8d Ac]
davidhw888: checks 
alex3d1985: checks 
jfgodtheg: bets $2.50
davidhw888: folds 
alex3d1985: folds 
Uncalled bet ($2.50) returned to jfgodtheg
jfgodtheg collected $2.44 from pot
jfgodtheg: doesn't show hand 
*** SUMMARY ***
Total pot $2.55 | Rake $0.11 
Board [Th 8d Ac]
Seat 1: Unclesmoll (button) folded before Flop (didn't bet)
Seat 2: davidhw888 (small blind) folded on the Flop
Seat 3: alex3d1985 (big blind) folded on the Flop
Seat 4: jfgodtheg collected ($2.44)
Seat 5: SantiagoWeight folded before Flop (didn't bet)
Seat 6: vigos king folded before Flop (didn't bet)



PokerStars Zoom Hand #195024032196:  Hold'em No Limit ($0.10/$0.25) - 2018/12/29 4:12:51 UTC [2018/12/28 23:12:51 ET]
Table 'Hydra' 6-max Seat #1 is the button
Seat 1: zbuci ($57.46 in chips) 
Seat 2: Becks Baker ($25.78 in chips) 
Seat 3: trttt74 ($25.69 in chips) 
Seat 4: denisss1801 ($28.76 in chips) 
Seat 5: SantiagoWeight ($28.09 in chips) 
Seat 6: dawwwid70 ($25 in chips) 
Becks Baker: posts small blind $0.10
trttt74: posts big blind $0.25
*** HOLE CARDS ***
Dealt to SantiagoWeight [8h 7c]
denisss1801: folds 
SantiagoWeight: folds 
dawwwid70: folds 
zbuci: raises $0.50 to $0.75
Becks Baker: raises $2 to $2.75
trttt74: folds 
zbuci: calls $2
*** FLOP *** [Qc Ks 8s]
Becks Baker: bets $1.65
zbuci: calls $1.65
*** TURN *** [Qc Ks 8s] [6s]
Becks Baker: bets $4.32
zbuci: calls $4.32
*** RIVER *** [Qc Ks 8s 6s] [2c]
Becks Baker: checks 
zbuci: bets $12
Becks Baker: calls $12
*** SHOW DOWN ***
zbuci: shows [5s As] (a flush, Ace high)
Becks Baker: mucks hand 
zbuci collected $39.81 from pot
*** SUMMARY ***
Total pot $41.69 | Rake $1.88 
Board [Qc Ks 8s 6s 2c]
Seat 1: zbuci (button) showed [5s As] and won ($39.81) with a flush, Ace high
Seat 2: Becks Baker (small blind) mucked [Th Kh]
Seat 3: trttt74 (big blind) folded before Flop
Seat 4: denisss1801 folded before Flop (didn't bet)
Seat 5: SantiagoWeight folded before Flop (didn't bet)
Seat 6: dawwwid70 folded before Flop (didn't bet)



PokerStars Zoom Hand #195024060698:  Hold'em No Limit ($0.10/$0.25) - 2018/12/29 4:14:29 UTC [2018/12/28 23:14:29 ET]
Table 'Hydra' 6-max Seat #1 is the button
Seat 1: ivann14 ($63 in chips) 
Seat 2: --LeGaaNs-- ($79.62 in chips) 
Seat 3: Gonzalit0o ($26.39 in chips) 
Seat 4: SantiagoWeight ($29.75 in chips) 
Seat 5: dan_iasi ($89.02 in chips) 
Seat 6: qing328 ($26.03 in chips) 
--LeGaaNs--: posts small blind $0.10
Gonzalit0o: posts big blind $0.25
*** HOLE CARDS ***
Dealt to SantiagoWeight [8h Kh]
SantiagoWeight: folds 
dan_iasi: folds 
qing328: folds 
ivann14: raises $0.25 to $0.50
--LeGaaNs--: folds 
Gonzalit0o: folds 
Uncalled bet ($0.25) returned to ivann14
ivann14 collected $0.60 from pot
ivann14: doesn't show hand 
*** SUMMARY ***
Total pot $0.60 | Rake $0 
Seat 1: ivann14 (button) collected ($0.60)
Seat 2: --LeGaaNs-- (small blind) folded before Flop
Seat 3: Gonzalit0o (big blind) folded before Flop
Seat 4: SantiagoWeight folded before Flop (didn't bet)
Seat 5: dan_iasi folded before Flop (didn't bet)
Seat 6: qing328 folded before Flop (didn't bet)



PokerStars Zoom Hand #195024063603:  Hold'em No Limit ($0.10/$0.25) - 2018/12/29 4:14:39 UTC [2018/12/28 23:14:39 ET]
Table 'Hydra' 6-max Seat #1 is the button
Seat 1: trttt74 ($32.10 in chips) 
Seat 2: buba de tuc ($18.28 in chips) 
Seat 3: SantiagoWeight ($29.75 in chips) 
Seat 4: tariko1980 ($31.18 in chips) 
Seat 5: KAllUSTA ($21.59 in chips) 
Seat 6: ruiken ($19.05 in chips) 
buba de tuc: posts small blind $0.10
SantiagoWeight: posts big blind $0.25
*** HOLE CARDS ***
Dealt to SantiagoWeight [8s 9d]
tariko1980: folds 
KAllUSTA: raises $0.25 to $0.50
ruiken: folds 
trttt74: folds 
buba de tuc: calls $0.40
SantiagoWeight: calls $0.25
*** FLOP *** [8h Qd 4s]
buba de tuc: checks 
SantiagoWeight: checks 
KAllUSTA: checks 
*** TURN *** [8h Qd 4s] [Td]
buba de tuc: bets $1.43
SantiagoWeight: folds 
KAllUSTA: folds 
Uncalled bet ($1.43) returned to buba de tuc
buba de tuc collected $1.43 from pot
buba de tuc: doesn't show hand 
*** SUMMARY ***
Total pot $1.50 | Rake $0.07 
Board [8h Qd 4s Td]
Seat 1: trttt74 (button) folded before Flop (didn't bet)
Seat 2: buba de tuc (small blind) collected ($1.43)
Seat 3: SantiagoWeight (big blind) folded on the Turn
Seat 4: tariko1980 folded before Flop (didn't bet)
Seat 5: KAllUSTA folded on the Turn
Seat 6: ruiken folded before Flop (didn't bet)



PokerStars Zoom Hand #195024081087:  Hold'em No Limit ($0.10/$0.25) - 2018/12/29 4:15:39 UTC [2018/12/28 23:15:39 ET]
Table 'Hydra' 6-max Seat #1 is the button
Seat 1: reggiedogg31 ($113.97 in chips) 
Seat 2: SantiagoWeight ($29.25 in chips) 
Seat 3: _BluDeeN_ ($24.25 in chips) 
Seat 4: kaizin727 ($24.96 in chips) 
Seat 5: BRSOB79 ($26.62 in chips) 
Seat 6: graysonai ($25.80 in chips) 
SantiagoWeight: posts small blind $0.10
_BluDeeN_: posts big blind $0.25
*** HOLE CARDS ***
Dealt to SantiagoWeight [7c Ah]
kaizin727: folds 
BRSOB79: folds 
graysonai: raises $0.30 to $0.55
reggiedogg31: folds 
SantiagoWeight: folds 
_BluDeeN_: folds 
Uncalled bet ($0.30) returned to graysonai
graysonai collected $0.60 from pot
graysonai: doesn't show hand 
*** SUMMARY ***
Total pot $0.60 | Rake $0 
Seat 1: reggiedogg31 (button) folded before Flop (didn't bet)
Seat 2: SantiagoWeight (small blind) folded before Flop
Seat 3: _BluDeeN_ (big blind) folded before Flop
Seat 4: kaizin727 folded before Flop (didn't bet)
Seat 5: BRSOB79 folded before Flop (didn't bet)
Seat 6: graysonai collected ($0.60)



PokerStars Zoom Hand #195024085986:  Hold'em No Limit ($0.10/$0.25) - 2018/12/29 4:15:56 UTC [2018/12/28 23:15:56 ET]
Table 'Hydra' 6-max Seat #1 is the button
Seat 1: SantiagoWeight ($29.15 in chips) 
Seat 2: vigos king ($34.92 in chips) 
Seat 3: dennis03823 ($32.05 in chips) 
Seat 4: pirosiky ($25 in chips) 
Seat 5: Jameson11 ($18.35 in chips) 
Seat 6: sigaro010 ($22.53 in chips) 
vigos king: posts small blind $0.10
dennis03823: posts big blind $0.25
*** HOLE CARDS ***
Dealt to SantiagoWeight [Qs Ad]
pirosiky: raises $0.50 to $0.75
Jameson11: folds 
sigaro010: calls $0.75
SantiagoWeight: calls $0.75
vigos king: folds 
dennis03823: folds 
*** FLOP *** [8s As 8h]
pirosiky: checks 
sigaro010: bets $1.50
SantiagoWeight: calls $1.50
pirosiky: folds 
*** TURN *** [8s As 8h] [6s]
sigaro010: checks 
SantiagoWeight: bets $3.90
sigaro010: folds 
Uncalled bet ($3.90) returned to SantiagoWeight
SantiagoWeight collected $5.35 from pot
SantiagoWeight: doesn't show hand 
*** SUMMARY ***
Total pot $5.60 | Rake $0.25 
Board [8s As 8h 6s]
Seat 1: SantiagoWeight (button) collected ($5.35)
Seat 2: vigos king (small blind) folded before Flop
Seat 3: dennis03823 (big blind) folded before Flop
Seat 4: pirosiky folded on the Flop
Seat 5: Jameson11 folded before Flop (didn't bet)
Seat 6: sigaro010 folded on the Turn



PokerStars Zoom Hand #195024102436:  Hold'em No Limit ($0.10/$0.25) - 2018/12/29 4:16:52 UTC [2018/12/28 23:16:52 ET]
Table 'Hydra' 6-max Seat #1 is the button
Seat 1: Lehared ($82.55 in chips) 
Seat 2: qing328 ($24.26 in chips) 
Seat 3: pirosiky ($25 in chips) 
Seat 4: SantiagoWeight ($32.25 in chips) 
Seat 5: Unclesmoll ($17.20 in chips) 
Seat 6: Bonen18 ($25.35 in chips) 
qing328: posts small blind $0.10
pirosiky: posts big blind $0.25
*** HOLE CARDS ***
Dealt to SantiagoWeight [6d Jd]
SantiagoWeight: folds 
Unclesmoll: folds 
Bonen18: folds 
Lehared: folds 
qing328: raises $0.50 to $0.75
pirosiky: folds 
Uncalled bet ($0.50) returned to qing328
qing328 collected $0.50 from pot
qing328: doesn't show hand 
*** SUMMARY ***
Total pot $0.50 | Rake $0 
Seat 1: Lehared (button) folded before Flop (didn't bet)
Seat 2: qing328 (small blind) collected ($0.50)
Seat 3: pirosiky (big blind) folded before Flop
Seat 4: SantiagoWeight folded before Flop (didn't bet)
Seat 5: Unclesmoll folded before Flop (didn't bet)
Seat 6: Bonen18 folded before Flop (didn't bet)



PokerStars Zoom Hand #195024103883:  Hold'em No Limit ($0.10/$0.25) - 2018/12/29 4:16:57 UTC [2018/12/28 23:16:57 ET]
Table 'Hydra' 6-max Seat #1 is the button
Seat 1: cheolbeom ($26.70 in chips) 
Seat 2: SantiagoWeight ($32.25 in chips) 
Seat 3: vulcandog ($4.22 in chips) 
Seat 4: Viiiru ($27.36 in chips) 
Seat 5: Ovanes911 ($84.89 in chips) 
Seat 6: clashwizard23 ($30.75 in chips) 
SantiagoWeight: posts small blind $0.10
vulcandog: posts big blind $0.25
*** HOLE CARDS ***
Dealt to SantiagoWeight [Jc Jd]
Viiiru: folds 
Ovanes911: folds 
clashwizard23: folds 
cheolbeom: folds 
SantiagoWeight: raises $0.50 to $0.75
vulcandog: folds 
Uncalled bet ($0.50) returned to SantiagoWeight
SantiagoWeight collected $0.50 from pot
SantiagoWeight: doesn't show hand 
*** SUMMARY ***
Total pot $0.50 | Rake $0 
Seat 1: cheolbeom (button) folded before Flop (didn't bet)
Seat 2: SantiagoWeight (small blind) collected ($0.50)
Seat 3: vulcandog (big blind) folded before Flop
Seat 4: Viiiru folded before Flop (didn't bet)
Seat 5: Ovanes911 folded before Flop (didn't bet)
Seat 6: clashwizard23 folded before Flop (didn't bet)



PokerStars Zoom Hand #195024100970:  Hold'em No Limit ($0.10/$0.25) - 2018/12/29 4:16:47 UTC [2018/12/28 23:16:47 ET]
Table 'Hydra' 6-max Seat #1 is the button
Seat 1: GrandmasterY ($29.10 in chips) 
Seat 2: Dimvov ($14.07 in chips) 
Seat 3: kaizin727 ($25.66 in chips) 
Seat 4: sigaro010 ($41.09 in chips) 
Seat 5: mariopork ($33.69 in chips) 
Seat 6: SantiagoWeight ($32.25 in chips) 
Dimvov: posts small blind $0.10
kaizin727: posts big blind $0.25
*** HOLE CARDS ***
Dealt to SantiagoWeight [9d 3h]
sigaro010: raises $0.50 to $0.75
mariopork: folds 
SantiagoWeight: folds 
GrandmasterY: folds 
Dimvov: calls $0.65
kaizin727: folds 
*** FLOP *** [4h Qs 3c]
Dimvov: bets $1.34
sigaro010: calls $1.34
*** TURN *** [4h Qs 3c] [Jc]
Dimvov: bets $0.50
sigaro010: calls $0.50
*** RIVER *** [4h Qs 3c Jc] [Kh]
Dimvov: checks 
sigaro010: checks 
*** SHOW DOWN ***
Dimvov: shows [As Qc] (a pair of Queens)
sigaro010: mucks hand 
Dimvov collected $5.19 from pot
*** SUMMARY ***
Total pot $5.43 | Rake $0.24 
Board [4h Qs 3c Jc Kh]
Seat 1: GrandmasterY (button) folded before Flop (didn't bet)
Seat 2: Dimvov (small blind) showed [As Qc] and won ($5.19) with a pair of Queens
Seat 3: kaizin727 (big blind) folded before Flop
Seat 4: sigaro010 mucked [7c 7s]
Seat 5: mariopork folded before Flop (didn't bet)
Seat 6: SantiagoWeight folded before Flop (didn't bet)



PokerStars Zoom Hand #195024108820:  Hold'em No Limit ($0.10/$0.25) - 2018/12/29 4:17:14 UTC [2018/12/28 23:17:14 ET]
Table 'Hydra' 6-max Seat #1 is the button
Seat 1: Gonzalit0o ($52.24 in chips) 
Seat 2: Party4Arthy ($34.21 in chips) 
Seat 3: ruiken ($34.62 in chips) 
Seat 4: dan_iasi ($91.34 in chips) 
Seat 5: SantiagoWeight ($32.50 in chips) 
Seat 6: hamen1990 ($24.19 in chips) 
Party4Arthy: posts small blind $0.10
ruiken: posts big blind $0.25
*** HOLE CARDS ***
Dealt to SantiagoWeight [Kd 8s]
dan_iasi: folds 
SantiagoWeight: folds 
hamen1990: folds 
Gonzalit0o: raises $0.50 to $0.75
Party4Arthy: folds 
ruiken: folds 
Uncalled bet ($0.50) returned to Gonzalit0o
Gonzalit0o collected $0.60 from pot
Gonzalit0o: doesn't show hand 
*** SUMMARY ***
Total pot $0.60 | Rake $0 
Seat 1: Gonzalit0o (button) collected ($0.60)
Seat 2: Party4Arthy (small blind) folded before Flop
Seat 3: ruiken (big blind) folded before Flop
Seat 4: dan_iasi folded before Flop (didn't bet)
Seat 5: SantiagoWeight folded before Flop (didn't bet)
Seat 6: hamen1990 folded before Flop (didn't bet)



PokerStars Zoom Hand #195024111991:  Hold'em No Limit ($0.10/$0.25) - 2018/12/29 4:17:25 UTC [2018/12/28 23:17:25 ET]
Table 'Hydra' 6-max Seat #1 is the button
Seat 1: dan_iasi ($56.84 in chips) 
Seat 2: mariopork ($34.04 in chips) 
Seat 3: SantiagoWeight ($32.50 in chips) 
Seat 4: !P0K3RM3T4L! ($25.10 in chips) 
Seat 5: sigaro010 ($38.50 in chips) 
Seat 6: ivann14 ($62.27 in chips) 
mariopork: posts small blind $0.10
SantiagoWeight: posts big blind $0.25
*** HOLE CARDS ***
Dealt to SantiagoWeight [Td 5c]
!P0K3RM3T4L!: folds 
sigaro010: folds 
ivann14: raises $0.50 to $0.75
dan_iasi: folds 
mariopork: folds 
SantiagoWeight: folds 
Uncalled bet ($0.50) returned to ivann14
ivann14 collected $0.60 from pot
*** SUMMARY ***
Total pot $0.60 | Rake $0 
Seat 1: dan_iasi (button) folded before Flop (didn't bet)
Seat 2: mariopork (small blind) folded before Flop
Seat 3: SantiagoWeight (big blind) folded before Flop
Seat 4: !P0K3RM3T4L! folded before Flop (didn't bet)
Seat 5: sigaro010 folded before Flop (didn't bet)
Seat 6: ivann14 collected ($0.60)



PokerStars Zoom Hand #195024124558:  Hold'em No Limit ($0.10/$0.25) - 2018/12/29 4:18:08 UTC [2018/12/28 23:18:08 ET]
Table 'Hydra' 6-max Seat #1 is the button
Seat 1: mariopork ($87.93 in chips) 
Seat 2: 1ownYourUsd ($69.70 in chips) 
Seat 3: winwinboy ($25.08 in chips) 
Seat 4: 666erkan ($17.62 in chips) 
Seat 5: ivann14 ($55.06 in chips) 
Seat 6: SantiagoWeight ($32.25 in chips) 
1ownYourUsd: posts small blind $0.10
winwinboy: posts big blind $0.25
*** HOLE CARDS ***
Dealt to SantiagoWeight [5c 8d]
666erkan: folds 
ivann14: raises $0.50 to $0.75
SantiagoWeight: folds 
mariopork: folds 
1ownYourUsd: folds 
winwinboy: folds 
Uncalled bet ($0.50) returned to ivann14
ivann14 collected $0.60 from pot
ivann14: doesn't show hand 
*** SUMMARY ***
Total pot $0.60 | Rake $0 
Seat 1: mariopork (button) folded before Flop (didn't bet)
Seat 2: 1ownYourUsd (small blind) folded before Flop
Seat 3: winwinboy (big blind) folded before Flop
Seat 4: 666erkan folded before Flop (didn't bet)
Seat 5: ivann14 collected ($0.60)
Seat 6: SantiagoWeight folded before Flop (didn't bet)



PokerStars Zoom Hand #195024123120:  Hold'em No Limit ($0.10/$0.25) - 2018/12/29 4:18:03 UTC [2018/12/28 23:18:03 ET]
Table 'Hydra' 6-max Seat #1 is the button
Seat 1: SantiagoWeight ($32.25 in chips) 
Seat 2: _BluDeeN_ ($22.65 in chips) 
Seat 3: TDAK1509 ($39.40 in chips) 
Seat 4: river plate9 ($40.39 in chips) 
Seat 5: !P0K3RM3T4L! ($25 in chips) 
Seat 6: mariopork ($87.93 in chips) 
_BluDeeN_: posts small blind $0.10
TDAK1509: posts big blind $0.25
*** HOLE CARDS ***
Dealt to SantiagoWeight [7d 2c]
river plate9: raises $0.25 to $0.50
!P0K3RM3T4L!: folds 
mariopork: folds 
SantiagoWeight: folds 
_BluDeeN_: folds 
TDAK1509: folds 
Uncalled bet ($0.25) returned to river plate9
river plate9 collected $0.60 from pot
river plate9: doesn't show hand 
*** SUMMARY ***
Total pot $0.60 | Rake $0 
Seat 1: SantiagoWeight (button) folded before Flop (didn't bet)
Seat 2: _BluDeeN_ (small blind) folded before Flop
Seat 3: TDAK1509 (big blind) folded before Flop
Seat 4: river plate9 collected ($0.60)
Seat 5: !P0K3RM3T4L! folded before Flop (didn't bet)
Seat 6: mariopork folded before Flop (didn't bet)



PokerStars Zoom Hand #195024126004:  Hold'em No Limit ($0.10/$0.25) - 2018/12/29 4:18:13 UTC [2018/12/28 23:18:13 ET]
Table 'Hydra' 6-max Seat #1 is the button
Seat 1: 1ownYourUsd ($69.60 in chips) 
Seat 2: ruiken ($34.02 in chips) 
Seat 3: SantiagoWeight ($32.25 in chips) 
Seat 4: !P0K3RM3T4L! ($25 in chips) 
Seat 5: Aco80 ($27.39 in chips) 
Seat 6: pirosiky ($25 in chips) 
ruiken: posts small blind $0.10
SantiagoWeight: posts big blind $0.25
*** HOLE CARDS ***
Dealt to SantiagoWeight [Ks Jd]
!P0K3RM3T4L!: folds 
Aco80 has timed out while disconnected
Aco80: folds 
pirosiky has timed out
pirosiky: folds 
1ownYourUsd: folds 
ruiken: raises $0.50 to $0.75
SantiagoWeight: calls $0.50
*** FLOP *** [7s 4d 2h]
ruiken: checks 
SantiagoWeight: checks 
*** TURN *** [7s 4d 2h] [Kd]
ruiken: checks 
SantiagoWeight: bets $0.95
ruiken: folds 
Uncalled bet ($0.95) returned to SantiagoWeight
SantiagoWeight collected $1.43 from pot
SantiagoWeight: doesn't show hand 
*** SUMMARY ***
Total pot $1.50 | Rake $0.07 
Board [7s 4d 2h Kd]
Seat 1: 1ownYourUsd (button) folded before Flop (didn't bet)
Seat 2: ruiken (small blind) folded on the Turn
Seat 3: SantiagoWeight (big blind) collected ($1.43)
Seat 4: !P0K3RM3T4L! folded before Flop (didn't bet)
Seat 5: Aco80 folded before Flop (didn't bet)
Seat 6: pirosiky folded before Flop (didn't bet)



PokerStars Zoom Hand #195024150342:  Hold'em No Limit ($0.10/$0.25) - 2018/12/29 4:19:37 UTC [2018/12/28 23:19:37 ET]
Table 'Hydra' 6-max Seat #1 is the button
Seat 1: zbuci ($34.16 in chips) 
Seat 2: qing328 ($23.91 in chips) 
Seat 3: Gongyong ($28.55 in chips) 
Seat 4: !P0K3RM3T4L! ($26.71 in chips) 
Seat 5: SantiagoWeight ($32.93 in chips) 
Seat 6: 1ownYourUsd ($59.80 in chips) 
qing328: posts small blind $0.10
Gongyong: posts big blind $0.25
*** HOLE CARDS ***
Dealt to SantiagoWeight [5h 3d]
!P0K3RM3T4L!: folds 
SantiagoWeight: folds 
1ownYourUsd: folds 
zbuci: folds 
qing328: folds 
Uncalled bet ($0.15) returned to Gongyong
Gongyong collected $0.20 from pot
Gongyong: doesn't show hand 
*** SUMMARY ***
Total pot $0.20 | Rake $0 
Seat 1: zbuci (button) folded before Flop (didn't bet)
Seat 2: qing328 (small blind) folded before Flop
Seat 3: Gongyong (big blind) collected ($0.20)
Seat 4: !P0K3RM3T4L! folded before Flop (didn't bet)
Seat 5: SantiagoWeight folded before Flop (didn't bet)
Seat 6: 1ownYourUsd folded before Flop (didn't bet)



PokerStars Zoom Hand #195024152381:  Hold'em No Limit ($0.10/$0.25) - 2018/12/29 4:19:44 UTC [2018/12/28 23:19:44 ET]
Table 'Hydra' 6-max Seat #1 is the button
Seat 1: !P0K3RM3T4L! ($26.71 in chips) 
Seat 2: SantiagoWeight ($32.93 in chips) 
Seat 3: sigaro010 ($24.80 in chips) 
Seat 4: RESTRICTED.CR17 ($26.34 in chips) 
Seat 5: graysonai ($28.06 in chips) 
Seat 6: reggiedogg31 ($113.29 in chips) 
SantiagoWeight: posts small blind $0.10
sigaro010: posts big blind $0.25
*** HOLE CARDS ***
Dealt to SantiagoWeight [2h 9h]
RESTRICTED.CR17: folds 
graysonai: folds 
reggiedogg31: folds 
!P0K3RM3T4L!: folds 
SantiagoWeight: folds 
Uncalled bet ($0.15) returned to sigaro010
sigaro010 collected $0.20 from pot
sigaro010: doesn't show hand 
*** SUMMARY ***
Total pot $0.20 | Rake $0 
Seat 1: !P0K3RM3T4L! (button) folded before Flop (didn't bet)
Seat 2: SantiagoWeight (small blind) folded before Flop
Seat 3: sigaro010 (big blind) collected ($0.20)
Seat 4: RESTRICTED.CR17 folded before Flop (didn't bet)
Seat 5: graysonai folded before Flop (didn't bet)
Seat 6: reggiedogg31 folded before Flop (didn't bet)



PokerStars Zoom Hand #195024157525:  Hold'em No Limit ($0.10/$0.25) - 2018/12/29 4:20:02 UTC [2018/12/28 23:20:02 ET]
Table 'Hydra' 6-max Seat #1 is the button
Seat 1: SantiagoWeight ($32.83 in chips) 
Seat 2: mariopork ($39.47 in chips) 
Seat 3: GrandmasterY ($28.75 in chips) 
Seat 4: papico3 ($25 in chips) 
Seat 5: the_ablist7 ($19.96 in chips) 
Seat 6: mililser ($21.69 in chips) 
mariopork: posts small blind $0.10
GrandmasterY: posts big blind $0.25
*** HOLE CARDS ***
Dealt to SantiagoWeight [Qc 8h]
papico3: folds 
the_ablist7: folds 
mililser: folds 
SantiagoWeight: raises $0.30 to $0.55
mariopork: folds 
GrandmasterY: folds 
Uncalled bet ($0.30) returned to SantiagoWeight
SantiagoWeight collected $0.60 from pot
SantiagoWeight: doesn't show hand 
*** SUMMARY ***
Total pot $0.60 | Rake $0 
Seat 1: SantiagoWeight (button) collected ($0.60)
Seat 2: mariopork (small blind) folded before Flop
Seat 3: GrandmasterY (big blind) folded before Flop
Seat 4: papico3 folded before Flop (didn't bet)
Seat 5: the_ablist7 folded before Flop (didn't bet)
Seat 6: mililser folded before Flop (didn't bet)



PokerStars Zoom Hand #195024161841:  Hold'em No Limit ($0.10/$0.25) - 2018/12/29 4:20:17 UTC [2018/12/28 23:20:17 ET]
Table 'Hydra' 6-max Seat #1 is the button
Seat 1: BIGPAIN14 ($31.35 in chips) 
Seat 2: Sco0oter ($24.44 in chips) 
Seat 3: dk dreadlook ($25 in chips) 
Seat 4: qing328 ($25 in chips) 
Seat 5: Fobos113 ($13.84 in chips) 
Seat 6: SantiagoWeight ($33.18 in chips) 
Sco0oter: posts small blind $0.10
dk dreadlook: posts big blind $0.25
*** HOLE CARDS ***
Dealt to SantiagoWeight [8c 3h]
qing328: folds 
Fobos113: folds 
SantiagoWeight: folds 
BIGPAIN14: folds 
Sco0oter: folds 
Uncalled bet ($0.15) returned to dk dreadlook
dk dreadlook collected $0.20 from pot
dk dreadlook: doesn't show hand 
*** SUMMARY ***
Total pot $0.20 | Rake $0 
Seat 1: BIGPAIN14 (button) folded before Flop (didn't bet)
Seat 2: Sco0oter (small blind) folded before Flop
Seat 3: dk dreadlook (big blind) collected ($0.20)
Seat 4: qing328 folded before Flop (didn't bet)
Seat 5: Fobos113 folded before Flop (didn't bet)
Seat 6: SantiagoWeight folded before Flop (didn't bet)



PokerStars Zoom Hand #195024163288:  Hold'em No Limit ($0.10/$0.25) - 2018/12/29 4:20:22 UTC [2018/12/28 23:20:22 ET]
Table 'Hydra' 6-max Seat #1 is the button
Seat 1: Buntar017 ($15.49 in chips) 
Seat 2: zdenekstavic ($37.96 in chips) 
Seat 3: dan_iasi ($70.37 in chips) 
Seat 4: leoval1010 ($12.25 in chips) 
Seat 5: SantiagoWeight ($33.18 in chips) 
Seat 6: BIGPAIN14 ($31.35 in chips) 
zdenekstavic: posts small blind $0.10
dan_iasi: posts big blind $0.25
*** HOLE CARDS ***
Dealt to SantiagoWeight [Qh 6s]
leoval1010: folds 
SantiagoWeight: folds 
BIGPAIN14: raises $0.50 to $0.75
Buntar017: folds 
zdenekstavic: calls $0.65
dan_iasi: folds 
*** FLOP *** [6h 7s Kc]
zdenekstavic: checks 
BIGPAIN14: checks 
*** TURN *** [6h 7s Kc] [Jc]
zdenekstavic: bets $0.84
BIGPAIN14: calls $0.84
*** RIVER *** [6h 7s Kc Jc] [5h]
zdenekstavic: checks 
BIGPAIN14: checks 
*** SHOW DOWN ***
zdenekstavic: shows [Qc Qd] (a pair of Queens)
BIGPAIN14: mucks hand 
zdenekstavic collected $3.28 from pot
*** SUMMARY ***
Total pot $3.43 | Rake $0.15 
Board [6h 7s Kc Jc 5h]
Seat 1: Buntar017 (button) folded before Flop (didn't bet)
Seat 2: zdenekstavic (small blind) showed [Qc Qd] and won ($3.28) with a pair of Queens
Seat 3: dan_iasi (big blind) folded before Flop
Seat 4: leoval1010 folded before Flop (didn't bet)
Seat 5: SantiagoWeight folded before Flop (didn't bet)
Seat 6: BIGPAIN14 mucked [Tc As]



PokerStars Zoom Hand #195024164145:  Hold'em No Limit ($0.10/$0.25) - 2018/12/29 4:20:25 UTC [2018/12/28 23:20:25 ET]
Table 'Hydra' 6-max Seat #1 is the button
Seat 1: Gongyong ($28.65 in chips) 
Seat 2: jfgodtheg ($21.79 in chips) 
Seat 3: tariko1980 ($36.71 in chips) 
Seat 4: kiteboard26 ($21.97 in chips) 
Seat 5: SantiagoWeight ($33.18 in chips) 
Seat 6: onhoang87 ($34.81 in chips) 
jfgodtheg: posts small blind $0.10
tariko1980: posts big blind $0.25
*** HOLE CARDS ***
Dealt to SantiagoWeight [Td Qh]
kiteboard26: folds 
SantiagoWeight: folds 
onhoang87: folds 
Gongyong: folds 
jfgodtheg: raises $0.50 to $0.75
tariko1980: calls $0.50
*** FLOP *** [7s Ac Kc]
jfgodtheg: checks 
tariko1980: checks 
*** TURN *** [7s Ac Kc] [Qd]
jfgodtheg: checks 
tariko1980: checks 
*** RIVER *** [7s Ac Kc Qd] [8s]
jfgodtheg: bets $1.50
tariko1980: calls $1.50
*** SHOW DOWN ***
jfgodtheg: shows [Kd 8d] (two pair, Kings and Eights)
tariko1980: mucks hand 
jfgodtheg collected $4.30 from pot
*** SUMMARY ***
Total pot $4.50 | Rake $0.20 
Board [7s Ac Kc Qd 8s]
Seat 1: Gongyong (button) folded before Flop (didn't bet)
Seat 2: jfgodtheg (small blind) showed [Kd 8d] and won ($4.30) with two pair, Kings and Eights
Seat 3: tariko1980 (big blind) mucked [Tc 8h]
Seat 4: kiteboard26 folded before Flop (didn't bet)
Seat 5: SantiagoWeight folded before Flop (didn't bet)
Seat 6: onhoang87 folded before Flop (didn't bet)



PokerStars Zoom Hand #195024165286:  Hold'em No Limit ($0.10/$0.25) - 2018/12/29 4:20:29 UTC [2018/12/28 23:20:29 ET]
Table 'Hydra' 6-max Seat #1 is the button
Seat 1: Mixxxxer599 ($23.34 in chips) 
Seat 2: TDAK1509 ($40.09 in chips) 
Seat 3: skePokerske ($23.05 in chips) 
Seat 4: SantiagoWeight ($33.18 in chips) 
Seat 5: onhoang87 ($34.81 in chips) 
Seat 6: Lehared ($39.56 in chips) 
TDAK1509: posts small blind $0.10
skePokerske: posts big blind $0.25
*** HOLE CARDS ***
Dealt to SantiagoWeight [4h 7c]
SantiagoWeight: folds 
onhoang87: folds 
Lehared: folds 
Mixxxxer599: raises $0.37 to $0.62
TDAK1509: folds 
skePokerske: calls $0.37
*** FLOP *** [2d Js Ks]
skePokerske: checks 
Mixxxxer599: bets $0.76
skePokerske has timed out
skePokerske: folds 
Uncalled bet ($0.76) returned to Mixxxxer599
Mixxxxer599 collected $1.28 from pot
Mixxxxer599: doesn't show hand 
skePokerske is disconnected 
*** SUMMARY ***
Total pot $1.34 | Rake $0.06 
Board [2d Js Ks]
Seat 1: Mixxxxer599 (button) collected ($1.28)
Seat 2: TDAK1509 (small blind) folded before Flop
Seat 3: skePokerske (big blind) folded on the Flop
Seat 4: SantiagoWeight folded before Flop (didn't bet)
Seat 5: onhoang87 folded before Flop (didn't bet)
Seat 6: Lehared folded before Flop (didn't bet)



PokerStars Zoom Hand #195024166381:  Hold'em No Limit ($0.10/$0.25) - 2018/12/29 4:20:33 UTC [2018/12/28 23:20:33 ET]
Table 'Hydra' 6-max Seat #1 is the button
Seat 1: xonegab ($26.78 in chips) 
Seat 2: ttshead ($55.63 in chips) 
Seat 3: SantiagoWeight ($33.18 in chips) 
Seat 4: tariko1980 ($12.14 in chips) 
Seat 5: GrandmasterY ($28.40 in chips) 
Seat 6: anlu0803 ($23.23 in chips) 
ttshead: posts small blind $0.10
SantiagoWeight: posts big blind $0.25
*** HOLE CARDS ***
Dealt to SantiagoWeight [3s 5d]
tariko1980: calls $0.25
GrandmasterY: folds 
anlu0803: folds 
xonegab: folds 
ttshead: folds 
SantiagoWeight: checks 
*** FLOP *** [6d 3c 2c]
SantiagoWeight: checks 
tariko1980: checks 
*** TURN *** [6d 3c 2c] [9d]
SantiagoWeight: bets $0.38
tariko1980: calls $0.38
*** RIVER *** [6d 3c 2c 9d] [Td]
SantiagoWeight: checks 
tariko1980: bets $1.25
SantiagoWeight: folds 
Uncalled bet ($1.25) returned to tariko1980
tariko1980 collected $1.30 from pot
*** SUMMARY ***
Total pot $1.36 | Rake $0.06 
Board [6d 3c 2c 9d Td]
Seat 1: xonegab (button) folded before Flop (didn't bet)
Seat 2: ttshead (small blind) folded before Flop
Seat 3: SantiagoWeight (big blind) folded on the River
Seat 4: tariko1980 collected ($1.30)
Seat 5: GrandmasterY folded before Flop (didn't bet)
Seat 6: anlu0803 folded before Flop (didn't bet)



PokerStars Zoom Hand #195024177827:  Hold'em No Limit ($0.10/$0.25) - 2018/12/29 4:21:13 UTC [2018/12/28 23:21:13 ET]
Table 'Hydra' 6-max Seat #1 is the button
Seat 1: Timon6300 ($19.75 in chips) 
Seat 2: SantiagoWeight ($32.55 in chips) 
Seat 3: Aco80 ($25 in chips) 
Seat 4: Gonzalit0o ($29.18 in chips) 
Seat 5: Elapostador33 ($28.79 in chips) 
Seat 6: ritchy99 ($23.23 in chips) 
SantiagoWeight: posts small blind $0.10
Aco80: posts big blind $0.25
*** HOLE CARDS ***
Dealt to SantiagoWeight [3h 8s]
Gonzalit0o: folds 
Elapostador33: folds 
ritchy99: folds 
Timon6300: raises $0.41 to $0.66
SantiagoWeight: folds 
Aco80: folds 
Uncalled bet ($0.41) returned to Timon6300
Timon6300 collected $0.60 from pot
Timon6300: doesn't show hand 
*** SUMMARY ***
Total pot $0.60 | Rake $0 
Seat 1: Timon6300 (button) collected ($0.60)
Seat 2: SantiagoWeight (small blind) folded before Flop
Seat 3: Aco80 (big blind) folded before Flop
Seat 4: Gonzalit0o folded before Flop (didn't bet)
Seat 5: Elapostador33 folded before Flop (didn't bet)
Seat 6: ritchy99 folded before Flop (didn't bet)



PokerStars Zoom Hand #195024178994:  Hold'em No Limit ($0.10/$0.25) - 2018/12/29 4:21:17 UTC [2018/12/28 23:21:17 ET]
Table 'Hydra' 6-max Seat #1 is the button
Seat 1: SantiagoWeight ($32.45 in chips) 
Seat 2: DUDA3553 ($20.56 in chips) 
Seat 3: ritchy99 ($23.23 in chips) 
Seat 4: tariko1980 ($34.36 in chips) 
Seat 5: reetskeet ($56.15 in chips) 
Seat 6: aa1421b ($43.94 in chips) 
DUDA3553: posts small blind $0.10
ritchy99: posts big blind $0.25
*** HOLE CARDS ***
Dealt to SantiagoWeight [5c Kh]
tariko1980: folds 
reetskeet: folds 
aa1421b: raises $0.50 to $0.75
SantiagoWeight: folds 
DUDA3553: folds 
ritchy99: calls $0.50
*** FLOP *** [Jh 4c 8c]
ritchy99: checks 
aa1421b: checks 
*** TURN *** [Jh 4c 8c] [3h]
ritchy99: bets $1.50
aa1421b: folds 
Uncalled bet ($1.50) returned to ritchy99
ritchy99 collected $1.53 from pot
ritchy99: doesn't show hand 
*** SUMMARY ***
Total pot $1.60 | Rake $0.07 
Board [Jh 4c 8c 3h]
Seat 1: SantiagoWeight (button) folded before Flop (didn't bet)
Seat 2: DUDA3553 (small blind) folded before Flop
Seat 3: ritchy99 (big blind) collected ($1.53)
Seat 4: tariko1980 folded before Flop (didn't bet)
Seat 5: reetskeet folded before Flop (didn't bet)
Seat 6: aa1421b folded on the Turn



PokerStars Zoom Hand #195024190605:  Hold'em No Limit ($0.10/$0.25) - 2018/12/29 4:21:57 UTC [2018/12/28 23:21:57 ET]
Table 'Hydra' 6-max Seat #1 is the button
Seat 1: Renner32 ($31.52 in chips) 
Seat 2: Bonen18 ($25 in chips) 
Seat 3: sigaro010 ($38.66 in chips) 
Seat 4: SantiagoWeight ($32.45 in chips) 
Seat 5: Becks Baker ($25.93 in chips) 
Seat 6: IMMPORT@L ($12.50 in chips) 
Bonen18: posts small blind $0.10
sigaro010: posts big blind $0.25
*** HOLE CARDS ***
Dealt to SantiagoWeight [Td Th]
SantiagoWeight: raises $0.42 to $0.67
Becks Baker: folds 
IMMPORT@L: calls $0.67
Renner32: folds 
Bonen18: folds 
sigaro010: folds 
*** FLOP *** [Kc 5s 2h]
SantiagoWeight: bets $0.40
IMMPORT@L: folds 
Uncalled bet ($0.40) returned to SantiagoWeight
SantiagoWeight collected $1.61 from pot
SantiagoWeight: doesn't show hand 
*** SUMMARY ***
Total pot $1.69 | Rake $0.08 
Board [Kc 5s 2h]
Seat 1: Renner32 (button) folded before Flop (didn't bet)
Seat 2: Bonen18 (small blind) folded before Flop
Seat 3: sigaro010 (big blind) folded before Flop
Seat 4: SantiagoWeight collected ($1.61)
Seat 5: Becks Baker folded before Flop (didn't bet)
Seat 6: IMMPORT@L folded on the Flop



PokerStars Zoom Hand #195024186520:  Hold'em No Limit ($0.10/$0.25) - 2018/12/29 4:21:43 UTC [2018/12/28 23:21:43 ET]
Table 'Hydra' 6-max Seat #1 is the button
Seat 1: ritchy99 ($24.01 in chips) 
Seat 2: hamen1990 ($49 in chips) 
Seat 3: Chellabro ($13.84 in chips) 
Seat 4: Party4Arthy ($34.74 in chips) 
Seat 5: GrandmasterY ($43.33 in chips) 
Seat 6: SantiagoWeight ($32.45 in chips) 
hamen1990: posts small blind $0.10
Chellabro: posts big blind $0.25
*** HOLE CARDS ***
Dealt to SantiagoWeight [2s 6s]
Party4Arthy: folds 
GrandmasterY: raises $0.50 to $0.75
SantiagoWeight: folds 
ritchy99: calls $0.75
hamen1990: folds 
Chellabro: calls $0.50
*** FLOP *** [Kh Jh 3h]
Chellabro: checks 
GrandmasterY: checks 
ritchy99: checks 
*** TURN *** [Kh Jh 3h] [5c]
Chellabro: checks 
GrandmasterY: bets $0.90
ritchy99: folds 
Chellabro: folds 
Uncalled bet ($0.90) returned to GrandmasterY
GrandmasterY collected $2.24 from pot
GrandmasterY: doesn't show hand 
*** SUMMARY ***
Total pot $2.35 | Rake $0.11 
Board [Kh Jh 3h 5c]
Seat 1: ritchy99 (button) folded on the Turn
Seat 2: hamen1990 (small blind) folded before Flop
Seat 3: Chellabro (big blind) folded on the Turn
Seat 4: Party4Arthy folded before Flop (didn't bet)
Seat 5: GrandmasterY collected ($2.24)
Seat 6: SantiagoWeight folded before Flop (didn't bet)



PokerStars Zoom Hand #195024183016:  Hold'em No Limit ($0.10/$0.25) - 2018/12/29 4:21:31 UTC [2018/12/28 23:21:31 ET]
Table 'Hydra' 6-max Seat #1 is the button
Seat 1: Viiiru ($26.85 in chips) 
Seat 2: ivann14 ($69.03 in chips) 
Seat 3: Aco80 ($28.35 in chips) 
Seat 4: SantiagoWeight ($32.45 in chips) 
Seat 5: Bonen18 ($35.08 in chips) 
Seat 6: Renner32 ($31.42 in chips) 
ivann14: posts small blind $0.10
Aco80: posts big blind $0.25
*** HOLE CARDS ***
Dealt to SantiagoWeight [6d 5h]
SantiagoWeight: folds 
Bonen18: folds 
Renner32: folds 
Viiiru: raises $0.37 to $0.62
ivann14: calls $0.52
Aco80: folds 
*** FLOP *** [4h Jh Ad]
ivann14: checks 
Viiiru: bets $0.47
ivann14: calls $0.47
*** TURN *** [4h Jh Ad] [Ah]
ivann14: bets $1.67
Viiiru: calls $1.67
*** RIVER *** [4h Jh Ad Ah] [8h]
ivann14: checks 
Viiiru: checks 
*** SHOW DOWN ***
ivann14: shows [Qh Kd] (a flush, Ace high)
Viiiru: mucks hand 
ivann14 collected $5.51 from pot
*** SUMMARY ***
Total pot $5.77 | Rake $0.26 
Board [4h Jh Ad Ah 8h]
Seat 1: Viiiru (button) mucked [Jd Qd]
Seat 2: ivann14 (small blind) showed [Qh Kd] and won ($5.51) with a flush, Ace high
Seat 3: Aco80 (big blind) folded before Flop
Seat 4: SantiagoWeight folded before Flop (didn't bet)
Seat 5: Bonen18 folded before Flop (didn't bet)
Seat 6: Renner32 folded before Flop (didn't bet)



PokerStars Zoom Hand #195024201015:  Hold'em No Limit ($0.10/$0.25) - 2018/12/29 4:22:33 UTC [2018/12/28 23:22:33 ET]
Table 'Hydra' 6-max Seat #1 is the button
Seat 1: SantiagoWeight ($33.39 in chips) 
Seat 2: ryanking99 ($39.81 in chips) 
Seat 3: Nutselas ($26.82 in chips) 
Seat 4: kaizin727 ($22.46 in chips) 
Seat 5: qing328 ($21.94 in chips) 
Seat 6: Gongyong ($27.48 in chips) 
ryanking99: posts small blind $0.10
Nutselas: posts big blind $0.25
*** HOLE CARDS ***
Dealt to SantiagoWeight [Kd 3s]
kaizin727: raises $0.50 to $0.75
qing328: folds 
Gongyong: raises $1.85 to $2.60
SantiagoWeight: folds 
ryanking99: folds 
Nutselas: folds 
kaizin727: folds 
Uncalled bet ($1.85) returned to Gongyong
Gongyong collected $1.85 from pot
Gongyong: doesn't show hand 
*** SUMMARY ***
Total pot $1.85 | Rake $0 
Seat 1: SantiagoWeight (button) folded before Flop (didn't bet)
Seat 2: ryanking99 (small blind) folded before Flop
Seat 3: Nutselas (big blind) folded before Flop
Seat 4: kaizin727 folded before Flop
Seat 5: qing328 folded before Flop (didn't bet)
Seat 6: Gongyong collected ($1.85)



PokerStars Zoom Hand #195024205346:  Hold'em No Limit ($0.10/$0.25) - 2018/12/29 4:22:48 UTC [2018/12/28 23:22:48 ET]
Table 'Hydra' 6-max Seat #1 is the button
Seat 1: river plate9 ($44.01 in chips) 
Seat 2: Suit3dGapp3r ($25 in chips) 
Seat 3: SantiagoWeight ($33.39 in chips) 
Seat 4: RESTRICTED.CR17 ($34.64 in chips) 
Seat 5: _BluDeeN_ ($25 in chips) 
Seat 6: abbi555 ($44.83 in chips) 
Suit3dGapp3r: posts small blind $0.10
SantiagoWeight: posts big blind $0.25
*** HOLE CARDS ***
Dealt to SantiagoWeight [3s 7s]
RESTRICTED.CR17: raises $0.75 to $1
_BluDeeN_: folds 
abbi555: folds 
river plate9: folds 
Suit3dGapp3r: folds 
SantiagoWeight: folds 
Uncalled bet ($0.75) returned to RESTRICTED.CR17
RESTRICTED.CR17 collected $0.60 from pot
*** SUMMARY ***
Total pot $0.60 | Rake $0 
Seat 1: river plate9 (button) folded before Flop (didn't bet)
Seat 2: Suit3dGapp3r (small blind) folded before Flop
Seat 3: SantiagoWeight (big blind) folded before Flop
Seat 4: RESTRICTED.CR17 collected ($0.60)
Seat 5: _BluDeeN_ folded before Flop (didn't bet)
Seat 6: abbi555 folded before Flop (didn't bet)



PokerStars Zoom Hand #195024214918:  Hold'em No Limit ($0.10/$0.25) - 2018/12/29 4:23:21 UTC [2018/12/28 23:23:21 ET]
Table 'Hydra' 6-max Seat #1 is the button
Seat 1: Viiiru ($25 in chips) 
Seat 2: SantiagoWeight ($33.14 in chips) 
Seat 3: mariopork ($25.84 in chips) 
Seat 4: dan_iasi ($67.90 in chips) 
Seat 5: pirosiky ($26.32 in chips) 
Seat 6: BRSOB79 ($31.52 in chips) 
SantiagoWeight: posts small blind $0.10
mariopork: posts big blind $0.25
*** HOLE CARDS ***
Dealt to SantiagoWeight [3c 2h]
dan_iasi: folds 
pirosiky: folds 
BRSOB79: folds 
Viiiru: folds 
SantiagoWeight: folds 
Uncalled bet ($0.15) returned to mariopork
mariopork collected $0.20 from pot
mariopork: doesn't show hand 
*** SUMMARY ***
Total pot $0.20 | Rake $0 
Seat 1: Viiiru (button) folded before Flop (didn't bet)
Seat 2: SantiagoWeight (small blind) folded before Flop
Seat 3: mariopork (big blind) collected ($0.20)
Seat 4: dan_iasi folded before Flop (didn't bet)
Seat 5: pirosiky folded before Flop (didn't bet)
Seat 6: BRSOB79 folded before Flop (didn't bet)



PokerStars Zoom Hand #195024222053:  Hold'em No Limit ($0.10/$0.25) - 2018/12/29 4:23:46 UTC [2018/12/28 23:23:46 ET]
Table 'Hydra' 6-max Seat #1 is the button
Seat 1: LastNoma ($25.66 in chips) 
Seat 2: sigaro010 ($49.08 in chips) 
Seat 3: BIGPAIN14 ($30.39 in chips) 
Seat 4: zdenekstavic ($33.53 in chips) 
Seat 5: SantiagoWeight ($33.04 in chips) 
Seat 6: cankum ($25 in chips) 
sigaro010: posts small blind $0.10
BIGPAIN14: posts big blind $0.25
*** HOLE CARDS ***
Dealt to SantiagoWeight [5d 2c]
zdenekstavic: folds 
SantiagoWeight: folds 
cankum: folds 
LastNoma: folds 
sigaro010: folds 
Uncalled bet ($0.15) returned to BIGPAIN14
BIGPAIN14 collected $0.20 from pot
BIGPAIN14: doesn't show hand 
*** SUMMARY ***
Total pot $0.20 | Rake $0 
Seat 1: LastNoma (button) folded before Flop (didn't bet)
Seat 2: sigaro010 (small blind) folded before Flop
Seat 3: BIGPAIN14 (big blind) collected ($0.20)
Seat 4: zdenekstavic folded before Flop (didn't bet)
Seat 5: SantiagoWeight folded before Flop (didn't bet)
Seat 6: cankum folded before Flop (didn't bet)



PokerStars Zoom Hand #195024223450:  Hold'em No Limit ($0.10/$0.25) - 2018/12/29 4:23:51 UTC [2018/12/28 23:23:51 ET]
Table 'Hydra' 6-max Seat #1 is the button
Seat 1: xonegab ($40.87 in chips) 
Seat 2: SantiagoWeight ($33.04 in chips) 
Seat 3: inujara4 ($25.38 in chips) 
Seat 4: MoMoney2612 ($25.70 in chips) 
Seat 5: Chrimmpam ($23.43 in chips) 
Seat 6: cankum ($25 in chips) 
SantiagoWeight: posts small blind $0.10
inujara4: posts big blind $0.25
*** HOLE CARDS ***
Dealt to SantiagoWeight [8c 2h]
MoMoney2612: folds 
Chrimmpam: folds 
cankum: folds 
xonegab: calls $0.25
SantiagoWeight: folds 
inujara4: checks 
*** FLOP *** [Ac 6h 8s]
inujara4: checks 
xonegab: bets $0.25
inujara4: folds 
Uncalled bet ($0.25) returned to xonegab
xonegab collected $0.57 from pot
xonegab: doesn't show hand 
*** SUMMARY ***
Total pot $0.60 | Rake $0.03 
Board [Ac 6h 8s]
Seat 1: xonegab (button) collected ($0.57)
Seat 2: SantiagoWeight (small blind) folded before Flop
Seat 3: inujara4 (big blind) folded on the Flop
Seat 4: MoMoney2612 folded before Flop (didn't bet)
Seat 5: Chrimmpam folded before Flop (didn't bet)
Seat 6: cankum folded before Flop (didn't bet)



PokerStars Zoom Hand #195024226337:  Hold'em No Limit ($0.10/$0.25) - 2018/12/29 4:24:01 UTC [2018/12/28 23:24:01 ET]
Table 'Hydra' 6-max Seat #1 is the button
Seat 1: SantiagoWeight ($32.94 in chips) 
Seat 2: ivann14 ($25 in chips) 
Seat 3: Unclesmoll ($15.03 in chips) 
Seat 4: Bonen18 ($27.53 in chips) 
Seat 5: !P0K3RM3T4L! ($26.49 in chips) 
Seat 6: graysonai ($32.50 in chips) 
ivann14: posts small blind $0.10
Unclesmoll: posts big blind $0.25
*** HOLE CARDS ***
Dealt to SantiagoWeight [7h Qd]
Bonen18: folds 
!P0K3RM3T4L!: folds 
graysonai: folds 
SantiagoWeight: raises $0.30 to $0.55
ivann14: folds 
Unclesmoll: folds 
Uncalled bet ($0.30) returned to SantiagoWeight
SantiagoWeight collected $0.60 from pot
SantiagoWeight: doesn't show hand 
*** SUMMARY ***
Total pot $0.60 | Rake $0 
Seat 1: SantiagoWeight (button) collected ($0.60)
Seat 2: ivann14 (small blind) folded before Flop
Seat 3: Unclesmoll (big blind) folded before Flop
Seat 4: Bonen18 folded before Flop (didn't bet)
Seat 5: !P0K3RM3T4L! folded before Flop (didn't bet)
Seat 6: graysonai folded before Flop (didn't bet)



PokerStars Zoom Hand #195024218092:  Hold'em No Limit ($0.10/$0.25) - 2018/12/29 4:23:32 UTC [2018/12/28 23:23:32 ET]
Table 'Hydra' 6-max Seat #1 is the button
Seat 1: papico3 ($27.48 in chips) 
Seat 2: DUDA3553 ($20.99 in chips) 
Seat 3: maskay88 ($13.41 in chips) 
Seat 4: TQNYMQNTANA ($26.94 in chips) 
Seat 5: Aco80 ($27.55 in chips) 
Seat 6: SantiagoWeight ($33.04 in chips) 
DUDA3553: posts small blind $0.10
maskay88: posts big blind $0.25
*** HOLE CARDS ***
Dealt to SantiagoWeight [5c Qc]
TQNYMQNTANA: folds 
Aco80: folds 
SantiagoWeight: folds 
papico3: raises $0.37 to $0.62
DUDA3553: folds 
maskay88: raises $1.34 to $1.96
papico3: calls $1.34
*** FLOP *** [6h Qh 4c]
maskay88: bets $2
papico3: calls $2
*** TURN *** [6h Qh 4c] [Kc]
maskay88: bets $3.75
papico3: calls $3.75
*** RIVER *** [6h Qh 4c Kc] [9c]
maskay88: bets $5.70 and is all-in
papico3: calls $5.70
*** SHOW DOWN ***
maskay88: shows [9s 4d] (two pair, Nines and Fours)
papico3: shows [Jh Kh] (a pair of Kings)
maskay88 collected $25.71 from pot
*** SUMMARY ***
Total pot $26.92 | Rake $1.21 
Board [6h Qh 4c Kc 9c]
Seat 1: papico3 (button) showed [Jh Kh] and lost with a pair of Kings
Seat 2: DUDA3553 (small blind) folded before Flop
Seat 3: maskay88 (big blind) showed [9s 4d] and won ($25.71) with two pair, Nines and Fours
Seat 4: TQNYMQNTANA folded before Flop (didn't bet)
Seat 5: Aco80 folded before Flop (didn't bet)
Seat 6: SantiagoWeight folded before Flop (didn't bet)



PokerStars Zoom Hand #195024232068:  Hold'em No Limit ($0.10/$0.25) - 2018/12/29 4:24:21 UTC [2018/12/28 23:24:21 ET]
Table 'Hydra' 6-max Seat #1 is the button
Seat 1: Nutselas ($35.38 in chips) 
Seat 2: the_ablist7 ($9.75 in chips) 
Seat 3: Guard poker ($25 in chips) 
Seat 4: SantiagoWeight ($33.29 in chips) 
Seat 5: ivann14 ($42.90 in chips) 
Seat 6: inujara4 ($29.41 in chips) 
the_ablist7: posts small blind $0.10
Guard poker: posts big blind $0.25
*** HOLE CARDS ***
Dealt to SantiagoWeight [8c Qc]
SantiagoWeight: folds 
ivann14: folds 
inujara4: raises $0.31 to $0.56
Nutselas: folds 
the_ablist7: folds 
Guard poker: folds 
Uncalled bet ($0.31) returned to inujara4
inujara4 collected $0.60 from pot
inujara4: doesn't show hand 
*** SUMMARY ***
Total pot $0.60 | Rake $0 
Seat 1: Nutselas (button) folded before Flop (didn't bet)
Seat 2: the_ablist7 (small blind) folded before Flop
Seat 3: Guard poker (big blind) folded before Flop
Seat 4: SantiagoWeight folded before Flop (didn't bet)
Seat 5: ivann14 folded before Flop (didn't bet)
Seat 6: inujara4 collected ($0.60)



PokerStars Zoom Hand #195024233987:  Hold'em No Limit ($0.10/$0.25) - 2018/12/29 4:24:28 UTC [2018/12/28 23:24:28 ET]
Table 'Hydra' 6-max Seat #1 is the button
Seat 1: cankum ($25.25 in chips) 
Seat 2: mariopork ($106.89 in chips) 
Seat 3: SantiagoWeight ($33.29 in chips) 
Seat 4: Mixxxxer599 ($25.63 in chips) 
Seat 5: cheolbeom ($28.55 in chips) 
Seat 6: mililser ($27.89 in chips) 
mariopork: posts small blind $0.10
SantiagoWeight: posts big blind $0.25
*** HOLE CARDS ***
Dealt to SantiagoWeight [7s Ts]
Mixxxxer599: raises $0.37 to $0.62
cheolbeom: folds 
mililser: folds 
cankum: raises $1.25 to $1.87
mariopork: folds 
SantiagoWeight: folds 
Mixxxxer599: folds 
Uncalled bet ($1.25) returned to cankum
cankum collected $1.59 from pot
cankum: doesn't show hand 
*** SUMMARY ***
Total pot $1.59 | Rake $0 
Seat 1: cankum (button) collected ($1.59)
Seat 2: mariopork (small blind) folded before Flop
Seat 3: SantiagoWeight (big blind) folded before Flop
Seat 4: Mixxxxer599 folded before Flop
Seat 5: cheolbeom folded before Flop (didn't bet)
Seat 6: mililser folded before Flop (didn't bet)



PokerStars Zoom Hand #195024240238:  Hold'em No Limit ($0.10/$0.25) - 2018/12/29 4:24:50 UTC [2018/12/28 23:24:50 ET]
Table 'Hydra' 6-max Seat #1 is the button
Seat 1: dan_iasi ($46.87 in chips) 
Seat 2: Dbakunwaves ($57.55 in chips) 
Seat 3: karbool ($25 in chips) 
Seat 4: xXBossHossXx ($57.09 in chips) 
Seat 5: SantiagoWeight ($33.04 in chips) 
Seat 6: reggiedogg31 ($122.01 in chips) 
Dbakunwaves: posts small blind $0.10
karbool: posts big blind $0.25
*** HOLE CARDS ***
Dealt to SantiagoWeight [6h 5c]
xXBossHossXx: folds 
SantiagoWeight: folds 
reggiedogg31: folds 
dan_iasi: folds 
Dbakunwaves: folds 
Uncalled bet ($0.15) returned to karbool
karbool collected $0.20 from pot
karbool: doesn't show hand 
*** SUMMARY ***
Total pot $0.20 | Rake $0 
Seat 1: dan_iasi (button) folded before Flop (didn't bet)
Seat 2: Dbakunwaves (small blind) folded before Flop
Seat 3: karbool (big blind) collected ($0.20)
Seat 4: xXBossHossXx folded before Flop (didn't bet)
Seat 5: SantiagoWeight folded before Flop (didn't bet)
Seat 6: reggiedogg31 folded before Flop (didn't bet)



PokerStars Zoom Hand #195024242591:  Hold'em No Limit ($0.10/$0.25) - 2018/12/29 4:24:58 UTC [2018/12/28 23:24:58 ET]
Table 'Hydra' 6-max Seat #1 is the button
Seat 1: Viiiru ($25 in chips) 
Seat 2: epazeli ($23.72 in chips) 
Seat 3: SantiagoWeight ($33.04 in chips) 
Seat 4: anlu0803 ($30.01 in chips) 
Seat 5: janluise ($26.84 in chips) 
Seat 6: louiskitu ($25.51 in chips) 
epazeli: posts small blind $0.10
SantiagoWeight: posts big blind $0.25
*** HOLE CARDS ***
Dealt to SantiagoWeight [Tc 2c]
anlu0803: folds 
janluise: folds 
louiskitu: folds 
Viiiru: folds 
epazeli: folds 
Uncalled bet ($0.15) returned to SantiagoWeight
SantiagoWeight collected $0.20 from pot
SantiagoWeight: doesn't show hand 
*** SUMMARY ***
Total pot $0.20 | Rake $0 
Seat 1: Viiiru (button) folded before Flop (didn't bet)
Seat 2: epazeli (small blind) folded before Flop
Seat 3: SantiagoWeight (big blind) collected ($0.20)
Seat 4: anlu0803 folded before Flop (didn't bet)
Seat 5: janluise folded before Flop (didn't bet)
Seat 6: louiskitu folded before Flop (didn't bet)



PokerStars Zoom Hand #195024238833:  Hold'em No Limit ($0.10/$0.25) - 2018/12/29 4:24:45 UTC [2018/12/28 23:24:45 ET]
Table 'Hydra' 6-max Seat #1 is the button
Seat 1: mariopork ($46.01 in chips) 
Seat 2: !P0K3RM3T4L! ($26.24 in chips) 
Seat 3: qing328 ($24.50 in chips) 
Seat 4: Suit3dGapp3r ($25.80 in chips) 
Seat 5: Nutselas ($35.38 in chips) 
Seat 6: SantiagoWeight ($33.04 in chips) 
!P0K3RM3T4L!: posts small blind $0.10
qing328: posts big blind $0.25
*** HOLE CARDS ***
Dealt to SantiagoWeight [5c Qc]
Suit3dGapp3r: raises $0.45 to $0.70
Nutselas: folds 
SantiagoWeight: folds 
mariopork: folds 
!P0K3RM3T4L!: folds 
qing328: calls $0.45
*** FLOP *** [3h 4s 2h]
qing328: checks 
Suit3dGapp3r: bets $0.79
qing328: folds 
Uncalled bet ($0.79) returned to Suit3dGapp3r
Suit3dGapp3r collected $1.43 from pot
Suit3dGapp3r: doesn't show hand 
*** SUMMARY ***
Total pot $1.50 | Rake $0.07 
Board [3h 4s 2h]
Seat 1: mariopork (button) folded before Flop (didn't bet)
Seat 2: !P0K3RM3T4L! (small blind) folded before Flop
Seat 3: qing328 (big blind) folded on the Flop
Seat 4: Suit3dGapp3r collected ($1.43)
Seat 5: Nutselas folded before Flop (didn't bet)
Seat 6: SantiagoWeight folded before Flop (didn't bet)



PokerStars Zoom Hand #195024241117:  Hold'em No Limit ($0.10/$0.25) - 2018/12/29 4:24:53 UTC [2018/12/28 23:24:53 ET]
Table 'Hydra' 6-max Seat #1 is the button
Seat 1: razil_999 ($23.52 in chips) 
Seat 2: denisss1801 ($26.08 in chips) 
Seat 3: ruiken ($24.15 in chips) 
Seat 4: SantiagoWeight ($33.04 in chips) 
Seat 5: mililser ($20.99 in chips) 
Seat 6: Guard poker ($25 in chips) 
denisss1801: posts small blind $0.10
ruiken: posts big blind $0.25
*** HOLE CARDS ***
Dealt to SantiagoWeight [8d 9c]
SantiagoWeight: folds 
mililser: folds 
Guard poker: folds 
razil_999: folds 
denisss1801: calls $0.15
ruiken: checks 
*** FLOP *** [6s 7c 3h]
denisss1801: checks 
ruiken: checks 
*** TURN *** [6s 7c 3h] [9d]
denisss1801: checks 
ruiken: checks 
*** RIVER *** [6s 7c 3h 9d] [Ks]
denisss1801: bets $0.25
ruiken: calls $0.25
*** SHOW DOWN ***
denisss1801: shows [Kd Jc] (a pair of Kings)
ruiken: mucks hand 
denisss1801 collected $0.96 from pot
*** SUMMARY ***
Total pot $1 | Rake $0.04 
Board [6s 7c 3h 9d Ks]
Seat 1: razil_999 (button) folded before Flop (didn't bet)
Seat 2: denisss1801 (small blind) showed [Kd Jc] and won ($0.96) with a pair of Kings
Seat 3: ruiken (big blind) mucked [Qd 3s]
Seat 4: SantiagoWeight folded before Flop (didn't bet)
Seat 5: mililser folded before Flop (didn't bet)
Seat 6: Guard poker folded before Flop (didn't bet)



PokerStars Zoom Hand #195024245754:  Hold'em No Limit ($0.10/$0.25) - 2018/12/29 4:25:09 UTC [2018/12/28 23:25:09 ET]
Table 'Hydra' 6-max Seat #1 is the button
Seat 1: KAllUSTA ($14.26 in chips) 
Seat 2: SantiagoWeight ($33.14 in chips) 
Seat 3: bestitest542 ($10.08 in chips) 
Seat 4: papico3 ($26.01 in chips) 
Seat 5: dan_iasi ($46.87 in chips) 
Seat 6: Higashi2314 ($29.03 in chips) 
SantiagoWeight: posts small blind $0.10
bestitest542: posts big blind $0.25
*** HOLE CARDS ***
Dealt to SantiagoWeight [Jh Qc]
papico3: folds 
dan_iasi: folds 
Higashi2314: folds 
KAllUSTA: raises $0.25 to $0.50
SantiagoWeight: raises $1.30 to $1.80
bestitest542: calls $1.55
KAllUSTA: calls $1.30
*** FLOP *** [2h 3d 8d]
SantiagoWeight: checks 
bestitest542: bets $8.28 and is all-in
KAllUSTA: calls $8.28
SantiagoWeight: folds 
*** TURN *** [2h 3d 8d] [3s]
*** RIVER *** [2h 3d 8d 3s] [9c]
*** SHOW DOWN ***
bestitest542: shows [9h Ad] (two pair, Nines and Threes)
KAllUSTA: shows [8h Ah] (two pair, Eights and Threes)
bestitest542 collected $20.97 from pot
*** SUMMARY ***
Total pot $21.96 | Rake $0.99 
Board [2h 3d 8d 3s 9c]
Seat 1: KAllUSTA (button) showed [8h Ah] and lost with two pair, Eights and Threes
Seat 2: SantiagoWeight (small blind) folded on the Flop
Seat 3: bestitest542 (big blind) showed [9h Ad] and won ($20.97) with two pair, Nines and Threes
Seat 4: papico3 folded before Flop (didn't bet)
Seat 5: dan_iasi folded before Flop (didn't bet)
Seat 6: Higashi2314 folded before Flop (didn't bet)



PokerStars Zoom Hand #195024258514:  Hold'em No Limit ($0.10/$0.25) - 2018/12/29 4:25:54 UTC [2018/12/28 23:25:54 ET]
Table 'Hydra' 6-max Seat #1 is the button
Seat 1: SantiagoWeight ($31.34 in chips) 
Seat 2: tariko1980 ($9.57 in chips) 
Seat 3: Guard poker ($26.66 in chips) 
Seat 4: G ster24 ($14.96 in chips) 
Seat 5: dan_iasi ($46.52 in chips) 
Seat 6: papico3 ($25 in chips) 
tariko1980: posts small blind $0.10
Guard poker: posts big blind $0.25
*** HOLE CARDS ***
Dealt to SantiagoWeight [Th Ks]
G ster24: folds 
dan_iasi: folds 
papico3: raises $0.50 to $0.75
SantiagoWeight: folds 
tariko1980: folds 
Guard poker: folds 
Uncalled bet ($0.50) returned to papico3
papico3 collected $0.60 from pot
papico3: doesn't show hand 
*** SUMMARY ***
Total pot $0.60 | Rake $0 
Seat 1: SantiagoWeight (button) folded before Flop (didn't bet)
Seat 2: tariko1980 (small blind) folded before Flop
Seat 3: Guard poker (big blind) folded before Flop
Seat 4: G ster24 folded before Flop (didn't bet)
Seat 5: dan_iasi folded before Flop (didn't bet)
Seat 6: papico3 collected ($0.60)



PokerStars Zoom Hand #195024262497:  Hold'em No Limit ($0.10/$0.25) - 2018/12/29 4:26:08 UTC [2018/12/28 23:26:08 ET]
Table 'Hydra' 6-max Seat #1 is the button
Seat 1: crashbuum ($27 in chips) 
Seat 2: karbool ($26.81 in chips) 
Seat 3: reggiedogg31 ($122.01 in chips) 
Seat 4: pkr_miracle ($33.78 in chips) 
Seat 5: SantiagoWeight ($31.34 in chips) 
Seat 6: TQNYMQNTANA ($27.08 in chips) 
karbool: posts small blind $0.10
reggiedogg31: posts big blind $0.25
*** HOLE CARDS ***
Dealt to SantiagoWeight [4d 6h]
pkr_miracle: raises $0.75 to $1
SantiagoWeight: folds 
TQNYMQNTANA: folds 
crashbuum: folds 
karbool: folds 
reggiedogg31: folds 
Uncalled bet ($0.75) returned to pkr_miracle
pkr_miracle collected $0.60 from pot
pkr_miracle: doesn't show hand 
*** SUMMARY ***
Total pot $0.60 | Rake $0 
Seat 1: crashbuum (button) folded before Flop (didn't bet)
Seat 2: karbool (small blind) folded before Flop
Seat 3: reggiedogg31 (big blind) folded before Flop
Seat 4: pkr_miracle collected ($0.60)
Seat 5: SantiagoWeight folded before Flop (didn't bet)
Seat 6: TQNYMQNTANA folded before Flop (didn't bet)



PokerStars Zoom Hand #195024263912:  Hold'em No Limit ($0.10/$0.25) - 2018/12/29 4:26:13 UTC [2018/12/28 23:26:13 ET]
Table 'Hydra' 6-max Seat #1 is the button
Seat 1: mariopork ($44.41 in chips) 
Seat 2: SantiagoWeight ($31.34 in chips) 
Seat 3: graysonai ($26.51 in chips) 
Seat 4: Gonzalit0o ($49.78 in chips) 
Seat 5: qing328 ($23.20 in chips) 
Seat 6: Viiiru ($25 in chips) 
SantiagoWeight: posts small blind $0.10
graysonai: posts big blind $0.25
*** HOLE CARDS ***
Dealt to SantiagoWeight [Ah 8c]
Gonzalit0o: folds 
qing328: folds 
Viiiru: folds 
mariopork: folds 
SantiagoWeight: raises $0.50 to $0.75
graysonai: calls $0.50
*** FLOP *** [2s 7c 5s]
SantiagoWeight: bets $0.36
graysonai: calls $0.36
*** TURN *** [2s 7c 5s] [Ac]
SantiagoWeight: bets $1.30
graysonai: folds 
Uncalled bet ($1.30) returned to SantiagoWeight
SantiagoWeight collected $2.12 from pot
SantiagoWeight: doesn't show hand 
*** SUMMARY ***
Total pot $2.22 | Rake $0.10 
Board [2s 7c 5s Ac]
Seat 1: mariopork (button) folded before Flop (didn't bet)
Seat 2: SantiagoWeight (small blind) collected ($2.12)
Seat 3: graysonai (big blind) folded on the Turn
Seat 4: Gonzalit0o folded before Flop (didn't bet)
Seat 5: qing328 folded before Flop (didn't bet)
Seat 6: Viiiru folded before Flop (didn't bet)



PokerStars Zoom Hand #195024283571:  Hold'em No Limit ($0.10/$0.25) - 2018/12/29 4:27:23 UTC [2018/12/28 23:27:23 ET]
Table 'Hydra' 6-max Seat #1 is the button
Seat 1: reggiedogg31 ($120.91 in chips) 
Seat 2: Breedijkie ($55.68 in chips) 
Seat 3: papico3 ($25 in chips) 
Seat 4: cheolbeom ($27.38 in chips) 
Seat 5: karbool ($27.19 in chips) 
Seat 6: SantiagoWeight ($32.35 in chips) 
Breedijkie: posts small blind $0.10
papico3: posts big blind $0.25
*** HOLE CARDS ***
Dealt to SantiagoWeight [3s Th]
cheolbeom: folds 
karbool: folds 
SantiagoWeight: folds 
reggiedogg31: raises $0.25 to $0.50
Breedijkie: folds 
papico3: folds 
Uncalled bet ($0.25) returned to reggiedogg31
reggiedogg31 collected $0.60 from pot
reggiedogg31: doesn't show hand 
*** SUMMARY ***
Total pot $0.60 | Rake $0 
Seat 1: reggiedogg31 (button) collected ($0.60)
Seat 2: Breedijkie (small blind) folded before Flop
Seat 3: papico3 (big blind) folded before Flop
Seat 4: cheolbeom folded before Flop (didn't bet)
Seat 5: karbool folded before Flop (didn't bet)
Seat 6: SantiagoWeight folded before Flop (didn't bet)



PokerStars Zoom Hand #195024301062:  Hold'em No Limit ($0.10/$0.25) - 2018/12/29 4:27:53 UTC [2018/12/28 23:27:53 ET]
Table 'Hydra' 6-max Seat #1 is the button
Seat 1: graysonai ($29.49 in chips) 
Seat 2: ruiken ($25.51 in chips) 
Seat 3: SantiagoWeight ($32.35 in chips) 
Seat 4: naxizzle ($106.68 in chips) 
Seat 5: sigaro010 ($49.83 in chips) 
Seat 6: IMMPORT@L ($12.98 in chips) 
ruiken: posts small blind $0.10
SantiagoWeight: posts big blind $0.25
*** HOLE CARDS ***
Dealt to SantiagoWeight [9d 7s]
naxizzle: folds 
sigaro010: folds 
IMMPORT@L: folds 
graysonai: folds 
ruiken: folds 
Uncalled bet ($0.15) returned to SantiagoWeight
SantiagoWeight collected $0.20 from pot
SantiagoWeight: doesn't show hand 
*** SUMMARY ***
Total pot $0.20 | Rake $0 
Seat 1: graysonai (button) folded before Flop (didn't bet)
Seat 2: ruiken (small blind) folded before Flop
Seat 3: SantiagoWeight (big blind) collected ($0.20)
Seat 4: naxizzle folded before Flop (didn't bet)
Seat 5: sigaro010 folded before Flop (didn't bet)
Seat 6: IMMPORT@L folded before Flop (didn't bet)



PokerStars Zoom Hand #195024286105:  Hold'em No Limit ($0.10/$0.25) - 2018/12/29 4:27:32 UTC [2018/12/28 23:27:32 ET]
Table 'Hydra' 6-max Seat #1 is the button
Seat 1: SantiagoWeight ($32.35 in chips) 
Seat 2: Buntar017 ($19.45 in chips) 
Seat 3: BIGPAIN14 ($22.05 in chips) 
Seat 4: cheolbeom ($41.35 in chips) 
Seat 5: Doomdigidoom ($41.55 in chips) 
Seat 6: Gonzalit0o ($34.35 in chips) 
Buntar017: posts small blind $0.10
BIGPAIN14: posts big blind $0.25
*** HOLE CARDS ***
Dealt to SantiagoWeight [Qs 6s]
cheolbeom: raises $0.50 to $0.75
Doomdigidoom: folds 
Gonzalit0o: folds 
SantiagoWeight: folds 
Buntar017: calls $0.65
BIGPAIN14: calls $0.50
*** FLOP *** [3c 4s 5s]
Buntar017: bets $1
BIGPAIN14: calls $1
cheolbeom: folds 
*** TURN *** [3c 4s 5s] [7d]
Buntar017: bets $2.50
BIGPAIN14: calls $2.50
*** RIVER *** [3c 4s 5s 7d] [2s]
Buntar017: bets $1
BIGPAIN14: calls $1
*** SHOW DOWN ***
Buntar017: shows [9c Ad] (a straight, Ace to Five)
BIGPAIN14: shows [Ah 5d] (a straight, Ace to Five)
Buntar017 collected $5.37 from pot
BIGPAIN14 collected $5.37 from pot
*** SUMMARY ***
Total pot $11.25 | Rake $0.51 
Board [3c 4s 5s 7d 2s]
Seat 1: SantiagoWeight (button) folded before Flop (didn't bet)
Seat 2: Buntar017 (small blind) showed [9c Ad] and won ($5.37) with a straight, Ace to Five
Seat 3: BIGPAIN14 (big blind) showed [Ah 5d] and won ($5.37) with a straight, Ace to Five
Seat 4: cheolbeom folded on the Flop
Seat 5: Doomdigidoom folded before Flop (didn't bet)
Seat 6: Gonzalit0o folded before Flop (didn't bet)



PokerStars Zoom Hand #195024307892:  Hold'em No Limit ($0.10/$0.25) - 2018/12/29 4:28:17 UTC [2018/12/28 23:28:17 ET]
Table 'Hydra' 6-max Seat #1 is the button
Seat 1: mariopork ($44.56 in chips) 
Seat 2: zbuci ($77.70 in chips) 
Seat 3: DUDA3553 ($3.59 in chips) 
Seat 4: SantiagoWeight ($32.45 in chips) 
Seat 5: Fobos113 ($23.30 in chips) 
Seat 6: alex3d1985 ($11.16 in chips) 
zbuci: posts small blind $0.10
DUDA3553: posts big blind $0.25
*** HOLE CARDS ***
Dealt to SantiagoWeight [5c Ks]
SantiagoWeight: folds 
Fobos113: folds 
alex3d1985: folds 
mariopork: folds 
zbuci: folds 
Uncalled bet ($0.15) returned to DUDA3553
DUDA3553 collected $0.20 from pot
DUDA3553: doesn't show hand 
*** SUMMARY ***
Total pot $0.20 | Rake $0 
Seat 1: mariopork (button) folded before Flop (didn't bet)
Seat 2: zbuci (small blind) folded before Flop
Seat 3: DUDA3553 (big blind) collected ($0.20)
Seat 4: SantiagoWeight folded before Flop (didn't bet)
Seat 5: Fobos113 folded before Flop (didn't bet)
Seat 6: alex3d1985 folded before Flop (didn't bet)



PokerStars Zoom Hand #195024303871:  Hold'em No Limit ($0.10/$0.25) - 2018/12/29 4:28:03 UTC [2018/12/28 23:28:03 ET]
Table 'Hydra' 6-max Seat #1 is the button
Seat 1: !P0K3RM3T4L! ($28.08 in chips) 
Seat 2: StrangeChip1 ($34.31 in chips) 
Seat 3: xonegab ($37.25 in chips) 
Seat 4: SantiagoWeight ($32.45 in chips) 
Seat 5: Lehared ($45.60 in chips) 
Seat 6: Chrimmpam ($19.18 in chips) 
StrangeChip1: posts small blind $0.10
xonegab: posts big blind $0.25
*** HOLE CARDS ***
Dealt to SantiagoWeight [4c 6h]
SantiagoWeight: folds 
Lehared: raises $0.37 to $0.62
Chrimmpam: folds 
!P0K3RM3T4L!: folds 
StrangeChip1: folds 
xonegab: calls $0.37
*** FLOP *** [8d Ac Js]
xonegab: checks 
Lehared: checks 
*** TURN *** [8d Ac Js] [9s]
xonegab: bets $0.25
Lehared: folds 
Uncalled bet ($0.25) returned to xonegab
xonegab collected $1.28 from pot
xonegab: doesn't show hand 
*** SUMMARY ***
Total pot $1.34 | Rake $0.06 
Board [8d Ac Js 9s]
Seat 1: !P0K3RM3T4L! (button) folded before Flop (didn't bet)
Seat 2: StrangeChip1 (small blind) folded before Flop
Seat 3: xonegab (big blind) collected ($1.28)
Seat 4: SantiagoWeight folded before Flop (didn't bet)
Seat 5: Lehared folded on the Turn
Seat 6: Chrimmpam folded before Flop (didn't bet)



PokerStars Zoom Hand #195024306735:  Hold'em No Limit ($0.10/$0.25) - 2018/12/29 4:28:13 UTC [2018/12/28 23:28:13 ET]
Table 'Hydra' 6-max Seat #1 is the button
Seat 1: MileVoliD49 ($23.71 in chips) 
Seat 2: papico3 ($25 in chips) 
Seat 3: Aco80 ($26.02 in chips) 
Seat 4: Chrimmpam ($23.34 in chips) 
Seat 5: reggiedogg31 ($120.91 in chips) 
Seat 6: SantiagoWeight ($32.45 in chips) 
papico3: posts small blind $0.10
Aco80: posts big blind $0.25
*** HOLE CARDS ***
Dealt to SantiagoWeight [Qc 4h]
Chrimmpam: raises $0.60 to $0.85
reggiedogg31: folds 
SantiagoWeight: folds 
MileVoliD49: folds 
papico3: folds 
Aco80: raises $2.15 to $3
Chrimmpam: calls $2.15
*** FLOP *** [5s 3h 6s]
Aco80: bets $3.36
Chrimmpam: folds 
Uncalled bet ($3.36) returned to Aco80
Aco80 collected $5.83 from pot
Aco80: doesn't show hand 
*** SUMMARY ***
Total pot $6.10 | Rake $0.27 
Board [5s 3h 6s]
Seat 1: MileVoliD49 (button) folded before Flop (didn't bet)
Seat 2: papico3 (small blind) folded before Flop
Seat 3: Aco80 (big blind) collected ($5.83)
Seat 4: Chrimmpam folded on the Flop
Seat 5: reggiedogg31 folded before Flop (didn't bet)
Seat 6: SantiagoWeight folded before Flop (didn't bet)



PokerStars Zoom Hand #195024309889:  Hold'em No Limit ($0.10/$0.25) - 2018/12/29 4:28:24 UTC [2018/12/28 23:28:24 ET]
Table 'Hydra' 6-max Seat #1 is the button
Seat 1: cheolbeom ($40.25 in chips) 
Seat 2: Mixxxxer599 ($26.42 in chips) 
Seat 3: alex3d1985 ($11.16 in chips) 
Seat 4: ricpoitras ($25.10 in chips) 
Seat 5: SantiagoWeight ($32.45 in chips) 
Seat 6: ivann14 ($63.44 in chips) 
Mixxxxer599: posts small blind $0.10
alex3d1985: posts big blind $0.25
*** HOLE CARDS ***
Dealt to SantiagoWeight [7d 8h]
ricpoitras: raises $0.50 to $0.75
SantiagoWeight: folds 
ivann14 has timed out
ivann14: folds 
cheolbeom: folds 
Mixxxxer599: folds 
alex3d1985: folds 
Uncalled bet ($0.50) returned to ricpoitras
ricpoitras collected $0.60 from pot
ricpoitras: doesn't show hand 
*** SUMMARY ***
Total pot $0.60 | Rake $0 
Seat 1: cheolbeom (button) folded before Flop (didn't bet)
Seat 2: Mixxxxer599 (small blind) folded before Flop
Seat 3: alex3d1985 (big blind) folded before Flop
Seat 4: ricpoitras collected ($0.60)
Seat 5: SantiagoWeight folded before Flop (didn't bet)
Seat 6: ivann14 folded before Flop (didn't bet)



PokerStars Zoom Hand #195024314781:  Hold'em No Limit ($0.10/$0.25) - 2018/12/29 4:28:41 UTC [2018/12/28 23:28:41 ET]
Table 'Hydra' 6-max Seat #1 is the button
Seat 1: Gonzalit0o ($29.05 in chips) 
Seat 2: SantiagoWeight ($32.45 in chips) 
Seat 3: Becks Baker ($26.30 in chips) 
Seat 4: Jameson11 ($12.80 in chips) 
Seat 5: abbi555 ($44.13 in chips) 
Seat 6: zbuci ($77.60 in chips) 
SantiagoWeight: posts small blind $0.10
Becks Baker: posts big blind $0.25
*** HOLE CARDS ***
Dealt to SantiagoWeight [Ks 6d]
Jameson11: folds 
abbi555: folds 
zbuci: folds 
Gonzalit0o: folds 
SantiagoWeight: folds 
Uncalled bet ($0.15) returned to Becks Baker
Becks Baker collected $0.20 from pot
*** SUMMARY ***
Total pot $0.20 | Rake $0 
Seat 1: Gonzalit0o (button) folded before Flop (didn't bet)
Seat 2: SantiagoWeight (small blind) folded before Flop
Seat 3: Becks Baker (big blind) collected ($0.20)
Seat 4: Jameson11 folded before Flop (didn't bet)
Seat 5: abbi555 folded before Flop (didn't bet)
Seat 6: zbuci folded before Flop (didn't bet)



PokerStars Zoom Hand #195024312190:  Hold'em No Limit ($0.10/$0.25) - 2018/12/29 4:28:32 UTC [2018/12/28 23:28:32 ET]
Table 'Hydra' 6-max Seat #1 is the button
Seat 1: SantiagoWeight ($32.45 in chips) 
Seat 2: BIGPAIN14 ($22.17 in chips) 
Seat 3: Aco80 ($30.92 in chips) 
Seat 4: Viiiru ($26 in chips) 
Seat 5: xonegab ($37.91 in chips) 
Seat 6: Chellabro ($9.60 in chips) 
BIGPAIN14: posts small blind $0.10
Aco80: posts big blind $0.25
*** HOLE CARDS ***
Dealt to SantiagoWeight [8d 6d]
Viiiru: folds 
xonegab: calls $0.25
Chellabro: folds 
SantiagoWeight: folds 
BIGPAIN14: folds 
Aco80: checks 
*** FLOP *** [9c 8s Ah]
Aco80: checks 
xonegab: checks 
*** TURN *** [9c 8s Ah] [Th]
Aco80: checks 
xonegab: bets $0.25
Aco80: folds 
Uncalled bet ($0.25) returned to xonegab
xonegab collected $0.57 from pot
xonegab: doesn't show hand 
*** SUMMARY ***
Total pot $0.60 | Rake $0.03 
Board [9c 8s Ah Th]
Seat 1: SantiagoWeight (button) folded before Flop (didn't bet)
Seat 2: BIGPAIN14 (small blind) folded before Flop
Seat 3: Aco80 (big blind) folded on the Turn
Seat 4: Viiiru folded before Flop (didn't bet)
Seat 5: xonegab collected ($0.57)
Seat 6: Chellabro folded before Flop (didn't bet)



PokerStars Zoom Hand #195024318783:  Hold'em No Limit ($0.10/$0.25) - 2018/12/29 4:28:55 UTC [2018/12/28 23:28:55 ET]
Table 'Hydra' 6-max Seat #1 is the button
Seat 1: mariopork ($26.65 in chips) 
Seat 2: Gonzalit0o ($25.92 in chips) 
Seat 3: SantiagoWeight ($32.35 in chips) 
Seat 4: xXBossHossXx ($29.55 in chips) 
Seat 5: allin969 ($13.12 in chips) 
Seat 6: ricpoitras ($25.35 in chips) 
Gonzalit0o: posts small blind $0.10
SantiagoWeight: posts big blind $0.25
*** HOLE CARDS ***
Dealt to SantiagoWeight [Tc 5h]
xXBossHossXx: raises $0.50 to $0.75
allin969: folds 
ricpoitras: folds 
mariopork: folds 
Gonzalit0o: calls $0.65
SantiagoWeight: folds 
*** FLOP *** [6h 8c 3s]
Gonzalit0o: checks 
xXBossHossXx: checks 
*** TURN *** [6h 8c 3s] [Kh]
Gonzalit0o: checks 
xXBossHossXx: bets $1
Gonzalit0o: calls $1
*** RIVER *** [6h 8c 3s Kh] [7s]
Gonzalit0o: checks 
xXBossHossXx: checks 
*** SHOW DOWN ***
Gonzalit0o: shows [8d Ad] (a pair of Eights)
xXBossHossXx: mucks hand 
Gonzalit0o collected $3.58 from pot
*** SUMMARY ***
Total pot $3.75 | Rake $0.17 
Board [6h 8c 3s Kh 7s]
Seat 1: mariopork (button) folded before Flop (didn't bet)
Seat 2: Gonzalit0o (small blind) showed [8d Ad] and won ($3.58) with a pair of Eights
Seat 3: SantiagoWeight (big blind) folded before Flop
Seat 4: xXBossHossXx mucked [Jh Th]
Seat 5: allin969 folded before Flop (didn't bet)
Seat 6: ricpoitras folded before Flop (didn't bet)



PokerStars Zoom Hand #195024321822:  Hold'em No Limit ($0.10/$0.25) - 2018/12/29 4:29:06 UTC [2018/12/28 23:29:06 ET]
Table 'Hydra' 6-max Seat #1 is the button
Seat 1: StrangeChip1 ($31.84 in chips) 
Seat 2: ryanking99 ($50.56 in chips) 
Seat 3: Doomdigidoom ($39.53 in chips) 
Seat 4: the_ablist7 ($11.13 in chips) 
Seat 5: paulieGB ($26.95 in chips) 
Seat 6: SantiagoWeight ($32.10 in chips) 
ryanking99: posts small blind $0.10
Doomdigidoom: posts big blind $0.25
*** HOLE CARDS ***
Dealt to SantiagoWeight [4c 2h]
the_ablist7: raises $0.50 to $0.75
paulieGB: folds 
SantiagoWeight: folds 
StrangeChip1: folds 
ryanking99: folds 
Doomdigidoom: folds 
Uncalled bet ($0.50) returned to the_ablist7
the_ablist7 collected $0.60 from pot
the_ablist7: doesn't show hand 
*** SUMMARY ***
Total pot $0.60 | Rake $0 
Seat 1: StrangeChip1 (button) folded before Flop (didn't bet)
Seat 2: ryanking99 (small blind) folded before Flop
Seat 3: Doomdigidoom (big blind) folded before Flop
Seat 4: the_ablist7 collected ($0.60)
Seat 5: paulieGB folded before Flop (didn't bet)
Seat 6: SantiagoWeight folded before Flop (didn't bet)



PokerStars Zoom Hand #195024328066:  Hold'em No Limit ($0.10/$0.25) - 2018/12/29 4:29:28 UTC [2018/12/28 23:29:28 ET]
Table 'Hydra' 6-max Seat #1 is the button
Seat 1: pirosiky ($29.31 in chips) 
Seat 2: ricpoitras ($25.10 in chips) 
Seat 3: Chellabro ($9.25 in chips) 
Seat 4: SantiagoWeight ($32.10 in chips) 
Seat 5: papico3 ($32.32 in chips) 
Seat 6: deaglepro ($47.81 in chips) 
ricpoitras: posts small blind $0.10
Chellabro: posts big blind $0.25
*** HOLE CARDS ***
Dealt to SantiagoWeight [9d Qc]
SantiagoWeight: folds 
papico3: folds 
deaglepro: folds 
pirosiky: folds 
ricpoitras: folds 
Uncalled bet ($0.15) returned to Chellabro
Chellabro collected $0.20 from pot
Chellabro: doesn't show hand 
*** SUMMARY ***
Total pot $0.20 | Rake $0 
Seat 1: pirosiky (button) folded before Flop (didn't bet)
Seat 2: ricpoitras (small blind) folded before Flop
Seat 3: Chellabro (big blind) collected ($0.20)
Seat 4: SantiagoWeight folded before Flop (didn't bet)
Seat 5: papico3 folded before Flop (didn't bet)
Seat 6: deaglepro folded before Flop (didn't bet)



PokerStars Zoom Hand #195024325767:  Hold'em No Limit ($0.10/$0.25) - 2018/12/29 4:29:20 UTC [2018/12/28 23:29:20 ET]
Table 'Hydra' 6-max Seat #1 is the button
Seat 1: mariopork ($109.66 in chips) 
Seat 2: cankum ($25.70 in chips) 
Seat 3: zaneti8722 ($24.65 in chips) 
Seat 4: alex3d1985 ($10.46 in chips) 
Seat 5: SantiagoWeight ($32.10 in chips) 
Seat 6: denisss1801 ($29.50 in chips) 
cankum: posts small blind $0.10
zaneti8722: posts big blind $0.25
*** HOLE CARDS ***
Dealt to SantiagoWeight [3h 5h]
alex3d1985: raises $1 to $1.25
SantiagoWeight: folds 
denisss1801: folds 
mariopork: folds 
cankum: folds 
zaneti8722: calls $1
*** FLOP *** [3c 7c 5c]
zaneti8722: checks 
alex3d1985: bets $2.48
zaneti8722: folds 
Uncalled bet ($2.48) returned to alex3d1985
alex3d1985 collected $2.48 from pot
alex3d1985: doesn't show hand 
*** SUMMARY ***
Total pot $2.60 | Rake $0.12 
Board [3c 7c 5c]
Seat 1: mariopork (button) folded before Flop (didn't bet)
Seat 2: cankum (small blind) folded before Flop
Seat 3: zaneti8722 (big blind) folded on the Flop
Seat 4: alex3d1985 collected ($2.48)
Seat 5: SantiagoWeight folded before Flop (didn't bet)
Seat 6: denisss1801 folded before Flop (didn't bet)



PokerStars Zoom Hand #195024329416:  Hold'em No Limit ($0.10/$0.25) - 2018/12/29 4:29:33 UTC [2018/12/28 23:29:33 ET]
Table 'Hydra' 6-max Seat #1 is the button
Seat 1: qing328 ($22.90 in chips) 
Seat 2: pirosiky ($29.31 in chips) 
Seat 3: SantiagoWeight ($32.10 in chips) 
Seat 4: glenn.vaughan ($23.47 in chips) 
Seat 5: StrangeChip1 ($32.19 in chips) 
Seat 6: mariopork ($109.66 in chips) 
pirosiky: posts small blind $0.10
SantiagoWeight: posts big blind $0.25
*** HOLE CARDS ***
Dealt to SantiagoWeight [8s 7c]
glenn.vaughan: calls $0.25
StrangeChip1: folds 
mariopork: folds 
qing328: folds 
pirosiky: folds 
SantiagoWeight: checks 
*** FLOP *** [3c Ts 2s]
SantiagoWeight: checks 
glenn.vaughan: checks 
*** TURN *** [3c Ts 2s] [4s]
SantiagoWeight: bets $0.38
glenn.vaughan: calls $0.38
*** RIVER *** [3c Ts 2s 4s] [Kd]
SantiagoWeight: bets $1.50
glenn.vaughan: calls $1.50
*** SHOW DOWN ***
SantiagoWeight: shows [8s 7c] (high card King)
glenn.vaughan: shows [Qd Ks] (a pair of Kings)
glenn.vaughan collected $4.16 from pot
*** SUMMARY ***
Total pot $4.36 | Rake $0.20 
Board [3c Ts 2s 4s Kd]
Seat 1: qing328 (button) folded before Flop (didn't bet)
Seat 2: pirosiky (small blind) folded before Flop
Seat 3: SantiagoWeight (big blind) showed [8s 7c] and lost with high card King
Seat 4: glenn.vaughan showed [Qd Ks] and won ($4.16) with a pair of Kings
Seat 5: StrangeChip1 folded before Flop (didn't bet)
Seat 6: mariopork folded before Flop (didn't bet)



PokerStars Zoom Hand #195024339602:  Hold'em No Limit ($0.10/$0.25) - 2018/12/29 4:30:09 UTC [2018/12/28 23:30:09 ET]
Table 'Hydra' 6-max Seat #1 is the button
Seat 1: Bonen18 ($25.10 in chips) 
Seat 2: SantiagoWeight ($29.97 in chips) 
Seat 3: clashwizard23 ($26.66 in chips) 
Seat 4: glenn.vaughan ($25.50 in chips) 
Seat 5: Lehared ($51.05 in chips) 
Seat 6: !P0K3RM3T4L! ($25.01 in chips) 
SantiagoWeight: posts small blind $0.10
clashwizard23: posts big blind $0.25
*** HOLE CARDS ***
Dealt to SantiagoWeight [Kh 3h]
glenn.vaughan: folds 
Lehared: folds 
!P0K3RM3T4L!: folds 
Bonen18: folds 
SantiagoWeight: raises $0.50 to $0.75
clashwizard23: calls $0.50
*** FLOP *** [Ad Qh Qs]
SantiagoWeight: bets $0.36
clashwizard23: calls $0.36
*** TURN *** [Ad Qh Qs] [8d]
SantiagoWeight: checks 
clashwizard23: bets $2.25
SantiagoWeight: folds 
Uncalled bet ($2.25) returned to clashwizard23
clashwizard23 collected $2.12 from pot
*** SUMMARY ***
Total pot $2.22 | Rake $0.10 
Board [Ad Qh Qs 8d]
Seat 1: Bonen18 (button) folded before Flop (didn't bet)
Seat 2: SantiagoWeight (small blind) folded on the Turn
Seat 3: clashwizard23 (big blind) collected ($2.12)
Seat 4: glenn.vaughan folded before Flop (didn't bet)
Seat 5: Lehared folded before Flop (didn't bet)
Seat 6: !P0K3RM3T4L! folded before Flop (didn't bet)



PokerStars Zoom Hand #195024355309:  Hold'em No Limit ($0.10/$0.25) - 2018/12/29 4:31:05 UTC [2018/12/28 23:31:05 ET]
Table 'Hydra' 6-max Seat #1 is the button
Seat 1: SantiagoWeight ($28.86 in chips) 
Seat 2: Sco0oter ($23.72 in chips) 
Seat 3: Gonzalit0o ($27.98 in chips) 
Seat 4: razil_999 ($24.57 in chips) 
Seat 5: cheolbeom ($39.65 in chips) 
Seat 6: ricpoitras ($25.67 in chips) 
Sco0oter: posts small blind $0.10
Gonzalit0o: posts big blind $0.25
*** HOLE CARDS ***
Dealt to SantiagoWeight [Ah 5h]
razil_999: folds 
cheolbeom: folds 
ricpoitras: folds 
SantiagoWeight: raises $0.30 to $0.55
Sco0oter has timed out
Sco0oter: folds 
Gonzalit0o: folds 
Uncalled bet ($0.30) returned to SantiagoWeight
SantiagoWeight collected $0.60 from pot
SantiagoWeight: doesn't show hand 
*** SUMMARY ***
Total pot $0.60 | Rake $0 
Seat 1: SantiagoWeight (button) collected ($0.60)
Seat 2: Sco0oter (small blind) folded before Flop
Seat 3: Gonzalit0o (big blind) folded before Flop
Seat 4: razil_999 folded before Flop (didn't bet)
Seat 5: cheolbeom folded before Flop (didn't bet)
Seat 6: ricpoitras folded before Flop (didn't bet)



PokerStars Zoom Hand #195024363379:  Hold'em No Limit ($0.10/$0.25) - 2018/12/29 4:31:34 UTC [2018/12/28 23:31:34 ET]
Table 'Hydra' 6-max Seat #1 is the button
Seat 1: qing328 ($25.76 in chips) 
Seat 2: Lehared ($25.10 in chips) 
Seat 3: KingsOfEdm ($62.71 in chips) 
Seat 4: lovintalbi ($91.22 in chips) 
Seat 5: crashbuum ($32.22 in chips) 
Seat 6: SantiagoWeight ($29.21 in chips) 
Lehared: posts small blind $0.10
KingsOfEdm: posts big blind $0.25
*** HOLE CARDS ***
Dealt to SantiagoWeight [9c Ah]
lovintalbi: folds 
crashbuum: folds 
SantiagoWeight: raises $0.30 to $0.55
qing328: folds 
Lehared: folds 
KingsOfEdm has timed out
KingsOfEdm: folds 
Uncalled bet ($0.30) returned to SantiagoWeight
SantiagoWeight collected $0.60 from pot
SantiagoWeight: doesn't show hand 
*** SUMMARY ***
Total pot $0.60 | Rake $0 
Seat 1: qing328 (button) folded before Flop (didn't bet)
Seat 2: Lehared (small blind) folded before Flop
Seat 3: KingsOfEdm (big blind) folded before Flop
Seat 4: lovintalbi folded before Flop (didn't bet)
Seat 5: crashbuum folded before Flop (didn't bet)
Seat 6: SantiagoWeight collected ($0.60)



PokerStars Zoom Hand #195024372051:  Hold'em No Limit ($0.10/$0.25) - 2018/12/29 4:32:05 UTC [2018/12/28 23:32:05 ET]
Table 'Hydra' 6-max Seat #1 is the button
Seat 1: Mixxxxer599 ($23.13 in chips) 
Seat 2: zaneti8722 ($22.70 in chips) 
Seat 3: anlu0803 ($24.92 in chips) 
Seat 4: SantiagoWeight ($29.56 in chips) 
Seat 5: moderi ($4.98 in chips) 
Seat 6: ricpoitras ($26.25 in chips) 
zaneti8722: posts small blind $0.10
anlu0803: posts big blind $0.25
*** HOLE CARDS ***
Dealt to SantiagoWeight [9s 8h]
SantiagoWeight: folds 
moderi: folds 
ricpoitras: folds 
Mixxxxer599: folds 
zaneti8722: folds 
Uncalled bet ($0.15) returned to anlu0803
anlu0803 collected $0.20 from pot
anlu0803: doesn't show hand 
*** SUMMARY ***
Total pot $0.20 | Rake $0 
Seat 1: Mixxxxer599 (button) folded before Flop (didn't bet)
Seat 2: zaneti8722 (small blind) folded before Flop
Seat 3: anlu0803 (big blind) collected ($0.20)
Seat 4: SantiagoWeight folded before Flop (didn't bet)
Seat 5: moderi folded before Flop (didn't bet)
Seat 6: ricpoitras folded before Flop (didn't bet)



PokerStars Zoom Hand #195024373183:  Hold'em No Limit ($0.10/$0.25) - 2018/12/29 4:32:09 UTC [2018/12/28 23:32:09 ET]
Table 'Hydra' 6-max Seat #1 is the button
Seat 1: ttshead ($68.17 in chips) 
Seat 2: ricpoitras ($25.77 in chips) 
Seat 3: fishnm2018 ($25 in chips) 
Seat 4: sigaro010 ($6.58 in chips) 
Seat 5: SantiagoWeight ($29.56 in chips) 
Seat 6: BIGPAIN14 ($22.32 in chips) 
ricpoitras: posts small blind $0.10
fishnm2018: posts big blind $0.25
*** HOLE CARDS ***
Dealt to SantiagoWeight [Ac 8c]
sigaro010: folds 
SantiagoWeight: raises $0.37 to $0.62
BIGPAIN14: folds 
ttshead: folds 
ricpoitras: folds 
fishnm2018: folds 
Uncalled bet ($0.37) returned to SantiagoWeight
SantiagoWeight collected $0.60 from pot
SantiagoWeight: doesn't show hand 
*** SUMMARY ***
Total pot $0.60 | Rake $0 
Seat 1: ttshead (button) folded before Flop (didn't bet)
Seat 2: ricpoitras (small blind) folded before Flop
Seat 3: fishnm2018 (big blind) folded before Flop
Seat 4: sigaro010 folded before Flop (didn't bet)
Seat 5: SantiagoWeight collected ($0.60)
Seat 6: BIGPAIN14 folded before Flop (didn't bet)



PokerStars Zoom Hand #195024376814:  Hold'em No Limit ($0.10/$0.25) - 2018/12/29 4:32:22 UTC [2018/12/28 23:32:22 ET]
Table 'Hydra' 6-max Seat #1 is the button
Seat 1: Aco80 ($28.15 in chips) 
Seat 2: SantiagoWeight ($29.91 in chips) 
Seat 3: ineedmoeny ($20.45 in chips) 
Seat 4: reggiedogg31 ($121.81 in chips) 
Seat 5: lovintalbi ($91.22 in chips) 
Seat 6: graysonai ($39.92 in chips) 
SantiagoWeight: posts small blind $0.10
ineedmoeny: posts big blind $0.25
*** HOLE CARDS ***
Dealt to SantiagoWeight [Js 3c]
reggiedogg31: folds 
lovintalbi: folds 
graysonai: folds 
Aco80: raises $0.37 to $0.62
SantiagoWeight: folds 
ineedmoeny: folds 
Uncalled bet ($0.37) returned to Aco80
Aco80 collected $0.60 from pot
Aco80: doesn't show hand 
*** SUMMARY ***
Total pot $0.60 | Rake $0 
Seat 1: Aco80 (button) collected ($0.60)
Seat 2: SantiagoWeight (small blind) folded before Flop
Seat 3: ineedmoeny (big blind) folded before Flop
Seat 4: reggiedogg31 folded before Flop (didn't bet)
Seat 5: lovintalbi folded before Flop (didn't bet)
Seat 6: graysonai folded before Flop (didn't bet)



PokerStars Zoom Hand #195024383060:  Hold'em No Limit ($0.10/$0.25) - 2018/12/29 4:32:44 UTC [2018/12/28 23:32:44 ET]
Table 'Hydra' 6-max Seat #1 is the button
Seat 1: louiskitu ($38.06 in chips) 
Seat 2: clashwizard23 ($27.50 in chips) 
Seat 3: kiteboard26 ($19.85 in chips) 
Seat 4: SantiagoWeight ($29.56 in chips) 
Seat 5: mariopork ($104.56 in chips) 
Seat 6: Pardaroxon ($25 in chips) 
clashwizard23: posts small blind $0.10
kiteboard26: posts big blind $0.25
*** HOLE CARDS ***
Dealt to SantiagoWeight [7s 8c]
SantiagoWeight: folds 
mariopork: folds 
Pardaroxon: folds 
louiskitu: folds 
clashwizard23: raises $0.50 to $0.75
kiteboard26: folds 
Uncalled bet ($0.50) returned to clashwizard23
clashwizard23 collected $0.50 from pot
clashwizard23: doesn't show hand 
*** SUMMARY ***
Total pot $0.50 | Rake $0 
Seat 1: louiskitu (button) folded before Flop (didn't bet)
Seat 2: clashwizard23 (small blind) collected ($0.50)
Seat 3: kiteboard26 (big blind) folded before Flop
Seat 4: SantiagoWeight folded before Flop (didn't bet)
Seat 5: mariopork folded before Flop (didn't bet)
Seat 6: Pardaroxon folded before Flop (didn't bet)



PokerStars Zoom Hand #195024379369:  Hold'em No Limit ($0.10/$0.25) - 2018/12/29 4:32:31 UTC [2018/12/28 23:32:31 ET]
Table 'Hydra' 6-max Seat #1 is the button
Seat 1: anlu0803 ($25.02 in chips) 
Seat 2: lovintalbi ($91.22 in chips) 
Seat 3: SantiagoWeight ($29.81 in chips) 
Seat 4: ARTBIL ($26.67 in chips) 
Seat 5: Breedijkie ($46.98 in chips) 
Seat 6: gustavotaina ($16.83 in chips) 
lovintalbi: posts small blind $0.10
SantiagoWeight: posts big blind $0.25
*** HOLE CARDS ***
Dealt to SantiagoWeight [7h 5d]
ARTBIL: raises $0.50 to $0.75
Breedijkie: folds 
gustavotaina: folds 
anlu0803: calls $0.75
lovintalbi: folds 
SantiagoWeight: folds 
*** FLOP *** [2s 6c Qs]
ARTBIL: bets $1.33
anlu0803: calls $1.33
*** TURN *** [2s 6c Qs] [Jc]
ARTBIL: checks 
anlu0803: bets $2.25
ARTBIL: folds 
Uncalled bet ($2.25) returned to anlu0803
anlu0803 collected $4.31 from pot
anlu0803: doesn't show hand 
*** SUMMARY ***
Total pot $4.51 | Rake $0.20 
Board [2s 6c Qs Jc]
Seat 1: anlu0803 (button) collected ($4.31)
Seat 2: lovintalbi (small blind) folded before Flop
Seat 3: SantiagoWeight (big blind) folded before Flop
Seat 4: ARTBIL folded on the Turn
Seat 5: Breedijkie folded before Flop (didn't bet)
Seat 6: gustavotaina folded before Flop (didn't bet)



PokerStars Zoom Hand #195024384216:  Hold'em No Limit ($0.10/$0.25) - 2018/12/29 4:32:48 UTC [2018/12/28 23:32:48 ET]
Table 'Hydra' 6-max Seat #1 is the button
Seat 1: SantiagoWeight ($29.56 in chips) 
Seat 2: Viiiru ($26.10 in chips) 
Seat 3: G ster24 ($22.31 in chips) 
Seat 4: Chellabro ($7.15 in chips) 
Seat 5: cheolbeom ($25 in chips) 
Seat 6: Nutselas ($91.85 in chips) 
Viiiru: posts small blind $0.10
G ster24: posts big blind $0.25
*** HOLE CARDS ***
Dealt to SantiagoWeight [7c 7d]
Chellabro: calls $0.25
cheolbeom: folds 
Nutselas: folds 
SantiagoWeight: calls $0.25
Viiiru: calls $0.15
G ster24: checks 
*** FLOP *** [9d Qc 8h]
Viiiru: checks 
G ster24: bets $0.96
Chellabro: folds 
SantiagoWeight: folds 
Viiiru: folds 
Uncalled bet ($0.96) returned to G ster24
G ster24 collected $0.96 from pot
G ster24: doesn't show hand 
*** SUMMARY ***
Total pot $1 | Rake $0.04 
Board [9d Qc 8h]
Seat 1: SantiagoWeight (button) folded on the Flop
Seat 2: Viiiru (small blind) folded on the Flop
Seat 3: G ster24 (big blind) collected ($0.96)
Seat 4: Chellabro folded on the Flop
Seat 5: cheolbeom folded before Flop (didn't bet)
Seat 6: Nutselas folded before Flop (didn't bet)



PokerStars Zoom Hand #195024403321:  Hold'em No Limit ($0.10/$0.25) - 2018/12/29 4:33:56 UTC [2018/12/28 23:33:56 ET]
Table 'Hydra' 6-max Seat #1 is the button
Seat 1: inujara4 ($28.42 in chips) 
Seat 2: know you cry ($12.25 in chips) 
Seat 3: alex3d1985 ($16.99 in chips) 
Seat 4: naxizzle ($105.42 in chips) 
Seat 5: SantiagoWeight ($29.31 in chips) 
Seat 6: TQNYMQNTANA ($58.22 in chips) 
know you cry: posts small blind $0.10
alex3d1985: posts big blind $0.25
*** HOLE CARDS ***
Dealt to SantiagoWeight [Ks 5s]
naxizzle: calls $0.25
SantiagoWeight: folds 
TQNYMQNTANA: raises $1 to $1.25
inujara4: folds 
know you cry: folds 
alex3d1985: folds 
naxizzle: folds 
Uncalled bet ($1) returned to TQNYMQNTANA
TQNYMQNTANA collected $0.85 from pot
TQNYMQNTANA: doesn't show hand 
*** SUMMARY ***
Total pot $0.85 | Rake $0 
Seat 1: inujara4 (button) folded before Flop (didn't bet)
Seat 2: know you cry (small blind) folded before Flop
Seat 3: alex3d1985 (big blind) folded before Flop
Seat 4: naxizzle folded before Flop
Seat 5: SantiagoWeight folded before Flop (didn't bet)
Seat 6: TQNYMQNTANA collected ($0.85)



PokerStars Zoom Hand #195024400561:  Hold'em No Limit ($0.10/$0.25) - 2018/12/29 4:33:46 UTC [2018/12/28 23:33:46 ET]
Table 'Hydra' 6-max Seat #1 is the button
Seat 1: BIGPAIN14 ($20.37 in chips) 
Seat 2: paulieGB ($25.71 in chips) 
Seat 3: karapuz1405 ($25 in chips) 
Seat 4: FarrOut1 ($7.92 in chips) 
Seat 5: Lehared ($25.97 in chips) 
Seat 6: SantiagoWeight ($29.31 in chips) 
paulieGB: posts small blind $0.10
karapuz1405: posts big blind $0.25
*** HOLE CARDS ***
Dealt to SantiagoWeight [6d 5h]
FarrOut1: folds 
Lehared: folds 
SantiagoWeight: folds 
BIGPAIN14: folds 
paulieGB: raises $0.37 to $0.62
karapuz1405: calls $0.37
*** FLOP *** [Tc Qd 8d]
paulieGB: checks 
karapuz1405: bets $1.18
paulieGB: folds 
Uncalled bet ($1.18) returned to karapuz1405
karapuz1405 collected $1.18 from pot
karapuz1405: doesn't show hand 
*** SUMMARY ***
Total pot $1.24 | Rake $0.06 
Board [Tc Qd 8d]
Seat 1: BIGPAIN14 (button) folded before Flop (didn't bet)
Seat 2: paulieGB (small blind) folded on the Flop
Seat 3: karapuz1405 (big blind) collected ($1.18)
Seat 4: FarrOut1 folded before Flop (didn't bet)
Seat 5: Lehared folded before Flop (didn't bet)
Seat 6: SantiagoWeight folded before Flop (didn't bet)



PokerStars Zoom Hand #195024405882:  Hold'em No Limit ($0.10/$0.25) - 2018/12/29 4:34:05 UTC [2018/12/28 23:34:05 ET]
Table 'Hydra' 6-max Seat #1 is the button
Seat 1: Renner32 ($58.01 in chips) 
Seat 2: G ster24 ($23.02 in chips) 
Seat 3: Pardaroxon ($27.61 in chips) 
Seat 4: ricpoitras ($27.94 in chips) 
Seat 5: SantiagoWeight ($29.31 in chips) 
Seat 6: trttt74 ($59.15 in chips) 
G ster24: posts small blind $0.10
Pardaroxon: posts big blind $0.25
*** HOLE CARDS ***
Dealt to SantiagoWeight [4h Js]
ricpoitras: folds 
SantiagoWeight: folds 
trttt74: folds 
Renner32: raises $0.50 to $0.75
G ster24: raises $1.75 to $2.50
Pardaroxon: folds 
Renner32: folds 
Uncalled bet ($1.75) returned to G ster24
G ster24 collected $1.75 from pot
G ster24: doesn't show hand 
*** SUMMARY ***
Total pot $1.75 | Rake $0 
Seat 1: Renner32 (button) folded before Flop
Seat 2: G ster24 (small blind) collected ($1.75)
Seat 3: Pardaroxon (big blind) folded before Flop
Seat 4: ricpoitras folded before Flop (didn't bet)
Seat 5: SantiagoWeight folded before Flop (didn't bet)
Seat 6: trttt74 folded before Flop (didn't bet)



PokerStars Zoom Hand #195024406965:  Hold'em No Limit ($0.10/$0.25) - 2018/12/29 4:34:09 UTC [2018/12/28 23:34:09 ET]
Table 'Hydra' 6-max Seat #1 is the button
Seat 1: dawwwid70 ($25 in chips) 
Seat 2: SantiagoWeight ($29.31 in chips) 
Seat 3: mariopork ($25.84 in chips) 
Seat 4: !P0K3RM3T4L! ($27.63 in chips) 
Seat 5: Fobos113 ($23.28 in chips) 
Seat 6: zbuci ($31.47 in chips) 
SantiagoWeight: posts small blind $0.10
mariopork: posts big blind $0.25
*** HOLE CARDS ***
Dealt to SantiagoWeight [Tc Ks]
!P0K3RM3T4L!: folds 
Fobos113: folds 
zbuci: folds 
dawwwid70: raises $0.50 to $0.75
SantiagoWeight: folds 
mariopork: folds 
Uncalled bet ($0.50) returned to dawwwid70
dawwwid70 collected $0.60 from pot
dawwwid70: doesn't show hand 
*** SUMMARY ***
Total pot $0.60 | Rake $0 
Seat 1: dawwwid70 (button) collected ($0.60)
Seat 2: SantiagoWeight (small blind) folded before Flop
Seat 3: mariopork (big blind) folded before Flop
Seat 4: !P0K3RM3T4L! folded before Flop (didn't bet)
Seat 5: Fobos113 folded before Flop (didn't bet)
Seat 6: zbuci folded before Flop (didn't bet)



PokerStars Zoom Hand #195024411382:  Hold'em No Limit ($0.10/$0.25) - 2018/12/29 4:34:25 UTC [2018/12/28 23:34:25 ET]
Table 'Hydra' 6-max Seat #1 is the button
Seat 1: ttshead ($66.79 in chips) 
Seat 2: Renner32 ($57.26 in chips) 
Seat 3: SantiagoWeight ($29.21 in chips) 
Seat 4: Higashi2314 ($25 in chips) 
Seat 5: Pardaroxon ($27.36 in chips) 
Seat 6: crashbuum ($29.47 in chips) 
Renner32: posts small blind $0.10
SantiagoWeight: posts big blind $0.25
*** HOLE CARDS ***
Dealt to SantiagoWeight [Kc Kd]
Higashi2314: folds 
Pardaroxon: folds 
crashbuum: raises $0.25 to $0.50
ttshead: folds 
Renner32: folds 
SantiagoWeight: raises $1.70 to $2.20
crashbuum: folds 
Uncalled bet ($1.70) returned to SantiagoWeight
SantiagoWeight collected $1.10 from pot
SantiagoWeight: doesn't show hand 
*** SUMMARY ***
Total pot $1.10 | Rake $0 
Seat 1: ttshead (button) folded before Flop (didn't bet)
Seat 2: Renner32 (small blind) folded before Flop
Seat 3: SantiagoWeight (big blind) collected ($1.10)
Seat 4: Higashi2314 folded before Flop (didn't bet)
Seat 5: Pardaroxon folded before Flop (didn't bet)
Seat 6: crashbuum folded before Flop



PokerStars Zoom Hand #195024410244:  Hold'em No Limit ($0.10/$0.25) - 2018/12/29 4:34:21 UTC [2018/12/28 23:34:21 ET]
Table 'Hydra' 6-max Seat #1 is the button
Seat 1: Becks Baker ($31.47 in chips) 
Seat 2: Dbakunwaves ($36.58 in chips) 
Seat 3: daveo1008 ($25 in chips) 
Seat 4: SantiagoWeight ($29.21 in chips) 
Seat 5: razil_999 ($22.90 in chips) 
Seat 6: alex3d1985 ($16.64 in chips) 
Dbakunwaves: posts small blind $0.10
daveo1008: posts big blind $0.25
*** HOLE CARDS ***
Dealt to SantiagoWeight [7s 3s]
SantiagoWeight: folds 
razil_999: folds 
alex3d1985: raises $1 to $1.25
Becks Baker: folds 
Dbakunwaves: folds 
daveo1008: calls $1
*** FLOP *** [7h 8c 3d]
daveo1008: checks 
alex3d1985: bets $1.50
daveo1008: folds 
Uncalled bet ($1.50) returned to alex3d1985
alex3d1985 collected $2.48 from pot
alex3d1985: doesn't show hand 
*** SUMMARY ***
Total pot $2.60 | Rake $0.12 
Board [7h 8c 3d]
Seat 1: Becks Baker (button) folded before Flop (didn't bet)
Seat 2: Dbakunwaves (small blind) folded before Flop
Seat 3: daveo1008 (big blind) folded on the Flop
Seat 4: SantiagoWeight folded before Flop (didn't bet)
Seat 5: razil_999 folded before Flop (didn't bet)
Seat 6: alex3d1985 collected ($2.48)



PokerStars Zoom Hand #195024418858:  Hold'em No Limit ($0.10/$0.25) - 2018/12/29 4:34:52 UTC [2018/12/28 23:34:52 ET]
Table 'Hydra' 6-max Seat #1 is the button
Seat 1: zdenekstavic ($35.29 in chips) 
Seat 2: asapon ($25 in chips) 
Seat 3: onhoang87 ($13.57 in chips) 
Seat 4: ryanking99 ($63.42 in chips) 
Seat 5: ARTBIL ($23.74 in chips) 
Seat 6: SantiagoWeight ($29.81 in chips) 
asapon: posts small blind $0.10
onhoang87: posts big blind $0.25
*** HOLE CARDS ***
Dealt to SantiagoWeight [Ts 7s]
ryanking99: folds 
ARTBIL: folds 
SantiagoWeight: raises $0.30 to $0.55
zdenekstavic: folds 
asapon: folds 
onhoang87: folds 
Uncalled bet ($0.30) returned to SantiagoWeight
SantiagoWeight collected $0.60 from pot
SantiagoWeight: doesn't show hand 
*** SUMMARY ***
Total pot $0.60 | Rake $0 
Seat 1: zdenekstavic (button) folded before Flop (didn't bet)
Seat 2: asapon (small blind) folded before Flop
Seat 3: onhoang87 (big blind) folded before Flop
Seat 4: ryanking99 folded before Flop (didn't bet)
Seat 5: ARTBIL folded before Flop (didn't bet)
Seat 6: SantiagoWeight collected ($0.60)



PokerStars Zoom Hand #195024417739:  Hold'em No Limit ($0.10/$0.25) - 2018/12/29 4:34:48 UTC [2018/12/28 23:34:48 ET]
Table 'Hydra' 6-max Seat #1 is the button
Seat 1: SantiagoWeight ($29.81 in chips) 
Seat 2: ttshead ($66.89 in chips) 
Seat 3: inujara4 ($25 in chips) 
Seat 4: river plate9 ($50.37 in chips) 
Seat 5: pkr_miracle ($61.87 in chips) 
Seat 6: Aco80 ($29.26 in chips) 
ttshead: posts small blind $0.10
inujara4: posts big blind $0.25
*** HOLE CARDS ***
Dealt to SantiagoWeight [3d 9d]
river plate9: folds 
pkr_miracle: calls $0.25
Aco80: folds 
SantiagoWeight: folds 
ttshead: folds 
inujara4: checks 
*** FLOP *** [Qd 4d Ks]
inujara4: checks 
pkr_miracle: checks 
*** TURN *** [Qd 4d Ks] [8d]
inujara4: checks 
pkr_miracle: checks 
*** RIVER *** [Qd 4d Ks 8d] [Ah]
inujara4: checks 
pkr_miracle: checks 
*** SHOW DOWN ***
inujara4: shows [Th Qs] (a pair of Queens)
pkr_miracle: mucks hand 
inujara4 collected $0.57 from pot
*** SUMMARY ***
Total pot $0.60 | Rake $0.03 
Board [Qd 4d Ks 8d Ah]
Seat 1: SantiagoWeight (button) folded before Flop (didn't bet)
Seat 2: ttshead (small blind) folded before Flop
Seat 3: inujara4 (big blind) showed [Th Qs] and won ($0.57) with a pair of Queens
Seat 4: river plate9 folded before Flop (didn't bet)
Seat 5: pkr_miracle mucked [5s 5d]
Seat 6: Aco80 folded before Flop (didn't bet)



PokerStars Zoom Hand #195024424123:  Hold'em No Limit ($0.10/$0.25) - 2018/12/29 4:35:11 UTC [2018/12/28 23:35:11 ET]
Table 'Hydra' 6-max Seat #1 is the button
Seat 1: pirosiky ($52.02 in chips) 
Seat 2: Lehared ($25 in chips) 
Seat 3: GrandmasterY ($78.16 in chips) 
Seat 4: SantiagoWeight ($30.16 in chips) 
Seat 5: janluise ($61.71 in chips) 
Seat 6: karapuz1405 ($25.11 in chips) 
Lehared: posts small blind $0.10
GrandmasterY: posts big blind $0.25
*** HOLE CARDS ***
Dealt to SantiagoWeight [3d 6c]
SantiagoWeight: folds 
janluise: folds 
karapuz1405: folds 
pirosiky: folds 
Lehared: folds 
Uncalled bet ($0.15) returned to GrandmasterY
GrandmasterY collected $0.20 from pot
GrandmasterY: doesn't show hand 
*** SUMMARY ***
Total pot $0.20 | Rake $0 
Seat 1: pirosiky (button) folded before Flop (didn't bet)
Seat 2: Lehared (small blind) folded before Flop
Seat 3: GrandmasterY (big blind) collected ($0.20)
Seat 4: SantiagoWeight folded before Flop (didn't bet)
Seat 5: janluise folded before Flop (didn't bet)
Seat 6: karapuz1405 folded before Flop (didn't bet)



PokerStars Zoom Hand #195024426936:  Hold'em No Limit ($0.10/$0.25) - 2018/12/29 4:35:21 UTC [2018/12/28 23:35:21 ET]
Table 'Hydra' 6-max Seat #1 is the button
Seat 1: ARTBIL ($23.39 in chips) 
Seat 2: clashwizard23 ($24.88 in chips) 
Seat 3: SantiagoWeight ($30.16 in chips) 
Seat 4: onhoang87 ($13.22 in chips) 
Seat 5: Guard poker ($26.66 in chips) 
Seat 6: tariko1980 ($39.68 in chips) 
clashwizard23: posts small blind $0.10
SantiagoWeight: posts big blind $0.25
*** HOLE CARDS ***
Dealt to SantiagoWeight [4h Js]
onhoang87: folds 
Guard poker: raises $0.50 to $0.75
tariko1980: folds 
ARTBIL: folds 
clashwizard23: folds 
SantiagoWeight: folds 
Uncalled bet ($0.50) returned to Guard poker
Guard poker collected $0.60 from pot
Guard poker: doesn't show hand 
*** SUMMARY ***
Total pot $0.60 | Rake $0 
Seat 1: ARTBIL (button) folded before Flop (didn't bet)
Seat 2: clashwizard23 (small blind) folded before Flop
Seat 3: SantiagoWeight (big blind) folded before Flop
Seat 4: onhoang87 folded before Flop (didn't bet)
Seat 5: Guard poker collected ($0.60)
Seat 6: tariko1980 folded before Flop (didn't bet)



PokerStars Zoom Hand #195024431067:  Hold'em No Limit ($0.10/$0.25) - 2018/12/29 4:35:36 UTC [2018/12/28 23:35:36 ET]
Table 'Hydra' 6-max Seat #1 is the button
Seat 1: pkr_miracle ($61.62 in chips) 
Seat 2: SantiagoWeight ($29.91 in chips) 
Seat 3: Jameson11 ($7.98 in chips) 
Seat 4: ivann14 ($37.43 in chips) 
Seat 5: sigaro010 ($16.28 in chips) 
Seat 6: river plate9 ($24.48 in chips) 
SantiagoWeight: posts small blind $0.10
Jameson11: posts big blind $0.25
*** HOLE CARDS ***
Dealt to SantiagoWeight [Ad Qc]
ivann14: folds 
sigaro010: folds 
river plate9: raises $0.50 to $0.75
pkr_miracle: calls $0.75
SantiagoWeight: raises $3.45 to $4.20
Jameson11: folds 
river plate9: raises $20.28 to $24.48 and is all-in
pkr_miracle: folds 
SantiagoWeight: folds 
Uncalled bet ($20.28) returned to river plate9
river plate9 collected $9.40 from pot
river plate9: doesn't show hand 
*** SUMMARY ***
Total pot $9.40 | Rake $0 
Seat 1: pkr_miracle (button) folded before Flop
Seat 2: SantiagoWeight (small blind) folded before Flop
Seat 3: Jameson11 (big blind) folded before Flop
Seat 4: ivann14 folded before Flop (didn't bet)
Seat 5: sigaro010 folded before Flop (didn't bet)
Seat 6: river plate9 collected ($9.40)



PokerStars Zoom Hand #195024448488:  Hold'em No Limit ($0.10/$0.25) - 2018/12/29 4:36:39 UTC [2018/12/28 23:36:39 ET]
Table 'Hydra' 6-max Seat #1 is the button
Seat 1: Suit3dGapp3r ($31.75 in chips) 
Seat 2: IMMPORT@L ($16.14 in chips) 
Seat 3: amansah ($15.51 in chips) 
Seat 4: SantiagoWeight ($25.71 in chips) 
Seat 5: trttt74 ($35.23 in chips) 
Seat 6: TQNYMQNTANA ($28.04 in chips) 
IMMPORT@L: posts small blind $0.10
amansah: posts big blind $0.25
*** HOLE CARDS ***
Dealt to SantiagoWeight [8h 8c]
SantiagoWeight: raises $0.42 to $0.67
trttt74: folds 
TQNYMQNTANA: folds 
Suit3dGapp3r: folds 
IMMPORT@L: folds 
amansah: calls $0.42
*** FLOP *** [6h 7s Qh]
amansah: checks 
SantiagoWeight: bets $0.92
amansah: calls $0.92
*** TURN *** [6h 7s Qh] [4c]
amansah: checks 
SantiagoWeight: bets $1.70
amansah: calls $1.70
*** RIVER *** [6h 7s Qh 4c] [Jh]
amansah: bets $5
SantiagoWeight: folds 
Uncalled bet ($5) returned to amansah
amansah collected $6.38 from pot
*** SUMMARY ***
Total pot $6.68 | Rake $0.30 
Board [6h 7s Qh 4c Jh]
Seat 1: Suit3dGapp3r (button) folded before Flop (didn't bet)
Seat 2: IMMPORT@L (small blind) folded before Flop
Seat 3: amansah (big blind) collected ($6.38)
Seat 4: SantiagoWeight folded on the River
Seat 5: trttt74 folded before Flop (didn't bet)
Seat 6: TQNYMQNTANA folded before Flop (didn't bet)



PokerStars Zoom Hand #195024467096:  Hold'em No Limit ($0.10/$0.25) - 2018/12/29 4:37:47 UTC [2018/12/28 23:37:47 ET]
Table 'Hydra' 6-max Seat #1 is the button
Seat 1: SantiagoWeight ($22.42 in chips) 
Seat 2: Renner32 ($57.03 in chips) 
Seat 3: ryanking99 ($24.62 in chips) 
Seat 4: inujara4 ($36.09 in chips) 
Seat 5: Shiltz17 ($36.30 in chips) 
Seat 6: ricpoitras ($25 in chips) 
Renner32: posts small blind $0.10
ryanking99: posts big blind $0.25
*** HOLE CARDS ***
Dealt to SantiagoWeight [5h Qh]
inujara4: folds 
Shiltz17: raises $0.50 to $0.75
ricpoitras: folds 
SantiagoWeight: folds 
Renner32: folds 
ryanking99: calls $0.50
*** FLOP *** [Th Jc 7c]
ryanking99: checks 
Shiltz17: bets $1
ryanking99: calls $1
*** TURN *** [Th Jc 7c] [9c]
ryanking99: checks 
Shiltz17: bets $2.50
ryanking99: folds 
Uncalled bet ($2.50) returned to Shiltz17
Shiltz17 collected $3.44 from pot
Shiltz17: doesn't show hand 
*** SUMMARY ***
Total pot $3.60 | Rake $0.16 
Board [Th Jc 7c 9c]
Seat 1: SantiagoWeight (button) folded before Flop (didn't bet)
Seat 2: Renner32 (small blind) folded before Flop
Seat 3: ryanking99 (big blind) folded on the Turn
Seat 4: inujara4 folded before Flop (didn't bet)
Seat 5: Shiltz17 collected ($3.44)
Seat 6: ricpoitras folded before Flop (didn't bet)



PokerStars Zoom Hand #195024471826:  Hold'em No Limit ($0.10/$0.25) - 2018/12/29 4:38:04 UTC [2018/12/28 23:38:04 ET]
Table 'Hydra' 6-max Seat #1 is the button
Seat 1: ARTBIL ($24.65 in chips) 
Seat 2: deaglepro ($69.19 in chips) 
Seat 3: Bonen18 ($26.72 in chips) 
Seat 4: 2poiRiver ($11.64 in chips) 
Seat 5: TQNYMQNTANA ($28.04 in chips) 
Seat 6: SantiagoWeight ($25 in chips) 
deaglepro: posts small blind $0.10
Bonen18: posts big blind $0.25
*** HOLE CARDS ***
Dealt to SantiagoWeight [7s 9s]
2poiRiver: folds 
TQNYMQNTANA: folds 
SantiagoWeight: raises $0.30 to $0.55
ARTBIL: folds 
deaglepro: folds 
Bonen18: calls $0.30
*** FLOP *** [5c 5s 3h]
Bonen18: checks 
SantiagoWeight: bets $0.29
Bonen18: folds 
Uncalled bet ($0.29) returned to SantiagoWeight
SantiagoWeight collected $1.15 from pot
SantiagoWeight: doesn't show hand 
*** SUMMARY ***
Total pot $1.20 | Rake $0.05 
Board [5c 5s 3h]
Seat 1: ARTBIL (button) folded before Flop (didn't bet)
Seat 2: deaglepro (small blind) folded before Flop
Seat 3: Bonen18 (big blind) folded on the Flop
Seat 4: 2poiRiver folded before Flop (didn't bet)
Seat 5: TQNYMQNTANA folded before Flop (didn't bet)
Seat 6: SantiagoWeight collected ($1.15)



PokerStars Zoom Hand #195024484846:  Hold'em No Limit ($0.10/$0.25) - 2018/12/29 4:38:51 UTC [2018/12/28 23:38:51 ET]
Table 'Hydra' 6-max Seat #1 is the button
Seat 1: Viiiru ($35.75 in chips) 
Seat 2: SantiagoWeight ($25.60 in chips) 
Seat 3: mililser ($48.31 in chips) 
Seat 4: oksana12422 ($23.40 in chips) 
Seat 5: Virus3232 ($26.57 in chips) 
Seat 6: stavro88 ($26.15 in chips) 
SantiagoWeight: posts small blind $0.10
mililser: posts big blind $0.25
*** HOLE CARDS ***
Dealt to SantiagoWeight [Jh Qh]
oksana12422: folds 
Virus3232: folds 
stavro88: folds 
Viiiru: raises $0.37 to $0.62
SantiagoWeight: raises $1.58 to $2.20
mililser: folds 
Viiiru: calls $1.58
*** FLOP *** [As 4c 2d]
SantiagoWeight: bets $1.11
Viiiru: calls $1.11
*** TURN *** [As 4c 2d] [6s]
SantiagoWeight: checks 
Viiiru: checks 
*** RIVER *** [As 4c 2d 6s] [Qc]
SantiagoWeight: bets $3.70
Viiiru: folds 
Uncalled bet ($3.70) returned to SantiagoWeight
SantiagoWeight collected $6.56 from pot
SantiagoWeight: doesn't show hand 
*** SUMMARY ***
Total pot $6.87 | Rake $0.31 
Board [As 4c 2d 6s Qc]
Seat 1: Viiiru (button) folded on the River
Seat 2: SantiagoWeight (small blind) collected ($6.56)
Seat 3: mililser (big blind) folded before Flop
Seat 4: oksana12422 folded before Flop (didn't bet)
Seat 5: Virus3232 folded before Flop (didn't bet)
Seat 6: stavro88 folded before Flop (didn't bet)



PokerStars Zoom Hand #195024510548:  Hold'em No Limit ($0.10/$0.25) - 2018/12/29 4:40:23 UTC [2018/12/28 23:40:23 ET]
Table 'Hydra' 6-max Seat #1 is the button
Seat 1: daveo1008 ($29.69 in chips) 
Seat 2: kurb1234 ($19.53 in chips) 
Seat 3: mariopork ($105.15 in chips) 
Seat 4: Lehared ($25.35 in chips) 
Seat 5: SantiagoWeight ($28.85 in chips) 
Seat 6: asapon ($25 in chips) 
kurb1234: posts small blind $0.10
mariopork: posts big blind $0.25
*** HOLE CARDS ***
Dealt to SantiagoWeight [Js Kc]
Lehared: folds 
SantiagoWeight: raises $0.37 to $0.62
asapon: folds 
daveo1008: folds 
kurb1234: folds 
mariopork: folds 
Uncalled bet ($0.37) returned to SantiagoWeight
SantiagoWeight collected $0.60 from pot
SantiagoWeight: doesn't show hand 
*** SUMMARY ***
Total pot $0.60 | Rake $0 
Seat 1: daveo1008 (button) folded before Flop (didn't bet)
Seat 2: kurb1234 (small blind) folded before Flop
Seat 3: mariopork (big blind) folded before Flop
Seat 4: Lehared folded before Flop (didn't bet)
Seat 5: SantiagoWeight collected ($0.60)
Seat 6: asapon folded before Flop (didn't bet)



PokerStars Zoom Hand #195024516350:  Hold'em No Limit ($0.10/$0.25) - 2018/12/29 4:40:44 UTC [2018/12/28 23:40:44 ET]
Table 'Hydra' 6-max Seat #1 is the button
Seat 1: dawwwid70 ($25 in chips) 
Seat 2: hamen1990 ($25 in chips) 
Seat 3: SantiagoWeight ($29.20 in chips) 
Seat 4: crashbuum ($29.43 in chips) 
Seat 5: MAKSSSSSS72 ($24.68 in chips) 
Seat 6: t57571245 ($34.05 in chips) 
hamen1990: posts small blind $0.10
SantiagoWeight: posts big blind $0.25
*** HOLE CARDS ***
Dealt to SantiagoWeight [8s Tc]
crashbuum: raises $0.25 to $0.50
MAKSSSSSS72: folds 
t57571245: calls $0.50
dawwwid70: folds 
hamen1990: folds 
SantiagoWeight: calls $0.25
*** FLOP *** [Js 3s Kc]
SantiagoWeight: checks 
crashbuum: checks 
t57571245: bets $1
SantiagoWeight: folds 
crashbuum: folds 
Uncalled bet ($1) returned to t57571245
t57571245 collected $1.53 from pot
t57571245: doesn't show hand 
*** SUMMARY ***
Total pot $1.60 | Rake $0.07 
Board [Js 3s Kc]
Seat 1: dawwwid70 (button) folded before Flop (didn't bet)
Seat 2: hamen1990 (small blind) folded before Flop
Seat 3: SantiagoWeight (big blind) folded on the Flop
Seat 4: crashbuum folded on the Flop
Seat 5: MAKSSSSSS72 folded before Flop (didn't bet)
Seat 6: t57571245 collected ($1.53)



PokerStars Zoom Hand #195024524326:  Hold'em No Limit ($0.10/$0.25) - 2018/12/29 4:41:13 UTC [2018/12/28 23:41:13 ET]
Table 'Hydra' 6-max Seat #1 is the button
Seat 1: SantiagoWeight ($28.70 in chips) 
Seat 2: MAKSSSSSS72 ($24.78 in chips) 
Seat 3: lauriña77 ($50.16 in chips) 
Seat 4: hames_tj ($26.61 in chips) 
Seat 5: Guard poker ($29.45 in chips) 
Seat 6: ARTBIL ($25.93 in chips) 
MAKSSSSSS72: posts small blind $0.10
lauriña77: posts big blind $0.25
*** HOLE CARDS ***
Dealt to SantiagoWeight [Qs Jd]
hames_tj: folds 
Guard poker: folds 
ARTBIL: raises $0.50 to $0.75
SantiagoWeight: calls $0.75
MAKSSSSSS72: calls $0.65
lauriña77: calls $0.50
*** FLOP *** [Qh Kh 4d]
MAKSSSSSS72: checks 
lauriña77: checks 
ARTBIL: checks 
SantiagoWeight: checks 
*** TURN *** [Qh Kh 4d] [8s]
MAKSSSSSS72: checks 
lauriña77: bets $1.50
ARTBIL: folds 
SantiagoWeight: calls $1.50
MAKSSSSSS72: folds 
*** RIVER *** [Qh Kh 4d 8s] [Th]
lauriña77: checks 
SantiagoWeight: checks 
*** SHOW DOWN ***
lauriña77: shows [Jc 4c] (a pair of Fours)
SantiagoWeight: shows [Qs Jd] (a pair of Queens)
SantiagoWeight collected $5.73 from pot
*** SUMMARY ***
Total pot $6 | Rake $0.27 
Board [Qh Kh 4d 8s Th]
Seat 1: SantiagoWeight (button) showed [Qs Jd] and won ($5.73) with a pair of Queens
Seat 2: MAKSSSSSS72 (small blind) folded on the Turn
Seat 3: lauriña77 (big blind) showed [Jc 4c] and lost with a pair of Fours
Seat 4: hames_tj folded before Flop (didn't bet)
Seat 5: Guard poker folded before Flop (didn't bet)
Seat 6: ARTBIL folded on the Turn



PokerStars Zoom Hand #195024539692:  Hold'em No Limit ($0.10/$0.25) - 2018/12/29 4:42:08 UTC [2018/12/28 23:42:08 ET]
Table 'Hydra' 6-max Seat #1 is the button
Seat 1: dk dreadlook ($37.31 in chips) 
Seat 2: hames_tj ($25 in chips) 
Seat 3: ritchy99 ($10.34 in chips) 
Seat 4: know you cry ($12.25 in chips) 
Seat 5: SantiagoWeight ($32.18 in chips) 
Seat 6: lauriña77 ($47.91 in chips) 
hames_tj: posts small blind $0.10
ritchy99: posts big blind $0.25
*** HOLE CARDS ***
Dealt to SantiagoWeight [Ks Kc]
know you cry: folds 
SantiagoWeight: raises $0.37 to $0.62
lauriña77: calls $0.62
dk dreadlook: folds 
hames_tj: folds 
ritchy99: calls $0.37
*** FLOP *** [3s 2c 3d]
ritchy99: bets $9.72 and is all-in
SantiagoWeight: calls $9.72
lauriña77: folds 
*** TURN *** [3s 2c 3d] [3c]
*** RIVER *** [3s 2c 3d 3c] [5h]
*** SHOW DOWN ***
ritchy99: shows [5c 5d] (a full house, Fives full of Threes)
SantiagoWeight: shows [Ks Kc] (a full house, Threes full of Kings)
ritchy99 collected $20.44 from pot
*** SUMMARY ***
Total pot $21.40 | Rake $0.96 
Board [3s 2c 3d 3c 5h]
Seat 1: dk dreadlook (button) folded before Flop (didn't bet)
Seat 2: hames_tj (small blind) folded before Flop
Seat 3: ritchy99 (big blind) showed [5c 5d] and won ($20.44) with a full house, Fives full of Threes
Seat 4: know you cry folded before Flop (didn't bet)
Seat 5: SantiagoWeight showed [Ks Kc] and lost with a full house, Threes full of Kings
Seat 6: lauriña77 folded on the Flop



PokerStars Zoom Hand #195024557555:  Hold'em No Limit ($0.10/$0.25) - 2018/12/29 4:43:13 UTC [2018/12/28 23:43:13 ET]
Table 'Hydra' 6-max Seat #1 is the button
Seat 1: Virus3232 ($30.65 in chips) 
Seat 2: xman141 ($93.98 in chips) 
Seat 3: MileVoliD49 ($13.09 in chips) 
Seat 4: SantiagoWeight ($21.84 in chips) 
Seat 5: ARTBIL ($24.86 in chips) 
Seat 6: reggiedogg31 ($116.55 in chips) 
xman141: posts small blind $0.10
MileVoliD49: posts big blind $0.25
*** HOLE CARDS ***
Dealt to SantiagoWeight [Tc 9d]
SantiagoWeight: folds 
ARTBIL: folds 
reggiedogg31: folds 
Virus3232: folds 
xman141: folds 
Uncalled bet ($0.15) returned to MileVoliD49
MileVoliD49 collected $0.20 from pot
MileVoliD49: doesn't show hand 
*** SUMMARY ***
Total pot $0.20 | Rake $0 
Seat 1: Virus3232 (button) folded before Flop (didn't bet)
Seat 2: xman141 (small blind) folded before Flop
Seat 3: MileVoliD49 (big blind) collected ($0.20)
Seat 4: SantiagoWeight folded before Flop (didn't bet)
Seat 5: ARTBIL folded before Flop (didn't bet)
Seat 6: reggiedogg31 folded before Flop (didn't bet)



PokerStars Zoom Hand #195024555635:  Hold'em No Limit ($0.10/$0.25) - 2018/12/29 4:43:06 UTC [2018/12/28 23:43:06 ET]
Table 'Hydra' 6-max Seat #1 is the button
Seat 1: !P0K3RM3T4L! ($28.89 in chips) 
Seat 2: hames_tj ($26.70 in chips) 
Seat 3: graysonai ($44.31 in chips) 
Seat 4: MAKSSSSSS72 ($12.04 in chips) 
Seat 5: IMMPORT@L ($19.26 in chips) 
Seat 6: SantiagoWeight ($21.84 in chips) 
hames_tj: posts small blind $0.10
graysonai: posts big blind $0.25
*** HOLE CARDS ***
Dealt to SantiagoWeight [3d 8s]
MAKSSSSSS72: folds 
IMMPORT@L: folds 
SantiagoWeight: folds 
!P0K3RM3T4L!: folds 
hames_tj: raises $0.35 to $0.60
graysonai: folds 
Uncalled bet ($0.35) returned to hames_tj
hames_tj collected $0.50 from pot
hames_tj: doesn't show hand 
*** SUMMARY ***
Total pot $0.50 | Rake $0 
Seat 1: !P0K3RM3T4L! (button) folded before Flop (didn't bet)
Seat 2: hames_tj (small blind) collected ($0.50)
Seat 3: graysonai (big blind) folded before Flop
Seat 4: MAKSSSSSS72 folded before Flop (didn't bet)
Seat 5: IMMPORT@L folded before Flop (didn't bet)
Seat 6: SantiagoWeight folded before Flop (didn't bet)



PokerStars Zoom Hand #195024559123:  Hold'em No Limit ($0.10/$0.25) - 2018/12/29 4:43:19 UTC [2018/12/28 23:43:19 ET]
Table 'Hydra' 6-max Seat #1 is the button
Seat 1: lovintalbi ($93.54 in chips) 
Seat 2: deaglepro ($61.90 in chips) 
Seat 3: dawwwid70 ($25 in chips) 
Seat 4: JeDti ($33.86 in chips) 
Seat 5: SantiagoWeight ($21.84 in chips) 
Seat 6: daveo1008 ($30.24 in chips) 
deaglepro: posts small blind $0.10
dawwwid70: posts big blind $0.25
*** HOLE CARDS ***
Dealt to SantiagoWeight [8d 9h]
JeDti: folds 
SantiagoWeight: folds 
daveo1008: folds 
lovintalbi: raises $0.50 to $0.75
deaglepro: folds 
dawwwid70: folds 
Uncalled bet ($0.50) returned to lovintalbi
lovintalbi collected $0.60 from pot
lovintalbi: doesn't show hand 
*** SUMMARY ***
Total pot $0.60 | Rake $0 
Seat 1: lovintalbi (button) collected ($0.60)
Seat 2: deaglepro (small blind) folded before Flop
Seat 3: dawwwid70 (big blind) folded before Flop
Seat 4: JeDti folded before Flop (didn't bet)
Seat 5: SantiagoWeight folded before Flop (didn't bet)
Seat 6: daveo1008 folded before Flop (didn't bet)



PokerStars Zoom Hand #195024563855:  Hold'em No Limit ($0.10/$0.25) - 2018/12/29 4:43:36 UTC [2018/12/28 23:43:36 ET]
Table 'Hydra' 6-max Seat #1 is the button
Seat 1: graysonai ($44.06 in chips) 
Seat 2: winwinboy ($25 in chips) 
Seat 3: SantiagoWeight ($21.74 in chips) 
Seat 4: Virus3232 ($25 in chips) 
Seat 5: reggiedogg31 ($116.45 in chips) 
Seat 6: gustavotaina ($18.10 in chips) 
winwinboy: posts small blind $0.10
SantiagoWeight: posts big blind $0.25
*** HOLE CARDS ***
Dealt to SantiagoWeight [3s Td]
Virus3232: folds 
reggiedogg31: folds 
gustavotaina: folds 
graysonai: folds 
winwinboy: raises $0.43 to $0.68
SantiagoWeight: folds 
Uncalled bet ($0.43) returned to winwinboy
winwinboy collected $0.50 from pot
*** SUMMARY ***
Total pot $0.50 | Rake $0 
Seat 1: graysonai (button) folded before Flop (didn't bet)
Seat 2: winwinboy (small blind) collected ($0.50)
Seat 3: SantiagoWeight (big blind) folded before Flop
Seat 4: Virus3232 folded before Flop (didn't bet)
Seat 5: reggiedogg31 folded before Flop (didn't bet)
Seat 6: gustavotaina folded before Flop (didn't bet)



PokerStars Zoom Hand #195024560310:  Hold'em No Limit ($0.10/$0.25) - 2018/12/29 4:43:23 UTC [2018/12/28 23:43:23 ET]
Table 'Hydra' 6-max Seat #1 is the button
Seat 1: deaglepro ($61.80 in chips) 
Seat 2: SantiagoWeight ($21.84 in chips) 
Seat 3: DetlefWD ($22.33 in chips) 
Seat 4: MAKSSSSSS72 ($12.04 in chips) 
Seat 5: LastNoma ($26.75 in chips) 
Seat 6: Guard poker ($55.90 in chips) 
SantiagoWeight: posts small blind $0.10
DetlefWD: posts big blind $0.25
*** HOLE CARDS ***
Dealt to SantiagoWeight [Tc 9h]
MAKSSSSSS72: folds 
LastNoma: raises $0.33 to $0.58
Guard poker: folds 
deaglepro: folds 
SantiagoWeight: folds 
DetlefWD: raises $0.67 to $1.25
LastNoma: calls $0.67
*** FLOP *** [8h 5c Kd]
DetlefWD: bets $1.75
LastNoma: calls $1.75
*** TURN *** [8h 5c Kd] [6c]
DetlefWD: bets $2.25
LastNoma: folds 
Uncalled bet ($2.25) returned to DetlefWD
DetlefWD collected $5.83 from pot
DetlefWD: doesn't show hand 
*** SUMMARY ***
Total pot $6.10 | Rake $0.27 
Board [8h 5c Kd 6c]
Seat 1: deaglepro (button) folded before Flop (didn't bet)
Seat 2: SantiagoWeight (small blind) folded before Flop
Seat 3: DetlefWD (big blind) collected ($5.83)
Seat 4: MAKSSSSSS72 folded before Flop (didn't bet)
Seat 5: LastNoma folded on the Turn
Seat 6: Guard poker folded before Flop (didn't bet)



PokerStars Zoom Hand #195024568173:  Hold'em No Limit ($0.10/$0.25) - 2018/12/29 4:43:52 UTC [2018/12/28 23:43:52 ET]
Table 'Hydra' 6-max Seat #1 is the button
Seat 1: SantiagoWeight ($21.49 in chips) 
Seat 2: hames_tj ($25.10 in chips) 
Seat 3: kurb1234 ($22.18 in chips) 
Seat 4: Chrimmpam ($18.81 in chips) 
Seat 5: Becks Baker ($27.35 in chips) 
Seat 6: papico3 ($25 in chips) 
hames_tj: posts small blind $0.10
kurb1234: posts big blind $0.25
*** HOLE CARDS ***
Dealt to SantiagoWeight [7s Qs]
Chrimmpam: folds 
Becks Baker: raises $0.37 to $0.62
papico3: folds 
SantiagoWeight: folds 
hames_tj: folds 
kurb1234: folds 
Uncalled bet ($0.37) returned to Becks Baker
Becks Baker collected $0.60 from pot
Becks Baker: doesn't show hand 
*** SUMMARY ***
Total pot $0.60 | Rake $0 
Seat 1: SantiagoWeight (button) folded before Flop (didn't bet)
Seat 2: hames_tj (small blind) folded before Flop
Seat 3: kurb1234 (big blind) folded before Flop
Seat 4: Chrimmpam folded before Flop (didn't bet)
Seat 5: Becks Baker collected ($0.60)
Seat 6: papico3 folded before Flop (didn't bet)



PokerStars Zoom Hand #195024573950:  Hold'em No Limit ($0.10/$0.25) - 2018/12/29 4:44:13 UTC [2018/12/28 23:44:13 ET]
Table 'Hydra' 6-max Seat #1 is the button
Seat 1: IMMPORT@L ($20.23 in chips) 
Seat 2: BRSOB79 ($49.10 in chips) 
Seat 3: crashbuum ($31.67 in chips) 
Seat 4: zaneti8722 ($9.34 in chips) 
Seat 5: graysonai ($34.93 in chips) 
Seat 6: SantiagoWeight ($25 in chips) 
BRSOB79: posts small blind $0.10
crashbuum: posts big blind $0.25
*** HOLE CARDS ***
Dealt to SantiagoWeight [6s 9c]
zaneti8722: folds 
graysonai: raises $0.30 to $0.55
SantiagoWeight: folds 
IMMPORT@L: folds 
BRSOB79: raises $1.95 to $2.50
crashbuum: folds 
graysonai: folds 
Uncalled bet ($1.95) returned to BRSOB79
BRSOB79 collected $1.35 from pot
BRSOB79: doesn't show hand 
*** SUMMARY ***
Total pot $1.35 | Rake $0 
Seat 1: IMMPORT@L (button) folded before Flop (didn't bet)
Seat 2: BRSOB79 (small blind) collected ($1.35)
Seat 3: crashbuum (big blind) folded before Flop
Seat 4: zaneti8722 folded before Flop (didn't bet)
Seat 5: graysonai folded before Flop
Seat 6: SantiagoWeight folded before Flop (didn't bet)



PokerStars Zoom Hand #195024581857:  Hold'em No Limit ($0.10/$0.25) - 2018/12/29 4:44:42 UTC [2018/12/28 23:44:42 ET]
Table 'Hydra' 6-max Seat #1 is the button
Seat 1: BADMEDICINEM ($21.52 in chips) 
Seat 2: ritchy99 ($20.90 in chips) 
Seat 3: SantiagoWeight ($24.90 in chips) 
Seat 4: zdenekstavic ($46.65 in chips) 
Seat 5: Nutselas ($94.10 in chips) 
Seat 6: papico3 ($26.27 in chips) 
ritchy99: posts small blind $0.10
SantiagoWeight: posts big blind $0.25
*** HOLE CARDS ***
Dealt to SantiagoWeight [5c Qd]
zdenekstavic: raises $0.25 to $0.50
Nutselas: folds 
papico3: folds 
BADMEDICINEM: folds 
ritchy99: folds 
SantiagoWeight: folds 
Uncalled bet ($0.25) returned to zdenekstavic
zdenekstavic collected $0.60 from pot
zdenekstavic: doesn't show hand 
*** SUMMARY ***
Total pot $0.60 | Rake $0 
Seat 1: BADMEDICINEM (button) folded before Flop (didn't bet)
Seat 2: ritchy99 (small blind) folded before Flop
Seat 3: SantiagoWeight (big blind) folded before Flop
Seat 4: zdenekstavic collected ($0.60)
Seat 5: Nutselas folded before Flop (didn't bet)
Seat 6: papico3 folded before Flop (didn't bet)



PokerStars Zoom Hand #195024572888:  Hold'em No Limit ($0.10/$0.25) - 2018/12/29 4:44:09 UTC [2018/12/28 23:44:09 ET]
Table 'Hydra' 6-max Seat #1 is the button
Seat 1: oksana12422 ($21.91 in chips) 
Seat 2: gustavotaina ($17.85 in chips) 
Seat 3: Virus3232 ($25 in chips) 
Seat 4: SantiagoWeight ($25 in chips) 
Seat 5: RESTRICTED.CR17 ($41.95 in chips) 
Seat 6: winwinboy ($25.25 in chips) 
gustavotaina: posts small blind $0.10
Virus3232: posts big blind $0.25
*** HOLE CARDS ***
Dealt to SantiagoWeight [2s Jh]
SantiagoWeight: folds 
RESTRICTED.CR17: raises $0.50 to $0.75
winwinboy: folds 
oksana12422: calls $0.75
gustavotaina: calls $0.65
Virus3232: raises $3 to $3.75
RESTRICTED.CR17: folds 
oksana12422: folds 
gustavotaina: raises $14.10 to $17.85 and is all-in
Virus3232: calls $14.10
*** FLOP *** [Td 9h 3c]
*** TURN *** [Td 9h 3c] [2c]
*** RIVER *** [Td 9h 3c 2c] [6h]
*** SHOW DOWN ***
gustavotaina: shows [Ks Ad] (high card Ace)
Virus3232: shows [Tc Qs] (a pair of Tens)
Virus3232 collected $35.53 from pot
*** SUMMARY ***
Total pot $37.20 | Rake $1.67 
Board [Td 9h 3c 2c 6h]
Seat 1: oksana12422 (button) folded before Flop
Seat 2: gustavotaina (small blind) showed [Ks Ad] and lost with high card Ace
Seat 3: Virus3232 (big blind) showed [Tc Qs] and won ($35.53) with a pair of Tens
Seat 4: SantiagoWeight folded before Flop (didn't bet)
Seat 5: RESTRICTED.CR17 folded before Flop
Seat 6: winwinboy folded before Flop (didn't bet)



PokerStars Zoom Hand #195024576375:  Hold'em No Limit ($0.10/$0.25) - 2018/12/29 4:44:22 UTC [2018/12/28 23:44:22 ET]
Table 'Hydra' 6-max Seat #1 is the button
Seat 1: hames_tj ($28.57 in chips) 
Seat 2: SantiagoWeight ($25 in chips) 
Seat 3: AVENTURICR ($25.68 in chips) 
Seat 4: doza123 ($12.55 in chips) 
Seat 5: mariopork ($25 in chips) 
Seat 6: MAKSSSSSS72 ($21.36 in chips) 
SantiagoWeight: posts small blind $0.10
AVENTURICR: posts big blind $0.25
*** HOLE CARDS ***
Dealt to SantiagoWeight [9s 8c]
doza123: calls $0.25
mariopork: raises $0.75 to $1
MAKSSSSSS72: folds 
hames_tj: folds 
SantiagoWeight: folds 
AVENTURICR: raises $0.75 to $1.75
doza123: folds 
mariopork: calls $0.75
*** FLOP *** [2d Ac 9d]
AVENTURICR: bets $1.84
mariopork: folds 
Uncalled bet ($1.84) returned to AVENTURICR
AVENTURICR collected $3.68 from pot
AVENTURICR: doesn't show hand 
*** SUMMARY ***
Total pot $3.85 | Rake $0.17 
Board [2d Ac 9d]
Seat 1: hames_tj (button) folded before Flop (didn't bet)
Seat 2: SantiagoWeight (small blind) folded before Flop
Seat 3: AVENTURICR (big blind) collected ($3.68)
Seat 4: doza123 folded before Flop
Seat 5: mariopork folded on the Flop
Seat 6: MAKSSSSSS72 folded before Flop (didn't bet)



PokerStars Zoom Hand #195024586794:  Hold'em No Limit ($0.10/$0.25) - 2018/12/29 4:45:00 UTC [2018/12/28 23:45:00 ET]
Table 'Hydra' 6-max Seat #1 is the button
Seat 1: SantiagoWeight ($24.65 in chips) 
Seat 2: Bonen18 ($25 in chips) 
Seat 3: mmeplamondon ($28.15 in chips) 
Seat 4: lauriña77 ($46.29 in chips) 
Seat 5: Nutselas ($69.06 in chips) 
Seat 6: MAKSSSSSS72 ($21.01 in chips) 
Bonen18: posts small blind $0.10
mmeplamondon: posts big blind $0.25
*** HOLE CARDS ***
Dealt to SantiagoWeight [Kc 5d]
lauriña77: folds 
Nutselas: folds 
MAKSSSSSS72: calls $0.25
SantiagoWeight: folds 
Bonen18: folds 
mmeplamondon: checks 
*** FLOP *** [8c 6c Ah]
mmeplamondon: checks 
MAKSSSSSS72: checks 
*** TURN *** [8c 6c Ah] [6d]
mmeplamondon: checks 
MAKSSSSSS72: checks 
*** RIVER *** [8c 6c Ah 6d] [Qc]
mmeplamondon: checks 
MAKSSSSSS72: checks 
*** SHOW DOWN ***
mmeplamondon: shows [8s 3s] (two pair, Eights and Sixes)
MAKSSSSSS72: mucks hand 
mmeplamondon collected $0.57 from pot
*** SUMMARY ***
Total pot $0.60 | Rake $0.03 
Board [8c 6c Ah 6d Qc]
Seat 1: SantiagoWeight (button) folded before Flop (didn't bet)
Seat 2: Bonen18 (small blind) folded before Flop
Seat 3: mmeplamondon (big blind) showed [8s 3s] and won ($0.57) with two pair, Eights and Sixes
Seat 4: lauriña77 folded before Flop (didn't bet)
Seat 5: Nutselas folded before Flop (didn't bet)
Seat 6: MAKSSSSSS72 mucked [2c 2h]



PokerStars Zoom Hand #195024584844:  Hold'em No Limit ($0.10/$0.25) - 2018/12/29 4:44:53 UTC [2018/12/28 23:44:53 ET]
Table 'Hydra' 6-max Seat #1 is the button
Seat 1: ryanking99 ($11.59 in chips) 
Seat 2: reetskeet ($68.76 in chips) 
Seat 3: JeDti ($34.18 in chips) 
Seat 4: mariopork ($39.48 in chips) 
Seat 5: SantiagoWeight ($24.65 in chips) 
Seat 6: Bonen18 ($66.64 in chips) 
reetskeet: posts small blind $0.10
JeDti: posts big blind $0.25
*** HOLE CARDS ***
Dealt to SantiagoWeight [2c 9c]
mariopork: folds 
SantiagoWeight: folds 
Bonen18: folds 
ryanking99: raises $0.31 to $0.56
reetskeet: calls $0.46
JeDti: calls $0.31
*** FLOP *** [Ad Kd 9h]
reetskeet: checks 
JeDti: checks 
ryanking99: checks 
*** TURN *** [Ad Kd 9h] [Ah]
reetskeet: bets $0.75
JeDti: calls $0.75
ryanking99: calls $0.75
*** RIVER *** [Ad Kd 9h Ah] [6d]
reetskeet: bets $3
JeDti: raises $12.19 to $15.19
ryanking99: folds 
reetskeet: calls $12.19
*** SHOW DOWN ***
JeDti: shows [As 8h] (three of a kind, Aces)
reetskeet: shows [Ac 6c] (a full house, Aces full of Sixes)
reetskeet collected $32.77 from pot
*** SUMMARY ***
Total pot $34.31 | Rake $1.54 
Board [Ad Kd 9h Ah 6d]
Seat 1: ryanking99 (button) folded on the River
Seat 2: reetskeet (small blind) showed [Ac 6c] and won ($32.77) with a full house, Aces full of Sixes
Seat 3: JeDti (big blind) showed [As 8h] and lost with three of a kind, Aces
Seat 4: mariopork folded before Flop (didn't bet)
Seat 5: SantiagoWeight folded before Flop (didn't bet)
Seat 6: Bonen18 folded before Flop (didn't bet)



PokerStars Zoom Hand #195024598146:  Hold'em No Limit ($0.10/$0.25) - 2018/12/29 4:45:42 UTC [2018/12/28 23:45:42 ET]
Table 'Hydra' 6-max Seat #1 is the button
Seat 1: koichi1210 ($25 in chips) 
Seat 2: SantiagoWeight ($24.65 in chips) 
Seat 3: GrandmasterY ($66.95 in chips) 
Seat 4: newbieforce ($25.80 in chips) 
Seat 5: reggiedogg31 ($115.75 in chips) 
Seat 6: hamen1990 ($29.46 in chips) 
SantiagoWeight: posts small blind $0.10
GrandmasterY: posts big blind $0.25
*** HOLE CARDS ***
Dealt to SantiagoWeight [5d Th]
newbieforce: folds 
reggiedogg31: folds 
hamen1990: raises $0.50 to $0.75
koichi1210: folds 
SantiagoWeight: folds 
GrandmasterY: folds 
Uncalled bet ($0.50) returned to hamen1990
hamen1990 collected $0.60 from pot
hamen1990: doesn't show hand 
*** SUMMARY ***
Total pot $0.60 | Rake $0 
Seat 1: koichi1210 (button) folded before Flop (didn't bet)
Seat 2: SantiagoWeight (small blind) folded before Flop
Seat 3: GrandmasterY (big blind) folded before Flop
Seat 4: newbieforce folded before Flop (didn't bet)
Seat 5: reggiedogg31 folded before Flop (didn't bet)
Seat 6: hamen1990 collected ($0.60)



PokerStars Zoom Hand #195024592703:  Hold'em No Limit ($0.10/$0.25) - 2018/12/29 4:45:22 UTC [2018/12/28 23:45:22 ET]
Table 'Hydra' 6-max Seat #1 is the button
Seat 1: hames_tj ($25.63 in chips) 
Seat 2: Viiiru ($33.52 in chips) 
Seat 3: tariko1980 ($7.26 in chips) 
Seat 4: SantiagoWeight ($24.65 in chips) 
Seat 5: Virus3232 ($42.58 in chips) 
Seat 6: AVENTURICR ($27.61 in chips) 
Viiiru: posts small blind $0.10
tariko1980: posts big blind $0.25
*** HOLE CARDS ***
Dealt to SantiagoWeight [4s 6h]
SantiagoWeight: folds 
Virus3232: folds 
AVENTURICR: folds 
hames_tj: folds 
Viiiru: raises $0.50 to $0.75
tariko1980: calls $0.50
*** FLOP *** [Ts 2d 5c]
Viiiru: bets $0.47
tariko1980: calls $0.47
*** TURN *** [Ts 2d 5c] [8c]
Viiiru: checks 
tariko1980: checks 
*** RIVER *** [Ts 2d 5c 8c] [4h]
Viiiru: bets $1.17
tariko1980: calls $1.17
*** SHOW DOWN ***
Viiiru: shows [Ah 5d] (a pair of Fives)
tariko1980: mucks hand 
Viiiru collected $4.56 from pot
*** SUMMARY ***
Total pot $4.78 | Rake $0.22 
Board [Ts 2d 5c 8c 4h]
Seat 1: hames_tj (button) folded before Flop (didn't bet)
Seat 2: Viiiru (small blind) showed [Ah 5d] and won ($4.56) with a pair of Fives
Seat 3: tariko1980 (big blind) mucked [7c 2h]
Seat 4: SantiagoWeight folded before Flop (didn't bet)
Seat 5: Virus3232 folded before Flop (didn't bet)
Seat 6: AVENTURICR folded before Flop (didn't bet)



PokerStars Zoom Hand #195024597062:  Hold'em No Limit ($0.10/$0.25) - 2018/12/29 4:45:38 UTC [2018/12/28 23:45:38 ET]
Table 'Hydra' 6-max Seat #1 is the button
Seat 1: hamen1990 ($29.46 in chips) 
Seat 2: urgok83 ($18.81 in chips) 
Seat 3: Suit3dGapp3r ($29.03 in chips) 
Seat 4: SantiagoWeight ($24.65 in chips) 
Seat 5: TQNYMQNTANA ($25 in chips) 
Seat 6: ARTBIL ($24.82 in chips) 
urgok83: posts small blind $0.10
Suit3dGapp3r: posts big blind $0.25
*** HOLE CARDS ***
Dealt to SantiagoWeight [6h Ad]
SantiagoWeight: folds 
TQNYMQNTANA: folds 
ARTBIL: raises $0.50 to $0.75
hamen1990: folds 
urgok83: calls $0.65
Suit3dGapp3r: folds 
*** FLOP *** [9h Js 8d]
urgok83: bets $0.75
ARTBIL: calls $0.75
*** TURN *** [9h Js 8d] [Jc]
urgok83: bets $1.50
ARTBIL: folds 
Uncalled bet ($1.50) returned to urgok83
urgok83 collected $3.10 from pot
urgok83: doesn't show hand 
*** SUMMARY ***
Total pot $3.25 | Rake $0.15 
Board [9h Js 8d Jc]
Seat 1: hamen1990 (button) folded before Flop (didn't bet)
Seat 2: urgok83 (small blind) collected ($3.10)
Seat 3: Suit3dGapp3r (big blind) folded before Flop
Seat 4: SantiagoWeight folded before Flop (didn't bet)
Seat 5: TQNYMQNTANA folded before Flop (didn't bet)
Seat 6: ARTBIL folded on the Turn



PokerStars Zoom Hand #195024601879:  Hold'em No Limit ($0.10/$0.25) - 2018/12/29 4:45:56 UTC [2018/12/28 23:45:56 ET]
Table 'Hydra' 6-max Seat #1 is the button
Seat 1: mariopork ($25.66 in chips) 
Seat 2: 905steelcity ($16.67 in chips) 
Seat 3: Doomdigidoom ($41.68 in chips) 
Seat 4: Higashi2314 ($28.47 in chips) 
Seat 5: JeDti ($25 in chips) 
Seat 6: SantiagoWeight ($24.55 in chips) 
905steelcity: posts small blind $0.10
Doomdigidoom: posts big blind $0.25
*** HOLE CARDS ***
Dealt to SantiagoWeight [8c Jh]
Higashi2314: folds 
JeDti: folds 
SantiagoWeight: folds 
mariopork: folds 
905steelcity: raises $0.50 to $0.75
Doomdigidoom: calls $0.50
*** FLOP *** [9s Tc 5s]
905steelcity: bets $1
Doomdigidoom: calls $1
*** TURN *** [9s Tc 5s] [Js]
905steelcity: bets $1.25
Doomdigidoom: calls $1.25
*** RIVER *** [9s Tc 5s Js] [4s]
905steelcity: checks 
Doomdigidoom: checks 
*** SHOW DOWN ***
905steelcity: shows [Kh Kd] (a pair of Kings)
Doomdigidoom: mucks hand 
905steelcity collected $5.73 from pot
*** SUMMARY ***
Total pot $6 | Rake $0.27 
Board [9s Tc 5s Js 4s]
Seat 1: mariopork (button) folded before Flop (didn't bet)
Seat 2: 905steelcity (small blind) showed [Kh Kd] and won ($5.73) with a pair of Kings
Seat 3: Doomdigidoom (big blind) mucked [7c 9c]
Seat 4: Higashi2314 folded before Flop (didn't bet)
Seat 5: JeDti folded before Flop (didn't bet)
Seat 6: SantiagoWeight folded before Flop (didn't bet)



PokerStars Zoom Hand #195024606198:  Hold'em No Limit ($0.10/$0.25) - 2018/12/29 4:46:12 UTC [2018/12/28 23:46:12 ET]
Table 'Hydra' 6-max Seat #1 is the button
Seat 1: bigpower629 ($25.60 in chips) 
Seat 2: Nutselas ($69.16 in chips) 
Seat 3: SantiagoWeight ($24.55 in chips) 
Seat 4: GrandmasterY ($66.70 in chips) 
Seat 5: alex3d1985 ($33.08 in chips) 
Seat 6: xman141 ($94.15 in chips) 
Nutselas: posts small blind $0.10
SantiagoWeight: posts big blind $0.25
*** HOLE CARDS ***
Dealt to SantiagoWeight [Jh 7h]
GrandmasterY: folds 
alex3d1985: folds 
xman141: folds 
bigpower629: folds 
Nutselas: raises $0.63 to $0.88
SantiagoWeight: folds 
Uncalled bet ($0.63) returned to Nutselas
Nutselas collected $0.50 from pot
*** SUMMARY ***
Total pot $0.50 | Rake $0 
Seat 1: bigpower629 (button) folded before Flop (didn't bet)
Seat 2: Nutselas (small blind) collected ($0.50)
Seat 3: SantiagoWeight (big blind) folded before Flop
Seat 4: GrandmasterY folded before Flop (didn't bet)
Seat 5: alex3d1985 folded before Flop (didn't bet)
Seat 6: xman141 folded before Flop (didn't bet)



PokerStars Zoom Hand #195024604056:  Hold'em No Limit ($0.10/$0.25) - 2018/12/29 4:46:04 UTC [2018/12/28 23:46:04 ET]
Table 'Hydra' 6-max Seat #1 is the button
Seat 1: GrandmasterY ($28.62 in chips) 
Seat 2: Gonzalit0o ($46.78 in chips) 
Seat 3: Bonen18 ($25.70 in chips) 
Seat 4: ivann14 ($33.51 in chips) 
Seat 5: SantiagoWeight ($24.55 in chips) 
Seat 6: Nutselas ($25.35 in chips) 
Gonzalit0o: posts small blind $0.10
Bonen18: posts big blind $0.25
*** HOLE CARDS ***
Dealt to SantiagoWeight [6c 8d]
ivann14: raises $0.50 to $0.75
SantiagoWeight: folds 
Nutselas: raises $1.50 to $2.25
GrandmasterY: folds 
Gonzalit0o: folds 
Bonen18: folds 
ivann14: calls $1.50
*** FLOP *** [7c 7h 8c]
ivann14: checks 
Nutselas: checks 
*** TURN *** [7c 7h 8c] [5d]
ivann14: bets $1.53
Nutselas: folds 
Uncalled bet ($1.53) returned to ivann14
ivann14 collected $4.63 from pot
ivann14: doesn't show hand 
*** SUMMARY ***
Total pot $4.85 | Rake $0.22 
Board [7c 7h 8c 5d]
Seat 1: GrandmasterY (button) folded before Flop (didn't bet)
Seat 2: Gonzalit0o (small blind) folded before Flop
Seat 3: Bonen18 (big blind) folded before Flop
Seat 4: ivann14 collected ($4.63)
Seat 5: SantiagoWeight folded before Flop (didn't bet)
Seat 6: Nutselas folded on the Turn



PokerStars Zoom Hand #195024612251:  Hold'em No Limit ($0.10/$0.25) - 2018/12/29 4:46:34 UTC [2018/12/28 23:46:34 ET]
Table 'Hydra' 6-max Seat #1 is the button
Seat 1: SantiagoWeight ($24.30 in chips) 
Seat 2: Buntar017 ($34.36 in chips) 
Seat 3: Chrimmpam ($18.54 in chips) 
Seat 4: winwinboy ($25 in chips) 
Seat 5: Thermal0007 ($21.53 in chips) 
Seat 6: doza123 ($12.47 in chips) 
Buntar017: posts small blind $0.10
Chrimmpam: posts big blind $0.25
*** HOLE CARDS ***
Dealt to SantiagoWeight [Ad 6s]
winwinboy: folds 
Thermal0007: folds 
doza123: folds 
SantiagoWeight: raises $0.30 to $0.55
Buntar017: raises $0.30 to $0.85
Chrimmpam: folds 
SantiagoWeight: calls $0.30
*** FLOP *** [2h Td Ks]
Buntar017: bets $1
SantiagoWeight: folds 
Uncalled bet ($1) returned to Buntar017
Buntar017 collected $1.86 from pot
Buntar017: doesn't show hand 
*** SUMMARY ***
Total pot $1.95 | Rake $0.09 
Board [2h Td Ks]
Seat 1: SantiagoWeight (button) folded on the Flop
Seat 2: Buntar017 (small blind) collected ($1.86)
Seat 3: Chrimmpam (big blind) folded before Flop
Seat 4: winwinboy folded before Flop (didn't bet)
Seat 5: Thermal0007 folded before Flop (didn't bet)
Seat 6: doza123 folded before Flop (didn't bet)



PokerStars Zoom Hand #195024624587:  Hold'em No Limit ($0.10/$0.25) - 2018/12/29 4:47:19 UTC [2018/12/28 23:47:19 ET]
Table 'Hydra' 6-max Seat #1 is the button
Seat 1: sikach78 ($24.69 in chips) 
Seat 2: dawwwid70 ($45.28 in chips) 
Seat 3: asapon ($33.22 in chips) 
Seat 4: BADMEDICINEM ($17.02 in chips) 
Seat 5: labattblu ($16.76 in chips) 
Seat 6: SantiagoWeight ($23.45 in chips) 
dawwwid70: posts small blind $0.10
asapon: posts big blind $0.25
*** HOLE CARDS ***
Dealt to SantiagoWeight [Td 4c]
BADMEDICINEM: folds 
labattblu: raises $0.50 to $0.75
SantiagoWeight has timed out
SantiagoWeight: folds 
sikach78: folds 
dawwwid70: folds 
asapon: folds 
Uncalled bet ($0.50) returned to labattblu
labattblu collected $0.60 from pot
labattblu: doesn't show hand 
*** SUMMARY ***
Total pot $0.60 | Rake $0 
Seat 1: sikach78 (button) folded before Flop (didn't bet)
Seat 2: dawwwid70 (small blind) folded before Flop
Seat 3: asapon (big blind) folded before Flop
Seat 4: BADMEDICINEM folded before Flop (didn't bet)
Seat 5: labattblu collected ($0.60)
Seat 6: SantiagoWeight folded before Flop (didn't bet)



PokerStars Zoom Hand #195024651000:  Hold'em No Limit ($0.10/$0.25) - 2018/12/29 4:48:55 UTC [2018/12/28 23:48:55 ET]
Table 'Hydra' 6-max Seat #1 is the button
Seat 1: Pardaroxon ($25.10 in chips) 
Seat 2: SantiagoWeight ($23.45 in chips) 
Seat 3: hames_tj ($26.95 in chips) 
Seat 4: ryanking99 ($47.45 in chips) 
Seat 5: Nutselas ($94.58 in chips) 
Seat 6: TQNYMQNTANA ($57.27 in chips) 
SantiagoWeight: posts small blind $0.10
hames_tj: posts big blind $0.25
*** HOLE CARDS ***
Dealt to SantiagoWeight [9c 2c]
ryanking99: raises $0.60 to $0.85
Nutselas: folds 
TQNYMQNTANA: folds 
Pardaroxon: folds 
SantiagoWeight: folds 
hames_tj: folds 
Uncalled bet ($0.60) returned to ryanking99
ryanking99 collected $0.60 from pot
ryanking99: doesn't show hand 
*** SUMMARY ***
Total pot $0.60 | Rake $0 
Seat 1: Pardaroxon (button) folded before Flop (didn't bet)
Seat 2: SantiagoWeight (small blind) folded before Flop
Seat 3: hames_tj (big blind) folded before Flop
Seat 4: ryanking99 collected ($0.60)
Seat 5: Nutselas folded before Flop (didn't bet)
Seat 6: TQNYMQNTANA folded before Flop (didn't bet)



PokerStars Zoom Hand #195024654324:  Hold'em No Limit ($0.10/$0.25) - 2018/12/29 4:49:07 UTC [2018/12/28 23:49:07 ET]
Table 'Hydra' 6-max Seat #1 is the button
Seat 1: alex3d1985 ($29.43 in chips) 
Seat 2: Virus3232 ($40.67 in chips) 
Seat 3: SantiagoWeight ($23.35 in chips) 
Seat 4: ARTBIL ($27.71 in chips) 
Seat 5: MAKSSSSSS72 ($53.09 in chips) 
Seat 6: Chrimmpam ($30.98 in chips) 
Virus3232: posts small blind $0.10
SantiagoWeight: posts big blind $0.25
*** HOLE CARDS ***
Dealt to SantiagoWeight [6d 7s]
ARTBIL: raises $0.50 to $0.75
MAKSSSSSS72: raises $1.85 to $2.60
Chrimmpam: folds 
alex3d1985: folds 
Virus3232: folds 
SantiagoWeight: folds 
ARTBIL: calls $1.85
*** FLOP *** [2h Ac 5s]
ARTBIL: checks 
MAKSSSSSS72: bets $5.25
ARTBIL: folds 
Uncalled bet ($5.25) returned to MAKSSSSSS72
MAKSSSSSS72 collected $5.30 from pot
MAKSSSSSS72: doesn't show hand 
*** SUMMARY ***
Total pot $5.55 | Rake $0.25 
Board [2h Ac 5s]
Seat 1: alex3d1985 (button) folded before Flop (didn't bet)
Seat 2: Virus3232 (small blind) folded before Flop
Seat 3: SantiagoWeight (big blind) folded before Flop
Seat 4: ARTBIL folded on the Flop
Seat 5: MAKSSSSSS72 collected ($5.30)
Seat 6: Chrimmpam folded before Flop (didn't bet)



PokerStars Zoom Hand #195024659193:  Hold'em No Limit ($0.10/$0.25) - 2018/12/29 4:49:25 UTC [2018/12/28 23:49:25 ET]
Table 'Hydra' 6-max Seat #1 is the button
Seat 1: Rika_run ($27.27 in chips) 
Seat 2: GrandmasterY ($25 in chips) 
Seat 3: Viiiru ($33.76 in chips) 
Seat 4: know you cry ($7.85 in chips) 
Seat 5: SantiagoWeight ($23.10 in chips) 
Seat 6: Elapostador33 ($38.99 in chips) 
GrandmasterY: posts small blind $0.10
Viiiru: posts big blind $0.25
*** HOLE CARDS ***
Dealt to SantiagoWeight [6c 7c]
know you cry: folds 
SantiagoWeight: folds 
Elapostador33: folds 
Rika_run: raises $0.32 to $0.57
GrandmasterY: raises $2.13 to $2.70
Viiiru: folds 
Rika_run: calls $2.13
*** FLOP *** [2s Ac 4h]
GrandmasterY: bets $2.16
Rika_run: folds 
Uncalled bet ($2.16) returned to GrandmasterY
GrandmasterY collected $5.40 from pot
GrandmasterY: doesn't show hand 
*** SUMMARY ***
Total pot $5.65 | Rake $0.25 
Board [2s Ac 4h]
Seat 1: Rika_run (button) folded on the Flop
Seat 2: GrandmasterY (small blind) collected ($5.40)
Seat 3: Viiiru (big blind) folded before Flop
Seat 4: know you cry folded before Flop (didn't bet)
Seat 5: SantiagoWeight folded before Flop (didn't bet)
Seat 6: Elapostador33 folded before Flop (didn't bet)



PokerStars Zoom Hand #195024668923:  Hold'em No Limit ($0.10/$0.25) - 2018/12/29 4:50:01 UTC [2018/12/28 23:50:01 ET]
Table 'Hydra' 6-max Seat #1 is the button
Seat 1: KAOS914 ($24 in chips) 
Seat 2: ARTBIL ($24.86 in chips) 
Seat 3: BADMEDICINEM ($20.44 in chips) 
Seat 4: SantiagoWeight ($23.10 in chips) 
Seat 5: dawwwid70 ($25.01 in chips) 
Seat 6: Pardaroxon ($48.46 in chips) 
ARTBIL: posts small blind $0.10
BADMEDICINEM: posts big blind $0.25
*** HOLE CARDS ***
Dealt to SantiagoWeight [Jh 9d]
SantiagoWeight: folds 
dawwwid70: folds 
Pardaroxon: folds 
KAOS914: folds 
ARTBIL: folds 
Uncalled bet ($0.15) returned to BADMEDICINEM
BADMEDICINEM collected $0.20 from pot
BADMEDICINEM: doesn't show hand 
*** SUMMARY ***
Total pot $0.20 | Rake $0 
Seat 1: KAOS914 (button) folded before Flop (didn't bet)
Seat 2: ARTBIL (small blind) folded before Flop
Seat 3: BADMEDICINEM (big blind) collected ($0.20)
Seat 4: SantiagoWeight folded before Flop (didn't bet)
Seat 5: dawwwid70 folded before Flop (didn't bet)
Seat 6: Pardaroxon folded before Flop (didn't bet)



PokerStars Zoom Hand #195024653247:  Hold'em No Limit ($0.10/$0.25) - 2018/12/29 4:49:03 UTC [2018/12/28 23:49:03 ET]
Table 'Hydra' 6-max Seat #1 is the button
Seat 1: Rika_run ($29.58 in chips) 
Seat 2: zaneti8722 ($6.77 in chips) 
Seat 3: graysonai ($34.45 in chips) 
Seat 4: SantiagoWeight ($23.35 in chips) 
Seat 5: dk dreadlook ($37.51 in chips) 
Seat 6: Suit3dGapp3r ($33.24 in chips) 
zaneti8722: posts small blind $0.10
graysonai: posts big blind $0.25
*** HOLE CARDS ***
Dealt to SantiagoWeight [3c 4s]
SantiagoWeight: folds 
dk dreadlook: calls $0.25
Suit3dGapp3r: folds 
Rika_run: calls $0.25
zaneti8722: folds 
graysonai: checks 
*** FLOP *** [Kh Jh 9c]
graysonai: checks 
dk dreadlook: bets $0.75
Rika_run: calls $0.75
graysonai: folds 
*** TURN *** [Kh Jh 9c] [2h]
dk dreadlook: checks 
Rika_run: bets $1.68
dk dreadlook: folds 
Uncalled bet ($1.68) returned to Rika_run
Rika_run collected $2.24 from pot
Rika_run: doesn't show hand 
*** SUMMARY ***
Total pot $2.35 | Rake $0.11 
Board [Kh Jh 9c 2h]
Seat 1: Rika_run (button) collected ($2.24)
Seat 2: zaneti8722 (small blind) folded before Flop
Seat 3: graysonai (big blind) folded on the Flop
Seat 4: SantiagoWeight folded before Flop (didn't bet)
Seat 5: dk dreadlook folded on the Turn
Seat 6: Suit3dGapp3r folded before Flop (didn't bet)



PokerStars Zoom Hand #195024676937:  Hold'em No Limit ($0.10/$0.25) - 2018/12/29 4:50:31 UTC [2018/12/28 23:50:31 ET]
Table 'Hydra' 6-max Seat #1 is the button
Seat 1: Chrimmpam ($11.47 in chips) 
Seat 2: Becks Baker ($28.56 in chips) 
Seat 3: reetskeet ($85.03 in chips) 
Seat 4: Rika_run ($25.35 in chips) 
Seat 5: SantiagoWeight ($23 in chips) 
Seat 6: fedextw0522 ($19.50 in chips) 
Becks Baker: posts small blind $0.10
reetskeet: posts big blind $0.25
*** HOLE CARDS ***
Dealt to SantiagoWeight [4d 6d]
Rika_run: folds 
SantiagoWeight: folds 
fedextw0522: folds 
Chrimmpam: folds 
Becks Baker: folds 
Uncalled bet ($0.15) returned to reetskeet
reetskeet collected $0.20 from pot
reetskeet: doesn't show hand 
*** SUMMARY ***
Total pot $0.20 | Rake $0 
Seat 1: Chrimmpam (button) folded before Flop (didn't bet)
Seat 2: Becks Baker (small blind) folded before Flop
Seat 3: reetskeet (big blind) collected ($0.20)
Seat 4: Rika_run folded before Flop (didn't bet)
Seat 5: SantiagoWeight folded before Flop (didn't bet)
Seat 6: fedextw0522 folded before Flop (didn't bet)



PokerStars Zoom Hand #195024675574:  Hold'em No Limit ($0.10/$0.25) - 2018/12/29 4:50:26 UTC [2018/12/28 23:50:26 ET]
Table 'Hydra' 6-max Seat #1 is the button
Seat 1: GQwang ($42.55 in chips) 
Seat 2: BADMEDICINEM ($35.81 in chips) 
Seat 3: ryanking99 ($44.12 in chips) 
Seat 4: TQNYMQNTANA ($55.07 in chips) 
Seat 5: reggiedogg31 ($115.83 in chips) 
Seat 6: SantiagoWeight ($23 in chips) 
BADMEDICINEM: posts small blind $0.10
ryanking99: posts big blind $0.25
*** HOLE CARDS ***
Dealt to SantiagoWeight [Tc 3h]
TQNYMQNTANA: folds 
reggiedogg31: folds 
SantiagoWeight: folds 
GQwang: raises $0.50 to $0.75
BADMEDICINEM: folds 
ryanking99: raises $2 to $2.75
GQwang: folds 
Uncalled bet ($2) returned to ryanking99
ryanking99 collected $1.60 from pot
ryanking99: doesn't show hand 
*** SUMMARY ***
Total pot $1.60 | Rake $0 
Seat 1: GQwang (button) folded before Flop
Seat 2: BADMEDICINEM (small blind) folded before Flop
Seat 3: ryanking99 (big blind) collected ($1.60)
Seat 4: TQNYMQNTANA folded before Flop (didn't bet)
Seat 5: reggiedogg31 folded before Flop (didn't bet)
Seat 6: SantiagoWeight folded before Flop (didn't bet)



PokerStars Zoom Hand #195024677993:  Hold'em No Limit ($0.10/$0.25) - 2018/12/29 4:50:35 UTC [2018/12/28 23:50:35 ET]
Table 'Hydra' 6-max Seat #1 is the button
Seat 1: oksana12422 ($14.89 in chips) 
Seat 2: Pardaroxon ($49.48 in chips) 
Seat 3: IMMPORT@L ($15.42 in chips) 
Seat 4: urgok83 ($20.97 in chips) 
Seat 5: lauriña77 ($36.96 in chips) 
Seat 6: SantiagoWeight ($23 in chips) 
Pardaroxon: posts small blind $0.10
IMMPORT@L: posts big blind $0.25
*** HOLE CARDS ***
Dealt to SantiagoWeight [9s Qd]
urgok83: folds 
lauriña77: folds 
SantiagoWeight: raises $0.30 to $0.55
oksana12422: raises $1.45 to $2
Pardaroxon: folds 
IMMPORT@L: folds 
SantiagoWeight: folds 
Uncalled bet ($1.45) returned to oksana12422
oksana12422 collected $1.45 from pot
oksana12422: doesn't show hand 
*** SUMMARY ***
Total pot $1.45 | Rake $0 
Seat 1: oksana12422 (button) collected ($1.45)
Seat 2: Pardaroxon (small blind) folded before Flop
Seat 3: IMMPORT@L (big blind) folded before Flop
Seat 4: urgok83 folded before Flop (didn't bet)
Seat 5: lauriña77 folded before Flop (didn't bet)
Seat 6: SantiagoWeight folded before Flop



PokerStars Zoom Hand #195024662983:  Hold'em No Limit ($0.10/$0.25) - 2018/12/29 4:49:39 UTC [2018/12/28 23:49:39 ET]
Table 'Hydra' 6-max Seat #1 is the button
Seat 1: SantiagoWeight ($23.10 in chips) 
Seat 2: mariopork ($37.61 in chips) 
Seat 3: MAKSSSSSS72 ($55.79 in chips) 
Seat 4: winwinboy ($29.07 in chips) 
Seat 5: _BluDeeN_ ($25 in chips) 
Seat 6: ricpoitras ($27 in chips) 
mariopork: posts small blind $0.10
MAKSSSSSS72: posts big blind $0.25
*** HOLE CARDS ***
Dealt to SantiagoWeight [Ac 9h]
winwinboy: folds 
_BluDeeN_: raises $0.50 to $0.75
ricpoitras: raises $1.50 to $2.25
SantiagoWeight: folds 
mariopork: folds 
MAKSSSSSS72: folds 
_BluDeeN_: calls $1.50
*** FLOP *** [Kc As Th]
_BluDeeN_: checks 
ricpoitras: bets $1.57
_BluDeeN_: raises $2.68 to $4.25
ricpoitras: calls $2.68
*** TURN *** [Kc As Th] [Ts]
_BluDeeN_: bets $6.25
ricpoitras: raises $14.25 to $20.50 and is all-in
_BluDeeN_: calls $12.25 and is all-in
Uncalled bet ($2) returned to ricpoitras
*** FIRST RIVER *** [Kc As Th Ts] [7d]
*** SECOND RIVER *** [Kc As Th Ts] [Qc]
*** FIRST SHOW DOWN ***
_BluDeeN_: shows [Td Tc] (four of a kind, Tens)
ricpoitras: shows [Kh Ad] (two pair, Aces and Kings)
_BluDeeN_ collected $24.18 from pot
*** SECOND SHOW DOWN ***
_BluDeeN_: shows [Td Tc] (four of a kind, Tens)
ricpoitras: shows [Kh Ad] (two pair, Aces and Kings)
_BluDeeN_ collected $24.17 from pot
*** SUMMARY ***
Total pot $50.35 | Rake $2 
Hand was run twice
FIRST Board [Kc As Th Ts 7d]
SECOND Board [Kc As Th Ts Qc]
Seat 1: SantiagoWeight (button) folded before Flop (didn't bet)
Seat 2: mariopork (small blind) folded before Flop
Seat 3: MAKSSSSSS72 (big blind) folded before Flop
Seat 4: winwinboy folded before Flop (didn't bet)
Seat 5: _BluDeeN_ showed [Td Tc] and won ($24.18) with four of a kind, Tens, and won ($24.17) with four of a kind, Tens
Seat 6: ricpoitras showed [Kh Ad] and lost with two pair, Aces and Kings, and lost with two pair, Aces and Kings



PokerStars Zoom Hand #195024669963:  Hold'em No Limit ($0.10/$0.25) - 2018/12/29 4:50:05 UTC [2018/12/28 23:50:05 ET]
Table 'Hydra' 6-max Seat #1 is the button
Seat 1: winwinboy ($25.66 in chips) 
Seat 2: SantiagoWeight ($23.10 in chips) 
Seat 3: Gonzalit0o ($43.90 in chips) 
Seat 4: simy96704 ($5 in chips) 
Seat 5: mariopork ($125.41 in chips) 
Seat 6: Chrimmpam ($33.45 in chips) 
SantiagoWeight: posts small blind $0.10
Gonzalit0o: posts big blind $0.25
*** HOLE CARDS ***
Dealt to SantiagoWeight [4h 8c]
simy96704: calls $0.25
mariopork: calls $0.25
Chrimmpam: folds 
winwinboy: raises $1.25 to $1.50
SantiagoWeight: folds 
Gonzalit0o: folds 
simy96704: raises $1.25 to $2.75
mariopork: folds 
winwinboy: raises $1.25 to $4
simy96704: calls $1.25
*** FLOP *** [Ad 8s 7h]
simy96704: bets $0.25
winwinboy: raises $0.25 to $0.50
simy96704: calls $0.25
*** TURN *** [Ad 8s 7h] [As]
simy96704: checks 
winwinboy: bets $9.35
simy96704: calls $0.50 and is all-in
Uncalled bet ($8.85) returned to winwinboy
*** RIVER *** [Ad 8s 7h As] [3h]
*** SHOW DOWN ***
simy96704: shows [6d 9h] (a pair of Aces)
winwinboy: shows [Ac Qs] (three of a kind, Aces)
winwinboy collected $10.12 from pot
*** SUMMARY ***
Total pot $10.60 | Rake $0.48 
Board [Ad 8s 7h As 3h]
Seat 1: winwinboy (button) showed [Ac Qs] and won ($10.12) with three of a kind, Aces
Seat 2: SantiagoWeight (small blind) folded before Flop
Seat 3: Gonzalit0o (big blind) folded before Flop
Seat 4: simy96704 showed [6d 9h] and lost with a pair of Aces
Seat 5: mariopork folded before Flop
Seat 6: Chrimmpam folded before Flop (didn't bet)



PokerStars Zoom Hand #195024686503:  Hold'em No Limit ($0.10/$0.25) - 2018/12/29 4:51:07 UTC [2018/12/28 23:51:07 ET]
Table 'Hydra' 6-max Seat #1 is the button
Seat 1: !P0K3RM3T4L! ($27.02 in chips) 
Seat 2: GrandmasterY ($26.95 in chips) 
Seat 3: SantiagoWeight ($22.45 in chips) 
Seat 4: reggiedogg31 ($110.72 in chips) 
Seat 5: asapon ($25.35 in chips) 
Seat 6: mmeplamondon ($38.88 in chips) 
GrandmasterY: posts small blind $0.10
SantiagoWeight: posts big blind $0.25
*** HOLE CARDS ***
Dealt to SantiagoWeight [Tc 6c]
reggiedogg31: folds 
asapon: folds 
mmeplamondon: folds 
!P0K3RM3T4L!: folds 
GrandmasterY: raises $0.50 to $0.75
SantiagoWeight: calls $0.50
*** FLOP *** [Th Ts 9d]
GrandmasterY: bets $0.43
SantiagoWeight: calls $0.43
*** TURN *** [Th Ts 9d] [6d]
GrandmasterY: bets $1
SantiagoWeight: calls $1
*** RIVER *** [Th Ts 9d 6d] [Qs]
GrandmasterY: checks 
SantiagoWeight: bets $2.77
GrandmasterY: calls $2.77
*** SHOW DOWN ***
SantiagoWeight: shows [Tc 6c] (a full house, Tens full of Sixes)
GrandmasterY: mucks hand 
SantiagoWeight collected $9.45 from pot
*** SUMMARY ***
Total pot $9.90 | Rake $0.45 
Board [Th Ts 9d 6d Qs]
Seat 1: !P0K3RM3T4L! (button) folded before Flop (didn't bet)
Seat 2: GrandmasterY (small blind) mucked [Js Jh]
Seat 3: SantiagoWeight (big blind) showed [Tc 6c] and won ($9.45) with a full house, Tens full of Sixes
Seat 4: reggiedogg31 folded before Flop (didn't bet)
Seat 5: asapon folded before Flop (didn't bet)
Seat 6: mmeplamondon folded before Flop (didn't bet)



PokerStars Zoom Hand #195024715608:  Hold'em No Limit ($0.10/$0.25) - 2018/12/29 4:52:58 UTC [2018/12/28 23:52:58 ET]
Table 'Hydra' 6-max Seat #1 is the button
Seat 1: SantiagoWeight ($26.95 in chips) 
Seat 2: JeDti ($43.98 in chips) 
Seat 3: LastNoma ($45.98 in chips) 
Seat 4: newbieforce ($27.56 in chips) 
Seat 5: Lehared ($0.58 in chips) 
Seat 6: G ster24 ($48.16 in chips) 
JeDti: posts small blind $0.10
LastNoma: posts big blind $0.25
*** HOLE CARDS ***
Dealt to SantiagoWeight [4d 6c]
newbieforce: raises $0.25 to $0.50
Lehared: folds 
G ster24: folds 
SantiagoWeight: folds 
JeDti: calls $0.40
LastNoma: calls $0.25
*** FLOP *** [8d 3c 5s]
JeDti: checks 
LastNoma: checks 
newbieforce: bets $1.43
JeDti: calls $1.43
LastNoma: folds 
*** TURN *** [8d 3c 5s] [3s]
JeDti: checks 
newbieforce: bets $4.16
JeDti: folds 
Uncalled bet ($4.16) returned to newbieforce
newbieforce collected $4.16 from pot
newbieforce: doesn't show hand 
*** SUMMARY ***
Total pot $4.36 | Rake $0.20 
Board [8d 3c 5s 3s]
Seat 1: SantiagoWeight (button) folded before Flop (didn't bet)
Seat 2: JeDti (small blind) folded on the Turn
Seat 3: LastNoma (big blind) folded on the Flop
Seat 4: newbieforce collected ($4.16)
Seat 5: Lehared folded before Flop (didn't bet)
Seat 6: G ster24 folded before Flop (didn't bet)



PokerStars Zoom Hand #195024717396:  Hold'em No Limit ($0.10/$0.25) - 2018/12/29 4:53:05 UTC [2018/12/28 23:53:05 ET]
Table 'Hydra' 6-max Seat #1 is the button
Seat 1: asapon ($25 in chips) 
Seat 2: amansah ($26.81 in chips) 
Seat 3: koichi1210 ($24.77 in chips) 
Seat 4: Buntar017 ($59.96 in chips) 
Seat 5: SantiagoWeight ($26.95 in chips) 
Seat 6: labattblu ($15.82 in chips) 
amansah: posts small blind $0.10
koichi1210: posts big blind $0.25
*** HOLE CARDS ***
Dealt to SantiagoWeight [Qs 5h]
Buntar017: calls $0.25
SantiagoWeight: folds 
labattblu: folds 
asapon: folds 
amansah: folds 
koichi1210: checks 
*** FLOP *** [2s 6d 9h]
koichi1210: checks 
Buntar017: checks 
*** TURN *** [2s 6d 9h] [9d]
koichi1210: bets $0.25
Buntar017: calls $0.25
*** RIVER *** [2s 6d 9h 9d] [3c]
koichi1210: checks 
Buntar017: bets $1
koichi1210: calls $1
*** SHOW DOWN ***
Buntar017: shows [3s Ah] (two pair, Nines and Threes)
koichi1210: shows [6h Kd] (two pair, Nines and Sixes)
koichi1210 collected $2.96 from pot
*** SUMMARY ***
Total pot $3.10 | Rake $0.14 
Board [2s 6d 9h 9d 3c]
Seat 1: asapon (button) folded before Flop (didn't bet)
Seat 2: amansah (small blind) folded before Flop
Seat 3: koichi1210 (big blind) showed [6h Kd] and won ($2.96) with two pair, Nines and Sixes
Seat 4: Buntar017 showed [3s Ah] and lost with two pair, Nines and Threes
Seat 5: SantiagoWeight folded before Flop (didn't bet)
Seat 6: labattblu folded before Flop (didn't bet)



PokerStars Zoom Hand #195024719174:  Hold'em No Limit ($0.10/$0.25) - 2018/12/29 4:53:12 UTC [2018/12/28 23:53:12 ET]
Table 'Hydra' 6-max Seat #1 is the button
Seat 1: graysonai ($68.82 in chips) 
Seat 2: SantiagoWeight ($26.95 in chips) 
Seat 3: crashbuum ($20.64 in chips) 
Seat 4: trillerGTO ($24.85 in chips) 
Seat 5: asapon ($25 in chips) 
Seat 6: papico3 ($26.25 in chips) 
SantiagoWeight: posts small blind $0.10
crashbuum: posts big blind $0.25
*** HOLE CARDS ***
Dealt to SantiagoWeight [Qh 3c]
trillerGTO: raises $0.50 to $0.75
asapon: folds 
papico3: folds 
graysonai: folds 
SantiagoWeight: folds 
crashbuum: calls $0.50
*** FLOP *** [Ks Kd 2c]
crashbuum: bets $0.77
trillerGTO: calls $0.77
*** TURN *** [Ks Kd 2c] [9d]
crashbuum: bets $1.50
trillerGTO: calls $1.50
*** RIVER *** [Ks Kd 2c 9d] [2h]
crashbuum: checks 
trillerGTO: checks 
*** SHOW DOWN ***
crashbuum: shows [Td Qd] (two pair, Kings and Deuces)
trillerGTO: shows [Ad 8d] (two pair, Kings and Deuces - Ace kicker)
trillerGTO collected $5.86 from pot
*** SUMMARY ***
Total pot $6.14 | Rake $0.28 
Board [Ks Kd 2c 9d 2h]
Seat 1: graysonai (button) folded before Flop (didn't bet)
Seat 2: SantiagoWeight (small blind) folded before Flop
Seat 3: crashbuum (big blind) showed [Td Qd] and lost with two pair, Kings and Deuces
Seat 4: trillerGTO showed [Ad 8d] and won ($5.86) with two pair, Kings and Deuces
Seat 5: asapon folded before Flop (didn't bet)
Seat 6: papico3 folded before Flop (didn't bet)



PokerStars Zoom Hand #195024720797:  Hold'em No Limit ($0.10/$0.25) - 2018/12/29 4:53:18 UTC [2018/12/28 23:53:18 ET]
Table 'Hydra' 6-max Seat #1 is the button
Seat 1: SantiagoWeight ($26.85 in chips) 
Seat 2: davidhw888 ($27.54 in chips) 
Seat 3: ivann14 ($39.03 in chips) 
Seat 4: papico3 ($26.25 in chips) 
Seat 5: JeDti ($25 in chips) 
Seat 6: BRSOB79 ($27.88 in chips) 
davidhw888: posts small blind $0.10
ivann14: posts big blind $0.25
*** HOLE CARDS ***
Dealt to SantiagoWeight [Tc 8s]
papico3: folds 
JeDti: folds 
BRSOB79: folds 
SantiagoWeight: raises $0.30 to $0.55
davidhw888: folds 
ivann14: calls $0.30
*** FLOP *** [8c 7s 4c]
ivann14: checks 
SantiagoWeight: bets $0.77
ivann14: raises $1.73 to $2.50
SantiagoWeight: calls $1.73
*** TURN *** [8c 7s 4c] [Th]
ivann14: bets $4.50
SantiagoWeight: calls $4.50
*** RIVER *** [8c 7s 4c Th] [Kd]
ivann14: bets $10.75
SantiagoWeight said, "man"
ivann14 said, "yes"
SantiagoWeight: calls $10.75
ivann14 said, "tell me"
*** SHOW DOWN ***
ivann14: shows [9s 6s] (a straight, Six to Ten)
SantiagoWeight: mucks hand 
ivann14 collected $35.05 from pot
*** SUMMARY ***
Total pot $36.70 | Rake $1.65 
Board [8c 7s 4c Th Kd]
Seat 1: SantiagoWeight (button) mucked [Tc 8s]
Seat 2: davidhw888 (small blind) folded before Flop
Seat 3: ivann14 (big blind) showed [9s 6s] and won ($35.05) with a straight, Six to Ten
Seat 4: papico3 folded before Flop (didn't bet)
Seat 5: JeDti folded before Flop (didn't bet)
Seat 6: BRSOB79 folded before Flop (didn't bet)



PokerStars Zoom Hand #195024747904:  Hold'em No Limit ($0.10/$0.25) - 2018/12/29 4:55:02 UTC [2018/12/28 23:55:02 ET]
Table 'Hydra' 6-max Seat #1 is the button
Seat 1: lauriña77 ($22.92 in chips) 
Seat 2: KAOS914 ($26.91 in chips) 
Seat 3: SantiagoWeight ($8.55 in chips) 
Seat 4: Rika_run ($30.06 in chips) 
Seat 5: Chrimmpam ($28.32 in chips) 
Seat 6: Nutselas ($69.43 in chips) 
KAOS914: posts small blind $0.10
SantiagoWeight: posts big blind $0.25
*** HOLE CARDS ***
Dealt to SantiagoWeight [Kh Qh]
Rika_run: folds 
Chrimmpam: folds 
Nutselas: folds 
lauriña77: folds 
KAOS914: folds 
Uncalled bet ($0.15) returned to SantiagoWeight
SantiagoWeight collected $0.20 from pot
SantiagoWeight: doesn't show hand 
*** SUMMARY ***
Total pot $0.20 | Rake $0 
Seat 1: lauriña77 (button) folded before Flop (didn't bet)
Seat 2: KAOS914 (small blind) folded before Flop
Seat 3: SantiagoWeight (big blind) collected ($0.20)
Seat 4: Rika_run folded before Flop (didn't bet)
Seat 5: Chrimmpam folded before Flop (didn't bet)
Seat 6: Nutselas folded before Flop (didn't bet)



PokerStars Zoom Hand #195024751101:  Hold'em No Limit ($0.10/$0.25) - 2018/12/29 4:55:15 UTC [2018/12/28 23:55:15 ET]
Table 'Hydra' 6-max Seat #1 is the button
Seat 1: Rika_run ($27.55 in chips) 
Seat 2: SantiagoWeight ($8.65 in chips) 
Seat 3: ivann14 ($33.48 in chips) 
Seat 4: ryanking99 ($51.26 in chips) 
Seat 5: Chrimmpam ($38.27 in chips) 
Seat 6: _BluDeeN_ ($21.35 in chips) 
SantiagoWeight: posts small blind $0.10
ivann14: posts big blind $0.25
*** HOLE CARDS ***
Dealt to SantiagoWeight [4c 2c]
ryanking99: folds 
Chrimmpam: folds 
_BluDeeN_: folds 
Rika_run: folds 
SantiagoWeight: folds 
Uncalled bet ($0.15) returned to ivann14
ivann14 collected $0.20 from pot
*** SUMMARY ***
Total pot $0.20 | Rake $0 
Seat 1: Rika_run (button) folded before Flop (didn't bet)
Seat 2: SantiagoWeight (small blind) folded before Flop
Seat 3: ivann14 (big blind) collected ($0.20)
Seat 4: ryanking99 folded before Flop (didn't bet)
Seat 5: Chrimmpam folded before Flop (didn't bet)
Seat 6: _BluDeeN_ folded before Flop (didn't bet)



PokerStars Zoom Hand #195024753832:  Hold'em No Limit ($0.10/$0.25) - 2018/12/29 4:55:27 UTC [2018/12/28 23:55:27 ET]
Table 'Hydra' 6-max Seat #1 is the button
Seat 1: Rika_run ($30.41 in chips) 
Seat 2: louiskitu ($15.99 in chips) 
Seat 3: ARTBIL ($22.61 in chips) 
Seat 4: hames_tj ($27.86 in chips) 
Seat 5: SantiagoWeight ($8.55 in chips) 
Seat 6: Chrimmpam ($38.27 in chips) 
louiskitu: posts small blind $0.10
ARTBIL: posts big blind $0.25
*** HOLE CARDS ***
Dealt to SantiagoWeight [Kc Kh]
hames_tj: folds 
SantiagoWeight: raises $0.37 to $0.62
Chrimmpam: folds 
Rika_run: folds 
louiskitu: folds 
ARTBIL: raises $1.34 to $1.96
SantiagoWeight: raises $3.14 to $5.10
ARTBIL: raises $10.30 to $15.40
SantiagoWeight: calls $3.45 and is all-in
Uncalled bet ($6.85) returned to ARTBIL
*** FLOP *** [Qs Ts Td]
*** TURN *** [Qs Ts Td] [3s]
*** RIVER *** [Qs Ts Td 3s] [9h]
*** SHOW DOWN ***
ARTBIL: shows [Qc Qd] (a full house, Queens full of Tens)
SantiagoWeight: shows [Kc Kh] (two pair, Kings and Tens)
ARTBIL collected $16.43 from pot
*** SUMMARY ***
Total pot $17.20 | Rake $0.77 
Board [Qs Ts Td 3s 9h]
Seat 1: Rika_run (button) folded before Flop (didn't bet)
Seat 2: louiskitu (small blind) folded before Flop
Seat 3: ARTBIL (big blind) showed [Qc Qd] and won ($16.43) with a full house, Queens full of Tens
Seat 4: hames_tj folded before Flop (didn't bet)
Seat 5: SantiagoWeight showed [Kc Kh] and lost with two pair, Kings and Tens
Seat 6: Chrimmpam folded before Flop (didn't bet)



PokerStars Zoom Hand #195024776427:  Hold'em No Limit ($0.10/$0.25) - 2018/12/29 4:57:04 UTC [2018/12/28 23:57:04 ET]
Table 'Hydra' 6-max Seat #1 is the button
Seat 1: glenn.vaughan ($39.73 in chips) 
Seat 2: TQNYMQNTANA ($33.33 in chips) 
Seat 3: zbuci ($84.28 in chips) 
Seat 4: SantiagoWeight ($25 in chips) 
Seat 5: Papaya006 ($25 in chips) 
Seat 6: trillerGTO ($22.01 in chips) 
TQNYMQNTANA: posts small blind $0.10
zbuci: posts big blind $0.25
*** HOLE CARDS ***
Dealt to SantiagoWeight [8h 5s]
SantiagoWeight: folds 
Papaya006: folds 
trillerGTO: raises $0.43 to $0.68
glenn.vaughan: folds 
TQNYMQNTANA: folds 
zbuci: folds 
Uncalled bet ($0.43) returned to trillerGTO
trillerGTO collected $0.60 from pot
trillerGTO: doesn't show hand 
*** SUMMARY ***
Total pot $0.60 | Rake $0 
Seat 1: glenn.vaughan (button) folded before Flop (didn't bet)
Seat 2: TQNYMQNTANA (small blind) folded before Flop
Seat 3: zbuci (big blind) folded before Flop
Seat 4: SantiagoWeight folded before Flop (didn't bet)
Seat 5: Papaya006 folded before Flop (didn't bet)
Seat 6: trillerGTO collected ($0.60)



PokerStars Zoom Hand #195024777398:  Hold'em No Limit ($0.10/$0.25) - 2018/12/29 4:57:08 UTC [2018/12/28 23:57:08 ET]
Table 'Hydra' 6-max Seat #1 is the button
Seat 1: asapon ($25 in chips) 
Seat 2: yoube ($11.40 in chips) 
Seat 3: JeDti ($57.20 in chips) 
Seat 4: SantiagoWeight ($25 in chips) 
Seat 5: daveo1008 ($37.10 in chips) 
Seat 6: trillerGTO ($31.45 in chips) 
yoube: posts small blind $0.10
JeDti: posts big blind $0.25
*** HOLE CARDS ***
Dealt to SantiagoWeight [Kd Jc]
SantiagoWeight: folds 
daveo1008: folds 
trillerGTO: folds 
asapon: raises $0.37 to $0.62
yoube: folds 
JeDti: folds 
Uncalled bet ($0.37) returned to asapon
asapon collected $0.60 from pot
asapon: doesn't show hand 
*** SUMMARY ***
Total pot $0.60 | Rake $0 
Seat 1: asapon (button) collected ($0.60)
Seat 2: yoube (small blind) folded before Flop
Seat 3: JeDti (big blind) folded before Flop
Seat 4: SantiagoWeight folded before Flop (didn't bet)
Seat 5: daveo1008 folded before Flop (didn't bet)
Seat 6: trillerGTO folded before Flop (didn't bet)



PokerStars Zoom Hand #195024774815:  Hold'em No Limit ($0.10/$0.25) - 2018/12/29 4:56:57 UTC [2018/12/28 23:56:57 ET]
Table 'Hydra' 6-max Seat #1 is the button
Seat 1: SpaZz0205 ($25.35 in chips) 
Seat 2: winwinboy ($27.07 in chips) 
Seat 3: _BluDeeN_ ($20.85 in chips) 
Seat 4: athos 007 ($49.22 in chips) 
Seat 5: BRSOB79 ($25.25 in chips) 
Seat 6: SantiagoWeight ($25 in chips) 
winwinboy: posts small blind $0.10
_BluDeeN_: posts big blind $0.25
*** HOLE CARDS ***
Dealt to SantiagoWeight [4d 7s]
athos 007: calls $0.25
BRSOB79: raises $0.85 to $1.10
SantiagoWeight: folds 
SpaZz0205: folds 
winwinboy: folds 
_BluDeeN_: calls $0.85
athos 007: folds 
*** FLOP *** [7d 9d 3s]
_BluDeeN_: checks 
BRSOB79: bets $0.98
_BluDeeN_: calls $0.98
*** TURN *** [7d 9d 3s] [5h]
_BluDeeN_: checks 
BRSOB79: bets $2.84
_BluDeeN_: calls $2.84
*** RIVER *** [7d 9d 3s 5h] [6d]
_BluDeeN_: bets $5.75
BRSOB79: folds 
Uncalled bet ($5.75) returned to _BluDeeN_
_BluDeeN_ collected $9.73 from pot
_BluDeeN_: doesn't show hand 
*** SUMMARY ***
Total pot $10.19 | Rake $0.46 
Board [7d 9d 3s 5h 6d]
Seat 1: SpaZz0205 (button) folded before Flop (didn't bet)
Seat 2: winwinboy (small blind) folded before Flop
Seat 3: _BluDeeN_ (big blind) collected ($9.73)
Seat 4: athos 007 folded before Flop
Seat 5: BRSOB79 folded on the River
Seat 6: SantiagoWeight folded before Flop (didn't bet)



PokerStars Zoom Hand #195024778768:  Hold'em No Limit ($0.10/$0.25) - 2018/12/29 4:57:14 UTC [2018/12/28 23:57:14 ET]
Table 'Hydra' 6-max Seat #1 is the button
Seat 1: GrandmasterY ($45.30 in chips) 
Seat 2: Buntar017 ($62.46 in chips) 
Seat 3: naxizzle ($104.98 in chips) 
Seat 4: hames_tj ($25.35 in chips) 
Seat 5: SantiagoWeight ($25 in chips) 
Seat 6: _BluDeeN_ ($25.27 in chips) 
Buntar017: posts small blind $0.10
naxizzle: posts big blind $0.25
*** HOLE CARDS ***
Dealt to SantiagoWeight [Qc Ah]
hames_tj: folds 
SantiagoWeight: raises $0.37 to $0.62
_BluDeeN_: folds 
GrandmasterY: folds 
Buntar017: calls $0.52
naxizzle: folds 
*** FLOP *** [3c 9d 7c]
Buntar017: checks 
SantiagoWeight: bets $0.95
Buntar017: calls $0.95
*** TURN *** [3c 9d 7c] [3h]
Buntar017: checks 
SantiagoWeight: checks 
*** RIVER *** [3c 9d 7c 3h] [2s]
Buntar017: checks 
SantiagoWeight: checks 
*** SHOW DOWN ***
Buntar017: shows [3s 4h] (three of a kind, Threes)
SantiagoWeight: mucks hand 
Buntar017 collected $3.24 from pot
*** SUMMARY ***
Total pot $3.39 | Rake $0.15 
Board [3c 9d 7c 3h 2s]
Seat 1: GrandmasterY (button) folded before Flop (didn't bet)
Seat 2: Buntar017 (small blind) showed [3s 4h] and won ($3.24) with three of a kind, Threes
Seat 3: naxizzle (big blind) folded before Flop
Seat 4: hames_tj folded before Flop (didn't bet)
Seat 5: SantiagoWeight mucked [Qc Ah]
Seat 6: _BluDeeN_ folded before Flop (didn't bet)



PokerStars Zoom Hand #195024792013:  Hold'em No Limit ($0.10/$0.25) - 2018/12/29 4:58:10 UTC [2018/12/28 23:58:10 ET]
Table 'Hydra' 6-max Seat #1 is the button
Seat 1: TQNYMQNTANA ($52.96 in chips) 
Seat 2: ivann14 ($33.18 in chips) 
Seat 3: SantiagoWeight ($23.43 in chips) 
Seat 4: fishnm2018 ($23.76 in chips) 
Seat 5: hames_tj ($25.50 in chips) 
Seat 6: columb80 ($25 in chips) 
ivann14: posts small blind $0.10
SantiagoWeight: posts big blind $0.25
*** HOLE CARDS ***
Dealt to SantiagoWeight [Ah 5s]
fishnm2018: raises $0.50 to $0.75
hames_tj: folds 
columb80: folds 
TQNYMQNTANA: folds 
ivann14: folds 
SantiagoWeight: folds 
Uncalled bet ($0.50) returned to fishnm2018
fishnm2018 collected $0.60 from pot
fishnm2018: doesn't show hand 
*** SUMMARY ***
Total pot $0.60 | Rake $0 
Seat 1: TQNYMQNTANA (button) folded before Flop (didn't bet)
Seat 2: ivann14 (small blind) folded before Flop
Seat 3: SantiagoWeight (big blind) folded before Flop
Seat 4: fishnm2018 collected ($0.60)
Seat 5: hames_tj folded before Flop (didn't bet)
Seat 6: columb80 folded before Flop (didn't bet)



PokerStars Zoom Hand #195024798521:  Hold'em No Limit ($0.10/$0.25) - 2018/12/29 4:58:38 UTC [2018/12/28 23:58:38 ET]
Table 'Hydra' 6-max Seat #1 is the button
Seat 1: SantiagoWeight ($23.18 in chips) 
Seat 2: Cainban ($19.60 in chips) 
Seat 3: reetskeet ($88.45 in chips) 
Seat 4: fishnm2018 ($24.11 in chips) 
Seat 5: graysonai ($33.77 in chips) 
Seat 6: Rika_run ($54.37 in chips) 
Cainban: posts small blind $0.10
reetskeet: posts big blind $0.25
*** HOLE CARDS ***
Dealt to SantiagoWeight [3s 9h]
fishnm2018: folds 
graysonai: folds 
Rika_run: folds 
SantiagoWeight: folds 
Cainban: raises $0.25 to $0.50
reetskeet: calls $0.25
*** FLOP *** [Jc Td 3d]
Cainban: bets $0.50
reetskeet: folds 
Uncalled bet ($0.50) returned to Cainban
Cainban collected $0.96 from pot
Cainban: doesn't show hand 
*** SUMMARY ***
Total pot $1 | Rake $0.04 
Board [Jc Td 3d]
Seat 1: SantiagoWeight (button) folded before Flop (didn't bet)
Seat 2: Cainban (small blind) collected ($0.96)
Seat 3: reetskeet (big blind) folded on the Flop
Seat 4: fishnm2018 folded before Flop (didn't bet)
Seat 5: graysonai folded before Flop (didn't bet)
Seat 6: Rika_run folded before Flop (didn't bet)



PokerStars Zoom Hand #195024800646:  Hold'em No Limit ($0.10/$0.25) - 2018/12/29 4:58:47 UTC [2018/12/28 23:58:47 ET]
Table 'Hydra' 6-max Seat #1 is the button
Seat 1: Chrimmpam ($20.70 in chips) 
Seat 2: Virus3232 ($30.97 in chips) 
Seat 3: LastNoma ($28.05 in chips) 
Seat 4: doza123 ($15.14 in chips) 
Seat 5: winwinboy ($25.45 in chips) 
Seat 6: SantiagoWeight ($23.18 in chips) 
Virus3232: posts small blind $0.10
LastNoma: posts big blind $0.25
*** HOLE CARDS ***
Dealt to SantiagoWeight [Td Ac]
doza123: folds 
winwinboy: folds 
SantiagoWeight: raises $0.30 to $0.55
Chrimmpam: folds 
Virus3232: folds 
LastNoma: calls $0.30
*** FLOP *** [6s Jh 4c]
LastNoma: checks 
SantiagoWeight: bets $0.29
LastNoma: calls $0.29
*** TURN *** [6s Jh 4c] [3s]
LastNoma: checks 
SantiagoWeight: checks 
*** RIVER *** [6s Jh 4c 3s] [Ah]
LastNoma: checks 
SantiagoWeight: bets $1.13
LastNoma: folds 
Uncalled bet ($1.13) returned to SantiagoWeight
SantiagoWeight collected $1.70 from pot
SantiagoWeight: doesn't show hand 
*** SUMMARY ***
Total pot $1.78 | Rake $0.08 
Board [6s Jh 4c 3s Ah]
Seat 1: Chrimmpam (button) folded before Flop (didn't bet)
Seat 2: Virus3232 (small blind) folded before Flop
Seat 3: LastNoma (big blind) folded on the River
Seat 4: doza123 folded before Flop (didn't bet)
Seat 5: winwinboy folded before Flop (didn't bet)
Seat 6: SantiagoWeight collected ($1.70)



PokerStars Zoom Hand #195024814353:  Hold'em No Limit ($0.10/$0.25) - 2018/12/29 4:59:46 UTC [2018/12/28 23:59:46 ET]
Table 'Hydra' 6-max Seat #1 is the button
Seat 1: Higashi2314 ($48.61 in chips) 
Seat 2: KAOS914 ($35.45 in chips) 
Seat 3: SantiagoWeight ($23.94 in chips) 
Seat 4: davidhw888 ($24.78 in chips) 
Seat 5: hames_tj ($27.47 in chips) 
Seat 6: BRSOB79 ($25 in chips) 
KAOS914: posts small blind $0.10
SantiagoWeight: posts big blind $0.25
*** HOLE CARDS ***
Dealt to SantiagoWeight [2c Js]
davidhw888: folds 
hames_tj: folds 
BRSOB79: folds 
Higashi2314: raises $0.50 to $0.75
KAOS914: folds 
SantiagoWeight: folds 
Uncalled bet ($0.50) returned to Higashi2314
Higashi2314 collected $0.60 from pot
Higashi2314: doesn't show hand 
*** SUMMARY ***
Total pot $0.60 | Rake $0 
Seat 1: Higashi2314 (button) collected ($0.60)
Seat 2: KAOS914 (small blind) folded before Flop
Seat 3: SantiagoWeight (big blind) folded before Flop
Seat 4: davidhw888 folded before Flop (didn't bet)
Seat 5: hames_tj folded before Flop (didn't bet)
Seat 6: BRSOB79 folded before Flop (didn't bet)



PokerStars Zoom Hand #195024812938:  Hold'em No Limit ($0.10/$0.25) - 2018/12/29 4:59:40 UTC [2018/12/28 23:59:40 ET]
Table 'Hydra' 6-max Seat #1 is the button
Seat 1: river plate9 ($72.51 in chips) 
Seat 2: SantiagoWeight ($24.04 in chips) 
Seat 3: ivann14 ($33.33 in chips) 
Seat 4: Virus3232 ($50.35 in chips) 
Seat 5: ryanking99 ($24.75 in chips) 
Seat 6: hames_tj ($26.01 in chips) 
SantiagoWeight: posts small blind $0.10
ivann14: posts big blind $0.25
*** HOLE CARDS ***
Dealt to SantiagoWeight [7d 3s]
Virus3232: folds 
ryanking99: raises $0.60 to $0.85
hames_tj: folds 
river plate9: calls $0.85
SantiagoWeight: folds 
ivann14: calls $0.60
*** FLOP *** [5h Ks Ac]
ivann14: checks 
ryanking99: checks 
river plate9: bets $1.25
ivann14: calls $1.25
ryanking99: folds 
*** TURN *** [5h Ks Ac] [Kh]
ivann14: checks 
river plate9: checks 
*** RIVER *** [5h Ks Ac Kh] [6h]
ivann14: bets $3.54
river plate9: calls $3.54
*** SHOW DOWN ***
ivann14: shows [2h 4h] (a flush, King high)
river plate9: mucks hand 
ivann14 collected $11.68 from pot
*** SUMMARY ***
Total pot $12.23 | Rake $0.55 
Board [5h Ks Ac Kh 6h]
Seat 1: river plate9 (button) mucked [As Jd]
Seat 2: SantiagoWeight (small blind) folded before Flop
Seat 3: ivann14 (big blind) showed [2h 4h] and won ($11.68) with a flush, King high
Seat 4: Virus3232 folded before Flop (didn't bet)
Seat 5: ryanking99 folded on the Flop
Seat 6: hames_tj folded before Flop (didn't bet)



