PokerStars Zoom Hand #195021954671:  Hold'em No Limit ($0.10/$0.25) - 2018/12/29 2:31:02 UTC [2018/12/28 21:31:02 ET]
Table 'Hydra' 6-max Seat #1 is the button
Seat 1: Mrs_Squeeze ($44.74 in chips) 
Seat 2: checho0231 ($24.99 in chips) 
Seat 3: SantiagoWeight ($25 in chips) 
Seat 4: Xp0Hb ($20.54 in chips) 
Seat 5: ninjaboots82 ($12.65 in chips) 
Seat 6: Chellabro ($11.88 in chips) 
checho0231: posts small blind $0.10
SantiagoWeight: posts big blind $0.25
*** HOLE CARDS ***
Dealt to SantiagoWeight [8h 5s]
Xp0Hb: folds 
ninjaboots82: raises $0.25 to $0.50
Chellabro: calls $0.50
Mrs_Squeeze: calls $0.50
checho0231: calls $0.40
SantiagoWeight: calls $0.25
*** FLOP *** [3h 6h Js]
checho0231: checks 
SantiagoWeight: checks 
ninjaboots82: checks 
Chellabro: checks 
Mrs_Squeeze: checks 
*** TURN *** [3h 6h Js] [4d]
checho0231: checks 
SantiagoWeight: bets $1.50
ninjaboots82: folds 
Chellabro: folds 
Mrs_Squeeze: folds 
checho0231: calls $1.50
*** RIVER *** [3h 6h Js 4d] [Kc]
checho0231: checks 
SantiagoWeight: bets $6.25
checho0231: folds 
Uncalled bet ($6.25) returned to SantiagoWeight
SantiagoWeight collected $5.25 from pot
SantiagoWeight: doesn't show hand 
*** SUMMARY ***
Total pot $5.50 | Rake $0.25 
Board [3h 6h Js 4d Kc]
Seat 1: Mrs_Squeeze (button) folded on the Turn
Seat 2: checho0231 (small blind) folded on the River
Seat 3: SantiagoWeight (big blind) collected ($5.25)
Seat 4: Xp0Hb folded before Flop (didn't bet)
Seat 5: ninjaboots82 folded on the Turn
Seat 6: Chellabro folded on the Turn



PokerStars Zoom Hand #195021987559:  Hold'em No Limit ($0.10/$0.25) - 2018/12/29 2:32:26 UTC [2018/12/28 21:32:26 ET]
Table 'Hydra' 6-max Seat #1 is the button
Seat 1: Archi1024 ($24.65 in chips) 
Seat 2: crescendo34 ($39.57 in chips) 
Seat 3: Z3rbinatti ($100.66 in chips) 
Seat 4: Dancer DnB ($4.77 in chips) 
Seat 5: SantiagoWeight ($28.15 in chips) 
Seat 6: RandomWalk77 ($36.50 in chips) 
crescendo34: posts small blind $0.10
Z3rbinatti: posts big blind $0.25
*** HOLE CARDS ***
Dealt to SantiagoWeight [Ts 8h]
Dancer DnB: folds 
SantiagoWeight: folds 
RandomWalk77: folds 
Archi1024: folds 
crescendo34: folds 
Uncalled bet ($0.15) returned to Z3rbinatti
Z3rbinatti collected $0.20 from pot
Z3rbinatti: doesn't show hand 
*** SUMMARY ***
Total pot $0.20 | Rake $0 
Seat 1: Archi1024 (button) folded before Flop (didn't bet)
Seat 2: crescendo34 (small blind) folded before Flop
Seat 3: Z3rbinatti (big blind) collected ($0.20)
Seat 4: Dancer DnB folded before Flop (didn't bet)
Seat 5: SantiagoWeight folded before Flop (didn't bet)
Seat 6: RandomWalk77 folded before Flop (didn't bet)



PokerStars Zoom Hand #195021983749:  Hold'em No Limit ($0.10/$0.25) - 2018/12/29 2:32:16 UTC [2018/12/28 21:32:16 ET]
Table 'Hydra' 6-max Seat #1 is the button
Seat 1: hoodbya!r ($18.02 in chips) 
Seat 2: SantiagoWeight ($28.25 in chips) 
Seat 3: StarBusch ($29.12 in chips) 
Seat 4: Raptor1964 ($25.12 in chips) 
Seat 5: nhanminhtri ($29.17 in chips) 
Seat 6: ludisima ($78.17 in chips) 
SantiagoWeight: posts small blind $0.10
StarBusch: posts big blind $0.25
*** HOLE CARDS ***
Dealt to SantiagoWeight [5h Jd]
Raptor1964: folds 
nhanminhtri: raises $0.50 to $0.75
ludisima: calls $0.75
hoodbya!r: folds 
SantiagoWeight: folds 
StarBusch: calls $0.50
*** FLOP *** [7h 4s 9c]
StarBusch: checks 
nhanminhtri: checks 
ludisima: bets $1
StarBusch: folds 
nhanminhtri: folds 
Uncalled bet ($1) returned to ludisima
ludisima collected $2.24 from pot
ludisima: doesn't show hand 
*** SUMMARY ***
Total pot $2.35 | Rake $0.11 
Board [7h 4s 9c]
Seat 1: hoodbya!r (button) folded before Flop (didn't bet)
Seat 2: SantiagoWeight (small blind) folded before Flop
Seat 3: StarBusch (big blind) folded on the Flop
Seat 4: Raptor1964 folded before Flop (didn't bet)
Seat 5: nhanminhtri folded on the Flop
Seat 6: ludisima collected ($2.24)



PokerStars Zoom Hand #195021990225:  Hold'em No Limit ($0.10/$0.25) - 2018/12/29 2:32:33 UTC [2018/12/28 21:32:33 ET]
Table 'Hydra' 6-max Seat #1 is the button
Seat 1: SantiagoWeight ($28.15 in chips) 
Seat 2: Cryptoz91 ($25 in chips) 
Seat 3: Butch030 ($122.79 in chips) 
Seat 4: ryanking99 ($12.80 in chips) 
Seat 5: samioattila ($55.78 in chips) 
Seat 6: tightpokerAA ($34.50 in chips) 
Cryptoz91: posts small blind $0.10
Butch030: posts big blind $0.25
*** HOLE CARDS ***
Dealt to SantiagoWeight [Kh 7c]
ryanking99: folds 
samioattila: folds 
tightpokerAA: folds 
SantiagoWeight: raises $0.25 to $0.50
Cryptoz91: folds 
Butch030: raises $1.75 to $2.25
SantiagoWeight: folds 
Uncalled bet ($1.75) returned to Butch030
Butch030 collected $1.10 from pot
*** SUMMARY ***
Total pot $1.10 | Rake $0 
Seat 1: SantiagoWeight (button) folded before Flop
Seat 2: Cryptoz91 (small blind) folded before Flop
Seat 3: Butch030 (big blind) collected ($1.10)
Seat 4: ryanking99 folded before Flop (didn't bet)
Seat 5: samioattila folded before Flop (didn't bet)
Seat 6: tightpokerAA folded before Flop (didn't bet)



PokerStars Zoom Hand #195022000680:  Hold'em No Limit ($0.10/$0.25) - 2018/12/29 2:33:00 UTC [2018/12/28 21:33:00 ET]
Table 'Hydra' 6-max Seat #1 is the button
Seat 1: ludaslol ($31.96 in chips) 
Seat 2: TDAK1509 ($27.88 in chips) 
Seat 3: SantiagoWeight ($27.65 in chips) 
Seat 4: zdenekstavic ($34.28 in chips) 
Seat 5: ARTBIL ($15.69 in chips) 
Seat 6: KFD363 ($16.63 in chips) 
TDAK1509: posts small blind $0.10
SantiagoWeight: posts big blind $0.25
*** HOLE CARDS ***
Dealt to SantiagoWeight [7c 6h]
zdenekstavic: folds 
ARTBIL: folds 
KFD363: calls $0.25
ludaslol: folds 
TDAK1509: folds 
SantiagoWeight: checks 
*** FLOP *** [Kc 8c Qd]
SantiagoWeight: checks 
KFD363: bets $0.25
SantiagoWeight: folds 
Uncalled bet ($0.25) returned to KFD363
KFD363 collected $0.57 from pot
*** SUMMARY ***
Total pot $0.60 | Rake $0.03 
Board [Kc 8c Qd]
Seat 1: ludaslol (button) folded before Flop (didn't bet)
Seat 2: TDAK1509 (small blind) folded before Flop
Seat 3: SantiagoWeight (big blind) folded on the Flop
Seat 4: zdenekstavic folded before Flop (didn't bet)
Seat 5: ARTBIL folded before Flop (didn't bet)
Seat 6: KFD363 collected ($0.57)



PokerStars Zoom Hand #195022014007:  Hold'em No Limit ($0.10/$0.25) - 2018/12/29 2:33:35 UTC [2018/12/28 21:33:35 ET]
Table 'Hydra' 6-max Seat #1 is the button
Seat 1: RandomWalk77 ($37 in chips) 
Seat 2: sleapyjoe ($24.75 in chips) 
Seat 3: Rollout2018 ($19.57 in chips) 
Seat 4: FrommyBu ($28.54 in chips) 
Seat 5: mattmoney8 ($13.48 in chips) 
Seat 6: SantiagoWeight ($27.40 in chips) 
sleapyjoe: posts small blind $0.10
Rollout2018: posts big blind $0.25
*** HOLE CARDS ***
Dealt to SantiagoWeight [5s Kh]
FrommyBu: folds 
mattmoney8: folds 
SantiagoWeight: folds 
RandomWalk77: folds 
sleapyjoe: calls $0.15
Rollout2018: checks 
*** FLOP *** [4h 6c As]
sleapyjoe: bets $0.50
Rollout2018: folds 
Uncalled bet ($0.50) returned to sleapyjoe
sleapyjoe collected $0.48 from pot
sleapyjoe: doesn't show hand 
*** SUMMARY ***
Total pot $0.50 | Rake $0.02 
Board [4h 6c As]
Seat 1: RandomWalk77 (button) folded before Flop (didn't bet)
Seat 2: sleapyjoe (small blind) collected ($0.48)
Seat 3: Rollout2018 (big blind) folded on the Flop
Seat 4: FrommyBu folded before Flop (didn't bet)
Seat 5: mattmoney8 folded before Flop (didn't bet)
Seat 6: SantiagoWeight folded before Flop (didn't bet)



PokerStars Zoom Hand #195022029871:  Hold'em No Limit ($0.10/$0.25) - 2018/12/29 2:34:18 UTC [2018/12/28 21:34:18 ET]
Table 'Hydra' 6-max Seat #1 is the button
Seat 1: SantiagoWeight ($27.30 in chips) 
Seat 2: Lehared ($95.92 in chips) 
Seat 3: lionheart470 ($20.18 in chips) 
Seat 4: Dr.Montana56 ($28.85 in chips) 
Seat 5: ludaslol ($31.96 in chips) 
Seat 6: Cryptoz91 ($25 in chips) 
Lehared: posts small blind $0.10
lionheart470: posts big blind $0.25
*** HOLE CARDS ***
Dealt to SantiagoWeight [3h Jh]
Dr.Montana56: raises $0.50 to $0.75
ludaslol: folds 
Cryptoz91: folds 
SantiagoWeight: folds 
Lehared: folds 
lionheart470: folds 
Uncalled bet ($0.50) returned to Dr.Montana56
Dr.Montana56 collected $0.60 from pot
Dr.Montana56: doesn't show hand 
*** SUMMARY ***
Total pot $0.60 | Rake $0 
Seat 1: SantiagoWeight (button) folded before Flop (didn't bet)
Seat 2: Lehared (small blind) folded before Flop
Seat 3: lionheart470 (big blind) folded before Flop
Seat 4: Dr.Montana56 collected ($0.60)
Seat 5: ludaslol folded before Flop (didn't bet)
Seat 6: Cryptoz91 folded before Flop (didn't bet)



PokerStars Zoom Hand #195022020369:  Hold'em No Limit ($0.10/$0.25) - 2018/12/29 2:33:52 UTC [2018/12/28 21:33:52 ET]
Table 'Hydra' 6-max Seat #1 is the button
Seat 1: IceAgeDream7 ($120.83 in chips) 
Seat 2: pkr_miracle ($73.20 in chips) 
Seat 3: ryanking99 ($22.56 in chips) 
Seat 4: samioattila ($56.68 in chips) 
Seat 5: allin969 ($22.50 in chips) 
Seat 6: SantiagoWeight ($27.30 in chips) 
pkr_miracle: posts small blind $0.10
ryanking99: posts big blind $0.25
*** HOLE CARDS ***
Dealt to SantiagoWeight [Kc 3d]
samioattila: folds 
allin969: folds 
SantiagoWeight has timed out
SantiagoWeight: folds 
IceAgeDream7: folds 
pkr_miracle: raises $0.50 to $0.75
ryanking99: calls $0.50
*** FLOP *** [5d 8h 2h]
pkr_miracle: checks 
ryanking99: bets $0.47
pkr_miracle: calls $0.47
*** TURN *** [5d 8h 2h] [2c]
pkr_miracle: checks 
ryanking99: bets $1.23
pkr_miracle: folds 
Uncalled bet ($1.23) returned to ryanking99
ryanking99 collected $2.33 from pot
ryanking99: doesn't show hand 
*** SUMMARY ***
Total pot $2.44 | Rake $0.11 
Board [5d 8h 2h 2c]
Seat 1: IceAgeDream7 (button) folded before Flop (didn't bet)
Seat 2: pkr_miracle (small blind) folded on the Turn
Seat 3: ryanking99 (big blind) collected ($2.33)
Seat 4: samioattila folded before Flop (didn't bet)
Seat 5: allin969 folded before Flop (didn't bet)
Seat 6: SantiagoWeight folded before Flop (didn't bet)



PokerStars Zoom Hand #195022016278:  Hold'em No Limit ($0.10/$0.25) - 2018/12/29 2:33:41 UTC [2018/12/28 21:33:41 ET]
Table 'Hydra' 6-max Seat #1 is the button
Seat 1: stavro88 ($36.77 in chips) 
Seat 2: SantiagoWeight ($27.40 in chips) 
Seat 3: pfunkolstar ($38.86 in chips) 
Seat 4: $lope$tyle ($25 in chips) 
Seat 5: lbautista91 ($23.22 in chips) 
Seat 6: MISTAAJ ($21.43 in chips) 
SantiagoWeight: posts small blind $0.10
pfunkolstar: posts big blind $0.25
*** HOLE CARDS ***
Dealt to SantiagoWeight [6c 4s]
$lope$tyle: folds 
lbautista91: folds 
MISTAAJ: calls $0.25
stavro88: calls $0.25
SantiagoWeight: folds 
pfunkolstar: checks 
*** FLOP *** [8h 8s Kc]
pfunkolstar: checks 
MISTAAJ: checks 
stavro88: bets $0.25
pfunkolstar: calls $0.25
MISTAAJ: calls $0.25
*** TURN *** [8h 8s Kc] [5h]
pfunkolstar: checks 
MISTAAJ: checks 
stavro88: checks 
*** RIVER *** [8h 8s Kc 5h] [Ah]
pfunkolstar: checks 
MISTAAJ: checks 
stavro88: bets $1.50
pfunkolstar: folds 
MISTAAJ: folds 
Uncalled bet ($1.50) returned to stavro88
stavro88 collected $1.53 from pot
stavro88: doesn't show hand 
*** SUMMARY ***
Total pot $1.60 | Rake $0.07 
Board [8h 8s Kc 5h Ah]
Seat 1: stavro88 (button) collected ($1.53)
Seat 2: SantiagoWeight (small blind) folded before Flop
Seat 3: pfunkolstar (big blind) folded on the River
Seat 4: $lope$tyle folded before Flop (didn't bet)
Seat 5: lbautista91 folded before Flop (didn't bet)
Seat 6: MISTAAJ folded on the River



PokerStars Zoom Hand #195022035226:  Hold'em No Limit ($0.10/$0.25) - 2018/12/29 2:34:32 UTC [2018/12/28 21:34:32 ET]
Table 'Hydra' 6-max Seat #1 is the button
Seat 1: TQNYMQNTANA ($29.17 in chips) 
Seat 2: benddo ($50.79 in chips) 
Seat 3: zdenekstavic ($31.28 in chips) 
Seat 4: davidhw888 ($22.95 in chips) 
Seat 5: SantiagoWeight ($27.30 in chips) 
Seat 6: maximus25203 ($25.50 in chips) 
benddo: posts small blind $0.10
zdenekstavic: posts big blind $0.25
*** HOLE CARDS ***
Dealt to SantiagoWeight [Qc Ts]
davidhw888: raises $0.50 to $0.75
SantiagoWeight: folds 
maximus25203: calls $0.75
TQNYMQNTANA: folds 
benddo: raises $2.75 to $3.50
zdenekstavic: folds 
davidhw888: calls $2.75
maximus25203: folds 
*** FLOP *** [4h 2d Ah]
benddo: bets $3
davidhw888: folds 
Uncalled bet ($3) returned to benddo
benddo collected $7.64 from pot
benddo: doesn't show hand 
*** SUMMARY ***
Total pot $8 | Rake $0.36 
Board [4h 2d Ah]
Seat 1: TQNYMQNTANA (button) folded before Flop (didn't bet)
Seat 2: benddo (small blind) collected ($7.64)
Seat 3: zdenekstavic (big blind) folded before Flop
Seat 4: davidhw888 folded on the Flop
Seat 5: SantiagoWeight folded before Flop (didn't bet)
Seat 6: maximus25203 folded before Flop



PokerStars Zoom Hand #195022046632:  Hold'em No Limit ($0.10/$0.25) - 2018/12/29 2:35:01 UTC [2018/12/28 21:35:01 ET]
Table 'Hydra' 6-max Seat #1 is the button
Seat 1: TDAK1509 ($26.41 in chips) 
Seat 2: the_ablist7 ($9.19 in chips) 
Seat 3: SantiagoWeight ($27.30 in chips) 
Seat 4: Butch030 ($77.35 in chips) 
Seat 5: idontnownow ($28.77 in chips) 
Seat 6: cobra2846 ($60.64 in chips) 
the_ablist7: posts small blind $0.10
SantiagoWeight: posts big blind $0.25
*** HOLE CARDS ***
Dealt to SantiagoWeight [5s Qc]
Butch030: folds 
idontnownow: folds 
cobra2846: raises $0.50 to $0.75
TDAK1509: folds 
the_ablist7: folds 
SantiagoWeight: folds 
Uncalled bet ($0.50) returned to cobra2846
cobra2846 collected $0.60 from pot
cobra2846: doesn't show hand 
*** SUMMARY ***
Total pot $0.60 | Rake $0 
Seat 1: TDAK1509 (button) folded before Flop (didn't bet)
Seat 2: the_ablist7 (small blind) folded before Flop
Seat 3: SantiagoWeight (big blind) folded before Flop
Seat 4: Butch030 folded before Flop (didn't bet)
Seat 5: idontnownow folded before Flop (didn't bet)
Seat 6: cobra2846 collected ($0.60)



PokerStars Zoom Hand #195022051841:  Hold'em No Limit ($0.10/$0.25) - 2018/12/29 2:35:14 UTC [2018/12/28 21:35:14 ET]
Table 'Hydra' 6-max Seat #1 is the button
Seat 1: davidhw888 ($26.97 in chips) 
Seat 2: SantiagoWeight ($27.05 in chips) 
Seat 3: cobra2846 ($60.99 in chips) 
Seat 4: houstor65 ($13.90 in chips) 
Seat 5: Cryptoz91 ($25 in chips) 
Seat 6: thedemise69 ($10.88 in chips) 
SantiagoWeight: posts small blind $0.10
cobra2846: posts big blind $0.25
*** HOLE CARDS ***
Dealt to SantiagoWeight [9d 9h]
houstor65: folds 
Cryptoz91: folds 
thedemise69: folds 
davidhw888: raises $0.50 to $0.75
SantiagoWeight: raises $2 to $2.75
cobra2846: folds 
davidhw888: folds 
Uncalled bet ($2) returned to SantiagoWeight
SantiagoWeight collected $1.75 from pot
SantiagoWeight: doesn't show hand 
*** SUMMARY ***
Total pot $1.75 | Rake $0 
Seat 1: davidhw888 (button) folded before Flop
Seat 2: SantiagoWeight (small blind) collected ($1.75)
Seat 3: cobra2846 (big blind) folded before Flop
Seat 4: houstor65 folded before Flop (didn't bet)
Seat 5: Cryptoz91 folded before Flop (didn't bet)
Seat 6: thedemise69 folded before Flop (didn't bet)



PokerStars Zoom Hand #195022040905:  Hold'em No Limit ($0.10/$0.25) - 2018/12/29 2:34:46 UTC [2018/12/28 21:34:46 ET]
Table 'Hydra' 6-max Seat #1 is the button
Seat 1: samioattila ($58.48 in chips) 
Seat 2: BirreteX ($39.47 in chips) 
Seat 3: river plate9 ($36.11 in chips) 
Seat 4: SantiagoWeight ($27.30 in chips) 
Seat 5: sigaro010 ($49.58 in chips) 
Seat 6: !P0K3RM3T4L! ($31.06 in chips) 
BirreteX: posts small blind $0.10
river plate9: posts big blind $0.25
*** HOLE CARDS ***
Dealt to SantiagoWeight [8h 6h]
SantiagoWeight: folds 
sigaro010: folds 
!P0K3RM3T4L!: raises $0.35 to $0.60
samioattila: calls $0.60
BirreteX: folds 
river plate9: calls $0.35
*** FLOP *** [2c 6d Jc]
river plate9: checks 
!P0K3RM3T4L!: checks 
samioattila: bets $1.19
river plate9: calls $1.19
!P0K3RM3T4L!: folds 
*** TURN *** [2c 6d Jc] [2s]
river plate9: checks 
samioattila: bets $4.70
river plate9: calls $4.70
*** RIVER *** [2c 6d Jc 2s] [Tc]
river plate9: bets $6.50
samioattila: calls $6.50
*** SHOW DOWN ***
river plate9: shows [Jh Td] (two pair, Jacks and Tens)
samioattila: shows [Ah Ac] (two pair, Aces and Deuces)
samioattila collected $25.48 from pot
*** SUMMARY ***
Total pot $26.68 | Rake $1.20 
Board [2c 6d Jc 2s Tc]
Seat 1: samioattila (button) showed [Ah Ac] and won ($25.48) with two pair, Aces and Deuces
Seat 2: BirreteX (small blind) folded before Flop
Seat 3: river plate9 (big blind) showed [Jh Td] and lost with two pair, Jacks and Tens
Seat 4: SantiagoWeight folded before Flop (didn't bet)
Seat 5: sigaro010 folded before Flop (didn't bet)
Seat 6: !P0K3RM3T4L! folded on the Flop



PokerStars Zoom Hand #195022061397:  Hold'em No Limit ($0.10/$0.25) - 2018/12/29 2:35:39 UTC [2018/12/28 21:35:39 ET]
Table 'Hydra' 6-max Seat #1 is the button
Seat 1: SantiagoWeight ($28.05 in chips) 
Seat 2: rastyb87 ($25.50 in chips) 
Seat 3: osa126 ($31.31 in chips) 
Seat 4: Butch030 ($71.56 in chips) 
Seat 5: ryanking99 ($23.01 in chips) 
Seat 6: cpt.peep ($44.12 in chips) 
rastyb87: posts small blind $0.10
osa126: posts big blind $0.25
*** HOLE CARDS ***
Dealt to SantiagoWeight [9s 9h]
Butch030: folds 
ryanking99: folds 
cpt.peep: folds 
SantiagoWeight: raises $0.25 to $0.50
rastyb87: folds 
osa126: calls $0.25
*** FLOP *** [Qd 9c 7s]
osa126: checks 
SantiagoWeight: bets $1.10
osa126: folds 
Uncalled bet ($1.10) returned to SantiagoWeight
SantiagoWeight collected $1.05 from pot
SantiagoWeight: doesn't show hand 
*** SUMMARY ***
Total pot $1.10 | Rake $0.05 
Board [Qd 9c 7s]
Seat 1: SantiagoWeight (button) collected ($1.05)
Seat 2: rastyb87 (small blind) folded before Flop
Seat 3: osa126 (big blind) folded on the Flop
Seat 4: Butch030 folded before Flop (didn't bet)
Seat 5: ryanking99 folded before Flop (didn't bet)
Seat 6: cpt.peep folded before Flop (didn't bet)



PokerStars Zoom Hand #195022074616:  Hold'em No Limit ($0.10/$0.25) - 2018/12/29 2:36:13 UTC [2018/12/28 21:36:13 ET]
Table 'Hydra' 6-max Seat #1 is the button
Seat 1: oleg77552 ($69 in chips) 
Seat 2: Xa4_88 ($39.51 in chips) 
Seat 3: davidhw888 ($31.12 in chips) 
Seat 4: svents ($71.54 in chips) 
Seat 5: hoodbya!r ($30.52 in chips) 
Seat 6: SantiagoWeight ($28.60 in chips) 
Xa4_88: posts small blind $0.10
davidhw888: posts big blind $0.25
*** HOLE CARDS ***
Dealt to SantiagoWeight [2h 4c]
svents: folds 
hoodbya!r: folds 
SantiagoWeight: folds 
oleg77552: folds 
Xa4_88: folds 
Uncalled bet ($0.15) returned to davidhw888
davidhw888 collected $0.20 from pot
davidhw888: doesn't show hand 
*** SUMMARY ***
Total pot $0.20 | Rake $0 
Seat 1: oleg77552 (button) folded before Flop (didn't bet)
Seat 2: Xa4_88 (small blind) folded before Flop
Seat 3: davidhw888 (big blind) collected ($0.20)
Seat 4: svents folded before Flop (didn't bet)
Seat 5: hoodbya!r folded before Flop (didn't bet)
Seat 6: SantiagoWeight folded before Flop (didn't bet)



PokerStars Zoom Hand #195022085532:  Hold'em No Limit ($0.10/$0.25) - 2018/12/29 2:36:41 UTC [2018/12/28 21:36:41 ET]
Table 'Hydra' 6-max Seat #1 is the button
Seat 1: checho0231 ($13.29 in chips) 
Seat 2: satisfhy_you ($25.35 in chips) 
Seat 3: SantiagoWeight ($28.50 in chips) 
Seat 4: Rollout2018 ($14.87 in chips) 
Seat 5: xmenvn1989 ($40.93 in chips) 
Seat 6: FrommyBu ($52.38 in chips) 
satisfhy_you: posts small blind $0.10
SantiagoWeight: posts big blind $0.25
*** HOLE CARDS ***
Dealt to SantiagoWeight [9d 8c]
Rollout2018: folds 
xmenvn1989: folds 
FrommyBu: folds 
checho0231: folds 
satisfhy_you: folds 
Uncalled bet ($0.15) returned to SantiagoWeight
SantiagoWeight collected $0.20 from pot
SantiagoWeight: doesn't show hand 
*** SUMMARY ***
Total pot $0.20 | Rake $0 
Seat 1: checho0231 (button) folded before Flop (didn't bet)
Seat 2: satisfhy_you (small blind) folded before Flop
Seat 3: SantiagoWeight (big blind) collected ($0.20)
Seat 4: Rollout2018 folded before Flop (didn't bet)
Seat 5: xmenvn1989 folded before Flop (didn't bet)
Seat 6: FrommyBu folded before Flop (didn't bet)



PokerStars Zoom Hand #195022089350:  Hold'em No Limit ($0.10/$0.25) - 2018/12/29 2:36:52 UTC [2018/12/28 21:36:52 ET]
Table 'Hydra' 6-max Seat #1 is the button
Seat 1: the_ablist7 ($3 in chips) 
Seat 2: Parsam5 ($25.42 in chips) 
Seat 3: HonourMan23 ($25.54 in chips) 
Seat 4: davidhw888 ($25 in chips) 
Seat 5: SantiagoWeight ($28.60 in chips) 
Seat 6: sZCzpNtheKot ($38.35 in chips) 
Parsam5: posts small blind $0.10
HonourMan23: posts big blind $0.25
*** HOLE CARDS ***
Dealt to SantiagoWeight [7d Qc]
davidhw888: folds 
SantiagoWeight: folds 
sZCzpNtheKot: folds 
the_ablist7: folds 
Parsam5: folds 
Uncalled bet ($0.15) returned to HonourMan23
HonourMan23 collected $0.20 from pot
HonourMan23: doesn't show hand 
*** SUMMARY ***
Total pot $0.20 | Rake $0 
Seat 1: the_ablist7 (button) folded before Flop (didn't bet)
Seat 2: Parsam5 (small blind) folded before Flop
Seat 3: HonourMan23 (big blind) collected ($0.20)
Seat 4: davidhw888 folded before Flop (didn't bet)
Seat 5: SantiagoWeight folded before Flop (didn't bet)
Seat 6: sZCzpNtheKot folded before Flop (didn't bet)



PokerStars Zoom Hand #195022079660:  Hold'em No Limit ($0.10/$0.25) - 2018/12/29 2:36:26 UTC [2018/12/28 21:36:26 ET]
Table 'Hydra' 6-max Seat #1 is the button
Seat 1: kounoupiss ($33.54 in chips) 
Seat 2: SantiagoWeight ($28.60 in chips) 
Seat 3: LupiGonzales ($21.94 in chips) 
Seat 4: meettokill ($26.30 in chips) 
Seat 5: samioattila ($51.37 in chips) 
Seat 6: FrommyBu ($27.69 in chips) 
SantiagoWeight: posts small blind $0.10
LupiGonzales: posts big blind $0.25
*** HOLE CARDS ***
Dealt to SantiagoWeight [Ts 8d]
meettokill: calls $0.25
samioattila: folds 
FrommyBu: folds 
kounoupiss: raises $0.85 to $1.10
SantiagoWeight: folds 
LupiGonzales: folds 
meettokill: calls $0.85
*** FLOP *** [4s 4d 5s]
meettokill: checks 
kounoupiss: bets $1.22
meettokill: folds 
Uncalled bet ($1.22) returned to kounoupiss
kounoupiss collected $2.44 from pot
kounoupiss: doesn't show hand 
*** SUMMARY ***
Total pot $2.55 | Rake $0.11 
Board [4s 4d 5s]
Seat 1: kounoupiss (button) collected ($2.44)
Seat 2: SantiagoWeight (small blind) folded before Flop
Seat 3: LupiGonzales (big blind) folded before Flop
Seat 4: meettokill folded on the Flop
Seat 5: samioattila folded before Flop (didn't bet)
Seat 6: FrommyBu folded before Flop (didn't bet)



PokerStars Zoom Hand #195022103810:  Hold'em No Limit ($0.10/$0.25) - 2018/12/29 2:37:28 UTC [2018/12/28 21:37:28 ET]
Table 'Hydra' 6-max Seat #1 is the button
Seat 1: LupiGonzales ($25.66 in chips) 
Seat 2: davidhw888 ($26.27 in chips) 
Seat 3: pioneer577 ($17.39 in chips) 
Seat 4: negreanuNya ($67.94 in chips) 
Seat 5: rush.pp ($107.92 in chips) 
Seat 6: SantiagoWeight ($28.60 in chips) 
davidhw888: posts small blind $0.10
pioneer577: posts big blind $0.25
*** HOLE CARDS ***
Dealt to SantiagoWeight [8d 4h]
negreanuNya: folds 
rush.pp: raises $0.50 to $0.75
SantiagoWeight: folds 
LupiGonzales: folds 
davidhw888: folds 
pioneer577: calls $0.50
*** FLOP *** [Jc Jh Qd]
pioneer577: checks 
rush.pp: bets $1
pioneer577: folds 
Uncalled bet ($1) returned to rush.pp
rush.pp collected $1.53 from pot
rush.pp: doesn't show hand 
*** SUMMARY ***
Total pot $1.60 | Rake $0.07 
Board [Jc Jh Qd]
Seat 1: LupiGonzales (button) folded before Flop (didn't bet)
Seat 2: davidhw888 (small blind) folded before Flop
Seat 3: pioneer577 (big blind) folded on the Flop
Seat 4: negreanuNya folded before Flop (didn't bet)
Seat 5: rush.pp collected ($1.53)
Seat 6: SantiagoWeight folded before Flop (didn't bet)



PokerStars Zoom Hand #195022111541:  Hold'em No Limit ($0.10/$0.25) - 2018/12/29 2:37:48 UTC [2018/12/28 21:37:48 ET]
Table 'Hydra' 6-max Seat #1 is the button
Seat 1: Parsam5 ($51.15 in chips) 
Seat 2: paczek.kr ($25.35 in chips) 
Seat 3: zdena102 ($25 in chips) 
Seat 4: Butch030 ($71.09 in chips) 
Seat 5: SantiagoWeight ($28.60 in chips) 
Seat 6: !P0K3RM3T4L! ($25 in chips) 
paczek.kr: posts small blind $0.10
zdena102: posts big blind $0.25
*** HOLE CARDS ***
Dealt to SantiagoWeight [Kd 6c]
Butch030: folds 
SantiagoWeight has timed out
SantiagoWeight: folds 
!P0K3RM3T4L!: folds 
Parsam5: folds 
paczek.kr: folds 
Uncalled bet ($0.15) returned to zdena102
zdena102 collected $0.20 from pot
zdena102: doesn't show hand 
*** SUMMARY ***
Total pot $0.20 | Rake $0 
Seat 1: Parsam5 (button) folded before Flop (didn't bet)
Seat 2: paczek.kr (small blind) folded before Flop
Seat 3: zdena102 (big blind) collected ($0.20)
Seat 4: Butch030 folded before Flop (didn't bet)
Seat 5: SantiagoWeight folded before Flop (didn't bet)
Seat 6: !P0K3RM3T4L! folded before Flop (didn't bet)



PokerStars Zoom Hand #195022094830:  Hold'em No Limit ($0.10/$0.25) - 2018/12/29 2:37:06 UTC [2018/12/28 21:37:06 ET]
Table 'Hydra' 6-max Seat #1 is the button
Seat 1: SantiagoWeight ($28.60 in chips) 
Seat 2: steveblockx ($14.45 in chips) 
Seat 3: ongravity ($24.32 in chips) 
Seat 4: TDAK1509 ($35.84 in chips) 
Seat 5: moderi ($11.78 in chips) 
Seat 6: Cryptoz91 ($26.29 in chips) 
steveblockx: posts small blind $0.10
ongravity: posts big blind $0.25
*** HOLE CARDS ***
Dealt to SantiagoWeight [Ad 5c]
TDAK1509: folds 
moderi: calls $0.25
Cryptoz91: raises $0.75 to $1
SantiagoWeight: folds 
steveblockx: folds 
ongravity: calls $0.75
moderi: calls $0.75
*** FLOP *** [9c 3s Qd]
ongravity: checks 
moderi: checks 
Cryptoz91: checks 
*** TURN *** [9c 3s Qd] [9s]
ongravity: checks 
moderi: checks 
Cryptoz91: bets $1.60
ongravity: folds 
moderi: folds 
Uncalled bet ($1.60) returned to Cryptoz91
Cryptoz91 collected $2.96 from pot
Cryptoz91: doesn't show hand 
*** SUMMARY ***
Total pot $3.10 | Rake $0.14 
Board [9c 3s Qd 9s]
Seat 1: SantiagoWeight (button) folded before Flop (didn't bet)
Seat 2: steveblockx (small blind) folded before Flop
Seat 3: ongravity (big blind) folded on the Turn
Seat 4: TDAK1509 folded before Flop (didn't bet)
Seat 5: moderi folded on the Turn
Seat 6: Cryptoz91 collected ($2.96)



PokerStars Zoom Hand #195022120443:  Hold'em No Limit ($0.10/$0.25) - 2018/12/29 2:38:11 UTC [2018/12/28 21:38:11 ET]
Table 'Hydra' 6-max Seat #1 is the button
Seat 1: ckriszee ($78.60 in chips) 
Seat 2: pokerpienda ($37.63 in chips) 
Seat 3: ducepot15 ($30.40 in chips) 
Seat 4: SantiagoWeight ($28.60 in chips) 
Seat 5: river plate9 ($41.65 in chips) 
Seat 6: hoodbya!r ($30.17 in chips) 
pokerpienda: posts small blind $0.10
ducepot15: posts big blind $0.25
*** HOLE CARDS ***
Dealt to SantiagoWeight [Ah Qd]
SantiagoWeight: raises $0.50 to $0.75
river plate9: folds 
hoodbya!r: folds 
ckriszee: folds 
pokerpienda: folds 
ducepot15: calls $0.50
*** FLOP *** [2c 5c 9s]
ducepot15: checks 
SantiagoWeight: checks 
*** TURN *** [2c 5c 9s] [5d]
ducepot15: checks 
SantiagoWeight: bets $0.70
ducepot15: calls $0.70
*** RIVER *** [2c 5c 9s 5d] [4c]
ducepot15: checks 
SantiagoWeight: checks 
*** SHOW DOWN ***
ducepot15: shows [Tc Kc] (a flush, King high)
SantiagoWeight: mucks hand 
ducepot15 collected $2.86 from pot
*** SUMMARY ***
Total pot $3 | Rake $0.14 
Board [2c 5c 9s 5d 4c]
Seat 1: ckriszee (button) folded before Flop (didn't bet)
Seat 2: pokerpienda (small blind) folded before Flop
Seat 3: ducepot15 (big blind) showed [Tc Kc] and won ($2.86) with a flush, King high
Seat 4: SantiagoWeight mucked [Ah Qd]
Seat 5: river plate9 folded before Flop (didn't bet)
Seat 6: hoodbya!r folded before Flop (didn't bet)



PokerStars Zoom Hand #195022140824:  Hold'em No Limit ($0.10/$0.25) - 2018/12/29 2:39:04 UTC [2018/12/28 21:39:04 ET]
Table 'Hydra' 6-max Seat #1 is the button
Seat 1: franco373513 ($5.56 in chips) 
Seat 2: SantiagoWeight ($27.15 in chips) 
Seat 3: nhanminhtri ($27.62 in chips) 
Seat 4: cpt.peep ($55.69 in chips) 
Seat 5: hoodbya!r ($19.09 in chips) 
Seat 6: Xander_B88 ($46.23 in chips) 
SantiagoWeight: posts small blind $0.10
nhanminhtri: posts big blind $0.25
*** HOLE CARDS ***
Dealt to SantiagoWeight [Js Qd]
cpt.peep: folds 
hoodbya!r: raises $0.50 to $0.75
Xander_B88: raises $1.85 to $2.60
franco373513: folds 
SantiagoWeight: folds 
nhanminhtri: folds 
hoodbya!r: folds 
Uncalled bet ($1.85) returned to Xander_B88
Xander_B88 collected $1.85 from pot
Xander_B88: doesn't show hand 
*** SUMMARY ***
Total pot $1.85 | Rake $0 
Seat 1: franco373513 (button) folded before Flop (didn't bet)
Seat 2: SantiagoWeight (small blind) folded before Flop
Seat 3: nhanminhtri (big blind) folded before Flop
Seat 4: cpt.peep folded before Flop (didn't bet)
Seat 5: hoodbya!r folded before Flop
Seat 6: Xander_B88 collected ($1.85)



PokerStars Zoom Hand #195022172134:  Hold'em No Limit ($0.10/$0.25) - 2018/12/29 2:40:25 UTC [2018/12/28 21:40:25 ET]
Table 'Hydra' 6-max Seat #1 is the button
Seat 1: davidhw888 ($31.20 in chips) 
Seat 2: Cryptoz91 ($27.30 in chips) 
Seat 3: SantiagoWeight ($27.05 in chips) 
Seat 4: SDCMan ($30.31 in chips) 
Seat 5: samioattila ($63.69 in chips) 
Seat 6: zdena102 ($24.83 in chips) 
Cryptoz91: posts small blind $0.10
SantiagoWeight: posts big blind $0.25
*** HOLE CARDS ***
Dealt to SantiagoWeight [Kd Qc]
SDCMan: folds 
samioattila: folds 
zdena102: raises $0.50 to $0.75
davidhw888: folds 
Cryptoz91: folds 
SantiagoWeight: calls $0.50
*** FLOP *** [9c Td 2d]
SantiagoWeight: checks 
zdena102: bets $1
SantiagoWeight: calls $1
*** TURN *** [9c Td 2d] [6d]
SantiagoWeight: checks 
zdena102: checks 
*** RIVER *** [9c Td 2d 6d] [2h]
SantiagoWeight: bets $5.25
zdena102: calls $5.25
*** SHOW DOWN ***
SantiagoWeight: shows [Kd Qc] (a pair of Deuces)
zdena102: shows [Tc Ad] (two pair, Tens and Deuces)
zdena102 collected $13.47 from pot
*** SUMMARY ***
Total pot $14.10 | Rake $0.63 
Board [9c Td 2d 6d 2h]
Seat 1: davidhw888 (button) folded before Flop (didn't bet)
Seat 2: Cryptoz91 (small blind) folded before Flop
Seat 3: SantiagoWeight (big blind) showed [Kd Qc] and lost with a pair of Deuces
Seat 4: SDCMan folded before Flop (didn't bet)
Seat 5: samioattila folded before Flop (didn't bet)
Seat 6: zdena102 showed [Tc Ad] and won ($13.47) with two pair, Tens and Deuces



PokerStars Zoom Hand #195022202659:  Hold'em No Limit ($0.10/$0.25) - 2018/12/29 2:41:43 UTC [2018/12/28 21:41:43 ET]
Table 'Hydra' 6-max Seat #1 is the button
Seat 1: ivann14 ($25.25 in chips) 
Seat 2: Tsundere ($9.16 in chips) 
Seat 3: benddo ($57.40 in chips) 
Seat 4: SantiagoWeight ($20.05 in chips) 
Seat 5: c@ller ($23.72 in chips) 
Seat 6: negreanuNya ($39.38 in chips) 
Tsundere: posts small blind $0.10
benddo: posts big blind $0.25
*** HOLE CARDS ***
Dealt to SantiagoWeight [2s 8d]
SantiagoWeight: folds 
c@ller: folds 
negreanuNya: folds 
ivann14: folds 
Tsundere: raises $0.50 to $0.75
benddo: folds 
Uncalled bet ($0.50) returned to Tsundere
Tsundere collected $0.50 from pot
Tsundere: doesn't show hand 
*** SUMMARY ***
Total pot $0.50 | Rake $0 
Seat 1: ivann14 (button) folded before Flop (didn't bet)
Seat 2: Tsundere (small blind) collected ($0.50)
Seat 3: benddo (big blind) folded before Flop
Seat 4: SantiagoWeight folded before Flop (didn't bet)
Seat 5: c@ller folded before Flop (didn't bet)
Seat 6: negreanuNya folded before Flop (didn't bet)



PokerStars Zoom Hand #195022208097:  Hold'em No Limit ($0.10/$0.25) - 2018/12/29 2:41:57 UTC [2018/12/28 21:41:57 ET]
Table 'Hydra' 6-max Seat #1 is the button
Seat 1: Butch030 ($69.50 in chips) 
Seat 2: BirreteX ($38.96 in chips) 
Seat 3: sZCzpNtheKot ($41.36 in chips) 
Seat 4: Lehared ($32.56 in chips) 
Seat 5: !P0K3RM3T4L! ($25 in chips) 
Seat 6: SantiagoWeight ($20.05 in chips) 
BirreteX: posts small blind $0.10
sZCzpNtheKot: posts big blind $0.25
*** HOLE CARDS ***
Dealt to SantiagoWeight [3d Jc]
Lehared: raises $0.37 to $0.62
!P0K3RM3T4L!: folds 
SantiagoWeight: folds 
Butch030: folds 
BirreteX: folds 
sZCzpNtheKot: folds 
Uncalled bet ($0.37) returned to Lehared
Lehared collected $0.60 from pot
Lehared: doesn't show hand 
*** SUMMARY ***
Total pot $0.60 | Rake $0 
Seat 1: Butch030 (button) folded before Flop (didn't bet)
Seat 2: BirreteX (small blind) folded before Flop
Seat 3: sZCzpNtheKot (big blind) folded before Flop
Seat 4: Lehared collected ($0.60)
Seat 5: !P0K3RM3T4L! folded before Flop (didn't bet)
Seat 6: SantiagoWeight folded before Flop (didn't bet)



PokerStars Zoom Hand #195022210845:  Hold'em No Limit ($0.10/$0.25) - 2018/12/29 2:42:04 UTC [2018/12/28 21:42:04 ET]
Table 'Hydra' 6-max Seat #1 is the button
Seat 1: SantiagoWeight ($20.05 in chips) 
Seat 2: sZCzpNtheKot ($41.11 in chips) 
Seat 3: hoodbya!r ($10.99 in chips) 
Seat 4: Tsundere ($9.41 in chips) 
Seat 5: river plate9 ($42.17 in chips) 
Seat 6: yobbos ($28.76 in chips) 
sZCzpNtheKot: posts small blind $0.10
hoodbya!r: posts big blind $0.25
*** HOLE CARDS ***
Dealt to SantiagoWeight [8h Th]
Tsundere: raises $0.25 to $0.50
river plate9: folds 
yobbos: folds 
SantiagoWeight: calls $0.50
sZCzpNtheKot: folds 
hoodbya!r: folds 
*** FLOP *** [4s 2h 3d]
Tsundere: checks 
SantiagoWeight: bets $0.65
Tsundere: folds 
Uncalled bet ($0.65) returned to SantiagoWeight
SantiagoWeight collected $1.29 from pot
SantiagoWeight: doesn't show hand 
*** SUMMARY ***
Total pot $1.35 | Rake $0.06 
Board [4s 2h 3d]
Seat 1: SantiagoWeight (button) collected ($1.29)
Seat 2: sZCzpNtheKot (small blind) folded before Flop
Seat 3: hoodbya!r (big blind) folded before Flop
Seat 4: Tsundere folded on the Flop
Seat 5: river plate9 folded before Flop (didn't bet)
Seat 6: yobbos folded before Flop (didn't bet)



PokerStars Zoom Hand #195022222426:  Hold'em No Limit ($0.10/$0.25) - 2018/12/29 2:42:34 UTC [2018/12/28 21:42:34 ET]
Table 'Hydra' 6-max Seat #1 is the button
Seat 1: nadal335 ($104.88 in chips) 
Seat 2: ARTBIL ($28.25 in chips) 
Seat 3: nhanminhtri ($26.12 in chips) 
Seat 4: ongravity ($24.61 in chips) 
Seat 5: SantiagoWeight ($20.84 in chips) 
Seat 6: qing328 ($25.07 in chips) 
ARTBIL: posts small blind $0.10
nhanminhtri: posts big blind $0.25
*** HOLE CARDS ***
Dealt to SantiagoWeight [Ah 5d]
ongravity: folds 
SantiagoWeight: folds 
qing328: folds 
nadal335: folds 
ARTBIL: folds 
Uncalled bet ($0.15) returned to nhanminhtri
nhanminhtri collected $0.20 from pot
nhanminhtri: doesn't show hand 
*** SUMMARY ***
Total pot $0.20 | Rake $0 
Seat 1: nadal335 (button) folded before Flop (didn't bet)
Seat 2: ARTBIL (small blind) folded before Flop
Seat 3: nhanminhtri (big blind) collected ($0.20)
Seat 4: ongravity folded before Flop (didn't bet)
Seat 5: SantiagoWeight folded before Flop (didn't bet)
Seat 6: qing328 folded before Flop (didn't bet)



PokerStars Zoom Hand #195022225846:  Hold'em No Limit ($0.10/$0.25) - 2018/12/29 2:42:43 UTC [2018/12/28 21:42:43 ET]
Table 'Hydra' 6-max Seat #1 is the button
Seat 1: aloominat ($25.58 in chips) 
Seat 2: sZCzpNtheKot ($40.76 in chips) 
Seat 3: negreanuNya ($39.28 in chips) 
Seat 4: Chellabro ($24.37 in chips) 
Seat 5: SantiagoWeight ($20.84 in chips) 
Seat 6: Parsam5 ($68.06 in chips) 
sZCzpNtheKot: posts small blind $0.10
negreanuNya: posts big blind $0.25
*** HOLE CARDS ***
Dealt to SantiagoWeight [Ks Jd]
Chellabro: folds 
SantiagoWeight: raises $0.35 to $0.60
Parsam5: folds 
aloominat: folds 
sZCzpNtheKot: folds 
negreanuNya: folds 
Uncalled bet ($0.35) returned to SantiagoWeight
SantiagoWeight collected $0.60 from pot
SantiagoWeight: doesn't show hand 
*** SUMMARY ***
Total pot $0.60 | Rake $0 
Seat 1: aloominat (button) folded before Flop (didn't bet)
Seat 2: sZCzpNtheKot (small blind) folded before Flop
Seat 3: negreanuNya (big blind) folded before Flop
Seat 4: Chellabro folded before Flop (didn't bet)
Seat 5: SantiagoWeight collected ($0.60)
Seat 6: Parsam5 folded before Flop (didn't bet)



PokerStars Zoom Hand #195022234655:  Hold'em No Limit ($0.10/$0.25) - 2018/12/29 2:43:06 UTC [2018/12/28 21:43:06 ET]
Table 'Hydra' 6-max Seat #1 is the button
Seat 1: pioneer577 ($14.32 in chips) 
Seat 2: hoodbya!r ($18.58 in chips) 
Seat 3: SantiagoWeight ($21.19 in chips) 
Seat 4: Franky1853 ($18.78 in chips) 
Seat 5: vegan1972 ($24.45 in chips) 
Seat 6: nadal335 ($28.21 in chips) 
hoodbya!r: posts small blind $0.10
SantiagoWeight: posts big blind $0.25
*** HOLE CARDS ***
Dealt to SantiagoWeight [4c Ac]
Franky1853: raises $0.50 to $0.75
vegan1972: folds 
nadal335: calls $0.75
pioneer577: folds 
hoodbya!r: folds 
SantiagoWeight: calls $0.50
*** FLOP *** [7h 9c 2h]
SantiagoWeight: checks 
Franky1853: checks 
nadal335: checks 
*** TURN *** [7h 9c 2h] [Ad]
SantiagoWeight: checks 
Franky1853: checks 
nadal335: bets $1.12
SantiagoWeight: folds 
Franky1853: folds 
Uncalled bet ($1.12) returned to nadal335
nadal335 collected $2.24 from pot
nadal335: doesn't show hand 
*** SUMMARY ***
Total pot $2.35 | Rake $0.11 
Board [7h 9c 2h Ad]
Seat 1: pioneer577 (button) folded before Flop (didn't bet)
Seat 2: hoodbya!r (small blind) folded before Flop
Seat 3: SantiagoWeight (big blind) folded on the Turn
Seat 4: Franky1853 folded on the Turn
Seat 5: vegan1972 folded before Flop (didn't bet)
Seat 6: nadal335 collected ($2.24)



PokerStars Zoom Hand #195022263739:  Hold'em No Limit ($0.10/$0.25) - 2018/12/29 2:44:22 UTC [2018/12/28 21:44:22 ET]
Table 'Hydra' 6-max Seat #1 is the button
Seat 1: Mrs Flush25 ($65.11 in chips) 
Seat 2: SantiagoWeight ($20.44 in chips) 
Seat 3: negreanuNya ($25.24 in chips) 
Seat 4: cpt.peep ($45.25 in chips) 
Seat 5: yobbos ($125.38 in chips) 
Seat 6: Lehared ($97.54 in chips) 
SantiagoWeight: posts small blind $0.10
negreanuNya: posts big blind $0.25
*** HOLE CARDS ***
Dealt to SantiagoWeight [2c Qs]
cpt.peep: folds 
yobbos: folds 
Lehared: folds 
Mrs Flush25: raises $0.37 to $0.62
SantiagoWeight: folds 
negreanuNya: calls $0.37
*** FLOP *** [5s 3s Ah]
negreanuNya: checks 
Mrs Flush25: checks 
*** TURN *** [5s 3s Ah] [3d]
negreanuNya: checks 
Mrs Flush25: checks 
*** RIVER *** [5s 3s Ah 3d] [Qc]
negreanuNya: bets $0.50
Mrs Flush25: folds 
Uncalled bet ($0.50) returned to negreanuNya
negreanuNya collected $1.28 from pot
negreanuNya: doesn't show hand 
*** SUMMARY ***
Total pot $1.34 | Rake $0.06 
Board [5s 3s Ah 3d Qc]
Seat 1: Mrs Flush25 (button) folded on the River
Seat 2: SantiagoWeight (small blind) folded before Flop
Seat 3: negreanuNya (big blind) collected ($1.28)
Seat 4: cpt.peep folded before Flop (didn't bet)
Seat 5: yobbos folded before Flop (didn't bet)
Seat 6: Lehared folded before Flop (didn't bet)



PokerStars Zoom Hand #195022267250:  Hold'em No Limit ($0.10/$0.25) - 2018/12/29 2:44:31 UTC [2018/12/28 21:44:31 ET]
Table 'Hydra' 6-max Seat #1 is the button
Seat 1: SantiagoWeight ($20.34 in chips) 
Seat 2: benddo ($80.91 in chips) 
Seat 3: hoodbya!r ($10.32 in chips) 
Seat 4: Taran0001 ($4.60 in chips) 
Seat 5: !P0K3RM3T4L! ($64.25 in chips) 
Seat 6: tightpokerAA ($23.25 in chips) 
benddo: posts small blind $0.10
hoodbya!r: posts big blind $0.25
*** HOLE CARDS ***
Dealt to SantiagoWeight [Ts 6s]
Taran0001: folds 
!P0K3RM3T4L!: folds 
tightpokerAA: folds 
SantiagoWeight: raises $0.25 to $0.50
benddo: raises $2 to $2.50
hoodbya!r: folds 
SantiagoWeight: folds 
Uncalled bet ($2) returned to benddo
benddo collected $1.25 from pot
benddo: doesn't show hand 
*** SUMMARY ***
Total pot $1.25 | Rake $0 
Seat 1: SantiagoWeight (button) folded before Flop
Seat 2: benddo (small blind) collected ($1.25)
Seat 3: hoodbya!r (big blind) folded before Flop
Seat 4: Taran0001 folded before Flop (didn't bet)
Seat 5: !P0K3RM3T4L! folded before Flop (didn't bet)
Seat 6: tightpokerAA folded before Flop (didn't bet)



PokerStars Zoom Hand #195022279499:  Hold'em No Limit ($0.10/$0.25) - 2018/12/29 2:45:03 UTC [2018/12/28 21:45:03 ET]
Table 'Hydra' 6-max Seat #1 is the button
Seat 1: Dbakunwaves ($21.65 in chips) 
Seat 2: ChungkingExp ($33.64 in chips) 
Seat 3: benddo ($49.80 in chips) 
Seat 4: SantiagoWeight ($19.84 in chips) 
Seat 5: MarcoA12 ($23.07 in chips) 
Seat 6: !P0K3RM3T4L! ($27.88 in chips) 
ChungkingExp: posts small blind $0.10
benddo: posts big blind $0.25
*** HOLE CARDS ***
Dealt to SantiagoWeight [3c Jc]
SantiagoWeight: folds 
MarcoA12: folds 
!P0K3RM3T4L!: folds 
Dbakunwaves: folds 
ChungkingExp: folds 
Uncalled bet ($0.15) returned to benddo
benddo collected $0.20 from pot
benddo: doesn't show hand 
*** SUMMARY ***
Total pot $0.20 | Rake $0 
Seat 1: Dbakunwaves (button) folded before Flop (didn't bet)
Seat 2: ChungkingExp (small blind) folded before Flop
Seat 3: benddo (big blind) collected ($0.20)
Seat 4: SantiagoWeight folded before Flop (didn't bet)
Seat 5: MarcoA12 folded before Flop (didn't bet)
Seat 6: !P0K3RM3T4L! folded before Flop (didn't bet)



PokerStars Zoom Hand #195022281839:  Hold'em No Limit ($0.10/$0.25) - 2018/12/29 2:45:10 UTC [2018/12/28 21:45:10 ET]
Table 'Hydra' 6-max Seat #1 is the button
Seat 1: Indiaan1625 ($31.08 in chips) 
Seat 2: ola_Sakala ($33.58 in chips) 
Seat 3: trillerGTO ($24.25 in chips) 
Seat 4: HansMSM ($25 in chips) 
Seat 5: oleg77552 ($60.91 in chips) 
Seat 6: SantiagoWeight ($19.84 in chips) 
ola_Sakala: posts small blind $0.10
trillerGTO: posts big blind $0.25
*** HOLE CARDS ***
Dealt to SantiagoWeight [2s Jd]
HansMSM: folds 
oleg77552: folds 
SantiagoWeight: folds 
Indiaan1625: folds 
ola_Sakala: raises $0.50 to $0.75
trillerGTO: folds 
Uncalled bet ($0.50) returned to ola_Sakala
ola_Sakala collected $0.50 from pot
ola_Sakala: doesn't show hand 
*** SUMMARY ***
Total pot $0.50 | Rake $0 
Seat 1: Indiaan1625 (button) folded before Flop (didn't bet)
Seat 2: ola_Sakala (small blind) collected ($0.50)
Seat 3: trillerGTO (big blind) folded before Flop
Seat 4: HansMSM folded before Flop (didn't bet)
Seat 5: oleg77552 folded before Flop (didn't bet)
Seat 6: SantiagoWeight folded before Flop (didn't bet)



PokerStars Zoom Hand #195022285220:  Hold'em No Limit ($0.10/$0.25) - 2018/12/29 2:45:18 UTC [2018/12/28 21:45:18 ET]
Table 'Hydra' 6-max Seat #1 is the button
Seat 1: TQNYMQNTANA ($25 in chips) 
Seat 2: zdenekstavic ($21.43 in chips) 
Seat 3: BIGPAIN14 ($56.90 in chips) 
Seat 4: SantiagoWeight ($19.84 in chips) 
Seat 5: Bujan 07 ($22.98 in chips) 
Seat 6: negreanuNya ($35.59 in chips) 
zdenekstavic: posts small blind $0.10
BIGPAIN14: posts big blind $0.25
*** HOLE CARDS ***
Dealt to SantiagoWeight [5h 9s]
SantiagoWeight: folds 
Bujan 07: raises $0.50 to $0.75
negreanuNya: folds 
TQNYMQNTANA: folds 
zdenekstavic: folds 
BIGPAIN14: folds 
Uncalled bet ($0.50) returned to Bujan 07
Bujan 07 collected $0.60 from pot
Bujan 07: doesn't show hand 
*** SUMMARY ***
Total pot $0.60 | Rake $0 
Seat 1: TQNYMQNTANA (button) folded before Flop (didn't bet)
Seat 2: zdenekstavic (small blind) folded before Flop
Seat 3: BIGPAIN14 (big blind) folded before Flop
Seat 4: SantiagoWeight folded before Flop (didn't bet)
Seat 5: Bujan 07 collected ($0.60)
Seat 6: negreanuNya folded before Flop (didn't bet)



PokerStars Zoom Hand #195022289012:  Hold'em No Limit ($0.10/$0.25) - 2018/12/29 2:45:28 UTC [2018/12/28 21:45:28 ET]
Table 'Hydra' 6-max Seat #1 is the button
Seat 1: yobbos ($50.87 in chips) 
Seat 2: ryanking99 ($42.89 in chips) 
Seat 3: benddo ($50.40 in chips) 
Seat 4: freak896 ($9.28 in chips) 
Seat 5: SantiagoWeight ($19.84 in chips) 
Seat 6: rim975 ($19.70 in chips) 
ryanking99: posts small blind $0.10
benddo: posts big blind $0.25
*** HOLE CARDS ***
Dealt to SantiagoWeight [Kd Js]
freak896: folds 
SantiagoWeight: raises $0.40 to $0.65
rim975: folds 
yobbos: folds 
ryanking99: folds 
benddo: folds 
Uncalled bet ($0.40) returned to SantiagoWeight
SantiagoWeight collected $0.60 from pot
SantiagoWeight: doesn't show hand 
*** SUMMARY ***
Total pot $0.60 | Rake $0 
Seat 1: yobbos (button) folded before Flop (didn't bet)
Seat 2: ryanking99 (small blind) folded before Flop
Seat 3: benddo (big blind) folded before Flop
Seat 4: freak896 folded before Flop (didn't bet)
Seat 5: SantiagoWeight collected ($0.60)
Seat 6: rim975 folded before Flop (didn't bet)



PokerStars Zoom Hand #195022297342:  Hold'em No Limit ($0.10/$0.25) - 2018/12/29 2:45:50 UTC [2018/12/28 21:45:50 ET]
Table 'Hydra' 6-max Seat #1 is the button
Seat 1: Butch030 ($122.03 in chips) 
Seat 2: SantiagoWeight ($25 in chips) 
Seat 3: sigaro010 ($26.70 in chips) 
Seat 4: samioattila ($40.47 in chips) 
Seat 5: MileVoliD49 ($53.82 in chips) 
Seat 6: ryanking99 ($42.89 in chips) 
SantiagoWeight: posts small blind $0.10
sigaro010: posts big blind $0.25
*** HOLE CARDS ***
Dealt to SantiagoWeight [9s Ac]
samioattila: folds 
MileVoliD49: folds 
ryanking99: folds 
Butch030: folds 
SantiagoWeight: raises $0.50 to $0.75
sigaro010: raises $1.75 to $2.50
SantiagoWeight: folds 
Uncalled bet ($1.75) returned to sigaro010
sigaro010 collected $1.50 from pot
sigaro010: doesn't show hand 
*** SUMMARY ***
Total pot $1.50 | Rake $0 
Seat 1: Butch030 (button) folded before Flop (didn't bet)
Seat 2: SantiagoWeight (small blind) folded before Flop
Seat 3: sigaro010 (big blind) collected ($1.50)
Seat 4: samioattila folded before Flop (didn't bet)
Seat 5: MileVoliD49 folded before Flop (didn't bet)
Seat 6: ryanking99 folded before Flop (didn't bet)



PokerStars Zoom Hand #195022316085:  Hold'em No Limit ($0.10/$0.25) - 2018/12/29 2:46:39 UTC [2018/12/28 21:46:39 ET]
Table 'Hydra' 6-max Seat #1 is the button
Seat 1: mariopork ($35.02 in chips) 
Seat 2: Dr.Montana56 ($13.02 in chips) 
Seat 3: SantiagoWeight ($24.25 in chips) 
Seat 4: franco373513 ($15.59 in chips) 
Seat 5: Jack123985 ($28.32 in chips) 
Seat 6: hoodbya!r ($18.06 in chips) 
Dr.Montana56: posts small blind $0.10
SantiagoWeight: posts big blind $0.25
*** HOLE CARDS ***
Dealt to SantiagoWeight [9h 7c]
franco373513: folds 
Jack123985: raises $0.37 to $0.62
hoodbya!r: folds 
mariopork: folds 
Dr.Montana56: folds 
SantiagoWeight: folds 
Uncalled bet ($0.37) returned to Jack123985
Jack123985 collected $0.60 from pot
Jack123985: doesn't show hand 
*** SUMMARY ***
Total pot $0.60 | Rake $0 
Seat 1: mariopork (button) folded before Flop (didn't bet)
Seat 2: Dr.Montana56 (small blind) folded before Flop
Seat 3: SantiagoWeight (big blind) folded before Flop
Seat 4: franco373513 folded before Flop (didn't bet)
Seat 5: Jack123985 collected ($0.60)
Seat 6: hoodbya!r folded before Flop (didn't bet)



PokerStars Zoom Hand #195022334764:  Hold'em No Limit ($0.10/$0.25) - 2018/12/29 2:47:29 UTC [2018/12/28 21:47:29 ET]
Table 'Hydra' 6-max Seat #1 is the button
Seat 1: SantiagoWeight ($24 in chips) 
Seat 2: tightpokerAA ($34.89 in chips) 
Seat 3: deaglepro ($30.72 in chips) 
Seat 4: zhang1zhang ($42.31 in chips) 
Seat 5: gamoniusz ($48.37 in chips) 
Seat 6: MISTAAJ ($51.57 in chips) 
tightpokerAA: posts small blind $0.10
deaglepro: posts big blind $0.25
*** HOLE CARDS ***
Dealt to SantiagoWeight [Qc 6s]
zhang1zhang: folds 
gamoniusz: folds 
MISTAAJ: folds 
SantiagoWeight has timed out
SantiagoWeight: folds 
tightpokerAA: folds 
Uncalled bet ($0.15) returned to deaglepro
deaglepro collected $0.20 from pot
deaglepro: doesn't show hand 
*** SUMMARY ***
Total pot $0.20 | Rake $0 
Seat 1: SantiagoWeight (button) folded before Flop (didn't bet)
Seat 2: tightpokerAA (small blind) folded before Flop
Seat 3: deaglepro (big blind) collected ($0.20)
Seat 4: zhang1zhang folded before Flop (didn't bet)
Seat 5: gamoniusz folded before Flop (didn't bet)
Seat 6: MISTAAJ folded before Flop (didn't bet)



PokerStars Zoom Hand #195022324789:  Hold'em No Limit ($0.10/$0.25) - 2018/12/29 2:47:02 UTC [2018/12/28 21:47:02 ET]
Table 'Hydra' 6-max Seat #1 is the button
Seat 1: sleapyjoe ($6.58 in chips) 
Seat 2: kounoupiss ($84.64 in chips) 
Seat 3: aloominat ($30.18 in chips) 
Seat 4: lbautista91 ($24.10 in chips) 
Seat 5: Kaazer ($14.29 in chips) 
Seat 6: SantiagoWeight ($24 in chips) 
kounoupiss: posts small blind $0.10
aloominat: posts big blind $0.25
*** HOLE CARDS ***
Dealt to SantiagoWeight [8s 9d]
lbautista91 has timed out
lbautista91: folds 
Kaazer: raises $0.50 to $0.75
SantiagoWeight: folds 
sleapyjoe: folds 
kounoupiss: folds 
aloominat: calls $0.50
*** FLOP *** [Jh 6d 9c]
aloominat: checks 
Kaazer: bets $1.53
aloominat: folds 
Uncalled bet ($1.53) returned to Kaazer
Kaazer collected $1.53 from pot
Kaazer: doesn't show hand 
*** SUMMARY ***
Total pot $1.60 | Rake $0.07 
Board [Jh 6d 9c]
Seat 1: sleapyjoe (button) folded before Flop (didn't bet)
Seat 2: kounoupiss (small blind) folded before Flop
Seat 3: aloominat (big blind) folded on the Flop
Seat 4: lbautista91 folded before Flop (didn't bet)
Seat 5: Kaazer collected ($1.53)
Seat 6: SantiagoWeight folded before Flop (didn't bet)



PokerStars Zoom Hand #195022432621:  Hold'em No Limit ($0.10/$0.25) - 2018/12/29 2:51:28 UTC [2018/12/28 21:51:28 ET]
Table 'Hydra' 6-max Seat #1 is the button
Seat 1: zhang1zhang ($37.50 in chips) 
Seat 2: SantiagoWeight ($24 in chips) 
Seat 3: MISTAAJ ($52.19 in chips) 
Seat 4: 6a6JI0 ($14.87 in chips) 
Seat 5: Z3rbinatti ($92.02 in chips) 
Seat 6: yobbos ($35.75 in chips) 
SantiagoWeight: posts small blind $0.10
MISTAAJ: posts big blind $0.25
*** HOLE CARDS ***
Dealt to SantiagoWeight [Td 8s]
6a6JI0: folds 
Z3rbinatti: folds 
yobbos: raises $0.37 to $0.62
zhang1zhang: folds 
SantiagoWeight: folds 
MISTAAJ: folds 
Uncalled bet ($0.37) returned to yobbos
yobbos collected $0.60 from pot
yobbos: doesn't show hand 
*** SUMMARY ***
Total pot $0.60 | Rake $0 
Seat 1: zhang1zhang (button) folded before Flop (didn't bet)
Seat 2: SantiagoWeight (small blind) folded before Flop
Seat 3: MISTAAJ (big blind) folded before Flop
Seat 4: 6a6JI0 folded before Flop (didn't bet)
Seat 5: Z3rbinatti folded before Flop (didn't bet)
Seat 6: yobbos collected ($0.60)



PokerStars Zoom Hand #195022430340:  Hold'em No Limit ($0.10/$0.25) - 2018/12/29 2:51:22 UTC [2018/12/28 21:51:22 ET]
Table 'Hydra' 6-max Seat #1 is the button
Seat 1: samioattila ($70.80 in chips) 
Seat 2: Dbakunwaves ($46.74 in chips) 
Seat 3: Lehared ($92.55 in chips) 
Seat 4: SantiagoWeight ($24 in chips) 
Seat 5: crescendo34 ($9.14 in chips) 
Seat 6: anorectal ($52.36 in chips) 
Dbakunwaves: posts small blind $0.10
Lehared: posts big blind $0.25
*** HOLE CARDS ***
Dealt to SantiagoWeight [5s Th]
SantiagoWeight: folds 
crescendo34: folds 
anorectal: raises $0.45 to $0.70
samioattila: folds 
Dbakunwaves: raises $1.55 to $2.25
Lehared: folds 
anorectal: calls $1.55
*** FLOP *** [Ad 2h 9s]
Dbakunwaves: checks 
anorectal: checks 
*** TURN *** [Ad 2h 9s] [Ts]
Dbakunwaves: checks 
anorectal: checks 
*** RIVER *** [Ad 2h 9s Ts] [3s]
Dbakunwaves: bets $2.72
anorectal: folds 
Uncalled bet ($2.72) returned to Dbakunwaves
Dbakunwaves collected $4.54 from pot
Dbakunwaves: doesn't show hand 
*** SUMMARY ***
Total pot $4.75 | Rake $0.21 
Board [Ad 2h 9s Ts 3s]
Seat 1: samioattila (button) folded before Flop (didn't bet)
Seat 2: Dbakunwaves (small blind) collected ($4.54)
Seat 3: Lehared (big blind) folded before Flop
Seat 4: SantiagoWeight folded before Flop (didn't bet)
Seat 5: crescendo34 folded before Flop (didn't bet)
Seat 6: anorectal folded on the River



PokerStars Zoom Hand #195022441855:  Hold'em No Limit ($0.10/$0.25) - 2018/12/29 2:51:52 UTC [2018/12/28 21:51:52 ET]
Table 'Hydra' 6-max Seat #1 is the button
Seat 1: anorectal ($57.43 in chips) 
Seat 2: call me??107 ($20.77 in chips) 
Seat 3: SantiagoWeight ($23.90 in chips) 
Seat 4: tightpokerAA ($29.89 in chips) 
Seat 5: Cryptoz91 ($37.36 in chips) 
Seat 6: xXBossHossXx ($28.88 in chips) 
call me??107: posts small blind $0.10
SantiagoWeight: posts big blind $0.25
*** HOLE CARDS ***
Dealt to SantiagoWeight [6d Ts]
tightpokerAA: folds 
Cryptoz91: folds 
xXBossHossXx: folds 
anorectal: raises $0.35 to $0.60
call me??107: raises $1.45 to $2.05
SantiagoWeight: folds 
anorectal: calls $1.45
*** FLOP *** [8s Qs 7h]
call me??107: bets $2.08
anorectal: folds 
Uncalled bet ($2.08) returned to call me??107
call me??107 collected $4.15 from pot
call me??107: doesn't show hand 
*** SUMMARY ***
Total pot $4.35 | Rake $0.20 
Board [8s Qs 7h]
Seat 1: anorectal (button) folded on the Flop
Seat 2: call me??107 (small blind) collected ($4.15)
Seat 3: SantiagoWeight (big blind) folded before Flop
Seat 4: tightpokerAA folded before Flop (didn't bet)
Seat 5: Cryptoz91 folded before Flop (didn't bet)
Seat 6: xXBossHossXx folded before Flop (didn't bet)



PokerStars Zoom Hand #195022453554:  Hold'em No Limit ($0.10/$0.25) - 2018/12/29 2:52:24 UTC [2018/12/28 21:52:24 ET]
Table 'Hydra' 6-max Seat #1 is the button
Seat 1: Z3rbinatti ($111.58 in chips) 
Seat 2: Chrimmpam ($19.50 in chips) 
Seat 3: yobbos ($35.25 in chips) 
Seat 4: SantiagoWeight ($23.65 in chips) 
Seat 5: nhanminhtri ($25 in chips) 
Seat 6: mihai_f1986 ($24.30 in chips) 
Chrimmpam: posts small blind $0.10
yobbos: posts big blind $0.25
*** HOLE CARDS ***
Dealt to SantiagoWeight [8h 9d]
SantiagoWeight: folds 
nhanminhtri: raises $0.50 to $0.75
mihai_f1986: folds 
Z3rbinatti: folds 
Chrimmpam: folds 
yobbos: folds 
Uncalled bet ($0.50) returned to nhanminhtri
nhanminhtri collected $0.60 from pot
nhanminhtri: doesn't show hand 
*** SUMMARY ***
Total pot $0.60 | Rake $0 
Seat 1: Z3rbinatti (button) folded before Flop (didn't bet)
Seat 2: Chrimmpam (small blind) folded before Flop
Seat 3: yobbos (big blind) folded before Flop
Seat 4: SantiagoWeight folded before Flop (didn't bet)
Seat 5: nhanminhtri collected ($0.60)
Seat 6: mihai_f1986 folded before Flop (didn't bet)



PokerStars Zoom Hand #195022436721:  Hold'em No Limit ($0.10/$0.25) - 2018/12/29 2:51:39 UTC [2018/12/28 21:51:39 ET]
Table 'Hydra' 6-max Seat #1 is the button
Seat 1: ryanking99 ($47.52 in chips) 
Seat 2: KrishnaRadha ($30.60 in chips) 
Seat 3: tightpokerAA ($23.22 in chips) 
Seat 4: aa1421b ($6.86 in chips) 
Seat 5: winwinboy ($28.53 in chips) 
Seat 6: SantiagoWeight ($23.90 in chips) 
KrishnaRadha: posts small blind $0.10
tightpokerAA: posts big blind $0.25
*** HOLE CARDS ***
Dealt to SantiagoWeight [6d 5h]
aa1421b: folds 
winwinboy: raises $0.43 to $0.68
SantiagoWeight: folds 
ryanking99: folds 
KrishnaRadha: folds 
tightpokerAA: raises $1.46 to $2.14
winwinboy: calls $1.46
*** FLOP *** [7c 2h Th]
tightpokerAA: bets $2.09
winwinboy: calls $2.09
*** TURN *** [7c 2h Th] [Kh]
tightpokerAA: bets $5.75
winwinboy: folds 
Uncalled bet ($5.75) returned to tightpokerAA
tightpokerAA collected $8.17 from pot
tightpokerAA: doesn't show hand 
*** SUMMARY ***
Total pot $8.56 | Rake $0.39 
Board [7c 2h Th Kh]
Seat 1: ryanking99 (button) folded before Flop (didn't bet)
Seat 2: KrishnaRadha (small blind) folded before Flop
Seat 3: tightpokerAA (big blind) collected ($8.17)
Seat 4: aa1421b folded before Flop (didn't bet)
Seat 5: winwinboy folded on the Turn
Seat 6: SantiagoWeight folded before Flop (didn't bet)



PokerStars Zoom Hand #195022461041:  Hold'em No Limit ($0.10/$0.25) - 2018/12/29 2:52:44 UTC [2018/12/28 21:52:44 ET]
Table 'Hydra' 6-max Seat #1 is the button
Seat 1: ARTBIL ($20.82 in chips) 
Seat 2: !P0K3RM3T4L! ($58.60 in chips) 
Seat 3: HonourMan23 ($35.10 in chips) 
Seat 4: nhanminhtri ($25.35 in chips) 
Seat 5: SantiagoWeight ($23.65 in chips) 
Seat 6: Parsam5 ($35.68 in chips) 
!P0K3RM3T4L!: posts small blind $0.10
HonourMan23: posts big blind $0.25
*** HOLE CARDS ***
Dealt to SantiagoWeight [Jd 6c]
nhanminhtri: raises $0.50 to $0.75
SantiagoWeight: folds 
Parsam5: folds 
ARTBIL: folds 
!P0K3RM3T4L!: folds 
HonourMan23: folds 
Uncalled bet ($0.50) returned to nhanminhtri
nhanminhtri collected $0.60 from pot
nhanminhtri: doesn't show hand 
*** SUMMARY ***
Total pot $0.60 | Rake $0 
Seat 1: ARTBIL (button) folded before Flop (didn't bet)
Seat 2: !P0K3RM3T4L! (small blind) folded before Flop
Seat 3: HonourMan23 (big blind) folded before Flop
Seat 4: nhanminhtri collected ($0.60)
Seat 5: SantiagoWeight folded before Flop (didn't bet)
Seat 6: Parsam5 folded before Flop (didn't bet)



PokerStars Zoom Hand #195022466634:  Hold'em No Limit ($0.10/$0.25) - 2018/12/29 2:52:58 UTC [2018/12/28 21:52:58 ET]
Table 'Hydra' 6-max Seat #1 is the button
Seat 1: 6a6JI0 ($12.90 in chips) 
Seat 2: SantiagoWeight ($23.65 in chips) 
Seat 3: zdenekstavic ($10.08 in chips) 
Seat 4: davidhw888 ($35.37 in chips) 
Seat 5: Dr.Jekyll197 ($17.44 in chips) 
Seat 6: svents ($58.33 in chips) 
SantiagoWeight: posts small blind $0.10
zdenekstavic: posts big blind $0.25
*** HOLE CARDS ***
Dealt to SantiagoWeight [2s Td]
davidhw888: folds 
Dr.Jekyll197: folds 
svents: raises $0.30 to $0.55
6a6JI0: folds 
SantiagoWeight: folds 
zdenekstavic: folds 
Uncalled bet ($0.30) returned to svents
svents collected $0.60 from pot
svents: doesn't show hand 
*** SUMMARY ***
Total pot $0.60 | Rake $0 
Seat 1: 6a6JI0 (button) folded before Flop (didn't bet)
Seat 2: SantiagoWeight (small blind) folded before Flop
Seat 3: zdenekstavic (big blind) folded before Flop
Seat 4: davidhw888 folded before Flop (didn't bet)
Seat 5: Dr.Jekyll197 folded before Flop (didn't bet)
Seat 6: svents collected ($0.60)



PokerStars Zoom Hand #195022455815:  Hold'em No Limit ($0.10/$0.25) - 2018/12/29 2:52:29 UTC [2018/12/28 21:52:29 ET]
Table 'Hydra' 6-max Seat #1 is the button
Seat 1: SantiagoWeight ($23.65 in chips) 
Seat 2: samioattila ($47.63 in chips) 
Seat 3: trillerGTO ($26.62 in chips) 
Seat 4: ARTBIL ($26.28 in chips) 
Seat 5: mariopork ($31.24 in chips) 
Seat 6: SapientiAA ($25 in chips) 
samioattila: posts small blind $0.10
trillerGTO: posts big blind $0.25
*** HOLE CARDS ***
Dealt to SantiagoWeight [Ac Th]
ARTBIL: raises $0.50 to $0.75
mariopork: folds 
SapientiAA: calls $0.75
SantiagoWeight: folds 
samioattila: folds 
trillerGTO: folds 
*** FLOP *** [5d Kc 6h]
ARTBIL: bets $1.18
SapientiAA: calls $1.18
*** TURN *** [5d Kc 6h] [8d]
ARTBIL: checks 
SapientiAA: bets $0.75
ARTBIL: calls $0.75
*** RIVER *** [5d Kc 6h 8d] [6d]
ARTBIL: checks 
SapientiAA: checks 
*** SHOW DOWN ***
ARTBIL: shows [9s Js] (a pair of Sixes)
SapientiAA: shows [Td Ts] (two pair, Tens and Sixes)
SapientiAA collected $5.45 from pot
*** SUMMARY ***
Total pot $5.71 | Rake $0.26 
Board [5d Kc 6h 8d 6d]
Seat 1: SantiagoWeight (button) folded before Flop (didn't bet)
Seat 2: samioattila (small blind) folded before Flop
Seat 3: trillerGTO (big blind) folded before Flop
Seat 4: ARTBIL showed [9s Js] and lost with a pair of Sixes
Seat 5: mariopork folded before Flop (didn't bet)
Seat 6: SapientiAA showed [Td Ts] and won ($5.45) with two pair, Tens and Sixes



PokerStars Zoom Hand #195022477338:  Hold'em No Limit ($0.10/$0.25) - 2018/12/29 2:53:27 UTC [2018/12/28 21:53:27 ET]
Table 'Hydra' 6-max Seat #1 is the button
Seat 1: tightpokerAA ($33.75 in chips) 
Seat 2: ckriszee ($25 in chips) 
Seat 3: Baboscrubx ($29.52 in chips) 
Seat 4: samioattila ($83.90 in chips) 
Seat 5: jeffwalker23 ($36.15 in chips) 
Seat 6: SantiagoWeight ($23.30 in chips) 
ckriszee: posts small blind $0.10
Baboscrubx: posts big blind $0.25
*** HOLE CARDS ***
Dealt to SantiagoWeight [4d 9s]
samioattila: folds 
jeffwalker23: raises $0.50 to $0.75
SantiagoWeight: folds 
tightpokerAA: folds 
ckriszee: folds 
Baboscrubx: folds 
Uncalled bet ($0.50) returned to jeffwalker23
jeffwalker23 collected $0.60 from pot
jeffwalker23: doesn't show hand 
*** SUMMARY ***
Total pot $0.60 | Rake $0 
Seat 1: tightpokerAA (button) folded before Flop (didn't bet)
Seat 2: ckriszee (small blind) folded before Flop
Seat 3: Baboscrubx (big blind) folded before Flop
Seat 4: samioattila folded before Flop (didn't bet)
Seat 5: jeffwalker23 collected ($0.60)
Seat 6: SantiagoWeight folded before Flop (didn't bet)



PokerStars Zoom Hand #195022469898:  Hold'em No Limit ($0.10/$0.25) - 2018/12/29 2:53:07 UTC [2018/12/28 21:53:07 ET]
Table 'Hydra' 6-max Seat #1 is the button
Seat 1: Z3rbinatti ($95.86 in chips) 
Seat 2: Buntar017 ($95.06 in chips) 
Seat 3: SantiagoWeight ($23.55 in chips) 
Seat 4: mariopork ($30.52 in chips) 
Seat 5: Fujfuj_Mele ($29.41 in chips) 
Seat 6: ryanking99 ($34.97 in chips) 
Buntar017: posts small blind $0.10
SantiagoWeight: posts big blind $0.25
*** HOLE CARDS ***
Dealt to SantiagoWeight [5h Th]
mariopork: folds 
Fujfuj_Mele: folds 
ryanking99: raises $0.31 to $0.56
Z3rbinatti: folds 
Buntar017: calls $0.46
SantiagoWeight: folds 
*** FLOP *** [6d Qd 2c]
Buntar017: bets $0.25
ryanking99: calls $0.25
*** TURN *** [6d Qd 2c] [Td]
Buntar017: bets $1
ryanking99: calls $1
*** RIVER *** [6d Qd 2c Td] [9s]
Buntar017: bets $4.25
ryanking99: calls $4.25
*** SHOW DOWN ***
Buntar017: shows [As 7c] (high card Ace)
ryanking99: shows [Jc Js] (a pair of Jacks)
ryanking99 collected $11.81 from pot
*** SUMMARY ***
Total pot $12.37 | Rake $0.56 
Board [6d Qd 2c Td 9s]
Seat 1: Z3rbinatti (button) folded before Flop (didn't bet)
Seat 2: Buntar017 (small blind) showed [As 7c] and lost with high card Ace
Seat 3: SantiagoWeight (big blind) folded before Flop
Seat 4: mariopork folded before Flop (didn't bet)
Seat 5: Fujfuj_Mele folded before Flop (didn't bet)
Seat 6: ryanking99 showed [Jc Js] and won ($11.81) with a pair of Jacks



PokerStars Zoom Hand #195022489646:  Hold'em No Limit ($0.10/$0.25) - 2018/12/29 2:54:00 UTC [2018/12/28 21:54:00 ET]
Table 'Hydra' 6-max Seat #1 is the button
Seat 1: SantiagoWeight ($23.30 in chips) 
Seat 2: samioattila ($48.33 in chips) 
Seat 3: nadal335 ($108.08 in chips) 
Seat 4: Cryptoz91 ($57.47 in chips) 
Seat 5: glennsterr ($32.81 in chips) 
Seat 6: osa126 ($33.10 in chips) 
samioattila: posts small blind $0.10
nadal335: posts big blind $0.25
*** HOLE CARDS ***
Dealt to SantiagoWeight [4s 7d]
Cryptoz91: folds 
glennsterr: folds 
osa126: folds 
SantiagoWeight: folds 
samioattila: raises $0.50 to $0.75
nadal335: folds 
Uncalled bet ($0.50) returned to samioattila
samioattila collected $0.50 from pot
samioattila: doesn't show hand 
*** SUMMARY ***
Total pot $0.50 | Rake $0 
Seat 1: SantiagoWeight (button) folded before Flop (didn't bet)
Seat 2: samioattila (small blind) collected ($0.50)
Seat 3: nadal335 (big blind) folded before Flop
Seat 4: Cryptoz91 folded before Flop (didn't bet)
Seat 5: glennsterr folded before Flop (didn't bet)
Seat 6: osa126 folded before Flop (didn't bet)



PokerStars Zoom Hand #195022484064:  Hold'em No Limit ($0.10/$0.25) - 2018/12/29 2:53:46 UTC [2018/12/28 21:53:46 ET]
Table 'Hydra' 6-max Seat #1 is the button
Seat 1: SDCMan ($25.80 in chips) 
Seat 2: altum15a ($54.62 in chips) 
Seat 3: nathan_eeg ($18.81 in chips) 
Seat 4: Dr.Jekyll197 ($16.59 in chips) 
Seat 5: SantiagoWeight ($23.30 in chips) 
Seat 6: nhanminhtri ($29.44 in chips) 
altum15a: posts small blind $0.10
nathan_eeg: posts big blind $0.25
*** HOLE CARDS ***
Dealt to SantiagoWeight [Tc 3c]
Dr.Jekyll197: folds 
SantiagoWeight: folds 
nhanminhtri: folds 
SDCMan: raises $0.50 to $0.75
altum15a: calls $0.65
nathan_eeg: calls $0.50
*** FLOP *** [2h 3s 7c]
altum15a: bets $2.25
nathan_eeg: folds 
SDCMan: folds 
Uncalled bet ($2.25) returned to altum15a
altum15a collected $2.15 from pot
altum15a: doesn't show hand 
*** SUMMARY ***
Total pot $2.25 | Rake $0.10 
Board [2h 3s 7c]
Seat 1: SDCMan (button) folded on the Flop
Seat 2: altum15a (small blind) collected ($2.15)
Seat 3: nathan_eeg (big blind) folded on the Flop
Seat 4: Dr.Jekyll197 folded before Flop (didn't bet)
Seat 5: SantiagoWeight folded before Flop (didn't bet)
Seat 6: nhanminhtri folded before Flop (didn't bet)



PokerStars Zoom Hand #195022497201:  Hold'em No Limit ($0.10/$0.25) - 2018/12/29 2:54:21 UTC [2018/12/28 21:54:21 ET]
Table 'Hydra' 6-max Seat #1 is the button
Seat 1: MISTAAJ ($15.47 in chips) 
Seat 2: SantiagoWeight ($23.30 in chips) 
Seat 3: kounoupiss ($147.89 in chips) 
Seat 4: Lehared ($89.45 in chips) 
Seat 5: nhanminhtri ($25 in chips) 
Seat 6: ryanking99 ($30.53 in chips) 
SantiagoWeight: posts small blind $0.10
kounoupiss: posts big blind $0.25
*** HOLE CARDS ***
Dealt to SantiagoWeight [7h Ad]
Lehared: folds 
nhanminhtri: folds 
ryanking99: folds 
MISTAAJ: raises $0.50 to $0.75
SantiagoWeight: folds 
kounoupiss: raises $2.25 to $3
MISTAAJ: folds 
Uncalled bet ($2.25) returned to kounoupiss
kounoupiss collected $1.60 from pot
kounoupiss: doesn't show hand 
*** SUMMARY ***
Total pot $1.60 | Rake $0 
Seat 1: MISTAAJ (button) folded before Flop
Seat 2: SantiagoWeight (small blind) folded before Flop
Seat 3: kounoupiss (big blind) collected ($1.60)
Seat 4: Lehared folded before Flop (didn't bet)
Seat 5: nhanminhtri folded before Flop (didn't bet)
Seat 6: ryanking99 folded before Flop (didn't bet)



PokerStars Zoom Hand #195022494581:  Hold'em No Limit ($0.10/$0.25) - 2018/12/29 2:54:14 UTC [2018/12/28 21:54:14 ET]
Table 'Hydra' 6-max Seat #1 is the button
Seat 1: SirSatan001 ($33.96 in chips) 
Seat 2: yobbos ($104.55 in chips) 
Seat 3: kounoupiss ($82.04 in chips) 
Seat 4: SantiagoWeight ($23.30 in chips) 
Seat 5: ivann14 ($25 in chips) 
Seat 6: Chrimmpam ($24.35 in chips) 
yobbos: posts small blind $0.10
kounoupiss: posts big blind $0.25
*** HOLE CARDS ***
Dealt to SantiagoWeight [Th 9s]
SantiagoWeight: folds 
ivann14: folds 
Chrimmpam: folds 
SirSatan001: folds 
yobbos: raises $0.37 to $0.62
kounoupiss: calls $0.37
*** FLOP *** [4c Jh 2d]
yobbos: bets $0.59
kounoupiss: calls $0.59
*** TURN *** [4c Jh 2d] [5d]
yobbos: bets $0.79
kounoupiss: calls $0.79
*** RIVER *** [4c Jh 2d 5d] [8c]
yobbos: bets $2.83
kounoupiss: calls $2.83
*** SHOW DOWN ***
yobbos: shows [As Tc] (high card Ace)
kounoupiss: shows [Qh Jc] (a pair of Jacks)
kounoupiss collected $9.23 from pot
*** SUMMARY ***
Total pot $9.66 | Rake $0.43 
Board [4c Jh 2d 5d 8c]
Seat 1: SirSatan001 (button) folded before Flop (didn't bet)
Seat 2: yobbos (small blind) showed [As Tc] and lost with high card Ace
Seat 3: kounoupiss (big blind) showed [Qh Jc] and won ($9.23) with a pair of Jacks
Seat 4: SantiagoWeight folded before Flop (didn't bet)
Seat 5: ivann14 folded before Flop (didn't bet)
Seat 6: Chrimmpam folded before Flop (didn't bet)



PokerStars Zoom Hand #195022500840:  Hold'em No Limit ($0.10/$0.25) - 2018/12/29 2:54:30 UTC [2018/12/28 21:54:30 ET]
Table 'Hydra' 6-max Seat #1 is the button
Seat 1: mariopork ($29.82 in chips) 
Seat 2: samioattila ($42.52 in chips) 
Seat 3: SantiagoWeight ($23.20 in chips) 
Seat 4: ivann14 ($27 in chips) 
Seat 5: tightpokerAA ($33.40 in chips) 
Seat 6: deaglepro ($25.44 in chips) 
samioattila: posts small blind $0.10
SantiagoWeight: posts big blind $0.25
*** HOLE CARDS ***
Dealt to SantiagoWeight [9h 9c]
ivann14: folds 
tightpokerAA: folds 
deaglepro: folds 
mariopork: folds 
samioattila: raises $0.50 to $0.75
SantiagoWeight: raises $1.50 to $2.25
samioattila: calls $1.50
*** FLOP *** [5h Qh 3d]
samioattila: checks 
SantiagoWeight: bets $1.25
samioattila: raises $5.78 to $7.03
SantiagoWeight: calls $5.78
*** TURN *** [5h Qh 3d] [Jh]
samioattila: bets $23.92
SantiagoWeight: folds 
Uncalled bet ($23.92) returned to samioattila
samioattila collected $17.72 from pot
samioattila: doesn't show hand 
*** SUMMARY ***
Total pot $18.56 | Rake $0.84 
Board [5h Qh 3d Jh]
Seat 1: mariopork (button) folded before Flop (didn't bet)
Seat 2: samioattila (small blind) collected ($17.72)
Seat 3: SantiagoWeight (big blind) folded on the Turn
Seat 4: ivann14 folded before Flop (didn't bet)
Seat 5: tightpokerAA folded before Flop (didn't bet)
Seat 6: deaglepro folded before Flop (didn't bet)



PokerStars Zoom Hand #195022543030:  Hold'em No Limit ($0.10/$0.25) - 2018/12/29 2:56:36 UTC [2018/12/28 21:56:36 ET]
Table 'Hydra' 6-max Seat #1 is the button
Seat 1: paulieGB ($35.32 in chips) 
Seat 2: FrommyBu ($31.53 in chips) 
Seat 3: BärbärKush ($25 in chips) 
Seat 4: SantiagoWeight ($15.72 in chips) 
Seat 5: trillerGTO ($23.76 in chips) 
Seat 6: Alehan-ev ($25 in chips) 
FrommyBu: posts small blind $0.10
BärbärKush: posts big blind $0.25
*** HOLE CARDS ***
Dealt to SantiagoWeight [2d 5h]
SantiagoWeight: folds 
trillerGTO: folds 
Alehan-ev: folds 
paulieGB: folds 
FrommyBu: folds 
Uncalled bet ($0.15) returned to BärbärKush
BärbärKush collected $0.20 from pot
BärbärKush: doesn't show hand 
*** SUMMARY ***
Total pot $0.20 | Rake $0 
Seat 1: paulieGB (button) folded before Flop (didn't bet)
Seat 2: FrommyBu (small blind) folded before Flop
Seat 3: BärbärKush (big blind) collected ($0.20)
Seat 4: SantiagoWeight folded before Flop (didn't bet)
Seat 5: trillerGTO folded before Flop (didn't bet)
Seat 6: Alehan-ev folded before Flop (didn't bet)



PokerStars Zoom Hand #195022537617:  Hold'em No Limit ($0.10/$0.25) - 2018/12/29 2:56:19 UTC [2018/12/28 21:56:19 ET]
Table 'Hydra' 6-max Seat #1 is the button
Seat 1: samioattila ($82.65 in chips) 
Seat 2: winwinboy ($25 in chips) 
Seat 3: Cryptoz91 ($60.28 in chips) 
Seat 4: FrommyBu ($25 in chips) 
Seat 5: SantiagoWeight ($15.72 in chips) 
Seat 6: Z3rbinatti ($122.35 in chips) 
winwinboy: posts small blind $0.10
Cryptoz91: posts big blind $0.25
*** HOLE CARDS ***
Dealt to SantiagoWeight [Qh 3c]
FrommyBu: raises $0.45 to $0.70
SantiagoWeight: folds 
Z3rbinatti: folds 
samioattila: folds 
winwinboy has timed out
winwinboy: folds 
Cryptoz91: folds 
Uncalled bet ($0.45) returned to FrommyBu
FrommyBu collected $0.60 from pot
FrommyBu: doesn't show hand 
*** SUMMARY ***
Total pot $0.60 | Rake $0 
Seat 1: samioattila (button) folded before Flop (didn't bet)
Seat 2: winwinboy (small blind) folded before Flop
Seat 3: Cryptoz91 (big blind) folded before Flop
Seat 4: FrommyBu collected ($0.60)
Seat 5: SantiagoWeight folded before Flop (didn't bet)
Seat 6: Z3rbinatti folded before Flop (didn't bet)



PokerStars Zoom Hand #195022535418:  Hold'em No Limit ($0.10/$0.25) - 2018/12/29 2:56:12 UTC [2018/12/28 21:56:12 ET]
Table 'Hydra' 6-max Seat #1 is the button
Seat 1: tightpokerAA ($35.14 in chips) 
Seat 2: nathan_eeg ($19.09 in chips) 
Seat 3: samioattila ($50.96 in chips) 
Seat 4: KAOS914 ($34.81 in chips) 
Seat 5: ujustgotpawned ($19.75 in chips) 
Seat 6: SantiagoWeight ($15.72 in chips) 
nathan_eeg: posts small blind $0.10
samioattila: posts big blind $0.25
*** HOLE CARDS ***
Dealt to SantiagoWeight [5d 7s]
KAOS914: raises $0.50 to $0.75
ujustgotpawned: folds 
SantiagoWeight: folds 
tightpokerAA has timed out
tightpokerAA: folds 
nathan_eeg: calls $0.65
samioattila: folds 
*** FLOP *** [4c Ts 9s]
nathan_eeg: bets $1.25
KAOS914: folds 
Uncalled bet ($1.25) returned to nathan_eeg
nathan_eeg collected $1.67 from pot
nathan_eeg: doesn't show hand 
*** SUMMARY ***
Total pot $1.75 | Rake $0.08 
Board [4c Ts 9s]
Seat 1: tightpokerAA (button) folded before Flop (didn't bet)
Seat 2: nathan_eeg (small blind) collected ($1.67)
Seat 3: samioattila (big blind) folded before Flop
Seat 4: KAOS914 folded on the Flop
Seat 5: ujustgotpawned folded before Flop (didn't bet)
Seat 6: SantiagoWeight folded before Flop (didn't bet)



PokerStars Zoom Hand #195022540186:  Hold'em No Limit ($0.10/$0.25) - 2018/12/29 2:56:27 UTC [2018/12/28 21:56:27 ET]
Table 'Hydra' 6-max Seat #1 is the button
Seat 1: Lehared ($51.90 in chips) 
Seat 2: !P0K3RM3T4L! ($27.24 in chips) 
Seat 3: will82777 ($25.10 in chips) 
Seat 4: TDAK1509 ($60.16 in chips) 
Seat 5: SantiagoWeight ($15.72 in chips) 
Seat 6: FoldureAces ($23.82 in chips) 
!P0K3RM3T4L!: posts small blind $0.10
will82777: posts big blind $0.25
*** HOLE CARDS ***
Dealt to SantiagoWeight [7s 3s]
TDAK1509: raises $0.37 to $0.62
SantiagoWeight: folds 
FoldureAces: folds 
Lehared: folds 
!P0K3RM3T4L!: raises $1.68 to $2.30
will82777: folds 
TDAK1509: raises $3.45 to $5.75
!P0K3RM3T4L!: folds 
Uncalled bet ($3.45) returned to TDAK1509
TDAK1509 collected $4.85 from pot
TDAK1509: doesn't show hand 
*** SUMMARY ***
Total pot $4.85 | Rake $0 
Seat 1: Lehared (button) folded before Flop (didn't bet)
Seat 2: !P0K3RM3T4L! (small blind) folded before Flop
Seat 3: will82777 (big blind) folded before Flop
Seat 4: TDAK1509 collected ($4.85)
Seat 5: SantiagoWeight folded before Flop (didn't bet)
Seat 6: FoldureAces folded before Flop (didn't bet)



PokerStars Zoom Hand #195022544339:  Hold'em No Limit ($0.10/$0.25) - 2018/12/29 2:56:40 UTC [2018/12/28 21:56:40 ET]
Table 'Hydra' 6-max Seat #1 is the button
Seat 1: SantiagoWeight ($15.72 in chips) 
Seat 2: realbruzer ($24.50 in chips) 
Seat 3: TQNYMQNTANA ($39.43 in chips) 
Seat 4: Baboscrubx ($25 in chips) 
Seat 5: Dbakunwaves ($53.31 in chips) 
Seat 6: trillerGTO ($35.84 in chips) 
realbruzer: posts small blind $0.10
TQNYMQNTANA: posts big blind $0.25
*** HOLE CARDS ***
Dealt to SantiagoWeight [4d 7d]
Baboscrubx: folds 
Dbakunwaves: folds 
trillerGTO: folds 
SantiagoWeight: raises $0.25 to $0.50
realbruzer: raises $1.25 to $1.75
TQNYMQNTANA: folds 
SantiagoWeight: folds 
Uncalled bet ($1.25) returned to realbruzer
realbruzer collected $1.25 from pot
realbruzer: doesn't show hand 
*** SUMMARY ***
Total pot $1.25 | Rake $0 
Seat 1: SantiagoWeight (button) folded before Flop
Seat 2: realbruzer (small blind) collected ($1.25)
Seat 3: TQNYMQNTANA (big blind) folded before Flop
Seat 4: Baboscrubx folded before Flop (didn't bet)
Seat 5: Dbakunwaves folded before Flop (didn't bet)
Seat 6: trillerGTO folded before Flop (didn't bet)



PokerStars Zoom Hand #195022574337:  Hold'em No Limit ($0.10/$0.25) - 2018/12/29 2:58:15 UTC [2018/12/28 21:58:15 ET]
Table 'Hydra' 6-max Seat #1 is the button
Seat 1: simytis ($34.33 in chips) 
Seat 2: glennsterr ($24.06 in chips) 
Seat 3: SantiagoWeight ($22.30 in chips) 
Seat 4: 1ownYourUsd ($25 in chips) 
Seat 5: samioattila ($54.94 in chips) 
Seat 6: MISTAAJ ($49.53 in chips) 
glennsterr: posts small blind $0.10
SantiagoWeight: posts big blind $0.25
*** HOLE CARDS ***
Dealt to SantiagoWeight [5s Tc]
1ownYourUsd: folds 
samioattila: folds 
MISTAAJ: folds 
simytis: folds 
glennsterr: raises $0.50 to $0.75
SantiagoWeight: folds 
Uncalled bet ($0.50) returned to glennsterr
glennsterr collected $0.50 from pot
glennsterr: doesn't show hand 
*** SUMMARY ***
Total pot $0.50 | Rake $0 
Seat 1: simytis (button) folded before Flop (didn't bet)
Seat 2: glennsterr (small blind) collected ($0.50)
Seat 3: SantiagoWeight (big blind) folded before Flop
Seat 4: 1ownYourUsd folded before Flop (didn't bet)
Seat 5: samioattila folded before Flop (didn't bet)
Seat 6: MISTAAJ folded before Flop (didn't bet)



PokerStars Zoom Hand #195022558758:  Hold'em No Limit ($0.10/$0.25) - 2018/12/29 2:57:25 UTC [2018/12/28 21:57:25 ET]
Table 'Hydra' 6-max Seat #1 is the button
Seat 1: Bujan 07 ($13.11 in chips) 
Seat 2: SantiagoWeight ($24.50 in chips) 
Seat 3: ivann14 ($26.50 in chips) 
Seat 4: mariopork ($29.82 in chips) 
Seat 5: anorectal ($60.53 in chips) 
Seat 6: tightpokerAA ($24.72 in chips) 
SantiagoWeight: posts small blind $0.10
ivann14: posts big blind $0.25
*** HOLE CARDS ***
Dealt to SantiagoWeight [8h Ah]
mariopork: folds 
anorectal: folds 
tightpokerAA: raises $0.50 to $0.75
Bujan 07: folds 
SantiagoWeight: raises $1.45 to $2.20
ivann14: calls $1.95
tightpokerAA: raises $5.55 to $7.75
SantiagoWeight: folds 
ivann14: raises $18.75 to $26.50 and is all-in
tightpokerAA: calls $16.97 and is all-in
Uncalled bet ($1.78) returned to ivann14
*** FLOP *** [9s Ad Qd]
*** TURN *** [9s Ad Qd] [6s]
*** RIVER *** [9s Ad Qd 6s] [3c]
*** SHOW DOWN ***
ivann14: shows [Ac As] (three of a kind, Aces)
tightpokerAA: shows [Kh Kd] (a pair of Kings)
ivann14 collected $49.64 from pot
*** SUMMARY ***
Total pot $51.64 | Rake $2 
Board [9s Ad Qd 6s 3c]
Seat 1: Bujan 07 (button) folded before Flop (didn't bet)
Seat 2: SantiagoWeight (small blind) folded before Flop
Seat 3: ivann14 (big blind) showed [Ac As] and won ($49.64) with three of a kind, Aces
Seat 4: mariopork folded before Flop (didn't bet)
Seat 5: anorectal folded before Flop (didn't bet)
Seat 6: tightpokerAA showed [Kh Kd] and lost with a pair of Kings



PokerStars Zoom Hand #195022585913:  Hold'em No Limit ($0.10/$0.25) - 2018/12/29 2:58:52 UTC [2018/12/28 21:58:52 ET]
Table 'Hydra' 6-max Seat #1 is the button
Seat 1: FrommyBu ($33.55 in chips) 
Seat 2: glennsterr ($24.41 in chips) 
Seat 3: HansMSM ($26.72 in chips) 
Seat 4: SantiagoWeight ($22.05 in chips) 
Seat 5: myrtasaTR ($25 in chips) 
Seat 6: Xa4_88 ($54.95 in chips) 
glennsterr: posts small blind $0.10
HansMSM: posts big blind $0.25
*** HOLE CARDS ***
Dealt to SantiagoWeight [3c 7h]
SantiagoWeight: folds 
myrtasaTR: folds 
Xa4_88: folds 
FrommyBu: folds 
glennsterr: folds 
Uncalled bet ($0.15) returned to HansMSM
HansMSM collected $0.20 from pot
HansMSM: doesn't show hand 
*** SUMMARY ***
Total pot $0.20 | Rake $0 
Seat 1: FrommyBu (button) folded before Flop (didn't bet)
Seat 2: glennsterr (small blind) folded before Flop
Seat 3: HansMSM (big blind) collected ($0.20)
Seat 4: SantiagoWeight folded before Flop (didn't bet)
Seat 5: myrtasaTR folded before Flop (didn't bet)
Seat 6: Xa4_88 folded before Flop (didn't bet)



PokerStars Zoom Hand #195022579049:  Hold'em No Limit ($0.10/$0.25) - 2018/12/29 2:58:29 UTC [2018/12/28 21:58:29 ET]
Table 'Hydra' 6-max Seat #1 is the button
Seat 1: SantiagoWeight ($22.05 in chips) 
Seat 2: Lehared ($88.25 in chips) 
Seat 3: senzorul69 ($25 in chips) 
Seat 4: qing328 ($41.94 in chips) 
Seat 5: TQNYMQNTANA ($33.01 in chips) 
Seat 6: anlu0803 ($24.65 in chips) 
Lehared: posts small blind $0.10
senzorul69: posts big blind $0.25
*** HOLE CARDS ***
Dealt to SantiagoWeight [Ts 3c]
qing328: folds 
TQNYMQNTANA: raises $0.50 to $0.75
anlu0803: folds 
SantiagoWeight: folds 
Lehared: folds 
senzorul69: calls $0.50
*** FLOP *** [Js Kc 7s]
senzorul69: checks 
TQNYMQNTANA: checks 
*** TURN *** [Js Kc 7s] [Ah]
senzorul69: checks 
TQNYMQNTANA: checks 
*** RIVER *** [Js Kc 7s Ah] [Qs]
senzorul69: bets $0.75
TQNYMQNTANA: calls $0.75
*** SHOW DOWN ***
senzorul69: shows [4c Tc] (a straight, Ten to Ace)
TQNYMQNTANA: mucks hand 
senzorul69 collected $2.96 from pot
*** SUMMARY ***
Total pot $3.10 | Rake $0.14 
Board [Js Kc 7s Ah Qs]
Seat 1: SantiagoWeight (button) folded before Flop (didn't bet)
Seat 2: Lehared (small blind) folded before Flop
Seat 3: senzorul69 (big blind) showed [4c Tc] and won ($2.96) with a straight, Ten to Ace
Seat 4: qing328 folded before Flop (didn't bet)
Seat 5: TQNYMQNTANA mucked [Qc Qh]
Seat 6: anlu0803 folded before Flop (didn't bet)



PokerStars Zoom Hand #195022583746:  Hold'em No Limit ($0.10/$0.25) - 2018/12/29 2:58:44 UTC [2018/12/28 21:58:44 ET]
Table 'Hydra' 6-max Seat #1 is the button
Seat 1: MileVoliD49 ($54.77 in chips) 
Seat 2: Chrimmpam ($15.83 in chips) 
Seat 3: Z3rbinatti ($113.69 in chips) 
Seat 4: 173fish ($33.18 in chips) 
Seat 5: crux1994 ($9.87 in chips) 
Seat 6: SantiagoWeight ($22.05 in chips) 
Chrimmpam: posts small blind $0.10
Z3rbinatti: posts big blind $0.25
*** HOLE CARDS ***
Dealt to SantiagoWeight [5s 2c]
173fish: raises $0.50 to $0.75
crux1994: folds 
SantiagoWeight: folds 
MileVoliD49: folds 
Chrimmpam: folds 
Z3rbinatti: calls $0.50
*** FLOP *** [6c Ah Js]
Z3rbinatti: checks 
173fish: bets $1
Z3rbinatti: calls $1
*** TURN *** [6c Ah Js] [6d]
Z3rbinatti: checks 
173fish: checks 
*** RIVER *** [6c Ah Js 6d] [As]
Z3rbinatti: bets $111.94 and is all-in
173fish: folds 
Uncalled bet ($111.94) returned to Z3rbinatti
Z3rbinatti collected $3.44 from pot
Z3rbinatti: doesn't show hand 
*** SUMMARY ***
Total pot $3.60 | Rake $0.16 
Board [6c Ah Js 6d As]
Seat 1: MileVoliD49 (button) folded before Flop (didn't bet)
Seat 2: Chrimmpam (small blind) folded before Flop
Seat 3: Z3rbinatti (big blind) collected ($3.44)
Seat 4: 173fish folded on the River
Seat 5: crux1994 folded before Flop (didn't bet)
Seat 6: SantiagoWeight folded before Flop (didn't bet)



PokerStars Zoom Hand #195022587488:  Hold'em No Limit ($0.10/$0.25) - 2018/12/29 2:58:56 UTC [2018/12/28 21:58:56 ET]
Table 'Hydra' 6-max Seat #1 is the button
Seat 1: Xa4_88 ($54.95 in chips) 
Seat 2: HonourMan23 ($31.25 in chips) 
Seat 3: Z3rbinatti ($96.10 in chips) 
Seat 4: SantiagoWeight ($22.05 in chips) 
Seat 5: qing328 ($41.69 in chips) 
Seat 6: Dbakunwaves ($52.92 in chips) 
HonourMan23: posts small blind $0.10
Z3rbinatti: posts big blind $0.25
*** HOLE CARDS ***
Dealt to SantiagoWeight [8h 3s]
SantiagoWeight: folds 
qing328: raises $0.25 to $0.50
Dbakunwaves: calls $0.50
Xa4_88: folds 
HonourMan23: calls $0.40
Z3rbinatti: folds 
*** FLOP *** [4d 6s 7d]
HonourMan23: checks 
qing328: checks 
Dbakunwaves: bets $1.50
HonourMan23: folds 
qing328: calls $1.50
*** TURN *** [4d 6s 7d] [Kc]
qing328: checks 
Dbakunwaves: checks 
*** RIVER *** [4d 6s 7d Kc] [7s]
qing328: checks 
Dbakunwaves: bets $3.75
qing328: folds 
Uncalled bet ($3.75) returned to Dbakunwaves
Dbakunwaves collected $4.54 from pot
Dbakunwaves: doesn't show hand 
*** SUMMARY ***
Total pot $4.75 | Rake $0.21 
Board [4d 6s 7d Kc 7s]
Seat 1: Xa4_88 (button) folded before Flop (didn't bet)
Seat 2: HonourMan23 (small blind) folded on the Flop
Seat 3: Z3rbinatti (big blind) folded before Flop
Seat 4: SantiagoWeight folded before Flop (didn't bet)
Seat 5: qing328 folded on the River
Seat 6: Dbakunwaves collected ($4.54)



PokerStars Zoom Hand #195022591223:  Hold'em No Limit ($0.10/$0.25) - 2018/12/29 2:59:09 UTC [2018/12/28 21:59:09 ET]
Table 'Hydra' 6-max Seat #1 is the button
Seat 1: anlu0803 ($24.30 in chips) 
Seat 2: Danil.Gerasimov ($12.55 in chips) 
Seat 3: SantiagoWeight ($22.05 in chips) 
Seat 4: KAOS914 ($31.79 in chips) 
Seat 5: cankum ($34.36 in chips) 
Seat 6: !P0K3RM3T4L! ($25.50 in chips) 
Danil.Gerasimov: posts small blind $0.10
SantiagoWeight: posts big blind $0.25
*** HOLE CARDS ***
Dealt to SantiagoWeight [6h 6s]
KAOS914: raises $0.50 to $0.75
cankum: folds 
!P0K3RM3T4L!: folds 
anlu0803: folds 
Danil.Gerasimov: folds 
SantiagoWeight: calls $0.50
*** FLOP *** [2c Qh 9c]
SantiagoWeight: checks 
KAOS914: checks 
*** TURN *** [2c Qh 9c] [Kd]
SantiagoWeight: checks 
KAOS914: bets $1.53
SantiagoWeight: folds 
Uncalled bet ($1.53) returned to KAOS914
KAOS914 collected $1.53 from pot
*** SUMMARY ***
Total pot $1.60 | Rake $0.07 
Board [2c Qh 9c Kd]
Seat 1: anlu0803 (button) folded before Flop (didn't bet)
Seat 2: Danil.Gerasimov (small blind) folded before Flop
Seat 3: SantiagoWeight (big blind) folded on the Turn
Seat 4: KAOS914 collected ($1.53)
Seat 5: cankum folded before Flop (didn't bet)
Seat 6: !P0K3RM3T4L! folded before Flop (didn't bet)



PokerStars Zoom Hand #195022607462:  Hold'em No Limit ($0.10/$0.25) - 2018/12/29 3:00:00 UTC [2018/12/28 22:00:00 ET]
Table 'Hydra' 6-max Seat #1 is the button
Seat 1: BirreteX ($34.04 in chips) 
Seat 2: cankum ($25.12 in chips) 
Seat 3: ckriszee ($48.24 in chips) 
Seat 4: SantiagoWeight ($24.25 in chips) 
Seat 5: _BluDeeN_ ($24.30 in chips) 
Seat 6: --LeGaaNs-- ($25.05 in chips) 
cankum: posts small blind $0.10
ckriszee: posts big blind $0.25
*** HOLE CARDS ***
Dealt to SantiagoWeight [Kh Qc]
SantiagoWeight: raises $0.42 to $0.67
_BluDeeN_: raises $1.69 to $2.36
--LeGaaNs--: folds 
BirreteX: folds 
cankum: folds 
ckriszee: folds 
SantiagoWeight: raises $3.14 to $5.50
_BluDeeN_: calls $3.14
*** FLOP *** [8d 8h 6h]
SantiagoWeight: bets $2.71
_BluDeeN_: calls $2.71
*** TURN *** [8d 8h 6h] [9h]
SantiagoWeight: bets $16.04 and is all-in
_BluDeeN_: calls $16.04
*** FIRST RIVER *** [8d 8h 6h 9h] [5s]
*** SECOND RIVER *** [8d 8h 6h 9h] [Qh]
*** FIRST SHOW DOWN ***
SantiagoWeight: shows [Kh Qc] (a pair of Eights)
_BluDeeN_: shows [Td Ts] (two pair, Tens and Eights)
_BluDeeN_ collected $23.43 from pot
*** SECOND SHOW DOWN ***
SantiagoWeight: shows [Kh Qc] (a flush, King high)
_BluDeeN_: shows [Td Ts] (two pair, Tens and Eights)
SantiagoWeight collected $23.42 from pot
*** SUMMARY ***
Total pot $48.85 | Rake $2 
Hand was run twice
FIRST Board [8d 8h 6h 9h 5s]
SECOND Board [8d 8h 6h 9h Qh]
Seat 1: BirreteX (button) folded before Flop (didn't bet)
Seat 2: cankum (small blind) folded before Flop
Seat 3: ckriszee (big blind) folded before Flop
Seat 4: SantiagoWeight showed [Kh Qc] and lost with a pair of Eights, and won ($23.42) with a flush, King high
Seat 5: _BluDeeN_ showed [Td Ts] and won ($23.43) with two pair, Tens and Eights, and lost with two pair, Tens and Eights
Seat 6: --LeGaaNs-- folded before Flop (didn't bet)



PokerStars Zoom Hand #195022626937:  Hold'em No Limit ($0.10/$0.25) - 2018/12/29 3:00:59 UTC [2018/12/28 22:00:59 ET]
Table 'Hydra' 6-max Seat #1 is the button
Seat 1: BärbärKush ($30.70 in chips) 
Seat 2: SantiagoWeight ($23.42 in chips) 
Seat 3: anorectal ($75.15 in chips) 
Seat 4: mistdog ($33.76 in chips) 
Seat 5: reggiedogg31 ($112.30 in chips) 
Seat 6: TQNYMQNTANA ($25 in chips) 
SantiagoWeight: posts small blind $0.10
anorectal: posts big blind $0.25
*** HOLE CARDS ***
Dealt to SantiagoWeight [Tc 2c]
mistdog has timed out
mistdog: folds 
reggiedogg31: folds 
TQNYMQNTANA: folds 
BärbärKush: raises $0.50 to $0.75
SantiagoWeight: folds 
anorectal: folds 
Uncalled bet ($0.50) returned to BärbärKush
BärbärKush collected $0.60 from pot
BärbärKush: doesn't show hand 
*** SUMMARY ***
Total pot $0.60 | Rake $0 
Seat 1: BärbärKush (button) collected ($0.60)
Seat 2: SantiagoWeight (small blind) folded before Flop
Seat 3: anorectal (big blind) folded before Flop
Seat 4: mistdog folded before Flop (didn't bet)
Seat 5: reggiedogg31 folded before Flop (didn't bet)
Seat 6: TQNYMQNTANA folded before Flop (didn't bet)



PokerStars Zoom Hand #195022636722:  Hold'em No Limit ($0.10/$0.25) - 2018/12/29 3:01:26 UTC [2018/12/28 22:01:26 ET]
Table 'Hydra' 6-max Seat #1 is the button
Seat 1: Dbakunwaves ($54.68 in chips) 
Seat 2: !P0K3RM3T4L! ($27.97 in chips) 
Seat 3: davidhw888 ($27.07 in chips) 
Seat 4: Cryptoz91 ($41.10 in chips) 
Seat 5: negreanuNya ($25 in chips) 
Seat 6: SantiagoWeight ($23.32 in chips) 
!P0K3RM3T4L!: posts small blind $0.10
davidhw888: posts big blind $0.25
*** HOLE CARDS ***
Dealt to SantiagoWeight [Qs 6d]
Cryptoz91: folds 
negreanuNya: folds 
SantiagoWeight: folds 
Dbakunwaves: raises $0.75 to $1
!P0K3RM3T4L!: folds 
davidhw888: folds 
Uncalled bet ($0.75) returned to Dbakunwaves
Dbakunwaves collected $0.60 from pot
Dbakunwaves: doesn't show hand 
*** SUMMARY ***
Total pot $0.60 | Rake $0 
Seat 1: Dbakunwaves (button) collected ($0.60)
Seat 2: !P0K3RM3T4L! (small blind) folded before Flop
Seat 3: davidhw888 (big blind) folded before Flop
Seat 4: Cryptoz91 folded before Flop (didn't bet)
Seat 5: negreanuNya folded before Flop (didn't bet)
Seat 6: SantiagoWeight folded before Flop (didn't bet)



PokerStars Zoom Hand #195022641119:  Hold'em No Limit ($0.10/$0.25) - 2018/12/29 3:01:39 UTC [2018/12/28 22:01:39 ET]
Table 'Hydra' 6-max Seat #1 is the button
Seat 1: Doomdigidoom ($16.25 in chips) 
Seat 2: Tisho1234 ($30.89 in chips) 
Seat 3: assassin0875 ($186.37 in chips) 
Seat 4: franco373513 ($18.66 in chips) 
Seat 5: SantiagoWeight ($23.32 in chips) 
Seat 6: Xander_B88 ($59.20 in chips) 
Tisho1234: posts small blind $0.10
assassin0875: posts big blind $0.25
*** HOLE CARDS ***
Dealt to SantiagoWeight [Jd 2s]
franco373513: folds 
SantiagoWeight: folds 
Xander_B88: folds 
Doomdigidoom: folds 
Tisho1234: folds 
Uncalled bet ($0.15) returned to assassin0875
assassin0875 collected $0.20 from pot
assassin0875: doesn't show hand 
*** SUMMARY ***
Total pot $0.20 | Rake $0 
Seat 1: Doomdigidoom (button) folded before Flop (didn't bet)
Seat 2: Tisho1234 (small blind) folded before Flop
Seat 3: assassin0875 (big blind) collected ($0.20)
Seat 4: franco373513 folded before Flop (didn't bet)
Seat 5: SantiagoWeight folded before Flop (didn't bet)
Seat 6: Xander_B88 folded before Flop (didn't bet)



PokerStars Zoom Hand #195022645448:  Hold'em No Limit ($0.10/$0.25) - 2018/12/29 3:01:51 UTC [2018/12/28 22:01:51 ET]
Table 'Hydra' 6-max Seat #1 is the button
Seat 1: GrandmasterY ($25.25 in chips) 
Seat 2: SantiagoWeight ($23.32 in chips) 
Seat 3: trillerGTO ($34.39 in chips) 
Seat 4: zbuci ($37.37 in chips) 
Seat 5: mariopork ($41.90 in chips) 
Seat 6: faris0 ($28.40 in chips) 
SantiagoWeight: posts small blind $0.10
trillerGTO: posts big blind $0.25
*** HOLE CARDS ***
Dealt to SantiagoWeight [6d 5c]
zbuci: folds 
mariopork: folds 
faris0: folds 
GrandmasterY: folds 
SantiagoWeight: folds 
Uncalled bet ($0.15) returned to trillerGTO
trillerGTO collected $0.20 from pot
trillerGTO: doesn't show hand 
*** SUMMARY ***
Total pot $0.20 | Rake $0 
Seat 1: GrandmasterY (button) folded before Flop (didn't bet)
Seat 2: SantiagoWeight (small blind) folded before Flop
Seat 3: trillerGTO (big blind) collected ($0.20)
Seat 4: zbuci folded before Flop (didn't bet)
Seat 5: mariopork folded before Flop (didn't bet)
Seat 6: faris0 folded before Flop (didn't bet)



PokerStars Zoom Hand #195022656006:  Hold'em No Limit ($0.10/$0.25) - 2018/12/29 3:02:19 UTC [2018/12/28 22:02:19 ET]
Table 'Hydra' 6-max Seat #1 is the button
Seat 1: SapientiAA ($25.66 in chips) 
Seat 2: Akkana ($25.10 in chips) 
Seat 3: SantiagoWeight ($23.22 in chips) 
Seat 4: anorectal ($56.72 in chips) 
Seat 5: zhang1zhang ($54.19 in chips) 
Seat 6: BärbärKush ($39.81 in chips) 
Akkana: posts small blind $0.10
SantiagoWeight: posts big blind $0.25
*** HOLE CARDS ***
Dealt to SantiagoWeight [Kh 6d]
anorectal: folds 
zhang1zhang: raises $0.50 to $0.75
BärbärKush: folds 
SapientiAA: folds 
Akkana: folds 
SantiagoWeight: folds 
Uncalled bet ($0.50) returned to zhang1zhang
zhang1zhang collected $0.60 from pot
zhang1zhang: doesn't show hand 
*** SUMMARY ***
Total pot $0.60 | Rake $0 
Seat 1: SapientiAA (button) folded before Flop (didn't bet)
Seat 2: Akkana (small blind) folded before Flop
Seat 3: SantiagoWeight (big blind) folded before Flop
Seat 4: anorectal folded before Flop (didn't bet)
Seat 5: zhang1zhang collected ($0.60)
Seat 6: BärbärKush folded before Flop (didn't bet)



PokerStars Zoom Hand #195022653164:  Hold'em No Limit ($0.10/$0.25) - 2018/12/29 3:02:12 UTC [2018/12/28 22:02:12 ET]
Table 'Hydra' 6-max Seat #1 is the button
Seat 1: SantiagoWeight ($23.22 in chips) 
Seat 2: sigaro010 ($61.04 in chips) 
Seat 3: Slim Wolfie ($25 in chips) 
Seat 4: trillerGTO ($20.33 in chips) 
Seat 5: qing328 ($38.59 in chips) 
Seat 6: cankum ($25 in chips) 
sigaro010: posts small blind $0.10
Slim Wolfie: posts big blind $0.25
*** HOLE CARDS ***
Dealt to SantiagoWeight [3c 4s]
trillerGTO: raises $0.43 to $0.68
qing328: folds 
cankum: folds 
SantiagoWeight: folds 
sigaro010: folds 
Slim Wolfie: folds 
Uncalled bet ($0.43) returned to trillerGTO
trillerGTO collected $0.60 from pot
trillerGTO: doesn't show hand 
*** SUMMARY ***
Total pot $0.60 | Rake $0 
Seat 1: SantiagoWeight (button) folded before Flop (didn't bet)
Seat 2: sigaro010 (small blind) folded before Flop
Seat 3: Slim Wolfie (big blind) folded before Flop
Seat 4: trillerGTO collected ($0.60)
Seat 5: qing328 folded before Flop (didn't bet)
Seat 6: cankum folded before Flop (didn't bet)



PokerStars Zoom Hand #195022662982:  Hold'em No Limit ($0.10/$0.25) - 2018/12/29 3:02:38 UTC [2018/12/28 22:02:38 ET]
Table 'Hydra' 6-max Seat #1 is the button
Seat 1: Actarusqc ($35.90 in chips) 
Seat 2: trillerGTO ($24.99 in chips) 
Seat 3: AngelicDiana ($77.26 in chips) 
Seat 4: Chrimmpam ($21.78 in chips) 
Seat 5: SantiagoWeight ($22.97 in chips) 
Seat 6: negreanuNya ($25 in chips) 
trillerGTO: posts small blind $0.10
AngelicDiana: posts big blind $0.25
*** HOLE CARDS ***
Dealt to SantiagoWeight [5h 5d]
Chrimmpam: folds 
SantiagoWeight: raises $0.37 to $0.62
negreanuNya: raises $1.28 to $1.90
Actarusqc: folds 
trillerGTO: folds 
AngelicDiana: folds 
SantiagoWeight: calls $1.28
*** FLOP *** [Qd 6h 6s]
SantiagoWeight: checks 
negreanuNya: bets $2.18
SantiagoWeight: folds 
Uncalled bet ($2.18) returned to negreanuNya
negreanuNya collected $3.96 from pot
*** SUMMARY ***
Total pot $4.15 | Rake $0.19 
Board [Qd 6h 6s]
Seat 1: Actarusqc (button) folded before Flop (didn't bet)
Seat 2: trillerGTO (small blind) folded before Flop
Seat 3: AngelicDiana (big blind) folded before Flop
Seat 4: Chrimmpam folded before Flop (didn't bet)
Seat 5: SantiagoWeight folded on the Flop
Seat 6: negreanuNya collected ($3.96)



PokerStars Zoom Hand #195022683250:  Hold'em No Limit ($0.10/$0.25) - 2018/12/29 3:03:33 UTC [2018/12/28 22:03:33 ET]
Table 'Hydra' 6-max Seat #1 is the button
Seat 1: SantiagoWeight ($21.07 in chips) 
Seat 2: kingkooi86 ($103.62 in chips) 
Seat 3: Doomdigidoom ($16.07 in chips) 
Seat 4: _BluDeeN_ ($28.52 in chips) 
Seat 5: ryanking99 ($31.74 in chips) 
Seat 6: Slim Wolfie ($25 in chips) 
kingkooi86: posts small blind $0.10
Doomdigidoom: posts big blind $0.25
*** HOLE CARDS ***
Dealt to SantiagoWeight [4h 6h]
_BluDeeN_: folds 
ryanking99: folds 
Slim Wolfie: folds 
SantiagoWeight: raises $0.25 to $0.50
kingkooi86: folds 
Doomdigidoom: calls $0.25
*** FLOP *** [Td Qc Kh]
Doomdigidoom: bets $0.50
SantiagoWeight: folds 
Uncalled bet ($0.50) returned to Doomdigidoom
Doomdigidoom collected $1.05 from pot
*** SUMMARY ***
Total pot $1.10 | Rake $0.05 
Board [Td Qc Kh]
Seat 1: SantiagoWeight (button) folded on the Flop
Seat 2: kingkooi86 (small blind) folded before Flop
Seat 3: Doomdigidoom (big blind) collected ($1.05)
Seat 4: _BluDeeN_ folded before Flop (didn't bet)
Seat 5: ryanking99 folded before Flop (didn't bet)
Seat 6: Slim Wolfie folded before Flop (didn't bet)



PokerStars Zoom Hand #195022693844:  Hold'em No Limit ($0.10/$0.25) - 2018/12/29 3:04:03 UTC [2018/12/28 22:04:03 ET]
Table 'Hydra' 6-max Seat #1 is the button
Seat 1: Flippay ($61.62 in chips) 
Seat 2: Rollout2018 ($15.33 in chips) 
Seat 3: Ryoji1029 ($21 in chips) 
Seat 4: Dr.Jekyll197 ($33.29 in chips) 
Seat 5: osa126 ($31.85 in chips) 
Seat 6: SantiagoWeight ($24.50 in chips) 
Rollout2018: posts small blind $0.10
Ryoji1029: posts big blind $0.25
*** HOLE CARDS ***
Dealt to SantiagoWeight [7h 8c]
Dr.Jekyll197: folds 
osa126: folds 
SantiagoWeight: folds 
Flippay: folds 
Rollout2018: folds 
Uncalled bet ($0.15) returned to Ryoji1029
Ryoji1029 collected $0.20 from pot
Ryoji1029: doesn't show hand 
*** SUMMARY ***
Total pot $0.20 | Rake $0 
Seat 1: Flippay (button) folded before Flop (didn't bet)
Seat 2: Rollout2018 (small blind) folded before Flop
Seat 3: Ryoji1029 (big blind) collected ($0.20)
Seat 4: Dr.Jekyll197 folded before Flop (didn't bet)
Seat 5: osa126 folded before Flop (didn't bet)
Seat 6: SantiagoWeight folded before Flop (didn't bet)



PokerStars Zoom Hand #195022697866:  Hold'em No Limit ($0.10/$0.25) - 2018/12/29 3:04:14 UTC [2018/12/28 22:04:14 ET]
Table 'Hydra' 6-max Seat #1 is the button
Seat 1: ludisima ($51.27 in chips) 
Seat 2: nathan_eeg ($29.13 in chips) 
Seat 3: 1ownYourUsd ($45.16 in chips) 
Seat 4: kingkooi86 ($103.52 in chips) 
Seat 5: SantiagoWeight ($24.50 in chips) 
Seat 6: davidhw888 ($44.04 in chips) 
nathan_eeg: posts small blind $0.10
1ownYourUsd: posts big blind $0.25
*** HOLE CARDS ***
Dealt to SantiagoWeight [9d Kd]
kingkooi86: folds 
SantiagoWeight: raises $0.37 to $0.62
davidhw888: calls $0.62
ludisima: folds 
nathan_eeg: folds 
1ownYourUsd: calls $0.37
*** FLOP *** [Ad Tc Kc]
1ownYourUsd: checks 
SantiagoWeight: checks 
davidhw888: bets $0.94
1ownYourUsd: calls $0.94
SantiagoWeight: folds 
*** TURN *** [Ad Tc Kc] [Th]
1ownYourUsd: checks 
davidhw888: bets $3.67
1ownYourUsd: folds 
Uncalled bet ($3.67) returned to davidhw888
davidhw888 collected $3.67 from pot
davidhw888: doesn't show hand 
*** SUMMARY ***
Total pot $3.84 | Rake $0.17 
Board [Ad Tc Kc Th]
Seat 1: ludisima (button) folded before Flop (didn't bet)
Seat 2: nathan_eeg (small blind) folded before Flop
Seat 3: 1ownYourUsd (big blind) folded on the Turn
Seat 4: kingkooi86 folded before Flop (didn't bet)
Seat 5: SantiagoWeight folded on the Flop
Seat 6: davidhw888 collected ($3.67)



PokerStars Zoom Hand #195022716150:  Hold'em No Limit ($0.10/$0.25) - 2018/12/29 3:05:03 UTC [2018/12/28 22:05:03 ET]
Table 'Hydra' 6-max Seat #1 is the button
Seat 1: MeDoubleJ ($25 in chips) 
Seat 2: SantiagoWeight ($23.88 in chips) 
Seat 3: naxizzle ($120.80 in chips) 
Seat 4: Actarusqc ($35.49 in chips) 
Seat 5: zdena102 ($52.56 in chips) 
Seat 6: trillerGTO ($22.99 in chips) 
SantiagoWeight: posts small blind $0.10
naxizzle: posts big blind $0.25
*** HOLE CARDS ***
Dealt to SantiagoWeight [3h 6s]
Actarusqc: folds 
zdena102: folds 
trillerGTO: raises $0.50 to $0.75
MeDoubleJ: folds 
SantiagoWeight: folds 
naxizzle: folds 
Uncalled bet ($0.50) returned to trillerGTO
trillerGTO collected $0.60 from pot
trillerGTO: doesn't show hand 
*** SUMMARY ***
Total pot $0.60 | Rake $0 
Seat 1: MeDoubleJ (button) folded before Flop (didn't bet)
Seat 2: SantiagoWeight (small blind) folded before Flop
Seat 3: naxizzle (big blind) folded before Flop
Seat 4: Actarusqc folded before Flop (didn't bet)
Seat 5: zdena102 folded before Flop (didn't bet)
Seat 6: trillerGTO collected ($0.60)



PokerStars Zoom Hand #195022718665:  Hold'em No Limit ($0.10/$0.25) - 2018/12/29 3:05:10 UTC [2018/12/28 22:05:10 ET]
Table 'Hydra' 6-max Seat #1 is the button
Seat 1: franco373513 ($15.63 in chips) 
Seat 2: anorectal ($56.39 in chips) 
Seat 3: SantiagoWeight ($23.78 in chips) 
Seat 4: davidhw888 ($16.26 in chips) 
Seat 5: IceAgeDream7 ($113.62 in chips) 
Seat 6: SapientiAA ($25.74 in chips) 
anorectal: posts small blind $0.10
SantiagoWeight: posts big blind $0.25
*** HOLE CARDS ***
Dealt to SantiagoWeight [9c 7c]
davidhw888: folds 
IceAgeDream7: folds 
SapientiAA: folds 
franco373513: folds 
anorectal: folds 
Uncalled bet ($0.15) returned to SantiagoWeight
SantiagoWeight collected $0.20 from pot
SantiagoWeight: doesn't show hand 
*** SUMMARY ***
Total pot $0.20 | Rake $0 
Seat 1: franco373513 (button) folded before Flop (didn't bet)
Seat 2: anorectal (small blind) folded before Flop
Seat 3: SantiagoWeight (big blind) collected ($0.20)
Seat 4: davidhw888 folded before Flop (didn't bet)
Seat 5: IceAgeDream7 folded before Flop (didn't bet)
Seat 6: SapientiAA folded before Flop (didn't bet)



PokerStars Zoom Hand #195022713583:  Hold'em No Limit ($0.10/$0.25) - 2018/12/29 3:04:57 UTC [2018/12/28 22:04:57 ET]
Table 'Hydra' 6-max Seat #1 is the button
Seat 1: SantiagoWeight ($23.88 in chips) 
Seat 2: MeDoubleJ ($25 in chips) 
Seat 3: samioattila ($48.14 in chips) 
Seat 4: aloominat ($18.32 in chips) 
Seat 5: assassin0875 ($188.15 in chips) 
Seat 6: nhanminhtri ($25 in chips) 
MeDoubleJ: posts small blind $0.10
samioattila: posts big blind $0.25
*** HOLE CARDS ***
Dealt to SantiagoWeight [2d Ts]
aloominat: folds 
assassin0875: raises $0.50 to $0.75
nhanminhtri: raises $1.75 to $2.50
SantiagoWeight: folds 
MeDoubleJ: folds 
samioattila: folds 
assassin0875: calls $1.75
*** FLOP *** [3s 2s 7h]
assassin0875: checks 
nhanminhtri: bets $2.81
assassin0875: calls $2.81
*** TURN *** [3s 2s 7h] [6c]
assassin0875: checks 
nhanminhtri: checks 
*** RIVER *** [3s 2s 7h 6c] [Ah]
assassin0875: checks 
nhanminhtri: bets $6.50
assassin0875: calls $6.50
*** SHOW DOWN ***
nhanminhtri: shows [As Kc] (a pair of Aces)
assassin0875: mucks hand 
nhanminhtri collected $22.89 from pot
*** SUMMARY ***
Total pot $23.97 | Rake $1.08 
Board [3s 2s 7h 6c Ah]
Seat 1: SantiagoWeight (button) folded before Flop (didn't bet)
Seat 2: MeDoubleJ (small blind) folded before Flop
Seat 3: samioattila (big blind) folded before Flop
Seat 4: aloominat folded before Flop (didn't bet)
Seat 5: assassin0875 mucked [Ac Qs]
Seat 6: nhanminhtri showed [As Kc] and won ($22.89) with a pair of Aces



PokerStars Zoom Hand #195022724126:  Hold'em No Limit ($0.10/$0.25) - 2018/12/29 3:05:26 UTC [2018/12/28 22:05:26 ET]
Table 'Hydra' 6-max Seat #1 is the button
Seat 1: yobbos ($118.41 in chips) 
Seat 2: Bujan 07 ($18.06 in chips) 
Seat 3: zdena102 ($52.46 in chips) 
Seat 4: call me??107 ($36.56 in chips) 
Seat 5: BIGPAIN14 ($61.70 in chips) 
Seat 6: SantiagoWeight ($23.88 in chips) 
Bujan 07: posts small blind $0.10
zdena102: posts big blind $0.25
*** HOLE CARDS ***
Dealt to SantiagoWeight [7d Tc]
call me??107: folds 
BIGPAIN14: folds 
SantiagoWeight: folds 
yobbos: folds 
Bujan 07: folds 
Uncalled bet ($0.15) returned to zdena102
zdena102 collected $0.20 from pot
zdena102: doesn't show hand 
*** SUMMARY ***
Total pot $0.20 | Rake $0 
Seat 1: yobbos (button) folded before Flop (didn't bet)
Seat 2: Bujan 07 (small blind) folded before Flop
Seat 3: zdena102 (big blind) collected ($0.20)
Seat 4: call me??107 folded before Flop (didn't bet)
Seat 5: BIGPAIN14 folded before Flop (didn't bet)
Seat 6: SantiagoWeight folded before Flop (didn't bet)



PokerStars Zoom Hand #195022731016:  Hold'em No Limit ($0.10/$0.25) - 2018/12/29 3:05:45 UTC [2018/12/28 22:05:45 ET]
Table 'Hydra' 6-max Seat #1 is the button
Seat 1: donmarc777 ($26.38 in chips) 
Seat 2: HansMSM ($26.52 in chips) 
Seat 3: nadal335 ($105.12 in chips) 
Seat 4: nhanminhtri ($33.33 in chips) 
Seat 5: SantiagoWeight ($23.88 in chips) 
Seat 6: _BluDeeN_ ($29.24 in chips) 
HansMSM: posts small blind $0.10
nadal335: posts big blind $0.25
*** HOLE CARDS ***
Dealt to SantiagoWeight [9h Kh]
nhanminhtri: raises $0.50 to $0.75
SantiagoWeight: folds 
_BluDeeN_: folds 
donmarc777: folds 
HansMSM: folds 
nadal335: folds 
Uncalled bet ($0.50) returned to nhanminhtri
nhanminhtri collected $0.60 from pot
nhanminhtri: doesn't show hand 
*** SUMMARY ***
Total pot $0.60 | Rake $0 
Seat 1: donmarc777 (button) folded before Flop (didn't bet)
Seat 2: HansMSM (small blind) folded before Flop
Seat 3: nadal335 (big blind) folded before Flop
Seat 4: nhanminhtri collected ($0.60)
Seat 5: SantiagoWeight folded before Flop (didn't bet)
Seat 6: _BluDeeN_ folded before Flop (didn't bet)



PokerStars Zoom Hand #195022748523:  Hold'em No Limit ($0.10/$0.25) - 2018/12/29 3:06:32 UTC [2018/12/28 22:06:32 ET]
Table 'Hydra' 6-max Seat #1 is the button
Seat 1: osa126 ($25 in chips) 
Seat 2: djambat ($15.27 in chips) 
Seat 3: SantiagoWeight ($23.88 in chips) 
Seat 4: Xander_B88 ($40.15 in chips) 
Seat 5: theman120294 ($62.13 in chips) 
Seat 6: ducepot15 ($35.35 in chips) 
djambat: posts small blind $0.10
SantiagoWeight: posts big blind $0.25
*** HOLE CARDS ***
Dealt to SantiagoWeight [3s 2h]
Xander_B88: folds 
theman120294: folds 
ducepot15: raises $0.50 to $0.75
osa126: folds 
djambat: folds 
SantiagoWeight: folds 
Uncalled bet ($0.50) returned to ducepot15
ducepot15 collected $0.60 from pot
*** SUMMARY ***
Total pot $0.60 | Rake $0 
Seat 1: osa126 (button) folded before Flop (didn't bet)
Seat 2: djambat (small blind) folded before Flop
Seat 3: SantiagoWeight (big blind) folded before Flop
Seat 4: Xander_B88 folded before Flop (didn't bet)
Seat 5: theman120294 folded before Flop (didn't bet)
Seat 6: ducepot15 collected ($0.60)



PokerStars Zoom Hand #195022736906:  Hold'em No Limit ($0.10/$0.25) - 2018/12/29 3:06:01 UTC [2018/12/28 22:06:01 ET]
Table 'Hydra' 6-max Seat #1 is the button
Seat 1: will82777 ($41.22 in chips) 
Seat 2: kingkooi86 ($92.27 in chips) 
Seat 3: Baboscrubx ($25 in chips) 
Seat 4: yobbos ($50.45 in chips) 
Seat 5: BirreteX ($29.14 in chips) 
Seat 6: SantiagoWeight ($23.88 in chips) 
kingkooi86: posts small blind $0.10
Baboscrubx: posts big blind $0.25
*** HOLE CARDS ***
Dealt to SantiagoWeight [9s 4h]
yobbos: raises $0.50 to $0.75
BirreteX: folds 
SantiagoWeight: folds 
will82777: folds 
kingkooi86: calls $0.65
Baboscrubx: calls $0.50
*** FLOP *** [7s 8h Tc]
kingkooi86: checks 
Baboscrubx: checks 
yobbos: checks 
*** TURN *** [7s 8h Tc] [9d]
kingkooi86: checks 
Baboscrubx: checks 
yobbos: bets $1.08
kingkooi86: folds 
Baboscrubx: folds 
Uncalled bet ($1.08) returned to yobbos
yobbos collected $2.15 from pot
yobbos: doesn't show hand 
*** SUMMARY ***
Total pot $2.25 | Rake $0.10 
Board [7s 8h Tc 9d]
Seat 1: will82777 (button) folded before Flop (didn't bet)
Seat 2: kingkooi86 (small blind) folded on the Turn
Seat 3: Baboscrubx (big blind) folded on the Turn
Seat 4: yobbos collected ($2.15)
Seat 5: BirreteX folded before Flop (didn't bet)
Seat 6: SantiagoWeight folded before Flop (didn't bet)



PokerStars Zoom Hand #195022745700:  Hold'em No Limit ($0.10/$0.25) - 2018/12/29 3:06:25 UTC [2018/12/28 22:06:25 ET]
Table 'Hydra' 6-max Seat #1 is the button
Seat 1: nhanminhtri ($30.95 in chips) 
Seat 2: Kaazer ($8.20 in chips) 
Seat 3: mariopork ($28.15 in chips) 
Seat 4: SantiagoWeight ($23.88 in chips) 
Seat 5: djambat ($15.27 in chips) 
Seat 6: river plate9 ($24.75 in chips) 
Kaazer: posts small blind $0.10
mariopork: posts big blind $0.25
*** HOLE CARDS ***
Dealt to SantiagoWeight [3h 6d]
SantiagoWeight: folds 
djambat: folds 
river plate9: folds 
nhanminhtri: folds 
Kaazer: raises $0.50 to $0.75
mariopork: calls $0.50
*** FLOP *** [Ks 2d Kd]
Kaazer: bets $1.43
mariopork: folds 
Uncalled bet ($1.43) returned to Kaazer
Kaazer collected $1.43 from pot
Kaazer: doesn't show hand 
*** SUMMARY ***
Total pot $1.50 | Rake $0.07 
Board [Ks 2d Kd]
Seat 1: nhanminhtri (button) folded before Flop (didn't bet)
Seat 2: Kaazer (small blind) collected ($1.43)
Seat 3: mariopork (big blind) folded on the Flop
Seat 4: SantiagoWeight folded before Flop (didn't bet)
Seat 5: djambat folded before Flop (didn't bet)
Seat 6: river plate9 folded before Flop (didn't bet)



PokerStars Zoom Hand #195022753722:  Hold'em No Limit ($0.10/$0.25) - 2018/12/29 3:06:47 UTC [2018/12/28 22:06:47 ET]
Table 'Hydra' 6-max Seat #1 is the button
Seat 1: Dr.Jekyll197 ($31.95 in chips) 
Seat 2: SantiagoWeight ($23.63 in chips) 
Seat 3: samioattila ($33.60 in chips) 
Seat 4: HonourMan23 ($30.43 in chips) 
Seat 5: HansMSM ($25.10 in chips) 
Seat 6: zekoxxx ($14.07 in chips) 
SantiagoWeight: posts small blind $0.10
samioattila: posts big blind $0.25
*** HOLE CARDS ***
Dealt to SantiagoWeight [5d Qs]
HonourMan23: folds 
HansMSM: folds 
zekoxxx: calls $0.25
Dr.Jekyll197: raises $0.75 to $1
SantiagoWeight: folds 
samioattila: folds 
zekoxxx: calls $0.75
*** FLOP *** [Jc 7h Kh]
zekoxxx: checks 
Dr.Jekyll197: checks 
*** TURN *** [Jc 7h Kh] [7d]
zekoxxx: checks 
Dr.Jekyll197: bets $1.12
zekoxxx: folds 
Uncalled bet ($1.12) returned to Dr.Jekyll197
Dr.Jekyll197 collected $2.24 from pot
Dr.Jekyll197: doesn't show hand 
*** SUMMARY ***
Total pot $2.35 | Rake $0.11 
Board [Jc 7h Kh 7d]
Seat 1: Dr.Jekyll197 (button) collected ($2.24)
Seat 2: SantiagoWeight (small blind) folded before Flop
Seat 3: samioattila (big blind) folded before Flop
Seat 4: HonourMan23 folded before Flop (didn't bet)
Seat 5: HansMSM folded before Flop (didn't bet)
Seat 6: zekoxxx folded on the Turn



PokerStars Zoom Hand #195022740586:  Hold'em No Limit ($0.10/$0.25) - 2018/12/29 3:06:10 UTC [2018/12/28 22:06:10 ET]
Table 'Hydra' 6-max Seat #1 is the button
Seat 1: ckriszee ($44.17 in chips) 
Seat 2: pokerpienda ($21.11 in chips) 
Seat 3: MeDoubleJ ($25.25 in chips) 
Seat 4: SantiagoWeight ($23.88 in chips) 
Seat 5: !P0K3RM3T4L! ($48.91 in chips) 
Seat 6: trillerGTO ($26.49 in chips) 
pokerpienda: posts small blind $0.10
MeDoubleJ: posts big blind $0.25
*** HOLE CARDS ***
Dealt to SantiagoWeight [2d 9c]
SantiagoWeight: folds 
!P0K3RM3T4L!: folds 
trillerGTO: raises $0.50 to $0.75
ckriszee: folds 
pokerpienda: calls $0.65
MeDoubleJ: folds 
*** FLOP *** [9s 5d 7c]
pokerpienda: checks 
trillerGTO: checks 
*** TURN *** [9s 5d 7c] [7s]
pokerpienda: checks 
trillerGTO: bets $0.58
pokerpienda: calls $0.58
*** RIVER *** [9s 5d 7c 7s] [4d]
pokerpienda: checks 
trillerGTO: bets $0.97
pokerpienda: folds 
Uncalled bet ($0.97) returned to trillerGTO
trillerGTO collected $2.78 from pot
trillerGTO: doesn't show hand 
*** SUMMARY ***
Total pot $2.91 | Rake $0.13 
Board [9s 5d 7c 7s 4d]
Seat 1: ckriszee (button) folded before Flop (didn't bet)
Seat 2: pokerpienda (small blind) folded on the River
Seat 3: MeDoubleJ (big blind) folded before Flop
Seat 4: SantiagoWeight folded before Flop (didn't bet)
Seat 5: !P0K3RM3T4L! folded before Flop (didn't bet)
Seat 6: trillerGTO collected ($2.78)



PokerStars Zoom Hand #195022757764:  Hold'em No Limit ($0.10/$0.25) - 2018/12/29 3:06:57 UTC [2018/12/28 22:06:57 ET]
Table 'Hydra' 6-max Seat #1 is the button
Seat 1: SantiagoWeight ($23.53 in chips) 
Seat 2: zdena102 ($52.56 in chips) 
Seat 3: Baboscrubx ($27.15 in chips) 
Seat 4: realbruzer ($22.99 in chips) 
Seat 5: Lehared ($46.85 in chips) 
Seat 6: nhanminhtri ($33.16 in chips) 
zdena102: posts small blind $0.10
Baboscrubx: posts big blind $0.25
*** HOLE CARDS ***
Dealt to SantiagoWeight [As 6h]
realbruzer: folds 
Lehared: folds 
nhanminhtri: folds 
SantiagoWeight: raises $0.25 to $0.50
zdena102: calls $0.40
Baboscrubx: calls $0.25
*** FLOP *** [7d 2c 5c]
zdena102: checks 
Baboscrubx: checks 
SantiagoWeight: checks 
*** TURN *** [7d 2c 5c] [Jh]
zdena102: bets $0.75
Baboscrubx: calls $0.75
SantiagoWeight: folds 
*** RIVER *** [7d 2c 5c Jh] [6c]
zdena102: bets $1
Baboscrubx: raises $2.48 to $3.48
zdena102: folds 
Uncalled bet ($2.48) returned to Baboscrubx
Baboscrubx collected $4.78 from pot
Baboscrubx: doesn't show hand 
*** SUMMARY ***
Total pot $5 | Rake $0.22 
Board [7d 2c 5c Jh 6c]
Seat 1: SantiagoWeight (button) folded on the Turn
Seat 2: zdena102 (small blind) folded on the River
Seat 3: Baboscrubx (big blind) collected ($4.78)
Seat 4: realbruzer folded before Flop (didn't bet)
Seat 5: Lehared folded before Flop (didn't bet)
Seat 6: nhanminhtri folded before Flop (didn't bet)



PokerStars Zoom Hand #195022772593:  Hold'em No Limit ($0.10/$0.25) - 2018/12/29 3:07:38 UTC [2018/12/28 22:07:38 ET]
Table 'Hydra' 6-max Seat #1 is the button
Seat 1: Actarusqc ($30.33 in chips) 
Seat 2: yobbos ($33.64 in chips) 
Seat 3: realbruzer ($22.99 in chips) 
Seat 4: SantiagoWeight ($23.03 in chips) 
Seat 5: samioattila ($47.54 in chips) 
Seat 6: Jack123985 ($31.61 in chips) 
yobbos: posts small blind $0.10
realbruzer: posts big blind $0.25
*** HOLE CARDS ***
Dealt to SantiagoWeight [9c 3d]
SantiagoWeight: folds 
samioattila: folds 
Jack123985: folds 
Actarusqc: calls $0.25
yobbos: calls $0.15
realbruzer: checks 
*** FLOP *** [2d Ah Kd]
yobbos: checks 
realbruzer: checks 
Actarusqc: bets $0.75
yobbos: folds 
realbruzer: folds 
Uncalled bet ($0.75) returned to Actarusqc
Actarusqc collected $0.72 from pot
Actarusqc: doesn't show hand 
*** SUMMARY ***
Total pot $0.75 | Rake $0.03 
Board [2d Ah Kd]
Seat 1: Actarusqc (button) collected ($0.72)
Seat 2: yobbos (small blind) folded on the Flop
Seat 3: realbruzer (big blind) folded on the Flop
Seat 4: SantiagoWeight folded before Flop (didn't bet)
Seat 5: samioattila folded before Flop (didn't bet)
Seat 6: Jack123985 folded before Flop (didn't bet)



PokerStars Zoom Hand #195022774026:  Hold'em No Limit ($0.10/$0.25) - 2018/12/29 3:07:43 UTC [2018/12/28 22:07:43 ET]
Table 'Hydra' 6-max Seat #1 is the button
Seat 1: Lehared ($58.60 in chips) 
Seat 2: Baboscrubx ($25 in chips) 
Seat 3: nhanminhtri ($30.95 in chips) 
Seat 4: Slim Wolfie ($28.04 in chips) 
Seat 5: SantiagoWeight ($23.03 in chips) 
Seat 6: ckriszee ($43.97 in chips) 
Baboscrubx: posts small blind $0.10
nhanminhtri: posts big blind $0.25
*** HOLE CARDS ***
Dealt to SantiagoWeight [Kd 9d]
Slim Wolfie: folds 
SantiagoWeight: raises $0.37 to $0.62
ckriszee: folds 
Lehared: folds 
Baboscrubx: folds 
nhanminhtri: folds 
Uncalled bet ($0.37) returned to SantiagoWeight
SantiagoWeight collected $0.60 from pot
SantiagoWeight: doesn't show hand 
*** SUMMARY ***
Total pot $0.60 | Rake $0 
Seat 1: Lehared (button) folded before Flop (didn't bet)
Seat 2: Baboscrubx (small blind) folded before Flop
Seat 3: nhanminhtri (big blind) folded before Flop
Seat 4: Slim Wolfie folded before Flop (didn't bet)
Seat 5: SantiagoWeight collected ($0.60)
Seat 6: ckriszee folded before Flop (didn't bet)



PokerStars Zoom Hand #195022782281:  Hold'em No Limit ($0.10/$0.25) - 2018/12/29 3:08:05 UTC [2018/12/28 22:08:05 ET]
Table 'Hydra' 6-max Seat #1 is the button
Seat 1: Akkana ($21.85 in chips) 
Seat 2: Parsam5 ($66.77 in chips) 
Seat 3: SantiagoWeight ($25 in chips) 
Seat 4: ckriszee ($25 in chips) 
Seat 5: benddo ($75.51 in chips) 
Seat 6: Doomdigidoom ($19.22 in chips) 
Parsam5: posts small blind $0.10
SantiagoWeight: posts big blind $0.25
*** HOLE CARDS ***
Dealt to SantiagoWeight [Jc Jd]
ckriszee: folds 
benddo: folds 
Doomdigidoom: raises $0.50 to $0.75
Akkana: folds 
Parsam5: folds 
SantiagoWeight: raises $2.45 to $3.20
Doomdigidoom: folds 
Uncalled bet ($2.45) returned to SantiagoWeight
SantiagoWeight collected $1.60 from pot
SantiagoWeight: doesn't show hand 
*** SUMMARY ***
Total pot $1.60 | Rake $0 
Seat 1: Akkana (button) folded before Flop (didn't bet)
Seat 2: Parsam5 (small blind) folded before Flop
Seat 3: SantiagoWeight (big blind) collected ($1.60)
Seat 4: ckriszee folded before Flop (didn't bet)
Seat 5: benddo folded before Flop (didn't bet)
Seat 6: Doomdigidoom folded before Flop



PokerStars Zoom Hand #195022797581:  Hold'em No Limit ($0.10/$0.25) - 2018/12/29 3:08:49 UTC [2018/12/28 22:08:49 ET]
Table 'Hydra' 6-max Seat #1 is the button
Seat 1: !P0K3RM3T4L! ($30.06 in chips) 
Seat 2: TQNYMQNTANA ($30.22 in chips) 
Seat 3: kopasz221 ($26.35 in chips) 
Seat 4: SantiagoWeight ($25.85 in chips) 
Seat 5: pokerpienda ($9.78 in chips) 
Seat 6: nhanminhtri ($37.91 in chips) 
TQNYMQNTANA: posts small blind $0.10
kopasz221: posts big blind $0.25
*** HOLE CARDS ***
Dealt to SantiagoWeight [8s 4d]
SantiagoWeight: folds 
pokerpienda: folds 
nhanminhtri: folds 
!P0K3RM3T4L!: raises $0.35 to $0.60
TQNYMQNTANA: folds 
kopasz221: folds 
Uncalled bet ($0.35) returned to !P0K3RM3T4L!
!P0K3RM3T4L! collected $0.60 from pot
!P0K3RM3T4L!: doesn't show hand 
*** SUMMARY ***
Total pot $0.60 | Rake $0 
Seat 1: !P0K3RM3T4L! (button) collected ($0.60)
Seat 2: TQNYMQNTANA (small blind) folded before Flop
Seat 3: kopasz221 (big blind) folded before Flop
Seat 4: SantiagoWeight folded before Flop (didn't bet)
Seat 5: pokerpienda folded before Flop (didn't bet)
Seat 6: nhanminhtri folded before Flop (didn't bet)



PokerStars Zoom Hand #195022801829:  Hold'em No Limit ($0.10/$0.25) - 2018/12/29 3:09:01 UTC [2018/12/28 22:09:01 ET]
Table 'Hydra' 6-max Seat #1 is the button
Seat 1: Parsam5 ($66.52 in chips) 
Seat 2: SantiagoWeight ($25.85 in chips) 
Seat 3: nhanminhtri ($37.91 in chips) 
Seat 4: rim975 ($14.66 in chips) 
Seat 5: _BluDeeN_ ($33.74 in chips) 
Seat 6: mayadelrey ($21.73 in chips) 
SantiagoWeight: posts small blind $0.10
nhanminhtri: posts big blind $0.25
*** HOLE CARDS ***
Dealt to SantiagoWeight [2d Jc]
rim975: raises $0.25 to $0.50
_BluDeeN_: folds 
mayadelrey: folds 
Parsam5: folds 
SantiagoWeight: folds 
nhanminhtri: folds 
Uncalled bet ($0.25) returned to rim975
rim975 collected $0.60 from pot
rim975: doesn't show hand 
*** SUMMARY ***
Total pot $0.60 | Rake $0 
Seat 1: Parsam5 (button) folded before Flop (didn't bet)
Seat 2: SantiagoWeight (small blind) folded before Flop
Seat 3: nhanminhtri (big blind) folded before Flop
Seat 4: rim975 collected ($0.60)
Seat 5: _BluDeeN_ folded before Flop (didn't bet)
Seat 6: mayadelrey folded before Flop (didn't bet)



PokerStars Zoom Hand #195022807554:  Hold'em No Limit ($0.10/$0.25) - 2018/12/29 3:09:16 UTC [2018/12/28 22:09:16 ET]
Table 'Hydra' 6-max Seat #1 is the button
Seat 1: anlu0803 ($24.30 in chips) 
Seat 2: KrishnaRadha ($33.24 in chips) 
Seat 3: Parsam5 ($66.42 in chips) 
Seat 4: yobbos ($139.51 in chips) 
Seat 5: Ryoji1029 ($20.16 in chips) 
Seat 6: SantiagoWeight ($25.75 in chips) 
KrishnaRadha: posts small blind $0.10
Parsam5: posts big blind $0.25
*** HOLE CARDS ***
Dealt to SantiagoWeight [8h Qh]
yobbos: folds 
Ryoji1029: raises $0.50 to $0.75
SantiagoWeight: folds 
anlu0803: folds 
KrishnaRadha: folds 
Parsam5: folds 
Uncalled bet ($0.50) returned to Ryoji1029
Ryoji1029 collected $0.60 from pot
Ryoji1029: doesn't show hand 
*** SUMMARY ***
Total pot $0.60 | Rake $0 
Seat 1: anlu0803 (button) folded before Flop (didn't bet)
Seat 2: KrishnaRadha (small blind) folded before Flop
Seat 3: Parsam5 (big blind) folded before Flop
Seat 4: yobbos folded before Flop (didn't bet)
Seat 5: Ryoji1029 collected ($0.60)
Seat 6: SantiagoWeight folded before Flop (didn't bet)



PokerStars Zoom Hand #195022810782:  Hold'em No Limit ($0.10/$0.25) - 2018/12/29 3:09:26 UTC [2018/12/28 22:09:26 ET]
Table 'Hydra' 6-max Seat #1 is the button
Seat 1: SantiagoWeight ($25.75 in chips) 
Seat 2: zhang1zhang ($26.75 in chips) 
Seat 3: kingkooi86 ($87.42 in chips) 
Seat 4: !P0K3RM3T4L! ($30.16 in chips) 
Seat 5: TQNYMQNTANA ($25 in chips) 
Seat 6: HonourMan23 ($33.10 in chips) 
zhang1zhang: posts small blind $0.10
kingkooi86: posts big blind $0.25
*** HOLE CARDS ***
Dealt to SantiagoWeight [6c 8s]
!P0K3RM3T4L!: folds 
TQNYMQNTANA: folds 
HonourMan23: folds 
SantiagoWeight: folds 
zhang1zhang: raises $0.50 to $0.75
kingkooi86: calls $0.50
*** FLOP *** [9h Ah 6s]
zhang1zhang: checks 
kingkooi86: bets $0.75
zhang1zhang: calls $0.75
*** TURN *** [9h Ah 6s] [2c]
zhang1zhang: checks 
kingkooi86: bets $1.50
zhang1zhang: folds 
Uncalled bet ($1.50) returned to kingkooi86
kingkooi86 collected $2.86 from pot
kingkooi86: doesn't show hand 
*** SUMMARY ***
Total pot $3 | Rake $0.14 
Board [9h Ah 6s 2c]
Seat 1: SantiagoWeight (button) folded before Flop (didn't bet)
Seat 2: zhang1zhang (small blind) folded on the Turn
Seat 3: kingkooi86 (big blind) collected ($2.86)
Seat 4: !P0K3RM3T4L! folded before Flop (didn't bet)
Seat 5: TQNYMQNTANA folded before Flop (didn't bet)
Seat 6: HonourMan23 folded before Flop (didn't bet)



PokerStars Zoom Hand #195022818337:  Hold'em No Limit ($0.10/$0.25) - 2018/12/29 3:09:46 UTC [2018/12/28 22:09:46 ET]
Table 'Hydra' 6-max Seat #1 is the button
Seat 1: Akkana ($21.25 in chips) 
Seat 2: HansMSM ($65.34 in chips) 
Seat 3: SantiagoWeight ($25.75 in chips) 
Seat 4: Kaazer ($8.45 in chips) 
Seat 5: _BluDeeN_ ($32.94 in chips) 
Seat 6: anorectal ($63.59 in chips) 
HansMSM: posts small blind $0.10
SantiagoWeight: posts big blind $0.25
*** HOLE CARDS ***
Dealt to SantiagoWeight [Qc 7s]
Kaazer: raises $0.50 to $0.75
_BluDeeN_: folds 
anorectal: folds 
Akkana: folds 
HansMSM: raises $1.75 to $2.50
SantiagoWeight: folds 
Kaazer: calls $1.75
*** FLOP *** [8c 3c 6c]
HansMSM: bets $6.76
Kaazer: calls $5.95 and is all-in
Uncalled bet ($0.81) returned to HansMSM
*** TURN *** [8c 3c 6c] [Kc]
*** RIVER *** [8c 3c 6c Kc] [7h]
*** SHOW DOWN ***
HansMSM: shows [Ah As] (a pair of Aces)
Kaazer: shows [9s 9h] (a pair of Nines)
HansMSM collected $16.38 from pot
*** SUMMARY ***
Total pot $17.15 | Rake $0.77 
Board [8c 3c 6c Kc 7h]
Seat 1: Akkana (button) folded before Flop (didn't bet)
Seat 2: HansMSM (small blind) showed [Ah As] and won ($16.38) with a pair of Aces
Seat 3: SantiagoWeight (big blind) folded before Flop
Seat 4: Kaazer showed [9s 9h] and lost with a pair of Nines
Seat 5: _BluDeeN_ folded before Flop (didn't bet)
Seat 6: anorectal folded before Flop (didn't bet)



PokerStars Zoom Hand #195022831429:  Hold'em No Limit ($0.10/$0.25) - 2018/12/29 3:10:24 UTC [2018/12/28 22:10:24 ET]
Table 'Hydra' 6-max Seat #1 is the button
Seat 1: 365DaysSucesful ($24.65 in chips) 
Seat 2: TQNYMQNTANA ($25 in chips) 
Seat 3: Parsam5 ($66.42 in chips) 
Seat 4: seba6688 ($11.19 in chips) 
Seat 5: SantiagoWeight ($25.50 in chips) 
Seat 6: MarcoA12 ($43.47 in chips) 
TQNYMQNTANA: posts small blind $0.10
Parsam5: posts big blind $0.25
*** HOLE CARDS ***
Dealt to SantiagoWeight [7s 8h]
seba6688: raises $0.50 to $0.75
SantiagoWeight: folds 
MarcoA12: calls $0.75
365DaysSucesful: folds 
TQNYMQNTANA: folds 
Parsam5: folds 
*** FLOP *** [9c Jd 7h]
seba6688: bets $1
MarcoA12: calls $1
*** TURN *** [9c Jd 7h] [3s]
seba6688: bets $1.75
MarcoA12: folds 
Uncalled bet ($1.75) returned to seba6688
seba6688 collected $3.68 from pot
seba6688: doesn't show hand 
*** SUMMARY ***
Total pot $3.85 | Rake $0.17 
Board [9c Jd 7h 3s]
Seat 1: 365DaysSucesful (button) folded before Flop (didn't bet)
Seat 2: TQNYMQNTANA (small blind) folded before Flop
Seat 3: Parsam5 (big blind) folded before Flop
Seat 4: seba6688 collected ($3.68)
Seat 5: SantiagoWeight folded before Flop (didn't bet)
Seat 6: MarcoA12 folded on the Turn



PokerStars Zoom Hand #195022837947:  Hold'em No Limit ($0.10/$0.25) - 2018/12/29 3:10:42 UTC [2018/12/28 22:10:42 ET]
Table 'Hydra' 6-max Seat #1 is the button
Seat 1: SantiagoWeight ($25.40 in chips) 
Seat 2: yobbos ($139.51 in chips) 
Seat 3: 365DaysSucesful ($24.90 in chips) 
Seat 4: Rollout2018 ($12.89 in chips) 
Seat 5: Chrimmpam ($23.84 in chips) 
Seat 6: reggiedogg31 ($111.77 in chips) 
yobbos: posts small blind $0.10
365DaysSucesful: posts big blind $0.25
*** HOLE CARDS ***
Dealt to SantiagoWeight [2d 6h]
Rollout2018: folds 
Chrimmpam: folds 
reggiedogg31: folds 
SantiagoWeight: folds 
yobbos: folds 
Uncalled bet ($0.15) returned to 365DaysSucesful
365DaysSucesful collected $0.20 from pot
365DaysSucesful: doesn't show hand 
*** SUMMARY ***
Total pot $0.20 | Rake $0 
Seat 1: SantiagoWeight (button) folded before Flop (didn't bet)
Seat 2: yobbos (small blind) folded before Flop
Seat 3: 365DaysSucesful (big blind) collected ($0.20)
Seat 4: Rollout2018 folded before Flop (didn't bet)
Seat 5: Chrimmpam folded before Flop (didn't bet)
Seat 6: reggiedogg31 folded before Flop (didn't bet)



PokerStars Zoom Hand #195022835052:  Hold'em No Limit ($0.10/$0.25) - 2018/12/29 3:10:33 UTC [2018/12/28 22:10:33 ET]
Table 'Hydra' 6-max Seat #1 is the button
Seat 1: ducepot15 ($35.85 in chips) 
Seat 2: SantiagoWeight ($25.50 in chips) 
Seat 3: Nutselas ($29.53 in chips) 
Seat 4: NL_BYreg ($58.27 in chips) 
Seat 5: gamoniusz ($43.05 in chips) 
Seat 6: Rollout2018 ($12.99 in chips) 
SantiagoWeight: posts small blind $0.10
Nutselas: posts big blind $0.25
*** HOLE CARDS ***
Dealt to SantiagoWeight [Ah 9s]
NL_BYreg: raises $0.50 to $0.75
gamoniusz: folds 
Rollout2018: folds 
ducepot15: folds 
SantiagoWeight: folds 
Nutselas: calls $0.50
*** FLOP *** [3h 9d 4h]
Nutselas: checks 
NL_BYreg: checks 
*** TURN *** [3h 9d 4h] [2c]
Nutselas: bets $1.07
NL_BYreg: folds 
Uncalled bet ($1.07) returned to Nutselas
Nutselas collected $1.53 from pot
Nutselas: doesn't show hand 
*** SUMMARY ***
Total pot $1.60 | Rake $0.07 
Board [3h 9d 4h 2c]
Seat 1: ducepot15 (button) folded before Flop (didn't bet)
Seat 2: SantiagoWeight (small blind) folded before Flop
Seat 3: Nutselas (big blind) collected ($1.53)
Seat 4: NL_BYreg folded on the Turn
Seat 5: gamoniusz folded before Flop (didn't bet)
Seat 6: Rollout2018 folded before Flop (didn't bet)



PokerStars Zoom Hand #195022845701:  Hold'em No Limit ($0.10/$0.25) - 2018/12/29 3:11:04 UTC [2018/12/28 22:11:04 ET]
Table 'Hydra' 6-max Seat #1 is the button
Seat 1: trillerGTO ($31.23 in chips) 
Seat 2: river plate9 ($25 in chips) 
Seat 3: BMB8888 ($23.38 in chips) 
Seat 4: negreanuNya ($25.10 in chips) 
Seat 5: rim975 ($16.85 in chips) 
Seat 6: SantiagoWeight ($25.40 in chips) 
river plate9: posts small blind $0.10
BMB8888: posts big blind $0.25
*** HOLE CARDS ***
Dealt to SantiagoWeight [Ad Ks]
negreanuNya: folds 
rim975: folds 
SantiagoWeight: raises $0.30 to $0.55
trillerGTO: folds 
river plate9: calls $0.45
BMB8888: calls $0.30
*** FLOP *** [5h Kd Td]
river plate9: checks 
BMB8888: bets $0.75
SantiagoWeight: raises $1.05 to $1.80
river plate9: folds 
BMB8888: calls $1.05
*** TURN *** [5h Kd Td] [Th]
BMB8888: checks 
SantiagoWeight: bets $3.34
BMB8888: raises $3.34 to $6.68
SantiagoWeight: calls $3.34
*** RIVER *** [5h Kd Td Th] [Tc]
BMB8888: bets $9
SantiagoWeight: calls $9
*** SHOW DOWN ***
BMB8888: shows [As Ts] (four of a kind, Tens)
SantiagoWeight: mucks hand 
BMB8888 collected $34.96 from pot
*** SUMMARY ***
Total pot $36.61 | Rake $1.65 
Board [5h Kd Td Th Tc]
Seat 1: trillerGTO (button) folded before Flop (didn't bet)
Seat 2: river plate9 (small blind) folded on the Flop
Seat 3: BMB8888 (big blind) showed [As Ts] and won ($34.96) with four of a kind, Tens
Seat 4: negreanuNya folded before Flop (didn't bet)
Seat 5: rim975 folded before Flop (didn't bet)
Seat 6: SantiagoWeight mucked [Ad Ks]



PokerStars Zoom Hand #195022886162:  Hold'em No Limit ($0.10/$0.25) - 2018/12/29 3:12:59 UTC [2018/12/28 22:12:59 ET]
Table 'Hydra' 6-max Seat #1 is the button
Seat 1: trillerGTO ($26.99 in chips) 
Seat 2: jfgodtheg ($45.69 in chips) 
Seat 3: mistdog ($40.53 in chips) 
Seat 4: HansMSM ($71.72 in chips) 
Seat 5: SantiagoWeight ($7.37 in chips) 
Seat 6: Pardaroxon ($25.57 in chips) 
jfgodtheg: posts small blind $0.10
mistdog: posts big blind $0.25
*** HOLE CARDS ***
Dealt to SantiagoWeight [Kd 3d]
HansMSM: raises $0.45 to $0.70
SantiagoWeight: folds 
Pardaroxon: folds 
trillerGTO: folds 
jfgodtheg: folds 
mistdog: folds 
Uncalled bet ($0.45) returned to HansMSM
HansMSM collected $0.60 from pot
HansMSM: doesn't show hand 
*** SUMMARY ***
Total pot $0.60 | Rake $0 
Seat 1: trillerGTO (button) folded before Flop (didn't bet)
Seat 2: jfgodtheg (small blind) folded before Flop
Seat 3: mistdog (big blind) folded before Flop
Seat 4: HansMSM collected ($0.60)
Seat 5: SantiagoWeight folded before Flop (didn't bet)
Seat 6: Pardaroxon folded before Flop (didn't bet)



PokerStars Zoom Hand #195022890477:  Hold'em No Limit ($0.10/$0.25) - 2018/12/29 3:13:11 UTC [2018/12/28 22:13:11 ET]
Table 'Hydra' 6-max Seat #1 is the button
Seat 1: qing328 ($32.20 in chips) 
Seat 2: zdena102 ($44.02 in chips) 
Seat 3: SantiagoWeight ($22.76 in chips) 
Seat 4: mistdog ($40.28 in chips) 
Seat 5: _BluDeeN_ ($24.20 in chips) 
Seat 6: Bujan 07 ($25.61 in chips) 
zdena102: posts small blind $0.10
SantiagoWeight: posts big blind $0.25
*** HOLE CARDS ***
Dealt to SantiagoWeight [4h 3d]
mistdog: folds 
_BluDeeN_: folds 
Bujan 07: folds 
qing328: folds 
zdena102: calls $0.15
SantiagoWeight: checks 
*** FLOP *** [6d 4c 8d]
zdena102: checks 
SantiagoWeight: bets $0.32
zdena102: folds 
Uncalled bet ($0.32) returned to SantiagoWeight
SantiagoWeight collected $0.48 from pot
SantiagoWeight: doesn't show hand 
*** SUMMARY ***
Total pot $0.50 | Rake $0.02 
Board [6d 4c 8d]
Seat 1: qing328 (button) folded before Flop (didn't bet)
Seat 2: zdena102 (small blind) folded on the Flop
Seat 3: SantiagoWeight (big blind) collected ($0.48)
Seat 4: mistdog folded before Flop (didn't bet)
Seat 5: _BluDeeN_ folded before Flop (didn't bet)
Seat 6: Bujan 07 folded before Flop (didn't bet)



PokerStars Zoom Hand #195022907412:  Hold'em No Limit ($0.10/$0.25) - 2018/12/29 3:13:58 UTC [2018/12/28 22:13:58 ET]
Table 'Hydra' 6-max Seat #1 is the button
Seat 1: ryanking99 ($45.69 in chips) 
Seat 2: SantiagoWeight ($22.99 in chips) 
Seat 3: Akkana ($10.63 in chips) 
Seat 4: meettokill ($33.01 in chips) 
Seat 5: Ars_cube ($14.35 in chips) 
Seat 6: Slim Wolfie ($36.90 in chips) 
SantiagoWeight: posts small blind $0.10
Akkana: posts big blind $0.25
*** HOLE CARDS ***
Dealt to SantiagoWeight [7h Ah]
meettokill: folds 
Ars_cube: folds 
Slim Wolfie: folds 
ryanking99: folds 
SantiagoWeight: raises $0.50 to $0.75
Akkana: folds 
Uncalled bet ($0.50) returned to SantiagoWeight
SantiagoWeight collected $0.50 from pot
SantiagoWeight: doesn't show hand 
*** SUMMARY ***
Total pot $0.50 | Rake $0 
Seat 1: ryanking99 (button) folded before Flop (didn't bet)
Seat 2: SantiagoWeight (small blind) collected ($0.50)
Seat 3: Akkana (big blind) folded before Flop
Seat 4: meettokill folded before Flop (didn't bet)
Seat 5: Ars_cube folded before Flop (didn't bet)
Seat 6: Slim Wolfie folded before Flop (didn't bet)



PokerStars Zoom Hand #195022903772:  Hold'em No Limit ($0.10/$0.25) - 2018/12/29 3:13:49 UTC [2018/12/28 22:13:49 ET]
Table 'Hydra' 6-max Seat #1 is the button
Seat 1: theman120294 ($48.54 in chips) 
Seat 2: BnanaBread13 ($25.10 in chips) 
Seat 3: assassin0875 ($194.77 in chips) 
Seat 4: SantiagoWeight ($22.99 in chips) 
Seat 5: Lehared ($59.41 in chips) 
Seat 6: gift-cloud9 ($35.15 in chips) 
BnanaBread13: posts small blind $0.10
assassin0875: posts big blind $0.25
*** HOLE CARDS ***
Dealt to SantiagoWeight [9d Js]
SantiagoWeight: folds 
Lehared: folds 
gift-cloud9: folds 
theman120294: raises $0.50 to $0.75
BnanaBread13: folds 
assassin0875: calls $0.50
*** FLOP *** [7d Th 7s]
assassin0875: checks 
theman120294: checks 
*** TURN *** [7d Th 7s] [2h]
assassin0875: bets $0.55
theman120294: raises $1.70 to $2.25
assassin0875: calls $1.70
*** RIVER *** [7d Th 7s 2h] [3c]
assassin0875: checks 
theman120294: bets $3.50
assassin0875: folds 
Uncalled bet ($3.50) returned to theman120294
theman120294 collected $5.83 from pot
theman120294: doesn't show hand 
*** SUMMARY ***
Total pot $6.10 | Rake $0.27 
Board [7d Th 7s 2h 3c]
Seat 1: theman120294 (button) collected ($5.83)
Seat 2: BnanaBread13 (small blind) folded before Flop
Seat 3: assassin0875 (big blind) folded on the River
Seat 4: SantiagoWeight folded before Flop (didn't bet)
Seat 5: Lehared folded before Flop (didn't bet)
Seat 6: gift-cloud9 folded before Flop (didn't bet)



PokerStars Zoom Hand #195022900298:  Hold'em No Limit ($0.10/$0.25) - 2018/12/29 3:13:38 UTC [2018/12/28 22:13:38 ET]
Table 'Hydra' 6-max Seat #1 is the button
Seat 1: zdena102 ($43.77 in chips) 
Seat 2: moderi ($39.40 in chips) 
Seat 3: Baboscrubx ($32.16 in chips) 
Seat 4: SantiagoWeight ($22.99 in chips) 
Seat 5: river plate9 ($25.25 in chips) 
Seat 6: zbuci ($39.45 in chips) 
moderi: posts small blind $0.10
Baboscrubx: posts big blind $0.25
*** HOLE CARDS ***
Dealt to SantiagoWeight [Ks 9c]
SantiagoWeight: folds 
river plate9: folds 
zbuci: calls $0.25
zdena102: raises $0.50 to $0.75
moderi: calls $0.65
Baboscrubx: calls $0.50
zbuci: calls $0.50
*** FLOP *** [Ah 7c 6d]
moderi: checks 
Baboscrubx: checks 
zbuci: checks 
zdena102: checks 
*** TURN *** [Ah 7c 6d] [6c]
moderi: checks 
Baboscrubx: checks 
zbuci: checks 
zdena102: checks 
*** RIVER *** [Ah 7c 6d 6c] [3h]
moderi: bets $5.25
Baboscrubx: folds 
zbuci: folds 
zdena102: folds 
Uncalled bet ($5.25) returned to moderi
moderi collected $2.86 from pot
moderi: doesn't show hand 
*** SUMMARY ***
Total pot $3 | Rake $0.14 
Board [Ah 7c 6d 6c 3h]
Seat 1: zdena102 (button) folded on the River
Seat 2: moderi (small blind) collected ($2.86)
Seat 3: Baboscrubx (big blind) folded on the River
Seat 4: SantiagoWeight folded before Flop (didn't bet)
Seat 5: river plate9 folded before Flop (didn't bet)
Seat 6: zbuci folded on the River



PokerStars Zoom Hand #195022913689:  Hold'em No Limit ($0.10/$0.25) - 2018/12/29 3:14:17 UTC [2018/12/28 22:14:17 ET]
Table 'Hydra' 6-max Seat #1 is the button
Seat 1: SantiagoWeight ($23.24 in chips) 
Seat 2: benddo ($107.75 in chips) 
Seat 3: Buntar017 ($140.38 in chips) 
Seat 4: mariopork ($48.95 in chips) 
Seat 5: anorectal ($47.64 in chips) 
Seat 6: nhanminhtri ($38.05 in chips) 
benddo: posts small blind $0.10
Buntar017: posts big blind $0.25
*** HOLE CARDS ***
Dealt to SantiagoWeight [Ah As]
mariopork: raises $0.50 to $0.75
anorectal: folds 
nhanminhtri: folds 
SantiagoWeight: raises $1.25 to $2
benddo: folds 
Buntar017: calls $1.75
mariopork: calls $1.25
*** FLOP *** [7h 7d Ks]
Buntar017: checks 
mariopork: checks 
SantiagoWeight: bets $1.46
Buntar017: calls $1.46
mariopork: folds 
*** TURN *** [7h 7d Ks] [3d]
Buntar017: checks 
SantiagoWeight: bets $5.70
Buntar017: folds 
Uncalled bet ($5.70) returned to SantiagoWeight
SantiagoWeight collected $8.61 from pot
SantiagoWeight: doesn't show hand 
*** SUMMARY ***
Total pot $9.02 | Rake $0.41 
Board [7h 7d Ks 3d]
Seat 1: SantiagoWeight (button) collected ($8.61)
Seat 2: benddo (small blind) folded before Flop
Seat 3: Buntar017 (big blind) folded on the Turn
Seat 4: mariopork folded on the Flop
Seat 5: anorectal folded before Flop (didn't bet)
Seat 6: nhanminhtri folded before Flop (didn't bet)



PokerStars Zoom Hand #195022930337:  Hold'em No Limit ($0.10/$0.25) - 2018/12/29 3:15:04 UTC [2018/12/28 22:15:04 ET]
Table 'Hydra' 6-max Seat #1 is the button
Seat 1: mariopork ($26.60 in chips) 
Seat 2: TQNYMQNTANA ($25.62 in chips) 
Seat 3: CrazieFreddy ($24.65 in chips) 
Seat 4: nhanminhtri ($38.83 in chips) 
Seat 5: gift-cloud9 ($33.93 in chips) 
Seat 6: SantiagoWeight ($28.39 in chips) 
TQNYMQNTANA: posts small blind $0.10
CrazieFreddy: posts big blind $0.25
*** HOLE CARDS ***
Dealt to SantiagoWeight [4s Jc]
nhanminhtri: folds 
gift-cloud9: folds 
SantiagoWeight: folds 
mariopork: folds 
TQNYMQNTANA: folds 
Uncalled bet ($0.15) returned to CrazieFreddy
CrazieFreddy collected $0.20 from pot
CrazieFreddy: doesn't show hand 
*** SUMMARY ***
Total pot $0.20 | Rake $0 
Seat 1: mariopork (button) folded before Flop (didn't bet)
Seat 2: TQNYMQNTANA (small blind) folded before Flop
Seat 3: CrazieFreddy (big blind) collected ($0.20)
Seat 4: nhanminhtri folded before Flop (didn't bet)
Seat 5: gift-cloud9 folded before Flop (didn't bet)
Seat 6: SantiagoWeight folded before Flop (didn't bet)



PokerStars Zoom Hand #195022934827:  Hold'em No Limit ($0.10/$0.25) - 2018/12/29 3:15:17 UTC [2018/12/28 22:15:17 ET]
Table 'Hydra' 6-max Seat #1 is the button
Seat 1: pokerpienda ($6.86 in chips) 
Seat 2: negreanuNya ($25 in chips) 
Seat 3: SantiagoWeight ($28.39 in chips) 
Seat 4: nhanminhtri ($28.87 in chips) 
Seat 5: gift-cloud9 ($25.45 in chips) 
Seat 6: G ster24 ($38.41 in chips) 
negreanuNya: posts small blind $0.10
SantiagoWeight: posts big blind $0.25
*** HOLE CARDS ***
Dealt to SantiagoWeight [3h 8h]
nhanminhtri: folds 
gift-cloud9: raises $0.37 to $0.62
G ster24: folds 
pokerpienda: folds 
negreanuNya: folds 
SantiagoWeight: folds 
Uncalled bet ($0.37) returned to gift-cloud9
gift-cloud9 collected $0.60 from pot
gift-cloud9: doesn't show hand 
*** SUMMARY ***
Total pot $0.60 | Rake $0 
Seat 1: pokerpienda (button) folded before Flop (didn't bet)
Seat 2: negreanuNya (small blind) folded before Flop
Seat 3: SantiagoWeight (big blind) folded before Flop
Seat 4: nhanminhtri folded before Flop (didn't bet)
Seat 5: gift-cloud9 collected ($0.60)
Seat 6: G ster24 folded before Flop (didn't bet)



PokerStars Zoom Hand #195022931710:  Hold'em No Limit ($0.10/$0.25) - 2018/12/29 3:15:08 UTC [2018/12/28 22:15:08 ET]
Table 'Hydra' 6-max Seat #1 is the button
Seat 1: TQNYMQNTANA ($25.52 in chips) 
Seat 2: zhang1zhang ($27.18 in chips) 
Seat 3: GrandmasterY ($25.47 in chips) 
Seat 4: Bujan 07 ($23.46 in chips) 
Seat 5: SantiagoWeight ($28.39 in chips) 
Seat 6: TDAK1509 ($58.87 in chips) 
zhang1zhang: posts small blind $0.10
GrandmasterY: posts big blind $0.25
*** HOLE CARDS ***
Dealt to SantiagoWeight [Kd 8h]
Bujan 07: raises $0.50 to $0.75
SantiagoWeight: folds 
TDAK1509: folds 
TQNYMQNTANA: folds 
zhang1zhang: folds 
GrandmasterY: calls $0.50
*** FLOP *** [Js 8s Td]
GrandmasterY: checks 
Bujan 07: bets $0.75
GrandmasterY: calls $0.75
*** TURN *** [Js 8s Td] [Qh]
GrandmasterY: bets $0.80
Bujan 07: folds 
Uncalled bet ($0.80) returned to GrandmasterY
GrandmasterY collected $2.96 from pot
GrandmasterY: doesn't show hand 
*** SUMMARY ***
Total pot $3.10 | Rake $0.14 
Board [Js 8s Td Qh]
Seat 1: TQNYMQNTANA (button) folded before Flop (didn't bet)
Seat 2: zhang1zhang (small blind) folded before Flop
Seat 3: GrandmasterY (big blind) collected ($2.96)
Seat 4: Bujan 07 folded on the Turn
Seat 5: SantiagoWeight folded before Flop (didn't bet)
Seat 6: TDAK1509 folded before Flop (didn't bet)



PokerStars Zoom Hand #195022946079:  Hold'em No Limit ($0.10/$0.25) - 2018/12/29 3:15:48 UTC [2018/12/28 22:15:48 ET]
Table 'Hydra' 6-max Seat #1 is the button
Seat 1: Xp0Hb ($25.33 in chips) 
Seat 2: SantiagoWeight ($28.14 in chips) 
Seat 3: mariopork ($36.80 in chips) 
Seat 4: Rollout2018 ($16.03 in chips) 
Seat 5: anorectal ($47.64 in chips) 
Seat 6: river plate9 ($22.33 in chips) 
SantiagoWeight: posts small blind $0.10
mariopork: posts big blind $0.25
*** HOLE CARDS ***
Dealt to SantiagoWeight [Qs As]
Rollout2018: raises $0.50 to $0.75
anorectal: folds 
river plate9: folds 
Xp0Hb: folds 
SantiagoWeight: raises $2.35 to $3.10
mariopork: folds 
Rollout2018: calls $2.35
*** FLOP *** [Jc Tc 9s]
SantiagoWeight: bets $3.60
Rollout2018: raises $9.33 to $12.93 and is all-in
SantiagoWeight: folds 
Uncalled bet ($9.33) returned to Rollout2018
Rollout2018 collected $13.04 from pot
*** SUMMARY ***
Total pot $13.65 | Rake $0.61 
Board [Jc Tc 9s]
Seat 1: Xp0Hb (button) folded before Flop (didn't bet)
Seat 2: SantiagoWeight (small blind) folded on the Flop
Seat 3: mariopork (big blind) folded before Flop
Seat 4: Rollout2018 collected ($13.04)
Seat 5: anorectal folded before Flop (didn't bet)
Seat 6: river plate9 folded before Flop (didn't bet)



PokerStars Zoom Hand #195022984376:  Hold'em No Limit ($0.10/$0.25) - 2018/12/29 3:17:38 UTC [2018/12/28 22:17:38 ET]
Table 'Hydra' 6-max Seat #1 is the button
Seat 1: gift-cloud9 ($32.01 in chips) 
Seat 2: FrommyBu ($28.79 in chips) 
Seat 3: mariopork ($48.15 in chips) 
Seat 4: Doomdigidoom ($15 in chips) 
Seat 5: anorectal ($25 in chips) 
Seat 6: SantiagoWeight ($21.44 in chips) 
FrommyBu: posts small blind $0.10
mariopork: posts big blind $0.25
*** HOLE CARDS ***
Dealt to SantiagoWeight [Ac 8c]
Doomdigidoom: folds 
anorectal: folds 
SantiagoWeight: raises $0.30 to $0.55
gift-cloud9: folds 
FrommyBu: folds 
mariopork: folds 
Uncalled bet ($0.30) returned to SantiagoWeight
SantiagoWeight collected $0.60 from pot
SantiagoWeight: doesn't show hand 
*** SUMMARY ***
Total pot $0.60 | Rake $0 
Seat 1: gift-cloud9 (button) folded before Flop (didn't bet)
Seat 2: FrommyBu (small blind) folded before Flop
Seat 3: mariopork (big blind) folded before Flop
Seat 4: Doomdigidoom folded before Flop (didn't bet)
Seat 5: anorectal folded before Flop (didn't bet)
Seat 6: SantiagoWeight collected ($0.60)



PokerStars Zoom Hand #195023000458:  Hold'em No Limit ($0.10/$0.25) - 2018/12/29 3:18:24 UTC [2018/12/28 22:18:24 ET]
Table 'Hydra' 6-max Seat #1 is the button
Seat 1: feihongjin ($24.65 in chips) 
Seat 2: nhanminhtri ($31.64 in chips) 
Seat 3: CrazieFreddy ($23.30 in chips) 
Seat 4: SantiagoWeight ($25 in chips) 
Seat 5: naxizzle ($136.60 in chips) 
Seat 6: TQNYMQNTANA ($94.27 in chips) 
nhanminhtri: posts small blind $0.10
CrazieFreddy: posts big blind $0.25
*** HOLE CARDS ***
Dealt to SantiagoWeight [8d 2c]
SantiagoWeight: folds 
naxizzle: folds 
TQNYMQNTANA: folds 
feihongjin: folds 
nhanminhtri: folds 
Uncalled bet ($0.15) returned to CrazieFreddy
CrazieFreddy collected $0.20 from pot
CrazieFreddy: doesn't show hand 
*** SUMMARY ***
Total pot $0.20 | Rake $0 
Seat 1: feihongjin (button) folded before Flop (didn't bet)
Seat 2: nhanminhtri (small blind) folded before Flop
Seat 3: CrazieFreddy (big blind) collected ($0.20)
Seat 4: SantiagoWeight folded before Flop (didn't bet)
Seat 5: naxizzle folded before Flop (didn't bet)
Seat 6: TQNYMQNTANA folded before Flop (didn't bet)



PokerStars Zoom Hand #195022989967:  Hold'em No Limit ($0.10/$0.25) - 2018/12/29 3:17:54 UTC [2018/12/28 22:17:54 ET]
Table 'Hydra' 6-max Seat #1 is the button
Seat 1: SantiagoWeight ($21.79 in chips) 
Seat 2: BirreteX ($25 in chips) 
Seat 3: ttshead ($60.27 in chips) 
Seat 4: Lehared ($110.77 in chips) 
Seat 5: mistdog ($40.61 in chips) 
Seat 6: pfunkolstar ($25 in chips) 
BirreteX: posts small blind $0.10
ttshead: posts big blind $0.25
*** HOLE CARDS ***
Dealt to SantiagoWeight [6c 3c]
Lehared: raises $0.37 to $0.62
mistdog: folds 
pfunkolstar: calls $0.62
SantiagoWeight: folds 
BirreteX: folds 
ttshead: folds 
*** FLOP *** [8h Kc 8c]
Lehared: bets $0.82
pfunkolstar: folds 
Uncalled bet ($0.82) returned to Lehared
Lehared collected $1.52 from pot
Lehared: doesn't show hand 
*** SUMMARY ***
Total pot $1.59 | Rake $0.07 
Board [8h Kc 8c]
Seat 1: SantiagoWeight (button) folded before Flop (didn't bet)
Seat 2: BirreteX (small blind) folded before Flop
Seat 3: ttshead (big blind) folded before Flop
Seat 4: Lehared collected ($1.52)
Seat 5: mistdog folded before Flop (didn't bet)
Seat 6: pfunkolstar folded on the Flop



PokerStars Zoom Hand #195022999055:  Hold'em No Limit ($0.10/$0.25) - 2018/12/29 3:18:20 UTC [2018/12/28 22:18:20 ET]
Table 'Hydra' 6-max Seat #1 is the button
Seat 1: Unclesmoll ($15.10 in chips) 
Seat 2: Parsam5 ($67.14 in chips) 
Seat 3: numbernine5 ($26 in chips) 
Seat 4: SantiagoWeight ($25 in chips) 
Seat 5: river plate9 ($19.70 in chips) 
Seat 6: gaffer31 ($26.47 in chips) 
Parsam5: posts small blind $0.10
numbernine5: posts big blind $0.25
*** HOLE CARDS ***
Dealt to SantiagoWeight [Jc 8c]
SantiagoWeight: folds 
river plate9: folds 
gaffer31: folds 
Unclesmoll: raises $0.50 to $0.75
Parsam5: folds 
numbernine5: raises $2.25 to $3
Unclesmoll: calls $2.25
*** FLOP *** [8s 7s Ac]
numbernine5: bets $3.21
Unclesmoll: folds 
Uncalled bet ($3.21) returned to numbernine5
numbernine5 collected $5.83 from pot
numbernine5: doesn't show hand 
*** SUMMARY ***
Total pot $6.10 | Rake $0.27 
Board [8s 7s Ac]
Seat 1: Unclesmoll (button) folded on the Flop
Seat 2: Parsam5 (small blind) folded before Flop
Seat 3: numbernine5 (big blind) collected ($5.83)
Seat 4: SantiagoWeight folded before Flop (didn't bet)
Seat 5: river plate9 folded before Flop (didn't bet)
Seat 6: gaffer31 folded before Flop (didn't bet)



PokerStars Zoom Hand #195023007383:  Hold'em No Limit ($0.10/$0.25) - 2018/12/29 3:18:44 UTC [2018/12/28 22:18:44 ET]
Table 'Hydra' 6-max Seat #1 is the button
Seat 1: miru877 ($24.30 in chips) 
Seat 2: Only1Table ($20.03 in chips) 
Seat 3: franco373513 ($14.77 in chips) 
Seat 4: Pardaroxon ($25.89 in chips) 
Seat 5: anorectal ($94.26 in chips) 
Seat 6: SantiagoWeight ($24.75 in chips) 
Only1Table: posts small blind $0.10
franco373513: posts big blind $0.25
*** HOLE CARDS ***
Dealt to SantiagoWeight [8h 8s]
Pardaroxon: folds 
anorectal: folds 
SantiagoWeight: raises $0.30 to $0.55
miru877: folds 
Only1Table: folds 
franco373513: folds 
Uncalled bet ($0.30) returned to SantiagoWeight
SantiagoWeight collected $0.60 from pot
SantiagoWeight: doesn't show hand 
*** SUMMARY ***
Total pot $0.60 | Rake $0 
Seat 1: miru877 (button) folded before Flop (didn't bet)
Seat 2: Only1Table (small blind) folded before Flop
Seat 3: franco373513 (big blind) folded before Flop
Seat 4: Pardaroxon folded before Flop (didn't bet)
Seat 5: anorectal folded before Flop (didn't bet)
Seat 6: SantiagoWeight collected ($0.60)



PokerStars Zoom Hand #195023002534:  Hold'em No Limit ($0.10/$0.25) - 2018/12/29 3:18:30 UTC [2018/12/28 22:18:30 ET]
Table 'Hydra' 6-max Seat #1 is the button
Seat 1: seba6688 ($10.80 in chips) 
Seat 2: feihongjin ($24.65 in chips) 
Seat 3: SantiagoWeight ($25 in chips) 
Seat 4: HansMSM ($29.77 in chips) 
Seat 5: Bujan 07 ($20.69 in chips) 
Seat 6: ttshead ($60.27 in chips) 
feihongjin: posts small blind $0.10
SantiagoWeight: posts big blind $0.25
*** HOLE CARDS ***
Dealt to SantiagoWeight [5h 3d]
HansMSM: raises $0.45 to $0.70
Bujan 07: calls $0.70
ttshead: folds 
seba6688: folds 
feihongjin: folds 
SantiagoWeight: folds 
*** FLOP *** [Jh 2d Kc]
HansMSM: checks 
Bujan 07: bets $0.75
HansMSM: folds 
Uncalled bet ($0.75) returned to Bujan 07
Bujan 07 collected $1.67 from pot
Bujan 07: doesn't show hand 
*** SUMMARY ***
Total pot $1.75 | Rake $0.08 
Board [Jh 2d Kc]
Seat 1: seba6688 (button) folded before Flop (didn't bet)
Seat 2: feihongjin (small blind) folded before Flop
Seat 3: SantiagoWeight (big blind) folded before Flop
Seat 4: HansMSM folded on the Flop
Seat 5: Bujan 07 collected ($1.67)
Seat 6: ttshead folded before Flop (didn't bet)



PokerStars Zoom Hand #195023016461:  Hold'em No Limit ($0.10/$0.25) - 2018/12/29 3:19:10 UTC [2018/12/28 22:19:10 ET]
Table 'Hydra' 6-max Seat #1 is the button
Seat 1: SantiagoWeight ($25 in chips) 
Seat 2: mistdog ($41.26 in chips) 
Seat 3: ryanking99 ($16.85 in chips) 
Seat 4: anorectal ($31.91 in chips) 
Seat 5: pfunkolstar ($25 in chips) 
Seat 6: nhanminhtri ($30.63 in chips) 
mistdog: posts small blind $0.10
ryanking99: posts big blind $0.25
*** HOLE CARDS ***
Dealt to SantiagoWeight [Qc 6s]
anorectal: folds 
pfunkolstar: folds 
nhanminhtri: folds 
SantiagoWeight: folds 
mistdog: folds 
Uncalled bet ($0.15) returned to ryanking99
ryanking99 collected $0.20 from pot
ryanking99: doesn't show hand 
*** SUMMARY ***
Total pot $0.20 | Rake $0 
Seat 1: SantiagoWeight (button) folded before Flop (didn't bet)
Seat 2: mistdog (small blind) folded before Flop
Seat 3: ryanking99 (big blind) collected ($0.20)
Seat 4: anorectal folded before Flop (didn't bet)
Seat 5: pfunkolstar folded before Flop (didn't bet)
Seat 6: nhanminhtri folded before Flop (didn't bet)



PokerStars Zoom Hand #195023015088:  Hold'em No Limit ($0.10/$0.25) - 2018/12/29 3:19:06 UTC [2018/12/28 22:19:06 ET]
Table 'Hydra' 6-max Seat #1 is the button
Seat 1: killerB17 ($34.46 in chips) 
Seat 2: SantiagoWeight ($25.10 in chips) 
Seat 3: zhang1zhang ($29.99 in chips) 
Seat 4: anlu0803 ($24.75 in chips) 
Seat 5: mayadelrey ($51.78 in chips) 
Seat 6: miru877 ($24.30 in chips) 
SantiagoWeight: posts small blind $0.10
zhang1zhang: posts big blind $0.25
*** HOLE CARDS ***
Dealt to SantiagoWeight [2c 9h]
anlu0803: folds 
mayadelrey: folds 
miru877: raises $0.50 to $0.75
killerB17: folds 
SantiagoWeight: folds 
zhang1zhang: raises $1.75 to $2.50
miru877: folds 
Uncalled bet ($1.75) returned to zhang1zhang
zhang1zhang collected $1.60 from pot
zhang1zhang: doesn't show hand 
*** SUMMARY ***
Total pot $1.60 | Rake $0 
Seat 1: killerB17 (button) folded before Flop (didn't bet)
Seat 2: SantiagoWeight (small blind) folded before Flop
Seat 3: zhang1zhang (big blind) collected ($1.60)
Seat 4: anlu0803 folded before Flop (didn't bet)
Seat 5: mayadelrey folded before Flop (didn't bet)
Seat 6: miru877 folded before Flop



PokerStars Zoom Hand #195023025390:  Hold'em No Limit ($0.10/$0.25) - 2018/12/29 3:19:36 UTC [2018/12/28 22:19:36 ET]
Table 'Hydra' 6-max Seat #1 is the button
Seat 1: qing328 ($22.45 in chips) 
Seat 2: gift-cloud9 ($27.87 in chips) 
Seat 3: SantiagoWeight ($25 in chips) 
Seat 4: kevinwelsk ($24.93 in chips) 
Seat 5: miru877 ($22.99 in chips) 
Seat 6: CAPTAINSKA ($30.39 in chips) 
gift-cloud9: posts small blind $0.10
SantiagoWeight: posts big blind $0.25
*** HOLE CARDS ***
Dealt to SantiagoWeight [5c Jh]
kevinwelsk: folds 
miru877: folds 
CAPTAINSKA: raises $0.37 to $0.62
qing328: folds 
gift-cloud9: folds 
SantiagoWeight: folds 
Uncalled bet ($0.37) returned to CAPTAINSKA
CAPTAINSKA collected $0.60 from pot
*** SUMMARY ***
Total pot $0.60 | Rake $0 
Seat 1: qing328 (button) folded before Flop (didn't bet)
Seat 2: gift-cloud9 (small blind) folded before Flop
Seat 3: SantiagoWeight (big blind) folded before Flop
Seat 4: kevinwelsk folded before Flop (didn't bet)
Seat 5: miru877 folded before Flop (didn't bet)
Seat 6: CAPTAINSKA collected ($0.60)



PokerStars Zoom Hand #195022998006:  Hold'em No Limit ($0.10/$0.25) - 2018/12/29 3:18:17 UTC [2018/12/28 22:18:17 ET]
Table 'Hydra' 6-max Seat #1 is the button
Seat 1: Ryoji1029 ($31.02 in chips) 
Seat 2: HonourMan23 ($32.28 in chips) 
Seat 3: naxizzle ($136.85 in chips) 
Seat 4: Nutselas ($29.01 in chips) 
Seat 5: SantiagoWeight ($25 in chips) 
Seat 6: nadal335 ($61.45 in chips) 
HonourMan23: posts small blind $0.10
naxizzle: posts big blind $0.25
*** HOLE CARDS ***
Dealt to SantiagoWeight [5s 2d]
Nutselas: raises $0.50 to $0.75
SantiagoWeight: folds 
nadal335: folds 
Ryoji1029: raises $0.75 to $1.50
HonourMan23: folds 
naxizzle: folds 
Nutselas: raises $3 to $4.50
Ryoji1029: calls $3
*** FLOP *** [8c Qs 4s]
Nutselas: bets $3.50
Ryoji1029: calls $3.50
*** TURN *** [8c Qs 4s] [7s]
Nutselas: checks 
Ryoji1029: bets $6.50
Nutselas: calls $6.50
*** RIVER *** [8c Qs 4s 7s] [9d]
Nutselas: checks 
Ryoji1029: bets $16.52 and is all-in
Nutselas: folds 
Uncalled bet ($16.52) returned to Ryoji1029
Ryoji1029 collected $28.03 from pot
Ryoji1029: doesn't show hand 
*** SUMMARY ***
Total pot $29.35 | Rake $1.32 
Board [8c Qs 4s 7s 9d]
Seat 1: Ryoji1029 (button) collected ($28.03)
Seat 2: HonourMan23 (small blind) folded before Flop
Seat 3: naxizzle (big blind) folded before Flop
Seat 4: Nutselas folded on the River
Seat 5: SantiagoWeight folded before Flop (didn't bet)
Seat 6: nadal335 folded before Flop (didn't bet)



PokerStars Zoom Hand #195023022330:  Hold'em No Limit ($0.10/$0.25) - 2018/12/29 3:19:27 UTC [2018/12/28 22:19:27 ET]
Table 'Hydra' 6-max Seat #1 is the button
Seat 1: Lehared ($110.85 in chips) 
Seat 2: Dbakunwaves ($104.32 in chips) 
Seat 3: Only1Table ($20.28 in chips) 
Seat 4: Mandu_xiii ($25.71 in chips) 
Seat 5: SantiagoWeight ($25 in chips) 
Seat 6: call me??107 ($38.01 in chips) 
Dbakunwaves: posts small blind $0.10
Only1Table: posts big blind $0.25
*** HOLE CARDS ***
Dealt to SantiagoWeight [3d 7d]
Mandu_xiii: folds 
SantiagoWeight: folds 
call me??107: folds 
Lehared: raises $0.37 to $0.62
Dbakunwaves: calls $0.52
Only1Table: calls $0.37
*** FLOP *** [6h 8d Kc]
Dbakunwaves: checks 
Only1Table: checks 
Lehared: checks 
*** TURN *** [6h 8d Kc] [7h]
Dbakunwaves: checks 
Only1Table: bets $0.89
Lehared: folds 
Dbakunwaves: folds 
Uncalled bet ($0.89) returned to Only1Table
Only1Table collected $1.78 from pot
Only1Table: doesn't show hand 
*** SUMMARY ***
Total pot $1.86 | Rake $0.08 
Board [6h 8d Kc 7h]
Seat 1: Lehared (button) folded on the Turn
Seat 2: Dbakunwaves (small blind) folded on the Turn
Seat 3: Only1Table (big blind) collected ($1.78)
Seat 4: Mandu_xiii folded before Flop (didn't bet)
Seat 5: SantiagoWeight folded before Flop (didn't bet)
Seat 6: call me??107 folded before Flop (didn't bet)



PokerStars Zoom Hand #195023031563:  Hold'em No Limit ($0.10/$0.25) - 2018/12/29 3:19:54 UTC [2018/12/28 22:19:54 ET]
Table 'Hydra' 6-max Seat #1 is the button
Seat 1: Baboscrubx ($31.41 in chips) 
Seat 2: SantiagoWeight ($24.75 in chips) 
Seat 3: winwinboy ($27.12 in chips) 
Seat 4: qing328 ($29.83 in chips) 
Seat 5: ckriszee ($25.41 in chips) 
Seat 6: river plate9 ($24.90 in chips) 
SantiagoWeight: posts small blind $0.10
winwinboy: posts big blind $0.25
*** HOLE CARDS ***
Dealt to SantiagoWeight [9h 7d]
qing328: folds 
ckriszee: folds 
river plate9: raises $0.25 to $0.50
Baboscrubx: calls $0.50
SantiagoWeight: folds 
winwinboy: calls $0.25
*** FLOP *** [Ts Ac As]
winwinboy: checks 
river plate9: checks 
Baboscrubx: checks 
*** TURN *** [Ts Ac As] [Qd]
winwinboy: bets $1
river plate9: folds 
Baboscrubx: folds 
Uncalled bet ($1) returned to winwinboy
winwinboy collected $1.53 from pot
winwinboy: doesn't show hand 
*** SUMMARY ***
Total pot $1.60 | Rake $0.07 
Board [Ts Ac As Qd]
Seat 1: Baboscrubx (button) folded on the Turn
Seat 2: SantiagoWeight (small blind) folded before Flop
Seat 3: winwinboy (big blind) collected ($1.53)
Seat 4: qing328 folded before Flop (didn't bet)
Seat 5: ckriszee folded before Flop (didn't bet)
Seat 6: river plate9 folded on the Turn



PokerStars Zoom Hand #195023037681:  Hold'em No Limit ($0.10/$0.25) - 2018/12/29 3:20:12 UTC [2018/12/28 22:20:12 ET]
Table 'Hydra' 6-max Seat #1 is the button
Seat 1: gaffer31 ($14.72 in chips) 
Seat 2: TDAK1509 ($64.53 in chips) 
Seat 3: Parsam5 ($50.88 in chips) 
Seat 4: winwinboy ($25.61 in chips) 
Seat 5: yobbos ($63.29 in chips) 
Seat 6: SantiagoWeight ($24.65 in chips) 
TDAK1509: posts small blind $0.10
Parsam5: posts big blind $0.25
*** HOLE CARDS ***
Dealt to SantiagoWeight [6h Ad]
winwinboy: folds 
yobbos: folds 
SantiagoWeight: folds 
gaffer31: folds 
TDAK1509: folds 
Uncalled bet ($0.15) returned to Parsam5
Parsam5 collected $0.20 from pot
Parsam5: doesn't show hand 
*** SUMMARY ***
Total pot $0.20 | Rake $0 
Seat 1: gaffer31 (button) folded before Flop (didn't bet)
Seat 2: TDAK1509 (small blind) folded before Flop
Seat 3: Parsam5 (big blind) collected ($0.20)
Seat 4: winwinboy folded before Flop (didn't bet)
Seat 5: yobbos folded before Flop (didn't bet)
Seat 6: SantiagoWeight folded before Flop (didn't bet)



PokerStars Zoom Hand #195023055582:  Hold'em No Limit ($0.10/$0.25) - 2018/12/29 3:21:04 UTC [2018/12/28 22:21:04 ET]
Table 'Hydra' 6-max Seat #1 is the button
Seat 1: nhanminhtri ($25 in chips) 
Seat 2: angipoker ($12.60 in chips) 
Seat 3: Pardaroxon ($25.25 in chips) 
Seat 4: CAPTAINSKA ($29.77 in chips) 
Seat 5: SantiagoWeight ($24.65 in chips) 
Seat 6: ckriszee ($25.06 in chips) 
angipoker: posts small blind $0.10
Pardaroxon: posts big blind $0.25
*** HOLE CARDS ***
Dealt to SantiagoWeight [5s 3c]
CAPTAINSKA: folds 
SantiagoWeight: folds 
ckriszee: folds 
nhanminhtri: raises $0.37 to $0.62
angipoker: folds 
Pardaroxon: folds 
Uncalled bet ($0.37) returned to nhanminhtri
nhanminhtri collected $0.60 from pot
nhanminhtri: doesn't show hand 
*** SUMMARY ***
Total pot $0.60 | Rake $0 
Seat 1: nhanminhtri (button) collected ($0.60)
Seat 2: angipoker (small blind) folded before Flop
Seat 3: Pardaroxon (big blind) folded before Flop
Seat 4: CAPTAINSKA folded before Flop (didn't bet)
Seat 5: SantiagoWeight folded before Flop (didn't bet)
Seat 6: ckriszee folded before Flop (didn't bet)



PokerStars Zoom Hand #195023046621:  Hold'em No Limit ($0.10/$0.25) - 2018/12/29 3:20:38 UTC [2018/12/28 22:20:38 ET]
Table 'Hydra' 6-max Seat #1 is the button
Seat 1: SantiagoWeight ($24.65 in chips) 
Seat 2: nadal335 ($57.45 in chips) 
Seat 3: anorectal ($28.25 in chips) 
Seat 4: HansMSM ($61.19 in chips) 
Seat 5: reademenweep ($18.99 in chips) 
Seat 6: miru877 ($26.11 in chips) 
nadal335: posts small blind $0.10
anorectal: posts big blind $0.25
*** HOLE CARDS ***
Dealt to SantiagoWeight [9s Qc]
HansMSM: folds 
reademenweep: calls $0.25
miru877: folds 
SantiagoWeight: folds 
nadal335: folds 
anorectal: checks 
*** FLOP *** [5d Kd 7c]
anorectal: checks 
reademenweep: bets $0.50
anorectal: calls $0.50
*** TURN *** [5d Kd 7c] [7d]
anorectal: checks 
reademenweep: checks 
*** RIVER *** [5d Kd 7c 7d] [4d]
anorectal: bets $1.22
reademenweep: folds 
Uncalled bet ($1.22) returned to anorectal
anorectal collected $1.53 from pot
anorectal: doesn't show hand 
*** SUMMARY ***
Total pot $1.60 | Rake $0.07 
Board [5d Kd 7c 7d 4d]
Seat 1: SantiagoWeight (button) folded before Flop (didn't bet)
Seat 2: nadal335 (small blind) folded before Flop
Seat 3: anorectal (big blind) collected ($1.53)
Seat 4: HansMSM folded before Flop (didn't bet)
Seat 5: reademenweep folded on the River
Seat 6: miru877 folded before Flop (didn't bet)



PokerStars Zoom Hand #195023051792:  Hold'em No Limit ($0.10/$0.25) - 2018/12/29 3:20:53 UTC [2018/12/28 22:20:53 ET]
Table 'Hydra' 6-max Seat #1 is the button
Seat 1: winwinboy ($25 in chips) 
Seat 2: Dr.Jekyll197 ($34.50 in chips) 
Seat 3: negreanuNya ($26.83 in chips) 
Seat 4: SantiagoWeight ($24.65 in chips) 
Seat 5: Looooser #1 ($22.50 in chips) 
Seat 6: Tsundere ($26.08 in chips) 
Dr.Jekyll197: posts small blind $0.10
negreanuNya: posts big blind $0.25
*** HOLE CARDS ***
Dealt to SantiagoWeight [4h Th]
SantiagoWeight: folds 
Looooser #1: folds 
Tsundere: folds 
winwinboy: raises $0.43 to $0.68
Dr.Jekyll197: folds 
negreanuNya: calls $0.43
*** FLOP *** [Js 8h Ah]
negreanuNya: checks 
winwinboy: bets $0.90
negreanuNya: raises $1.90 to $2.80
winwinboy: folds 
Uncalled bet ($1.90) returned to negreanuNya
negreanuNya collected $3.11 from pot
negreanuNya: doesn't show hand 
*** SUMMARY ***
Total pot $3.26 | Rake $0.15 
Board [Js 8h Ah]
Seat 1: winwinboy (button) folded on the Flop
Seat 2: Dr.Jekyll197 (small blind) folded before Flop
Seat 3: negreanuNya (big blind) collected ($3.11)
Seat 4: SantiagoWeight folded before Flop (didn't bet)
Seat 5: Looooser #1 folded before Flop (didn't bet)
Seat 6: Tsundere folded before Flop (didn't bet)



PokerStars Zoom Hand #195023058262:  Hold'em No Limit ($0.10/$0.25) - 2018/12/29 3:21:12 UTC [2018/12/28 22:21:12 ET]
Table 'Hydra' 6-max Seat #1 is the button
Seat 1: aa1421b ($28.37 in chips) 
Seat 2: miru877 ($22.58 in chips) 
Seat 3: SantiagoWeight ($24.65 in chips) 
Seat 4: davidhw888 ($23.18 in chips) 
Seat 5: mistdog ($41.69 in chips) 
Seat 6: GQwang ($32.50 in chips) 
miru877: posts small blind $0.10
SantiagoWeight: posts big blind $0.25
*** HOLE CARDS ***
Dealt to SantiagoWeight [Kc Th]
davidhw888: folds 
mistdog: folds 
GQwang: raises $0.50 to $0.75
aa1421b: folds 
miru877: folds 
SantiagoWeight: folds 
Uncalled bet ($0.50) returned to GQwang
GQwang collected $0.60 from pot
GQwang: doesn't show hand 
*** SUMMARY ***
Total pot $0.60 | Rake $0 
Seat 1: aa1421b (button) folded before Flop (didn't bet)
Seat 2: miru877 (small blind) folded before Flop
Seat 3: SantiagoWeight (big blind) folded before Flop
Seat 4: davidhw888 folded before Flop (didn't bet)
Seat 5: mistdog folded before Flop (didn't bet)
Seat 6: GQwang collected ($0.60)



PokerStars Zoom Hand #195023066583:  Hold'em No Limit ($0.10/$0.25) - 2018/12/29 3:21:36 UTC [2018/12/28 22:21:36 ET]
Table 'Hydra' 6-max Seat #1 is the button
Seat 1: TQNYMQNTANA ($26.34 in chips) 
Seat 2: 1ownYourUsd ($35.50 in chips) 
Seat 3: will82777 ($8.50 in chips) 
Seat 4: anorectal ($86.40 in chips) 
Seat 5: gift-cloud9 ($25 in chips) 
Seat 6: SantiagoWeight ($24.40 in chips) 
1ownYourUsd: posts small blind $0.10
will82777: posts big blind $0.25
*** HOLE CARDS ***
Dealt to SantiagoWeight [Qh 8c]
anorectal: folds 
gift-cloud9: folds 
SantiagoWeight: raises $0.30 to $0.55
TQNYMQNTANA: folds 
1ownYourUsd: folds 
will82777: calls $0.30
*** FLOP *** [2h 4d 7c]
will82777: checks 
SantiagoWeight: bets $0.29
will82777: raises $0.96 to $1.25
SantiagoWeight: folds 
Uncalled bet ($0.96) returned to will82777
will82777 collected $1.70 from pot
*** SUMMARY ***
Total pot $1.78 | Rake $0.08 
Board [2h 4d 7c]
Seat 1: TQNYMQNTANA (button) folded before Flop (didn't bet)
Seat 2: 1ownYourUsd (small blind) folded before Flop
Seat 3: will82777 (big blind) collected ($1.70)
Seat 4: anorectal folded before Flop (didn't bet)
Seat 5: gift-cloud9 folded before Flop (didn't bet)
Seat 6: SantiagoWeight folded on the Flop



PokerStars Zoom Hand #195023087808:  Hold'em No Limit ($0.10/$0.25) - 2018/12/29 3:22:38 UTC [2018/12/28 22:22:38 ET]
Table 'Hydra' 6-max Seat #1 is the button
Seat 1: _BluDeeN_ ($54.10 in chips) 
Seat 2: SantiagoWeight ($23.56 in chips) 
Seat 3: miru877 ($22.97 in chips) 
Seat 4: Rollout2018 ($21.60 in chips) 
Seat 5: winwinboy ($25.26 in chips) 
Seat 6: Looooser #1 ($14.39 in chips) 
SantiagoWeight: posts small blind $0.10
miru877: posts big blind $0.25
*** HOLE CARDS ***
Dealt to SantiagoWeight [Tc 7d]
Rollout2018: folds 
winwinboy: folds 
Looooser #1: folds 
_BluDeeN_: folds 
SantiagoWeight: folds 
Uncalled bet ($0.15) returned to miru877
miru877 collected $0.20 from pot
miru877: doesn't show hand 
*** SUMMARY ***
Total pot $0.20 | Rake $0 
Seat 1: _BluDeeN_ (button) folded before Flop (didn't bet)
Seat 2: SantiagoWeight (small blind) folded before Flop
Seat 3: miru877 (big blind) collected ($0.20)
Seat 4: Rollout2018 folded before Flop (didn't bet)
Seat 5: winwinboy folded before Flop (didn't bet)
Seat 6: Looooser #1 folded before Flop (didn't bet)



PokerStars Zoom Hand #195023089212:  Hold'em No Limit ($0.10/$0.25) - 2018/12/29 3:22:42 UTC [2018/12/28 22:22:42 ET]
Table 'Hydra' 6-max Seat #1 is the button
Seat 1: SantiagoWeight ($23.46 in chips) 
Seat 2: mayadelrey ($57.23 in chips) 
Seat 3: mistdog ($47.45 in chips) 
Seat 4: seba6688 ($9.89 in chips) 
Seat 5: gift-cloud9 ($38.85 in chips) 
Seat 6: ckriszee ($40.73 in chips) 
mayadelrey: posts small blind $0.10
mistdog: posts big blind $0.25
*** HOLE CARDS ***
Dealt to SantiagoWeight [5s 8h]
seba6688: folds 
gift-cloud9: folds 
ckriszee: folds 
SantiagoWeight: folds 
mayadelrey: folds 
Uncalled bet ($0.15) returned to mistdog
mistdog collected $0.20 from pot
mistdog: doesn't show hand 
*** SUMMARY ***
Total pot $0.20 | Rake $0 
Seat 1: SantiagoWeight (button) folded before Flop (didn't bet)
Seat 2: mayadelrey (small blind) folded before Flop
Seat 3: mistdog (big blind) collected ($0.20)
Seat 4: seba6688 folded before Flop (didn't bet)
Seat 5: gift-cloud9 folded before Flop (didn't bet)
Seat 6: ckriszee folded before Flop (didn't bet)



PokerStars Zoom Hand #195023086464:  Hold'em No Limit ($0.10/$0.25) - 2018/12/29 3:22:34 UTC [2018/12/28 22:22:34 ET]
Table 'Hydra' 6-max Seat #1 is the button
Seat 1: nadal335 ($29.56 in chips) 
Seat 2: Rollout2018 ($21.70 in chips) 
Seat 3: osa126 ($27.89 in chips) 
Seat 4: SantiagoWeight ($23.56 in chips) 
Seat 5: ckriszee ($37.86 in chips) 
Seat 6: numbernine5 ($38.42 in chips) 
Rollout2018: posts small blind $0.10
osa126: posts big blind $0.25
*** HOLE CARDS ***
Dealt to SantiagoWeight [3d 7d]
SantiagoWeight: folds 
ckriszee: raises $0.35 to $0.60
numbernine5: raises $1.20 to $1.80
nadal335: folds 
Rollout2018: folds 
osa126: folds 
ckriszee: calls $1.20
*** FLOP *** [Js Qh Ks]
ckriszee: checks 
numbernine5: bets $2.07
ckriszee: folds 
Uncalled bet ($2.07) returned to numbernine5
numbernine5 collected $3.77 from pot
numbernine5: doesn't show hand 
*** SUMMARY ***
Total pot $3.95 | Rake $0.18 
Board [Js Qh Ks]
Seat 1: nadal335 (button) folded before Flop (didn't bet)
Seat 2: Rollout2018 (small blind) folded before Flop
Seat 3: osa126 (big blind) folded before Flop
Seat 4: SantiagoWeight folded before Flop (didn't bet)
Seat 5: ckriszee folded on the Flop
Seat 6: numbernine5 collected ($3.77)



PokerStars Zoom Hand #195023093590:  Hold'em No Limit ($0.10/$0.25) - 2018/12/29 3:22:55 UTC [2018/12/28 22:22:55 ET]
Table 'Hydra' 6-max Seat #1 is the button
Seat 1: MileVoliD49 ($73.76 in chips) 
Seat 2: SantiagoWeight ($25 in chips) 
Seat 3: MISTAAJ ($18.02 in chips) 
Seat 4: will82777 ($9.26 in chips) 
Seat 5: BnanaBread13 ($25 in chips) 
Seat 6: Josip1119 ($9.64 in chips) 
SantiagoWeight: posts small blind $0.10
MISTAAJ: posts big blind $0.25
*** HOLE CARDS ***
Dealt to SantiagoWeight [Kd Qh]
will82777: raises $0.37 to $0.62
BnanaBread13: folds 
Josip1119: raises $1.51 to $2.13
MileVoliD49: folds 
SantiagoWeight: folds 
MISTAAJ: folds 
will82777: folds 
Uncalled bet ($1.51) returned to Josip1119
Josip1119 collected $1.59 from pot
Josip1119: doesn't show hand 
*** SUMMARY ***
Total pot $1.59 | Rake $0 
Seat 1: MileVoliD49 (button) folded before Flop (didn't bet)
Seat 2: SantiagoWeight (small blind) folded before Flop
Seat 3: MISTAAJ (big blind) folded before Flop
Seat 4: will82777 folded before Flop
Seat 5: BnanaBread13 folded before Flop (didn't bet)
Seat 6: Josip1119 collected ($1.59)



PokerStars Zoom Hand #195023101741:  Hold'em No Limit ($0.10/$0.25) - 2018/12/29 3:23:19 UTC [2018/12/28 22:23:19 ET]
Table 'Hydra' 6-max Seat #1 is the button
Seat 1: ckriszee ($25 in chips) 
Seat 2: MarcoA12 ($61.10 in chips) 
Seat 3: SantiagoWeight ($24.90 in chips) 
Seat 4: Antwerken ($15.66 in chips) 
Seat 5: Baboscrubx ($31.64 in chips) 
Seat 6: nadal335 ($56.82 in chips) 
MarcoA12: posts small blind $0.10
SantiagoWeight: posts big blind $0.25
*** HOLE CARDS ***
Dealt to SantiagoWeight [Th Js]
Antwerken: raises $0.50 to $0.75
Baboscrubx: folds 
nadal335: folds 
ckriszee: folds 
MarcoA12: folds 
SantiagoWeight: folds 
Uncalled bet ($0.50) returned to Antwerken
Antwerken collected $0.60 from pot
*** SUMMARY ***
Total pot $0.60 | Rake $0 
Seat 1: ckriszee (button) folded before Flop (didn't bet)
Seat 2: MarcoA12 (small blind) folded before Flop
Seat 3: SantiagoWeight (big blind) folded before Flop
Seat 4: Antwerken collected ($0.60)
Seat 5: Baboscrubx folded before Flop (didn't bet)
Seat 6: nadal335 folded before Flop (didn't bet)



PokerStars Zoom Hand #195023090897:  Hold'em No Limit ($0.10/$0.25) - 2018/12/29 3:22:47 UTC [2018/12/28 22:22:47 ET]
Table 'Hydra' 6-max Seat #1 is the button
Seat 1: GrandmasterY ($32.05 in chips) 
Seat 2: Ovanes911 ($22.15 in chips) 
Seat 3: Looooser #1 ($14.39 in chips) 
Seat 4: Slim Wolfie ($25.35 in chips) 
Seat 5: SantiagoWeight ($23.46 in chips) 
Seat 6: anlu0803 ($18.80 in chips) 
Ovanes911: posts small blind $0.10
Looooser #1: posts big blind $0.25
*** HOLE CARDS ***
Dealt to SantiagoWeight [5h 8d]
Slim Wolfie: raises $0.37 to $0.62
SantiagoWeight: folds 
anlu0803: folds 
GrandmasterY: folds 
Ovanes911: calls $0.52
Looooser #1: calls $0.37
*** FLOP *** [Jc 2h Qd]
Ovanes911: checks 
Looooser #1: checks 
Slim Wolfie: bets $0.59
Ovanes911: calls $0.59
Looooser #1: folds 
*** TURN *** [Jc 2h Qd] [4d]
Ovanes911: checks 
Slim Wolfie: checks 
*** RIVER *** [Jc 2h Qd 4d] [2s]
Ovanes911: bets $1.45
Slim Wolfie: folds 
Uncalled bet ($1.45) returned to Ovanes911
Ovanes911 collected $2.90 from pot
Ovanes911: doesn't show hand 
*** SUMMARY ***
Total pot $3.04 | Rake $0.14 
Board [Jc 2h Qd 4d 2s]
Seat 1: GrandmasterY (button) folded before Flop (didn't bet)
Seat 2: Ovanes911 (small blind) collected ($2.90)
Seat 3: Looooser #1 (big blind) folded on the Flop
Seat 4: Slim Wolfie folded on the River
Seat 5: SantiagoWeight folded before Flop (didn't bet)
Seat 6: anlu0803 folded before Flop (didn't bet)



PokerStars Zoom Hand #195023111933:  Hold'em No Limit ($0.10/$0.25) - 2018/12/29 3:23:36 UTC [2018/12/28 22:23:36 ET]
Table 'Hydra' 6-max Seat #1 is the button
Seat 1: SantiagoWeight ($24.65 in chips) 
Seat 2: gift-cloud9 ($38.60 in chips) 
Seat 3: !P0K3RM3T4L! ($61.84 in chips) 
Seat 4: Rollout2018 ($22.49 in chips) 
Seat 5: TDAK1509 ($66.01 in chips) 
Seat 6: Xa4_88 ($76.64 in chips) 
gift-cloud9: posts small blind $0.10
!P0K3RM3T4L!: posts big blind $0.25
*** HOLE CARDS ***
Dealt to SantiagoWeight [Ah 8h]
Rollout2018: folds 
TDAK1509: folds 
Xa4_88: folds 
SantiagoWeight: raises $0.25 to $0.50
gift-cloud9: folds 
!P0K3RM3T4L!: calls $0.25
*** FLOP *** [6s Td 9d]
!P0K3RM3T4L!: checks 
SantiagoWeight: checks 
*** TURN *** [6s Td 9d] [7h]
!P0K3RM3T4L!: bets $0.61
SantiagoWeight: raises $1.49 to $2.10
!P0K3RM3T4L!: calls $1.49
*** RIVER *** [6s Td 9d 7h] [Qh]
!P0K3RM3T4L!: checks 
SantiagoWeight: bets $3.80
!P0K3RM3T4L!: calls $3.80
*** SHOW DOWN ***
SantiagoWeight: shows [Ah 8h] (a straight, Six to Ten)
!P0K3RM3T4L!: shows [6d 8d] (a straight, Six to Ten)
!P0K3RM3T4L! collected $6.16 from pot
SantiagoWeight collected $6.16 from pot
*** SUMMARY ***
Total pot $12.90 | Rake $0.58 
Board [6s Td 9d 7h Qh]
Seat 1: SantiagoWeight (button) showed [Ah 8h] and won ($6.16) with a straight, Six to Ten
Seat 2: gift-cloud9 (small blind) folded before Flop
Seat 3: !P0K3RM3T4L! (big blind) showed [6d 8d] and won ($6.16) with a straight, Six to Ten
Seat 4: Rollout2018 folded before Flop (didn't bet)
Seat 5: TDAK1509 folded before Flop (didn't bet)
Seat 6: Xa4_88 folded before Flop (didn't bet)



PokerStars Zoom Hand #195023146807:  Hold'em No Limit ($0.10/$0.25) - 2018/12/29 3:25:20 UTC [2018/12/28 22:25:20 ET]
Table 'Hydra' 6-max Seat #1 is the button
Seat 1: Bujan 07 ($20.29 in chips) 
Seat 2: Party4Arthy ($76.27 in chips) 
Seat 3: TQNYMQNTANA ($104.85 in chips) 
Seat 4: SantiagoWeight ($24.41 in chips) 
Seat 5: aldoalb0207 ($63.89 in chips) 
Seat 6: Jarre1977 ($20.49 in chips) 
Party4Arthy: posts small blind $0.10
TQNYMQNTANA: posts big blind $0.25
*** HOLE CARDS ***
Dealt to SantiagoWeight [7s Ah]
SantiagoWeight: folds 
aldoalb0207: calls $0.25
Jarre1977: raises $0.50 to $0.75
Bujan 07: folds 
Party4Arthy: folds 
TQNYMQNTANA: folds 
aldoalb0207: calls $0.50
*** FLOP *** [Qc 4c Ks]
aldoalb0207: checks 
Jarre1977: bets $1
aldoalb0207: folds 
Uncalled bet ($1) returned to Jarre1977
Jarre1977 collected $1.77 from pot
Jarre1977: doesn't show hand 
*** SUMMARY ***
Total pot $1.85 | Rake $0.08 
Board [Qc 4c Ks]
Seat 1: Bujan 07 (button) folded before Flop (didn't bet)
Seat 2: Party4Arthy (small blind) folded before Flop
Seat 3: TQNYMQNTANA (big blind) folded before Flop
Seat 4: SantiagoWeight folded before Flop (didn't bet)
Seat 5: aldoalb0207 folded on the Flop
Seat 6: Jarre1977 collected ($1.77)



PokerStars Zoom Hand #195023152064:  Hold'em No Limit ($0.10/$0.25) - 2018/12/29 3:25:36 UTC [2018/12/28 22:25:36 ET]
Table 'Hydra' 6-max Seat #1 is the button
Seat 1: Nutselas ($29.28 in chips) 
Seat 2: I M GOIN OFF ($30.58 in chips) 
Seat 3: qing328 ($24.75 in chips) 
Seat 4: SantiagoWeight ($24.41 in chips) 
Seat 5: Baboscrubx ($30.77 in chips) 
Seat 6: Renner32 ($26.57 in chips) 
I M GOIN OFF: posts small blind $0.10
qing328: posts big blind $0.25
*** HOLE CARDS ***
Dealt to SantiagoWeight [As 7d]
SantiagoWeight: folds 
Baboscrubx: folds 
Renner32: folds 
Nutselas: raises $0.50 to $0.75
I M GOIN OFF: folds 
qing328: folds 
Uncalled bet ($0.50) returned to Nutselas
Nutselas collected $0.60 from pot
Nutselas: doesn't show hand 
*** SUMMARY ***
Total pot $0.60 | Rake $0 
Seat 1: Nutselas (button) collected ($0.60)
Seat 2: I M GOIN OFF (small blind) folded before Flop
Seat 3: qing328 (big blind) folded before Flop
Seat 4: SantiagoWeight folded before Flop (didn't bet)
Seat 5: Baboscrubx folded before Flop (didn't bet)
Seat 6: Renner32 folded before Flop (didn't bet)



PokerStars Zoom Hand #195023156007:  Hold'em No Limit ($0.10/$0.25) - 2018/12/29 3:25:48 UTC [2018/12/28 22:25:48 ET]
Table 'Hydra' 6-max Seat #1 is the button
Seat 1: angipoker ($12.50 in chips) 
Seat 2: negreanuNya ($41.81 in chips) 
Seat 3: I M GOIN OFF ($30.48 in chips) 
Seat 4: davidhw888 ($22.81 in chips) 
Seat 5: SantiagoWeight ($24.41 in chips) 
Seat 6: Lehared ($66.89 in chips) 
negreanuNya: posts small blind $0.10
I M GOIN OFF: posts big blind $0.25
*** HOLE CARDS ***
Dealt to SantiagoWeight [Ts Jd]
davidhw888: folds 
SantiagoWeight: raises $0.37 to $0.62
Lehared: folds 
angipoker: folds 
negreanuNya: folds 
I M GOIN OFF: folds 
Uncalled bet ($0.37) returned to SantiagoWeight
SantiagoWeight collected $0.60 from pot
SantiagoWeight: doesn't show hand 
*** SUMMARY ***
Total pot $0.60 | Rake $0 
Seat 1: angipoker (button) folded before Flop (didn't bet)
Seat 2: negreanuNya (small blind) folded before Flop
Seat 3: I M GOIN OFF (big blind) folded before Flop
Seat 4: davidhw888 folded before Flop (didn't bet)
Seat 5: SantiagoWeight collected ($0.60)
Seat 6: Lehared folded before Flop (didn't bet)



PokerStars Zoom Hand #195023148163:  Hold'em No Limit ($0.10/$0.25) - 2018/12/29 3:25:24 UTC [2018/12/28 22:25:24 ET]
Table 'Hydra' 6-max Seat #1 is the button
Seat 1: Xp0Hb ($32.44 in chips) 
Seat 2: call me??107 ($12.60 in chips) 
Seat 3: ivann14 ($25.35 in chips) 
Seat 4: Chrimmpam ($20.68 in chips) 
Seat 5: TQNYMQNTANA ($28.31 in chips) 
Seat 6: SantiagoWeight ($24.41 in chips) 
call me??107: posts small blind $0.10
ivann14: posts big blind $0.25
*** HOLE CARDS ***
Dealt to SantiagoWeight [6s 2h]
Chrimmpam: folds 
TQNYMQNTANA: folds 
SantiagoWeight: folds 
Xp0Hb: raises $0.50 to $0.75
call me??107: folds 
ivann14: calls $0.50
*** FLOP *** [7d 4s 8h]
ivann14: checks 
Xp0Hb: bets $0.75
ivann14: calls $0.75
*** TURN *** [7d 4s 8h] [Tc]
ivann14: checks 
Xp0Hb: checks 
*** RIVER *** [7d 4s 8h Tc] [Ts]
ivann14: bets $2.13
Xp0Hb: folds 
Uncalled bet ($2.13) returned to ivann14
ivann14 collected $2.96 from pot
ivann14: doesn't show hand 
*** SUMMARY ***
Total pot $3.10 | Rake $0.14 
Board [7d 4s 8h Tc Ts]
Seat 1: Xp0Hb (button) folded on the River
Seat 2: call me??107 (small blind) folded before Flop
Seat 3: ivann14 (big blind) collected ($2.96)
Seat 4: Chrimmpam folded before Flop (didn't bet)
Seat 5: TQNYMQNTANA folded before Flop (didn't bet)
Seat 6: SantiagoWeight folded before Flop (didn't bet)



PokerStars Zoom Hand #195023161246:  Hold'em No Limit ($0.10/$0.25) - 2018/12/29 3:26:04 UTC [2018/12/28 22:26:04 ET]
Table 'Hydra' 6-max Seat #1 is the button
Seat 1: nhanminhtri ($25 in chips) 
Seat 2: SantiagoWeight ($24.76 in chips) 
Seat 3: MISTAAJ ($34.01 in chips) 
Seat 4: gift-cloud9 ($32.12 in chips) 
Seat 5: river plate9 ($22.49 in chips) 
Seat 6: Lehared ($107.62 in chips) 
SantiagoWeight: posts small blind $0.10
MISTAAJ: posts big blind $0.25
*** HOLE CARDS ***
Dealt to SantiagoWeight [Tc 4d]
gift-cloud9: folds 
river plate9: raises $0.25 to $0.50
Lehared: folds 
nhanminhtri: folds 
SantiagoWeight: folds 
MISTAAJ: calls $0.25
*** FLOP *** [Kc 8s 6h]
MISTAAJ: checks 
river plate9: bets $0.50
MISTAAJ: folds 
Uncalled bet ($0.50) returned to river plate9
river plate9 collected $1.05 from pot
river plate9: doesn't show hand 
*** SUMMARY ***
Total pot $1.10 | Rake $0.05 
Board [Kc 8s 6h]
Seat 1: nhanminhtri (button) folded before Flop (didn't bet)
Seat 2: SantiagoWeight (small blind) folded before Flop
Seat 3: MISTAAJ (big blind) folded on the Flop
Seat 4: gift-cloud9 folded before Flop (didn't bet)
Seat 5: river plate9 collected ($1.05)
Seat 6: Lehared folded before Flop (didn't bet)



PokerStars Zoom Hand #195023164210:  Hold'em No Limit ($0.10/$0.25) - 2018/12/29 3:26:13 UTC [2018/12/28 22:26:13 ET]
Table 'Hydra' 6-max Seat #1 is the button
Seat 1: SantiagoWeight ($24.66 in chips) 
Seat 2: Dr.Jekyll197 ($31.13 in chips) 
Seat 3: kyracarmen ($55.23 in chips) 
Seat 4: Looooser #1 ($18.25 in chips) 
Seat 5: nadal335 ($24 in chips) 
Seat 6: nhanminhtri ($27.81 in chips) 
Dr.Jekyll197: posts small blind $0.10
kyracarmen: posts big blind $0.25
*** HOLE CARDS ***
Dealt to SantiagoWeight [5h Jd]
Looooser #1: calls $0.25
nadal335: folds 
nhanminhtri: folds 
SantiagoWeight: folds 
Dr.Jekyll197: folds 
kyracarmen: checks 
*** FLOP *** [Ts 7c 6d]
kyracarmen: checks 
Looooser #1: bets $0.25
kyracarmen: folds 
Uncalled bet ($0.25) returned to Looooser #1
Looooser #1 collected $0.57 from pot
Looooser #1: doesn't show hand 
*** SUMMARY ***
Total pot $0.60 | Rake $0.03 
Board [Ts 7c 6d]
Seat 1: SantiagoWeight (button) folded before Flop (didn't bet)
Seat 2: Dr.Jekyll197 (small blind) folded before Flop
Seat 3: kyracarmen (big blind) folded on the Flop
Seat 4: Looooser #1 collected ($0.57)
Seat 5: nadal335 folded before Flop (didn't bet)
Seat 6: nhanminhtri folded before Flop (didn't bet)



PokerStars Zoom Hand #195023170784:  Hold'em No Limit ($0.10/$0.25) - 2018/12/29 3:26:33 UTC [2018/12/28 22:26:33 ET]
Table 'Hydra' 6-max Seat #1 is the button
Seat 1: zbuci ($30.82 in chips) 
Seat 2: Rollout2018 ($28.43 in chips) 
Seat 3: SantiagoWeight ($24.66 in chips) 
Seat 4: nhanminhtri ($25.10 in chips) 
Seat 5: !P0K3RM3T4L! ($61.95 in chips) 
Seat 6: davidhw888 ($22.93 in chips) 
Rollout2018: posts small blind $0.10
SantiagoWeight: posts big blind $0.25
*** HOLE CARDS ***
Dealt to SantiagoWeight [9c 3h]
nhanminhtri: raises $0.50 to $0.75
!P0K3RM3T4L!: folds 
davidhw888: folds 
zbuci: calls $0.75
Rollout2018: folds 
SantiagoWeight: folds 
*** FLOP *** [Ad 9h Kc]
nhanminhtri: bets $1.25
zbuci: folds 
Uncalled bet ($1.25) returned to nhanminhtri
nhanminhtri collected $1.77 from pot
nhanminhtri: doesn't show hand 
*** SUMMARY ***
Total pot $1.85 | Rake $0.08 
Board [Ad 9h Kc]
Seat 1: zbuci (button) folded on the Flop
Seat 2: Rollout2018 (small blind) folded before Flop
Seat 3: SantiagoWeight (big blind) folded before Flop
Seat 4: nhanminhtri collected ($1.77)
Seat 5: !P0K3RM3T4L! folded before Flop (didn't bet)
Seat 6: davidhw888 folded before Flop (didn't bet)



PokerStars Zoom Hand #195023174404:  Hold'em No Limit ($0.10/$0.25) - 2018/12/29 3:26:44 UTC [2018/12/28 22:26:44 ET]
Table 'Hydra' 6-max Seat #1 is the button
Seat 1: Nutselas ($29.38 in chips) 
Seat 2: davidhw888 ($21.96 in chips) 
Seat 3: nhanminhtri ($25 in chips) 
Seat 4: zdena102 ($15.38 in chips) 
Seat 5: gaffer31 ($21.24 in chips) 
Seat 6: SantiagoWeight ($24.41 in chips) 
davidhw888: posts small blind $0.10
nhanminhtri: posts big blind $0.25
*** HOLE CARDS ***
Dealt to SantiagoWeight [7h 2d]
zdena102: raises $0.25 to $0.50
gaffer31: folds 
SantiagoWeight: folds 
Nutselas: folds 
davidhw888: folds 
nhanminhtri: folds 
Uncalled bet ($0.25) returned to zdena102
zdena102 collected $0.60 from pot
zdena102: doesn't show hand 
*** SUMMARY ***
Total pot $0.60 | Rake $0 
Seat 1: Nutselas (button) folded before Flop (didn't bet)
Seat 2: davidhw888 (small blind) folded before Flop
Seat 3: nhanminhtri (big blind) folded before Flop
Seat 4: zdena102 collected ($0.60)
Seat 5: gaffer31 folded before Flop (didn't bet)
Seat 6: SantiagoWeight folded before Flop (didn't bet)



PokerStars Zoom Hand #195023181314:  Hold'em No Limit ($0.10/$0.25) - 2018/12/29 3:27:05 UTC [2018/12/28 22:27:05 ET]
Table 'Hydra' 6-max Seat #1 is the button
Seat 1: GrandmasterY ($25 in chips) 
Seat 2: SantiagoWeight ($24.41 in chips) 
Seat 3: TQNYMQNTANA ($28.63 in chips) 
Seat 4: nhanminhtri ($25 in chips) 
Seat 5: Paasinha ($26.12 in chips) 
Seat 6: zxlazy ($12.92 in chips) 
SantiagoWeight: posts small blind $0.10
TQNYMQNTANA: posts big blind $0.25
*** HOLE CARDS ***
Dealt to SantiagoWeight [Jc 8h]
nhanminhtri: folds 
Paasinha: folds 
zxlazy: folds 
GrandmasterY: raises $0.35 to $0.60
SantiagoWeight: folds 
TQNYMQNTANA: folds 
Uncalled bet ($0.35) returned to GrandmasterY
GrandmasterY collected $0.60 from pot
GrandmasterY: doesn't show hand 
*** SUMMARY ***
Total pot $0.60 | Rake $0 
Seat 1: GrandmasterY (button) collected ($0.60)
Seat 2: SantiagoWeight (small blind) folded before Flop
Seat 3: TQNYMQNTANA (big blind) folded before Flop
Seat 4: nhanminhtri folded before Flop (didn't bet)
Seat 5: Paasinha folded before Flop (didn't bet)
Seat 6: zxlazy folded before Flop (didn't bet)



PokerStars Zoom Hand #195023183590:  Hold'em No Limit ($0.10/$0.25) - 2018/12/29 3:27:12 UTC [2018/12/28 22:27:12 ET]
Table 'Hydra' 6-max Seat #1 is the button
Seat 1: SantiagoWeight ($24.31 in chips) 
Seat 2: ryanking99 ($48.96 in chips) 
Seat 3: reademenweep ($19.07 in chips) 
Seat 4: zhang1zhang ($34.46 in chips) 
Seat 5: Xp0Hb ($30.84 in chips) 
Seat 6: davidhw888 ($21.76 in chips) 
ryanking99: posts small blind $0.10
reademenweep: posts big blind $0.25
*** HOLE CARDS ***
Dealt to SantiagoWeight [Td 8s]
zhang1zhang: raises $0.50 to $0.75
Xp0Hb: folds 
davidhw888: folds 
SantiagoWeight: folds 
ryanking99: folds 
reademenweep: folds 
Uncalled bet ($0.50) returned to zhang1zhang
zhang1zhang collected $0.60 from pot
zhang1zhang: doesn't show hand 
*** SUMMARY ***
Total pot $0.60 | Rake $0 
Seat 1: SantiagoWeight (button) folded before Flop (didn't bet)
Seat 2: ryanking99 (small blind) folded before Flop
Seat 3: reademenweep (big blind) folded before Flop
Seat 4: zhang1zhang collected ($0.60)
Seat 5: Xp0Hb folded before Flop (didn't bet)
Seat 6: davidhw888 folded before Flop (didn't bet)



PokerStars Zoom Hand #195023179736:  Hold'em No Limit ($0.10/$0.25) - 2018/12/29 3:27:00 UTC [2018/12/28 22:27:00 ET]
Table 'Hydra' 6-max Seat #1 is the button
Seat 1: petanquemeis ($25.09 in chips) 
Seat 2: nhanminhtri ($25 in chips) 
Seat 3: river plate9 ($19.91 in chips) 
Seat 4: SantiagoWeight ($24.41 in chips) 
Seat 5: golf7287 ($26.23 in chips) 
Seat 6: negreanuNya ($41.71 in chips) 
nhanminhtri: posts small blind $0.10
river plate9: posts big blind $0.25
*** HOLE CARDS ***
Dealt to SantiagoWeight [2s Jd]
SantiagoWeight: folds 
golf7287: folds 
negreanuNya: folds 
petanquemeis: raises $0.60 to $0.85
nhanminhtri: folds 
river plate9: calls $0.60
*** FLOP *** [Tc 9d As]
river plate9: checks 
petanquemeis: bets $1.72
river plate9: folds 
Uncalled bet ($1.72) returned to petanquemeis
petanquemeis collected $1.72 from pot
petanquemeis: doesn't show hand 
*** SUMMARY ***
Total pot $1.80 | Rake $0.08 
Board [Tc 9d As]
Seat 1: petanquemeis (button) collected ($1.72)
Seat 2: nhanminhtri (small blind) folded before Flop
Seat 3: river plate9 (big blind) folded on the Flop
Seat 4: SantiagoWeight folded before Flop (didn't bet)
Seat 5: golf7287 folded before Flop (didn't bet)
Seat 6: negreanuNya folded before Flop (didn't bet)



PokerStars Zoom Hand #195023177094:  Hold'em No Limit ($0.10/$0.25) - 2018/12/29 3:26:52 UTC [2018/12/28 22:26:52 ET]
Table 'Hydra' 6-max Seat #1 is the button
Seat 1: gift-cloud9 ($31.41 in chips) 
Seat 2: Unclesmoll ($10.98 in chips) 
Seat 3: Sirfredulrik ($16.34 in chips) 
Seat 4: FSK78 ($50.44 in chips) 
Seat 5: SantiagoWeight ($24.41 in chips) 
Seat 6: KeySssi ($25.25 in chips) 
Unclesmoll: posts small blind $0.10
Sirfredulrik: posts big blind $0.25
*** HOLE CARDS ***
Dealt to SantiagoWeight [3h Th]
FSK78: raises $0.50 to $0.75
SantiagoWeight: folds 
KeySssi: folds 
gift-cloud9: folds 
Unclesmoll: folds 
Sirfredulrik: calls $0.50
*** FLOP *** [Js 2s Kh]
Sirfredulrik: checks 
FSK78: bets $1.22
Sirfredulrik: folds 
Uncalled bet ($1.22) returned to FSK78
FSK78 collected $1.53 from pot
FSK78: doesn't show hand 
*** SUMMARY ***
Total pot $1.60 | Rake $0.07 
Board [Js 2s Kh]
Seat 1: gift-cloud9 (button) folded before Flop (didn't bet)
Seat 2: Unclesmoll (small blind) folded before Flop
Seat 3: Sirfredulrik (big blind) folded on the Flop
Seat 4: FSK78 collected ($1.53)
Seat 5: SantiagoWeight folded before Flop (didn't bet)
Seat 6: KeySssi folded before Flop (didn't bet)



PokerStars Zoom Hand #195023186921:  Hold'em No Limit ($0.10/$0.25) - 2018/12/29 3:27:22 UTC [2018/12/28 22:27:22 ET]
Table 'Hydra' 6-max Seat #1 is the button
Seat 1: gift-cloud9 ($25 in chips) 
Seat 2: nadal335 ($24.10 in chips) 
Seat 3: SantiagoWeight ($24.31 in chips) 
Seat 4: davidhw888 ($23.15 in chips) 
Seat 5: Jack123985 ($25 in chips) 
Seat 6: ivann14 ($26.21 in chips) 
nadal335: posts small blind $0.10
SantiagoWeight: posts big blind $0.25
*** HOLE CARDS ***
Dealt to SantiagoWeight [4h 3s]
davidhw888: raises $0.25 to $0.50
Jack123985: folds 
ivann14: folds 
gift-cloud9: folds 
nadal335: folds 
SantiagoWeight: folds 
Uncalled bet ($0.25) returned to davidhw888
davidhw888 collected $0.60 from pot
*** SUMMARY ***
Total pot $0.60 | Rake $0 
Seat 1: gift-cloud9 (button) folded before Flop (didn't bet)
Seat 2: nadal335 (small blind) folded before Flop
Seat 3: SantiagoWeight (big blind) folded before Flop
Seat 4: davidhw888 collected ($0.60)
Seat 5: Jack123985 folded before Flop (didn't bet)
Seat 6: ivann14 folded before Flop (didn't bet)



PokerStars Zoom Hand #195023191930:  Hold'em No Limit ($0.10/$0.25) - 2018/12/29 3:27:37 UTC [2018/12/28 22:27:37 ET]
Table 'Hydra' 6-max Seat #1 is the button
Seat 1: negreanuNya ($25 in chips) 
Seat 2: angipoker ($12.50 in chips) 
Seat 3: davidhw888 ($30.03 in chips) 
Seat 4: call me??107 ($9.62 in chips) 
Seat 5: Viiiru ($33.37 in chips) 
Seat 6: SantiagoWeight ($24.06 in chips) 
angipoker: posts small blind $0.10
davidhw888: posts big blind $0.25
*** HOLE CARDS ***
Dealt to SantiagoWeight [8s Kh]
call me??107: folds 
Viiiru: folds 
SantiagoWeight: raises $0.30 to $0.55
negreanuNya: folds 
angipoker: folds 
davidhw888: folds 
Uncalled bet ($0.30) returned to SantiagoWeight
SantiagoWeight collected $0.60 from pot
SantiagoWeight: doesn't show hand 
*** SUMMARY ***
Total pot $0.60 | Rake $0 
Seat 1: negreanuNya (button) folded before Flop (didn't bet)
Seat 2: angipoker (small blind) folded before Flop
Seat 3: davidhw888 (big blind) folded before Flop
Seat 4: call me??107 folded before Flop (didn't bet)
Seat 5: Viiiru folded before Flop (didn't bet)
Seat 6: SantiagoWeight collected ($0.60)



PokerStars Zoom Hand #195023197465:  Hold'em No Limit ($0.10/$0.25) - 2018/12/29 3:27:54 UTC [2018/12/28 22:27:54 ET]
Table 'Hydra' 6-max Seat #1 is the button
Seat 1: Lehared ($107.17 in chips) 
Seat 2: moderi ($35.57 in chips) 
Seat 3: --LeGaaNs-- ($58.13 in chips) 
Seat 4: zdena102 ($16.61 in chips) 
Seat 5: SantiagoWeight ($24.41 in chips) 
Seat 6: franco373513 ($12.34 in chips) 
moderi: posts small blind $0.10
--LeGaaNs--: posts big blind $0.25
*** HOLE CARDS ***
Dealt to SantiagoWeight [6s 4c]
zdena102: folds 
SantiagoWeight: folds 
franco373513: folds 
Lehared: folds 
moderi: calls $0.15
--LeGaaNs--: checks 
*** FLOP *** [8c Js As]
moderi: bets $0.50
--LeGaaNs--: folds 
Uncalled bet ($0.50) returned to moderi
moderi collected $0.48 from pot
moderi: doesn't show hand 
*** SUMMARY ***
Total pot $0.50 | Rake $0.02 
Board [8c Js As]
Seat 1: Lehared (button) folded before Flop (didn't bet)
Seat 2: moderi (small blind) collected ($0.48)
Seat 3: --LeGaaNs-- (big blind) folded on the Flop
Seat 4: zdena102 folded before Flop (didn't bet)
Seat 5: SantiagoWeight folded before Flop (didn't bet)
Seat 6: franco373513 folded before Flop (didn't bet)



PokerStars Zoom Hand #195023199819:  Hold'em No Limit ($0.10/$0.25) - 2018/12/29 3:28:01 UTC [2018/12/28 22:28:01 ET]
Table 'Hydra' 6-max Seat #1 is the button
Seat 1: nhanminhtri ($25 in chips) 
Seat 2: osa126 ($30.56 in chips) 
Seat 3: Ushite209 ($25 in chips) 
Seat 4: SantiagoWeight ($24.41 in chips) 
Seat 5: !P0K3RM3T4L! ($26.03 in chips) 
Seat 6: Chrimmpam ($20.09 in chips) 
osa126: posts small blind $0.10
Ushite209: posts big blind $0.25
*** HOLE CARDS ***
Dealt to SantiagoWeight [Th 7d]
SantiagoWeight: folds 
!P0K3RM3T4L!: folds 
Chrimmpam: folds 
nhanminhtri: raises $0.37 to $0.62
osa126: folds 
Ushite209: folds 
Uncalled bet ($0.37) returned to nhanminhtri
nhanminhtri collected $0.60 from pot
nhanminhtri: doesn't show hand 
*** SUMMARY ***
Total pot $0.60 | Rake $0 
Seat 1: nhanminhtri (button) collected ($0.60)
Seat 2: osa126 (small blind) folded before Flop
Seat 3: Ushite209 (big blind) folded before Flop
Seat 4: SantiagoWeight folded before Flop (didn't bet)
Seat 5: !P0K3RM3T4L! folded before Flop (didn't bet)
Seat 6: Chrimmpam folded before Flop (didn't bet)



PokerStars Zoom Hand #195023201145:  Hold'em No Limit ($0.10/$0.25) - 2018/12/29 3:28:05 UTC [2018/12/28 22:28:05 ET]
Table 'Hydra' 6-max Seat #1 is the button
Seat 1: !P0K3RM3T4L! ($26.03 in chips) 
Seat 2: nhanminhtri ($26.53 in chips) 
Seat 3: ^J0K3RST@RS! ($25 in chips) 
Seat 4: tafuioo ($24.82 in chips) 
Seat 5: SantiagoWeight ($24.41 in chips) 
Seat 6: Baboscrubx ($31.11 in chips) 
nhanminhtri: posts small blind $0.10
^J0K3RST@RS!: posts big blind $0.25
*** HOLE CARDS ***
Dealt to SantiagoWeight [Jh 5s]
tafuioo: folds 
SantiagoWeight: folds 
Baboscrubx: folds 
!P0K3RM3T4L!: folds 
nhanminhtri: folds 
Uncalled bet ($0.15) returned to ^J0K3RST@RS!
^J0K3RST@RS! collected $0.20 from pot
^J0K3RST@RS!: doesn't show hand 
*** SUMMARY ***
Total pot $0.20 | Rake $0 
Seat 1: !P0K3RM3T4L! (button) folded before Flop (didn't bet)
Seat 2: nhanminhtri (small blind) folded before Flop
Seat 3: ^J0K3RST@RS! (big blind) collected ($0.20)
Seat 4: tafuioo folded before Flop (didn't bet)
Seat 5: SantiagoWeight folded before Flop (didn't bet)
Seat 6: Baboscrubx folded before Flop (didn't bet)



PokerStars Zoom Hand #195023204476:  Hold'em No Limit ($0.10/$0.25) - 2018/12/29 3:28:15 UTC [2018/12/28 22:28:15 ET]
Table 'Hydra' 6-max Seat #1 is the button
Seat 1: qing328 ($36.71 in chips) 
Seat 2: SantiagoWeight ($24.41 in chips) 
Seat 3: call me??107 ($10.37 in chips) 
Seat 4: Chrimmpam ($23.70 in chips) 
Seat 5: osa126 ($30.46 in chips) 
Seat 6: christulio ($16.24 in chips) 
SantiagoWeight: posts small blind $0.10
call me??107: posts big blind $0.25
*** HOLE CARDS ***
Dealt to SantiagoWeight [Ac Qs]
Chrimmpam: folds 
osa126: folds 
christulio: folds 
qing328: folds 
SantiagoWeight: raises $0.50 to $0.75
call me??107: raises $1.50 to $2.25
SantiagoWeight: raises $20.85 to $23.10
call me??107: calls $8.12 and is all-in
Uncalled bet ($12.73) returned to SantiagoWeight
*** FLOP *** [8s Td 5c]
*** TURN *** [8s Td 5c] [2h]
*** RIVER *** [8s Td 5c 2h] [3h]
*** SHOW DOWN ***
SantiagoWeight: shows [Ac Qs] (high card Ace)
call me??107: shows [Ad 5s] (a pair of Fives)
call me??107 collected $19.81 from pot
*** SUMMARY ***
Total pot $20.74 | Rake $0.93 
Board [8s Td 5c 2h 3h]
Seat 1: qing328 (button) folded before Flop (didn't bet)
Seat 2: SantiagoWeight (small blind) showed [Ac Qs] and lost with high card Ace
Seat 3: call me??107 (big blind) showed [Ad 5s] and won ($19.81) with a pair of Fives
Seat 4: Chrimmpam folded before Flop (didn't bet)
Seat 5: osa126 folded before Flop (didn't bet)
Seat 6: christulio folded before Flop (didn't bet)



PokerStars Zoom Hand #195023220191:  Hold'em No Limit ($0.10/$0.25) - 2018/12/29 3:29:02 UTC [2018/12/28 22:29:02 ET]
Table 'Hydra' 6-max Seat #1 is the button
Seat 1: SantiagoWeight ($23.79 in chips) 
Seat 2: ttshead ($66.41 in chips) 
Seat 3: Unclesmoll ($15.25 in chips) 
Seat 4: davidhw888 ($33.29 in chips) 
Seat 5: gingdog ($19.98 in chips) 
Seat 6: reggiedogg31 ($108.29 in chips) 
ttshead: posts small blind $0.10
Unclesmoll: posts big blind $0.25
*** HOLE CARDS ***
Dealt to SantiagoWeight [2s 9h]
davidhw888: folds 
gingdog: raises $0.25 to $0.50
reggiedogg31: folds 
SantiagoWeight: folds 
ttshead: folds 
Unclesmoll: folds 
Uncalled bet ($0.25) returned to gingdog
gingdog collected $0.60 from pot
gingdog: doesn't show hand 
*** SUMMARY ***
Total pot $0.60 | Rake $0 
Seat 1: SantiagoWeight (button) folded before Flop (didn't bet)
Seat 2: ttshead (small blind) folded before Flop
Seat 3: Unclesmoll (big blind) folded before Flop
Seat 4: davidhw888 folded before Flop (didn't bet)
Seat 5: gingdog collected ($0.60)
Seat 6: reggiedogg31 folded before Flop (didn't bet)



PokerStars Zoom Hand #195023216185:  Hold'em No Limit ($0.10/$0.25) - 2018/12/29 3:28:50 UTC [2018/12/28 22:28:50 ET]
Table 'Hydra' 6-max Seat #1 is the button
Seat 1: christulio ($16.24 in chips) 
Seat 2: reggiedogg31 ($108.39 in chips) 
Seat 3: SantiagoWeight ($14.04 in chips) 
Seat 4: HonourMan23 ($34.01 in chips) 
Seat 5: Dr.Jekyll197 ($38.53 in chips) 
Seat 6: golf7287 ($33.74 in chips) 
reggiedogg31: posts small blind $0.10
SantiagoWeight: posts big blind $0.25
*** HOLE CARDS ***
Dealt to SantiagoWeight [Jd 7c]
HonourMan23: raises $0.30 to $0.55
Dr.Jekyll197: folds 
golf7287: folds 
christulio: calls $0.55
reggiedogg31: folds 
SantiagoWeight: folds 
*** FLOP *** [5c 2c Qc]
HonourMan23: bets $0.76
christulio: calls $0.76
*** TURN *** [5c 2c Qc] [8c]
HonourMan23: checks 
christulio: checks 
*** RIVER *** [5c 2c Qc 8c] [5d]
HonourMan23: checks 
christulio: checks 
*** SHOW DOWN ***
HonourMan23: shows [Js Ac] (a flush, Ace high)
christulio: mucks hand 
HonourMan23 collected $2.84 from pot
*** SUMMARY ***
Total pot $2.97 | Rake $0.13 
Board [5c 2c Qc 8c 5d]
Seat 1: christulio (button) mucked [4s As]
Seat 2: reggiedogg31 (small blind) folded before Flop
Seat 3: SantiagoWeight (big blind) folded before Flop
Seat 4: HonourMan23 showed [Js Ac] and won ($2.84) with a flush, Ace high
Seat 5: Dr.Jekyll197 folded before Flop (didn't bet)
Seat 6: golf7287 folded before Flop (didn't bet)



PokerStars Zoom Hand #195023222793:  Hold'em No Limit ($0.10/$0.25) - 2018/12/29 3:29:10 UTC [2018/12/28 22:29:10 ET]
Table 'Hydra' 6-max Seat #1 is the button
Seat 1: GrandmasterY ($41.26 in chips) 
Seat 2: Viiiru ($34.26 in chips) 
Seat 3: !P0K3RM3T4L! ($25.53 in chips) 
Seat 4: river plate9 ($71.25 in chips) 
Seat 5: zdenekstavic ($33.66 in chips) 
Seat 6: SantiagoWeight ($23.79 in chips) 
Viiiru: posts small blind $0.10
!P0K3RM3T4L!: posts big blind $0.25
*** HOLE CARDS ***
Dealt to SantiagoWeight [3s As]
river plate9: folds 
zdenekstavic: folds 
SantiagoWeight: raises $0.30 to $0.55
GrandmasterY: folds 
Viiiru: folds 
!P0K3RM3T4L!: folds 
Uncalled bet ($0.30) returned to SantiagoWeight
SantiagoWeight collected $0.60 from pot
SantiagoWeight: doesn't show hand 
*** SUMMARY ***
Total pot $0.60 | Rake $0 
Seat 1: GrandmasterY (button) folded before Flop (didn't bet)
Seat 2: Viiiru (small blind) folded before Flop
Seat 3: !P0K3RM3T4L! (big blind) folded before Flop
Seat 4: river plate9 folded before Flop (didn't bet)
Seat 5: zdenekstavic folded before Flop (didn't bet)
Seat 6: SantiagoWeight collected ($0.60)



PokerStars Zoom Hand #195023233156:  Hold'em No Limit ($0.10/$0.25) - 2018/12/29 3:29:41 UTC [2018/12/28 22:29:41 ET]
Table 'Hydra' 6-max Seat #1 is the button
Seat 1: SirSatan001 ($24.15 in chips) 
Seat 2: nhanminhtri ($27.34 in chips) 
Seat 3: SantiagoWeight ($24.14 in chips) 
Seat 4: Viiiru ($34.26 in chips) 
Seat 5: Lehared ($69.35 in chips) 
Seat 6: Jack123985 ($26.87 in chips) 
nhanminhtri: posts small blind $0.10
SantiagoWeight: posts big blind $0.25
*** HOLE CARDS ***
Dealt to SantiagoWeight [5s 3c]
Viiiru: folds 
Lehared: folds 
Jack123985: folds 
SirSatan001: folds 
nhanminhtri: folds 
Uncalled bet ($0.15) returned to SantiagoWeight
SantiagoWeight collected $0.20 from pot
SantiagoWeight: doesn't show hand 
*** SUMMARY ***
Total pot $0.20 | Rake $0 
Seat 1: SirSatan001 (button) folded before Flop (didn't bet)
Seat 2: nhanminhtri (small blind) folded before Flop
Seat 3: SantiagoWeight (big blind) collected ($0.20)
Seat 4: Viiiru folded before Flop (didn't bet)
Seat 5: Lehared folded before Flop (didn't bet)
Seat 6: Jack123985 folded before Flop (didn't bet)



PokerStars Zoom Hand #195023231774:  Hold'em No Limit ($0.10/$0.25) - 2018/12/29 3:29:37 UTC [2018/12/28 22:29:37 ET]
Table 'Hydra' 6-max Seat #1 is the button
Seat 1: winwinboy ($25.36 in chips) 
Seat 2: TDAK1509 ($47.83 in chips) 
Seat 3: yobbos ($25 in chips) 
Seat 4: SantiagoWeight ($24.14 in chips) 
Seat 5: pfunkolstar ($25 in chips) 
Seat 6: negreanuNya ($25.99 in chips) 
TDAK1509: posts small blind $0.10
yobbos: posts big blind $0.25
*** HOLE CARDS ***
Dealt to SantiagoWeight [2c Jh]
SantiagoWeight: folds 
pfunkolstar: folds 
negreanuNya: raises $0.35 to $0.60
winwinboy: calls $0.60
TDAK1509: folds 
yobbos: calls $0.35
*** FLOP *** [2s 6h 7d]
yobbos: checks 
negreanuNya: bets $1
winwinboy: folds 
yobbos: folds 
Uncalled bet ($1) returned to negreanuNya
negreanuNya collected $1.81 from pot
negreanuNya: doesn't show hand 
*** SUMMARY ***
Total pot $1.90 | Rake $0.09 
Board [2s 6h 7d]
Seat 1: winwinboy (button) folded on the Flop
Seat 2: TDAK1509 (small blind) folded before Flop
Seat 3: yobbos (big blind) folded on the Flop
Seat 4: SantiagoWeight folded before Flop (didn't bet)
Seat 5: pfunkolstar folded before Flop (didn't bet)
Seat 6: negreanuNya collected ($1.81)



PokerStars Zoom Hand #195023247182:  Hold'em No Limit ($0.10/$0.25) - 2018/12/29 3:30:23 UTC [2018/12/28 22:30:23 ET]
Table 'Hydra' 6-max Seat #1 is the button
Seat 1: angipoker ($12.50 in chips) 
Seat 2: SantiagoWeight ($24.24 in chips) 
Seat 3: allin969 ($25 in chips) 
Seat 4: river plate9 ($24.65 in chips) 
Seat 5: IceAgeDream7 ($27.28 in chips) 
Seat 6: _BluDeeN_ ($25 in chips) 
SantiagoWeight: posts small blind $0.10
allin969: posts big blind $0.25
*** HOLE CARDS ***
Dealt to SantiagoWeight [Qs 4s]
river plate9: folds 
IceAgeDream7: folds 
_BluDeeN_: folds 
angipoker: folds 
SantiagoWeight: folds 
Uncalled bet ($0.15) returned to allin969
allin969 collected $0.20 from pot
*** SUMMARY ***
Total pot $0.20 | Rake $0 
Seat 1: angipoker (button) folded before Flop (didn't bet)
Seat 2: SantiagoWeight (small blind) folded before Flop
Seat 3: allin969 (big blind) collected ($0.20)
Seat 4: river plate9 folded before Flop (didn't bet)
Seat 5: IceAgeDream7 folded before Flop (didn't bet)
Seat 6: _BluDeeN_ folded before Flop (didn't bet)



PokerStars Zoom Hand #195023251559:  Hold'em No Limit ($0.10/$0.25) - 2018/12/29 3:30:36 UTC [2018/12/28 22:30:36 ET]
Table 'Hydra' 6-max Seat #1 is the button
Seat 1: Josip1119 ($26.09 in chips) 
Seat 2: davidhw888 ($26.61 in chips) 
Seat 3: zxlazy ($14.42 in chips) 
Seat 4: _BluDeeN_ ($25 in chips) 
Seat 5: Lehared ($37.45 in chips) 
Seat 6: SantiagoWeight ($24.14 in chips) 
davidhw888: posts small blind $0.10
zxlazy: posts big blind $0.25
*** HOLE CARDS ***
Dealt to SantiagoWeight [5h 9d]
_BluDeeN_: folds 
Lehared: folds 
SantiagoWeight: folds 
Josip1119: folds 
davidhw888: folds 
Uncalled bet ($0.15) returned to zxlazy
zxlazy collected $0.20 from pot
zxlazy: doesn't show hand 
*** SUMMARY ***
Total pot $0.20 | Rake $0 
Seat 1: Josip1119 (button) folded before Flop (didn't bet)
Seat 2: davidhw888 (small blind) folded before Flop
Seat 3: zxlazy (big blind) collected ($0.20)
Seat 4: _BluDeeN_ folded before Flop (didn't bet)
Seat 5: Lehared folded before Flop (didn't bet)
Seat 6: SantiagoWeight folded before Flop (didn't bet)



PokerStars Zoom Hand #195023242114:  Hold'em No Limit ($0.10/$0.25) - 2018/12/29 3:30:08 UTC [2018/12/28 22:30:08 ET]
Table 'Hydra' 6-max Seat #1 is the button
Seat 1: Baboscrubx ($27.89 in chips) 
Seat 2: cankum ($25 in chips) 
Seat 3: zzzMASTERzzz ($25 in chips) 
Seat 4: Gf Chipz ($30.59 in chips) 
Seat 5: SantiagoWeight ($24.24 in chips) 
Seat 6: moderi ($43.41 in chips) 
cankum: posts small blind $0.10
zzzMASTERzzz: posts big blind $0.25
*** HOLE CARDS ***
Dealt to SantiagoWeight [7c 5h]
Gf Chipz: raises $0.75 to $1
SantiagoWeight: folds 
moderi: calls $1
Baboscrubx: folds 
cankum: calls $0.90
zzzMASTERzzz: calls $0.75
*** FLOP *** [Td Jd 2d]
cankum: checks 
zzzMASTERzzz: checks 
Gf Chipz: bets $1
moderi: calls $1
cankum: folds 
zzzMASTERzzz: folds 
*** TURN *** [Td Jd 2d] [3d]
Gf Chipz: bets $1.25
moderi: calls $1.25
*** RIVER *** [Td Jd 2d 3d] [3c]
Gf Chipz: bets $5.75
moderi: calls $5.75
*** SHOW DOWN ***
Gf Chipz: shows [Ts Qd] (a flush, Queen high)
moderi: mucks hand 
Gf Chipz collected $19.10 from pot
*** SUMMARY ***
Total pot $20 | Rake $0.90 
Board [Td Jd 2d 3d 3c]
Seat 1: Baboscrubx (button) folded before Flop (didn't bet)
Seat 2: cankum (small blind) folded on the Flop
Seat 3: zzzMASTERzzz (big blind) folded on the Flop
Seat 4: Gf Chipz showed [Ts Qd] and won ($19.10) with a flush, Queen high
Seat 5: SantiagoWeight folded before Flop (didn't bet)
Seat 6: moderi mucked [Ac 4d]



PokerStars Zoom Hand #195023254523:  Hold'em No Limit ($0.10/$0.25) - 2018/12/29 3:30:45 UTC [2018/12/28 22:30:45 ET]
Table 'Hydra' 6-max Seat #1 is the button
Seat 1: osa126 ($28.18 in chips) 
Seat 2: SantiagoWeight ($24.14 in chips) 
Seat 3: Lehared ($37.45 in chips) 
Seat 4: Ovanes911 ($23.46 in chips) 
Seat 5: cankum ($36.71 in chips) 
Seat 6: yobbos ($136.91 in chips) 
SantiagoWeight: posts small blind $0.10
Lehared: posts big blind $0.25
*** HOLE CARDS ***
Dealt to SantiagoWeight [3d 6h]
Ovanes911: folds 
cankum: folds 
yobbos: raises $0.37 to $0.62
osa126: folds 
SantiagoWeight: folds 
Lehared: folds 
Uncalled bet ($0.37) returned to yobbos
yobbos collected $0.60 from pot
yobbos: doesn't show hand 
*** SUMMARY ***
Total pot $0.60 | Rake $0 
Seat 1: osa126 (button) folded before Flop (didn't bet)
Seat 2: SantiagoWeight (small blind) folded before Flop
Seat 3: Lehared (big blind) folded before Flop
Seat 4: Ovanes911 folded before Flop (didn't bet)
Seat 5: cankum folded before Flop (didn't bet)
Seat 6: yobbos collected ($0.60)



PokerStars Zoom Hand #195023258559:  Hold'em No Limit ($0.10/$0.25) - 2018/12/29 3:30:57 UTC [2018/12/28 22:30:57 ET]
Table 'Hydra' 6-max Seat #1 is the button
Seat 1: Ovanes911 ($23.46 in chips) 
Seat 2: river plate9 ($23.15 in chips) 
Seat 3: BnanaBread13 ($25 in chips) 
Seat 4: Viiiru ($33.91 in chips) 
Seat 5: SantiagoWeight ($24.04 in chips) 
Seat 6: zbuci ($31.74 in chips) 
river plate9: posts small blind $0.10
BnanaBread13: posts big blind $0.25
*** HOLE CARDS ***
Dealt to SantiagoWeight [2s Qc]
Viiiru: folds 
SantiagoWeight: folds 
zbuci: raises $0.50 to $0.75
Ovanes911: folds 
river plate9: folds 
BnanaBread13: folds 
Uncalled bet ($0.50) returned to zbuci
zbuci collected $0.60 from pot
zbuci: doesn't show hand 
*** SUMMARY ***
Total pot $0.60 | Rake $0 
Seat 1: Ovanes911 (button) folded before Flop (didn't bet)
Seat 2: river plate9 (small blind) folded before Flop
Seat 3: BnanaBread13 (big blind) folded before Flop
Seat 4: Viiiru folded before Flop (didn't bet)
Seat 5: SantiagoWeight folded before Flop (didn't bet)
Seat 6: zbuci collected ($0.60)



PokerStars Zoom Hand #195023240834:  Hold'em No Limit ($0.10/$0.25) - 2018/12/29 3:30:04 UTC [2018/12/28 22:30:04 ET]
Table 'Hydra' 6-max Seat #1 is the button
Seat 1: SantiagoWeight ($24.24 in chips) 
Seat 2: ColinCaine ($32.18 in chips) 
Seat 3: nadal335 ($75.70 in chips) 
Seat 4: mayadelrey ($59.81 in chips) 
Seat 5: nhanminhtri ($25 in chips) 
Seat 6: ryanking99 ($52.63 in chips) 
ColinCaine: posts small blind $0.10
nadal335: posts big blind $0.25
*** HOLE CARDS ***
Dealt to SantiagoWeight [4d Th]
mayadelrey: raises $0.25 to $0.50
nhanminhtri: folds 
ryanking99: raises $0.62 to $1.12
SantiagoWeight: folds 
ColinCaine: calls $1.02
nadal335: folds 
mayadelrey: calls $0.62
*** FLOP *** [9c Qc 7d]
ColinCaine: checks 
mayadelrey: checks 
ryanking99: bets $1.14
ColinCaine: calls $1.14
mayadelrey: raises $3.89 to $5.03
ryanking99: folds 
ColinCaine: calls $3.89
*** TURN *** [9c Qc 7d] [4c]
ColinCaine: checks 
mayadelrey: bets $7.25
ColinCaine: folds 
Uncalled bet ($7.25) returned to mayadelrey
mayadelrey collected $14.14 from pot
mayadelrey: doesn't show hand 
*** SUMMARY ***
Total pot $14.81 | Rake $0.67 
Board [9c Qc 7d 4c]
Seat 1: SantiagoWeight (button) folded before Flop (didn't bet)
Seat 2: ColinCaine (small blind) folded on the Turn
Seat 3: nadal335 (big blind) folded before Flop
Seat 4: mayadelrey collected ($14.14)
Seat 5: nhanminhtri folded before Flop (didn't bet)
Seat 6: ryanking99 folded on the Flop



PokerStars Zoom Hand #195023262119:  Hold'em No Limit ($0.10/$0.25) - 2018/12/29 3:31:08 UTC [2018/12/28 22:31:08 ET]
Table 'Hydra' 6-max Seat #1 is the button
Seat 1: SantiagoWeight ($24.04 in chips) 
Seat 2: franco373513 ($25.29 in chips) 
Seat 3: sigaro010 ($58.57 in chips) 
Seat 4: mariopork ($39.67 in chips) 
Seat 5: davidhw888 ($33.61 in chips) 
Seat 6: GrandmasterY ($25 in chips) 
franco373513: posts small blind $0.10
sigaro010: posts big blind $0.25
*** HOLE CARDS ***
Dealt to SantiagoWeight [7h Td]
mariopork: raises $0.50 to $0.75
davidhw888: folds 
GrandmasterY: folds 
SantiagoWeight: folds 
franco373513: calls $0.65
sigaro010: calls $0.50
*** FLOP *** [4c 2c 8s]
franco373513: checks 
sigaro010: checks 
mariopork: checks 
*** TURN *** [4c 2c 8s] [9h]
franco373513: checks 
sigaro010: checks 
mariopork: checks 
*** RIVER *** [4c 2c 8s 9h] [2h]
franco373513: checks 
sigaro010: checks 
mariopork: bets $2.30
franco373513: folds 
sigaro010: calls $2.30
*** SHOW DOWN ***
mariopork: shows [Ad 2d] (three of a kind, Deuces)
sigaro010: mucks hand 
mariopork collected $6.54 from pot
*** SUMMARY ***
Total pot $6.85 | Rake $0.31 
Board [4c 2c 8s 9h 2h]
Seat 1: SantiagoWeight (button) folded before Flop (didn't bet)
Seat 2: franco373513 (small blind) folded on the River
Seat 3: sigaro010 (big blind) mucked [7d 7s]
Seat 4: mariopork showed [Ad 2d] and won ($6.54) with three of a kind, Deuces
Seat 5: davidhw888 folded before Flop (didn't bet)
Seat 6: GrandmasterY folded before Flop (didn't bet)



PokerStars Zoom Hand #195023270546:  Hold'em No Limit ($0.10/$0.25) - 2018/12/29 3:31:33 UTC [2018/12/28 22:31:33 ET]
Table 'Hydra' 6-max Seat #1 is the button
Seat 1: HansMSM ($63.65 in chips) 
Seat 2: ckriszee ($26.94 in chips) 
Seat 3: KeySssi ($25.66 in chips) 
Seat 4: angipoker ($12.60 in chips) 
Seat 5: Gf Chipz ($41.37 in chips) 
Seat 6: SantiagoWeight ($23.79 in chips) 
ckriszee: posts small blind $0.10
KeySssi: posts big blind $0.25
*** HOLE CARDS ***
Dealt to SantiagoWeight [Js 8d]
angipoker: raises $0.37 to $0.62
Gf Chipz: folds 
SantiagoWeight: folds 
HansMSM: folds 
ckriszee: folds 
KeySssi: folds 
Uncalled bet ($0.37) returned to angipoker
angipoker collected $0.60 from pot
angipoker: doesn't show hand 
*** SUMMARY ***
Total pot $0.60 | Rake $0 
Seat 1: HansMSM (button) folded before Flop (didn't bet)
Seat 2: ckriszee (small blind) folded before Flop
Seat 3: KeySssi (big blind) folded before Flop
Seat 4: angipoker collected ($0.60)
Seat 5: Gf Chipz folded before Flop (didn't bet)
Seat 6: SantiagoWeight folded before Flop (didn't bet)



PokerStars Zoom Hand #195023266189:  Hold'em No Limit ($0.10/$0.25) - 2018/12/29 3:31:20 UTC [2018/12/28 22:31:20 ET]
Table 'Hydra' 6-max Seat #1 is the button
Seat 1: mariopork ($26.32 in chips) 
Seat 2: davidhw888 ($26.96 in chips) 
Seat 3: SantiagoWeight ($24.04 in chips) 
Seat 4: MileVoliD49 ($70.58 in chips) 
Seat 5: zdena102 ($15.96 in chips) 
Seat 6: pfunkolstar ($31.51 in chips) 
davidhw888: posts small blind $0.10
SantiagoWeight: posts big blind $0.25
*** HOLE CARDS ***
Dealt to SantiagoWeight [Jd 4h]
MileVoliD49: folds 
zdena102: folds 
pfunkolstar: raises $0.37 to $0.62
mariopork: folds 
davidhw888: raises $1.49 to $2.11
SantiagoWeight: folds 
pfunkolstar: calls $1.49
*** FLOP *** [2c Qc Js]
davidhw888: bets $2.14
pfunkolstar: calls $2.14
*** TURN *** [2c Qc Js] [As]
davidhw888: bets $22.71 and is all-in
pfunkolstar: folds 
Uncalled bet ($22.71) returned to davidhw888
davidhw888 collected $8.36 from pot
davidhw888: doesn't show hand 
*** SUMMARY ***
Total pot $8.75 | Rake $0.39 
Board [2c Qc Js As]
Seat 1: mariopork (button) folded before Flop (didn't bet)
Seat 2: davidhw888 (small blind) collected ($8.36)
Seat 3: SantiagoWeight (big blind) folded before Flop
Seat 4: MileVoliD49 folded before Flop (didn't bet)
Seat 5: zdena102 folded before Flop (didn't bet)
Seat 6: pfunkolstar folded on the Turn



PokerStars Zoom Hand #195023274867:  Hold'em No Limit ($0.10/$0.25) - 2018/12/29 3:31:46 UTC [2018/12/28 22:31:46 ET]
Table 'Hydra' 6-max Seat #1 is the button
Seat 1: miru877 ($25.01 in chips) 
Seat 2: golf7287 ($41.40 in chips) 
Seat 3: mariopork ($29.29 in chips) 
Seat 4: SantiagoWeight ($23.79 in chips) 
Seat 5: CAPTAINSKA ($21.62 in chips) 
Seat 6: Rollout2018 ($21.78 in chips) 
golf7287: posts small blind $0.10
mariopork: posts big blind $0.25
*** HOLE CARDS ***
Dealt to SantiagoWeight [Ah Th]
SantiagoWeight: raises $0.42 to $0.67
CAPTAINSKA: folds 
Rollout2018: folds 
miru877: folds 
golf7287: raises $1.08 to $1.75
mariopork: folds 
SantiagoWeight: calls $1.08
*** FLOP *** [2d Qd 4s]
golf7287: bets $1.75
SantiagoWeight: folds 
Uncalled bet ($1.75) returned to golf7287
golf7287 collected $3.58 from pot
golf7287: doesn't show hand 
*** SUMMARY ***
Total pot $3.75 | Rake $0.17 
Board [2d Qd 4s]
Seat 1: miru877 (button) folded before Flop (didn't bet)
Seat 2: golf7287 (small blind) collected ($3.58)
Seat 3: mariopork (big blind) folded before Flop
Seat 4: SantiagoWeight folded on the Flop
Seat 5: CAPTAINSKA folded before Flop (didn't bet)
Seat 6: Rollout2018 folded before Flop (didn't bet)



PokerStars Zoom Hand #195023287166:  Hold'em No Limit ($0.10/$0.25) - 2018/12/29 3:32:23 UTC [2018/12/28 22:32:23 ET]
Table 'Hydra' 6-max Seat #1 is the button
Seat 1: Pardaroxon ($25.75 in chips) 
Seat 2: assassin0875 ($181.34 in chips) 
Seat 3: davidhw888 ($33.51 in chips) 
Seat 4: pfunkolstar ($25 in chips) 
Seat 5: SantiagoWeight ($22.04 in chips) 
Seat 6: Mrs_Squeeze ($25.93 in chips) 
assassin0875: posts small blind $0.10
davidhw888: posts big blind $0.25
*** HOLE CARDS ***
Dealt to SantiagoWeight [As 3h]
pfunkolstar: folds 
SantiagoWeight: folds 
Mrs_Squeeze: folds 
Pardaroxon: raises $0.25 to $0.50
assassin0875: folds 
davidhw888: folds 
Uncalled bet ($0.25) returned to Pardaroxon
Pardaroxon collected $0.60 from pot
Pardaroxon: doesn't show hand 
*** SUMMARY ***
Total pot $0.60 | Rake $0 
Seat 1: Pardaroxon (button) collected ($0.60)
Seat 2: assassin0875 (small blind) folded before Flop
Seat 3: davidhw888 (big blind) folded before Flop
Seat 4: pfunkolstar folded before Flop (didn't bet)
Seat 5: SantiagoWeight folded before Flop (didn't bet)
Seat 6: Mrs_Squeeze folded before Flop (didn't bet)



PokerStars Zoom Hand #195023289857:  Hold'em No Limit ($0.10/$0.25) - 2018/12/29 3:32:31 UTC [2018/12/28 22:32:31 ET]
Table 'Hydra' 6-max Seat #1 is the button
Seat 1: ivann14 ($32.05 in chips) 
Seat 2: river plate9 ($24.88 in chips) 
Seat 3: Mrs_Squeeze ($25.93 in chips) 
Seat 4: SantiagoWeight ($22.04 in chips) 
Seat 5: CrazieFreddy ($29.97 in chips) 
Seat 6: Chrimmpam ($19.42 in chips) 
river plate9: posts small blind $0.10
Mrs_Squeeze: posts big blind $0.25
*** HOLE CARDS ***
Dealt to SantiagoWeight [4h Ah]
SantiagoWeight: raises $0.42 to $0.67
CrazieFreddy: raises $0.83 to $1.50
Chrimmpam: folds 
ivann14: folds 
river plate9: folds 
Mrs_Squeeze: folds 
SantiagoWeight: calls $0.83
*** FLOP *** [3h 7c 6s]
SantiagoWeight: checks 
CrazieFreddy: bets $1.75
SantiagoWeight: raises $3.45 to $5.20
CrazieFreddy: calls $3.45
*** TURN *** [3h 7c 6s] [5h]
SantiagoWeight: bets $7.90
CrazieFreddy: folds 
Uncalled bet ($7.90) returned to SantiagoWeight
SantiagoWeight collected $13.13 from pot
SantiagoWeight: doesn't show hand 
*** SUMMARY ***
Total pot $13.75 | Rake $0.62 
Board [3h 7c 6s 5h]
Seat 1: ivann14 (button) folded before Flop (didn't bet)
Seat 2: river plate9 (small blind) folded before Flop
Seat 3: Mrs_Squeeze (big blind) folded before Flop
Seat 4: SantiagoWeight collected ($13.13)
Seat 5: CrazieFreddy folded on the Turn
Seat 6: Chrimmpam folded before Flop (didn't bet)



PokerStars Zoom Hand #195023314532:  Hold'em No Limit ($0.10/$0.25) - 2018/12/29 3:33:45 UTC [2018/12/28 22:33:45 ET]
Table 'Hydra' 6-max Seat #1 is the button
Seat 1: pfunkolstar ($28.21 in chips) 
Seat 2: TQNYMQNTANA ($95.71 in chips) 
Seat 3: SantiagoWeight ($28.47 in chips) 
Seat 4: ckriszee ($26.66 in chips) 
Seat 5: davidhw888 ($53.98 in chips) 
Seat 6: trttt74 ($6.95 in chips) 
TQNYMQNTANA: posts small blind $0.10
SantiagoWeight: posts big blind $0.25
*** HOLE CARDS ***
Dealt to SantiagoWeight [Jd 5d]
ckriszee: folds 
davidhw888: raises $0.25 to $0.50
trttt74: folds 
pfunkolstar: folds 
TQNYMQNTANA: folds 
SantiagoWeight: folds 
Uncalled bet ($0.25) returned to davidhw888
davidhw888 collected $0.60 from pot
*** SUMMARY ***
Total pot $0.60 | Rake $0 
Seat 1: pfunkolstar (button) folded before Flop (didn't bet)
Seat 2: TQNYMQNTANA (small blind) folded before Flop
Seat 3: SantiagoWeight (big blind) folded before Flop
Seat 4: ckriszee folded before Flop (didn't bet)
Seat 5: davidhw888 collected ($0.60)
Seat 6: trttt74 folded before Flop (didn't bet)



PokerStars Zoom Hand #195023312913:  Hold'em No Limit ($0.10/$0.25) - 2018/12/29 3:33:40 UTC [2018/12/28 22:33:40 ET]
Table 'Hydra' 6-max Seat #1 is the button
Seat 1: negreanuNya ($37.98 in chips) 
Seat 2: miru877 ($24.76 in chips) 
Seat 3: ivann14 ($83.83 in chips) 
Seat 4: SantiagoWeight ($28.47 in chips) 
Seat 5: Viiiru ($34.18 in chips) 
Seat 6: KAOS914 ($44.58 in chips) 
miru877: posts small blind $0.10
ivann14: posts big blind $0.25
*** HOLE CARDS ***
Dealt to SantiagoWeight [Jh 6s]
SantiagoWeight: folds 
Viiiru: raises $0.50 to $0.75
KAOS914: calls $0.75
negreanuNya: folds 
miru877: folds 
ivann14: calls $0.50
*** FLOP *** [7c Tc 4c]
ivann14: bets $1.75
Viiiru: folds 
KAOS914: folds 
Uncalled bet ($1.75) returned to ivann14
ivann14 collected $2.24 from pot
ivann14: doesn't show hand 
*** SUMMARY ***
Total pot $2.35 | Rake $0.11 
Board [7c Tc 4c]
Seat 1: negreanuNya (button) folded before Flop (didn't bet)
Seat 2: miru877 (small blind) folded before Flop
Seat 3: ivann14 (big blind) collected ($2.24)
Seat 4: SantiagoWeight folded before Flop (didn't bet)
Seat 5: Viiiru folded on the Flop
Seat 6: KAOS914 folded on the Flop



PokerStars Zoom Hand #195023319170:  Hold'em No Limit ($0.10/$0.25) - 2018/12/29 3:33:59 UTC [2018/12/28 22:33:59 ET]
Table 'Hydra' 6-max Seat #1 is the button
Seat 1: aa1421b ($33.68 in chips) 
Seat 2: SantiagoWeight ($28.22 in chips) 
Seat 3: GrandmasterY ($25 in chips) 
Seat 4: nadal335 ($24.17 in chips) 
Seat 5: yobbos ($131.86 in chips) 
Seat 6: ryanking99 ($49 in chips) 
SantiagoWeight: posts small blind $0.10
GrandmasterY: posts big blind $0.25
*** HOLE CARDS ***
Dealt to SantiagoWeight [5s 5h]
nadal335: folds 
yobbos: folds 
ryanking99: folds 
aa1421b: raises $0.50 to $0.75
SantiagoWeight: raises $1.95 to $2.70
GrandmasterY: folds 
aa1421b: calls $1.95
*** FLOP *** [As Kd Ah]
SantiagoWeight: bets $0.25
aa1421b: raises $2.25 to $2.50
SantiagoWeight: folds 
Uncalled bet ($2.25) returned to aa1421b
aa1421b collected $5.87 from pot
aa1421b: doesn't show hand 
*** SUMMARY ***
Total pot $6.15 | Rake $0.28 
Board [As Kd Ah]
Seat 1: aa1421b (button) collected ($5.87)
Seat 2: SantiagoWeight (small blind) folded on the Flop
Seat 3: GrandmasterY (big blind) folded before Flop
Seat 4: nadal335 folded before Flop (didn't bet)
Seat 5: yobbos folded before Flop (didn't bet)
Seat 6: ryanking99 folded before Flop (didn't bet)



PokerStars Zoom Hand #195023336074:  Hold'em No Limit ($0.10/$0.25) - 2018/12/29 3:34:50 UTC [2018/12/28 22:34:50 ET]
Table 'Hydra' 6-max Seat #1 is the button
Seat 1: SantiagoWeight ($25.27 in chips) 
Seat 2: aa1421b ($36.60 in chips) 
Seat 3: Antwerken ($27.68 in chips) 
Seat 4: nhanminhtri ($25 in chips) 
Seat 5: zxlazy ($13.74 in chips) 
Seat 6: Only1Table ($21.66 in chips) 
aa1421b: posts small blind $0.10
Antwerken: posts big blind $0.25
*** HOLE CARDS ***
Dealt to SantiagoWeight [8h 6d]
nhanminhtri: folds 
zxlazy: folds 
Only1Table: folds 
SantiagoWeight: folds 
aa1421b: folds 
Uncalled bet ($0.15) returned to Antwerken
Antwerken collected $0.20 from pot
Antwerken: doesn't show hand 
*** SUMMARY ***
Total pot $0.20 | Rake $0 
Seat 1: SantiagoWeight (button) folded before Flop (didn't bet)
Seat 2: aa1421b (small blind) folded before Flop
Seat 3: Antwerken (big blind) collected ($0.20)
Seat 4: nhanminhtri folded before Flop (didn't bet)
Seat 5: zxlazy folded before Flop (didn't bet)
Seat 6: Only1Table folded before Flop (didn't bet)



PokerStars Zoom Hand #195023341030:  Hold'em No Limit ($0.10/$0.25) - 2018/12/29 3:35:05 UTC [2018/12/28 22:35:05 ET]
Table 'Hydra' 6-max Seat #1 is the button
Seat 1: maklareti ($25 in chips) 
Seat 2: ivann14 ($28.70 in chips) 
Seat 3: SantiagoWeight ($25.27 in chips) 
Seat 4: zzzMASTERzzz ($20.56 in chips) 
Seat 5: Viiiru ($26.56 in chips) 
Seat 6: Lehared ($65.50 in chips) 
ivann14: posts small blind $0.10
SantiagoWeight: posts big blind $0.25
*** HOLE CARDS ***
Dealt to SantiagoWeight [Kc Ks]
zzzMASTERzzz: folds 
Viiiru: folds 
Lehared: folds 
maklareti: folds 
ivann14: raises $0.50 to $0.75
SantiagoWeight: raises $1.75 to $2.50
ivann14: folds 
Uncalled bet ($1.75) returned to SantiagoWeight
SantiagoWeight collected $1.50 from pot
SantiagoWeight: doesn't show hand 
*** SUMMARY ***
Total pot $1.50 | Rake $0 
Seat 1: maklareti (button) folded before Flop (didn't bet)
Seat 2: ivann14 (small blind) folded before Flop
Seat 3: SantiagoWeight (big blind) collected ($1.50)
Seat 4: zzzMASTERzzz folded before Flop (didn't bet)
Seat 5: Viiiru folded before Flop (didn't bet)
Seat 6: Lehared folded before Flop (didn't bet)



PokerStars Zoom Hand #195023338456:  Hold'em No Limit ($0.10/$0.25) - 2018/12/29 3:34:57 UTC [2018/12/28 22:34:57 ET]
Table 'Hydra' 6-max Seat #1 is the button
Seat 1: TQNYMQNTANA ($25 in chips) 
Seat 2: osa126 ($42.25 in chips) 
Seat 3: river plate9 ($22.68 in chips) 
Seat 4: Mrs_Squeeze ($21.83 in chips) 
Seat 5: TDAK1509 ($49.23 in chips) 
Seat 6: SantiagoWeight ($25.27 in chips) 
osa126: posts small blind $0.10
river plate9: posts big blind $0.25
*** HOLE CARDS ***
Dealt to SantiagoWeight [4h 7s]
Mrs_Squeeze: raises $0.25 to $0.50
TDAK1509: calls $0.50
SantiagoWeight: folds 
TQNYMQNTANA: folds 
osa126: folds 
river plate9: calls $0.25
*** FLOP *** [3d Qd Ac]
river plate9: checks 
Mrs_Squeeze: checks 
TDAK1509: bets $0.75
river plate9: calls $0.75
Mrs_Squeeze: calls $0.75
*** TURN *** [3d Qd Ac] [Qs]
river plate9: checks 
Mrs_Squeeze: checks 
TDAK1509: checks 
*** RIVER *** [3d Qd Ac Qs] [Jc]
river plate9: checks 
Mrs_Squeeze: bets $1.84
TDAK1509: folds 
river plate9: folds 
Uncalled bet ($1.84) returned to Mrs_Squeeze
Mrs_Squeeze collected $3.68 from pot
Mrs_Squeeze: doesn't show hand 
*** SUMMARY ***
Total pot $3.85 | Rake $0.17 
Board [3d Qd Ac Qs Jc]
Seat 1: TQNYMQNTANA (button) folded before Flop (didn't bet)
Seat 2: osa126 (small blind) folded before Flop
Seat 3: river plate9 (big blind) folded on the River
Seat 4: Mrs_Squeeze collected ($3.68)
Seat 5: TDAK1509 folded on the River
Seat 6: SantiagoWeight folded before Flop (didn't bet)



PokerStars Zoom Hand #195023354551:  Hold'em No Limit ($0.10/$0.25) - 2018/12/29 3:35:46 UTC [2018/12/28 22:35:46 ET]
Table 'Hydra' 6-max Seat #1 is the button
Seat 1: mariopork ($44.74 in chips) 
Seat 2: SantiagoWeight ($26.02 in chips) 
Seat 3: NL_BYreg ($43.83 in chips) 
Seat 4: jeffwalker23 ($81.91 in chips) 
Seat 5: ttshead ($66.33 in chips) 
Seat 6: golf7287 ($39.28 in chips) 
SantiagoWeight: posts small blind $0.10
NL_BYreg: posts big blind $0.25
*** HOLE CARDS ***
Dealt to SantiagoWeight [6s 7c]
jeffwalker23: folds 
ttshead: folds 
golf7287: folds 
mariopork: folds 
SantiagoWeight: folds 
Uncalled bet ($0.15) returned to NL_BYreg
NL_BYreg collected $0.20 from pot
NL_BYreg: doesn't show hand 
*** SUMMARY ***
Total pot $0.20 | Rake $0 
Seat 1: mariopork (button) folded before Flop (didn't bet)
Seat 2: SantiagoWeight (small blind) folded before Flop
Seat 3: NL_BYreg (big blind) collected ($0.20)
Seat 4: jeffwalker23 folded before Flop (didn't bet)
Seat 5: ttshead folded before Flop (didn't bet)
Seat 6: golf7287 folded before Flop (didn't bet)



PokerStars Zoom Hand #195023366400:  Hold'em No Limit ($0.10/$0.25) - 2018/12/29 3:36:22 UTC [2018/12/28 22:36:22 ET]
Table 'Hydra' 6-max Seat #1 is the button
Seat 1: SantiagoWeight ($25.92 in chips) 
Seat 2: gingdog ($35.71 in chips) 
Seat 3: zxlazy ($13.58 in chips) 
Seat 4: zdenekstavic ($37.28 in chips) 
Seat 5: CrazieFreddy ($17.60 in chips) 
Seat 6: MoMoney2612 ($25.43 in chips) 
gingdog: posts small blind $0.10
zxlazy: posts big blind $0.25
*** HOLE CARDS ***
Dealt to SantiagoWeight [3c Th]
zdenekstavic: folds 
CrazieFreddy: folds 
MoMoney2612: folds 
SantiagoWeight: folds 
gingdog: folds 
Uncalled bet ($0.15) returned to zxlazy
zxlazy collected $0.20 from pot
zxlazy: doesn't show hand 
*** SUMMARY ***
Total pot $0.20 | Rake $0 
Seat 1: SantiagoWeight (button) folded before Flop (didn't bet)
Seat 2: gingdog (small blind) folded before Flop
Seat 3: zxlazy (big blind) collected ($0.20)
Seat 4: zdenekstavic folded before Flop (didn't bet)
Seat 5: CrazieFreddy folded before Flop (didn't bet)
Seat 6: MoMoney2612 folded before Flop (didn't bet)



PokerStars Zoom Hand #195023367630:  Hold'em No Limit ($0.10/$0.25) - 2018/12/29 3:36:26 UTC [2018/12/28 22:36:26 ET]
Table 'Hydra' 6-max Seat #1 is the button
Seat 1: MoMoney2612 ($25 in chips) 
Seat 2: ^J0K3RST@RS! ($21.20 in chips) 
Seat 3: reademenweep ($22.07 in chips) 
Seat 4: zdenekstavic ($37.28 in chips) 
Seat 5: razil_999 ($23.67 in chips) 
Seat 6: SantiagoWeight ($25.92 in chips) 
^J0K3RST@RS!: posts small blind $0.10
reademenweep: posts big blind $0.25
*** HOLE CARDS ***
Dealt to SantiagoWeight [4d 6h]
zdenekstavic: raises $0.25 to $0.50
razil_999: folds 
SantiagoWeight: folds 
MoMoney2612: folds 
^J0K3RST@RS!: folds 
reademenweep: folds 
Uncalled bet ($0.25) returned to zdenekstavic
zdenekstavic collected $0.60 from pot
zdenekstavic: doesn't show hand 
*** SUMMARY ***
Total pot $0.60 | Rake $0 
Seat 1: MoMoney2612 (button) folded before Flop (didn't bet)
Seat 2: ^J0K3RST@RS! (small blind) folded before Flop
Seat 3: reademenweep (big blind) folded before Flop
Seat 4: zdenekstavic collected ($0.60)
Seat 5: razil_999 folded before Flop (didn't bet)
Seat 6: SantiagoWeight folded before Flop (didn't bet)



PokerStars Zoom Hand #195023368948:  Hold'em No Limit ($0.10/$0.25) - 2018/12/29 3:36:30 UTC [2018/12/28 22:36:30 ET]
Table 'Hydra' 6-max Seat #1 is the button
Seat 1: gingdog ($35.61 in chips) 
Seat 2: call me??107 ($28.98 in chips) 
Seat 3: 1ownYourUsd ($42.12 in chips) 
Seat 4: cankum ($42.15 in chips) 
Seat 5: SantiagoWeight ($25.92 in chips) 
Seat 6: nhanminhtri ($26.11 in chips) 
call me??107: posts small blind $0.10
1ownYourUsd: posts big blind $0.25
*** HOLE CARDS ***
Dealt to SantiagoWeight [2s 3d]
cankum: folds 
SantiagoWeight: folds 
nhanminhtri: folds 
gingdog: folds 
call me??107: folds 
Uncalled bet ($0.15) returned to 1ownYourUsd
1ownYourUsd collected $0.20 from pot
1ownYourUsd: doesn't show hand 
*** SUMMARY ***
Total pot $0.20 | Rake $0 
Seat 1: gingdog (button) folded before Flop (didn't bet)
Seat 2: call me??107 (small blind) folded before Flop
Seat 3: 1ownYourUsd (big blind) collected ($0.20)
Seat 4: cankum folded before Flop (didn't bet)
Seat 5: SantiagoWeight folded before Flop (didn't bet)
Seat 6: nhanminhtri folded before Flop (didn't bet)



PokerStars Zoom Hand #195023370270:  Hold'em No Limit ($0.10/$0.25) - 2018/12/29 3:36:34 UTC [2018/12/28 22:36:34 ET]
Table 'Hydra' 6-max Seat #1 is the button
Seat 1: SantiagoWeight ($25.92 in chips) 
Seat 2: river plate9 ($66.96 in chips) 
Seat 3: Lehared ($74.32 in chips) 
Seat 4: _BluDeeN_ ($33.42 in chips) 
Seat 5: davidhw888 ($17.57 in chips) 
Seat 6: ttshead ($66.93 in chips) 
river plate9: posts small blind $0.10
Lehared: posts big blind $0.25
*** HOLE CARDS ***
Dealt to SantiagoWeight [9s Qs]
_BluDeeN_: folds 
davidhw888: folds 
ttshead: raises $0.43 to $0.68
SantiagoWeight: folds 
river plate9: folds 
Lehared: folds 
Uncalled bet ($0.43) returned to ttshead
ttshead collected $0.60 from pot
ttshead: doesn't show hand 
*** SUMMARY ***
Total pot $0.60 | Rake $0 
Seat 1: SantiagoWeight (button) folded before Flop (didn't bet)
Seat 2: river plate9 (small blind) folded before Flop
Seat 3: Lehared (big blind) folded before Flop
Seat 4: _BluDeeN_ folded before Flop (didn't bet)
Seat 5: davidhw888 folded before Flop (didn't bet)
Seat 6: ttshead collected ($0.60)



PokerStars Zoom Hand #195023378746:  Hold'em No Limit ($0.10/$0.25) - 2018/12/29 3:37:00 UTC [2018/12/28 22:37:00 ET]
Table 'Hydra' 6-max Seat #1 is the button
Seat 1: gaffer31 ($31.58 in chips) 
Seat 2: KeySssi ($25.40 in chips) 
Seat 3: river plate9 ($66.86 in chips) 
Seat 4: Renner32 ($24.03 in chips) 
Seat 5: SantiagoWeight ($25.92 in chips) 
Seat 6: davidhw888 ($33.48 in chips) 
KeySssi: posts small blind $0.10
river plate9: posts big blind $0.25
*** HOLE CARDS ***
Dealt to SantiagoWeight [Th Jh]
Renner32: folds 
SantiagoWeight: raises $0.37 to $0.62
davidhw888: calls $0.62
gaffer31: folds 
KeySssi: folds 
river plate9: folds 
*** FLOP *** [Js 6h Ks]
SantiagoWeight: checks 
davidhw888: bets $1.10
SantiagoWeight: calls $1.10
*** TURN *** [Js 6h Ks] [7s]
SantiagoWeight: checks 
davidhw888: checks 
*** RIVER *** [Js 6h Ks 7s] [5d]
SantiagoWeight: bets $2.20
davidhw888: folds 
Uncalled bet ($2.20) returned to SantiagoWeight
SantiagoWeight collected $3.62 from pot
SantiagoWeight: doesn't show hand 
*** SUMMARY ***
Total pot $3.79 | Rake $0.17 
Board [Js 6h Ks 7s 5d]
Seat 1: gaffer31 (button) folded before Flop (didn't bet)
Seat 2: KeySssi (small blind) folded before Flop
Seat 3: river plate9 (big blind) folded before Flop
Seat 4: Renner32 folded before Flop (didn't bet)
Seat 5: SantiagoWeight collected ($3.62)
Seat 6: davidhw888 folded on the River



PokerStars Zoom Hand #195023397649:  Hold'em No Limit ($0.10/$0.25) - 2018/12/29 3:37:58 UTC [2018/12/28 22:37:58 ET]
Table 'Hydra' 6-max Seat #1 is the button
Seat 1: ckriszee ($41.59 in chips) 
Seat 2: NakdemAlle ($25.73 in chips) 
Seat 3: winwinboy ($25 in chips) 
Seat 4: SantiagoWeight ($27.82 in chips) 
Seat 5: franco373513 ($22.40 in chips) 
Seat 6: KeySssi ($25 in chips) 
NakdemAlle: posts small blind $0.10
winwinboy: posts big blind $0.25
*** HOLE CARDS ***
Dealt to SantiagoWeight [4c 3d]
SantiagoWeight: folds 
franco373513: folds 
KeySssi: raises $0.37 to $0.62
ckriszee: folds 
NakdemAlle: raises $1.49 to $2.11
winwinboy: folds 
KeySssi: folds 
Uncalled bet ($1.49) returned to NakdemAlle
NakdemAlle collected $1.49 from pot
NakdemAlle: doesn't show hand 
*** SUMMARY ***
Total pot $1.49 | Rake $0 
Seat 1: ckriszee (button) folded before Flop (didn't bet)
Seat 2: NakdemAlle (small blind) collected ($1.49)
Seat 3: winwinboy (big blind) folded before Flop
Seat 4: SantiagoWeight folded before Flop (didn't bet)
Seat 5: franco373513 folded before Flop (didn't bet)
Seat 6: KeySssi folded before Flop



PokerStars Zoom Hand #195023400189:  Hold'em No Limit ($0.10/$0.25) - 2018/12/29 3:38:06 UTC [2018/12/28 22:38:06 ET]
Table 'Hydra' 6-max Seat #1 is the button
Seat 1: kyracarmen ($51.25 in chips) 
Seat 2: TQNYMQNTANA ($86.73 in chips) 
Seat 3: SantiagoWeight ($27.82 in chips) 
Seat 4: miru877 ($26.31 in chips) 
Seat 5: 1ownYourUsd ($43.51 in chips) 
Seat 6: yobbos ($137.82 in chips) 
TQNYMQNTANA: posts small blind $0.10
SantiagoWeight: posts big blind $0.25
*** HOLE CARDS ***
Dealt to SantiagoWeight [3d 6c]
miru877: folds 
1ownYourUsd: folds 
yobbos: raises $0.37 to $0.62
kyracarmen: folds 
TQNYMQNTANA: folds 
SantiagoWeight: folds 
Uncalled bet ($0.37) returned to yobbos
yobbos collected $0.60 from pot
yobbos: doesn't show hand 
*** SUMMARY ***
Total pot $0.60 | Rake $0 
Seat 1: kyracarmen (button) folded before Flop (didn't bet)
Seat 2: TQNYMQNTANA (small blind) folded before Flop
Seat 3: SantiagoWeight (big blind) folded before Flop
Seat 4: miru877 folded before Flop (didn't bet)
Seat 5: 1ownYourUsd folded before Flop (didn't bet)
Seat 6: yobbos collected ($0.60)



PokerStars Zoom Hand #195023413626:  Hold'em No Limit ($0.10/$0.25) - 2018/12/29 3:38:48 UTC [2018/12/28 22:38:48 ET]
Table 'Hydra' 6-max Seat #1 is the button
Seat 1: Xp0Hb ($25.03 in chips) 
Seat 2: abbi555 ($28.46 in chips) 
Seat 3: Baboscrubx ($31.83 in chips) 
Seat 4: SantiagoWeight ($27.47 in chips) 
Seat 5: Jack123985 ($25 in chips) 
Seat 6: yobbos ($138.07 in chips) 
abbi555: posts small blind $0.10
Baboscrubx: posts big blind $0.25
*** HOLE CARDS ***
Dealt to SantiagoWeight [6s Ac]
SantiagoWeight: folds 
Jack123985: folds 
yobbos: folds 
Xp0Hb: raises $0.50 to $0.75
abbi555: folds 
Baboscrubx: folds 
Uncalled bet ($0.50) returned to Xp0Hb
Xp0Hb collected $0.60 from pot
Xp0Hb: doesn't show hand 
*** SUMMARY ***
Total pot $0.60 | Rake $0 
Seat 1: Xp0Hb (button) collected ($0.60)
Seat 2: abbi555 (small blind) folded before Flop
Seat 3: Baboscrubx (big blind) folded before Flop
Seat 4: SantiagoWeight folded before Flop (didn't bet)
Seat 5: Jack123985 folded before Flop (didn't bet)
Seat 6: yobbos folded before Flop (didn't bet)



PokerStars Zoom Hand #195023415895:  Hold'em No Limit ($0.10/$0.25) - 2018/12/29 3:38:55 UTC [2018/12/28 22:38:55 ET]
Table 'Hydra' 6-max Seat #1 is the button
Seat 1: MileVoliD49 ($75.43 in chips) 
Seat 2: GrandmasterY ($25.10 in chips) 
Seat 3: Chrimmpam ($17.50 in chips) 
Seat 4: TQNYMQNTANA ($29.03 in chips) 
Seat 5: graysonai ($30.46 in chips) 
Seat 6: SantiagoWeight ($27.47 in chips) 
GrandmasterY: posts small blind $0.10
Chrimmpam: posts big blind $0.25
*** HOLE CARDS ***
Dealt to SantiagoWeight [4c Kc]
TQNYMQNTANA: raises $0.50 to $0.75
graysonai: folds 
SantiagoWeight: folds 
MileVoliD49: folds 
GrandmasterY: folds 
Chrimmpam: folds 
Uncalled bet ($0.50) returned to TQNYMQNTANA
TQNYMQNTANA collected $0.60 from pot
TQNYMQNTANA: doesn't show hand 
*** SUMMARY ***
Total pot $0.60 | Rake $0 
Seat 1: MileVoliD49 (button) folded before Flop (didn't bet)
Seat 2: GrandmasterY (small blind) folded before Flop
Seat 3: Chrimmpam (big blind) folded before Flop
Seat 4: TQNYMQNTANA collected ($0.60)
Seat 5: graysonai folded before Flop (didn't bet)
Seat 6: SantiagoWeight folded before Flop (didn't bet)



PokerStars Zoom Hand #195023420128:  Hold'em No Limit ($0.10/$0.25) - 2018/12/29 3:39:08 UTC [2018/12/28 22:39:08 ET]
Table 'Hydra' 6-max Seat #1 is the button
Seat 1: Lehared ($64.59 in chips) 
Seat 2: SantiagoWeight ($27.47 in chips) 
Seat 3: HansMSM ($25.60 in chips) 
Seat 4: osa126 ($35.47 in chips) 
Seat 5: Baboscrubx ($25 in chips) 
Seat 6: yobbos ($138.17 in chips) 
SantiagoWeight: posts small blind $0.10
HansMSM: posts big blind $0.25
*** HOLE CARDS ***
Dealt to SantiagoWeight [5d 4s]
osa126: folds 
Baboscrubx: folds 
yobbos: folds 
Lehared: folds 
SantiagoWeight: folds 
Uncalled bet ($0.15) returned to HansMSM
HansMSM collected $0.20 from pot
HansMSM: doesn't show hand 
*** SUMMARY ***
Total pot $0.20 | Rake $0 
Seat 1: Lehared (button) folded before Flop (didn't bet)
Seat 2: SantiagoWeight (small blind) folded before Flop
Seat 3: HansMSM (big blind) collected ($0.20)
Seat 4: osa126 folded before Flop (didn't bet)
Seat 5: Baboscrubx folded before Flop (didn't bet)
Seat 6: yobbos folded before Flop (didn't bet)



PokerStars Zoom Hand #195023418836:  Hold'em No Limit ($0.10/$0.25) - 2018/12/29 3:39:04 UTC [2018/12/28 22:39:04 ET]
Table 'Hydra' 6-max Seat #1 is the button
Seat 1: HansMSM ($62.85 in chips) 
Seat 2: nhanminhtri ($31.71 in chips) 
Seat 3: reggiedogg31 ($102.35 in chips) 
Seat 4: SantiagoWeight ($27.47 in chips) 
Seat 5: onhoang87 ($23.16 in chips) 
Seat 6: !P0K3RM3T4L! ($59.38 in chips) 
nhanminhtri: posts small blind $0.10
reggiedogg31: posts big blind $0.25
*** HOLE CARDS ***
Dealt to SantiagoWeight [5s Kd]
SantiagoWeight: folds 
onhoang87: calls $0.25
!P0K3RM3T4L!: folds 
HansMSM: folds 
nhanminhtri: folds 
reggiedogg31: checks 
*** FLOP *** [Ah Jh 3c]
reggiedogg31: bets $1.25
onhoang87: folds 
Uncalled bet ($1.25) returned to reggiedogg31
reggiedogg31 collected $0.57 from pot
reggiedogg31: doesn't show hand 
*** SUMMARY ***
Total pot $0.60 | Rake $0.03 
Board [Ah Jh 3c]
Seat 1: HansMSM (button) folded before Flop (didn't bet)
Seat 2: nhanminhtri (small blind) folded before Flop
Seat 3: reggiedogg31 (big blind) collected ($0.57)
Seat 4: SantiagoWeight folded before Flop (didn't bet)
Seat 5: onhoang87 folded on the Flop
Seat 6: !P0K3RM3T4L! folded before Flop (didn't bet)



PokerStars Zoom Hand #195023426581:  Hold'em No Limit ($0.10/$0.25) - 2018/12/29 3:39:28 UTC [2018/12/28 22:39:28 ET]
Table 'Hydra' 6-max Seat #1 is the button
Seat 1: Josip1119 ($22.54 in chips) 
Seat 2: ckriszee ($42.27 in chips) 
Seat 3: SantiagoWeight ($27.37 in chips) 
Seat 4: graysonai ($25 in chips) 
Seat 5: Dbakunwaves ($117.91 in chips) 
Seat 6: naxizzle ($154.15 in chips) 
ckriszee: posts small blind $0.10
SantiagoWeight: posts big blind $0.25
*** HOLE CARDS ***
Dealt to SantiagoWeight [7d 2d]
graysonai: folds 
Dbakunwaves: folds 
naxizzle: folds 
Josip1119: folds 
ckriszee: folds 
Uncalled bet ($0.15) returned to SantiagoWeight
SantiagoWeight collected $0.20 from pot
SantiagoWeight: doesn't show hand 
*** SUMMARY ***
Total pot $0.20 | Rake $0 
Seat 1: Josip1119 (button) folded before Flop (didn't bet)
Seat 2: ckriszee (small blind) folded before Flop
Seat 3: SantiagoWeight (big blind) collected ($0.20)
Seat 4: graysonai folded before Flop (didn't bet)
Seat 5: Dbakunwaves folded before Flop (didn't bet)
Seat 6: naxizzle folded before Flop (didn't bet)



PokerStars Zoom Hand #195023431682:  Hold'em No Limit ($0.10/$0.25) - 2018/12/29 3:39:44 UTC [2018/12/28 22:39:44 ET]
Table 'Hydra' 6-max Seat #1 is the button
Seat 1: SantiagoWeight ($27.47 in chips) 
Seat 2: davidhw888 ($30.41 in chips) 
Seat 3: Lehared ($40.63 in chips) 
Seat 4: angipoker ($13.30 in chips) 
Seat 5: Slim Wolfie ($29.68 in chips) 
Seat 6: Party4Arthy ($60.43 in chips) 
davidhw888: posts small blind $0.10
Lehared: posts big blind $0.25
*** HOLE CARDS ***
Dealt to SantiagoWeight [9d 3c]
angipoker: folds 
Slim Wolfie: folds 
Party4Arthy: raises $0.50 to $0.75
SantiagoWeight: folds 
davidhw888: folds 
Lehared: calls $0.50
*** FLOP *** [3s 5d 2d]
Lehared: checks 
Party4Arthy: bets $1
Lehared: folds 
Uncalled bet ($1) returned to Party4Arthy
Party4Arthy collected $1.53 from pot
Party4Arthy: doesn't show hand 
*** SUMMARY ***
Total pot $1.60 | Rake $0.07 
Board [3s 5d 2d]
Seat 1: SantiagoWeight (button) folded before Flop (didn't bet)
Seat 2: davidhw888 (small blind) folded before Flop
Seat 3: Lehared (big blind) folded on the Flop
Seat 4: angipoker folded before Flop (didn't bet)
Seat 5: Slim Wolfie folded before Flop (didn't bet)
Seat 6: Party4Arthy collected ($1.53)



PokerStars Zoom Hand #195023434640:  Hold'em No Limit ($0.10/$0.25) - 2018/12/29 3:39:53 UTC [2018/12/28 22:39:53 ET]
Table 'Hydra' 6-max Seat #1 is the button
Seat 1: Baboscrubx ($31.48 in chips) 
Seat 2: sZCzpNtheKot ($27.82 in chips) 
Seat 3: angipoker ($13.30 in chips) 
Seat 4: deaglepro ($63.24 in chips) 
Seat 5: reggiedogg31 ($102.67 in chips) 
Seat 6: SantiagoWeight ($27.47 in chips) 
sZCzpNtheKot: posts small blind $0.10
angipoker: posts big blind $0.25
*** HOLE CARDS ***
Dealt to SantiagoWeight [3c Qh]
deaglepro: folds 
reggiedogg31: folds 
SantiagoWeight: folds 
Baboscrubx: folds 
sZCzpNtheKot: raises $0.50 to $0.75
angipoker: folds 
Uncalled bet ($0.50) returned to sZCzpNtheKot
sZCzpNtheKot collected $0.50 from pot
sZCzpNtheKot: doesn't show hand 
*** SUMMARY ***
Total pot $0.50 | Rake $0 
Seat 1: Baboscrubx (button) folded before Flop (didn't bet)
Seat 2: sZCzpNtheKot (small blind) collected ($0.50)
Seat 3: angipoker (big blind) folded before Flop
Seat 4: deaglepro folded before Flop (didn't bet)
Seat 5: reggiedogg31 folded before Flop (didn't bet)
Seat 6: SantiagoWeight folded before Flop (didn't bet)



PokerStars Zoom Hand #195023407182:  Hold'em No Limit ($0.10/$0.25) - 2018/12/29 3:38:28 UTC [2018/12/28 22:38:28 ET]
Table 'Hydra' 6-max Seat #1 is the button
Seat 1: nhanminhtri ($25.50 in chips) 
Seat 2: SantiagoWeight ($27.57 in chips) 
Seat 3: t57571245 ($25 in chips) 
Seat 4: HansMSM ($86.59 in chips) 
Seat 5: gingdog ($38.47 in chips) 
Seat 6: !P0K3RM3T4L! ($46.20 in chips) 
SantiagoWeight: posts small blind $0.10
t57571245: posts big blind $0.25
*** HOLE CARDS ***
Dealt to SantiagoWeight [Ks 5d]
HansMSM: raises $0.45 to $0.70
gingdog: folds 
!P0K3RM3T4L!: raises $1.55 to $2.25
nhanminhtri: folds 
SantiagoWeight: folds 
t57571245: folds 
HansMSM: calls $1.55
*** FLOP *** [Ad 5s 8h]
HansMSM: checks 
!P0K3RM3T4L!: bets $1.57
HansMSM: calls $1.57
*** TURN *** [Ad 5s 8h] [5h]
HansMSM: checks 
!P0K3RM3T4L!: bets $4.70
HansMSM: calls $4.70
*** RIVER *** [Ad 5s 8h 5h] [4d]
HansMSM: checks 
!P0K3RM3T4L!: bets $2.65
HansMSM: calls $2.65
*** SHOW DOWN ***
!P0K3RM3T4L!: shows [Kh As] (two pair, Aces and Fives)
HansMSM: mucks hand 
!P0K3RM3T4L! collected $21.67 from pot
*** SUMMARY ***
Total pot $22.69 | Rake $1.02 
Board [Ad 5s 8h 5h 4d]
Seat 1: nhanminhtri (button) folded before Flop (didn't bet)
Seat 2: SantiagoWeight (small blind) folded before Flop
Seat 3: t57571245 (big blind) folded before Flop
Seat 4: HansMSM mucked [Ah Td]
Seat 5: gingdog folded before Flop (didn't bet)
Seat 6: !P0K3RM3T4L! showed [Kh As] and won ($21.67) with two pair, Aces and Fives



PokerStars Zoom Hand #195023439141:  Hold'em No Limit ($0.10/$0.25) - 2018/12/29 3:40:07 UTC [2018/12/28 22:40:07 ET]
Table 'Hydra' 6-max Seat #1 is the button
Seat 1: jeffwalker23 ($83.06 in chips) 
Seat 2: mariopork ($25 in chips) 
Seat 3: davidhw888 ($43.74 in chips) 
Seat 4: Theo Heisman ($8.99 in chips) 
Seat 5: SantiagoWeight ($27.47 in chips) 
Seat 6: Baboscrubx ($31.48 in chips) 
mariopork: posts small blind $0.10
davidhw888: posts big blind $0.25
*** HOLE CARDS ***
Dealt to SantiagoWeight [3d 7d]
Theo Heisman: folds 
SantiagoWeight: folds 
Baboscrubx: folds 
jeffwalker23: raises $0.50 to $0.75
mariopork: raises $1.95 to $2.70
davidhw888: folds 
jeffwalker23: folds 
Uncalled bet ($1.95) returned to mariopork
mariopork collected $1.75 from pot
mariopork: doesn't show hand 
*** SUMMARY ***
Total pot $1.75 | Rake $0 
Seat 1: jeffwalker23 (button) folded before Flop
Seat 2: mariopork (small blind) collected ($1.75)
Seat 3: davidhw888 (big blind) folded before Flop
Seat 4: Theo Heisman folded before Flop (didn't bet)
Seat 5: SantiagoWeight folded before Flop (didn't bet)
Seat 6: Baboscrubx folded before Flop (didn't bet)



PokerStars Zoom Hand #195023441675:  Hold'em No Limit ($0.10/$0.25) - 2018/12/29 3:40:15 UTC [2018/12/28 22:40:15 ET]
Table 'Hydra' 6-max Seat #1 is the button
Seat 1: negreanuNya ($28.87 in chips) 
Seat 2: HansMSM ($63.30 in chips) 
Seat 3: SantiagoWeight ($27.47 in chips) 
Seat 4: KrishnaRadha ($33.14 in chips) 
Seat 5: Nutselas ($26.33 in chips) 
Seat 6: sZCzpNtheKot ($28.07 in chips) 
HansMSM: posts small blind $0.10
SantiagoWeight: posts big blind $0.25
*** HOLE CARDS ***
Dealt to SantiagoWeight [Kc 8d]
KrishnaRadha: folds 
Nutselas: folds 
sZCzpNtheKot: folds 
negreanuNya: raises $0.35 to $0.60
HansMSM: folds 
SantiagoWeight: calls $0.35
*** FLOP *** [5h 2c Js]
SantiagoWeight: checks 
negreanuNya: checks 
*** TURN *** [5h 2c Js] [Ts]
SantiagoWeight: checks 
negreanuNya: checks 
*** RIVER *** [5h 2c Js Ts] [3d]
SantiagoWeight: checks 
negreanuNya: checks 
*** SHOW DOWN ***
SantiagoWeight: shows [Kc 8d] (high card King)
negreanuNya: shows [As 7c] (high card Ace)
negreanuNya collected $1.24 from pot
*** SUMMARY ***
Total pot $1.30 | Rake $0.06 
Board [5h 2c Js Ts 3d]
Seat 1: negreanuNya (button) showed [As 7c] and won ($1.24) with high card Ace
Seat 2: HansMSM (small blind) folded before Flop
Seat 3: SantiagoWeight (big blind) showed [Kc 8d] and lost with high card King
Seat 4: KrishnaRadha folded before Flop (didn't bet)
Seat 5: Nutselas folded before Flop (didn't bet)
Seat 6: sZCzpNtheKot folded before Flop (didn't bet)



PokerStars Zoom Hand #195023458414:  Hold'em No Limit ($0.10/$0.25) - 2018/12/29 3:41:07 UTC [2018/12/28 22:41:07 ET]
Table 'Hydra' 6-max Seat #1 is the button
Seat 1: SantiagoWeight ($26.87 in chips) 
Seat 2: winwinboy ($26.05 in chips) 
Seat 3: davidhw888 ($42.89 in chips) 
Seat 4: GrandmasterY ($29.18 in chips) 
Seat 5: osa126 ($66.60 in chips) 
Seat 6: reggiedogg31 ($101.97 in chips) 
winwinboy: posts small blind $0.10
davidhw888: posts big blind $0.25
*** HOLE CARDS ***
Dealt to SantiagoWeight [5d As]
GrandmasterY: folds 
osa126: folds 
reggiedogg31: folds 
SantiagoWeight: raises $0.30 to $0.55
winwinboy: folds 
davidhw888: calls $0.30
*** FLOP *** [9s Ks Tc]
davidhw888: checks 
SantiagoWeight: bets $0.77
davidhw888: calls $0.77
*** TURN *** [9s Ks Tc] [8s]
davidhw888: checks 
SantiagoWeight: bets $2.62
davidhw888: calls $2.62
*** RIVER *** [9s Ks Tc 8s] [4s]
davidhw888: bets $7.62
SantiagoWeight: raises $15.31 to $22.93 and is all-in
davidhw888: folds 
Uncalled bet ($15.31) returned to SantiagoWeight
SantiagoWeight collected $22.18 from pot
SantiagoWeight: doesn't show hand 
*** SUMMARY ***
Total pot $23.22 | Rake $1.04 
Board [9s Ks Tc 8s 4s]
Seat 1: SantiagoWeight (button) collected ($22.18)
Seat 2: winwinboy (small blind) folded before Flop
Seat 3: davidhw888 (big blind) folded on the River
Seat 4: GrandmasterY folded before Flop (didn't bet)
Seat 5: osa126 folded before Flop (didn't bet)
Seat 6: reggiedogg31 folded before Flop (didn't bet)



PokerStars Zoom Hand #195023488098:  Hold'em No Limit ($0.10/$0.25) - 2018/12/29 3:42:40 UTC [2018/12/28 22:42:40 ET]
Table 'Hydra' 6-max Seat #1 is the button
Seat 1: naxizzle ($140.40 in chips) 
Seat 2: SantiagoWeight ($37.49 in chips) 
Seat 3: Unclesmoll ($8.54 in chips) 
Seat 4: Lehared ($40.13 in chips) 
Seat 5: Chrimmpam ($17.11 in chips) 
Seat 6: CrazieFreddy ($9.26 in chips) 
SantiagoWeight: posts small blind $0.10
Unclesmoll: posts big blind $0.25
*** HOLE CARDS ***
Dealt to SantiagoWeight [6c 8s]
Lehared: folds 
Chrimmpam: folds 
CrazieFreddy: folds 
naxizzle: folds 
SantiagoWeight: folds 
Uncalled bet ($0.15) returned to Unclesmoll
Unclesmoll collected $0.20 from pot
*** SUMMARY ***
Total pot $0.20 | Rake $0 
Seat 1: naxizzle (button) folded before Flop (didn't bet)
Seat 2: SantiagoWeight (small blind) folded before Flop
Seat 3: Unclesmoll (big blind) collected ($0.20)
Seat 4: Lehared folded before Flop (didn't bet)
Seat 5: Chrimmpam folded before Flop (didn't bet)
Seat 6: CrazieFreddy folded before Flop (didn't bet)



PokerStars Zoom Hand #195023494468:  Hold'em No Limit ($0.10/$0.25) - 2018/12/29 3:43:00 UTC [2018/12/28 22:43:00 ET]
Table 'Hydra' 6-max Seat #1 is the button
Seat 1: osa126 ($66 in chips) 
Seat 2: river plate9 ($109.47 in chips) 
Seat 3: aa1421b ($42.18 in chips) 
Seat 4: SantiagoWeight ($37.39 in chips) 
Seat 5: Mandu_xiii ($29.01 in chips) 
Seat 6: G ster24 ($31.49 in chips) 
river plate9: posts small blind $0.10
aa1421b: posts big blind $0.25
*** HOLE CARDS ***
Dealt to SantiagoWeight [Ah 4h]
SantiagoWeight: raises $0.42 to $0.67
Mandu_xiii: folds 
G ster24: folds 
osa126: folds 
river plate9: folds 
aa1421b: folds 
Uncalled bet ($0.42) returned to SantiagoWeight
SantiagoWeight collected $0.60 from pot
SantiagoWeight: doesn't show hand 
*** SUMMARY ***
Total pot $0.60 | Rake $0 
Seat 1: osa126 (button) folded before Flop (didn't bet)
Seat 2: river plate9 (small blind) folded before Flop
Seat 3: aa1421b (big blind) folded before Flop
Seat 4: SantiagoWeight collected ($0.60)
Seat 5: Mandu_xiii folded before Flop (didn't bet)
Seat 6: G ster24 folded before Flop (didn't bet)



PokerStars Zoom Hand #195023497890:  Hold'em No Limit ($0.10/$0.25) - 2018/12/29 3:43:11 UTC [2018/12/28 22:43:11 ET]
Table 'Hydra' 6-max Seat #1 is the button
Seat 1: rim975 ($10.28 in chips) 
Seat 2: graysonai ($29.31 in chips) 
Seat 3: TQNYMQNTANA ($37.18 in chips) 
Seat 4: Viiiru ($31.02 in chips) 
Seat 5: SantiagoWeight ($37.74 in chips) 
Seat 6: sZCzpNtheKot ($25 in chips) 
graysonai: posts small blind $0.10
TQNYMQNTANA: posts big blind $0.25
*** HOLE CARDS ***
Dealt to SantiagoWeight [7c Ac]
Viiiru: folds 
SantiagoWeight: raises $0.37 to $0.62
sZCzpNtheKot: folds 
rim975: folds 
graysonai: folds 
TQNYMQNTANA: folds 
Uncalled bet ($0.37) returned to SantiagoWeight
SantiagoWeight collected $0.60 from pot
SantiagoWeight: doesn't show hand 
*** SUMMARY ***
Total pot $0.60 | Rake $0 
Seat 1: rim975 (button) folded before Flop (didn't bet)
Seat 2: graysonai (small blind) folded before Flop
Seat 3: TQNYMQNTANA (big blind) folded before Flop
Seat 4: Viiiru folded before Flop (didn't bet)
Seat 5: SantiagoWeight collected ($0.60)
Seat 6: sZCzpNtheKot folded before Flop (didn't bet)



PokerStars Zoom Hand #195023503570:  Hold'em No Limit ($0.10/$0.25) - 2018/12/29 3:43:29 UTC [2018/12/28 22:43:29 ET]
Table 'Hydra' 6-max Seat #1 is the button
Seat 1: Chellabro ($38.68 in chips) 
Seat 2: !P0K3RM3T4L! ($32.56 in chips) 
Seat 3: Dr.Jekyll197 ($22.21 in chips) 
Seat 4: yobbos ($27.38 in chips) 
Seat 5: xman141 ($39.25 in chips) 
Seat 6: SantiagoWeight ($38.09 in chips) 
!P0K3RM3T4L!: posts small blind $0.10
Dr.Jekyll197: posts big blind $0.25
*** HOLE CARDS ***
Dealt to SantiagoWeight [Ac 7h]
yobbos: folds 
xman141: raises $0.25 to $0.50
SantiagoWeight: folds 
Chellabro: folds 
!P0K3RM3T4L!: folds 
Dr.Jekyll197: folds 
Uncalled bet ($0.25) returned to xman141
xman141 collected $0.60 from pot
xman141: doesn't show hand 
*** SUMMARY ***
Total pot $0.60 | Rake $0 
Seat 1: Chellabro (button) folded before Flop (didn't bet)
Seat 2: !P0K3RM3T4L! (small blind) folded before Flop
Seat 3: Dr.Jekyll197 (big blind) folded before Flop
Seat 4: yobbos folded before Flop (didn't bet)
Seat 5: xman141 collected ($0.60)
Seat 6: SantiagoWeight folded before Flop (didn't bet)



PokerStars Zoom Hand #195023492550:  Hold'em No Limit ($0.10/$0.25) - 2018/12/29 3:42:54 UTC [2018/12/28 22:42:54 ET]
Table 'Hydra' 6-max Seat #1 is the button
Seat 1: Viiiru ($66.14 in chips) 
Seat 2: GrandmasterY ($51.26 in chips) 
Seat 3: nhanminhtri ($25 in chips) 
Seat 4: aldoalb0207 ($54.80 in chips) 
Seat 5: landromede ($22.80 in chips) 
Seat 6: SantiagoWeight ($37.39 in chips) 
GrandmasterY: posts small blind $0.10
nhanminhtri: posts big blind $0.25
*** HOLE CARDS ***
Dealt to SantiagoWeight [2s Qd]
aldoalb0207: folds 
landromede: folds 
SantiagoWeight: folds 
Viiiru: folds 
GrandmasterY: raises $0.50 to $0.75
nhanminhtri: raises $1.75 to $2.50
GrandmasterY: calls $1.75
*** FLOP *** [Jh Th 9d]
GrandmasterY: checks 
nhanminhtri: bets $3.59
GrandmasterY: calls $3.59
*** TURN *** [Jh Th 9d] [3h]
GrandmasterY: checks 
nhanminhtri: checks 
*** RIVER *** [Jh Th 9d 3h] [5h]
GrandmasterY: checks 
nhanminhtri: checks 
*** SHOW DOWN ***
GrandmasterY: shows [7c Tc] (a pair of Tens)
nhanminhtri: shows [Ks Kc] (a pair of Kings)
nhanminhtri collected $11.63 from pot
*** SUMMARY ***
Total pot $12.18 | Rake $0.55 
Board [Jh Th 9d 3h 5h]
Seat 1: Viiiru (button) folded before Flop (didn't bet)
Seat 2: GrandmasterY (small blind) showed [7c Tc] and lost with a pair of Tens
Seat 3: nhanminhtri (big blind) showed [Ks Kc] and won ($11.63) with a pair of Kings
Seat 4: aldoalb0207 folded before Flop (didn't bet)
Seat 5: landromede folded before Flop (didn't bet)
Seat 6: SantiagoWeight folded before Flop (didn't bet)



PokerStars Zoom Hand #195023507709:  Hold'em No Limit ($0.10/$0.25) - 2018/12/29 3:43:42 UTC [2018/12/28 22:43:42 ET]
Table 'Hydra' 6-max Seat #1 is the button
Seat 1: osa126 ($37.26 in chips) 
Seat 2: miru877 ($24.75 in chips) 
Seat 3: SantiagoWeight ($38.09 in chips) 
Seat 4: negreanuNya ($25 in chips) 
Seat 5: mariopork ($68.02 in chips) 
Seat 6: graysonai ($37.65 in chips) 
miru877: posts small blind $0.10
SantiagoWeight: posts big blind $0.25
*** HOLE CARDS ***
Dealt to SantiagoWeight [8c 7h]
negreanuNya: raises $0.35 to $0.60
mariopork: folds 
graysonai: folds 
osa126: folds 
miru877: folds 
SantiagoWeight: folds 
Uncalled bet ($0.35) returned to negreanuNya
negreanuNya collected $0.60 from pot
*** SUMMARY ***
Total pot $0.60 | Rake $0 
Seat 1: osa126 (button) folded before Flop (didn't bet)
Seat 2: miru877 (small blind) folded before Flop
Seat 3: SantiagoWeight (big blind) folded before Flop
Seat 4: negreanuNya collected ($0.60)
Seat 5: mariopork folded before Flop (didn't bet)
Seat 6: graysonai folded before Flop (didn't bet)



PokerStars Zoom Hand #195023514744:  Hold'em No Limit ($0.10/$0.25) - 2018/12/29 3:44:04 UTC [2018/12/28 22:44:04 ET]
Table 'Hydra' 6-max Seat #1 is the button
Seat 1: !P0K3RM3T4L! ($56.22 in chips) 
Seat 2: SantiagoWeight ($37.84 in chips) 
Seat 3: allin969 ($25 in chips) 
Seat 4: nhanminhtri ($30.44 in chips) 
Seat 5: call me??107 ($24.55 in chips) 
Seat 6: Party4Arthy ($56.67 in chips) 
SantiagoWeight: posts small blind $0.10
allin969: posts big blind $0.25
*** HOLE CARDS ***
Dealt to SantiagoWeight [4h 3s]
nhanminhtri: folds 
call me??107: folds 
Party4Arthy: folds 
!P0K3RM3T4L!: folds 
SantiagoWeight: folds 
Uncalled bet ($0.15) returned to allin969
allin969 collected $0.20 from pot
allin969: doesn't show hand 
*** SUMMARY ***
Total pot $0.20 | Rake $0 
Seat 1: !P0K3RM3T4L! (button) folded before Flop (didn't bet)
Seat 2: SantiagoWeight (small blind) folded before Flop
Seat 3: allin969 (big blind) collected ($0.20)
Seat 4: nhanminhtri folded before Flop (didn't bet)
Seat 5: call me??107 folded before Flop (didn't bet)
Seat 6: Party4Arthy folded before Flop (didn't bet)



PokerStars Zoom Hand #195023517880:  Hold'em No Limit ($0.10/$0.25) - 2018/12/29 3:44:14 UTC [2018/12/28 22:44:14 ET]
Table 'Hydra' 6-max Seat #1 is the button
Seat 1: SantiagoWeight ($37.74 in chips) 
Seat 2: allin969 ($25.10 in chips) 
Seat 3: ckriszee ($28.79 in chips) 
Seat 4: winwinboy ($25 in chips) 
Seat 5: tariko1980 ($21.83 in chips) 
Seat 6: miru877 ($60.37 in chips) 
allin969: posts small blind $0.10
ckriszee: posts big blind $0.25
*** HOLE CARDS ***
Dealt to SantiagoWeight [6c 9d]
winwinboy: folds 
tariko1980: folds 
miru877: raises $0.50 to $0.75
SantiagoWeight: folds 
allin969: folds 
ckriszee: folds 
Uncalled bet ($0.50) returned to miru877
miru877 collected $0.60 from pot
miru877: doesn't show hand 
*** SUMMARY ***
Total pot $0.60 | Rake $0 
Seat 1: SantiagoWeight (button) folded before Flop (didn't bet)
Seat 2: allin969 (small blind) folded before Flop
Seat 3: ckriszee (big blind) folded before Flop
Seat 4: winwinboy folded before Flop (didn't bet)
Seat 5: tariko1980 folded before Flop (didn't bet)
Seat 6: miru877 collected ($0.60)



PokerStars Zoom Hand #195023521346:  Hold'em No Limit ($0.10/$0.25) - 2018/12/29 3:44:25 UTC [2018/12/28 22:44:25 ET]
Table 'Hydra' 6-max Seat #1 is the button
Seat 1: angipoker ($12.50 in chips) 
Seat 2: TDAK1509 ($46.81 in chips) 
Seat 3: mariopork ($42.87 in chips) 
Seat 4: G ster24 ($32.29 in chips) 
Seat 5: SantiagoWeight ($37.74 in chips) 
Seat 6: CrazieFreddy ($11.76 in chips) 
TDAK1509: posts small blind $0.10
mariopork: posts big blind $0.25
*** HOLE CARDS ***
Dealt to SantiagoWeight [2h 4s]
G ster24: folds 
SantiagoWeight: folds 
CrazieFreddy: calls $0.25
angipoker: calls $0.25
TDAK1509: folds 
mariopork: checks 
*** FLOP *** [Qs As 2s]
mariopork: checks 
CrazieFreddy: bets $0.25
angipoker: folds 
mariopork: folds 
Uncalled bet ($0.25) returned to CrazieFreddy
CrazieFreddy collected $0.81 from pot
CrazieFreddy: doesn't show hand 
*** SUMMARY ***
Total pot $0.85 | Rake $0.04 
Board [Qs As 2s]
Seat 1: angipoker (button) folded on the Flop
Seat 2: TDAK1509 (small blind) folded before Flop
Seat 3: mariopork (big blind) folded on the Flop
Seat 4: G ster24 folded before Flop (didn't bet)
Seat 5: SantiagoWeight folded before Flop (didn't bet)
Seat 6: CrazieFreddy collected ($0.81)



PokerStars Zoom Hand #195023524631:  Hold'em No Limit ($0.10/$0.25) - 2018/12/29 3:44:35 UTC [2018/12/28 22:44:35 ET]
Table 'Hydra' 6-max Seat #1 is the button
Seat 1: FSK78 ($88.92 in chips) 
Seat 2: gaffer31 ($32.93 in chips) 
Seat 3: Rollout2018 ($39.72 in chips) 
Seat 4: SantiagoWeight ($37.74 in chips) 
Seat 5: pirosiky ($52.52 in chips) 
Seat 6: KeySssi ($25 in chips) 
gaffer31: posts small blind $0.10
Rollout2018: posts big blind $0.25
*** HOLE CARDS ***
Dealt to SantiagoWeight [Ts Ah]
SantiagoWeight: raises $0.42 to $0.67
pirosiky: folds 
KeySssi: folds 
FSK78: raises $0.58 to $1.25
gaffer31: calls $1.15
Rollout2018: folds 
SantiagoWeight: calls $0.58
*** FLOP *** [Qd 3c Tc]
gaffer31: checks 
SantiagoWeight: checks 
FSK78: bets $3.75
gaffer31: calls $3.75
SantiagoWeight: folds 
*** TURN *** [Qd 3c Tc] [5s]
gaffer31: checks 
FSK78: bets $5.50
gaffer31: folds 
Uncalled bet ($5.50) returned to FSK78
FSK78 collected $10.98 from pot
FSK78: doesn't show hand 
*** SUMMARY ***
Total pot $11.50 | Rake $0.52 
Board [Qd 3c Tc 5s]
Seat 1: FSK78 (button) collected ($10.98)
Seat 2: gaffer31 (small blind) folded on the Turn
Seat 3: Rollout2018 (big blind) folded before Flop
Seat 4: SantiagoWeight folded on the Flop
Seat 5: pirosiky folded before Flop (didn't bet)
Seat 6: KeySssi folded before Flop (didn't bet)



PokerStars Zoom Hand #195023548585:  Hold'em No Limit ($0.10/$0.25) - 2018/12/29 3:45:35 UTC [2018/12/28 22:45:35 ET]
Table 'Hydra' 6-max Seat #1 is the button
Seat 1: ColinCaine ($21.61 in chips) 
Seat 2: G ster24 ($38.95 in chips) 
Seat 3: SantiagoWeight ($36.49 in chips) 
Seat 4: onhoang87 ($21.80 in chips) 
Seat 5: HonourMan23 ($97.45 in chips) 
Seat 6: pirosiky ($53.17 in chips) 
G ster24: posts small blind $0.10
SantiagoWeight: posts big blind $0.25
*** HOLE CARDS ***
Dealt to SantiagoWeight [9c Kh]
onhoang87: folds 
HonourMan23: raises $0.30 to $0.55
pirosiky: folds 
ColinCaine: calls $0.55
G ster24: folds 
SantiagoWeight: folds 
*** FLOP *** [6d 3d 8h]
HonourMan23: checks 
ColinCaine: bets $0.75
HonourMan23: folds 
Uncalled bet ($0.75) returned to ColinCaine
ColinCaine collected $1.38 from pot
ColinCaine: doesn't show hand 
*** SUMMARY ***
Total pot $1.45 | Rake $0.07 
Board [6d 3d 8h]
Seat 1: ColinCaine (button) collected ($1.38)
Seat 2: G ster24 (small blind) folded before Flop
Seat 3: SantiagoWeight (big blind) folded before Flop
Seat 4: onhoang87 folded before Flop (didn't bet)
Seat 5: HonourMan23 folded on the Flop
Seat 6: pirosiky folded before Flop (didn't bet)



PokerStars Zoom Hand #195023561603:  Hold'em No Limit ($0.10/$0.25) - 2018/12/29 3:46:16 UTC [2018/12/28 22:46:16 ET]
Table 'Hydra' 6-max Seat #1 is the button
Seat 1: pfunkolstar ($25.74 in chips) 
Seat 2: SantiagoWeight ($36.24 in chips) 
Seat 3: reademenweep ($13.68 in chips) 
Seat 4: Nutselas ($73.25 in chips) 
Seat 5: Renner32 ($25.22 in chips) 
Seat 6: golf7287 ($34.65 in chips) 
SantiagoWeight: posts small blind $0.10
reademenweep: posts big blind $0.25
*** HOLE CARDS ***
Dealt to SantiagoWeight [6d 3h]
Nutselas: folds 
Renner32: folds 
golf7287: folds 
pfunkolstar: folds 
SantiagoWeight: folds 
Uncalled bet ($0.15) returned to reademenweep
reademenweep collected $0.20 from pot
reademenweep: doesn't show hand 
*** SUMMARY ***
Total pot $0.20 | Rake $0 
Seat 1: pfunkolstar (button) folded before Flop (didn't bet)
Seat 2: SantiagoWeight (small blind) folded before Flop
Seat 3: reademenweep (big blind) collected ($0.20)
Seat 4: Nutselas folded before Flop (didn't bet)
Seat 5: Renner32 folded before Flop (didn't bet)
Seat 6: golf7287 folded before Flop (didn't bet)



PokerStars Zoom Hand #195023560360:  Hold'em No Limit ($0.10/$0.25) - 2018/12/29 3:46:12 UTC [2018/12/28 22:46:12 ET]
Table 'Hydra' 6-max Seat #1 is the button
Seat 1: zhang1zhang ($25 in chips) 
Seat 2: Albratros2 ($22.53 in chips) 
Seat 3: Dr.Jekyll197 ($15.87 in chips) 
Seat 4: SantiagoWeight ($36.24 in chips) 
Seat 5: Nutselas ($57.44 in chips) 
Seat 6: Xp0Hb ($41.20 in chips) 
Albratros2: posts small blind $0.10
Dr.Jekyll197: posts big blind $0.25
*** HOLE CARDS ***
Dealt to SantiagoWeight [Qs 9c]
SantiagoWeight: folds 
Nutselas: folds 
Xp0Hb: raises $0.50 to $0.75
zhang1zhang: folds 
Albratros2: calls $0.65
Dr.Jekyll197: folds 
*** FLOP *** [2h Ad 9s]
Albratros2: checks 
Xp0Hb: bets $0.75
Albratros2: calls $0.75
*** TURN *** [2h Ad 9s] [Kd]
Albratros2: checks 
Xp0Hb: checks 
*** RIVER *** [2h Ad 9s Kd] [4s]
Albratros2: checks 
Xp0Hb: checks 
*** SHOW DOWN ***
Albratros2: shows [Js Th] (high card Ace)
Xp0Hb: shows [8d Ah] (a pair of Aces)
Xp0Hb collected $3.10 from pot
*** SUMMARY ***
Total pot $3.25 | Rake $0.15 
Board [2h Ad 9s Kd 4s]
Seat 1: zhang1zhang (button) folded before Flop (didn't bet)
Seat 2: Albratros2 (small blind) showed [Js Th] and lost with high card Ace
Seat 3: Dr.Jekyll197 (big blind) folded before Flop
Seat 4: SantiagoWeight folded before Flop (didn't bet)
Seat 5: Nutselas folded before Flop (didn't bet)
Seat 6: Xp0Hb showed [8d Ah] and won ($3.10) with a pair of Aces



PokerStars Zoom Hand #195023554659:  Hold'em No Limit ($0.10/$0.25) - 2018/12/29 3:45:54 UTC [2018/12/28 22:45:54 ET]
Table 'Hydra' 6-max Seat #1 is the button
Seat 1: BMB8888 ($28.18 in chips) 
Seat 2: Nutselas ($25 in chips) 
Seat 3: _BluDeeN_ ($31.25 in chips) 
Seat 4: SantiagoWeight ($36.24 in chips) 
Seat 5: zzzMASTERzzz ($12.86 in chips) 
Seat 6: ryanking99 ($33.53 in chips) 
Nutselas: posts small blind $0.10
_BluDeeN_: posts big blind $0.25
*** HOLE CARDS ***
Dealt to SantiagoWeight [Ah 5c]
SantiagoWeight: folds 
zzzMASTERzzz: folds 
ryanking99: raises $0.31 to $0.56
BMB8888: calls $0.56
Nutselas: folds 
_BluDeeN_: folds 
*** FLOP *** [3c 5s 3d]
ryanking99: checks 
BMB8888: bets $0.25
ryanking99: calls $0.25
*** TURN *** [3c 5s 3d] [8d]
ryanking99: checks 
BMB8888: bets $1
ryanking99: raises $1.28 to $2.28
BMB8888: calls $1.28
*** RIVER *** [3c 5s 3d 8d] [2s]
ryanking99: bets $3.31
BMB8888: folds 
Uncalled bet ($3.31) returned to ryanking99
ryanking99 collected $6.24 from pot
ryanking99: doesn't show hand 
*** SUMMARY ***
Total pot $6.53 | Rake $0.29 
Board [3c 5s 3d 8d 2s]
Seat 1: BMB8888 (button) folded on the River
Seat 2: Nutselas (small blind) folded before Flop
Seat 3: _BluDeeN_ (big blind) folded before Flop
Seat 4: SantiagoWeight folded before Flop (didn't bet)
Seat 5: zzzMASTERzzz folded before Flop (didn't bet)
Seat 6: ryanking99 collected ($6.24)



PokerStars Zoom Hand #195023563143:  Hold'em No Limit ($0.10/$0.25) - 2018/12/29 3:46:21 UTC [2018/12/28 22:46:21 ET]
Table 'Hydra' 6-max Seat #1 is the button
Seat 1: SantiagoWeight ($36.14 in chips) 
Seat 2: ckriszee ($44.39 in chips) 
Seat 3: reggiedogg31 ($99.22 in chips) 
Seat 4: golf7287 ($34.65 in chips) 
Seat 5: Chellabro ($37.98 in chips) 
Seat 6: MoMoney2612 ($25.86 in chips) 
ckriszee: posts small blind $0.10
reggiedogg31: posts big blind $0.25
*** HOLE CARDS ***
Dealt to SantiagoWeight [6d 6c]
golf7287: folds 
Chellabro: folds 
MoMoney2612: raises $0.31 to $0.56
SantiagoWeight: calls $0.56
ckriszee: folds 
reggiedogg31: folds 
*** FLOP *** [7s Th 8s]
MoMoney2612: bets $1.04
SantiagoWeight: calls $1.04
*** TURN *** [7s Th 8s] [8d]
MoMoney2612: bets $2.51
SantiagoWeight: folds 
Uncalled bet ($2.51) returned to MoMoney2612
MoMoney2612 collected $3.39 from pot
*** SUMMARY ***
Total pot $3.55 | Rake $0.16 
Board [7s Th 8s 8d]
Seat 1: SantiagoWeight (button) folded on the Turn
Seat 2: ckriszee (small blind) folded before Flop
Seat 3: reggiedogg31 (big blind) folded before Flop
Seat 4: golf7287 folded before Flop (didn't bet)
Seat 5: Chellabro folded before Flop (didn't bet)
Seat 6: MoMoney2612 collected ($3.39)



PokerStars Zoom Hand #195023583901:  Hold'em No Limit ($0.10/$0.25) - 2018/12/29 3:47:27 UTC [2018/12/28 22:47:27 ET]
Table 'Hydra' 6-max Seat #1 is the button
Seat 1: ttshead ($63.87 in chips) 
Seat 2: xman141 ($40.47 in chips) 
Seat 3: MoMoney2612 ($47.97 in chips) 
Seat 4: golf7287 ($35 in chips) 
Seat 5: 2poiRiver ($23.80 in chips) 
Seat 6: SantiagoWeight ($34.54 in chips) 
xman141: posts small blind $0.10
MoMoney2612: posts big blind $0.25
*** HOLE CARDS ***
Dealt to SantiagoWeight [3s Th]
golf7287: folds 
2poiRiver: folds 
SantiagoWeight: folds 
ttshead: folds 
xman141: folds 
Uncalled bet ($0.15) returned to MoMoney2612
MoMoney2612 collected $0.20 from pot
MoMoney2612: doesn't show hand 
*** SUMMARY ***
Total pot $0.20 | Rake $0 
Seat 1: ttshead (button) folded before Flop (didn't bet)
Seat 2: xman141 (small blind) folded before Flop
Seat 3: MoMoney2612 (big blind) collected ($0.20)
Seat 4: golf7287 folded before Flop (didn't bet)
Seat 5: 2poiRiver folded before Flop (didn't bet)
Seat 6: SantiagoWeight folded before Flop (didn't bet)



PokerStars Zoom Hand #195023587021:  Hold'em No Limit ($0.10/$0.25) - 2018/12/29 3:47:37 UTC [2018/12/28 22:47:37 ET]
Table 'Hydra' 6-max Seat #1 is the button
Seat 1: TDAK1509 ($36.84 in chips) 
Seat 2: !P0K3RM3T4L! ($30.71 in chips) 
Seat 3: pRoma66 ($27.27 in chips) 
Seat 4: Viiiru ($68.24 in chips) 
Seat 5: HonourMan23 ($94.95 in chips) 
Seat 6: SantiagoWeight ($34.54 in chips) 
!P0K3RM3T4L!: posts small blind $0.10
pRoma66: posts big blind $0.25
*** HOLE CARDS ***
Dealt to SantiagoWeight [Kd 9d]
Viiiru: raises $0.50 to $0.75
HonourMan23: folds 
SantiagoWeight: folds 
TDAK1509: folds 
!P0K3RM3T4L!: folds 
pRoma66: folds 
Uncalled bet ($0.50) returned to Viiiru
Viiiru collected $0.60 from pot
Viiiru: doesn't show hand 
*** SUMMARY ***
Total pot $0.60 | Rake $0 
Seat 1: TDAK1509 (button) folded before Flop (didn't bet)
Seat 2: !P0K3RM3T4L! (small blind) folded before Flop
Seat 3: pRoma66 (big blind) folded before Flop
Seat 4: Viiiru collected ($0.60)
Seat 5: HonourMan23 folded before Flop (didn't bet)
Seat 6: SantiagoWeight folded before Flop (didn't bet)



PokerStars Zoom Hand #195023594844:  Hold'em No Limit ($0.10/$0.25) - 2018/12/29 3:48:02 UTC [2018/12/28 22:48:02 ET]
Table 'Hydra' 6-max Seat #1 is the button
Seat 1: ttshead ($63.87 in chips) 
Seat 2: Nutselas ($74.92 in chips) 
Seat 3: SantiagoWeight ($34.54 in chips) 
Seat 4: franco373513 ($12.54 in chips) 
Seat 5: aldoalb0207 ($47.25 in chips) 
Seat 6: Chellabro ($36.38 in chips) 
Nutselas: posts small blind $0.10
SantiagoWeight: posts big blind $0.25
*** HOLE CARDS ***
Dealt to SantiagoWeight [2d 7s]
franco373513: folds 
aldoalb0207: raises $0.25 to $0.50
Chellabro: folds 
ttshead: folds 
Nutselas: folds 
SantiagoWeight: folds 
Uncalled bet ($0.25) returned to aldoalb0207
aldoalb0207 collected $0.60 from pot
aldoalb0207: doesn't show hand 
*** SUMMARY ***
Total pot $0.60 | Rake $0 
Seat 1: ttshead (button) folded before Flop (didn't bet)
Seat 2: Nutselas (small blind) folded before Flop
Seat 3: SantiagoWeight (big blind) folded before Flop
Seat 4: franco373513 folded before Flop (didn't bet)
Seat 5: aldoalb0207 collected ($0.60)
Seat 6: Chellabro folded before Flop (didn't bet)



PokerStars Zoom Hand #195023598573:  Hold'em No Limit ($0.10/$0.25) - 2018/12/29 3:48:14 UTC [2018/12/28 22:48:14 ET]
Table 'Hydra' 6-max Seat #1 is the button
Seat 1: SantiagoWeight ($34.29 in chips) 
Seat 2: zbuci ($22.32 in chips) 
Seat 3: river plate9 ($25 in chips) 
Seat 4: golf7287 ($34.90 in chips) 
Seat 5: ivann14 ($67.92 in chips) 
Seat 6: Lehared ($26.08 in chips) 
zbuci: posts small blind $0.10
river plate9: posts big blind $0.25
*** HOLE CARDS ***
Dealt to SantiagoWeight [8s 6c]
golf7287: folds 
ivann14: folds 
Lehared: folds 
SantiagoWeight: folds 
zbuci: raises $0.50 to $0.75
river plate9: folds 
Uncalled bet ($0.50) returned to zbuci
zbuci collected $0.50 from pot
zbuci: doesn't show hand 
*** SUMMARY ***
Total pot $0.50 | Rake $0 
Seat 1: SantiagoWeight (button) folded before Flop (didn't bet)
Seat 2: zbuci (small blind) collected ($0.50)
Seat 3: river plate9 (big blind) folded before Flop
Seat 4: golf7287 folded before Flop (didn't bet)
Seat 5: ivann14 folded before Flop (didn't bet)
Seat 6: Lehared folded before Flop (didn't bet)



PokerStars Zoom Hand #195023611801:  Hold'em No Limit ($0.10/$0.25) - 2018/12/29 3:48:57 UTC [2018/12/28 22:48:57 ET]
Table 'Hydra' 6-max Seat #1 is the button
Seat 1: ryanking99 ($38.11 in chips) 
Seat 2: HansMSM ($67.86 in chips) 
Seat 3: winwinboy ($27.10 in chips) 
Seat 4: nhanminhtri ($25 in chips) 
Seat 5: SantiagoWeight ($34.19 in chips) 
Seat 6: miru877 ($23.04 in chips) 
HansMSM: posts small blind $0.10
winwinboy: posts big blind $0.25
*** HOLE CARDS ***
Dealt to SantiagoWeight [6s Ts]
nhanminhtri: folds 
SantiagoWeight: folds 
miru877: folds 
ryanking99: raises $0.31 to $0.56
HansMSM: raises $1.54 to $2.10
winwinboy: folds 
ryanking99: folds 
Uncalled bet ($1.54) returned to HansMSM
HansMSM collected $1.37 from pot
HansMSM: doesn't show hand 
*** SUMMARY ***
Total pot $1.37 | Rake $0 
Seat 1: ryanking99 (button) folded before Flop
Seat 2: HansMSM (small blind) collected ($1.37)
Seat 3: winwinboy (big blind) folded before Flop
Seat 4: nhanminhtri folded before Flop (didn't bet)
Seat 5: SantiagoWeight folded before Flop (didn't bet)
Seat 6: miru877 folded before Flop (didn't bet)



PokerStars Zoom Hand #195023601412:  Hold'em No Limit ($0.10/$0.25) - 2018/12/29 3:48:23 UTC [2018/12/28 22:48:23 ET]
Table 'Hydra' 6-max Seat #1 is the button
Seat 1: Renner32 ($23.73 in chips) 
Seat 2: SantiagoWeight ($34.29 in chips) 
Seat 3: gaffer31 ($24.90 in chips) 
Seat 4: zdenekstavic ($41.94 in chips) 
Seat 5: _BluDeeN_ ($32.14 in chips) 
Seat 6: anorectal ($25 in chips) 
SantiagoWeight: posts small blind $0.10
gaffer31: posts big blind $0.25
*** HOLE CARDS ***
Dealt to SantiagoWeight [Ks Js]
zdenekstavic: folds 
_BluDeeN_: raises $0.50 to $0.75
anorectal: folds 
Renner32: folds 
SantiagoWeight: folds 
gaffer31: calls $0.50
*** FLOP *** [3s 8s Jh]
gaffer31: checks 
_BluDeeN_: bets $1.25
gaffer31: calls $1.25
*** TURN *** [3s 8s Jh] [Tc]
gaffer31: checks 
_BluDeeN_: bets $3.25
gaffer31: folds 
Uncalled bet ($3.25) returned to _BluDeeN_
_BluDeeN_ collected $3.92 from pot
_BluDeeN_: doesn't show hand 
*** SUMMARY ***
Total pot $4.10 | Rake $0.18 
Board [3s 8s Jh Tc]
Seat 1: Renner32 (button) folded before Flop (didn't bet)
Seat 2: SantiagoWeight (small blind) folded before Flop
Seat 3: gaffer31 (big blind) folded on the Turn
Seat 4: zdenekstavic folded before Flop (didn't bet)
Seat 5: _BluDeeN_ collected ($3.92)
Seat 6: anorectal folded before Flop (didn't bet)



PokerStars Zoom Hand #195023609062:  Hold'em No Limit ($0.10/$0.25) - 2018/12/29 3:48:48 UTC [2018/12/28 22:48:48 ET]
Table 'Hydra' 6-max Seat #1 is the button
Seat 1: davidhw888 ($12.45 in chips) 
Seat 2: miba16 ($24.25 in chips) 
Seat 3: trttt74 ($30.26 in chips) 
Seat 4: Albratros2 ($18.45 in chips) 
Seat 5: SantiagoWeight ($34.19 in chips) 
Seat 6: dithflo ($25 in chips) 
miba16: posts small blind $0.10
trttt74: posts big blind $0.25
*** HOLE CARDS ***
Dealt to SantiagoWeight [3h 2h]
Albratros2: folds 
SantiagoWeight: folds 
dithflo: raises $0.25 to $0.50
davidhw888: folds 
miba16: calls $0.40
trttt74: calls $0.25
*** FLOP *** [Jc 5h 2c]
miba16: checks 
trttt74: checks 
dithflo: checks 
*** TURN *** [Jc 5h 2c] [Qc]
miba16: bets $0.75
trttt74: folds 
dithflo: folds 
Uncalled bet ($0.75) returned to miba16
miba16 collected $1.43 from pot
miba16: doesn't show hand 
*** SUMMARY ***
Total pot $1.50 | Rake $0.07 
Board [Jc 5h 2c Qc]
Seat 1: davidhw888 (button) folded before Flop (didn't bet)
Seat 2: miba16 (small blind) collected ($1.43)
Seat 3: trttt74 (big blind) folded on the Turn
Seat 4: Albratros2 folded before Flop (didn't bet)
Seat 5: SantiagoWeight folded before Flop (didn't bet)
Seat 6: dithflo folded on the Turn



PokerStars Zoom Hand #195023613673:  Hold'em No Limit ($0.10/$0.25) - 2018/12/29 3:49:03 UTC [2018/12/28 22:49:03 ET]
Table 'Hydra' 6-max Seat #1 is the button
Seat 1: BIGPAIN14 ($26.60 in chips) 
Seat 2: GrandmasterY ($56.89 in chips) 
Seat 3: SantiagoWeight ($34.19 in chips) 
Seat 4: Chrimmpam ($16.96 in chips) 
Seat 5: miru877 ($23.04 in chips) 
Seat 6: 666erkan ($22.85 in chips) 
GrandmasterY: posts small blind $0.10
SantiagoWeight: posts big blind $0.25
*** HOLE CARDS ***
Dealt to SantiagoWeight [3s Kd]
Chrimmpam: raises $0.60 to $0.85
miru877: folds 
666erkan: calls $0.85
BIGPAIN14: calls $0.85
GrandmasterY: folds 
SantiagoWeight: folds 
*** FLOP *** [4c 4h 4s]
Chrimmpam: checks 
666erkan: checks 
BIGPAIN14: checks 
*** TURN *** [4c 4h 4s] [Js]
Chrimmpam: checks 
666erkan: checks 
BIGPAIN14: bets $1.39
Chrimmpam: folds 
666erkan: folds 
Uncalled bet ($1.39) returned to BIGPAIN14
BIGPAIN14 collected $2.77 from pot
BIGPAIN14: doesn't show hand 
*** SUMMARY ***
Total pot $2.90 | Rake $0.13 
Board [4c 4h 4s Js]
Seat 1: BIGPAIN14 (button) collected ($2.77)
Seat 2: GrandmasterY (small blind) folded before Flop
Seat 3: SantiagoWeight (big blind) folded before Flop
Seat 4: Chrimmpam folded on the Turn
Seat 5: miru877 folded before Flop (didn't bet)
Seat 6: 666erkan folded on the Turn



PokerStars Zoom Hand #195023617442:  Hold'em No Limit ($0.10/$0.25) - 2018/12/29 3:49:15 UTC [2018/12/28 22:49:15 ET]
Table 'Hydra' 6-max Seat #1 is the button
Seat 1: Ovanes911 ($16.54 in chips) 
Seat 2: SantiagoWeight ($33.94 in chips) 
Seat 3: mojsza1 ($25 in chips) 
Seat 4: CrazieFreddy ($6.27 in chips) 
Seat 5: Renner32 ($23.73 in chips) 
Seat 6: pRoma66 ($26.25 in chips) 
SantiagoWeight: posts small blind $0.10
mojsza1: posts big blind $0.25
*** HOLE CARDS ***
Dealt to SantiagoWeight [9s Ks]
CrazieFreddy: raises $0.50 to $0.75
Renner32: folds 
pRoma66: folds 
Ovanes911: calls $0.75
SantiagoWeight: folds 
mojsza1: folds 
*** FLOP *** [2c Th 6s]
CrazieFreddy: checks 
Ovanes911: bets $0.89
CrazieFreddy: calls $0.89
*** TURN *** [2c Th 6s] [4c]
CrazieFreddy: checks 
Ovanes911: checks 
*** RIVER *** [2c Th 6s 4c] [Ah]
CrazieFreddy: bets $1
Ovanes911: raises $1 to $2
CrazieFreddy: raises $2.63 to $4.63 and is all-in
Ovanes911: calls $2.63
*** SHOW DOWN ***
CrazieFreddy: shows [As Kh] (a pair of Aces)
Ovanes911: shows [Ad Qc] (a pair of Aces - lower kicker)
CrazieFreddy collected $12.31 from pot
*** SUMMARY ***
Total pot $12.89 | Rake $0.58 
Board [2c Th 6s 4c Ah]
Seat 1: Ovanes911 (button) showed [Ad Qc] and lost with a pair of Aces
Seat 2: SantiagoWeight (small blind) folded before Flop
Seat 3: mojsza1 (big blind) folded before Flop
Seat 4: CrazieFreddy showed [As Kh] and won ($12.31) with a pair of Aces
Seat 5: Renner32 folded before Flop (didn't bet)
Seat 6: pRoma66 folded before Flop (didn't bet)



PokerStars Zoom Hand #195023628280:  Hold'em No Limit ($0.10/$0.25) - 2018/12/29 3:49:50 UTC [2018/12/28 22:49:50 ET]
Table 'Hydra' 6-max Seat #1 is the button
Seat 1: KeySssi ($25 in chips) 
Seat 2: zbuci ($21.77 in chips) 
Seat 3: aa1421b ($40.66 in chips) 
Seat 4: SantiagoWeight ($33.84 in chips) 
Seat 5: ckriszee ($28.40 in chips) 
Seat 6: gaffer31 ($22.65 in chips) 
zbuci: posts small blind $0.10
aa1421b: posts big blind $0.25
*** HOLE CARDS ***
Dealt to SantiagoWeight [9h Ac]
SantiagoWeight: folds 
ckriszee: folds 
gaffer31: folds 
KeySssi: folds 
zbuci: folds 
Uncalled bet ($0.15) returned to aa1421b
aa1421b collected $0.20 from pot
aa1421b: doesn't show hand 
*** SUMMARY ***
Total pot $0.20 | Rake $0 
Seat 1: KeySssi (button) folded before Flop (didn't bet)
Seat 2: zbuci (small blind) folded before Flop
Seat 3: aa1421b (big blind) collected ($0.20)
Seat 4: SantiagoWeight folded before Flop (didn't bet)
Seat 5: ckriszee folded before Flop (didn't bet)
Seat 6: gaffer31 folded before Flop (didn't bet)



PokerStars Zoom Hand #195023626738:  Hold'em No Limit ($0.10/$0.25) - 2018/12/29 3:49:45 UTC [2018/12/28 22:49:45 ET]
Table 'Hydra' 6-max Seat #1 is the button
Seat 1: aa1421b ($40.66 in chips) 
Seat 2: Boew_75 ($4.26 in chips) 
Seat 3: miru877 ($22.73 in chips) 
Seat 4: Xp0Hb ($40.85 in chips) 
Seat 5: call me??107 ($8.32 in chips) 
Seat 6: SantiagoWeight ($33.84 in chips) 
Boew_75: posts small blind $0.10
miru877: posts big blind $0.25
*** HOLE CARDS ***
Dealt to SantiagoWeight [Th 5d]
Xp0Hb: folds 
call me??107: raises $0.60 to $0.85
SantiagoWeight: folds 
aa1421b: folds 
Boew_75: calls $0.75
miru877: folds 
*** FLOP *** [3h 4s 4d]
Boew_75: checks 
call me??107: bets $7.47 and is all-in
Boew_75: folds 
Uncalled bet ($7.47) returned to call me??107
call me??107 collected $1.86 from pot
call me??107: doesn't show hand 
*** SUMMARY ***
Total pot $1.95 | Rake $0.09 
Board [3h 4s 4d]
Seat 1: aa1421b (button) folded before Flop (didn't bet)
Seat 2: Boew_75 (small blind) folded on the Flop
Seat 3: miru877 (big blind) folded before Flop
Seat 4: Xp0Hb folded before Flop (didn't bet)
Seat 5: call me??107 collected ($1.86)
Seat 6: SantiagoWeight folded before Flop (didn't bet)



PokerStars Zoom Hand #195023634315:  Hold'em No Limit ($0.10/$0.25) - 2018/12/29 3:50:10 UTC [2018/12/28 22:50:10 ET]
Table 'Hydra' 6-max Seat #1 is the button
Seat 1: ruiken ($32.74 in chips) 
Seat 2: nhanminhtri ($28.80 in chips) 
Seat 3: HansMSM ($55.22 in chips) 
Seat 4: winwinboy ($25.68 in chips) 
Seat 5: 2poiRiver ($19.70 in chips) 
Seat 6: SantiagoWeight ($33.84 in chips) 
nhanminhtri: posts small blind $0.10
HansMSM: posts big blind $0.25
*** HOLE CARDS ***
Dealt to SantiagoWeight [8s Jd]
winwinboy: folds 
2poiRiver: folds 
SantiagoWeight: folds 
ruiken: folds 
nhanminhtri: folds 
Uncalled bet ($0.15) returned to HansMSM
HansMSM collected $0.20 from pot
HansMSM: doesn't show hand 
*** SUMMARY ***
Total pot $0.20 | Rake $0 
Seat 1: ruiken (button) folded before Flop (didn't bet)
Seat 2: nhanminhtri (small blind) folded before Flop
Seat 3: HansMSM (big blind) collected ($0.20)
Seat 4: winwinboy folded before Flop (didn't bet)
Seat 5: 2poiRiver folded before Flop (didn't bet)
Seat 6: SantiagoWeight folded before Flop (didn't bet)



PokerStars Zoom Hand #195023630087:  Hold'em No Limit ($0.10/$0.25) - 2018/12/29 3:49:56 UTC [2018/12/28 22:49:56 ET]
Table 'Hydra' 6-max Seat #1 is the button
Seat 1: petanquemeis ($24.05 in chips) 
Seat 2: numbernine5 ($58.24 in chips) 
Seat 3: KingsOfEdm ($23.30 in chips) 
Seat 4: zhang1zhang ($25 in chips) 
Seat 5: SantiagoWeight ($33.84 in chips) 
Seat 6: onhoang87 ($28.13 in chips) 
numbernine5: posts small blind $0.10
KingsOfEdm: posts big blind $0.25
*** HOLE CARDS ***
Dealt to SantiagoWeight [3h 7c]
zhang1zhang: raises $0.50 to $0.75
SantiagoWeight: folds 
onhoang87: calls $0.75
petanquemeis: folds 
numbernine5: folds 
KingsOfEdm: folds 
*** FLOP *** [8s Ks 5s]
zhang1zhang: checks 
onhoang87: bets $1.75
zhang1zhang: folds 
Uncalled bet ($1.75) returned to onhoang87
onhoang87 collected $1.77 from pot
onhoang87: doesn't show hand 
*** SUMMARY ***
Total pot $1.85 | Rake $0.08 
Board [8s Ks 5s]
Seat 1: petanquemeis (button) folded before Flop (didn't bet)
Seat 2: numbernine5 (small blind) folded before Flop
Seat 3: KingsOfEdm (big blind) folded before Flop
Seat 4: zhang1zhang folded on the Flop
Seat 5: SantiagoWeight folded before Flop (didn't bet)
Seat 6: onhoang87 collected ($1.77)



PokerStars Zoom Hand #195023637744:  Hold'em No Limit ($0.10/$0.25) - 2018/12/29 3:50:21 UTC [2018/12/28 22:50:21 ET]
Table 'Hydra' 6-max Seat #1 is the button
Seat 1: Renner32 ($23.38 in chips) 
Seat 2: river plate9 ($25.19 in chips) 
Seat 3: SantiagoWeight ($33.84 in chips) 
Seat 4: ssrace ($34.05 in chips) 
Seat 5: Bonen18 ($25 in chips) 
Seat 6: vigos king ($52.89 in chips) 
river plate9: posts small blind $0.10
SantiagoWeight: posts big blind $0.25
*** HOLE CARDS ***
Dealt to SantiagoWeight [Tc 8h]
ssrace: folds 
Bonen18: folds 
vigos king: raises $0.37 to $0.62
Renner32: folds 
river plate9: folds 
SantiagoWeight: folds 
Uncalled bet ($0.37) returned to vigos king
vigos king collected $0.60 from pot
*** SUMMARY ***
Total pot $0.60 | Rake $0 
Seat 1: Renner32 (button) folded before Flop (didn't bet)
Seat 2: river plate9 (small blind) folded before Flop
Seat 3: SantiagoWeight (big blind) folded before Flop
Seat 4: ssrace folded before Flop (didn't bet)
Seat 5: Bonen18 folded before Flop (didn't bet)
Seat 6: vigos king collected ($0.60)



PokerStars Zoom Hand #195023623025:  Hold'em No Limit ($0.10/$0.25) - 2018/12/29 3:49:33 UTC [2018/12/28 22:49:33 ET]
Table 'Hydra' 6-max Seat #1 is the button
Seat 1: SantiagoWeight ($33.84 in chips) 
Seat 2: Lehared ($72.32 in chips) 
Seat 3: ttshead ($63.42 in chips) 
Seat 4: Elapostador33 ($20.05 in chips) 
Seat 5: _BluDeeN_ ($33.96 in chips) 
Seat 6: HansMSM ($58.77 in chips) 
Lehared: posts small blind $0.10
ttshead: posts big blind $0.25
*** HOLE CARDS ***
Dealt to SantiagoWeight [4c Jd]
Elapostador33: folds 
_BluDeeN_: folds 
HansMSM: raises $0.45 to $0.70
SantiagoWeight: folds 
Lehared: calls $0.60
ttshead: calls $0.45
*** FLOP *** [As 9h 4s]
Lehared: checks 
ttshead: checks 
HansMSM: bets $1.01
Lehared: calls $1.01
ttshead: raises $3.24 to $4.25
HansMSM: folds 
Lehared: calls $3.24
*** TURN *** [As 9h 4s] [8d]
Lehared: checks 
ttshead: bets $7.32
Lehared: calls $7.32
*** RIVER *** [As 9h 4s 8d] [6d]
Lehared: checks 
ttshead: checks 
*** SHOW DOWN ***
Lehared: shows [9s 8s] (two pair, Nines and Eights)
ttshead: mucks hand 
Lehared collected $25.07 from pot
*** SUMMARY ***
Total pot $26.25 | Rake $1.18 
Board [As 9h 4s 8d 6d]
Seat 1: SantiagoWeight (button) folded before Flop (didn't bet)
Seat 2: Lehared (small blind) showed [9s 8s] and won ($25.07) with two pair, Nines and Eights
Seat 3: ttshead (big blind) mucked [Js Qs]
Seat 4: Elapostador33 folded before Flop (didn't bet)
Seat 5: _BluDeeN_ folded before Flop (didn't bet)
Seat 6: HansMSM folded on the Flop



PokerStars Zoom Hand #195023643884:  Hold'em No Limit ($0.10/$0.25) - 2018/12/29 3:50:41 UTC [2018/12/28 22:50:41 ET]
Table 'Hydra' 6-max Seat #1 is the button
Seat 1: BIGPAIN14 ($28.17 in chips) 
Seat 2: SantiagoWeight ($33.59 in chips) 
Seat 3: Ovanes911 ($19.71 in chips) 
Seat 4: donmarc777 ($91.28 in chips) 
Seat 5: miaozhuang ($24.03 in chips) 
Seat 6: yobbos ($119 in chips) 
SantiagoWeight: posts small blind $0.10
Ovanes911: posts big blind $0.25
*** HOLE CARDS ***
Dealt to SantiagoWeight [6c 3d]
donmarc777: folds 
miaozhuang: folds 
yobbos: folds 
BIGPAIN14: raises $0.50 to $0.75
SantiagoWeight: folds 
Ovanes911: raises $0.75 to $1.50
BIGPAIN14: raises $2 to $3.50
Ovanes911: calls $2
*** FLOP *** [7h 3s 4s]
Ovanes911: bets $3.39
BIGPAIN14: raises $4.11 to $7.50
Ovanes911: raises $8.71 to $16.21 and is all-in
BIGPAIN14: calls $8.71
*** TURN *** [7h 3s 4s] [Kh]
*** RIVER *** [7h 3s 4s Kh] [5d]
*** SHOW DOWN ***
Ovanes911: shows [9s Qd] (high card King)
BIGPAIN14: shows [Ah Ad] (a pair of Aces)
BIGPAIN14 collected $37.74 from pot
*** SUMMARY ***
Total pot $39.52 | Rake $1.78 
Board [7h 3s 4s Kh 5d]
Seat 1: BIGPAIN14 (button) showed [Ah Ad] and won ($37.74) with a pair of Aces
Seat 2: SantiagoWeight (small blind) folded before Flop
Seat 3: Ovanes911 (big blind) showed [9s Qd] and lost with high card King
Seat 4: donmarc777 folded before Flop (didn't bet)
Seat 5: miaozhuang folded before Flop (didn't bet)
Seat 6: yobbos folded before Flop (didn't bet)



PokerStars Zoom Hand #195023648174:  Hold'em No Limit ($0.10/$0.25) - 2018/12/29 3:50:55 UTC [2018/12/28 22:50:55 ET]
Table 'Hydra' 6-max Seat #1 is the button
Seat 1: SantiagoWeight ($33.49 in chips) 
Seat 2: Fishnoobking ($20.19 in chips) 
Seat 3: kiteboard26 ($21.87 in chips) 
Seat 4: Bujan 07 ($33.41 in chips) 
Seat 5: river plate9 ($26.21 in chips) 
Seat 6: MileVoliD49 ($33.48 in chips) 
Fishnoobking: posts small blind $0.10
kiteboard26: posts big blind $0.25
*** HOLE CARDS ***
Dealt to SantiagoWeight [Jc As]
Bujan 07: raises $0.50 to $0.75
river plate9: folds 
MileVoliD49: folds 
SantiagoWeight: raises $1.35 to $2.10
Fishnoobking: folds 
kiteboard26: folds 
Bujan 07: calls $1.35
*** FLOP *** [2h 8d 3s]
Bujan 07: bets $0.75
SantiagoWeight: calls $0.75
*** TURN *** [2h 8d 3s] [Kd]
Bujan 07: bets $0.75
SantiagoWeight: calls $0.75
*** RIVER *** [2h 8d 3s Kd] [4d]
Bujan 07: bets $0.75
SantiagoWeight: calls $0.75
*** SHOW DOWN ***
Bujan 07: shows [6s 6c] (a pair of Sixes)
SantiagoWeight: mucks hand 
Bujan 07 collected $8.64 from pot
*** SUMMARY ***
Total pot $9.05 | Rake $0.41 
Board [2h 8d 3s Kd 4d]
Seat 1: SantiagoWeight (button) mucked [Jc As]
Seat 2: Fishnoobking (small blind) folded before Flop
Seat 3: kiteboard26 (big blind) folded before Flop
Seat 4: Bujan 07 showed [6s 6c] and won ($8.64) with a pair of Sixes
Seat 5: river plate9 folded before Flop (didn't bet)
Seat 6: MileVoliD49 folded before Flop (didn't bet)



PokerStars Zoom Hand #195023647266:  Hold'em No Limit ($0.10/$0.25) - 2018/12/29 3:50:52 UTC [2018/12/28 22:50:52 ET]
Table 'Hydra' 6-max Seat #1 is the button
Seat 1: Nutselas ($25.35 in chips) 
Seat 2: HansMSM ($28.76 in chips) 
Seat 3: golf7287 ($33.97 in chips) 
Seat 4: SantiagoWeight ($33.49 in chips) 
Seat 5: ssrace ($33.95 in chips) 
Seat 6: osa126 ($25.62 in chips) 
HansMSM: posts small blind $0.10
golf7287: posts big blind $0.25
*** HOLE CARDS ***
Dealt to SantiagoWeight [2c Ts]
SantiagoWeight: folds 
ssrace: folds 
osa126: folds 
Nutselas: folds 
HansMSM: calls $0.15
golf7287: checks 
*** FLOP *** [Ad 4d 8c]
HansMSM: bets $0.30
golf7287: raises $0.70 to $1
HansMSM: calls $0.70
*** TURN *** [Ad 4d 8c] [6h]
HansMSM: checks 
golf7287: bets $1.25
HansMSM: calls $1.25
*** RIVER *** [Ad 4d 8c 6h] [8d]
HansMSM: checks 
golf7287: bets $2.25
HansMSM: folds 
Uncalled bet ($2.25) returned to golf7287
golf7287 collected $4.78 from pot
golf7287: doesn't show hand 
*** SUMMARY ***
Total pot $5 | Rake $0.22 
Board [Ad 4d 8c 6h 8d]
Seat 1: Nutselas (button) folded before Flop (didn't bet)
Seat 2: HansMSM (small blind) folded on the River
Seat 3: golf7287 (big blind) collected ($4.78)
Seat 4: SantiagoWeight folded before Flop (didn't bet)
Seat 5: ssrace folded before Flop (didn't bet)
Seat 6: osa126 folded before Flop (didn't bet)



PokerStars Zoom Hand #195023672023:  Hold'em No Limit ($0.10/$0.25) - 2018/12/29 3:52:13 UTC [2018/12/28 22:52:13 ET]
Table 'Hydra' 6-max Seat #1 is the button
Seat 1: yobbos ($123.70 in chips) 
Seat 2: MileVoliD49 ($32.48 in chips) 
Seat 3: bwim ($21.81 in chips) 
Seat 4: SantiagoWeight ($29.14 in chips) 
Seat 5: miru877 ($25 in chips) 
Seat 6: osa126 ($60.65 in chips) 
MileVoliD49: posts small blind $0.10
bwim: posts big blind $0.25
*** HOLE CARDS ***
Dealt to SantiagoWeight [Ad 9s]
SantiagoWeight: folds 
miru877: folds 
osa126: folds 
yobbos: folds 
MileVoliD49: folds 
Uncalled bet ($0.15) returned to bwim
bwim collected $0.20 from pot
bwim: doesn't show hand 
*** SUMMARY ***
Total pot $0.20 | Rake $0 
Seat 1: yobbos (button) folded before Flop (didn't bet)
Seat 2: MileVoliD49 (small blind) folded before Flop
Seat 3: bwim (big blind) collected ($0.20)
Seat 4: SantiagoWeight folded before Flop (didn't bet)
Seat 5: miru877 folded before Flop (didn't bet)
Seat 6: osa126 folded before Flop (didn't bet)



PokerStars Zoom Hand #195023673584:  Hold'em No Limit ($0.10/$0.25) - 2018/12/29 3:52:18 UTC [2018/12/28 22:52:18 ET]
Table 'Hydra' 6-max Seat #1 is the button
Seat 1: G ster24 ($39.51 in chips) 
Seat 2: Chrimmpam ($22.80 in chips) 
Seat 3: Albratros2 ($34.97 in chips) 
Seat 4: call me??107 ($28.54 in chips) 
Seat 5: SantiagoWeight ($29.14 in chips) 
Seat 6: HansMSM ($26.26 in chips) 
Chrimmpam: posts small blind $0.10
Albratros2: posts big blind $0.25
*** HOLE CARDS ***
Dealt to SantiagoWeight [Th 6d]
call me??107 has timed out while disconnected
call me??107: folds 
SantiagoWeight: folds 
HansMSM: folds 
G ster24: folds 
Chrimmpam: raises $0.50 to $0.75
Albratros2: calls $0.50
*** FLOP *** [Js Td Ah]
Chrimmpam: bets $0.75
Albratros2: calls $0.75
*** TURN *** [Js Td Ah] [8c]
Chrimmpam: bets $2
Albratros2: raises $2 to $4
Chrimmpam: raises $5 to $9
Albratros2: folds 
Uncalled bet ($5) returned to Chrimmpam
Chrimmpam collected $10.50 from pot
Chrimmpam: doesn't show hand 
*** SUMMARY ***
Total pot $11 | Rake $0.50 
Board [Js Td Ah 8c]
Seat 1: G ster24 (button) folded before Flop (didn't bet)
Seat 2: Chrimmpam (small blind) collected ($10.50)
Seat 3: Albratros2 (big blind) folded on the Turn
Seat 4: call me??107 folded before Flop (didn't bet)
Seat 5: SantiagoWeight folded before Flop (didn't bet)
Seat 6: HansMSM folded before Flop (didn't bet)



PokerStars Zoom Hand #195023676657:  Hold'em No Limit ($0.10/$0.25) - 2018/12/29 3:52:28 UTC [2018/12/28 22:52:28 ET]
Table 'Hydra' 6-max Seat #1 is the button
Seat 1: 777jsmith ($7.53 in chips) 
Seat 2: Mrs_Squeeze ($16.31 in chips) 
Seat 3: SantiagoWeight ($29.14 in chips) 
Seat 4: 666erkan ($23.37 in chips) 
Seat 5: yobbos ($141.61 in chips) 
Seat 6: miru877 ($25.38 in chips) 
Mrs_Squeeze: posts small blind $0.10
SantiagoWeight: posts big blind $0.25
*** HOLE CARDS ***
Dealt to SantiagoWeight [5h 3h]
666erkan: folds 
yobbos: folds 
miru877: folds 
777jsmith: calls $0.25
Mrs_Squeeze: folds 
SantiagoWeight: checks 
*** FLOP *** [7s 3c Ah]
SantiagoWeight: checks 
777jsmith: checks 
*** TURN *** [7s 3c Ah] [3s]
SantiagoWeight: bets $0.38
777jsmith: raises $0.38 to $0.76
SantiagoWeight: calls $0.38
*** RIVER *** [7s 3c Ah 3s] [6d]
SantiagoWeight: checks 
777jsmith: bets $6.52 and is all-in
SantiagoWeight: calls $6.52
*** SHOW DOWN ***
777jsmith: shows [Ac As] (a full house, Aces full of Threes)
SantiagoWeight: shows [5h 3h] (three of a kind, Threes)
777jsmith collected $14.48 from pot
*** SUMMARY ***
Total pot $15.16 | Rake $0.68 
Board [7s 3c Ah 3s 6d]
Seat 1: 777jsmith (button) showed [Ac As] and won ($14.48) with a full house, Aces full of Threes
Seat 2: Mrs_Squeeze (small blind) folded before Flop
Seat 3: SantiagoWeight (big blind) showed [5h 3h] and lost with three of a kind, Threes
Seat 4: 666erkan folded before Flop (didn't bet)
Seat 5: yobbos folded before Flop (didn't bet)
Seat 6: miru877 folded before Flop (didn't bet)



PokerStars Zoom Hand #195023691813:  Hold'em No Limit ($0.10/$0.25) - 2018/12/29 3:53:18 UTC [2018/12/28 22:53:18 ET]
Table 'Hydra' 6-max Seat #1 is the button
Seat 1: SantiagoWeight ($21.61 in chips) 
Seat 2: Guard poker ($25 in chips) 
Seat 3: Chrimmpam ($19.32 in chips) 
Seat 4: miaozhuang ($23.03 in chips) 
Seat 5: Actarusqc ($19.98 in chips) 
Seat 6: Pardaroxon ($44.13 in chips) 
Guard poker: posts small blind $0.10
Chrimmpam: posts big blind $0.25
*** HOLE CARDS ***
Dealt to SantiagoWeight [7s 8h]
miaozhuang: folds 
Actarusqc: folds 
Pardaroxon: raises $0.37 to $0.62
SantiagoWeight: folds 
Guard poker: folds 
Chrimmpam: folds 
Uncalled bet ($0.37) returned to Pardaroxon
Pardaroxon collected $0.60 from pot
Pardaroxon: doesn't show hand 
*** SUMMARY ***
Total pot $0.60 | Rake $0 
Seat 1: SantiagoWeight (button) folded before Flop (didn't bet)
Seat 2: Guard poker (small blind) folded before Flop
Seat 3: Chrimmpam (big blind) folded before Flop
Seat 4: miaozhuang folded before Flop (didn't bet)
Seat 5: Actarusqc folded before Flop (didn't bet)
Seat 6: Pardaroxon collected ($0.60)



PokerStars Zoom Hand #195023694793:  Hold'em No Limit ($0.10/$0.25) - 2018/12/29 3:53:28 UTC [2018/12/28 22:53:28 ET]
Table 'Hydra' 6-max Seat #1 is the button
Seat 1: yobbos ($125.38 in chips) 
Seat 2: SantiagoWeight ($21.61 in chips) 
Seat 3: alex3d1985 ($40.57 in chips) 
Seat 4: Renner32 ($23.82 in chips) 
Seat 5: _BluDeeN_ ($37.28 in chips) 
Seat 6: ckriszee ($25.10 in chips) 
SantiagoWeight: posts small blind $0.10
alex3d1985: posts big blind $0.25
*** HOLE CARDS ***
Dealt to SantiagoWeight [Ac 9d]
Renner32: folds 
_BluDeeN_: folds 
ckriszee: folds 
yobbos: folds 
SantiagoWeight: raises $0.50 to $0.75
alex3d1985: folds 
Uncalled bet ($0.50) returned to SantiagoWeight
SantiagoWeight collected $0.50 from pot
SantiagoWeight: doesn't show hand 
*** SUMMARY ***
Total pot $0.50 | Rake $0 
Seat 1: yobbos (button) folded before Flop (didn't bet)
Seat 2: SantiagoWeight (small blind) collected ($0.50)
Seat 3: alex3d1985 (big blind) folded before Flop
Seat 4: Renner32 folded before Flop (didn't bet)
Seat 5: _BluDeeN_ folded before Flop (didn't bet)
Seat 6: ckriszee folded before Flop (didn't bet)



PokerStars Zoom Hand #195023701280:  Hold'em No Limit ($0.10/$0.25) - 2018/12/29 3:53:49 UTC [2018/12/28 22:53:49 ET]
Table 'Hydra' 6-max Seat #1 is the button
Seat 1: Bonen18 ($34.99 in chips) 
Seat 2: Chrimmpam ($27.90 in chips) 
Seat 3: pirosiky ($77.69 in chips) 
Seat 4: bwim ($22.48 in chips) 
Seat 5: aa1421b ($46.05 in chips) 
Seat 6: SantiagoWeight ($21.86 in chips) 
Chrimmpam: posts small blind $0.10
pirosiky: posts big blind $0.25
*** HOLE CARDS ***
Dealt to SantiagoWeight [5d Ac]
bwim: raises $0.50 to $0.75
aa1421b: folds 
SantiagoWeight: folds 
Bonen18: folds 
Chrimmpam: calls $0.65
pirosiky: folds 
*** FLOP *** [As Td 9s]
Chrimmpam: checks 
bwim: bets $1
Chrimmpam: folds 
Uncalled bet ($1) returned to bwim
bwim collected $1.67 from pot
bwim: doesn't show hand 
*** SUMMARY ***
Total pot $1.75 | Rake $0.08 
Board [As Td 9s]
Seat 1: Bonen18 (button) folded before Flop (didn't bet)
Seat 2: Chrimmpam (small blind) folded on the Flop
Seat 3: pirosiky (big blind) folded before Flop
Seat 4: bwim collected ($1.67)
Seat 5: aa1421b folded before Flop (didn't bet)
Seat 6: SantiagoWeight folded before Flop (didn't bet)



PokerStars Zoom Hand #195023705551:  Hold'em No Limit ($0.10/$0.25) - 2018/12/29 3:54:03 UTC [2018/12/28 22:54:03 ET]
Table 'Hydra' 6-max Seat #1 is the button
Seat 1: graysonai ($26.97 in chips) 
Seat 2: pirosiky ($77.44 in chips) 
Seat 3: **HCL59** ($16.97 in chips) 
Seat 4: SantiagoWeight ($21.86 in chips) 
Seat 5: miba16 ($44.55 in chips) 
Seat 6: CrazieFreddy ($9.89 in chips) 
pirosiky: posts small blind $0.10
**HCL59**: posts big blind $0.25
*** HOLE CARDS ***
Dealt to SantiagoWeight [Kh Js]
SantiagoWeight: raises $0.42 to $0.67
miba16: folds 
CrazieFreddy: folds 
graysonai: calls $0.67
pirosiky: folds 
**HCL59**: raises $2.13 to $2.80
SantiagoWeight: folds 
graysonai: folds 
Uncalled bet ($2.13) returned to **HCL59**
**HCL59** collected $2.11 from pot
**HCL59**: doesn't show hand 
*** SUMMARY ***
Total pot $2.11 | Rake $0 
Seat 1: graysonai (button) folded before Flop
Seat 2: pirosiky (small blind) folded before Flop
Seat 3: **HCL59** (big blind) collected ($2.11)
Seat 4: SantiagoWeight folded before Flop
Seat 5: miba16 folded before Flop (didn't bet)
Seat 6: CrazieFreddy folded before Flop (didn't bet)



PokerStars Zoom Hand #195023718786:  Hold'em No Limit ($0.10/$0.25) - 2018/12/29 3:54:47 UTC [2018/12/28 22:54:47 ET]
Table 'Hydra' 6-max Seat #1 is the button
Seat 1: Chrimmpam ($27.25 in chips) 
Seat 2: Chellabro ($40.71 in chips) 
Seat 3: bigm2261 ($14.06 in chips) 
Seat 4: yobbos ($45.87 in chips) 
Seat 5: _BluDeeN_ ($37.95 in chips) 
Seat 6: SantiagoWeight ($21.19 in chips) 
Chellabro: posts small blind $0.10
bigm2261: posts big blind $0.25
*** HOLE CARDS ***
Dealt to SantiagoWeight [6h 6s]
yobbos: raises $0.50 to $0.75
_BluDeeN_: folds 
SantiagoWeight: calls $0.75
Chrimmpam: folds 
Chellabro: folds 
bigm2261: folds 
*** FLOP *** [Jh 4s 5s]
yobbos: checks 
SantiagoWeight: bets $1.18
yobbos: folds 
Uncalled bet ($1.18) returned to SantiagoWeight
SantiagoWeight collected $1.77 from pot
SantiagoWeight: doesn't show hand 
*** SUMMARY ***
Total pot $1.85 | Rake $0.08 
Board [Jh 4s 5s]
Seat 1: Chrimmpam (button) folded before Flop (didn't bet)
Seat 2: Chellabro (small blind) folded before Flop
Seat 3: bigm2261 (big blind) folded before Flop
Seat 4: yobbos folded on the Flop
Seat 5: _BluDeeN_ folded before Flop (didn't bet)
Seat 6: SantiagoWeight collected ($1.77)



PokerStars Zoom Hand #195023716929:  Hold'em No Limit ($0.10/$0.25) - 2018/12/29 3:54:41 UTC [2018/12/28 22:54:41 ET]
Table 'Hydra' 6-max Seat #1 is the button
Seat 1: river plate9 ($23.86 in chips) 
Seat 2: ckriszee ($26.44 in chips) 
Seat 3: franco373513 ($9.64 in chips) 
Seat 4: KeySssi ($57.02 in chips) 
Seat 5: SantiagoWeight ($21.19 in chips) 
Seat 6: Renner32 ($39.68 in chips) 
ckriszee: posts small blind $0.10
franco373513: posts big blind $0.25
*** HOLE CARDS ***
Dealt to SantiagoWeight [4c 5c]
KeySssi: folds 
SantiagoWeight: folds 
Renner32: folds 
river plate9: raises $0.25 to $0.50
ckriszee: raises $1.60 to $2.10
franco373513: folds 
river plate9: calls $1.60
*** FLOP *** [Js Ks Qh]
ckriszee: checks 
river plate9: bets $2.25
ckriszee: folds 
Uncalled bet ($2.25) returned to river plate9
river plate9 collected $4.25 from pot
river plate9: doesn't show hand 
*** SUMMARY ***
Total pot $4.45 | Rake $0.20 
Board [Js Ks Qh]
Seat 1: river plate9 (button) collected ($4.25)
Seat 2: ckriszee (small blind) folded on the Flop
Seat 3: franco373513 (big blind) folded before Flop
Seat 4: KeySssi folded before Flop (didn't bet)
Seat 5: SantiagoWeight folded before Flop (didn't bet)
Seat 6: Renner32 folded before Flop (didn't bet)



PokerStars Zoom Hand #195023726661:  Hold'em No Limit ($0.10/$0.25) - 2018/12/29 3:55:14 UTC [2018/12/28 22:55:14 ET]
Table 'Hydra' 6-max Seat #1 is the button
Seat 1: Virus3232 ($25.44 in chips) 
Seat 2: SantiagoWeight ($25 in chips) 
Seat 3: _BluDeeN_ ($32.43 in chips) 
Seat 4: Actarusqc ($19.11 in chips) 
Seat 5: KAllUSTA ($23.37 in chips) 
Seat 6: gustavotaina ($5.97 in chips) 
SantiagoWeight: posts small blind $0.10
_BluDeeN_: posts big blind $0.25
*** HOLE CARDS ***
Dealt to SantiagoWeight [6h 8d]
Actarusqc: folds 
KAllUSTA: folds 
gustavotaina: folds 
Virus3232: folds 
SantiagoWeight: folds 
Uncalled bet ($0.15) returned to _BluDeeN_
_BluDeeN_ collected $0.20 from pot
_BluDeeN_: doesn't show hand 
*** SUMMARY ***
Total pot $0.20 | Rake $0 
Seat 1: Virus3232 (button) folded before Flop (didn't bet)
Seat 2: SantiagoWeight (small blind) folded before Flop
Seat 3: _BluDeeN_ (big blind) collected ($0.20)
Seat 4: Actarusqc folded before Flop (didn't bet)
Seat 5: KAllUSTA folded before Flop (didn't bet)
Seat 6: gustavotaina folded before Flop (didn't bet)



PokerStars Zoom Hand #195023735768:  Hold'em No Limit ($0.10/$0.25) - 2018/12/29 3:55:48 UTC [2018/12/28 22:55:48 ET]
Table 'Hydra' 6-max Seat #1 is the button
Seat 1: MileVoliD49 ($29.66 in chips) 
Seat 2: razil_999 ($26.98 in chips) 
Seat 3: lovintalbi ($66.20 in chips) 
Seat 4: SantiagoWeight ($24.65 in chips) 
Seat 5: call me??107 ($22.83 in chips) 
Seat 6: kakashi_zion ($21.80 in chips) 
razil_999: posts small blind $0.10
lovintalbi: posts big blind $0.25
*** HOLE CARDS ***
Dealt to SantiagoWeight [7d 6s]
SantiagoWeight: folds 
call me??107: folds 
kakashi_zion: folds 
MileVoliD49: folds 
razil_999: folds 
Uncalled bet ($0.15) returned to lovintalbi
lovintalbi collected $0.20 from pot
lovintalbi: doesn't show hand 
*** SUMMARY ***
Total pot $0.20 | Rake $0 
Seat 1: MileVoliD49 (button) folded before Flop (didn't bet)
Seat 2: razil_999 (small blind) folded before Flop
Seat 3: lovintalbi (big blind) collected ($0.20)
Seat 4: SantiagoWeight folded before Flop (didn't bet)
Seat 5: call me??107 folded before Flop (didn't bet)
Seat 6: kakashi_zion folded before Flop (didn't bet)



PokerStars Zoom Hand #195023736841:  Hold'em No Limit ($0.10/$0.25) - 2018/12/29 3:55:52 UTC [2018/12/28 22:55:52 ET]
Table 'Hydra' 6-max Seat #1 is the button
Seat 1: osa126 ($68.52 in chips) 
Seat 2: Lehared ($79.11 in chips) 
Seat 3: superlalo14 ($25 in chips) 
Seat 4: kakashi_zion ($21.80 in chips) 
Seat 5: SantiagoWeight ($24.65 in chips) 
Seat 6: anorectal ($25.37 in chips) 
Lehared: posts small blind $0.10
superlalo14: posts big blind $0.25
*** HOLE CARDS ***
Dealt to SantiagoWeight [Jd 5d]
kakashi_zion: folds 
SantiagoWeight: folds 
anorectal: folds 
osa126: folds 
Lehared: folds 
Uncalled bet ($0.15) returned to superlalo14
superlalo14 collected $0.20 from pot
superlalo14: doesn't show hand 
*** SUMMARY ***
Total pot $0.20 | Rake $0 
Seat 1: osa126 (button) folded before Flop (didn't bet)
Seat 2: Lehared (small blind) folded before Flop
Seat 3: superlalo14 (big blind) collected ($0.20)
Seat 4: kakashi_zion folded before Flop (didn't bet)
Seat 5: SantiagoWeight folded before Flop (didn't bet)
Seat 6: anorectal folded before Flop (didn't bet)



PokerStars Zoom Hand #195023739283:  Hold'em No Limit ($0.10/$0.25) - 2018/12/29 3:56:01 UTC [2018/12/28 22:56:01 ET]
Table 'Hydra' 6-max Seat #1 is the button
Seat 1: SantiagoWeight ($24.65 in chips) 
Seat 2: anorectal ($25 in chips) 
Seat 3: cwreinbold ($12.50 in chips) 
Seat 4: MileVoliD49 ($29.66 in chips) 
Seat 5: Xp0Hb ($46 in chips) 
Seat 6: Lehared ($79.01 in chips) 
anorectal: posts small blind $0.10
cwreinbold: posts big blind $0.25
*** HOLE CARDS ***
Dealt to SantiagoWeight [Jh 4d]
MileVoliD49: folds 
Xp0Hb: folds 
Lehared: folds 
SantiagoWeight: folds 
anorectal: folds 
Uncalled bet ($0.15) returned to cwreinbold
cwreinbold collected $0.20 from pot
cwreinbold: doesn't show hand 
*** SUMMARY ***
Total pot $0.20 | Rake $0 
Seat 1: SantiagoWeight (button) folded before Flop (didn't bet)
Seat 2: anorectal (small blind) folded before Flop
Seat 3: cwreinbold (big blind) collected ($0.20)
Seat 4: MileVoliD49 folded before Flop (didn't bet)
Seat 5: Xp0Hb folded before Flop (didn't bet)
Seat 6: Lehared folded before Flop (didn't bet)



PokerStars Zoom Hand #195023738187:  Hold'em No Limit ($0.10/$0.25) - 2018/12/29 3:55:57 UTC [2018/12/28 22:55:57 ET]
Table 'Hydra' 6-max Seat #1 is the button
Seat 1: DUDA3553 ($28.41 in chips) 
Seat 2: Guard poker ($25.20 in chips) 
Seat 3: Jack123985 ($25.95 in chips) 
Seat 4: SantiagoWeight ($24.65 in chips) 
Seat 5: LLiarrr ($26.31 in chips) 
Seat 6: Unclesmoll ($25.51 in chips) 
Guard poker: posts small blind $0.10
Jack123985: posts big blind $0.25
*** HOLE CARDS ***
Dealt to SantiagoWeight [6s 4s]
SantiagoWeight: folds 
LLiarrr: folds 
Unclesmoll: folds 
DUDA3553: folds 
Guard poker: raises $0.37 to $0.62
Jack123985: raises $1.63 to $2.25
Guard poker: folds 
Uncalled bet ($1.63) returned to Jack123985
Jack123985 collected $1.24 from pot
Jack123985: doesn't show hand 
*** SUMMARY ***
Total pot $1.24 | Rake $0 
Seat 1: DUDA3553 (button) folded before Flop (didn't bet)
Seat 2: Guard poker (small blind) folded before Flop
Seat 3: Jack123985 (big blind) collected ($1.24)
Seat 4: SantiagoWeight folded before Flop (didn't bet)
Seat 5: LLiarrr folded before Flop (didn't bet)
Seat 6: Unclesmoll folded before Flop (didn't bet)



PokerStars Zoom Hand #195023740620:  Hold'em No Limit ($0.10/$0.25) - 2018/12/29 3:56:06 UTC [2018/12/28 22:56:06 ET]
Table 'Hydra' 6-max Seat #1 is the button
Seat 1: Chrimmpam ($18 in chips) 
Seat 2: Pardaroxon ($51.87 in chips) 
Seat 3: SantiagoWeight ($24.65 in chips) 
Seat 4: davidhw888 ($26.29 in chips) 
Seat 5: nadal335 ($31.43 in chips) 
Seat 6: 666erkan ($20.13 in chips) 
Pardaroxon: posts small blind $0.10
SantiagoWeight: posts big blind $0.25
*** HOLE CARDS ***
Dealt to SantiagoWeight [Qc 7s]
davidhw888: raises $0.50 to $0.75
nadal335: folds 
666erkan: folds 
Chrimmpam: folds 
Pardaroxon: folds 
SantiagoWeight: folds 
Uncalled bet ($0.50) returned to davidhw888
davidhw888 collected $0.60 from pot
davidhw888: doesn't show hand 
*** SUMMARY ***
Total pot $0.60 | Rake $0 
Seat 1: Chrimmpam (button) folded before Flop (didn't bet)
Seat 2: Pardaroxon (small blind) folded before Flop
Seat 3: SantiagoWeight (big blind) folded before Flop
Seat 4: davidhw888 collected ($0.60)
Seat 5: nadal335 folded before Flop (didn't bet)
Seat 6: 666erkan folded before Flop (didn't bet)



PokerStars Zoom Hand #195023731979:  Hold'em No Limit ($0.10/$0.25) - 2018/12/29 3:55:34 UTC [2018/12/28 22:55:34 ET]
Table 'Hydra' 6-max Seat #1 is the button
Seat 1: kakashi_zion ($21.80 in chips) 
Seat 2: yobbos ($140.35 in chips) 
Seat 3: SantiagoWeight ($24.90 in chips) 
Seat 4: river plate9 ($28.09 in chips) 
Seat 5: allin969 ($22.60 in chips) 
Seat 6: LLiarrr ($25 in chips) 
yobbos: posts small blind $0.10
SantiagoWeight: posts big blind $0.25
*** HOLE CARDS ***
Dealt to SantiagoWeight [3s Kh]
river plate9: raises $0.50 to $0.75
allin969: folds 
LLiarrr: folds 
kakashi_zion: folds 
yobbos: raises $2 to $2.75
SantiagoWeight: folds 
river plate9: calls $2
*** FLOP *** [9d 9h 6d]
yobbos: bets $1.87
river plate9: raises $2.37 to $4.24
yobbos: calls $2.37
*** TURN *** [9d 9h 6d] [4d]
yobbos: checks 
river plate9: checks 
*** RIVER *** [9d 9h 6d 4d] [Ad]
yobbos: checks 
river plate9: checks 
*** SHOW DOWN ***
yobbos: shows [Jd Js] (a flush, Ace high)
river plate9: mucks hand 
yobbos collected $13.59 from pot
*** SUMMARY ***
Total pot $14.23 | Rake $0.64 
Board [9d 9h 6d 4d Ad]
Seat 1: kakashi_zion (button) folded before Flop (didn't bet)
Seat 2: yobbos (small blind) showed [Jd Js] and won ($13.59) with a flush, Ace high
Seat 3: SantiagoWeight (big blind) folded before Flop
Seat 4: river plate9 mucked [Tc Ts]
Seat 5: allin969 folded before Flop (didn't bet)
Seat 6: LLiarrr folded before Flop (didn't bet)



PokerStars Zoom Hand #195023734646:  Hold'em No Limit ($0.10/$0.25) - 2018/12/29 3:55:44 UTC [2018/12/28 22:55:44 ET]
Table 'Hydra' 6-max Seat #1 is the button
Seat 1: SantiagoWeight ($24.65 in chips) 
Seat 2: bigm2261 ($13.56 in chips) 
Seat 3: mariopork ($34.18 in chips) 
Seat 4: Guard poker ($25 in chips) 
Seat 5: moderi ($26.45 in chips) 
Seat 6: winwinboy ($25 in chips) 
bigm2261: posts small blind $0.10
mariopork: posts big blind $0.25
*** HOLE CARDS ***
Dealt to SantiagoWeight [7s 3h]
Guard poker: folds 
moderi: calls $0.25
winwinboy: raises $0.85 to $1.10
SantiagoWeight: folds 
bigm2261: folds 
mariopork: folds 
moderi: calls $0.85
*** FLOP *** [7c Kh 8d]
moderi: checks 
winwinboy: bets $1.59
moderi: folds 
Uncalled bet ($1.59) returned to winwinboy
winwinboy collected $2.44 from pot
winwinboy: doesn't show hand 
*** SUMMARY ***
Total pot $2.55 | Rake $0.11 
Board [7c Kh 8d]
Seat 1: SantiagoWeight (button) folded before Flop (didn't bet)
Seat 2: bigm2261 (small blind) folded before Flop
Seat 3: mariopork (big blind) folded before Flop
Seat 4: Guard poker folded before Flop (didn't bet)
Seat 5: moderi folded on the Flop
Seat 6: winwinboy collected ($2.44)



PokerStars Zoom Hand #195023744706:  Hold'em No Limit ($0.10/$0.25) - 2018/12/29 3:56:21 UTC [2018/12/28 22:56:21 ET]
Table 'Hydra' 6-max Seat #1 is the button
Seat 1: Bonen18 ($26.46 in chips) 
Seat 2: SantiagoWeight ($24.40 in chips) 
Seat 3: razil_999 ($26.88 in chips) 
Seat 4: trttt74 ($21.89 in chips) 
Seat 5: LLiarrr ($25.25 in chips) 
Seat 6: Virus3232 ($25 in chips) 
SantiagoWeight: posts small blind $0.10
razil_999: posts big blind $0.25
*** HOLE CARDS ***
Dealt to SantiagoWeight [9h 9d]
trttt74: raises $0.64 to $0.89
LLiarrr: folds 
Virus3232: folds 
Bonen18: folds 
SantiagoWeight: calls $0.79
razil_999: folds 
*** FLOP *** [7h 8c Ah]
SantiagoWeight: checks 
trttt74: bets $0.75
SantiagoWeight: calls $0.75
*** TURN *** [7h 8c Ah] [5c]
SantiagoWeight: checks 
trttt74: bets $1.75
SantiagoWeight: calls $1.75
*** RIVER *** [7h 8c Ah 5c] [Ks]
SantiagoWeight: checks 
trttt74: bets $4.50
SantiagoWeight: folds 
Uncalled bet ($4.50) returned to trttt74
trttt74 collected $6.71 from pot
trttt74: doesn't show hand 
*** SUMMARY ***
Total pot $7.03 | Rake $0.32 
Board [7h 8c Ah 5c Ks]
Seat 1: Bonen18 (button) folded before Flop (didn't bet)
Seat 2: SantiagoWeight (small blind) folded on the River
Seat 3: razil_999 (big blind) folded before Flop
Seat 4: trttt74 collected ($6.71)
Seat 5: LLiarrr folded before Flop (didn't bet)
Seat 6: Virus3232 folded before Flop (didn't bet)



PokerStars Zoom Hand #195023762597:  Hold'em No Limit ($0.10/$0.25) - 2018/12/29 3:57:27 UTC [2018/12/28 22:57:27 ET]
Table 'Hydra' 6-max Seat #1 is the button
Seat 1: athos 007 ($40.02 in chips) 
Seat 2: Becks Baker ($25.06 in chips) 
Seat 3: Nutselas ($27.34 in chips) 
Seat 4: G ster24 ($35.31 in chips) 
Seat 5: Fishnoobking ($19.66 in chips) 
Seat 6: SantiagoWeight ($21.01 in chips) 
Becks Baker: posts small blind $0.10
Nutselas: posts big blind $0.25
*** HOLE CARDS ***
Dealt to SantiagoWeight [Kd Kc]
G ster24: folds 
Fishnoobking: folds 
SantiagoWeight: raises $0.30 to $0.55
athos 007: calls $0.55
Becks Baker: folds 
Nutselas: calls $0.30
*** FLOP *** [As Ks 3c]
Nutselas: checks 
SantiagoWeight: bets $1.67
athos 007: folds 
Nutselas: folds 
Uncalled bet ($1.67) returned to SantiagoWeight
SantiagoWeight collected $1.67 from pot
SantiagoWeight: doesn't show hand 
*** SUMMARY ***
Total pot $1.75 | Rake $0.08 
Board [As Ks 3c]
Seat 1: athos 007 (button) folded on the Flop
Seat 2: Becks Baker (small blind) folded before Flop
Seat 3: Nutselas (big blind) folded on the Flop
Seat 4: G ster24 folded before Flop (didn't bet)
Seat 5: Fishnoobking folded before Flop (didn't bet)
Seat 6: SantiagoWeight collected ($1.67)



PokerStars Zoom Hand #195023779361:  Hold'em No Limit ($0.10/$0.25) - 2018/12/29 3:58:29 UTC [2018/12/28 22:58:29 ET]
Table 'Hydra' 6-max Seat #1 is the button
Seat 1: nhanminhtri ($25 in chips) 
Seat 2: graysonai ($34.41 in chips) 
Seat 3: TQNYMQNTANA ($25 in chips) 
Seat 4: SantiagoWeight ($25 in chips) 
Seat 5: tariko1980 ($32.25 in chips) 
Seat 6: qing328 ($24.65 in chips) 
graysonai: posts small blind $0.10
TQNYMQNTANA: posts big blind $0.25
*** HOLE CARDS ***
Dealt to SantiagoWeight [Td 7h]
SantiagoWeight: folds 
tariko1980: folds 
qing328: folds 
nhanminhtri: raises $0.37 to $0.62
graysonai: folds 
TQNYMQNTANA: folds 
Uncalled bet ($0.37) returned to nhanminhtri
nhanminhtri collected $0.60 from pot
nhanminhtri: doesn't show hand 
*** SUMMARY ***
Total pot $0.60 | Rake $0 
Seat 1: nhanminhtri (button) collected ($0.60)
Seat 2: graysonai (small blind) folded before Flop
Seat 3: TQNYMQNTANA (big blind) folded before Flop
Seat 4: SantiagoWeight folded before Flop (didn't bet)
Seat 5: tariko1980 folded before Flop (didn't bet)
Seat 6: qing328 folded before Flop (didn't bet)



PokerStars Zoom Hand #195023776640:  Hold'em No Limit ($0.10/$0.25) - 2018/12/29 3:58:19 UTC [2018/12/28 22:58:19 ET]
Table 'Hydra' 6-max Seat #1 is the button
Seat 1: KeySssi ($25 in chips) 
Seat 2: Nutselas ($48.53 in chips) 
Seat 3: 1ownYourUsd ($70.73 in chips) 
Seat 4: bigm2261 ($15.33 in chips) 
Seat 5: SantiagoWeight ($25 in chips) 
Seat 6: _BluDeeN_ ($41.02 in chips) 
Nutselas: posts small blind $0.10
1ownYourUsd: posts big blind $0.25
*** HOLE CARDS ***
Dealt to SantiagoWeight [3s Kd]
bigm2261: folds 
SantiagoWeight: folds 
_BluDeeN_: folds 
KeySssi: folds 
Nutselas: raises $0.63 to $0.88
1ownYourUsd: calls $0.63
*** FLOP *** [Td Jd 8s]
Nutselas: checks 
1ownYourUsd: bets $0.50
Nutselas: folds 
Uncalled bet ($0.50) returned to 1ownYourUsd
1ownYourUsd collected $1.68 from pot
1ownYourUsd: doesn't show hand 
*** SUMMARY ***
Total pot $1.76 | Rake $0.08 
Board [Td Jd 8s]
Seat 1: KeySssi (button) folded before Flop (didn't bet)
Seat 2: Nutselas (small blind) folded on the Flop
Seat 3: 1ownYourUsd (big blind) collected ($1.68)
Seat 4: bigm2261 folded before Flop (didn't bet)
Seat 5: SantiagoWeight folded before Flop (didn't bet)
Seat 6: _BluDeeN_ folded before Flop (didn't bet)



PokerStars Zoom Hand #195023780965:  Hold'em No Limit ($0.10/$0.25) - 2018/12/29 3:58:35 UTC [2018/12/28 22:58:35 ET]
Table 'Hydra' 6-max Seat #1 is the button
Seat 1: osa126 ($67.02 in chips) 
Seat 2: dan_iasi ($25 in chips) 
Seat 3: SantiagoWeight ($25 in chips) 
Seat 4: 905steelcity ($14.98 in chips) 
Seat 5: Renner32 ($40.50 in chips) 
Seat 6: Trapduck ($25 in chips) 
dan_iasi: posts small blind $0.10
SantiagoWeight: posts big blind $0.25
*** HOLE CARDS ***
Dealt to SantiagoWeight [9d 8s]
905steelcity: raises $0.25 to $0.50
Renner32: folds 
Trapduck: folds 
osa126: folds 
dan_iasi: folds 
SantiagoWeight: calls $0.25
*** FLOP *** [Tc 3c Qd]
SantiagoWeight: checks 
905steelcity: bets $0.50
SantiagoWeight: raises $1.20 to $1.70
905steelcity: calls $1.20
*** TURN *** [Tc 3c Qd] [9h]
SantiagoWeight: checks 
905steelcity: checks 
*** RIVER *** [Tc 3c Qd 9h] [2c]
SantiagoWeight: checks 
905steelcity: bets $2.15
SantiagoWeight: folds 
Uncalled bet ($2.15) returned to 905steelcity
905steelcity collected $4.30 from pot
905steelcity: doesn't show hand 
*** SUMMARY ***
Total pot $4.50 | Rake $0.20 
Board [Tc 3c Qd 9h 2c]
Seat 1: osa126 (button) folded before Flop (didn't bet)
Seat 2: dan_iasi (small blind) folded before Flop
Seat 3: SantiagoWeight (big blind) folded on the River
Seat 4: 905steelcity collected ($4.30)
Seat 5: Renner32 folded before Flop (didn't bet)
Seat 6: Trapduck folded before Flop (didn't bet)



PokerStars Zoom Hand #195023778274:  Hold'em No Limit ($0.10/$0.25) - 2018/12/29 3:58:25 UTC [2018/12/28 22:58:25 ET]
Table 'Hydra' 6-max Seat #1 is the button
Seat 1: Jack123985 ($26.98 in chips) 
Seat 2: Albratros2 ($35.53 in chips) 
Seat 3: miru877 ($61.78 in chips) 
Seat 4: SantiagoWeight ($25 in chips) 
Seat 5: Party4Arthy ($61.08 in chips) 
Seat 6: dithflo ($18.62 in chips) 
Albratros2: posts small blind $0.10
miru877: posts big blind $0.25
*** HOLE CARDS ***
Dealt to SantiagoWeight [5h 2s]
SantiagoWeight: folds 
Party4Arthy: folds 
dithflo: folds 
Jack123985: raises $0.37 to $0.62
Albratros2: calls $0.52
miru877: calls $0.37
*** FLOP *** [6c 7s Jc]
Albratros2: checks 
miru877: checks 
Jack123985: checks 
*** TURN *** [6c 7s Jc] [9d]
Albratros2: checks 
miru877: checks 
Jack123985: checks 
*** RIVER *** [6c 7s Jc 9d] [Qh]
Albratros2: checks 
miru877: checks 
Jack123985: bets $1.24
Albratros2: folds 
miru877: calls $1.24
*** SHOW DOWN ***
Jack123985: shows [2d 5d] (high card Queen)
miru877: shows [Qc Ks] (a pair of Queens)
miru877 collected $4.14 from pot
*** SUMMARY ***
Total pot $4.34 | Rake $0.20 
Board [6c 7s Jc 9d Qh]
Seat 1: Jack123985 (button) showed [2d 5d] and lost with high card Queen
Seat 2: Albratros2 (small blind) folded on the River
Seat 3: miru877 (big blind) showed [Qc Ks] and won ($4.14) with a pair of Queens
Seat 4: SantiagoWeight folded before Flop (didn't bet)
Seat 5: Party4Arthy folded before Flop (didn't bet)
Seat 6: dithflo folded before Flop (didn't bet)



PokerStars Zoom Hand #195023792166:  Hold'em No Limit ($0.10/$0.25) - 2018/12/29 3:59:17 UTC [2018/12/28 22:59:17 ET]
Table 'Hydra' 6-max Seat #1 is the button
Seat 1: SantiagoWeight ($22.80 in chips) 
Seat 2: ruiken ($38.37 in chips) 
Seat 3: winwinboy ($27 in chips) 
Seat 4: Lehared ($66.16 in chips) 
Seat 5: ryanking99 ($27.28 in chips) 
Seat 6: Actarusqc ($21.44 in chips) 
ruiken: posts small blind $0.10
winwinboy: posts big blind $0.25
*** HOLE CARDS ***
Dealt to SantiagoWeight [Ac 9s]
Lehared: folds 
ryanking99: folds 
Actarusqc: calls $0.25
SantiagoWeight: raises $0.75 to $1
ruiken: folds 
winwinboy: folds 
Actarusqc: calls $0.75
*** FLOP *** [4d Qs Kd]
Actarusqc: checks 
SantiagoWeight: bets $0.56
Actarusqc: calls $0.56
*** TURN *** [4d Qs Kd] [2d]
Actarusqc: checks 
SantiagoWeight: checks 
*** RIVER *** [4d Qs Kd 2d] [7d]
Actarusqc: bets $3.31
SantiagoWeight: folds 
Uncalled bet ($3.31) returned to Actarusqc
Actarusqc collected $3.31 from pot
*** SUMMARY ***
Total pot $3.47 | Rake $0.16 
Board [4d Qs Kd 2d 7d]
Seat 1: SantiagoWeight (button) folded on the River
Seat 2: ruiken (small blind) folded before Flop
Seat 3: winwinboy (big blind) folded before Flop
Seat 4: Lehared folded before Flop (didn't bet)
Seat 5: ryanking99 folded before Flop (didn't bet)
Seat 6: Actarusqc collected ($3.31)



PokerStars Zoom Hand #195023807259:  Hold'em No Limit ($0.10/$0.25) - 2018/12/29 4:00:13 UTC [2018/12/28 23:00:13 ET]
Table 'Hydra' 6-max Seat #1 is the button
Seat 1: KeySssi ($25.02 in chips) 
Seat 2: SantiagoWeight ($21.24 in chips) 
Seat 3: razil_999 ($30.21 in chips) 
Seat 4: graysonai ($36.91 in chips) 
Seat 5: osa126 ($64.42 in chips) 
Seat 6: zdenekstavic ($43.38 in chips) 
SantiagoWeight: posts small blind $0.10
razil_999: posts big blind $0.25
*** HOLE CARDS ***
Dealt to SantiagoWeight [Qs Jd]
graysonai: folds 
osa126: raises $0.50 to $0.75
zdenekstavic: folds 
KeySssi: folds 
SantiagoWeight: folds 
razil_999: folds 
Uncalled bet ($0.50) returned to osa126
osa126 collected $0.60 from pot
osa126: doesn't show hand 
*** SUMMARY ***
Total pot $0.60 | Rake $0 
Seat 1: KeySssi (button) folded before Flop (didn't bet)
Seat 2: SantiagoWeight (small blind) folded before Flop
Seat 3: razil_999 (big blind) folded before Flop
Seat 4: graysonai folded before Flop (didn't bet)
Seat 5: osa126 collected ($0.60)
Seat 6: zdenekstavic folded before Flop (didn't bet)



PokerStars Zoom Hand #195023810728:  Hold'em No Limit ($0.10/$0.25) - 2018/12/29 4:00:26 UTC [2018/12/28 23:00:26 ET]
Table 'Hydra' 6-max Seat #1 is the button
Seat 1: Mrs_Squeeze ($17.76 in chips) 
Seat 2: 666erkan ($17.51 in chips) 
Seat 3: DUDA3553 ($27.46 in chips) 
Seat 4: dan_iasi ($46.58 in chips) 
Seat 5: qing328 ($26.10 in chips) 
Seat 6: SantiagoWeight ($21.14 in chips) 
666erkan: posts small blind $0.10
DUDA3553: posts big blind $0.25
*** HOLE CARDS ***
Dealt to SantiagoWeight [Kd 2d]
dan_iasi: folds 
qing328: folds 
SantiagoWeight: raises $0.30 to $0.55
Mrs_Squeeze: folds 
666erkan: folds 
DUDA3553: folds 
Uncalled bet ($0.30) returned to SantiagoWeight
SantiagoWeight collected $0.60 from pot
SantiagoWeight: doesn't show hand 
*** SUMMARY ***
Total pot $0.60 | Rake $0 
Seat 1: Mrs_Squeeze (button) folded before Flop (didn't bet)
Seat 2: 666erkan (small blind) folded before Flop
Seat 3: DUDA3553 (big blind) folded before Flop
Seat 4: dan_iasi folded before Flop (didn't bet)
Seat 5: qing328 folded before Flop (didn't bet)
Seat 6: SantiagoWeight collected ($0.60)



PokerStars Zoom Hand #195023816118:  Hold'em No Limit ($0.10/$0.25) - 2018/12/29 4:00:45 UTC [2018/12/28 23:00:45 ET]
Table 'Hydra' 6-max Seat #1 is the button
Seat 1: bestitest542 ($44.60 in chips) 
Seat 2: Unclesmoll ($46.17 in chips) 
Seat 3: SantiagoWeight ($21.49 in chips) 
Seat 4: LLiarrr ($25 in chips) 
Seat 5: kakashi_zion ($19.71 in chips) 
Seat 6: 666erkan ($17.41 in chips) 
Unclesmoll: posts small blind $0.10
SantiagoWeight: posts big blind $0.25
*** HOLE CARDS ***
Dealt to SantiagoWeight [7s As]
LLiarrr has timed out while disconnected
LLiarrr: folds 
kakashi_zion: folds 
666erkan: folds 
bestitest542: calls $0.25
Unclesmoll: folds 
SantiagoWeight: raises $1.05 to $1.30
bestitest542: calls $1.05
*** FLOP *** [3c 2h Kh]
SantiagoWeight: bets $0.65
bestitest542: calls $0.65
*** TURN *** [3c 2h Kh] [Th]
SantiagoWeight: checks 
bestitest542: bets $9.25
SantiagoWeight: folds 
Uncalled bet ($9.25) returned to bestitest542
bestitest542 collected $3.82 from pot
*** SUMMARY ***
Total pot $4 | Rake $0.18 
Board [3c 2h Kh Th]
Seat 1: bestitest542 (button) collected ($3.82)
Seat 2: Unclesmoll (small blind) folded before Flop
Seat 3: SantiagoWeight (big blind) folded on the Turn
Seat 4: LLiarrr folded before Flop (didn't bet)
Seat 5: kakashi_zion folded before Flop (didn't bet)
Seat 6: 666erkan folded before Flop (didn't bet)



PokerStars Zoom Hand #195023834221:  Hold'em No Limit ($0.10/$0.25) - 2018/12/29 4:01:47 UTC [2018/12/28 23:01:47 ET]
Table 'Hydra' 6-max Seat #1 is the button
Seat 1: SantiagoWeight ($23.05 in chips) 
Seat 2: dithflo ($12.95 in chips) 
Seat 3: mariopork ($48.79 in chips) 
Seat 4: Bonen18 ($26.05 in chips) 
Seat 5: miru877 ($28.48 in chips) 
Seat 6: HansMSM ($32.09 in chips) 
dithflo: posts small blind $0.10
mariopork: posts big blind $0.25
*** HOLE CARDS ***
Dealt to SantiagoWeight [2d Th]
Bonen18: folds 
miru877: folds 
HansMSM: raises $0.45 to $0.70
SantiagoWeight: folds 
dithflo: folds 
mariopork: folds 
Uncalled bet ($0.45) returned to HansMSM
HansMSM collected $0.60 from pot
HansMSM: doesn't show hand 
*** SUMMARY ***
Total pot $0.60 | Rake $0 
Seat 1: SantiagoWeight (button) folded before Flop (didn't bet)
Seat 2: dithflo (small blind) folded before Flop
Seat 3: mariopork (big blind) folded before Flop
Seat 4: Bonen18 folded before Flop (didn't bet)
Seat 5: miru877 folded before Flop (didn't bet)
Seat 6: HansMSM collected ($0.60)



PokerStars Zoom Hand #195023832238:  Hold'em No Limit ($0.10/$0.25) - 2018/12/29 4:01:40 UTC [2018/12/28 23:01:40 ET]
Table 'Hydra' 6-max Seat #1 is the button
Seat 1: ruiken ($39.65 in chips) 
Seat 2: _BluDeeN_ ($45.89 in chips) 
Seat 3: lovintalbi ($85.59 in chips) 
Seat 4: Trapduck ($25 in chips) 
Seat 5: SantiagoWeight ($23.05 in chips) 
Seat 6: BMB8888 ($12.14 in chips) 
_BluDeeN_: posts small blind $0.10
lovintalbi: posts big blind $0.25
*** HOLE CARDS ***
Dealt to SantiagoWeight [Ks 6c]
Trapduck: folds 
SantiagoWeight: folds 
BMB8888: calls $0.25
ruiken: folds 
_BluDeeN_: folds 
lovintalbi: checks 
*** FLOP *** [7h 4c As]
lovintalbi: checks 
BMB8888: checks 
*** TURN *** [7h 4c As] [Qh]
lovintalbi: checks 
BMB8888: bets $0.50
lovintalbi: folds 
Uncalled bet ($0.50) returned to BMB8888
BMB8888 collected $0.57 from pot
BMB8888: doesn't show hand 
*** SUMMARY ***
Total pot $0.60 | Rake $0.03 
Board [7h 4c As Qh]
Seat 1: ruiken (button) folded before Flop (didn't bet)
Seat 2: _BluDeeN_ (small blind) folded before Flop
Seat 3: lovintalbi (big blind) folded on the Turn
Seat 4: Trapduck folded before Flop (didn't bet)
Seat 5: SantiagoWeight folded before Flop (didn't bet)
Seat 6: BMB8888 collected ($0.57)



PokerStars Zoom Hand #195023835465:  Hold'em No Limit ($0.10/$0.25) - 2018/12/29 4:01:51 UTC [2018/12/28 23:01:51 ET]
Table 'Hydra' 6-max Seat #1 is the button
Seat 1: _BluDeeN_ ($27.31 in chips) 
Seat 2: SantiagoWeight ($23.05 in chips) 
Seat 3: Bonen18 ($26.05 in chips) 
Seat 4: VriesAde ($12.13 in chips) 
Seat 5: Nutselas ($31.31 in chips) 
Seat 6: KeySssi ($29.42 in chips) 
SantiagoWeight: posts small blind $0.10
Bonen18: posts big blind $0.25
*** HOLE CARDS ***
Dealt to SantiagoWeight [As Ks]
VriesAde: folds 
Nutselas: folds 
KeySssi: raises $0.37 to $0.62
_BluDeeN_: folds 
SantiagoWeight: raises $1.58 to $2.20
Bonen18: folds 
KeySssi: folds 
Uncalled bet ($1.58) returned to SantiagoWeight
SantiagoWeight collected $1.49 from pot
SantiagoWeight: doesn't show hand 
*** SUMMARY ***
Total pot $1.49 | Rake $0 
Seat 1: _BluDeeN_ (button) folded before Flop (didn't bet)
Seat 2: SantiagoWeight (small blind) collected ($1.49)
Seat 3: Bonen18 (big blind) folded before Flop
Seat 4: VriesAde folded before Flop (didn't bet)
Seat 5: Nutselas folded before Flop (didn't bet)
Seat 6: KeySssi folded before Flop



PokerStars Zoom Hand #195023843129:  Hold'em No Limit ($0.10/$0.25) - 2018/12/29 4:02:17 UTC [2018/12/28 23:02:17 ET]
Table 'Hydra' 6-max Seat #1 is the button
Seat 1: mariopork ($48.44 in chips) 
Seat 2: bigm2261 ($12.50 in chips) 
Seat 3: reggiedogg31 ($90.32 in chips) 
Seat 4: GrandmasterY ($45.32 in chips) 
Seat 5: Mandu_xiii ($48.20 in chips) 
Seat 6: SantiagoWeight ($23.92 in chips) 
bigm2261: posts small blind $0.10
reggiedogg31: posts big blind $0.25
*** HOLE CARDS ***
Dealt to SantiagoWeight [Qs Ah]
GrandmasterY: raises $0.50 to $0.75
Mandu_xiii: folds 
SantiagoWeight: calls $0.75
mariopork: folds 
bigm2261: folds 
reggiedogg31: raises $2.75 to $3.50
GrandmasterY: folds 
SantiagoWeight: calls $2.75
*** FLOP *** [8c 8d Ts]
reggiedogg31: bets $6.75
SantiagoWeight: folds 
Uncalled bet ($6.75) returned to reggiedogg31
reggiedogg31 collected $7.50 from pot
*** SUMMARY ***
Total pot $7.85 | Rake $0.35 
Board [8c 8d Ts]
Seat 1: mariopork (button) folded before Flop (didn't bet)
Seat 2: bigm2261 (small blind) folded before Flop
Seat 3: reggiedogg31 (big blind) collected ($7.50)
Seat 4: GrandmasterY folded before Flop
Seat 5: Mandu_xiii folded before Flop (didn't bet)
Seat 6: SantiagoWeight folded on the Flop



PokerStars Zoom Hand #195023868675:  Hold'em No Limit ($0.10/$0.25) - 2018/12/29 4:03:44 UTC [2018/12/28 23:03:44 ET]
Table 'Hydra' 6-max Seat #1 is the button
Seat 1: bigm2261 ($12.50 in chips) 
Seat 2: reademenweep ($20.14 in chips) 
Seat 3: yobbos ($146.95 in chips) 
Seat 4: Party4Arthy ($59.52 in chips) 
Seat 5: SantiagoWeight ($20.42 in chips) 
Seat 6: qing328 ($27.09 in chips) 
reademenweep: posts small blind $0.10
yobbos: posts big blind $0.25
*** HOLE CARDS ***
Dealt to SantiagoWeight [Kd Jc]
Party4Arthy: raises $0.25 to $0.50
SantiagoWeight: calls $0.50
qing328: folds 
bigm2261: folds 
reademenweep: folds 
yobbos: folds 
*** FLOP *** [Tc Qd 5c]
Party4Arthy: checks 
SantiagoWeight: bets $0.86
Party4Arthy: calls $0.86
*** TURN *** [Tc Qd 5c] [6h]
Party4Arthy: checks 
SantiagoWeight: bets $2.40
Party4Arthy: folds 
Uncalled bet ($2.40) returned to SantiagoWeight
SantiagoWeight collected $2.93 from pot
SantiagoWeight: doesn't show hand 
*** SUMMARY ***
Total pot $3.07 | Rake $0.14 
Board [Tc Qd 5c 6h]
Seat 1: bigm2261 (button) folded before Flop (didn't bet)
Seat 2: reademenweep (small blind) folded before Flop
Seat 3: yobbos (big blind) folded before Flop
Seat 4: Party4Arthy folded on the Turn
Seat 5: SantiagoWeight collected ($2.93)
Seat 6: qing328 folded before Flop (didn't bet)



PokerStars Zoom Hand #195023882153:  Hold'em No Limit ($0.10/$0.25) - 2018/12/29 4:04:29 UTC [2018/12/28 23:04:29 ET]
Table 'Hydra' 6-max Seat #1 is the button
Seat 1: razil_999 ($30.66 in chips) 
Seat 2: ColinCaine ($11.49 in chips) 
Seat 3: alex3d1985 ($39.70 in chips) 
Seat 4: SantiagoWeight ($21.99 in chips) 
Seat 5: nhanminhtri ($28.80 in chips) 
Seat 6: LLiarrr ($25.35 in chips) 
ColinCaine: posts small blind $0.10
alex3d1985: posts big blind $0.25
*** HOLE CARDS ***
Dealt to SantiagoWeight [Jh 9h]
SantiagoWeight: raises $0.42 to $0.67
nhanminhtri: folds 
LLiarrr: folds 
razil_999: folds 
ColinCaine: folds 
alex3d1985: folds 
Uncalled bet ($0.42) returned to SantiagoWeight
SantiagoWeight collected $0.60 from pot
SantiagoWeight: doesn't show hand 
*** SUMMARY ***
Total pot $0.60 | Rake $0 
Seat 1: razil_999 (button) folded before Flop (didn't bet)
Seat 2: ColinCaine (small blind) folded before Flop
Seat 3: alex3d1985 (big blind) folded before Flop
Seat 4: SantiagoWeight collected ($0.60)
Seat 5: nhanminhtri folded before Flop (didn't bet)
Seat 6: LLiarrr folded before Flop (didn't bet)



PokerStars Zoom Hand #195023885691:  Hold'em No Limit ($0.10/$0.25) - 2018/12/29 4:04:41 UTC [2018/12/28 23:04:41 ET]
Table 'Hydra' 6-max Seat #1 is the button
Seat 1: ivann14 ($25.25 in chips) 
Seat 2: dawwwid70 ($25 in chips) 
Seat 3: SantiagoWeight ($22.34 in chips) 
Seat 4: hamen1990 ($25.57 in chips) 
Seat 5: pirosiky ($27.43 in chips) 
Seat 6: ryanking99 ($31 in chips) 
dawwwid70: posts small blind $0.10
SantiagoWeight: posts big blind $0.25
*** HOLE CARDS ***
Dealt to SantiagoWeight [Jc Kd]
hamen1990: raises $0.50 to $0.75
pirosiky: folds 
ryanking99: folds 
ivann14: folds 
dawwwid70: calls $0.65
SantiagoWeight: calls $0.50
*** FLOP *** [Jh 4c 4d]
dawwwid70: checks 
SantiagoWeight: checks 
hamen1990: checks 
*** TURN *** [Jh 4c 4d] [5h]
dawwwid70: checks 
SantiagoWeight: bets $1.10
hamen1990: folds 
dawwwid70: calls $1.10
*** RIVER *** [Jh 4c 4d 5h] [5c]
dawwwid70: checks 
SantiagoWeight: bets $5.30
dawwwid70: calls $5.30
*** SHOW DOWN ***
SantiagoWeight: shows [Jc Kd] (two pair, Jacks and Fives)
dawwwid70: mucks hand 
SantiagoWeight collected $14.37 from pot
*** SUMMARY ***
Total pot $15.05 | Rake $0.68 
Board [Jh 4c 4d 5h 5c]
Seat 1: ivann14 (button) folded before Flop (didn't bet)
Seat 2: dawwwid70 (small blind) mucked [9c 9d]
Seat 3: SantiagoWeight (big blind) showed [Jc Kd] and won ($14.37) with two pair, Jacks and Fives
Seat 4: hamen1990 folded on the Turn
Seat 5: pirosiky folded before Flop (didn't bet)
Seat 6: ryanking99 folded before Flop (didn't bet)



PokerStars Zoom Hand #195023907452:  Hold'em No Limit ($0.10/$0.25) - 2018/12/29 4:05:54 UTC [2018/12/28 23:05:54 ET]
Table 'Hydra' 6-max Seat #1 is the button
Seat 1: Virus3232 ($26.35 in chips) 
Seat 2: SantiagoWeight ($29.56 in chips) 
Seat 3: ryanking99 ($28.72 in chips) 
Seat 4: qing328 ($23.75 in chips) 
Seat 5: zbuci ($25.17 in chips) 
Seat 6: kiteboard26 ($30.67 in chips) 
SantiagoWeight: posts small blind $0.10
ryanking99: posts big blind $0.25
*** HOLE CARDS ***
Dealt to SantiagoWeight [Ad Kc]
qing328: folds 
zbuci: folds 
kiteboard26: folds 
Virus3232: folds 
SantiagoWeight: raises $0.50 to $0.75
ryanking99: folds 
Uncalled bet ($0.50) returned to SantiagoWeight
SantiagoWeight collected $0.50 from pot
SantiagoWeight: doesn't show hand 
*** SUMMARY ***
Total pot $0.50 | Rake $0 
Seat 1: Virus3232 (button) folded before Flop (didn't bet)
Seat 2: SantiagoWeight (small blind) collected ($0.50)
Seat 3: ryanking99 (big blind) folded before Flop
Seat 4: qing328 folded before Flop (didn't bet)
Seat 5: zbuci folded before Flop (didn't bet)
Seat 6: kiteboard26 folded before Flop (didn't bet)



PokerStars Zoom Hand #195023912428:  Hold'em No Limit ($0.10/$0.25) - 2018/12/29 4:06:11 UTC [2018/12/28 23:06:11 ET]
Table 'Hydra' 6-max Seat #1 is the button
Seat 1: yobbos ($73.72 in chips) 
Seat 2: hamen1990 ($24.22 in chips) 
Seat 3: mariopork ($27.18 in chips) 
Seat 4: ColinCaine ($10.04 in chips) 
Seat 5: SantiagoWeight ($29.81 in chips) 
Seat 6: KeySssi ($25 in chips) 
hamen1990: posts small blind $0.10
mariopork: posts big blind $0.25
*** HOLE CARDS ***
Dealt to SantiagoWeight [Js Ts]
ColinCaine: raises $0.50 to $0.75
SantiagoWeight: raises $1.35 to $2.10
KeySssi: folds 
yobbos: folds 
hamen1990: folds 
mariopork: folds 
ColinCaine: calls $1.35
*** FLOP *** [Ah 6d 3h]
ColinCaine: bets $7.94 and is all-in
SantiagoWeight: folds 
Uncalled bet ($7.94) returned to ColinCaine
ColinCaine collected $4.35 from pot
ColinCaine: doesn't show hand 
*** SUMMARY ***
Total pot $4.55 | Rake $0.20 
Board [Ah 6d 3h]
Seat 1: yobbos (button) folded before Flop (didn't bet)
Seat 2: hamen1990 (small blind) folded before Flop
Seat 3: mariopork (big blind) folded before Flop
Seat 4: ColinCaine collected ($4.35)
Seat 5: SantiagoWeight folded on the Flop
Seat 6: KeySssi folded before Flop (didn't bet)



PokerStars Zoom Hand #195023920393:  Hold'em No Limit ($0.10/$0.25) - 2018/12/29 4:06:38 UTC [2018/12/28 23:06:38 ET]
Table 'Hydra' 6-max Seat #1 is the button
Seat 1: Lehared ($25 in chips) 
Seat 2: nabechan814 ($24.96 in chips) 
Seat 3: ol_2face ($83.35 in chips) 
Seat 4: alex3d1985 ($45.38 in chips) 
Seat 5: ColinCaine ($12.29 in chips) 
Seat 6: SantiagoWeight ($27.71 in chips) 
nabechan814: posts small blind $0.10
ol_2face: posts big blind $0.25
*** HOLE CARDS ***
Dealt to SantiagoWeight [8c 3h]
alex3d1985: folds 
ColinCaine: folds 
SantiagoWeight: folds 
Lehared: folds 
nabechan814: folds 
Uncalled bet ($0.15) returned to ol_2face
ol_2face collected $0.20 from pot
ol_2face: doesn't show hand 
*** SUMMARY ***
Total pot $0.20 | Rake $0 
Seat 1: Lehared (button) folded before Flop (didn't bet)
Seat 2: nabechan814 (small blind) folded before Flop
Seat 3: ol_2face (big blind) collected ($0.20)
Seat 4: alex3d1985 folded before Flop (didn't bet)
Seat 5: ColinCaine folded before Flop (didn't bet)
Seat 6: SantiagoWeight folded before Flop (didn't bet)



PokerStars Zoom Hand #195023924808:  Hold'em No Limit ($0.10/$0.25) - 2018/12/29 4:06:53 UTC [2018/12/28 23:06:53 ET]
Table 'Hydra' 6-max Seat #1 is the button
Seat 1: Virus3232 ($25 in chips) 
Seat 2: ryanking99 ($24.75 in chips) 
Seat 3: mililser ($26 in chips) 
Seat 4: SantiagoWeight ($27.71 in chips) 
Seat 5: mariopork ($27.18 in chips) 
Seat 6: --LeGaaNs-- ($84.91 in chips) 
ryanking99: posts small blind $0.10
mililser: posts big blind $0.25
*** HOLE CARDS ***
Dealt to SantiagoWeight [Jh Qh]
SantiagoWeight: raises $0.42 to $0.67
mariopork: folds 
--LeGaaNs--: calls $0.67
Virus3232: folds 
ryanking99: folds 
mililser: calls $0.42
*** FLOP *** [2d Kd 8h]
mililser: checks 
SantiagoWeight: bets $0.51
--LeGaaNs--: calls $0.51
mililser: folds 
*** TURN *** [2d Kd 8h] [Qc]
SantiagoWeight: checks 
--LeGaaNs--: checks 
*** RIVER *** [2d Kd 8h Qc] [6c]
SantiagoWeight: bets $1.20
--LeGaaNs--: folds 
Uncalled bet ($1.20) returned to SantiagoWeight
SantiagoWeight collected $2.99 from pot
SantiagoWeight: doesn't show hand 
*** SUMMARY ***
Total pot $3.13 | Rake $0.14 
Board [2d Kd 8h Qc 6c]
Seat 1: Virus3232 (button) folded before Flop (didn't bet)
Seat 2: ryanking99 (small blind) folded before Flop
Seat 3: mililser (big blind) folded on the Flop
Seat 4: SantiagoWeight collected ($2.99)
Seat 5: mariopork folded before Flop (didn't bet)
Seat 6: --LeGaaNs-- folded on the River



PokerStars Zoom Hand #195023943412:  Hold'em No Limit ($0.10/$0.25) - 2018/12/29 4:07:56 UTC [2018/12/28 23:07:56 ET]
Table 'Hydra' 6-max Seat #1 is the button
Seat 1: davidhw888 ($39.51 in chips) 
Seat 2: cashwillis17 ($26.24 in chips) 
Seat 3: SantiagoWeight ($29.52 in chips) 
Seat 4: --LeGaaNs-- ($83.73 in chips) 
Seat 5: mariopork ($34.17 in chips) 
Seat 6: ivann14 ($69.12 in chips) 
cashwillis17: posts small blind $0.10
SantiagoWeight: posts big blind $0.25
*** HOLE CARDS ***
Dealt to SantiagoWeight [Ts 9d]
--LeGaaNs--: folds 
mariopork: folds 
ivann14: folds 
davidhw888: folds 
cashwillis17: folds 
Uncalled bet ($0.15) returned to SantiagoWeight
SantiagoWeight collected $0.20 from pot
SantiagoWeight: doesn't show hand 
*** SUMMARY ***
Total pot $0.20 | Rake $0 
Seat 1: davidhw888 (button) folded before Flop (didn't bet)
Seat 2: cashwillis17 (small blind) folded before Flop
Seat 3: SantiagoWeight (big blind) collected ($0.20)
Seat 4: --LeGaaNs-- folded before Flop (didn't bet)
Seat 5: mariopork folded before Flop (didn't bet)
Seat 6: ivann14 folded before Flop (didn't bet)



PokerStars Zoom Hand #195023948402:  Hold'em No Limit ($0.10/$0.25) - 2018/12/29 4:08:13 UTC [2018/12/28 23:08:13 ET]
Table 'Hydra' 6-max Seat #1 is the button
Seat 1: onhoang87 ($20.22 in chips) 
Seat 2: SantiagoWeight ($29.62 in chips) 
Seat 3: ryanking99 ($26.32 in chips) 
Seat 4: vulcandog ($19.75 in chips) 
Seat 5: Bonen18 ($25 in chips) 
Seat 6: ivann14 ($54.02 in chips) 
SantiagoWeight: posts small blind $0.10
ryanking99: posts big blind $0.25
*** HOLE CARDS ***
Dealt to SantiagoWeight [2h 6d]
vulcandog: folds 
Bonen18: folds 
ivann14: folds 
onhoang87: folds 
SantiagoWeight: folds 
Uncalled bet ($0.15) returned to ryanking99
ryanking99 collected $0.20 from pot
ryanking99: doesn't show hand 
*** SUMMARY ***
Total pot $0.20 | Rake $0 
Seat 1: onhoang87 (button) folded before Flop (didn't bet)
Seat 2: SantiagoWeight (small blind) folded before Flop
Seat 3: ryanking99 (big blind) collected ($0.20)
Seat 4: vulcandog folded before Flop (didn't bet)
Seat 5: Bonen18 folded before Flop (didn't bet)
Seat 6: ivann14 folded before Flop (didn't bet)



PokerStars Zoom Hand #195023923654:  Hold'em No Limit ($0.10/$0.25) - 2018/12/29 4:06:49 UTC [2018/12/28 23:06:49 ET]
Table 'Hydra' 6-max Seat #1 is the button
Seat 1: SantiagoWeight ($27.71 in chips) 
Seat 2: graysonai ($29.64 in chips) 
Seat 3: Dbakunwaves ($53.18 in chips) 
Seat 4: franco373513 ($18.07 in chips) 
Seat 5: winwinboy ($25.35 in chips) 
Seat 6: nhanminhtri ($25 in chips) 
graysonai: posts small blind $0.10
Dbakunwaves: posts big blind $0.25
*** HOLE CARDS ***
Dealt to SantiagoWeight [5s 2h]
franco373513: calls $0.25
winwinboy: raises $1 to $1.25
nhanminhtri: folds 
SantiagoWeight: folds 
graysonai: folds 
Dbakunwaves has timed out
Dbakunwaves: folds 
franco373513: calls $1
*** FLOP *** [8h Tc 4s]
franco373513: checks 
winwinboy: bets $2.25
franco373513: folds 
Uncalled bet ($2.25) returned to winwinboy
winwinboy collected $2.72 from pot
winwinboy: doesn't show hand 
*** SUMMARY ***
Total pot $2.85 | Rake $0.13 
Board [8h Tc 4s]
Seat 1: SantiagoWeight (button) folded before Flop (didn't bet)
Seat 2: graysonai (small blind) folded before Flop
Seat 3: Dbakunwaves (big blind) folded before Flop
Seat 4: franco373513 folded on the Flop
Seat 5: winwinboy collected ($2.72)
Seat 6: nhanminhtri folded before Flop (didn't bet)



PokerStars Zoom Hand #195023951279:  Hold'em No Limit ($0.10/$0.25) - 2018/12/29 4:08:23 UTC [2018/12/28 23:08:23 ET]
Table 'Hydra' 6-max Seat #1 is the button
Seat 1: SantiagoWeight ($29.52 in chips) 
Seat 2: trttt74 ($14.25 in chips) 
Seat 3: KeySssi ($25.70 in chips) 
Seat 4: winwinboy ($25 in chips) 
Seat 5: naxizzle ($117.50 in chips) 
Seat 6: Nutselas ($33.87 in chips) 
trttt74: posts small blind $0.10
KeySssi: posts big blind $0.25
*** HOLE CARDS ***
Dealt to SantiagoWeight [Jc 7d]
winwinboy: folds 
naxizzle: folds 
Nutselas: folds 
SantiagoWeight: raises $0.30 to $0.55
trttt74: folds 
KeySssi: folds 
Uncalled bet ($0.30) returned to SantiagoWeight
SantiagoWeight collected $0.60 from pot
SantiagoWeight: doesn't show hand 
*** SUMMARY ***
Total pot $0.60 | Rake $0 
Seat 1: SantiagoWeight (button) collected ($0.60)
Seat 2: trttt74 (small blind) folded before Flop
Seat 3: KeySssi (big blind) folded before Flop
Seat 4: winwinboy folded before Flop (didn't bet)
Seat 5: naxizzle folded before Flop (didn't bet)
Seat 6: Nutselas folded before Flop (didn't bet)



PokerStars Zoom Hand #195023947237:  Hold'em No Limit ($0.10/$0.25) - 2018/12/29 4:08:09 UTC [2018/12/28 23:08:09 ET]
Table 'Hydra' 6-max Seat #1 is the button
Seat 1: Xp0Hb ($44.68 in chips) 
Seat 2: dan_iasi ($104.93 in chips) 
Seat 3: KAllUSTA ($22.21 in chips) 
Seat 4: SantiagoWeight ($29.62 in chips) 
Seat 5: winwinboy ($25 in chips) 
Seat 6: Virus3232 ($26.70 in chips) 
dan_iasi: posts small blind $0.10
KAllUSTA: posts big blind $0.25
*** HOLE CARDS ***
Dealt to SantiagoWeight [9d 8h]
SantiagoWeight: folds 
winwinboy: folds 
Virus3232 has timed out while disconnected
Virus3232: folds 
Xp0Hb: folds 
dan_iasi: raises $0.50 to $0.75
KAllUSTA: raises $1.50 to $2.25
dan_iasi: folds 
Uncalled bet ($1.50) returned to KAllUSTA
KAllUSTA collected $1.50 from pot
KAllUSTA: doesn't show hand 
*** SUMMARY ***
Total pot $1.50 | Rake $0 
Seat 1: Xp0Hb (button) folded before Flop (didn't bet)
Seat 2: dan_iasi (small blind) folded before Flop
Seat 3: KAllUSTA (big blind) collected ($1.50)
Seat 4: SantiagoWeight folded before Flop (didn't bet)
Seat 5: winwinboy folded before Flop (didn't bet)
Seat 6: Virus3232 folded before Flop (didn't bet)



PokerStars Zoom Hand #195023957074:  Hold'em No Limit ($0.10/$0.25) - 2018/12/29 4:08:43 UTC [2018/12/28 23:08:43 ET]
Table 'Hydra' 6-max Seat #1 is the button
Seat 1: MileVoliD49 ($30.88 in chips) 
Seat 2: Lehared ($75.54 in chips) 
Seat 3: TQNYMQNTANA ($26.23 in chips) 
Seat 4: cankum ($26.12 in chips) 
Seat 5: davidhw888 ($30.41 in chips) 
Seat 6: SantiagoWeight ($29.87 in chips) 
Lehared: posts small blind $0.10
TQNYMQNTANA: posts big blind $0.25
*** HOLE CARDS ***
Dealt to SantiagoWeight [4s Th]
cankum: folds 
davidhw888: folds 
SantiagoWeight: folds 
MileVoliD49: folds 
Lehared: raises $0.50 to $0.75
TQNYMQNTANA: calls $0.50
*** FLOP *** [Jc Qc 7s]
Lehared: bets $1.10
TQNYMQNTANA: calls $1.10
*** TURN *** [Jc Qc 7s] [2h]
Lehared: checks 
TQNYMQNTANA: bets $2.50
Lehared: calls $2.50
*** RIVER *** [Jc Qc 7s 2h] [9h]
Lehared: checks 
TQNYMQNTANA: checks 
*** SHOW DOWN ***
Lehared: shows [Td Qs] (a pair of Queens)
TQNYMQNTANA: mucks hand 
Lehared collected $8.31 from pot
*** SUMMARY ***
Total pot $8.70 | Rake $0.39 
Board [Jc Qc 7s 2h 9h]
Seat 1: MileVoliD49 (button) folded before Flop (didn't bet)
Seat 2: Lehared (small blind) showed [Td Qs] and won ($8.31) with a pair of Queens
Seat 3: TQNYMQNTANA (big blind) mucked [5c 4c]
Seat 4: cankum folded before Flop (didn't bet)
Seat 5: davidhw888 folded before Flop (didn't bet)
Seat 6: SantiagoWeight folded before Flop (didn't bet)



PokerStars Zoom Hand #195023960357:  Hold'em No Limit ($0.10/$0.25) - 2018/12/29 4:08:54 UTC [2018/12/28 23:08:54 ET]
Table 'Hydra' 6-max Seat #1 is the button
Seat 1: ivann14 ($25.10 in chips) 
Seat 2: GrandmasterY ($57.66 in chips) 
Seat 3: SantiagoWeight ($29.87 in chips) 
Seat 4: ryanking99 ($25.30 in chips) 
Seat 5: dawwwid70 ($25 in chips) 
Seat 6: 777jsmith ($25.76 in chips) 
GrandmasterY: posts small blind $0.10
SantiagoWeight: posts big blind $0.25
*** HOLE CARDS ***
Dealt to SantiagoWeight [7c 7d]
ryanking99: folds 
dawwwid70: folds 
777jsmith: folds 
ivann14: folds 
GrandmasterY: raises $0.50 to $0.75
SantiagoWeight: calls $0.50
*** FLOP *** [Qc Ah 4s]
GrandmasterY: bets $0.43
SantiagoWeight: calls $0.43
*** TURN *** [Qc Ah 4s] [2c]
GrandmasterY: bets $2.81
SantiagoWeight: folds 
Uncalled bet ($2.81) returned to GrandmasterY
GrandmasterY collected $2.25 from pot
GrandmasterY: doesn't show hand 
*** SUMMARY ***
Total pot $2.36 | Rake $0.11 
Board [Qc Ah 4s 2c]
Seat 1: ivann14 (button) folded before Flop (didn't bet)
Seat 2: GrandmasterY (small blind) collected ($2.25)
Seat 3: SantiagoWeight (big blind) folded on the Turn
Seat 4: ryanking99 folded before Flop (didn't bet)
Seat 5: dawwwid70 folded before Flop (didn't bet)
Seat 6: 777jsmith folded before Flop (didn't bet)



PokerStars Zoom Hand #195023973692:  Hold'em No Limit ($0.10/$0.25) - 2018/12/29 4:09:40 UTC [2018/12/28 23:09:40 ET]
Table 'Hydra' 6-max Seat #1 is the button
Seat 1: nhanminhtri ($27.53 in chips) 
Seat 2: Mastermimo ($16.75 in chips) 
Seat 3: aa1421b ($43.67 in chips) 
Seat 4: winwinboy ($26.07 in chips) 
Seat 5: SantiagoWeight ($28.69 in chips) 
Seat 6: aldoalb0207 ($71.54 in chips) 
Mastermimo: posts small blind $0.10
aa1421b: posts big blind $0.25
*** HOLE CARDS ***
Dealt to SantiagoWeight [8d 5s]
winwinboy: folds 
SantiagoWeight: folds 
aldoalb0207: folds 
nhanminhtri: folds 
Mastermimo: folds 
Uncalled bet ($0.15) returned to aa1421b
aa1421b collected $0.20 from pot
aa1421b: doesn't show hand 
*** SUMMARY ***
Total pot $0.20 | Rake $0 
Seat 1: nhanminhtri (button) folded before Flop (didn't bet)
Seat 2: Mastermimo (small blind) folded before Flop
Seat 3: aa1421b (big blind) collected ($0.20)
Seat 4: winwinboy folded before Flop (didn't bet)
Seat 5: SantiagoWeight folded before Flop (didn't bet)
Seat 6: aldoalb0207 folded before Flop (didn't bet)



PokerStars Zoom Hand #195023977958:  Hold'em No Limit ($0.10/$0.25) - 2018/12/29 4:09:55 UTC [2018/12/28 23:09:55 ET]
Table 'Hydra' 6-max Seat #1 is the button
Seat 1: aa1421b ($43.77 in chips) 
Seat 2: SantiagoWeight ($28.69 in chips) 
Seat 3: tariko1980 ($28.54 in chips) 
Seat 4: trttt74 ($21.88 in chips) 
Seat 5: Unclesmoll ($12.70 in chips) 
Seat 6: landromede ($24.94 in chips) 
SantiagoWeight: posts small blind $0.10
tariko1980: posts big blind $0.25
*** HOLE CARDS ***
Dealt to SantiagoWeight [Tc 6h]
trttt74: folds 
Unclesmoll: folds 
landromede: calls $0.25
aa1421b: folds 
SantiagoWeight: folds 
tariko1980: checks 
*** FLOP *** [5h Qd 6d]
tariko1980: checks 
landromede: checks 
*** TURN *** [5h Qd 6d] [8h]
tariko1980: bets $0.50
landromede: calls $0.50
*** RIVER *** [5h Qd 6d 8h] [5d]
tariko1980: bets $2.25
landromede: folds 
Uncalled bet ($2.25) returned to tariko1980
tariko1980 collected $1.53 from pot
tariko1980: doesn't show hand 
*** SUMMARY ***
Total pot $1.60 | Rake $0.07 
Board [5h Qd 6d 8h 5d]
Seat 1: aa1421b (button) folded before Flop (didn't bet)
Seat 2: SantiagoWeight (small blind) folded before Flop
Seat 3: tariko1980 (big blind) collected ($1.53)
Seat 4: trttt74 folded before Flop (didn't bet)
Seat 5: Unclesmoll folded before Flop (didn't bet)
Seat 6: landromede folded on the River



PokerStars Zoom Hand #195023976820:  Hold'em No Limit ($0.10/$0.25) - 2018/12/29 4:09:51 UTC [2018/12/28 23:09:51 ET]
Table 'Hydra' 6-max Seat #1 is the button
Seat 1: winwinboy ($25.96 in chips) 
Seat 2: dan_iasi ($49.69 in chips) 
Seat 3: Breedijkie ($48.92 in chips) 
Seat 4: SantiagoWeight ($28.69 in chips) 
Seat 5: nhanminhtri ($25 in chips) 
Seat 6: davidhw888 ($37.19 in chips) 
dan_iasi: posts small blind $0.10
Breedijkie: posts big blind $0.25
*** HOLE CARDS ***
Dealt to SantiagoWeight [6c 3d]
SantiagoWeight: folds 
nhanminhtri: folds 
davidhw888: folds 
winwinboy: folds 
dan_iasi: raises $0.50 to $0.75
Breedijkie: calls $0.50
*** FLOP *** [6h 6s 7h]
dan_iasi: bets $1.06
Breedijkie: calls $1.06
*** TURN *** [6h 6s 7h] [2c]
dan_iasi: checks 
Breedijkie: bets $1.73
dan_iasi: folds 
Uncalled bet ($1.73) returned to Breedijkie
Breedijkie collected $3.46 from pot
Breedijkie: doesn't show hand 
*** SUMMARY ***
Total pot $3.62 | Rake $0.16 
Board [6h 6s 7h 2c]
Seat 1: winwinboy (button) folded before Flop (didn't bet)
Seat 2: dan_iasi (small blind) folded on the Turn
Seat 3: Breedijkie (big blind) collected ($3.46)
Seat 4: SantiagoWeight folded before Flop (didn't bet)
Seat 5: nhanminhtri folded before Flop (didn't bet)
Seat 6: davidhw888 folded before Flop (didn't bet)



PokerStars Zoom Hand #195023980773:  Hold'em No Limit ($0.10/$0.25) - 2018/12/29 4:10:05 UTC [2018/12/28 23:10:05 ET]
Table 'Hydra' 6-max Seat #1 is the button
Seat 1: SantiagoWeight ($28.59 in chips) 
Seat 2: graysonai ($25 in chips) 
Seat 3: mariopork ($34.34 in chips) 
Seat 4: KeySssi ($33.67 in chips) 
Seat 5: nhanminhtri ($34.54 in chips) 
Seat 6: trttt74 ($19.75 in chips) 
graysonai: posts small blind $0.10
mariopork: posts big blind $0.25
*** HOLE CARDS ***
Dealt to SantiagoWeight [9s Td]
KeySssi: folds 
nhanminhtri: raises $0.50 to $0.75
trttt74: folds 
SantiagoWeight: folds 
graysonai: folds 
mariopork: folds 
Uncalled bet ($0.50) returned to nhanminhtri
nhanminhtri collected $0.60 from pot
nhanminhtri: doesn't show hand 
*** SUMMARY ***
Total pot $0.60 | Rake $0 
Seat 1: SantiagoWeight (button) folded before Flop (didn't bet)
Seat 2: graysonai (small blind) folded before Flop
Seat 3: mariopork (big blind) folded before Flop
Seat 4: KeySssi folded before Flop (didn't bet)
Seat 5: nhanminhtri collected ($0.60)
Seat 6: trttt74 folded before Flop (didn't bet)



PokerStars Zoom Hand #195023989709:  Hold'em No Limit ($0.10/$0.25) - 2018/12/29 4:10:36 UTC [2018/12/28 23:10:36 ET]
Table 'Hydra' 6-max Seat #1 is the button
Seat 1: Chrimmpam ($75.60 in chips) 
Seat 2: tariko1980 ($29.32 in chips) 
Seat 3: Fobos113 ($14.21 in chips) 
Seat 4: Mastermimo ($18.80 in chips) 
Seat 5: Becks Baker ($25.22 in chips) 
Seat 6: SantiagoWeight ($28.59 in chips) 
tariko1980: posts small blind $0.10
Fobos113: posts big blind $0.25
*** HOLE CARDS ***
Dealt to SantiagoWeight [5d Qc]
Mastermimo: folds 
Becks Baker: raises $0.37 to $0.62
SantiagoWeight: folds 
Chrimmpam: folds 
tariko1980: folds 
Fobos113: calls $0.37
*** FLOP *** [8c 2c Qd]
Fobos113: checks 
Becks Baker: bets $0.38
Fobos113: folds 
Uncalled bet ($0.38) returned to Becks Baker
Becks Baker collected $1.28 from pot
Becks Baker: doesn't show hand 
*** SUMMARY ***
Total pot $1.34 | Rake $0.06 
Board [8c 2c Qd]
Seat 1: Chrimmpam (button) folded before Flop (didn't bet)
Seat 2: tariko1980 (small blind) folded before Flop
Seat 3: Fobos113 (big blind) folded on the Flop
Seat 4: Mastermimo folded before Flop (didn't bet)
Seat 5: Becks Baker collected ($1.28)
Seat 6: SantiagoWeight folded before Flop (didn't bet)



PokerStars Zoom Hand #195023993741:  Hold'em No Limit ($0.10/$0.25) - 2018/12/29 4:10:50 UTC [2018/12/28 23:10:50 ET]
Table 'Hydra' 6-max Seat #1 is the button
Seat 1: dan_iasi ($103.99 in chips) 
Seat 2: dithflo ($12.20 in chips) 
Seat 3: Gonzalit0o ($25 in chips) 
Seat 4: Bonen18 ($30.01 in chips) 
Seat 5: SantiagoWeight ($28.59 in chips) 
Seat 6: sigaro010 ($42.74 in chips) 
dithflo: posts small blind $0.10
Gonzalit0o: posts big blind $0.25
*** HOLE CARDS ***
Dealt to SantiagoWeight [9h 9d]
Bonen18: folds 
SantiagoWeight: raises $0.37 to $0.62
sigaro010: folds 
dan_iasi: folds 
dithflo: folds 
Gonzalit0o: calls $0.37
*** FLOP *** [6s 2d Ac]
Gonzalit0o: checks 
SantiagoWeight: bets $0.32
Gonzalit0o: calls $0.32
*** TURN *** [6s 2d Ac] [Js]
Gonzalit0o: checks 
SantiagoWeight: checks 
*** RIVER *** [6s 2d Ac Js] [Kd]
Gonzalit0o: bets $0.62
SantiagoWeight: folds 
Uncalled bet ($0.62) returned to Gonzalit0o
Gonzalit0o collected $1.89 from pot
Gonzalit0o: doesn't show hand 
*** SUMMARY ***
Total pot $1.98 | Rake $0.09 
Board [6s 2d Ac Js Kd]
Seat 1: dan_iasi (button) folded before Flop (didn't bet)
Seat 2: dithflo (small blind) folded before Flop
Seat 3: Gonzalit0o (big blind) collected ($1.89)
Seat 4: Bonen18 folded before Flop (didn't bet)
Seat 5: SantiagoWeight folded on the River
Seat 6: sigaro010 folded before Flop (didn't bet)



PokerStars Zoom Hand #195024009332:  Hold'em No Limit ($0.10/$0.25) - 2018/12/29 4:11:33 UTC [2018/12/28 23:11:33 ET]
Table 'Hydra' 6-max Seat #1 is the button
Seat 1: kaizin727 ($23.63 in chips) 
Seat 2: winwinboy ($25 in chips) 
Seat 3: SantiagoWeight ($27.65 in chips) 
Seat 4: aa1421b ($43.17 in chips) 
Seat 5: graysonai ($47.93 in chips) 
Seat 6: bigm2261 ($12.60 in chips) 
winwinboy: posts small blind $0.10
SantiagoWeight: posts big blind $0.25
*** HOLE CARDS ***
Dealt to SantiagoWeight [Qs 8d]
aa1421b: folds 
graysonai: folds 
bigm2261: folds 
kaizin727: folds 
winwinboy: folds 
Uncalled bet ($0.15) returned to SantiagoWeight
SantiagoWeight collected $0.20 from pot
SantiagoWeight: doesn't show hand 
*** SUMMARY ***
Total pot $0.20 | Rake $0 
Seat 1: kaizin727 (button) folded before Flop (didn't bet)
Seat 2: winwinboy (small blind) folded before Flop
Seat 3: SantiagoWeight (big blind) collected ($0.20)
Seat 4: aa1421b folded before Flop (didn't bet)
Seat 5: graysonai folded before Flop (didn't bet)
Seat 6: bigm2261 folded before Flop (didn't bet)



PokerStars Zoom Hand #195024014567:  Hold'em No Limit ($0.10/$0.25) - 2018/12/29 4:11:51 UTC [2018/12/28 23:11:51 ET]
Table 'Hydra' 6-max Seat #1 is the button
Seat 1: SantiagoWeight ($27.75 in chips) 
Seat 2: call me??107 ($19.63 in chips) 
Seat 3: GrandmasterY ($57.38 in chips) 
Seat 4: dawwwid70 ($27.57 in chips) 
Seat 5: crashbuum ($24.24 in chips) 
Seat 6: 2poiRiver ($22.74 in chips) 
call me??107: posts small blind $0.10
GrandmasterY: posts big blind $0.25
*** HOLE CARDS ***
Dealt to SantiagoWeight [5d 7d]
dawwwid70: folds 
crashbuum: folds 
2poiRiver: raises $0.50 to $0.75
SantiagoWeight: raises $1.25 to $2
call me??107: calls $1.90
GrandmasterY: folds 
2poiRiver: raises $20.74 to $22.74 and is all-in
SantiagoWeight: folds 
call me??107: folds 
Uncalled bet ($20.74) returned to 2poiRiver
2poiRiver collected $6.25 from pot
2poiRiver: doesn't show hand 
*** SUMMARY ***
Total pot $6.25 | Rake $0 
Seat 1: SantiagoWeight (button) folded before Flop
Seat 2: call me??107 (small blind) folded before Flop
Seat 3: GrandmasterY (big blind) folded before Flop
Seat 4: dawwwid70 folded before Flop (didn't bet)
Seat 5: crashbuum folded before Flop (didn't bet)
Seat 6: 2poiRiver collected ($6.25)



PokerStars Zoom Hand #195024021700:  Hold'em No Limit ($0.10/$0.25) - 2018/12/29 4:12:15 UTC [2018/12/28 23:12:15 ET]
Table 'Hydra' 6-max Seat #1 is the button
Seat 1: dithflo ($11.50 in chips) 
Seat 2: LLiarrr ($27.48 in chips) 
Seat 3: DUDA3553 ($23.49 in chips) 
Seat 4: Fobos113 ($13.84 in chips) 
Seat 5: pirosiky ($67.33 in chips) 
Seat 6: SantiagoWeight ($25.75 in chips) 
LLiarrr: posts small blind $0.10
DUDA3553: posts big blind $0.25
*** HOLE CARDS ***
Dealt to SantiagoWeight [3s Ah]
Fobos113: folds 
pirosiky: folds 
SantiagoWeight: folds 
dithflo: folds 
LLiarrr: folds 
Uncalled bet ($0.15) returned to DUDA3553
DUDA3553 collected $0.20 from pot
DUDA3553: doesn't show hand 
*** SUMMARY ***
Total pot $0.20 | Rake $0 
Seat 1: dithflo (button) folded before Flop (didn't bet)
Seat 2: LLiarrr (small blind) folded before Flop
Seat 3: DUDA3553 (big blind) collected ($0.20)
Seat 4: Fobos113 folded before Flop (didn't bet)
Seat 5: pirosiky folded before Flop (didn't bet)
Seat 6: SantiagoWeight folded before Flop (didn't bet)



PokerStars Zoom Hand #195024023167:  Hold'em No Limit ($0.10/$0.25) - 2018/12/29 4:12:20 UTC [2018/12/28 23:12:20 ET]
Table 'Hydra' 6-max Seat #1 is the button
Seat 1: Viiiru ($32.45 in chips) 
Seat 2: SantiagoWeight ($25.75 in chips) 
Seat 3: winwinboy ($28.17 in chips) 
Seat 4: ol_2face ($81.98 in chips) 
Seat 5: sigaro010 ($38.99 in chips) 
Seat 6: davidhw888 ($44.01 in chips) 
SantiagoWeight: posts small blind $0.10
winwinboy: posts big blind $0.25
*** HOLE CARDS ***
Dealt to SantiagoWeight [8c 9h]
ol_2face: folds 
sigaro010: folds 
davidhw888: folds 
Viiiru: raises $0.37 to $0.62
SantiagoWeight: folds 
winwinboy: folds 
Uncalled bet ($0.37) returned to Viiiru
Viiiru collected $0.60 from pot
Viiiru: doesn't show hand 
*** SUMMARY ***
Total pot $0.60 | Rake $0 
Seat 1: Viiiru (button) collected ($0.60)
Seat 2: SantiagoWeight (small blind) folded before Flop
Seat 3: winwinboy (big blind) folded before Flop
Seat 4: ol_2face folded before Flop (didn't bet)
Seat 5: sigaro010 folded before Flop (didn't bet)
Seat 6: davidhw888 folded before Flop (didn't bet)



PokerStars Zoom Hand #195024026075:  Hold'em No Limit ($0.10/$0.25) - 2018/12/29 4:12:30 UTC [2018/12/28 23:12:30 ET]
Table 'Hydra' 6-max Seat #1 is the button
Seat 1: Lehared ($29.46 in chips) 
Seat 2: ol_2face ($81.98 in chips) 
Seat 3: dawwwid70 ($27.54 in chips) 
Seat 4: river plate9 ($12.06 in chips) 
Seat 5: SantiagoWeight ($25.65 in chips) 
Seat 6: _BluDeeN_ ($25 in chips) 
ol_2face: posts small blind $0.10
dawwwid70: posts big blind $0.25
*** HOLE CARDS ***
Dealt to SantiagoWeight [5s 4h]
river plate9: raises $0.25 to $0.50
SantiagoWeight: folds 
_BluDeeN_: folds 
Lehared: folds 
ol_2face: calls $0.40
dawwwid70: folds 
*** FLOP *** [2h Ac 6h]
ol_2face: checks 
river plate9: checks 
*** TURN *** [2h Ac 6h] [6s]
ol_2face: bets $0.50
river plate9: folds 
Uncalled bet ($0.50) returned to ol_2face
ol_2face collected $1.19 from pot
ol_2face: doesn't show hand 
*** SUMMARY ***
Total pot $1.25 | Rake $0.06 
Board [2h Ac 6h 6s]
Seat 1: Lehared (button) folded before Flop (didn't bet)
Seat 2: ol_2face (small blind) collected ($1.19)
Seat 3: dawwwid70 (big blind) folded before Flop
Seat 4: river plate9 folded on the Turn
Seat 5: SantiagoWeight folded before Flop (didn't bet)
Seat 6: _BluDeeN_ folded before Flop (didn't bet)



PokerStars Zoom Hand #195024027550:  Hold'em No Limit ($0.10/$0.25) - 2018/12/29 4:12:35 UTC [2018/12/28 23:12:35 ET]
Table 'Hydra' 6-max Seat #1 is the button
Seat 1: hamen1990 ($25 in chips) 
Seat 2: dawwwid70 ($27.29 in chips) 
Seat 3: osa126 ($25.69 in chips) 
Seat 4: SantiagoWeight ($25.65 in chips) 
Seat 5: Lehared ($29.67 in chips) 
Seat 6: abbi555 ($36.93 in chips) 
dawwwid70: posts small blind $0.10
osa126: posts big blind $0.25
*** HOLE CARDS ***
Dealt to SantiagoWeight [3h 6c]
SantiagoWeight: folds 
Lehared: folds 
abbi555: folds 
hamen1990: raises $0.50 to $0.75
dawwwid70: folds 
osa126: folds 
Uncalled bet ($0.50) returned to hamen1990
hamen1990 collected $0.60 from pot
hamen1990: doesn't show hand 
*** SUMMARY ***
Total pot $0.60 | Rake $0 
Seat 1: hamen1990 (button) collected ($0.60)
Seat 2: dawwwid70 (small blind) folded before Flop
Seat 3: osa126 (big blind) folded before Flop
Seat 4: SantiagoWeight folded before Flop (didn't bet)
Seat 5: Lehared folded before Flop (didn't bet)
Seat 6: abbi555 folded before Flop (didn't bet)



PokerStars Zoom Hand #195024028415:  Hold'em No Limit ($0.10/$0.25) - 2018/12/29 4:12:38 UTC [2018/12/28 23:12:38 ET]
Table 'Hydra' 6-max Seat #1 is the button
Seat 1: skePokerske ($10.49 in chips) 
Seat 2: GrandmasterY ($43.66 in chips) 
Seat 3: SantiagoWeight ($25.65 in chips) 
Seat 4: qing328 ($23.55 in chips) 
Seat 5: osa126 ($66.47 in chips) 
Seat 6: Fobos113 ($13.94 in chips) 
GrandmasterY: posts small blind $0.10
SantiagoWeight: posts big blind $0.25
*** HOLE CARDS ***
Dealt to SantiagoWeight [Td 7s]
qing328: raises $0.50 to $0.75
osa126: folds 
Fobos113 has timed out
Fobos113: folds 
skePokerske: folds 
GrandmasterY: folds 
SantiagoWeight: folds 
Uncalled bet ($0.50) returned to qing328
qing328 collected $0.60 from pot
qing328: doesn't show hand 
*** SUMMARY ***
Total pot $0.60 | Rake $0 
Seat 1: skePokerske (button) folded before Flop (didn't bet)
Seat 2: GrandmasterY (small blind) folded before Flop
Seat 3: SantiagoWeight (big blind) folded before Flop
Seat 4: qing328 collected ($0.60)
Seat 5: osa126 folded before Flop (didn't bet)
Seat 6: Fobos113 folded before Flop (didn't bet)



PokerStars Zoom Hand #195024043003:  Hold'em No Limit ($0.10/$0.25) - 2018/12/29 4:13:28 UTC [2018/12/28 23:13:28 ET]
Table 'Hydra' 6-max Seat #1 is the button
Seat 1: Jameson11 ($19.30 in chips) 
Seat 2: SantiagoWeight ($25.40 in chips) 
Seat 3: qing328 ($25.25 in chips) 
Seat 4: cheolbeom ($28.54 in chips) 
Seat 5: DUDA3553 ($23.19 in chips) 
Seat 6: winwinboy ($25.35 in chips) 
SantiagoWeight: posts small blind $0.10
qing328: posts big blind $0.25
*** HOLE CARDS ***
Dealt to SantiagoWeight [2d Js]
cheolbeom: folds 
DUDA3553: folds 
winwinboy: folds 
Jameson11: folds 
SantiagoWeight: folds 
Uncalled bet ($0.15) returned to qing328
qing328 collected $0.20 from pot
qing328: doesn't show hand 
*** SUMMARY ***
Total pot $0.20 | Rake $0 
Seat 1: Jameson11 (button) folded before Flop (didn't bet)
Seat 2: SantiagoWeight (small blind) folded before Flop
Seat 3: qing328 (big blind) collected ($0.20)
Seat 4: cheolbeom folded before Flop (didn't bet)
Seat 5: DUDA3553 folded before Flop (didn't bet)
Seat 6: winwinboy folded before Flop (didn't bet)



PokerStars Zoom Hand #195024041009:  Hold'em No Limit ($0.10/$0.25) - 2018/12/29 4:13:21 UTC [2018/12/28 23:13:21 ET]
Table 'Hydra' 6-max Seat #1 is the button
Seat 1: SantiagoWeight ($25.40 in chips) 
Seat 2: Chellabro ($22.07 in chips) 
Seat 3: vulcandog ($26.36 in chips) 
Seat 4: qing328 ($25.25 in chips) 
Seat 5: reetskeet ($54.42 in chips) 
Seat 6: bestitest542 ($44.93 in chips) 
Chellabro: posts small blind $0.10
vulcandog: posts big blind $0.25
*** HOLE CARDS ***
Dealt to SantiagoWeight [5h Qc]
qing328: folds 
reetskeet: folds 
bestitest542: folds 
SantiagoWeight: folds 
Chellabro: calls $0.15
vulcandog: checks 
*** FLOP *** [9s 2h Jh]
Chellabro: checks 
vulcandog: checks 
*** TURN *** [9s 2h Jh] [5d]
Chellabro: checks 
vulcandog: checks 
*** RIVER *** [9s 2h Jh 5d] [8d]
Chellabro: checks 
vulcandog: checks 
*** SHOW DOWN ***
Chellabro: shows [9c Tc] (a pair of Nines)
vulcandog: mucks hand 
Chellabro collected $0.48 from pot
*** SUMMARY ***
Total pot $0.50 | Rake $0.02 
Board [9s 2h Jh 5d 8d]
Seat 1: SantiagoWeight (button) folded before Flop (didn't bet)
Seat 2: Chellabro (small blind) showed [9c Tc] and won ($0.48) with a pair of Nines
Seat 3: vulcandog (big blind) mucked [4c Kh]
Seat 4: qing328 folded before Flop (didn't bet)
Seat 5: reetskeet folded before Flop (didn't bet)
Seat 6: bestitest542 folded before Flop (didn't bet)



PokerStars Zoom Hand #195024044146:  Hold'em No Limit ($0.10/$0.25) - 2018/12/29 4:13:32 UTC [2018/12/28 23:13:32 ET]
Table 'Hydra' 6-max Seat #1 is the button
Seat 1: buba de tuc ($18.68 in chips) 
Seat 2: franco373513 ($13.86 in chips) 
Seat 3: reggiedogg31 ($113.57 in chips) 
Seat 4: clashwizard23 ($34.14 in chips) 
Seat 5: !P0K3RM3T4L! ($25 in chips) 
Seat 6: SantiagoWeight ($25.30 in chips) 
franco373513: posts small blind $0.10
reggiedogg31: posts big blind $0.25
*** HOLE CARDS ***
Dealt to SantiagoWeight [9s 8c]
clashwizard23: folds 
!P0K3RM3T4L!: folds 
SantiagoWeight: raises $0.30 to $0.55
buba de tuc: folds 
franco373513: folds 
reggiedogg31: raises $2.70 to $3.25
SantiagoWeight: folds 
Uncalled bet ($2.70) returned to reggiedogg31
reggiedogg31 collected $1.20 from pot
reggiedogg31: doesn't show hand 
*** SUMMARY ***
Total pot $1.20 | Rake $0 
Seat 1: buba de tuc (button) folded before Flop (didn't bet)
Seat 2: franco373513 (small blind) folded before Flop
Seat 3: reggiedogg31 (big blind) collected ($1.20)
Seat 4: clashwizard23 folded before Flop (didn't bet)
Seat 5: !P0K3RM3T4L! folded before Flop (didn't bet)
Seat 6: SantiagoWeight folded before Flop



PokerStars Zoom Hand #195024052377:  Hold'em No Limit ($0.10/$0.25) - 2018/12/29 4:14:00 UTC [2018/12/28 23:14:00 ET]
Table 'Hydra' 6-max Seat #1 is the button
Seat 1: franco373513 ($13.51 in chips) 
Seat 2: anlu0803 ($20.74 in chips) 
Seat 3: ivann14 ($62.45 in chips) 
Seat 4: GrandmasterY ($43.21 in chips) 
Seat 5: SantiagoWeight ($24.75 in chips) 
Seat 6: DUDA3553 ($23.19 in chips) 
anlu0803: posts small blind $0.10
ivann14: posts big blind $0.25
*** HOLE CARDS ***
Dealt to SantiagoWeight [3c 8s]
GrandmasterY: folds 
SantiagoWeight: folds 
DUDA3553: raises $0.25 to $0.50
franco373513: folds 
anlu0803: folds 
ivann14: calls $0.25
*** FLOP *** [Js Ac 5d]
ivann14: checks 
DUDA3553: checks 
*** TURN *** [Js Ac 5d] [6d]
ivann14: checks 
DUDA3553: checks 
*** RIVER *** [Js Ac 5d 6d] [2h]
ivann14: checks 
DUDA3553: checks 
*** SHOW DOWN ***
ivann14: shows [Tc Jc] (a pair of Jacks)
DUDA3553: mucks hand 
ivann14 collected $1.05 from pot
*** SUMMARY ***
Total pot $1.10 | Rake $0.05 
Board [Js Ac 5d 6d 2h]
Seat 1: franco373513 (button) folded before Flop (didn't bet)
Seat 2: anlu0803 (small blind) folded before Flop
Seat 3: ivann14 (big blind) showed [Tc Jc] and won ($1.05) with a pair of Jacks
Seat 4: GrandmasterY folded before Flop (didn't bet)
Seat 5: SantiagoWeight folded before Flop (didn't bet)
Seat 6: DUDA3553 mucked [4s 4c]



PokerStars Zoom Hand #195024054690:  Hold'em No Limit ($0.10/$0.25) - 2018/12/29 4:14:08 UTC [2018/12/28 23:14:08 ET]
Table 'Hydra' 6-max Seat #1 is the button
Seat 1: qing328 ($26.13 in chips) 
Seat 2: BIGPAIN14 ($34.11 in chips) 
Seat 3: 666erkan ($20.10 in chips) 
Seat 4: SantiagoWeight ($24.75 in chips) 
Seat 5: Viiiru ($29.36 in chips) 
Seat 6: Renner32 ($34.47 in chips) 
BIGPAIN14: posts small blind $0.10
666erkan: posts big blind $0.25
*** HOLE CARDS ***
Dealt to SantiagoWeight [9s 6s]
SantiagoWeight: folds 
Viiiru: folds 
Renner32: folds 
qing328: folds 
BIGPAIN14: raises $0.25 to $0.50
666erkan: calls $0.25
*** FLOP *** [2c Ks 7h]
BIGPAIN14: checks 
666erkan: checks 
*** TURN *** [2c Ks 7h] [5c]
BIGPAIN14: bets $0.48
666erkan: folds 
Uncalled bet ($0.48) returned to BIGPAIN14
BIGPAIN14 collected $0.96 from pot
BIGPAIN14: doesn't show hand 
*** SUMMARY ***
Total pot $1 | Rake $0.04 
Board [2c Ks 7h 5c]
Seat 1: qing328 (button) folded before Flop (didn't bet)
Seat 2: BIGPAIN14 (small blind) collected ($0.96)
Seat 3: 666erkan (big blind) folded on the Turn
Seat 4: SantiagoWeight folded before Flop (didn't bet)
Seat 5: Viiiru folded before Flop (didn't bet)
Seat 6: Renner32 folded before Flop (didn't bet)



PokerStars Zoom Hand #195024058118:  Hold'em No Limit ($0.10/$0.25) - 2018/12/29 4:14:20 UTC [2018/12/28 23:14:20 ET]
Table 'Hydra' 6-max Seat #1 is the button
Seat 1: 5+0matolog ($24.21 in chips) 
Seat 2: davidhw888 ($12.22 in chips) 
Seat 3: SantiagoWeight ($24.75 in chips) 
Seat 4: nadal335 ($81.55 in chips) 
Seat 5: Gonzalit0o ($40.91 in chips) 
Seat 6: anlu0803 ($20.74 in chips) 
davidhw888: posts small blind $0.10
SantiagoWeight: posts big blind $0.25
*** HOLE CARDS ***
Dealt to SantiagoWeight [Qh 9s]
nadal335: folds 
Gonzalit0o: folds 
anlu0803: folds 
5+0matolog: folds 
davidhw888: raises $0.50 to $0.75
SantiagoWeight: calls $0.50
*** FLOP *** [Qs 8c 2c]
davidhw888: bets $11.47 and is all-in
SantiagoWeight: calls $11.47
*** FIRST TURN *** [Qs 8c 2c] [As]
*** FIRST RIVER *** [Qs 8c 2c As] [6h]
*** SECOND TURN *** [Qs 8c 2c] [Td]
*** SECOND RIVER *** [Qs 8c 2c Td] [5c]
*** FIRST SHOW DOWN ***
davidhw888: shows [Qd 9d] (a pair of Queens)
SantiagoWeight: shows [Qh 9s] (a pair of Queens)
davidhw888 collected $5.84 from pot
SantiagoWeight collected $5.83 from pot
*** SECOND SHOW DOWN ***
davidhw888: shows [Qd 9d] (a pair of Queens)
SantiagoWeight: shows [Qh 9s] (a pair of Queens)
davidhw888 collected $5.84 from pot
SantiagoWeight collected $5.83 from pot
*** SUMMARY ***
Total pot $24.44 | Rake $1.10 
Hand was run twice
FIRST Board [Qs 8c 2c As 6h]
SECOND Board [Qs 8c 2c Td 5c]
Seat 1: 5+0matolog (button) folded before Flop (didn't bet)
Seat 2: davidhw888 (small blind) showed [Qd 9d] and won ($5.84) with a pair of Queens, and won ($5.84) with a pair of Queens
Seat 3: SantiagoWeight (big blind) showed [Qh 9s] and won ($5.83) with a pair of Queens, and won ($5.83) with a pair of Queens
Seat 4: nadal335 folded before Flop (didn't bet)
Seat 5: Gonzalit0o folded before Flop (didn't bet)
Seat 6: anlu0803 folded before Flop (didn't bet)



PokerStars Zoom Hand #195024066413:  Hold'em No Limit ($0.10/$0.25) - 2018/12/29 4:14:49 UTC [2018/12/28 23:14:49 ET]
Table 'Hydra' 6-max Seat #1 is the button
Seat 1: pkr_miracle ($26.71 in chips) 
Seat 2: pirosiky ($64.44 in chips) 
Seat 3: pRoma66 ($28.52 in chips) 
Seat 4: KeySssi ($25.35 in chips) 
Seat 5: SantiagoWeight ($24.19 in chips) 
Seat 6: cheolbeom ($26.52 in chips) 
pirosiky: posts small blind $0.10
pRoma66: posts big blind $0.25
*** HOLE CARDS ***
Dealt to SantiagoWeight [Tc Ah]
KeySssi: folds 
SantiagoWeight: raises $0.37 to $0.62
cheolbeom: folds 
pkr_miracle: folds 
pirosiky: folds 
pRoma66: calls $0.37
*** FLOP *** [3d 4c 5d]
pRoma66: checks 
SantiagoWeight: checks 
*** TURN *** [3d 4c 5d] [Qh]
pRoma66: checks 
SantiagoWeight: checks 
*** RIVER *** [3d 4c 5d Qh] [8c]
pRoma66: bets $1.25
SantiagoWeight: calls $1.25
*** SHOW DOWN ***
pRoma66: shows [7h 9d] (high card Queen)
SantiagoWeight: shows [Tc Ah] (high card Ace)
SantiagoWeight collected $3.67 from pot
*** SUMMARY ***
Total pot $3.84 | Rake $0.17 
Board [3d 4c 5d Qh 8c]
Seat 1: pkr_miracle (button) folded before Flop (didn't bet)
Seat 2: pirosiky (small blind) folded before Flop
Seat 3: pRoma66 (big blind) showed [7h 9d] and lost with high card Queen
Seat 4: KeySssi folded before Flop (didn't bet)
Seat 5: SantiagoWeight showed [Tc Ah] and won ($3.67) with high card Ace
Seat 6: cheolbeom folded before Flop (didn't bet)



PokerStars Zoom Hand #195024094505:  Hold'em No Limit ($0.10/$0.25) - 2018/12/29 4:16:25 UTC [2018/12/28 23:16:25 ET]
Table 'Hydra' 6-max Seat #1 is the button
Seat 1: SantiagoWeight ($25.99 in chips) 
Seat 2: winwinboy ($25.51 in chips) 
Seat 3: mariopork ($35.22 in chips) 
Seat 4: _BluDeeN_ ($25 in chips) 
Seat 5: Sco0oter ($23.36 in chips) 
Seat 6: river plate9 ($40.06 in chips) 
winwinboy: posts small blind $0.10
mariopork: posts big blind $0.25
*** HOLE CARDS ***
Dealt to SantiagoWeight [4h 2h]
_BluDeeN_: folds 
Sco0oter: folds 
river plate9: folds 
SantiagoWeight: raises $0.30 to $0.55
winwinboy has timed out
winwinboy: folds 
mariopork: folds 
Uncalled bet ($0.30) returned to SantiagoWeight
SantiagoWeight collected $0.60 from pot
SantiagoWeight: doesn't show hand 
*** SUMMARY ***
Total pot $0.60 | Rake $0 
Seat 1: SantiagoWeight (button) collected ($0.60)
Seat 2: winwinboy (small blind) folded before Flop
Seat 3: mariopork (big blind) folded before Flop
Seat 4: _BluDeeN_ folded before Flop (didn't bet)
Seat 5: Sco0oter folded before Flop (didn't bet)
Seat 6: river plate9 folded before Flop (didn't bet)



PokerStars Zoom Hand #195024105605:  Hold'em No Limit ($0.10/$0.25) - 2018/12/29 4:17:03 UTC [2018/12/28 23:17:03 ET]
Table 'Hydra' 6-max Seat #1 is the button
Seat 1: Lehared ($25 in chips) 
Seat 2: SantiagoWeight ($26.34 in chips) 
Seat 3: ivann14 ($25.35 in chips) 
Seat 4: river plate9 ($10.21 in chips) 
Seat 5: --LeGaaNs-- ($81.78 in chips) 
Seat 6: osa126 ($64.80 in chips) 
SantiagoWeight: posts small blind $0.10
ivann14: posts big blind $0.25
*** HOLE CARDS ***
Dealt to SantiagoWeight [2s 7d]
river plate9: folds 
--LeGaaNs--: folds 
osa126: folds 
Lehared: raises $0.37 to $0.62
SantiagoWeight: folds 
ivann14: folds 
Uncalled bet ($0.37) returned to Lehared
Lehared collected $0.60 from pot
Lehared: doesn't show hand 
*** SUMMARY ***
Total pot $0.60 | Rake $0 
Seat 1: Lehared (button) collected ($0.60)
Seat 2: SantiagoWeight (small blind) folded before Flop
Seat 3: ivann14 (big blind) folded before Flop
Seat 4: river plate9 folded before Flop (didn't bet)
Seat 5: --LeGaaNs-- folded before Flop (didn't bet)
Seat 6: osa126 folded before Flop (didn't bet)



PokerStars Zoom Hand #195024109118:  Hold'em No Limit ($0.10/$0.25) - 2018/12/29 4:17:15 UTC [2018/12/28 23:17:15 ET]
Table 'Hydra' 6-max Seat #1 is the button
Seat 1: osa126 ($26.13 in chips) 
Seat 2: cheolbeom ($30.88 in chips) 
Seat 3: vulcandog ($11.68 in chips) 
Seat 4: SantiagoWeight ($26.24 in chips) 
Seat 5: Nutselas ($87.39 in chips) 
Seat 6: heromn ($23.26 in chips) 
cheolbeom: posts small blind $0.10
vulcandog: posts big blind $0.25
*** HOLE CARDS ***
Dealt to SantiagoWeight [Ts 4h]
SantiagoWeight: folds 
Nutselas: folds 
heromn: raises $0.50 to $0.75
osa126: folds 
cheolbeom: folds 
vulcandog: folds 
Uncalled bet ($0.50) returned to heromn
heromn collected $0.60 from pot
heromn: doesn't show hand 
*** SUMMARY ***
Total pot $0.60 | Rake $0 
Seat 1: osa126 (button) folded before Flop (didn't bet)
Seat 2: cheolbeom (small blind) folded before Flop
Seat 3: vulcandog (big blind) folded before Flop
Seat 4: SantiagoWeight folded before Flop (didn't bet)
Seat 5: Nutselas folded before Flop (didn't bet)
Seat 6: heromn collected ($0.60)



PokerStars Zoom Hand #195024111996:  Hold'em No Limit ($0.10/$0.25) - 2018/12/29 4:17:25 UTC [2018/12/28 23:17:25 ET]
Table 'Hydra' 6-max Seat #1 is the button
Seat 1: winwinboy ($25.97 in chips) 
Seat 2: qing328 ($22.79 in chips) 
Seat 3: Jameson11 ($18.25 in chips) 
Seat 4: Renner32 ($33.12 in chips) 
Seat 5: Bonen18 ($29.67 in chips) 
Seat 6: SantiagoWeight ($26.24 in chips) 
qing328: posts small blind $0.10
Jameson11: posts big blind $0.25
*** HOLE CARDS ***
Dealt to SantiagoWeight [Js Qs]
Renner32: folds 
Bonen18: folds 
SantiagoWeight: raises $0.30 to $0.55
winwinboy: folds 
qing328: folds 
Jameson11: calls $0.30
*** FLOP *** [As Jh 7h]
Jameson11: checks 
SantiagoWeight: checks 
*** TURN *** [As Jh 7h] [3h]
Jameson11: checks 
SantiagoWeight: bets $0.77
Jameson11: folds 
Uncalled bet ($0.77) returned to SantiagoWeight
SantiagoWeight collected $1.15 from pot
SantiagoWeight: doesn't show hand 
*** SUMMARY ***
Total pot $1.20 | Rake $0.05 
Board [As Jh 7h 3h]
Seat 1: winwinboy (button) folded before Flop (didn't bet)
Seat 2: qing328 (small blind) folded before Flop
Seat 3: Jameson11 (big blind) folded on the Turn
Seat 4: Renner32 folded before Flop (didn't bet)
Seat 5: Bonen18 folded before Flop (didn't bet)
Seat 6: SantiagoWeight collected ($1.15)



PokerStars Zoom Hand #195024126297:  Hold'em No Limit ($0.10/$0.25) - 2018/12/29 4:18:14 UTC [2018/12/28 23:18:14 ET]
Table 'Hydra' 6-max Seat #1 is the button
Seat 1: SantiagoWeight ($26.84 in chips) 
Seat 2: cheolbeom ($28.03 in chips) 
Seat 3: TQNYMQNTANA ($37.06 in chips) 
Seat 4: Becks Baker ($11.64 in chips) 
Seat 5: Gonzalit0o ($52.59 in chips) 
Seat 6: leoval1010 ($9.77 in chips) 
cheolbeom: posts small blind $0.10
TQNYMQNTANA: posts big blind $0.25
*** HOLE CARDS ***
Dealt to SantiagoWeight [Ah 9s]
Becks Baker: folds 
Gonzalit0o: folds 
leoval1010: folds 
SantiagoWeight: raises $0.30 to $0.55
cheolbeom: folds 
TQNYMQNTANA: folds 
Uncalled bet ($0.30) returned to SantiagoWeight
SantiagoWeight collected $0.60 from pot
SantiagoWeight: doesn't show hand 
*** SUMMARY ***
Total pot $0.60 | Rake $0 
Seat 1: SantiagoWeight (button) collected ($0.60)
Seat 2: cheolbeom (small blind) folded before Flop
Seat 3: TQNYMQNTANA (big blind) folded before Flop
Seat 4: Becks Baker folded before Flop (didn't bet)
Seat 5: Gonzalit0o folded before Flop (didn't bet)
Seat 6: leoval1010 folded before Flop (didn't bet)



PokerStars Zoom Hand #195024131217:  Hold'em No Limit ($0.10/$0.25) - 2018/12/29 4:18:31 UTC [2018/12/28 23:18:31 ET]
Table 'Hydra' 6-max Seat #1 is the button
Seat 1: ritchy99 ($26.50 in chips) 
Seat 2: TQNYMQNTANA ($36.81 in chips) 
Seat 3: Breedijkie ($48.79 in chips) 
Seat 4: cheolbeom ($25 in chips) 
Seat 5: SantiagoWeight ($27.19 in chips) 
Seat 6: mariopork ($33.44 in chips) 
TQNYMQNTANA: posts small blind $0.10
Breedijkie: posts big blind $0.25
*** HOLE CARDS ***
Dealt to SantiagoWeight [As 3d]
cheolbeom: folds 
SantiagoWeight: folds 
mariopork: folds 
ritchy99: folds 
TQNYMQNTANA: folds 
Uncalled bet ($0.15) returned to Breedijkie
Breedijkie collected $0.20 from pot
Breedijkie: doesn't show hand 
*** SUMMARY ***
Total pot $0.20 | Rake $0 
Seat 1: ritchy99 (button) folded before Flop (didn't bet)
Seat 2: TQNYMQNTANA (small blind) folded before Flop
Seat 3: Breedijkie (big blind) collected ($0.20)
Seat 4: cheolbeom folded before Flop (didn't bet)
Seat 5: SantiagoWeight folded before Flop (didn't bet)
Seat 6: mariopork folded before Flop (didn't bet)



PokerStars Zoom Hand #195024133209:  Hold'em No Limit ($0.10/$0.25) - 2018/12/29 4:18:38 UTC [2018/12/28 23:18:38 ET]
Table 'Hydra' 6-max Seat #1 is the button
Seat 1: qing328 ($24.26 in chips) 
Seat 2: Lehared ($28.69 in chips) 
Seat 3: SantiagoWeight ($27.19 in chips) 
Seat 4: ritchy99 ($26.50 in chips) 
Seat 5: Party4Arthy ($33.61 in chips) 
Seat 6: anlu0803 ($14.69 in chips) 
Lehared: posts small blind $0.10
SantiagoWeight: posts big blind $0.25
*** HOLE CARDS ***
Dealt to SantiagoWeight [9d 5h]
ritchy99: raises $0.25 to $0.50
Party4Arthy: raises $0.25 to $0.75
anlu0803: folds 
qing328: folds 
Lehared: folds 
SantiagoWeight: folds 
ritchy99: calls $0.25
*** FLOP *** [9s 2h Ts]
ritchy99: bets $1
Party4Arthy: calls $1
*** TURN *** [9s 2h Ts] [Qs]
ritchy99: checks 
Party4Arthy: bets $1.25
ritchy99: folds 
Uncalled bet ($1.25) returned to Party4Arthy
Party4Arthy collected $3.68 from pot
Party4Arthy: doesn't show hand 
*** SUMMARY ***
Total pot $3.85 | Rake $0.17 
Board [9s 2h Ts Qs]
Seat 1: qing328 (button) folded before Flop (didn't bet)
Seat 2: Lehared (small blind) folded before Flop
Seat 3: SantiagoWeight (big blind) folded before Flop
Seat 4: ritchy99 folded on the Turn
Seat 5: Party4Arthy collected ($3.68)
Seat 6: anlu0803 folded before Flop (didn't bet)



PokerStars Zoom Hand #195024135473:  Hold'em No Limit ($0.10/$0.25) - 2018/12/29 4:18:46 UTC [2018/12/28 23:18:46 ET]
Table 'Hydra' 6-max Seat #1 is the button
Seat 1: Unclesmoll ($15.25 in chips) 
Seat 2: Jameson11 ($17.45 in chips) 
Seat 3: qing328 ($22.34 in chips) 
Seat 4: hamen1990 ($21.67 in chips) 
Seat 5: Breedijkie ($48.89 in chips) 
Seat 6: SantiagoWeight ($26.94 in chips) 
Jameson11: posts small blind $0.10
qing328: posts big blind $0.25
*** HOLE CARDS ***
Dealt to SantiagoWeight [Td Kc]
hamen1990: folds 
Breedijkie: folds 
SantiagoWeight: raises $0.30 to $0.55
Unclesmoll: calls $0.55
Jameson11: folds 
qing328: folds 
*** FLOP *** [3s Qd Ts]
SantiagoWeight: bets $0.80
Unclesmoll: calls $0.80
*** TURN *** [3s Qd Ts] [4c]
SantiagoWeight: checks 
Unclesmoll: bets $1.50
SantiagoWeight: calls $1.50
*** RIVER *** [3s Qd Ts 4c] [4d]
SantiagoWeight: checks 
Unclesmoll: bets $3
SantiagoWeight: folds 
Uncalled bet ($3) returned to Unclesmoll
Unclesmoll collected $5.78 from pot
*** SUMMARY ***
Total pot $6.05 | Rake $0.27 
Board [3s Qd Ts 4c 4d]
Seat 1: Unclesmoll (button) collected ($5.78)
Seat 2: Jameson11 (small blind) folded before Flop
Seat 3: qing328 (big blind) folded before Flop
Seat 4: hamen1990 folded before Flop (didn't bet)
Seat 5: Breedijkie folded before Flop (didn't bet)
Seat 6: SantiagoWeight folded on the River



PokerStars Zoom Hand #195024163571:  Hold'em No Limit ($0.10/$0.25) - 2018/12/29 4:20:23 UTC [2018/12/28 23:20:23 ET]
Table 'Hydra' 6-max Seat #1 is the button
Seat 1: mariopork ($39.37 in chips) 
Seat 2: thecity1729 ($26.14 in chips) 
Seat 3: naxizzle ($99.09 in chips) 
Seat 4: SantiagoWeight ($23.99 in chips) 
Seat 5: crashbuum ($21.64 in chips) 
Seat 6: osa126 ($25 in chips) 
thecity1729: posts small blind $0.10
naxizzle: posts big blind $0.25
*** HOLE CARDS ***
Dealt to SantiagoWeight [Ks 2h]
SantiagoWeight: folds 
crashbuum: folds 
osa126: folds 
mariopork: folds 
thecity1729: folds 
Uncalled bet ($0.15) returned to naxizzle
naxizzle collected $0.20 from pot
naxizzle: doesn't show hand 
*** SUMMARY ***
Total pot $0.20 | Rake $0 
Seat 1: mariopork (button) folded before Flop (didn't bet)
Seat 2: thecity1729 (small blind) folded before Flop
Seat 3: naxizzle (big blind) collected ($0.20)
Seat 4: SantiagoWeight folded before Flop (didn't bet)
Seat 5: crashbuum folded before Flop (didn't bet)
Seat 6: osa126 folded before Flop (didn't bet)



PokerStars Zoom Hand #195024158652:  Hold'em No Limit ($0.10/$0.25) - 2018/12/29 4:20:06 UTC [2018/12/28 23:20:06 ET]
Table 'Hydra' 6-max Seat #1 is the button
Seat 1: cheolbeom ($28.49 in chips) 
Seat 2: SantiagoWeight ($24.09 in chips) 
Seat 3: MileVoliD49 ($27.19 in chips) 
Seat 4: Gonzalit0o ($52.34 in chips) 
Seat 5: Party4Arthy ($34.84 in chips) 
Seat 6: --LeGaaNs-- ($81.32 in chips) 
SantiagoWeight: posts small blind $0.10
MileVoliD49: posts big blind $0.25
*** HOLE CARDS ***
Dealt to SantiagoWeight [Ts Kh]
Gonzalit0o: folds 
Party4Arthy: folds 
--LeGaaNs--: raises $0.25 to $0.50
cheolbeom: folds 
SantiagoWeight: folds 
MileVoliD49: calls $0.25
*** FLOP *** [6c 8d Ac]
MileVoliD49: bets $0.25
--LeGaaNs--: folds 
Uncalled bet ($0.25) returned to MileVoliD49
MileVoliD49 collected $1.05 from pot
MileVoliD49: doesn't show hand 
*** SUMMARY ***
Total pot $1.10 | Rake $0.05 
Board [6c 8d Ac]
Seat 1: cheolbeom (button) folded before Flop (didn't bet)
Seat 2: SantiagoWeight (small blind) folded before Flop
Seat 3: MileVoliD49 (big blind) collected ($1.05)
Seat 4: Gonzalit0o folded before Flop (didn't bet)
Seat 5: Party4Arthy folded before Flop (didn't bet)
Seat 6: --LeGaaNs-- folded on the Flop



PokerStars Zoom Hand #195024164725:  Hold'em No Limit ($0.10/$0.25) - 2018/12/29 4:20:27 UTC [2018/12/28 23:20:27 ET]
Table 'Hydra' 6-max Seat #1 is the button
Seat 1: papico3 ($25 in chips) 
Seat 2: Elapostador33 ($28.79 in chips) 
Seat 3: playazhate ($25 in chips) 
Seat 4: SantiagoWeight ($23.99 in chips) 
Seat 5: Dimvov ($12.86 in chips) 
Seat 6: mariopork ($45.67 in chips) 
Elapostador33: posts small blind $0.10
playazhate: posts big blind $0.25
*** HOLE CARDS ***
Dealt to SantiagoWeight [As Th]
SantiagoWeight: folds 
Dimvov: raises $0.37 to $0.62
mariopork: folds 
papico3: folds 
Elapostador33: folds 
playazhate: folds 
Uncalled bet ($0.37) returned to Dimvov
Dimvov collected $0.60 from pot
Dimvov: doesn't show hand 
*** SUMMARY ***
Total pot $0.60 | Rake $0 
Seat 1: papico3 (button) folded before Flop (didn't bet)
Seat 2: Elapostador33 (small blind) folded before Flop
Seat 3: playazhate (big blind) folded before Flop
Seat 4: SantiagoWeight folded before Flop (didn't bet)
Seat 5: Dimvov collected ($0.60)
Seat 6: mariopork folded before Flop (didn't bet)



PokerStars Zoom Hand #195024166117:  Hold'em No Limit ($0.10/$0.25) - 2018/12/29 4:20:32 UTC [2018/12/28 23:20:32 ET]
Table 'Hydra' 6-max Seat #1 is the button
Seat 1: thecity1729 ($26.04 in chips) 
Seat 2: mariopork ($45.67 in chips) 
Seat 3: SantiagoWeight ($23.99 in chips) 
Seat 4: allin969 ($22.70 in chips) 
Seat 5: ryanking99 ($30.18 in chips) 
Seat 6: mililser ($21.34 in chips) 
mariopork: posts small blind $0.10
SantiagoWeight: posts big blind $0.25
*** HOLE CARDS ***
Dealt to SantiagoWeight [9h 2c]
allin969: raises $0.50 to $0.75
ryanking99: folds 
mililser: folds 
thecity1729: folds 
mariopork: folds 
SantiagoWeight: folds 
Uncalled bet ($0.50) returned to allin969
allin969 collected $0.60 from pot
*** SUMMARY ***
Total pot $0.60 | Rake $0 
Seat 1: thecity1729 (button) folded before Flop (didn't bet)
Seat 2: mariopork (small blind) folded before Flop
Seat 3: SantiagoWeight (big blind) folded before Flop
Seat 4: allin969 collected ($0.60)
Seat 5: ryanking99 folded before Flop (didn't bet)
Seat 6: mililser folded before Flop (didn't bet)



PokerStars Zoom Hand #195024170124:  Hold'em No Limit ($0.10/$0.25) - 2018/12/29 4:20:46 UTC [2018/12/28 23:20:46 ET]
Table 'Hydra' 6-max Seat #1 is the button
Seat 1: ruiken ($33.92 in chips) 
Seat 2: !P0K3RM3T4L! ($26.59 in chips) 
Seat 3: Lehared ($29.29 in chips) 
Seat 4: SantiagoWeight ($23.74 in chips) 
Seat 5: alex3d1985 ($14.86 in chips) 
Seat 6: hamen1990 ($49.50 in chips) 
!P0K3RM3T4L!: posts small blind $0.10
Lehared: posts big blind $0.25
*** HOLE CARDS ***
Dealt to SantiagoWeight [9c Kc]
SantiagoWeight: raises $0.42 to $0.67
alex3d1985: folds 
hamen1990: folds 
ruiken: folds 
!P0K3RM3T4L!: folds 
Lehared: calls $0.42
*** FLOP *** [Js Td Qc]
Lehared: checks 
SantiagoWeight: bets $1.38
Lehared: folds 
Uncalled bet ($1.38) returned to SantiagoWeight
SantiagoWeight collected $1.38 from pot
SantiagoWeight: doesn't show hand 
*** SUMMARY ***
Total pot $1.44 | Rake $0.06 
Board [Js Td Qc]
Seat 1: ruiken (button) folded before Flop (didn't bet)
Seat 2: !P0K3RM3T4L! (small blind) folded before Flop
Seat 3: Lehared (big blind) folded on the Flop
Seat 4: SantiagoWeight collected ($1.38)
Seat 5: alex3d1985 folded before Flop (didn't bet)
Seat 6: hamen1990 folded before Flop (didn't bet)



PokerStars Zoom Hand #195024178107:  Hold'em No Limit ($0.10/$0.25) - 2018/12/29 4:21:14 UTC [2018/12/28 23:21:14 ET]
Table 'Hydra' 6-max Seat #1 is the button
Seat 1: ruiken ($33.82 in chips) 
Seat 2: SantiagoWeight ($24.45 in chips) 
Seat 3: MileVoliD49 ($27.64 in chips) 
Seat 4: GrandmasterY ($43.23 in chips) 
Seat 5: cheolbeom ($28.52 in chips) 
Seat 6: Viiiru ($25.87 in chips) 
SantiagoWeight: posts small blind $0.10
MileVoliD49: posts big blind $0.25
*** HOLE CARDS ***
Dealt to SantiagoWeight [6h 7h]
GrandmasterY: folds 
cheolbeom: folds 
Viiiru: folds 
ruiken: raises $0.50 to $0.75
SantiagoWeight: folds 
MileVoliD49: folds 
Uncalled bet ($0.50) returned to ruiken
ruiken collected $0.60 from pot
ruiken: doesn't show hand 
*** SUMMARY ***
Total pot $0.60 | Rake $0 
Seat 1: ruiken (button) collected ($0.60)
Seat 2: SantiagoWeight (small blind) folded before Flop
Seat 3: MileVoliD49 (big blind) folded before Flop
Seat 4: GrandmasterY folded before Flop (didn't bet)
Seat 5: cheolbeom folded before Flop (didn't bet)
Seat 6: Viiiru folded before Flop (didn't bet)



PokerStars Zoom Hand #195024185036:  Hold'em No Limit ($0.10/$0.25) - 2018/12/29 4:21:38 UTC [2018/12/28 23:21:38 ET]
Table 'Hydra' 6-max Seat #1 is the button
Seat 1: SantiagoWeight ($24.35 in chips) 
Seat 2: ruiken ($31.12 in chips) 
Seat 3: !P0K3RM3T4L! ($32.17 in chips) 
Seat 4: mililser ($20.99 in chips) 
Seat 5: cheolbeom ($28.42 in chips) 
Seat 6: zbuci ($35.51 in chips) 
ruiken: posts small blind $0.10
!P0K3RM3T4L!: posts big blind $0.25
*** HOLE CARDS ***
Dealt to SantiagoWeight [2s 3s]
mililser: folds 
cheolbeom: folds 
zbuci: folds 
SantiagoWeight: raises $0.30 to $0.55
ruiken: calls $0.45
!P0K3RM3T4L!: folds 
*** FLOP *** [3h 2h Qh]
ruiken: checks 
SantiagoWeight: bets $1.40
ruiken: raises $2.10 to $3.50
SantiagoWeight: calls $2.10
*** TURN *** [3h 2h Qh] [5c]
ruiken: bets $4.50
SantiagoWeight: calls $4.50
*** RIVER *** [3h 2h Qh 5c] [5h]
ruiken: checks 
SantiagoWeight: bets $15.80 and is all-in
ruiken: folds 
Uncalled bet ($15.80) returned to SantiagoWeight
SantiagoWeight collected $16.57 from pot
SantiagoWeight: doesn't show hand 
*** SUMMARY ***
Total pot $17.35 | Rake $0.78 
Board [3h 2h Qh 5c 5h]
Seat 1: SantiagoWeight (button) collected ($16.57)
Seat 2: ruiken (small blind) folded on the River
Seat 3: !P0K3RM3T4L! (big blind) folded before Flop
Seat 4: mililser folded before Flop (didn't bet)
Seat 5: cheolbeom folded before Flop (didn't bet)
Seat 6: zbuci folded before Flop (didn't bet)



PokerStars Zoom Hand #195024218374:  Hold'em No Limit ($0.10/$0.25) - 2018/12/29 4:23:33 UTC [2018/12/28 23:23:33 ET]
Table 'Hydra' 6-max Seat #1 is the button
Seat 1: Dbakunwaves ($61.45 in chips) 
Seat 2: MoMoney2612 ($25.45 in chips) 
Seat 3: sigaro010 ($45.92 in chips) 
Seat 4: ryanking99 ($21.54 in chips) 
Seat 5: dan_iasi ($86.51 in chips) 
Seat 6: SantiagoWeight ($32.37 in chips) 
MoMoney2612: posts small blind $0.10
sigaro010: posts big blind $0.25
*** HOLE CARDS ***
Dealt to SantiagoWeight [9c 3d]
ryanking99: folds 
dan_iasi: folds 
SantiagoWeight: folds 
Dbakunwaves: folds 
MoMoney2612: raises $0.50 to $0.75
sigaro010: folds 
Uncalled bet ($0.50) returned to MoMoney2612
MoMoney2612 collected $0.50 from pot
MoMoney2612: doesn't show hand 
*** SUMMARY ***
Total pot $0.50 | Rake $0 
Seat 1: Dbakunwaves (button) folded before Flop (didn't bet)
Seat 2: MoMoney2612 (small blind) collected ($0.50)
Seat 3: sigaro010 (big blind) folded before Flop
Seat 4: ryanking99 folded before Flop (didn't bet)
Seat 5: dan_iasi folded before Flop (didn't bet)
Seat 6: SantiagoWeight folded before Flop (didn't bet)



PokerStars Zoom Hand #195024219209:  Hold'em No Limit ($0.10/$0.25) - 2018/12/29 4:23:36 UTC [2018/12/28 23:23:36 ET]
Table 'Hydra' 6-max Seat #1 is the button
Seat 1: dk dreadlook ($22 in chips) 
Seat 2: the_ablist7 ($10.60 in chips) 
Seat 3: SantiagoWeight ($32.37 in chips) 
Seat 4: mariopork ($46.01 in chips) 
Seat 5: epazeli ($24.67 in chips) 
Seat 6: pirosiky ($58.23 in chips) 
the_ablist7: posts small blind $0.10
SantiagoWeight: posts big blind $0.25
*** HOLE CARDS ***
Dealt to SantiagoWeight [3h 4h]
mariopork: folds 
epazeli: folds 
pirosiky: folds 
dk dreadlook: raises $0.50 to $0.75
the_ablist7: folds 
SantiagoWeight: folds 
Uncalled bet ($0.50) returned to dk dreadlook
dk dreadlook collected $0.60 from pot
dk dreadlook: doesn't show hand 
*** SUMMARY ***
Total pot $0.60 | Rake $0 
Seat 1: dk dreadlook (button) collected ($0.60)
Seat 2: the_ablist7 (small blind) folded before Flop
Seat 3: SantiagoWeight (big blind) folded before Flop
Seat 4: mariopork folded before Flop (didn't bet)
Seat 5: epazeli folded before Flop (didn't bet)
Seat 6: pirosiky folded before Flop (didn't bet)



PokerStars Zoom Hand #195024223154:  Hold'em No Limit ($0.10/$0.25) - 2018/12/29 4:23:50 UTC [2018/12/28 23:23:50 ET]
Table 'Hydra' 6-max Seat #1 is the button
Seat 1: KAllUSTA ($14.71 in chips) 
Seat 2: franco373513 ($8.36 in chips) 
Seat 3: reggiedogg31 ($122.36 in chips) 
Seat 4: Gonzalit0o ($33.05 in chips) 
Seat 5: heromn ($21.14 in chips) 
Seat 6: SantiagoWeight ($32.12 in chips) 
franco373513: posts small blind $0.10
reggiedogg31: posts big blind $0.25
*** HOLE CARDS ***
Dealt to SantiagoWeight [9s Td]
Gonzalit0o: folds 
heromn: folds 
SantiagoWeight: raises $0.30 to $0.55
KAllUSTA: folds 
franco373513: folds 
reggiedogg31: folds 
Uncalled bet ($0.30) returned to SantiagoWeight
SantiagoWeight collected $0.60 from pot
SantiagoWeight: doesn't show hand 
*** SUMMARY ***
Total pot $0.60 | Rake $0 
Seat 1: KAllUSTA (button) folded before Flop (didn't bet)
Seat 2: franco373513 (small blind) folded before Flop
Seat 3: reggiedogg31 (big blind) folded before Flop
Seat 4: Gonzalit0o folded before Flop (didn't bet)
Seat 5: heromn folded before Flop (didn't bet)
Seat 6: SantiagoWeight collected ($0.60)



PokerStars Zoom Hand #195024229468:  Hold'em No Limit ($0.10/$0.25) - 2018/12/29 4:24:12 UTC [2018/12/28 23:24:12 ET]
Table 'Hydra' 6-max Seat #1 is the button
Seat 1: papico3 ($26.36 in chips) 
Seat 2: anlu0803 ($30.36 in chips) 
Seat 3: IMMPORT@L ($11.95 in chips) 
Seat 4: MoMoney2612 ($25 in chips) 
Seat 5: SantiagoWeight ($32.47 in chips) 
Seat 6: ttshead ($55.08 in chips) 
anlu0803: posts small blind $0.10
IMMPORT@L: posts big blind $0.25
*** HOLE CARDS ***
Dealt to SantiagoWeight [Qs 6d]
MoMoney2612: folds 
SantiagoWeight: folds 
ttshead: raises $0.43 to $0.68
papico3: folds 
anlu0803: folds 
IMMPORT@L: folds 
Uncalled bet ($0.43) returned to ttshead
ttshead collected $0.60 from pot
ttshead: doesn't show hand 
*** SUMMARY ***
Total pot $0.60 | Rake $0 
Seat 1: papico3 (button) folded before Flop (didn't bet)
Seat 2: anlu0803 (small blind) folded before Flop
Seat 3: IMMPORT@L (big blind) folded before Flop
Seat 4: MoMoney2612 folded before Flop (didn't bet)
Seat 5: SantiagoWeight folded before Flop (didn't bet)
Seat 6: ttshead collected ($0.60)



PokerStars Zoom Hand #195024231496:  Hold'em No Limit ($0.10/$0.25) - 2018/12/29 4:24:19 UTC [2018/12/28 23:24:19 ET]
Table 'Hydra' 6-max Seat #1 is the button
Seat 1: SantiagoWeight ($32.47 in chips) 
Seat 2: reggiedogg31 ($122.11 in chips) 
Seat 3: cheolbeom ($26.97 in chips) 
Seat 4: Becks Baker ($23.95 in chips) 
Seat 5: Jameson11 ($14.30 in chips) 
Seat 6: trttt74 ($21 in chips) 
reggiedogg31: posts small blind $0.10
cheolbeom: posts big blind $0.25
*** HOLE CARDS ***
Dealt to SantiagoWeight [Qh 4s]
Becks Baker: folds 
Jameson11: folds 
trttt74: folds 
SantiagoWeight: folds 
reggiedogg31: folds 
Uncalled bet ($0.15) returned to cheolbeom
cheolbeom collected $0.20 from pot
cheolbeom: doesn't show hand 
*** SUMMARY ***
Total pot $0.20 | Rake $0 
Seat 1: SantiagoWeight (button) folded before Flop (didn't bet)
Seat 2: reggiedogg31 (small blind) folded before Flop
Seat 3: cheolbeom (big blind) collected ($0.20)
Seat 4: Becks Baker folded before Flop (didn't bet)
Seat 5: Jameson11 folded before Flop (didn't bet)
Seat 6: trttt74 folded before Flop (didn't bet)



PokerStars Zoom Hand #195024233685:  Hold'em No Limit ($0.10/$0.25) - 2018/12/29 4:24:27 UTC [2018/12/28 23:24:27 ET]
Table 'Hydra' 6-max Seat #1 is the button
Seat 1: reetskeet ($52.10 in chips) 
Seat 2: SantiagoWeight ($32.47 in chips) 
Seat 3: MoMoney2612 ($25 in chips) 
Seat 4: sigaro010 ($53.86 in chips) 
Seat 5: mariopork ($46.01 in chips) 
Seat 6: ivann14 ($25 in chips) 
SantiagoWeight: posts small blind $0.10
MoMoney2612: posts big blind $0.25
*** HOLE CARDS ***
Dealt to SantiagoWeight [3d Th]
sigaro010: folds 
mariopork: folds 
ivann14: folds 
reetskeet: raises $0.25 to $0.50
SantiagoWeight: folds 
MoMoney2612: raises $1.50 to $2
reetskeet: folds 
Uncalled bet ($1.50) returned to MoMoney2612
MoMoney2612 collected $1.10 from pot
MoMoney2612: doesn't show hand 
*** SUMMARY ***
Total pot $1.10 | Rake $0 
Seat 1: reetskeet (button) folded before Flop
Seat 2: SantiagoWeight (small blind) folded before Flop
Seat 3: MoMoney2612 (big blind) collected ($1.10)
Seat 4: sigaro010 folded before Flop (didn't bet)
Seat 5: mariopork folded before Flop (didn't bet)
Seat 6: ivann14 folded before Flop (didn't bet)



PokerStars Zoom Hand #195024238243:  Hold'em No Limit ($0.10/$0.25) - 2018/12/29 4:24:43 UTC [2018/12/28 23:24:43 ET]
Table 'Hydra' 6-max Seat #1 is the button
Seat 1: tariko1980 ($14.14 in chips) 
Seat 2: Zaebca ($17.18 in chips) 
Seat 3: Dimvov ($9.71 in chips) 
Seat 4: cheolbeom ($28.55 in chips) 
Seat 5: SantiagoWeight ($32.37 in chips) 
Seat 6: Viiiru ($25.87 in chips) 
Zaebca: posts small blind $0.10
Dimvov: posts big blind $0.25
*** HOLE CARDS ***
Dealt to SantiagoWeight [3h 2d]
cheolbeom: folds 
SantiagoWeight: folds 
Viiiru: folds 
tariko1980: folds 
Zaebca: raises $0.50 to $0.75
Dimvov: raises $8.96 to $9.71 and is all-in
Zaebca: calls $8.96
*** FLOP *** [4h 2s 9s]
*** TURN *** [4h 2s 9s] [7c]
*** RIVER *** [4h 2s 9s 7c] [8h]
*** SHOW DOWN ***
Zaebca: shows [As Js] (high card Ace)
Dimvov: shows [Th Kc] (high card King)
Zaebca collected $18.55 from pot
*** SUMMARY ***
Total pot $19.42 | Rake $0.87 
Board [4h 2s 9s 7c 8h]
Seat 1: tariko1980 (button) folded before Flop (didn't bet)
Seat 2: Zaebca (small blind) showed [As Js] and won ($18.55) with high card Ace
Seat 3: Dimvov (big blind) showed [Th Kc] and lost with high card King
Seat 4: cheolbeom folded before Flop (didn't bet)
Seat 5: SantiagoWeight folded before Flop (didn't bet)
Seat 6: Viiiru folded before Flop (didn't bet)



PokerStars Zoom Hand #195024237099:  Hold'em No Limit ($0.10/$0.25) - 2018/12/29 4:24:39 UTC [2018/12/28 23:24:39 ET]
Table 'Hydra' 6-max Seat #1 is the button
Seat 1: Suit3dGapp3r ($27.11 in chips) 
Seat 2: pkr_miracle ($29.63 in chips) 
Seat 3: anlu0803 ($20.30 in chips) 
Seat 4: SantiagoWeight ($32.37 in chips) 
Seat 5: RESTRICTED.CR17 ($34.68 in chips) 
Seat 6: TQNYMQNTANA ($33.84 in chips) 
pkr_miracle: posts small blind $0.10
anlu0803: posts big blind $0.25
*** HOLE CARDS ***
Dealt to SantiagoWeight [7h Qh]
SantiagoWeight: folds 
RESTRICTED.CR17: raises $0.50 to $0.75
TQNYMQNTANA: folds 
Suit3dGapp3r: folds 
pkr_miracle: calls $0.65
anlu0803: folds 
*** FLOP *** [Jd Ks 2h]
pkr_miracle: checks 
RESTRICTED.CR17: bets $0.75
pkr_miracle: calls $0.75
*** TURN *** [Jd Ks 2h] [Qd]
pkr_miracle: bets $3.10
RESTRICTED.CR17: folds 
Uncalled bet ($3.10) returned to pkr_miracle
pkr_miracle collected $3.10 from pot
pkr_miracle: doesn't show hand 
*** SUMMARY ***
Total pot $3.25 | Rake $0.15 
Board [Jd Ks 2h Qd]
Seat 1: Suit3dGapp3r (button) folded before Flop (didn't bet)
Seat 2: pkr_miracle (small blind) collected ($3.10)
Seat 3: anlu0803 (big blind) folded before Flop
Seat 4: SantiagoWeight folded before Flop (didn't bet)
Seat 5: RESTRICTED.CR17 folded on the Turn
Seat 6: TQNYMQNTANA folded before Flop (didn't bet)



PokerStars Zoom Hand #195024239129:  Hold'em No Limit ($0.10/$0.25) - 2018/12/29 4:24:46 UTC [2018/12/28 23:24:46 ET]
Table 'Hydra' 6-max Seat #1 is the button
Seat 1: Lehared ($42.44 in chips) 
Seat 2: alex3d1985 ($12.41 in chips) 
Seat 3: SantiagoWeight ($32.37 in chips) 
Seat 4: !P0K3RM3T4L! ($28.78 in chips) 
Seat 5: anlu0803 ($20.05 in chips) 
Seat 6: heromn ($20.79 in chips) 
alex3d1985: posts small blind $0.10
SantiagoWeight: posts big blind $0.25
*** HOLE CARDS ***
Dealt to SantiagoWeight [4d 4h]
!P0K3RM3T4L!: folds 
anlu0803: raises $0.25 to $0.50
heromn: folds 
Lehared: folds 
alex3d1985: folds 
SantiagoWeight: calls $0.25
*** FLOP *** [As Ad 3s]
SantiagoWeight: checks 
anlu0803: bets $1
SantiagoWeight: folds 
Uncalled bet ($1) returned to anlu0803
anlu0803 collected $1.05 from pot
*** SUMMARY ***
Total pot $1.10 | Rake $0.05 
Board [As Ad 3s]
Seat 1: Lehared (button) folded before Flop (didn't bet)
Seat 2: alex3d1985 (small blind) folded before Flop
Seat 3: SantiagoWeight (big blind) folded on the Flop
Seat 4: !P0K3RM3T4L! folded before Flop (didn't bet)
Seat 5: anlu0803 collected ($1.05)
Seat 6: heromn folded before Flop (didn't bet)



PokerStars Zoom Hand #195024262197:  Hold'em No Limit ($0.10/$0.25) - 2018/12/29 4:26:07 UTC [2018/12/28 23:26:07 ET]
Table 'Hydra' 6-max Seat #1 is the button
Seat 1: leoval1010 ($23.28 in chips) 
Seat 2: call me??107 ($14.38 in chips) 
Seat 3: Renner32 ($31.67 in chips) 
Seat 4: allin969 ($24.69 in chips) 
Seat 5: dan_iasi ($125.85 in chips) 
Seat 6: SantiagoWeight ($31.87 in chips) 
call me??107: posts small blind $0.10
Renner32: posts big blind $0.25
*** HOLE CARDS ***
Dealt to SantiagoWeight [6h Js]
allin969: raises $0.50 to $0.75
dan_iasi: folds 
SantiagoWeight: folds 
leoval1010: folds 
call me??107: calls $0.65
Renner32: folds 
*** FLOP *** [Qs 6d 2s]
call me??107: checks 
allin969: bets $1.67
call me??107: raises $1.67 to $3.34
allin969: folds 
Uncalled bet ($1.67) returned to call me??107
call me??107 collected $4.86 from pot
call me??107: doesn't show hand 
*** SUMMARY ***
Total pot $5.09 | Rake $0.23 
Board [Qs 6d 2s]
Seat 1: leoval1010 (button) folded before Flop (didn't bet)
Seat 2: call me??107 (small blind) collected ($4.86)
Seat 3: Renner32 (big blind) folded before Flop
Seat 4: allin969 folded on the Flop
Seat 5: dan_iasi folded before Flop (didn't bet)
Seat 6: SantiagoWeight folded before Flop (didn't bet)



PokerStars Zoom Hand #195024265059:  Hold'em No Limit ($0.10/$0.25) - 2018/12/29 4:26:17 UTC [2018/12/28 23:26:17 ET]
Table 'Hydra' 6-max Seat #1 is the button
Seat 1: mililser ($28.83 in chips) 
Seat 2: SantiagoWeight ($31.87 in chips) 
Seat 3: KrishnaRadha ($64.18 in chips) 
Seat 4: Aco80 ($25 in chips) 
Seat 5: crashbuum ($27 in chips) 
Seat 6: StrangeChip1 ($33.96 in chips) 
SantiagoWeight: posts small blind $0.10
KrishnaRadha: posts big blind $0.25
*** HOLE CARDS ***
Dealt to SantiagoWeight [6d Jc]
Aco80: raises $0.50 to $0.75
crashbuum: folds 
StrangeChip1: folds 
mililser: calls $0.75
SantiagoWeight: folds 
KrishnaRadha: folds 
*** FLOP *** [4s Ts Jd]
Aco80: bets $1.25
mililser: folds 
Uncalled bet ($1.25) returned to Aco80
Aco80 collected $1.77 from pot
Aco80: doesn't show hand 
*** SUMMARY ***
Total pot $1.85 | Rake $0.08 
Board [4s Ts Jd]
Seat 1: mililser (button) folded on the Flop
Seat 2: SantiagoWeight (small blind) folded before Flop
Seat 3: KrishnaRadha (big blind) folded before Flop
Seat 4: Aco80 collected ($1.77)
Seat 5: crashbuum folded before Flop (didn't bet)
Seat 6: StrangeChip1 folded before Flop (didn't bet)



PokerStars Zoom Hand #195024267249:  Hold'em No Limit ($0.10/$0.25) - 2018/12/29 4:26:25 UTC [2018/12/28 23:26:25 ET]
Table 'Hydra' 6-max Seat #1 is the button
Seat 1: SantiagoWeight ($31.77 in chips) 
Seat 2: Bonen18 ($33.62 in chips) 
Seat 3: athos 007 ($46.74 in chips) 
Seat 4: mariopork ($25 in chips) 
Seat 5: Becks Baker ($21.99 in chips) 
Seat 6: louiskitu ($24.87 in chips) 
Bonen18: posts small blind $0.10
athos 007: posts big blind $0.25
*** HOLE CARDS ***
Dealt to SantiagoWeight [8d Js]
mariopork: folds 
Becks Baker: folds 
louiskitu: folds 
SantiagoWeight: raises $0.30 to $0.55
Bonen18: folds 
athos 007: folds 
Uncalled bet ($0.30) returned to SantiagoWeight
SantiagoWeight collected $0.60 from pot
SantiagoWeight: doesn't show hand 
*** SUMMARY ***
Total pot $0.60 | Rake $0 
Seat 1: SantiagoWeight (button) collected ($0.60)
Seat 2: Bonen18 (small blind) folded before Flop
Seat 3: athos 007 (big blind) folded before Flop
Seat 4: mariopork folded before Flop (didn't bet)
Seat 5: Becks Baker folded before Flop (didn't bet)
Seat 6: louiskitu folded before Flop (didn't bet)



PokerStars Zoom Hand #195024250264:  Hold'em No Limit ($0.10/$0.25) - 2018/12/29 4:25:25 UTC [2018/12/28 23:25:25 ET]
Table 'Hydra' 6-max Seat #1 is the button
Seat 1: SantiagoWeight ($31.87 in chips) 
Seat 2: graysonai ($26.26 in chips) 
Seat 3: !P0K3RM3T4L! ($25.89 in chips) 
Seat 4: louiskitu ($24.25 in chips) 
Seat 5: deaglepro ($48.62 in chips) 
Seat 6: tariko1980 ($37.74 in chips) 
graysonai: posts small blind $0.10
!P0K3RM3T4L!: posts big blind $0.25
*** HOLE CARDS ***
Dealt to SantiagoWeight [As 5s]
louiskitu: folds 
deaglepro: raises $0.50 to $0.75
tariko1980: calls $0.75
SantiagoWeight: folds 
graysonai: folds 
!P0K3RM3T4L!: calls $0.50
*** FLOP *** [6c Ah 4d]
!P0K3RM3T4L!: checks 
deaglepro: checks 
tariko1980: bets $1
!P0K3RM3T4L!: raises $2.50 to $3.50
deaglepro: folds 
tariko1980: calls $2.50
*** TURN *** [6c Ah 4d] [4c]
!P0K3RM3T4L!: bets $7
tariko1980: calls $7
*** RIVER *** [6c Ah 4d 4c] [9s]
!P0K3RM3T4L!: checks 
tariko1980: checks 
*** SHOW DOWN ***
!P0K3RM3T4L!: shows [Qd Td] (a pair of Fours)
tariko1980: shows [Ac 8c] (two pair, Aces and Fours)
tariko1980 collected $22.30 from pot
*** SUMMARY ***
Total pot $23.35 | Rake $1.05 
Board [6c Ah 4d 4c 9s]
Seat 1: SantiagoWeight (button) folded before Flop (didn't bet)
Seat 2: graysonai (small blind) folded before Flop
Seat 3: !P0K3RM3T4L! (big blind) showed [Qd Td] and lost with a pair of Fours
Seat 4: louiskitu folded before Flop (didn't bet)
Seat 5: deaglepro folded on the Flop
Seat 6: tariko1980 showed [Ac 8c] and won ($22.30) with two pair, Aces and Fours



PokerStars Zoom Hand #195024277099:  Hold'em No Limit ($0.10/$0.25) - 2018/12/29 4:27:00 UTC [2018/12/28 23:27:00 ET]
Table 'Hydra' 6-max Seat #1 is the button
Seat 1: jyujyu1326 ($12.50 in chips) 
Seat 2: mariopork ($44.06 in chips) 
Seat 3: reggiedogg31 ($121.16 in chips) 
Seat 4: SantiagoWeight ($32.12 in chips) 
Seat 5: Bonen18 ($26.05 in chips) 
Seat 6: BRSOB79 ($43.41 in chips) 
mariopork: posts small blind $0.10
reggiedogg31: posts big blind $0.25
*** HOLE CARDS ***
Dealt to SantiagoWeight [3h Jc]
SantiagoWeight: folds 
Bonen18: folds 
BRSOB79: raises $0.35 to $0.60
jyujyu1326: folds 
mariopork: raises $2.10 to $2.70
reggiedogg31: folds 
BRSOB79: folds 
Uncalled bet ($2.10) returned to mariopork
mariopork collected $1.45 from pot
mariopork: doesn't show hand 
*** SUMMARY ***
Total pot $1.45 | Rake $0 
Seat 1: jyujyu1326 (button) folded before Flop (didn't bet)
Seat 2: mariopork (small blind) collected ($1.45)
Seat 3: reggiedogg31 (big blind) folded before Flop
Seat 4: SantiagoWeight folded before Flop (didn't bet)
Seat 5: Bonen18 folded before Flop (didn't bet)
Seat 6: BRSOB79 folded before Flop



PokerStars Zoom Hand #195024273989:  Hold'em No Limit ($0.10/$0.25) - 2018/12/29 4:26:49 UTC [2018/12/28 23:26:49 ET]
Table 'Hydra' 6-max Seat #1 is the button
Seat 1: crashbuum ($26.65 in chips) 
Seat 2: DUDA3553 ($18.29 in chips) 
Seat 3: !P0K3RM3T4L! ($28.43 in chips) 
Seat 4: janluise ($36.43 in chips) 
Seat 5: SantiagoWeight ($32.12 in chips) 
Seat 6: Guard poker ($25 in chips) 
DUDA3553: posts small blind $0.10
!P0K3RM3T4L!: posts big blind $0.25
*** HOLE CARDS ***
Dealt to SantiagoWeight [4s 5h]
janluise: raises $0.25 to $0.50
SantiagoWeight: folds 
Guard poker: calls $0.50
crashbuum: raises $1.85 to $2.35
DUDA3553: folds 
!P0K3RM3T4L!: folds 
janluise: folds 
Guard poker: calls $1.85
*** FLOP *** [2c Jd 6d]
Guard poker: checks 
crashbuum: bets $2.65
Guard poker: calls $2.65
*** TURN *** [2c Jd 6d] [8h]
Guard poker: checks 
crashbuum: bets $10.36
Guard poker: folds 
Uncalled bet ($10.36) returned to crashbuum
crashbuum collected $10.36 from pot
crashbuum: doesn't show hand 
*** SUMMARY ***
Total pot $10.85 | Rake $0.49 
Board [2c Jd 6d 8h]
Seat 1: crashbuum (button) collected ($10.36)
Seat 2: DUDA3553 (small blind) folded before Flop
Seat 3: !P0K3RM3T4L! (big blind) folded before Flop
Seat 4: janluise folded before Flop
Seat 5: SantiagoWeight folded before Flop (didn't bet)
Seat 6: Guard poker folded on the Turn



PokerStars Zoom Hand #195024280186:  Hold'em No Limit ($0.10/$0.25) - 2018/12/29 4:27:11 UTC [2018/12/28 23:27:11 ET]
Table 'Hydra' 6-max Seat #1 is the button
Seat 1: dan_iasi ($59.42 in chips) 
Seat 2: moderi ($7.23 in chips) 
Seat 3: SantiagoWeight ($32.12 in chips) 
Seat 4: papico3 ($25 in chips) 
Seat 5: !P0K3RM3T4L! ($25 in chips) 
Seat 6: jyujyu1326 ($12.50 in chips) 
moderi: posts small blind $0.10
SantiagoWeight: posts big blind $0.25
*** HOLE CARDS ***
Dealt to SantiagoWeight [6c 5s]
papico3: folds 
!P0K3RM3T4L!: folds 
jyujyu1326: raises $0.50 to $0.75
dan_iasi: folds 
moderi: calls $0.65
SantiagoWeight: folds 
*** FLOP *** [6s 9d 4h]
moderi: checks 
jyujyu1326: bets $0.68
moderi: calls $0.68
*** TURN *** [6s 9d 4h] [9c]
moderi: checks 
jyujyu1326: checks 
*** RIVER *** [6s 9d 4h 9c] [Js]
moderi: checks 
jyujyu1326: bets $1.25
moderi: calls $1.25
*** SHOW DOWN ***
jyujyu1326: shows [Kh Ks] (two pair, Kings and Nines)
moderi: mucks hand 
jyujyu1326 collected $5.36 from pot
*** SUMMARY ***
Total pot $5.61 | Rake $0.25 
Board [6s 9d 4h 9c Js]
Seat 1: dan_iasi (button) folded before Flop (didn't bet)
Seat 2: moderi (small blind) mucked [Qd Qc]
Seat 3: SantiagoWeight (big blind) folded before Flop
Seat 4: papico3 folded before Flop (didn't bet)
Seat 5: !P0K3RM3T4L! folded before Flop (didn't bet)
Seat 6: jyujyu1326 showed [Kh Ks] and won ($5.36) with two pair, Kings and Nines



PokerStars Zoom Hand #195024286404:  Hold'em No Limit ($0.10/$0.25) - 2018/12/29 4:27:33 UTC [2018/12/28 23:27:33 ET]
Table 'Hydra' 6-max Seat #1 is the button
Seat 1: Viiiru ($25 in chips) 
Seat 2: Zaebca ($23.15 in chips) 
Seat 3: Wieb84 ($25.09 in chips) 
Seat 4: mariopork ($44.91 in chips) 
Seat 5: Gonzalit0o ($25.57 in chips) 
Seat 6: SantiagoWeight ($31.87 in chips) 
Zaebca: posts small blind $0.10
Wieb84: posts big blind $0.25
*** HOLE CARDS ***
Dealt to SantiagoWeight [Jc Ac]
mariopork: folds 
Gonzalit0o: folds 
SantiagoWeight: raises $0.30 to $0.55
Viiiru: folds 
Zaebca: folds 
Wieb84: calls $0.30
*** FLOP *** [5c 7c 9h]
Wieb84: checks 
SantiagoWeight: bets $0.70
Wieb84: raises $1.55 to $2.25
SantiagoWeight: calls $1.55
*** TURN *** [5c 7c 9h] [6h]
Wieb84: bets $3.63
SantiagoWeight: calls $3.63
*** RIVER *** [5c 7c 9h 6h] [Jd]
Wieb84: bets $6.75
SantiagoWeight: folds 
Uncalled bet ($6.75) returned to Wieb84
Wieb84 collected $12.38 from pot
Wieb84: doesn't show hand 
*** SUMMARY ***
Total pot $12.96 | Rake $0.58 
Board [5c 7c 9h 6h Jd]
Seat 1: Viiiru (button) folded before Flop (didn't bet)
Seat 2: Zaebca (small blind) folded before Flop
Seat 3: Wieb84 (big blind) collected ($12.38)
Seat 4: mariopork folded before Flop (didn't bet)
Seat 5: Gonzalit0o folded before Flop (didn't bet)
Seat 6: SantiagoWeight folded on the River



PokerStars Zoom Hand #195024328330:  Hold'em No Limit ($0.10/$0.25) - 2018/12/29 4:29:29 UTC [2018/12/28 23:29:29 ET]
Table 'Hydra' 6-max Seat #1 is the button
Seat 1: Suit3dGapp3r ($26.63 in chips) 
Seat 2: SantiagoWeight ($25.44 in chips) 
Seat 3: TQNYMQNTANA ($30.68 in chips) 
Seat 4: allin969 ($12.77 in chips) 
Seat 5: mariopork ($42.09 in chips) 
Seat 6: Party4Arthy ($13.59 in chips) 
SantiagoWeight: posts small blind $0.10
TQNYMQNTANA: posts big blind $0.25
*** HOLE CARDS ***
Dealt to SantiagoWeight [7c 9c]
allin969: raises $0.25 to $0.50
mariopork: folds 
Party4Arthy: calls $0.50
Suit3dGapp3r: folds 
SantiagoWeight: folds 
TQNYMQNTANA: folds 
*** FLOP *** [Kd Qc 3h]
allin969: checks 
Party4Arthy: checks 
*** TURN *** [Kd Qc 3h] [3s]
allin969: bets $1.29
Party4Arthy: folds 
Uncalled bet ($1.29) returned to allin969
allin969 collected $1.29 from pot
allin969: doesn't show hand 
*** SUMMARY ***
Total pot $1.35 | Rake $0.06 
Board [Kd Qc 3h 3s]
Seat 1: Suit3dGapp3r (button) folded before Flop (didn't bet)
Seat 2: SantiagoWeight (small blind) folded before Flop
Seat 3: TQNYMQNTANA (big blind) folded before Flop
Seat 4: allin969 collected ($1.29)
Seat 5: mariopork folded before Flop (didn't bet)
Seat 6: Party4Arthy folded on the Turn



PokerStars Zoom Hand #195024333679:  Hold'em No Limit ($0.10/$0.25) - 2018/12/29 4:29:48 UTC [2018/12/28 23:29:48 ET]
Table 'Hydra' 6-max Seat #1 is the button
Seat 1: SantiagoWeight ($25.34 in chips) 
Seat 2: Lehared ($51.15 in chips) 
Seat 3: janluise ($35.32 in chips) 
Seat 4: athos 007 ($45.45 in chips) 
Seat 5: inujara4 ($35.73 in chips) 
Seat 6: leoval1010 ($31.24 in chips) 
Lehared: posts small blind $0.10
janluise: posts big blind $0.25
*** HOLE CARDS ***
Dealt to SantiagoWeight [4c 7s]
athos 007: raises $0.25 to $0.50
inujara4: folds 
leoval1010: folds 
SantiagoWeight: folds 
Lehared: folds 
janluise: folds 
Uncalled bet ($0.25) returned to athos 007
athos 007 collected $0.60 from pot
athos 007: doesn't show hand 
*** SUMMARY ***
Total pot $0.60 | Rake $0 
Seat 1: SantiagoWeight (button) folded before Flop (didn't bet)
Seat 2: Lehared (small blind) folded before Flop
Seat 3: janluise (big blind) folded before Flop
Seat 4: athos 007 collected ($0.60)
Seat 5: inujara4 folded before Flop (didn't bet)
Seat 6: leoval1010 folded before Flop (didn't bet)



PokerStars Zoom Hand #195024336206:  Hold'em No Limit ($0.10/$0.25) - 2018/12/29 4:29:57 UTC [2018/12/28 23:29:57 ET]
Table 'Hydra' 6-max Seat #1 is the button
Seat 1: MileVoliD49 ($20.21 in chips) 
Seat 2: trttt74 ($21.34 in chips) 
Seat 3: zbuci ($77.60 in chips) 
Seat 4: SantiagoWeight ($25.34 in chips) 
Seat 5: !P0K3RM3T4L! ($25.64 in chips) 
Seat 6: pkr_miracle ($36.58 in chips) 
trttt74: posts small blind $0.10
zbuci: posts big blind $0.25
*** HOLE CARDS ***
Dealt to SantiagoWeight [5d Jh]
SantiagoWeight: folds 
!P0K3RM3T4L!: folds 
pkr_miracle: folds 
MileVoliD49: folds 
trttt74: folds 
Uncalled bet ($0.15) returned to zbuci
zbuci collected $0.20 from pot
zbuci: doesn't show hand 
*** SUMMARY ***
Total pot $0.20 | Rake $0 
Seat 1: MileVoliD49 (button) folded before Flop (didn't bet)
Seat 2: trttt74 (small blind) folded before Flop
Seat 3: zbuci (big blind) collected ($0.20)
Seat 4: SantiagoWeight folded before Flop (didn't bet)
Seat 5: !P0K3RM3T4L! folded before Flop (didn't bet)
Seat 6: pkr_miracle folded before Flop (didn't bet)



PokerStars Zoom Hand #195024331913:  Hold'em No Limit ($0.10/$0.25) - 2018/12/29 4:29:42 UTC [2018/12/28 23:29:42 ET]
Table 'Hydra' 6-max Seat #1 is the button
Seat 1: Higashi2314 ($30.89 in chips) 
Seat 2: Doomdigidoom ($39.63 in chips) 
Seat 3: StrangeChip1 ($32.09 in chips) 
Seat 4: GrandmasterY ($56.36 in chips) 
Seat 5: SantiagoWeight ($25.34 in chips) 
Seat 6: sigaro010 ($58.47 in chips) 
Doomdigidoom: posts small blind $0.10
StrangeChip1: posts big blind $0.25
*** HOLE CARDS ***
Dealt to SantiagoWeight [6h 5s]
GrandmasterY: folds 
SantiagoWeight: folds 
sigaro010: folds 
Higashi2314: folds 
Doomdigidoom: raises $0.25 to $0.50
StrangeChip1: calls $0.25
*** FLOP *** [Ks Jh Ac]
Doomdigidoom: bets $0.50
StrangeChip1: calls $0.50
*** TURN *** [Ks Jh Ac] [7d]
Doomdigidoom: bets $0.25
StrangeChip1: raises $2.50 to $2.75
Doomdigidoom: folds 
Uncalled bet ($2.50) returned to StrangeChip1
StrangeChip1 collected $2.39 from pot
StrangeChip1: doesn't show hand 
*** SUMMARY ***
Total pot $2.50 | Rake $0.11 
Board [Ks Jh Ac 7d]
Seat 1: Higashi2314 (button) folded before Flop (didn't bet)
Seat 2: Doomdigidoom (small blind) folded on the Turn
Seat 3: StrangeChip1 (big blind) collected ($2.39)
Seat 4: GrandmasterY folded before Flop (didn't bet)
Seat 5: SantiagoWeight folded before Flop (didn't bet)
Seat 6: sigaro010 folded before Flop (didn't bet)



PokerStars Zoom Hand #195024338773:  Hold'em No Limit ($0.10/$0.25) - 2018/12/29 4:30:06 UTC [2018/12/28 23:30:06 ET]
Table 'Hydra' 6-max Seat #1 is the button
Seat 1: Gonzalit0o ($28.08 in chips) 
Seat 2: cheolbeom ($40 in chips) 
Seat 3: SantiagoWeight ($25.34 in chips) 
Seat 4: MileVoliD49 ($20.21 in chips) 
Seat 5: Breedijkie ($50.33 in chips) 
Seat 6: trttt74 ($21.24 in chips) 
cheolbeom: posts small blind $0.10
SantiagoWeight: posts big blind $0.25
*** HOLE CARDS ***
Dealt to SantiagoWeight [3c 3s]
MileVoliD49: folds 
Breedijkie: folds 
trttt74: raises $0.50 to $0.75
Gonzalit0o: folds 
cheolbeom: folds 
SantiagoWeight: calls $0.50
*** FLOP *** [8d 4s 6c]
SantiagoWeight: checks 
trttt74: bets $0.75
SantiagoWeight: calls $0.75
*** TURN *** [8d 4s 6c] [6s]
SantiagoWeight: checks 
trttt74: bets $1.74
SantiagoWeight: calls $1.74
*** RIVER *** [8d 4s 6c 6s] [8s]
SantiagoWeight: checks 
trttt74: bets $3.33
SantiagoWeight: folds 
Uncalled bet ($3.33) returned to trttt74
trttt74 collected $6.28 from pot
*** SUMMARY ***
Total pot $6.58 | Rake $0.30 
Board [8d 4s 6c 6s 8s]
Seat 1: Gonzalit0o (button) folded before Flop (didn't bet)
Seat 2: cheolbeom (small blind) folded before Flop
Seat 3: SantiagoWeight (big blind) folded on the River
Seat 4: MileVoliD49 folded before Flop (didn't bet)
Seat 5: Breedijkie folded before Flop (didn't bet)
Seat 6: trttt74 collected ($6.28)



PokerStars Zoom Hand #195024354475:  Hold'em No Limit ($0.10/$0.25) - 2018/12/29 4:31:02 UTC [2018/12/28 23:31:02 ET]
Table 'Hydra' 6-max Seat #1 is the button
Seat 1: leoval1010 ($30.29 in chips) 
Seat 2: SantiagoWeight ($22.10 in chips) 
Seat 3: Lehared ($25.05 in chips) 
Seat 4: Viiiru ($26.08 in chips) 
Seat 5: Bonen18 ($26.68 in chips) 
Seat 6: zbuci ($26.85 in chips) 
SantiagoWeight: posts small blind $0.10
Lehared: posts big blind $0.25
*** HOLE CARDS ***
Dealt to SantiagoWeight [5d Jc]
Viiiru: raises $0.50 to $0.75
Bonen18: folds 
zbuci: folds 
leoval1010: folds 
SantiagoWeight: folds 
Lehared: folds 
Uncalled bet ($0.50) returned to Viiiru
Viiiru collected $0.60 from pot
Viiiru: doesn't show hand 
*** SUMMARY ***
Total pot $0.60 | Rake $0 
Seat 1: leoval1010 (button) folded before Flop (didn't bet)
Seat 2: SantiagoWeight (small blind) folded before Flop
Seat 3: Lehared (big blind) folded before Flop
Seat 4: Viiiru collected ($0.60)
Seat 5: Bonen18 folded before Flop (didn't bet)
Seat 6: zbuci folded before Flop (didn't bet)



PokerStars Zoom Hand #195024360618:  Hold'em No Limit ($0.10/$0.25) - 2018/12/29 4:31:24 UTC [2018/12/28 23:31:24 ET]
Table 'Hydra' 6-max Seat #1 is the button
Seat 1: SantiagoWeight ($24.90 in chips) 
Seat 2: Chellabro ($8.50 in chips) 
Seat 3: BIGPAIN14 ($21.72 in chips) 
Seat 4: Gonzalit0o ($47.53 in chips) 
Seat 5: cheolbeom ($31.33 in chips) 
Seat 6: louiskitu ($21.58 in chips) 
Chellabro: posts small blind $0.10
BIGPAIN14: posts big blind $0.25
*** HOLE CARDS ***
Dealt to SantiagoWeight [Ad 7c]
Gonzalit0o: folds 
cheolbeom: folds 
louiskitu: folds 
SantiagoWeight: raises $0.30 to $0.55
Chellabro: folds 
BIGPAIN14: calls $0.30
*** FLOP *** [Qd 7s 9s]
BIGPAIN14: checks 
SantiagoWeight: checks 
*** TURN *** [Qd 7s 9s] [8c]
BIGPAIN14: bets $0.58
SantiagoWeight: folds 
Uncalled bet ($0.58) returned to BIGPAIN14
BIGPAIN14 collected $1.15 from pot
*** SUMMARY ***
Total pot $1.20 | Rake $0.05 
Board [Qd 7s 9s 8c]
Seat 1: SantiagoWeight (button) folded on the Turn
Seat 2: Chellabro (small blind) folded before Flop
Seat 3: BIGPAIN14 (big blind) collected ($1.15)
Seat 4: Gonzalit0o folded before Flop (didn't bet)
Seat 5: cheolbeom folded before Flop (didn't bet)
Seat 6: louiskitu folded before Flop (didn't bet)



PokerStars Zoom Hand #195024370422:  Hold'em No Limit ($0.10/$0.25) - 2018/12/29 4:31:59 UTC [2018/12/28 23:31:59 ET]
Table 'Hydra' 6-max Seat #1 is the button
Seat 1: mililser ($27.13 in chips) 
Seat 2: janluise ($29 in chips) 
Seat 3: bestitest542 ($41.75 in chips) 
Seat 4: Aco80 ($30.93 in chips) 
Seat 5: Bonen18 ($49.50 in chips) 
Seat 6: SantiagoWeight ($24.35 in chips) 
janluise: posts small blind $0.10
bestitest542: posts big blind $0.25
*** HOLE CARDS ***
Dealt to SantiagoWeight [2d Qc]
Aco80: folds 
Bonen18: folds 
SantiagoWeight: folds 
mililser: raises $0.50 to $0.75
janluise: folds 
bestitest542: folds 
Uncalled bet ($0.50) returned to mililser
mililser collected $0.60 from pot
mililser: doesn't show hand 
*** SUMMARY ***
Total pot $0.60 | Rake $0 
Seat 1: mililser (button) collected ($0.60)
Seat 2: janluise (small blind) folded before Flop
Seat 3: bestitest542 (big blind) folded before Flop
Seat 4: Aco80 folded before Flop (didn't bet)
Seat 5: Bonen18 folded before Flop (didn't bet)
Seat 6: SantiagoWeight folded before Flop (didn't bet)



PokerStars Zoom Hand #195024358379:  Hold'em No Limit ($0.10/$0.25) - 2018/12/29 4:31:16 UTC [2018/12/28 23:31:16 ET]
Table 'Hydra' 6-max Seat #1 is the button
Seat 1: Gonzalit0o ($34 in chips) 
Seat 2: GrandmasterY ($56.71 in chips) 
Seat 3: Becks Baker ($22.08 in chips) 
Seat 4: anlu0803 ($26.02 in chips) 
Seat 5: SantiagoWeight ($24.90 in chips) 
Seat 6: ryanking99 ($50.49 in chips) 
GrandmasterY: posts small blind $0.10
Becks Baker: posts big blind $0.25
*** HOLE CARDS ***
Dealt to SantiagoWeight [3h 9h]
anlu0803: folds 
SantiagoWeight: folds 
ryanking99: raises $0.60 to $0.85
Gonzalit0o: folds 
GrandmasterY: folds 
Becks Baker: calls $0.60
*** FLOP *** [Kd Jc 5d]
Becks Baker: checks 
ryanking99: bets $0.57
Becks Baker: calls $0.57
*** TURN *** [Kd Jc 5d] [Ac]
Becks Baker: checks 
ryanking99: bets $2.05
Becks Baker: folds 
Uncalled bet ($2.05) returned to ryanking99
ryanking99 collected $2.81 from pot
ryanking99: doesn't show hand 
*** SUMMARY ***
Total pot $2.94 | Rake $0.13 
Board [Kd Jc 5d Ac]
Seat 1: Gonzalit0o (button) folded before Flop (didn't bet)
Seat 2: GrandmasterY (small blind) folded before Flop
Seat 3: Becks Baker (big blind) folded on the Turn
Seat 4: anlu0803 folded before Flop (didn't bet)
Seat 5: SantiagoWeight folded before Flop (didn't bet)
Seat 6: ryanking99 collected ($2.81)



PokerStars Zoom Hand #195024372612:  Hold'em No Limit ($0.10/$0.25) - 2018/12/29 4:32:07 UTC [2018/12/28 23:32:07 ET]
Table 'Hydra' 6-max Seat #1 is the button
Seat 1: dk dreadlook ($27.43 in chips) 
Seat 2: athos 007 ($50.45 in chips) 
Seat 3: SantiagoWeight ($24.35 in chips) 
Seat 4: Gonzalit0o ($29.38 in chips) 
Seat 5: hamen1990 ($25.73 in chips) 
Seat 6: mariopork ($40.99 in chips) 
athos 007: posts small blind $0.10
SantiagoWeight: posts big blind $0.25
*** HOLE CARDS ***
Dealt to SantiagoWeight [4d Td]
Gonzalit0o: folds 
hamen1990: folds 
mariopork: folds 
dk dreadlook: folds 
athos 007: raises $0.25 to $0.50
SantiagoWeight: calls $0.25
*** FLOP *** [9h 5s 4c]
athos 007: bets $1
SantiagoWeight: calls $1
*** TURN *** [9h 5s 4c] [8h]
athos 007: bets $2.75
SantiagoWeight: folds 
Uncalled bet ($2.75) returned to athos 007
athos 007 collected $2.86 from pot
athos 007: doesn't show hand 
*** SUMMARY ***
Total pot $3 | Rake $0.14 
Board [9h 5s 4c 8h]
Seat 1: dk dreadlook (button) folded before Flop (didn't bet)
Seat 2: athos 007 (small blind) collected ($2.86)
Seat 3: SantiagoWeight (big blind) folded on the Turn
Seat 4: Gonzalit0o folded before Flop (didn't bet)
Seat 5: hamen1990 folded before Flop (didn't bet)
Seat 6: mariopork folded before Flop (didn't bet)



PokerStars Zoom Hand #195024384527:  Hold'em No Limit ($0.10/$0.25) - 2018/12/29 4:32:49 UTC [2018/12/28 23:32:49 ET]
Table 'Hydra' 6-max Seat #1 is the button
Seat 1: reggiedogg31 ($121.81 in chips) 
Seat 2: SantiagoWeight ($22.85 in chips) 
Seat 3: Nutselas ($86.52 in chips) 
Seat 4: fishnm2018 ($24.65 in chips) 
Seat 5: Lehared ($25.97 in chips) 
Seat 6: louiskitu ($18.15 in chips) 
SantiagoWeight: posts small blind $0.10
Nutselas: posts big blind $0.25
*** HOLE CARDS ***
Dealt to SantiagoWeight [2c 8c]
fishnm2018: folds 
Lehared: folds 
louiskitu: folds 
reggiedogg31: folds 
SantiagoWeight: folds 
Uncalled bet ($0.15) returned to Nutselas
Nutselas collected $0.20 from pot
*** SUMMARY ***
Total pot $0.20 | Rake $0 
Seat 1: reggiedogg31 (button) folded before Flop (didn't bet)
Seat 2: SantiagoWeight (small blind) folded before Flop
Seat 3: Nutselas (big blind) collected ($0.20)
Seat 4: fishnm2018 folded before Flop (didn't bet)
Seat 5: Lehared folded before Flop (didn't bet)
Seat 6: louiskitu folded before Flop (didn't bet)



PokerStars Zoom Hand #195024383061:  Hold'em No Limit ($0.10/$0.25) - 2018/12/29 4:32:44 UTC [2018/12/28 23:32:44 ET]
Table 'Hydra' 6-max Seat #1 is the button
Seat 1: GrandmasterY ($31.28 in chips) 
Seat 2: moderi ($4.73 in chips) 
Seat 3: Gonzalit0o ($46.78 in chips) 
Seat 4: SantiagoWeight ($22.85 in chips) 
Seat 5: papico3 ($25 in chips) 
Seat 6: athos 007 ($51.81 in chips) 
moderi: posts small blind $0.10
Gonzalit0o: posts big blind $0.25
*** HOLE CARDS ***
Dealt to SantiagoWeight [4s Ad]
SantiagoWeight: folds 
papico3: folds 
athos 007: folds 
GrandmasterY: raises $0.35 to $0.60
moderi: calls $0.50
Gonzalit0o: folds 
*** FLOP *** [Jc Td 2h]
moderi: checks 
GrandmasterY: bets $0.55
moderi: folds 
Uncalled bet ($0.55) returned to GrandmasterY
GrandmasterY collected $1.38 from pot
GrandmasterY: doesn't show hand 
*** SUMMARY ***
Total pot $1.45 | Rake $0.07 
Board [Jc Td 2h]
Seat 1: GrandmasterY (button) collected ($1.38)
Seat 2: moderi (small blind) folded on the Flop
Seat 3: Gonzalit0o (big blind) folded before Flop
Seat 4: SantiagoWeight folded before Flop (didn't bet)
Seat 5: papico3 folded before Flop (didn't bet)
Seat 6: athos 007 folded before Flop (didn't bet)



PokerStars Zoom Hand #195024391476:  Hold'em No Limit ($0.10/$0.25) - 2018/12/29 4:33:14 UTC [2018/12/28 23:33:14 ET]
Table 'Hydra' 6-max Seat #1 is the button
Seat 1: athos 007 ($51.91 in chips) 
Seat 2: Aco80 ($30.58 in chips) 
Seat 3: Gonzalit0o ($35.68 in chips) 
Seat 4: janluise ($38.09 in chips) 
Seat 5: SantiagoWeight ($22.75 in chips) 
Seat 6: glenn.vaughan ($27.05 in chips) 
Aco80: posts small blind $0.10
Gonzalit0o: posts big blind $0.25
*** HOLE CARDS ***
Dealt to SantiagoWeight [2h 8c]
janluise: folds 
SantiagoWeight: folds 
glenn.vaughan: folds 
athos 007: calls $0.25
Aco80: folds 
Gonzalit0o: checks 
*** FLOP *** [7c 2s 5d]
Gonzalit0o: checks 
athos 007: bets $0.50
Gonzalit0o: folds 
Uncalled bet ($0.50) returned to athos 007
athos 007 collected $0.57 from pot
athos 007: doesn't show hand 
*** SUMMARY ***
Total pot $0.60 | Rake $0.03 
Board [7c 2s 5d]
Seat 1: athos 007 (button) collected ($0.57)
Seat 2: Aco80 (small blind) folded before Flop
Seat 3: Gonzalit0o (big blind) folded on the Flop
Seat 4: janluise folded before Flop (didn't bet)
Seat 5: SantiagoWeight folded before Flop (didn't bet)
Seat 6: glenn.vaughan folded before Flop (didn't bet)



PokerStars Zoom Hand #195024395064:  Hold'em No Limit ($0.10/$0.25) - 2018/12/29 4:33:27 UTC [2018/12/28 23:33:27 ET]
Table 'Hydra' 6-max Seat #1 is the button
Seat 1: SantiagoWeight ($22.75 in chips) 
Seat 2: papico3 ($25.35 in chips) 
Seat 3: Renner32 ($57.41 in chips) 
Seat 4: cheolbeom ($51.43 in chips) 
Seat 5: Gonzalit0o ($29.03 in chips) 
Seat 6: !P0K3RM3T4L! ($27.31 in chips) 
papico3: posts small blind $0.10
Renner32: posts big blind $0.25
*** HOLE CARDS ***
Dealt to SantiagoWeight [Ks Tc]
cheolbeom: folds 
Gonzalit0o: folds 
!P0K3RM3T4L!: folds 
SantiagoWeight: raises $0.30 to $0.55
papico3: folds 
Renner32: calls $0.30
*** FLOP *** [9c Ah 5h]
Renner32: checks 
SantiagoWeight: checks 
*** TURN *** [9c Ah 5h] [4s]
Renner32: bets $1
SantiagoWeight: folds 
Uncalled bet ($1) returned to Renner32
Renner32 collected $1.15 from pot
Renner32: doesn't show hand 
*** SUMMARY ***
Total pot $1.20 | Rake $0.05 
Board [9c Ah 5h 4s]
Seat 1: SantiagoWeight (button) folded on the Turn
Seat 2: papico3 (small blind) folded before Flop
Seat 3: Renner32 (big blind) collected ($1.15)
Seat 4: cheolbeom folded before Flop (didn't bet)
Seat 5: Gonzalit0o folded before Flop (didn't bet)
Seat 6: !P0K3RM3T4L! folded before Flop (didn't bet)



PokerStars Zoom Hand #195024393689:  Hold'em No Limit ($0.10/$0.25) - 2018/12/29 4:33:22 UTC [2018/12/28 23:33:22 ET]
Table 'Hydra' 6-max Seat #1 is the button
Seat 1: moderi ($4.13 in chips) 
Seat 2: anlu0803 ($27.25 in chips) 
Seat 3: Viiiru ($35.50 in chips) 
Seat 4: SantiagoWeight ($22.75 in chips) 
Seat 5: onhoang87 ($12.09 in chips) 
Seat 6: GrandmasterY ($54.96 in chips) 
anlu0803: posts small blind $0.10
Viiiru: posts big blind $0.25
*** HOLE CARDS ***
Dealt to SantiagoWeight [8d 5s]
SantiagoWeight: folds 
onhoang87: calls $0.25
GrandmasterY: folds 
moderi: calls $0.25
anlu0803: folds 
Viiiru: checks 
*** FLOP *** [Qh Ah Ac]
Viiiru: checks 
onhoang87: checks 
moderi: checks 
*** TURN *** [Qh Ah Ac] [3c]
Viiiru: checks 
onhoang87: checks 
moderi: checks 
*** RIVER *** [Qh Ah Ac 3c] [6h]
Viiiru: bets $0.25
onhoang87: calls $0.25
moderi: folds 
*** SHOW DOWN ***
Viiiru: shows [9d Kh] (a pair of Aces)
onhoang87: shows [2s 2d] (two pair, Aces and Deuces)
onhoang87 collected $1.29 from pot
*** SUMMARY ***
Total pot $1.35 | Rake $0.06 
Board [Qh Ah Ac 3c 6h]
Seat 1: moderi (button) folded on the River
Seat 2: anlu0803 (small blind) folded before Flop
Seat 3: Viiiru (big blind) showed [9d Kh] and lost with a pair of Aces
Seat 4: SantiagoWeight folded before Flop (didn't bet)
Seat 5: onhoang87 showed [2s 2d] and won ($1.29) with two pair, Aces and Deuces
Seat 6: GrandmasterY folded before Flop (didn't bet)



PokerStars Zoom Hand #195024405881:  Hold'em No Limit ($0.10/$0.25) - 2018/12/29 4:34:05 UTC [2018/12/28 23:34:05 ET]
Table 'Hydra' 6-max Seat #1 is the button
Seat 1: inujara4 ($36.79 in chips) 
Seat 2: nozomi22s ($25.10 in chips) 
Seat 3: SantiagoWeight ($22.20 in chips) 
Seat 4: tariko1980 ($41.30 in chips) 
Seat 5: lovintalbi ($90.14 in chips) 
Seat 6: Viiiru ($25.85 in chips) 
nozomi22s: posts small blind $0.10
SantiagoWeight: posts big blind $0.25
*** HOLE CARDS ***
Dealt to SantiagoWeight [8c 6c]
tariko1980: calls $0.25
lovintalbi: folds 
Viiiru: folds 
inujara4: folds 
nozomi22s: folds 
SantiagoWeight: checks 
*** FLOP *** [Js 2d 6d]
SantiagoWeight: checks 
tariko1980: checks 
*** TURN *** [Js 2d 6d] [Ks]
SantiagoWeight: checks 
tariko1980: checks 
*** RIVER *** [Js 2d 6d Ks] [9c]
SantiagoWeight: checks 
tariko1980: checks 
*** SHOW DOWN ***
SantiagoWeight: shows [8c 6c] (a pair of Sixes)
tariko1980: mucks hand 
SantiagoWeight collected $0.57 from pot
*** SUMMARY ***
Total pot $0.60 | Rake $0.03 
Board [Js 2d 6d Ks 9c]
Seat 1: inujara4 (button) folded before Flop (didn't bet)
Seat 2: nozomi22s (small blind) folded before Flop
Seat 3: SantiagoWeight (big blind) showed [8c 6c] and won ($0.57) with a pair of Sixes
Seat 4: tariko1980 mucked [3d 3c]
Seat 5: lovintalbi folded before Flop (didn't bet)
Seat 6: Viiiru folded before Flop (didn't bet)



PokerStars Zoom Hand #195024414446:  Hold'em No Limit ($0.10/$0.25) - 2018/12/29 4:34:36 UTC [2018/12/28 23:34:36 ET]
Table 'Hydra' 6-max Seat #1 is the button
Seat 1: !P0K3RM3T4L! ($26.96 in chips) 
Seat 2: Pardaroxon ($27.36 in chips) 
Seat 3: ttshead ($66.79 in chips) 
Seat 4: Guard poker ($29.77 in chips) 
Seat 5: Aco80 ($29.36 in chips) 
Seat 6: SantiagoWeight ($22.52 in chips) 
Pardaroxon: posts small blind $0.10
ttshead: posts big blind $0.25
*** HOLE CARDS ***
Dealt to SantiagoWeight [As 5d]
Guard poker: folds 
Aco80: folds 
SantiagoWeight: folds 
!P0K3RM3T4L!: folds 
Pardaroxon: folds 
Uncalled bet ($0.15) returned to ttshead
ttshead collected $0.20 from pot
ttshead: doesn't show hand 
*** SUMMARY ***
Total pot $0.20 | Rake $0 
Seat 1: !P0K3RM3T4L! (button) folded before Flop (didn't bet)
Seat 2: Pardaroxon (small blind) folded before Flop
Seat 3: ttshead (big blind) collected ($0.20)
Seat 4: Guard poker folded before Flop (didn't bet)
Seat 5: Aco80 folded before Flop (didn't bet)
Seat 6: SantiagoWeight folded before Flop (didn't bet)



PokerStars Zoom Hand #195024417197:  Hold'em No Limit ($0.10/$0.25) - 2018/12/29 4:34:46 UTC [2018/12/28 23:34:46 ET]
Table 'Hydra' 6-max Seat #1 is the button
Seat 1: Viiiru ($25.50 in chips) 
Seat 2: ivann14 ($26.86 in chips) 
Seat 3: !P0K3RM3T4L! ($26.96 in chips) 
Seat 4: Jameson11 ($7.76 in chips) 
Seat 5: SantiagoWeight ($22.52 in chips) 
Seat 6: Suit3dGapp3r ($25.78 in chips) 
ivann14: posts small blind $0.10
!P0K3RM3T4L!: posts big blind $0.25
*** HOLE CARDS ***
Dealt to SantiagoWeight [9h 8c]
Jameson11: folds 
SantiagoWeight: folds 
Suit3dGapp3r: raises $0.45 to $0.70
Viiiru: raises $1.55 to $2.25
ivann14: folds 
!P0K3RM3T4L!: folds 
Suit3dGapp3r: folds 
Uncalled bet ($1.55) returned to Viiiru
Viiiru collected $1.75 from pot
Viiiru: doesn't show hand 
*** SUMMARY ***
Total pot $1.75 | Rake $0 
Seat 1: Viiiru (button) collected ($1.75)
Seat 2: ivann14 (small blind) folded before Flop
Seat 3: !P0K3RM3T4L! (big blind) folded before Flop
Seat 4: Jameson11 folded before Flop (didn't bet)
Seat 5: SantiagoWeight folded before Flop (didn't bet)
Seat 6: Suit3dGapp3r folded before Flop



PokerStars Zoom Hand #195024419142:  Hold'em No Limit ($0.10/$0.25) - 2018/12/29 4:34:53 UTC [2018/12/28 23:34:53 ET]
Table 'Hydra' 6-max Seat #1 is the button
Seat 1: clashwizard23 ($24.10 in chips) 
Seat 2: SantiagoWeight ($22.52 in chips) 
Seat 3: Renner32 ($57.16 in chips) 
Seat 4: ryanking99 ($22.11 in chips) 
Seat 5: uggsthelad ($9.16 in chips) 
Seat 6: abbi555 ($41.38 in chips) 
SantiagoWeight: posts small blind $0.10
Renner32: posts big blind $0.25
*** HOLE CARDS ***
Dealt to SantiagoWeight [9c 4c]
ryanking99: folds 
uggsthelad: folds 
abbi555: folds 
clashwizard23: raises $0.50 to $0.75
SantiagoWeight: folds 
Renner32: calls $0.50
*** FLOP *** [8h 3c 3s]
Renner32: checks 
clashwizard23: bets $0.75
Renner32: folds 
Uncalled bet ($0.75) returned to clashwizard23
clashwizard23 collected $1.53 from pot
clashwizard23: doesn't show hand 
*** SUMMARY ***
Total pot $1.60 | Rake $0.07 
Board [8h 3c 3s]
Seat 1: clashwizard23 (button) collected ($1.53)
Seat 2: SantiagoWeight (small blind) folded before Flop
Seat 3: Renner32 (big blind) folded on the Flop
Seat 4: ryanking99 folded before Flop (didn't bet)
Seat 5: uggsthelad folded before Flop (didn't bet)
Seat 6: abbi555 folded before Flop (didn't bet)



PokerStars Zoom Hand #195024423267:  Hold'em No Limit ($0.10/$0.25) - 2018/12/29 4:35:08 UTC [2018/12/28 23:35:08 ET]
Table 'Hydra' 6-max Seat #1 is the button
Seat 1: sigaro010 ($59.47 in chips) 
Seat 2: JeDti ($26.98 in chips) 
Seat 3: abbi555 ($41.38 in chips) 
Seat 4: SantiagoWeight ($22.42 in chips) 
Seat 5: Gonzalit0o ($42.28 in chips) 
Seat 6: ttshead ($66.79 in chips) 
JeDti: posts small blind $0.10
abbi555: posts big blind $0.25
*** HOLE CARDS ***
Dealt to SantiagoWeight [8c 6s]
SantiagoWeight: folds 
Gonzalit0o: folds 
ttshead: folds 
sigaro010: raises $0.50 to $0.75
JeDti: folds 
abbi555: folds 
Uncalled bet ($0.50) returned to sigaro010
sigaro010 collected $0.60 from pot
sigaro010: doesn't show hand 
*** SUMMARY ***
Total pot $0.60 | Rake $0 
Seat 1: sigaro010 (button) collected ($0.60)
Seat 2: JeDti (small blind) folded before Flop
Seat 3: abbi555 (big blind) folded before Flop
Seat 4: SantiagoWeight folded before Flop (didn't bet)
Seat 5: Gonzalit0o folded before Flop (didn't bet)
Seat 6: ttshead folded before Flop (didn't bet)



PokerStars Zoom Hand #195024425528:  Hold'em No Limit ($0.10/$0.25) - 2018/12/29 4:35:16 UTC [2018/12/28 23:35:16 ET]
Table 'Hydra' 6-max Seat #1 is the button
Seat 1: SantiagoWeight ($22.42 in chips) 
Seat 2: lovintalbi ($25.53 in chips) 
Seat 3: Virus3232 ($25 in chips) 
Seat 4: bestitest542 ($39.64 in chips) 
Seat 5: aa1421b ($25.74 in chips) 
Seat 6: ivann14 ($37.43 in chips) 
lovintalbi: posts small blind $0.10
Virus3232: posts big blind $0.25
*** HOLE CARDS ***
Dealt to SantiagoWeight [2d 2h]
bestitest542: calls $0.25
aa1421b: folds 
ivann14: folds 
SantiagoWeight: calls $0.25
lovintalbi: folds 
Virus3232: checks 
*** FLOP *** [6c 2c Th]
Virus3232: checks 
bestitest542: bets $1.25
SantiagoWeight: raises $2.21 to $3.46
Virus3232: folds 
bestitest542: raises $2.21 to $5.67
SantiagoWeight: raises $16.50 to $22.17 and is all-in
bestitest542: calls $16.50
*** TURN *** [6c 2c Th] [5h]
*** RIVER *** [6c 2c Th 5h] [6d]
*** SHOW DOWN ***
bestitest542: shows [Qs Qh] (two pair, Queens and Sixes)
SantiagoWeight: shows [2d 2h] (a full house, Deuces full of Sixes)
SantiagoWeight collected $43.19 from pot
*** SUMMARY ***
Total pot $45.19 | Rake $2 
Board [6c 2c Th 5h 6d]
Seat 1: SantiagoWeight (button) showed [2d 2h] and won ($43.19) with a full house, Deuces full of Sixes
Seat 2: lovintalbi (small blind) folded before Flop
Seat 3: Virus3232 (big blind) folded on the Flop
Seat 4: bestitest542 showed [Qs Qh] and lost with two pair, Queens and Sixes
Seat 5: aa1421b folded before Flop (didn't bet)
Seat 6: ivann14 folded before Flop (didn't bet)



PokerStars Zoom Hand #195024449040:  Hold'em No Limit ($0.10/$0.25) - 2018/12/29 4:36:41 UTC [2018/12/28 23:36:41 ET]
Table 'Hydra' 6-max Seat #1 is the button
Seat 1: Igrok0609 ($15.97 in chips) 
Seat 2: Guard poker ($29.79 in chips) 
Seat 3: ivann14 ($30.37 in chips) 
Seat 4: karapuz1405 ($21.12 in chips) 
Seat 5: dk dreadlook ($26.74 in chips) 
Seat 6: SantiagoWeight ($43.19 in chips) 
Guard poker: posts small blind $0.10
ivann14: posts big blind $0.25
*** HOLE CARDS ***
Dealt to SantiagoWeight [6h 7d]
karapuz1405: folds 
dk dreadlook: folds 
SantiagoWeight: folds 
Igrok0609: folds 
Guard poker: folds 
Uncalled bet ($0.15) returned to ivann14
ivann14 collected $0.20 from pot
ivann14: doesn't show hand 
*** SUMMARY ***
Total pot $0.20 | Rake $0 
Seat 1: Igrok0609 (button) folded before Flop (didn't bet)
Seat 2: Guard poker (small blind) folded before Flop
Seat 3: ivann14 (big blind) collected ($0.20)
Seat 4: karapuz1405 folded before Flop (didn't bet)
Seat 5: dk dreadlook folded before Flop (didn't bet)
Seat 6: SantiagoWeight folded before Flop (didn't bet)



PokerStars Zoom Hand #195024446834:  Hold'em No Limit ($0.10/$0.25) - 2018/12/29 4:36:33 UTC [2018/12/28 23:36:33 ET]
Table 'Hydra' 6-max Seat #1 is the button
Seat 1: inujara4 ($35.74 in chips) 
Seat 2: Fobos113 ($16.28 in chips) 
Seat 3: ricpoitras ($25 in chips) 
Seat 4: SantiagoWeight ($43.19 in chips) 
Seat 5: abbi555 ($40.68 in chips) 
Seat 6: Becks Baker ($26.20 in chips) 
Fobos113: posts small blind $0.10
ricpoitras: posts big blind $0.25
*** HOLE CARDS ***
Dealt to SantiagoWeight [Jc Qh]
SantiagoWeight: folds 
abbi555: folds 
Becks Baker: raises $0.37 to $0.62
inujara4: folds 
Fobos113: folds 
ricpoitras: folds 
Uncalled bet ($0.37) returned to Becks Baker
Becks Baker collected $0.60 from pot
Becks Baker: doesn't show hand 
*** SUMMARY ***
Total pot $0.60 | Rake $0 
Seat 1: inujara4 (button) folded before Flop (didn't bet)
Seat 2: Fobos113 (small blind) folded before Flop
Seat 3: ricpoitras (big blind) folded before Flop
Seat 4: SantiagoWeight folded before Flop (didn't bet)
Seat 5: abbi555 folded before Flop (didn't bet)
Seat 6: Becks Baker collected ($0.60)



PokerStars Zoom Hand #195024450143:  Hold'em No Limit ($0.10/$0.25) - 2018/12/29 4:36:45 UTC [2018/12/28 23:36:45 ET]
Table 'Hydra' 6-max Seat #1 is the button
Seat 1: hamen1990 ($24.03 in chips) 
Seat 2: asapon ($25.60 in chips) 
Seat 3: SantiagoWeight ($43.19 in chips) 
Seat 4: deaglepro ($58.26 in chips) 
Seat 5: kurb1234 ($12.98 in chips) 
Seat 6: know you cry ($13.41 in chips) 
asapon: posts small blind $0.10
SantiagoWeight: posts big blind $0.25
*** HOLE CARDS ***
Dealt to SantiagoWeight [Kd 3h]
deaglepro: folds 
kurb1234: folds 
know you cry: raises $0.50 to $0.75
hamen1990: calls $0.75
asapon: folds 
SantiagoWeight: folds 
*** FLOP *** [3s Kh 7d]
know you cry: checks 
hamen1990: bets $1
know you cry: folds 
Uncalled bet ($1) returned to hamen1990
hamen1990 collected $1.77 from pot
hamen1990: doesn't show hand 
*** SUMMARY ***
Total pot $1.85 | Rake $0.08 
Board [3s Kh 7d]
Seat 1: hamen1990 (button) collected ($1.77)
Seat 2: asapon (small blind) folded before Flop
Seat 3: SantiagoWeight (big blind) folded before Flop
Seat 4: deaglepro folded before Flop (didn't bet)
Seat 5: kurb1234 folded before Flop (didn't bet)
Seat 6: know you cry folded on the Flop



PokerStars Zoom Hand #195024458278:  Hold'em No Limit ($0.10/$0.25) - 2018/12/29 4:37:15 UTC [2018/12/28 23:37:15 ET]
Table 'Hydra' 6-max Seat #1 is the button
Seat 1: inujara4 ($28.81 in chips) 
Seat 2: SantiagoWeight ($42.94 in chips) 
Seat 3: alex3d1985 ($16.99 in chips) 
Seat 4: asapon ($25.80 in chips) 
Seat 5: dk dreadlook ($32.04 in chips) 
Seat 6: Chrimmpam ($29.82 in chips) 
SantiagoWeight: posts small blind $0.10
alex3d1985: posts big blind $0.25
*** HOLE CARDS ***
Dealt to SantiagoWeight [7s 9h]
asapon: folds 
dk dreadlook: folds 
Chrimmpam: folds 
inujara4: folds 
SantiagoWeight: folds 
Uncalled bet ($0.15) returned to alex3d1985
alex3d1985 collected $0.20 from pot
*** SUMMARY ***
Total pot $0.20 | Rake $0 
Seat 1: inujara4 (button) folded before Flop (didn't bet)
Seat 2: SantiagoWeight (small blind) folded before Flop
Seat 3: alex3d1985 (big blind) collected ($0.20)
Seat 4: asapon folded before Flop (didn't bet)
Seat 5: dk dreadlook folded before Flop (didn't bet)
Seat 6: Chrimmpam folded before Flop (didn't bet)



PokerStars Zoom Hand #195024462129:  Hold'em No Limit ($0.10/$0.25) - 2018/12/29 4:37:29 UTC [2018/12/28 23:37:29 ET]
Table 'Hydra' 6-max Seat #1 is the button
Seat 1: SantiagoWeight ($42.84 in chips) 
Seat 2: Bonen18 ($48.05 in chips) 
Seat 3: asapon ($25.80 in chips) 
Seat 4: mariopork ($39.94 in chips) 
Seat 5: Chrimmpam ($17.46 in chips) 
Seat 6: Gonzalit0o ($32.16 in chips) 
Bonen18: posts small blind $0.10
asapon: posts big blind $0.25
*** HOLE CARDS ***
Dealt to SantiagoWeight [9s Jh]
mariopork: folds 
Chrimmpam: folds 
Gonzalit0o: raises $0.50 to $0.75
SantiagoWeight: folds 
Bonen18: folds 
asapon: folds 
Uncalled bet ($0.50) returned to Gonzalit0o
Gonzalit0o collected $0.60 from pot
Gonzalit0o: doesn't show hand 
*** SUMMARY ***
Total pot $0.60 | Rake $0 
Seat 1: SantiagoWeight (button) folded before Flop (didn't bet)
Seat 2: Bonen18 (small blind) folded before Flop
Seat 3: asapon (big blind) folded before Flop
Seat 4: mariopork folded before Flop (didn't bet)
Seat 5: Chrimmpam folded before Flop (didn't bet)
Seat 6: Gonzalit0o collected ($0.60)



PokerStars Zoom Hand #195024455760:  Hold'em No Limit ($0.10/$0.25) - 2018/12/29 4:37:06 UTC [2018/12/28 23:37:06 ET]
Table 'Hydra' 6-max Seat #1 is the button
Seat 1: JeDti ($26 in chips) 
Seat 2: graysonai ($25.10 in chips) 
Seat 3: oksana12422 ($23.44 in chips) 
Seat 4: Lehared ($26.01 in chips) 
Seat 5: Fobos113 ($15.68 in chips) 
Seat 6: SantiagoWeight ($42.94 in chips) 
graysonai: posts small blind $0.10
oksana12422: posts big blind $0.25
*** HOLE CARDS ***
Dealt to SantiagoWeight [Qs 8h]
Lehared: folds 
Fobos113: raises $0.50 to $0.75
SantiagoWeight: folds 
JeDti: calls $0.75
graysonai: folds 
oksana12422: calls $0.50
*** FLOP *** [Ac Kd 7h]
oksana12422: checks 
Fobos113: bets $1
JeDti: calls $1
oksana12422: folds 
*** TURN *** [Ac Kd 7h] [Jc]
Fobos113: checks 
JeDti: bets $2.78
Fobos113: folds 
Uncalled bet ($2.78) returned to JeDti
JeDti collected $4.15 from pot
JeDti: doesn't show hand 
*** SUMMARY ***
Total pot $4.35 | Rake $0.20 
Board [Ac Kd 7h Jc]
Seat 1: JeDti (button) collected ($4.15)
Seat 2: graysonai (small blind) folded before Flop
Seat 3: oksana12422 (big blind) folded on the Flop
Seat 4: Lehared folded before Flop (didn't bet)
Seat 5: Fobos113 folded on the Turn
Seat 6: SantiagoWeight folded before Flop (didn't bet)



PokerStars Zoom Hand #195024466265:  Hold'em No Limit ($0.10/$0.25) - 2018/12/29 4:37:44 UTC [2018/12/28 23:37:44 ET]
Table 'Hydra' 6-max Seat #1 is the button
Seat 1: daveo1008 ($30.79 in chips) 
Seat 2: JeDti ($25.81 in chips) 
Seat 3: glenn.vaughan ($21.81 in chips) 
Seat 4: mariopork ($103.55 in chips) 
Seat 5: SantiagoWeight ($42.84 in chips) 
Seat 6: Virus3232 ($27.98 in chips) 
JeDti: posts small blind $0.10
glenn.vaughan: posts big blind $0.25
*** HOLE CARDS ***
Dealt to SantiagoWeight [Qs Jh]
mariopork: folds 
SantiagoWeight: raises $0.37 to $0.62
Virus3232: raises $1.59 to $2.21
daveo1008: folds 
JeDti: folds 
glenn.vaughan: calls $1.96
SantiagoWeight: folds 
*** FLOP *** [Ks Ad 8s]
glenn.vaughan: checks 
Virus3232: checks 
*** TURN *** [Ks Ad 8s] [5h]
glenn.vaughan: checks 
Virus3232: bets $3
glenn.vaughan: folds 
Uncalled bet ($3) returned to Virus3232
Virus3232 collected $4.91 from pot
Virus3232: doesn't show hand 
*** SUMMARY ***
Total pot $5.14 | Rake $0.23 
Board [Ks Ad 8s 5h]
Seat 1: daveo1008 (button) folded before Flop (didn't bet)
Seat 2: JeDti (small blind) folded before Flop
Seat 3: glenn.vaughan (big blind) folded on the Turn
Seat 4: mariopork folded before Flop (didn't bet)
Seat 5: SantiagoWeight folded before Flop
Seat 6: Virus3232 collected ($4.91)



PokerStars Zoom Hand #195024471547:  Hold'em No Limit ($0.10/$0.25) - 2018/12/29 4:38:03 UTC [2018/12/28 23:38:03 ET]
Table 'Hydra' 6-max Seat #1 is the button
Seat 1: Bonen18 ($47.70 in chips) 
Seat 2: Becks Baker ($26.55 in chips) 
Seat 3: mililser ($48.66 in chips) 
Seat 4: SantiagoWeight ($42.22 in chips) 
Seat 5: Splodge86 ($22.80 in chips) 
Seat 6: G ster24 ($29.44 in chips) 
Becks Baker: posts small blind $0.10
mililser: posts big blind $0.25
*** HOLE CARDS ***
Dealt to SantiagoWeight [Ad 6c]
SantiagoWeight: folds 
Splodge86: folds 
G ster24: folds 
Bonen18: raises $0.27 to $0.52
Becks Baker: folds 
mililser: folds 
Uncalled bet ($0.27) returned to Bonen18
Bonen18 collected $0.60 from pot
Bonen18: doesn't show hand 
*** SUMMARY ***
Total pot $0.60 | Rake $0 
Seat 1: Bonen18 (button) collected ($0.60)
Seat 2: Becks Baker (small blind) folded before Flop
Seat 3: mililser (big blind) folded before Flop
Seat 4: SantiagoWeight folded before Flop (didn't bet)
Seat 5: Splodge86 folded before Flop (didn't bet)
Seat 6: G ster24 folded before Flop (didn't bet)



PokerStars Zoom Hand #195024472644:  Hold'em No Limit ($0.10/$0.25) - 2018/12/29 4:38:07 UTC [2018/12/28 23:38:07 ET]
Table 'Hydra' 6-max Seat #1 is the button
Seat 1: Lehared ($29.81 in chips) 
Seat 2: inujara4 ($36.19 in chips) 
Seat 3: SantiagoWeight ($42.22 in chips) 
Seat 4: G ster24 ($29.44 in chips) 
Seat 5: sikach78 ($34.04 in chips) 
Seat 6: dawwwid70 ($25.10 in chips) 
inujara4: posts small blind $0.10
SantiagoWeight: posts big blind $0.25
*** HOLE CARDS ***
Dealt to SantiagoWeight [Kd 5h]
G ster24: raises $0.25 to $0.50
sikach78: folds 
dawwwid70: folds 
Lehared: folds 
inujara4: folds 
SantiagoWeight: calls $0.25
*** FLOP *** [6s 2h Kh]
SantiagoWeight: checks 
G ster24: bets $1.05
SantiagoWeight: calls $1.05
*** TURN *** [6s 2h Kh] [4s]
SantiagoWeight: checks 
G ster24: checks 
*** RIVER *** [6s 2h Kh 4s] [5s]
SantiagoWeight: bets $3.06
G ster24: folds 
Uncalled bet ($3.06) returned to SantiagoWeight
SantiagoWeight collected $3.06 from pot
SantiagoWeight: doesn't show hand 
*** SUMMARY ***
Total pot $3.20 | Rake $0.14 
Board [6s 2h Kh 4s 5s]
Seat 1: Lehared (button) folded before Flop (didn't bet)
Seat 2: inujara4 (small blind) folded before Flop
Seat 3: SantiagoWeight (big blind) collected ($3.06)
Seat 4: G ster24 folded on the River
Seat 5: sikach78 folded before Flop (didn't bet)
Seat 6: dawwwid70 folded before Flop (didn't bet)



PokerStars Zoom Hand #195024486547:  Hold'em No Limit ($0.10/$0.25) - 2018/12/29 4:38:57 UTC [2018/12/28 23:38:57 ET]
Table 'Hydra' 6-max Seat #1 is the button
Seat 1: ricpoitras ($26.62 in chips) 
Seat 2: SantiagoWeight ($43.73 in chips) 
Seat 3: TQNYMQNTANA ($54.17 in chips) 
Seat 4: oksana12422 ($23.40 in chips) 
Seat 5: dan_iasi ($28.87 in chips) 
Seat 6: Sco0oter ($22.34 in chips) 
SantiagoWeight: posts small blind $0.10
TQNYMQNTANA: posts big blind $0.25
*** HOLE CARDS ***
Dealt to SantiagoWeight [2s Kh]
oksana12422: folds 
dan_iasi: folds 
Sco0oter: raises $0.25 to $0.50
ricpoitras: folds 
SantiagoWeight: folds 
TQNYMQNTANA: folds 
Uncalled bet ($0.25) returned to Sco0oter
Sco0oter collected $0.60 from pot
Sco0oter: doesn't show hand 
*** SUMMARY ***
Total pot $0.60 | Rake $0 
Seat 1: ricpoitras (button) folded before Flop (didn't bet)
Seat 2: SantiagoWeight (small blind) folded before Flop
Seat 3: TQNYMQNTANA (big blind) folded before Flop
Seat 4: oksana12422 folded before Flop (didn't bet)
Seat 5: dan_iasi folded before Flop (didn't bet)
Seat 6: Sco0oter collected ($0.60)



PokerStars Zoom Hand #195024490599:  Hold'em No Limit ($0.10/$0.25) - 2018/12/29 4:39:11 UTC [2018/12/28 23:39:11 ET]
Table 'Hydra' 6-max Seat #1 is the button
Seat 1: Pardaroxon ($25.10 in chips) 
Seat 2: dan_iasi ($27.27 in chips) 
Seat 3: Lehared ($25.67 in chips) 
Seat 4: dawwwid70 ($32.04 in chips) 
Seat 5: SantiagoWeight ($43.63 in chips) 
Seat 6: GrandmasterY ($35.44 in chips) 
dan_iasi: posts small blind $0.10
Lehared: posts big blind $0.25
*** HOLE CARDS ***
Dealt to SantiagoWeight [Ks Ad]
dawwwid70: folds 
SantiagoWeight: raises $0.30 to $0.55
GrandmasterY: folds 
Pardaroxon: folds 
dan_iasi: folds 
Lehared: folds 
Uncalled bet ($0.30) returned to SantiagoWeight
SantiagoWeight collected $0.60 from pot
SantiagoWeight: doesn't show hand 
*** SUMMARY ***
Total pot $0.60 | Rake $0 
Seat 1: Pardaroxon (button) folded before Flop (didn't bet)
Seat 2: dan_iasi (small blind) folded before Flop
Seat 3: Lehared (big blind) folded before Flop
Seat 4: dawwwid70 folded before Flop (didn't bet)
Seat 5: SantiagoWeight collected ($0.60)
Seat 6: GrandmasterY folded before Flop (didn't bet)



PokerStars Zoom Hand #195024500006:  Hold'em No Limit ($0.10/$0.25) - 2018/12/29 4:39:45 UTC [2018/12/28 23:39:45 ET]
Table 'Hydra' 6-max Seat #1 is the button
Seat 1: Guard poker ($25 in chips) 
Seat 2: crashbuum ($30.23 in chips) 
Seat 3: ivann14 ($37.43 in chips) 
Seat 4: Suit3dGapp3r ($26.15 in chips) 
Seat 5: mariopork ($40.78 in chips) 
Seat 6: SantiagoWeight ($43.98 in chips) 
crashbuum: posts small blind $0.10
ivann14: posts big blind $0.25
*** HOLE CARDS ***
Dealt to SantiagoWeight [6h 6s]
Suit3dGapp3r: folds 
mariopork: folds 
SantiagoWeight: raises $0.30 to $0.55
Guard poker: folds 
crashbuum: folds 
ivann14: folds 
Uncalled bet ($0.30) returned to SantiagoWeight
SantiagoWeight collected $0.60 from pot
SantiagoWeight: doesn't show hand 
*** SUMMARY ***
Total pot $0.60 | Rake $0 
Seat 1: Guard poker (button) folded before Flop (didn't bet)
Seat 2: crashbuum (small blind) folded before Flop
Seat 3: ivann14 (big blind) folded before Flop
Seat 4: Suit3dGapp3r folded before Flop (didn't bet)
Seat 5: mariopork folded before Flop (didn't bet)
Seat 6: SantiagoWeight collected ($0.60)



PokerStars Zoom Hand #195024504441:  Hold'em No Limit ($0.10/$0.25) - 2018/12/29 4:40:01 UTC [2018/12/28 23:40:01 ET]
Table 'Hydra' 6-max Seat #1 is the button
Seat 1: SantiagoWeight ($44.33 in chips) 
Seat 2: davidhw888 ($24.75 in chips) 
Seat 3: Bonen18 ($35.57 in chips) 
Seat 4: Virus3232 ($25.77 in chips) 
Seat 5: mariopork ($38.04 in chips) 
Seat 6: hames_tj ($26.51 in chips) 
davidhw888: posts small blind $0.10
Bonen18: posts big blind $0.25
*** HOLE CARDS ***
Dealt to SantiagoWeight [Kc 6s]
Virus3232: folds 
mariopork: folds 
hames_tj: folds 
SantiagoWeight: raises $0.30 to $0.55
davidhw888: raises $1.35 to $1.90
Bonen18: folds 
SantiagoWeight: folds 
Uncalled bet ($1.35) returned to davidhw888
davidhw888 collected $1.35 from pot
davidhw888: doesn't show hand 
*** SUMMARY ***
Total pot $1.35 | Rake $0 
Seat 1: SantiagoWeight (button) folded before Flop
Seat 2: davidhw888 (small blind) collected ($1.35)
Seat 3: Bonen18 (big blind) folded before Flop
Seat 4: Virus3232 folded before Flop (didn't bet)
Seat 5: mariopork folded before Flop (didn't bet)
Seat 6: hames_tj folded before Flop (didn't bet)



PokerStars Zoom Hand #195024514389:  Hold'em No Limit ($0.10/$0.25) - 2018/12/29 4:40:37 UTC [2018/12/28 23:40:37 ET]
Table 'Hydra' 6-max Seat #1 is the button
Seat 1: bestitest542 ($18.95 in chips) 
Seat 2: Lelelemale ($5.60 in chips) 
Seat 3: georgexploit ($25 in chips) 
Seat 4: moderi ($17.63 in chips) 
Seat 5: davidhw888 ($25.55 in chips) 
Seat 6: SantiagoWeight ($43.78 in chips) 
Lelelemale: posts small blind $0.10
georgexploit: posts big blind $0.25
*** HOLE CARDS ***
Dealt to SantiagoWeight [8s Jc]
moderi: folds 
davidhw888: folds 
SantiagoWeight: folds 
bestitest542: folds 
Lelelemale: folds 
Uncalled bet ($0.15) returned to georgexploit
georgexploit collected $0.20 from pot
georgexploit: doesn't show hand 
*** SUMMARY ***
Total pot $0.20 | Rake $0 
Seat 1: bestitest542 (button) folded before Flop (didn't bet)
Seat 2: Lelelemale (small blind) folded before Flop
Seat 3: georgexploit (big blind) collected ($0.20)
Seat 4: moderi folded before Flop (didn't bet)
Seat 5: davidhw888 folded before Flop (didn't bet)
Seat 6: SantiagoWeight folded before Flop (didn't bet)



PokerStars Zoom Hand #195024511937:  Hold'em No Limit ($0.10/$0.25) - 2018/12/29 4:40:28 UTC [2018/12/28 23:40:28 ET]
Table 'Hydra' 6-max Seat #1 is the button
Seat 1: abbi555 ($43.12 in chips) 
Seat 2: Virus3232 ($25.52 in chips) 
Seat 3: aa1421b ($45.24 in chips) 
Seat 4: SantiagoWeight ($43.78 in chips) 
Seat 5: Bonen18 ($47.88 in chips) 
Seat 6: MAKSSSSSS72 ($25.10 in chips) 
Virus3232: posts small blind $0.10
aa1421b: posts big blind $0.25
*** HOLE CARDS ***
Dealt to SantiagoWeight [2d 2h]
SantiagoWeight: folds 
Bonen18: folds 
MAKSSSSSS72: folds 
abbi555: folds 
Virus3232: raises $0.50 to $0.75
aa1421b: folds 
Uncalled bet ($0.50) returned to Virus3232
Virus3232 collected $0.50 from pot
Virus3232: doesn't show hand 
*** SUMMARY ***
Total pot $0.50 | Rake $0 
Seat 1: abbi555 (button) folded before Flop (didn't bet)
Seat 2: Virus3232 (small blind) collected ($0.50)
Seat 3: aa1421b (big blind) folded before Flop
Seat 4: SantiagoWeight folded before Flop (didn't bet)
Seat 5: Bonen18 folded before Flop (didn't bet)
Seat 6: MAKSSSSSS72 folded before Flop (didn't bet)



PokerStars Zoom Hand #195024510818:  Hold'em No Limit ($0.10/$0.25) - 2018/12/29 4:40:24 UTC [2018/12/28 23:40:24 ET]
Table 'Hydra' 6-max Seat #1 is the button
Seat 1: SmBusBully ($26.90 in chips) 
Seat 2: trkdrvman111 ($24.69 in chips) 
Seat 3: Higashi2314 ($25.35 in chips) 
Seat 4: SantiagoWeight ($43.78 in chips) 
Seat 5: cheolbeom ($31.58 in chips) 
Seat 6: JeDti ($27.09 in chips) 
trkdrvman111: posts small blind $0.10
Higashi2314: posts big blind $0.25
*** HOLE CARDS ***
Dealt to SantiagoWeight [5c 6c]
SantiagoWeight: folds 
cheolbeom: raises $0.50 to $0.75
JeDti: folds 
SmBusBully: folds 
trkdrvman111: folds 
Higashi2314: calls $0.50
*** FLOP *** [Kh 5s Ah]
Higashi2314: checks 
cheolbeom: checks 
*** TURN *** [Kh 5s Ah] [7c]
Higashi2314: checks 
cheolbeom: checks 
*** RIVER *** [Kh 5s Ah 7c] [Td]
Higashi2314: checks 
cheolbeom: bets $0.50
Higashi2314: folds 
Uncalled bet ($0.50) returned to cheolbeom
cheolbeom collected $1.53 from pot
cheolbeom: doesn't show hand 
*** SUMMARY ***
Total pot $1.60 | Rake $0.07 
Board [Kh 5s Ah 7c Td]
Seat 1: SmBusBully (button) folded before Flop (didn't bet)
Seat 2: trkdrvman111 (small blind) folded before Flop
Seat 3: Higashi2314 (big blind) folded on the River
Seat 4: SantiagoWeight folded before Flop (didn't bet)
Seat 5: cheolbeom collected ($1.53)
Seat 6: JeDti folded before Flop (didn't bet)



PokerStars Zoom Hand #195024516351:  Hold'em No Limit ($0.10/$0.25) - 2018/12/29 4:40:44 UTC [2018/12/28 23:40:44 ET]
Table 'Hydra' 6-max Seat #1 is the button
Seat 1: karapuz1405 ($18.40 in chips) 
Seat 2: ricpoitras ($29.89 in chips) 
Seat 3: SantiagoWeight ($43.78 in chips) 
Seat 4: davidhw888 ($25.55 in chips) 
Seat 5: hames_tj ($25 in chips) 
Seat 6: dan_iasi ($25.93 in chips) 
ricpoitras: posts small blind $0.10
SantiagoWeight: posts big blind $0.25
*** HOLE CARDS ***
Dealt to SantiagoWeight [8h 9s]
davidhw888: raises $0.50 to $0.75
hames_tj: folds 
dan_iasi: calls $0.75
karapuz1405: folds 
ricpoitras: folds 
SantiagoWeight: folds 
*** FLOP *** [2c Kh 4s]
davidhw888: checks 
dan_iasi: bets $1.31
davidhw888: folds 
Uncalled bet ($1.31) returned to dan_iasi
dan_iasi collected $1.77 from pot
dan_iasi: doesn't show hand 
*** SUMMARY ***
Total pot $1.85 | Rake $0.08 
Board [2c Kh 4s]
Seat 1: karapuz1405 (button) folded before Flop (didn't bet)
Seat 2: ricpoitras (small blind) folded before Flop
Seat 3: SantiagoWeight (big blind) folded before Flop
Seat 4: davidhw888 folded on the Flop
Seat 5: hames_tj folded before Flop (didn't bet)
Seat 6: dan_iasi collected ($1.77)



PokerStars Zoom Hand #195024520398:  Hold'em No Limit ($0.10/$0.25) - 2018/12/29 4:40:59 UTC [2018/12/28 23:40:59 ET]
Table 'Hydra' 6-max Seat #1 is the button
Seat 1: Bonen18 ($36.17 in chips) 
Seat 2: SantiagoWeight ($43.53 in chips) 
Seat 3: ritchy99 ($10.02 in chips) 
Seat 4: reggiedogg31 ($118.02 in chips) 
Seat 5: gustavotaina ($21.15 in chips) 
Seat 6: Pardaroxon ($25 in chips) 
SantiagoWeight: posts small blind $0.10
ritchy99: posts big blind $0.25
*** HOLE CARDS ***
Dealt to SantiagoWeight [Ks 2h]
reggiedogg31: folds 
gustavotaina: folds 
Pardaroxon: folds 
Bonen18: folds 
SantiagoWeight: folds 
Uncalled bet ($0.15) returned to ritchy99
ritchy99 collected $0.20 from pot
ritchy99: doesn't show hand 
*** SUMMARY ***
Total pot $0.20 | Rake $0 
Seat 1: Bonen18 (button) folded before Flop (didn't bet)
Seat 2: SantiagoWeight (small blind) folded before Flop
Seat 3: ritchy99 (big blind) collected ($0.20)
Seat 4: reggiedogg31 folded before Flop (didn't bet)
Seat 5: gustavotaina folded before Flop (didn't bet)
Seat 6: Pardaroxon folded before Flop (didn't bet)



PokerStars Zoom Hand #195024523755:  Hold'em No Limit ($0.10/$0.25) - 2018/12/29 4:41:11 UTC [2018/12/28 23:41:11 ET]
Table 'Hydra' 6-max Seat #1 is the button
Seat 1: SantiagoWeight ($43.43 in chips) 
Seat 2: karapuz1405 ($18.15 in chips) 
Seat 3: mariopork ($38.64 in chips) 
Seat 4: aa1421b ($44.99 in chips) 
Seat 5: IMMPORT@L ($22.46 in chips) 
Seat 6: river plate9 ($25.04 in chips) 
karapuz1405: posts small blind $0.10
mariopork: posts big blind $0.25
*** HOLE CARDS ***
Dealt to SantiagoWeight [Kd Kh]
aa1421b: raises $0.50 to $0.75
IMMPORT@L: folds 
river plate9: folds 
SantiagoWeight: raises $1.25 to $2
karapuz1405: folds 
mariopork: folds 
aa1421b: folds 
Uncalled bet ($1.25) returned to SantiagoWeight
SantiagoWeight collected $1.85 from pot
SantiagoWeight: doesn't show hand 
*** SUMMARY ***
Total pot $1.85 | Rake $0 
Seat 1: SantiagoWeight (button) collected ($1.85)
Seat 2: karapuz1405 (small blind) folded before Flop
Seat 3: mariopork (big blind) folded before Flop
Seat 4: aa1421b folded before Flop
Seat 5: IMMPORT@L folded before Flop (didn't bet)
Seat 6: river plate9 folded before Flop (didn't bet)



PokerStars Zoom Hand #195024530750:  Hold'em No Limit ($0.10/$0.25) - 2018/12/29 4:41:36 UTC [2018/12/28 23:41:36 ET]
Table 'Hydra' 6-max Seat #1 is the button
Seat 1: thedalbgoma ($24.90 in chips) 
Seat 2: TQNYMQNTANA ($55.39 in chips) 
Seat 3: Bonen18 ($48.63 in chips) 
Seat 4: Splodge86 ($20.98 in chips) 
Seat 5: SantiagoWeight ($44.53 in chips) 
Seat 6: dawwwid70 ($25 in chips) 
TQNYMQNTANA: posts small blind $0.10
Bonen18: posts big blind $0.25
*** HOLE CARDS ***
Dealt to SantiagoWeight [Js 4d]
Splodge86: folds 
thedalbgoma is disconnected 
SantiagoWeight: folds 
dawwwid70: folds 
thedalbgoma has timed out while disconnected
thedalbgoma: folds 
TQNYMQNTANA: folds 
Uncalled bet ($0.15) returned to Bonen18
Bonen18 collected $0.20 from pot
Bonen18: doesn't show hand 
*** SUMMARY ***
Total pot $0.20 | Rake $0 
Seat 1: thedalbgoma (button) folded before Flop (didn't bet)
Seat 2: TQNYMQNTANA (small blind) folded before Flop
Seat 3: Bonen18 (big blind) collected ($0.20)
Seat 4: Splodge86 folded before Flop (didn't bet)
Seat 5: SantiagoWeight folded before Flop (didn't bet)
Seat 6: dawwwid70 folded before Flop (didn't bet)



PokerStars Zoom Hand #195024533540:  Hold'em No Limit ($0.10/$0.25) - 2018/12/29 4:41:46 UTC [2018/12/28 23:41:46 ET]
Table 'Hydra' 6-max Seat #1 is the button
Seat 1: Shiltz17 ($49.70 in chips) 
Seat 2: Nutselas ($25 in chips) 
Seat 3: SantiagoWeight ($44.53 in chips) 
Seat 4: MAKSSSSSS72 ($24.40 in chips) 
Seat 5: kurb1234 ($19.78 in chips) 
Seat 6: oksana12422 ($23.26 in chips) 
Nutselas: posts small blind $0.10
SantiagoWeight: posts big blind $0.25
*** HOLE CARDS ***
Dealt to SantiagoWeight [Js 3d]
MAKSSSSSS72: folds 
kurb1234: folds 
oksana12422: raises $0.25 to $0.50
Shiltz17: calls $0.50
Nutselas: folds 
SantiagoWeight: folds 
*** FLOP *** [Tc Ad 3h]
oksana12422: checks 
Shiltz17: checks 
*** TURN *** [Tc Ad 3h] [Kh]
oksana12422: bets $0.50
Shiltz17: calls $0.50
*** RIVER *** [Tc Ad 3h Kh] [4d]
oksana12422: bets $1
Shiltz17: calls $1
*** SHOW DOWN ***
oksana12422: shows [Jc Qc] (a straight, Ten to Ace)
Shiltz17: mucks hand 
oksana12422 collected $4.15 from pot
*** SUMMARY ***
Total pot $4.35 | Rake $0.20 
Board [Tc Ad 3h Kh 4d]
Seat 1: Shiltz17 (button) mucked [3c 9c]
Seat 2: Nutselas (small blind) folded before Flop
Seat 3: SantiagoWeight (big blind) folded before Flop
Seat 4: MAKSSSSSS72 folded before Flop (didn't bet)
Seat 5: kurb1234 folded before Flop (didn't bet)
Seat 6: oksana12422 showed [Jc Qc] and won ($4.15) with a straight, Ten to Ace



PokerStars Zoom Hand #195024537432:  Hold'em No Limit ($0.10/$0.25) - 2018/12/29 4:42:00 UTC [2018/12/28 23:42:00 ET]
Table 'Hydra' 6-max Seat #1 is the button
Seat 1: sikach78 ($23.20 in chips) 
Seat 2: SantiagoWeight ($44.28 in chips) 
Seat 3: deaglepro ($62.26 in chips) 
Seat 4: Bonen18 ($25.32 in chips) 
Seat 5: anatoliy1976 ($74.58 in chips) 
Seat 6: ivann14 ($33.65 in chips) 
SantiagoWeight: posts small blind $0.10
deaglepro: posts big blind $0.25
*** HOLE CARDS ***
Dealt to SantiagoWeight [3s Ac]
Bonen18: folds 
anatoliy1976: folds 
ivann14: folds 
sikach78: raises $0.25 to $0.50
SantiagoWeight: folds 
deaglepro: calls $0.25
*** FLOP *** [9c Ad 9s]
deaglepro: checks 
sikach78: bets $0.75
deaglepro: calls $0.75
*** TURN *** [9c Ad 9s] [Kh]
deaglepro: checks 
sikach78: bets $1.50
deaglepro: folds 
Uncalled bet ($1.50) returned to sikach78
sikach78 collected $2.48 from pot
sikach78: doesn't show hand 
*** SUMMARY ***
Total pot $2.60 | Rake $0.12 
Board [9c Ad 9s Kh]
Seat 1: sikach78 (button) collected ($2.48)
Seat 2: SantiagoWeight (small blind) folded before Flop
Seat 3: deaglepro (big blind) folded on the Turn
Seat 4: Bonen18 folded before Flop (didn't bet)
Seat 5: anatoliy1976 folded before Flop (didn't bet)
Seat 6: ivann14 folded before Flop (didn't bet)



PokerStars Zoom Hand #195024541621:  Hold'em No Limit ($0.10/$0.25) - 2018/12/29 4:42:15 UTC [2018/12/28 23:42:15 ET]
Table 'Hydra' 6-max Seat #1 is the button
Seat 1: naxizzle ($103.18 in chips) 
Seat 2: xman141 ($93.63 in chips) 
Seat 3: hames_tj ($27.69 in chips) 
Seat 4: sikach78 ($6.84 in chips) 
Seat 5: SantiagoWeight ($44.18 in chips) 
Seat 6: ricpoitras ($27.35 in chips) 
xman141: posts small blind $0.10
hames_tj: posts big blind $0.25
*** HOLE CARDS ***
Dealt to SantiagoWeight [3c Qh]
sikach78: raises $0.25 to $0.50
SantiagoWeight: folds 
ricpoitras: folds 
naxizzle: folds 
xman141: folds 
hames_tj: calls $0.25
*** FLOP *** [6d 5h Jh]
hames_tj: checks 
sikach78: checks 
*** TURN *** [6d 5h Jh] [Js]
hames_tj: bets $0.25
sikach78: calls $0.25
*** RIVER *** [6d 5h Jh Js] [Ah]
hames_tj: bets $1.01
sikach78: folds 
Uncalled bet ($1.01) returned to hames_tj
hames_tj collected $1.53 from pot
hames_tj: doesn't show hand 
*** SUMMARY ***
Total pot $1.60 | Rake $0.07 
Board [6d 5h Jh Js Ah]
Seat 1: naxizzle (button) folded before Flop (didn't bet)
Seat 2: xman141 (small blind) folded before Flop
Seat 3: hames_tj (big blind) collected ($1.53)
Seat 4: sikach78 folded on the River
Seat 5: SantiagoWeight folded before Flop (didn't bet)
Seat 6: ricpoitras folded before Flop (didn't bet)



PokerStars Zoom Hand #195024547335:  Hold'em No Limit ($0.10/$0.25) - 2018/12/29 4:42:36 UTC [2018/12/28 23:42:36 ET]
Table 'Hydra' 6-max Seat #1 is the button
Seat 1: anatoliy1976 ($74.93 in chips) 
Seat 2: amansah ($20.12 in chips) 
Seat 3: dawwwid70 ($25 in chips) 
Seat 4: SantiagoWeight ($44.18 in chips) 
Seat 5: alex3d1985 ($34.08 in chips) 
Seat 6: ivann14 ($25 in chips) 
amansah: posts small blind $0.10
dawwwid70: posts big blind $0.25
*** HOLE CARDS ***
Dealt to SantiagoWeight [Ks Ah]
SantiagoWeight: raises $0.42 to $0.67
alex3d1985: folds 
ivann14: folds 
anatoliy1976: folds 
amansah: calls $0.57
dawwwid70: folds 
*** FLOP *** [Jd 2h Kc]
amansah: bets $1
SantiagoWeight: raises $2 to $3
amansah: folds 
Uncalled bet ($2) returned to SantiagoWeight
SantiagoWeight collected $3.43 from pot
SantiagoWeight: doesn't show hand 
*** SUMMARY ***
Total pot $3.59 | Rake $0.16 
Board [Jd 2h Kc]
Seat 1: anatoliy1976 (button) folded before Flop (didn't bet)
Seat 2: amansah (small blind) folded on the Flop
Seat 3: dawwwid70 (big blind) folded before Flop
Seat 4: SantiagoWeight collected ($3.43)
Seat 5: alex3d1985 folded before Flop (didn't bet)
Seat 6: ivann14 folded before Flop (didn't bet)



PokerStars Zoom Hand #195024560311:  Hold'em No Limit ($0.10/$0.25) - 2018/12/29 4:43:23 UTC [2018/12/28 23:43:23 ET]
Table 'Hydra' 6-max Seat #1 is the button
Seat 1: SantiagoWeight ($45.94 in chips) 
Seat 2: mariopork ($25.10 in chips) 
Seat 3: TQNYMQNTANA ($25 in chips) 
Seat 4: xman141 ($93.88 in chips) 
Seat 5: Bonen18 ($55.08 in chips) 
Seat 6: JeDti ($25 in chips) 
mariopork: posts small blind $0.10
TQNYMQNTANA: posts big blind $0.25
*** HOLE CARDS ***
Dealt to SantiagoWeight [3d 6d]
xman141: folds 
Bonen18: folds 
JeDti: folds 
SantiagoWeight: folds 
mariopork: folds 
Uncalled bet ($0.15) returned to TQNYMQNTANA
TQNYMQNTANA collected $0.20 from pot
TQNYMQNTANA: doesn't show hand 
*** SUMMARY ***
Total pot $0.20 | Rake $0 
Seat 1: SantiagoWeight (button) folded before Flop (didn't bet)
Seat 2: mariopork (small blind) folded before Flop
Seat 3: TQNYMQNTANA (big blind) collected ($0.20)
Seat 4: xman141 folded before Flop (didn't bet)
Seat 5: Bonen18 folded before Flop (didn't bet)
Seat 6: JeDti folded before Flop (didn't bet)



PokerStars Zoom Hand #195024564109:  Hold'em No Limit ($0.10/$0.25) - 2018/12/29 4:43:37 UTC [2018/12/28 23:43:37 ET]
Table 'Hydra' 6-max Seat #1 is the button
Seat 1: alex3d1985 ($34.08 in chips) 
Seat 2: winwinboy ($25 in chips) 
Seat 3: !P0K3RM3T4L! ($28.89 in chips) 
Seat 4: Bonen18 ($25 in chips) 
Seat 5: Doomdigidoom ($39.40 in chips) 
Seat 6: SantiagoWeight ($45.94 in chips) 
winwinboy: posts small blind $0.10
!P0K3RM3T4L!: posts big blind $0.25
*** HOLE CARDS ***
Dealt to SantiagoWeight [Kd 8c]
Bonen18: folds 
Doomdigidoom: raises $0.25 to $0.50
SantiagoWeight: folds 
alex3d1985: folds 
winwinboy: folds 
!P0K3RM3T4L!: folds 
Uncalled bet ($0.25) returned to Doomdigidoom
Doomdigidoom collected $0.60 from pot
Doomdigidoom: doesn't show hand 
*** SUMMARY ***
Total pot $0.60 | Rake $0 
Seat 1: alex3d1985 (button) folded before Flop (didn't bet)
Seat 2: winwinboy (small blind) folded before Flop
Seat 3: !P0K3RM3T4L! (big blind) folded before Flop
Seat 4: Bonen18 folded before Flop (didn't bet)
Seat 5: Doomdigidoom collected ($0.60)
Seat 6: SantiagoWeight folded before Flop (didn't bet)



PokerStars Zoom Hand #195024563036:  Hold'em No Limit ($0.10/$0.25) - 2018/12/29 4:43:33 UTC [2018/12/28 23:43:33 ET]
Table 'Hydra' 6-max Seat #1 is the button
Seat 1: graysonai ($34.58 in chips) 
Seat 2: SpaZz0205 ($28.18 in chips) 
Seat 3: dawwwid70 ($25 in chips) 
Seat 4: SantiagoWeight ($45.94 in chips) 
Seat 5: GrandmasterY ($27.92 in chips) 
Seat 6: KingsOfEdm ($69.81 in chips) 
SpaZz0205: posts small blind $0.10
dawwwid70: posts big blind $0.25
*** HOLE CARDS ***
Dealt to SantiagoWeight [4c Jd]
SantiagoWeight: folds 
GrandmasterY: folds 
KingsOfEdm: calls $0.25
graysonai: folds 
SpaZz0205: calls $0.15
dawwwid70: raises $2.62 to $2.87
KingsOfEdm has timed out
KingsOfEdm: folds 
SpaZz0205: calls $2.62
*** FLOP *** [Qh 8h 8d]
SpaZz0205: checks 
dawwwid70: bets $22.13 and is all-in
SpaZz0205: folds 
Uncalled bet ($22.13) returned to dawwwid70
dawwwid70 collected $5.72 from pot
dawwwid70: doesn't show hand 
*** SUMMARY ***
Total pot $5.99 | Rake $0.27 
Board [Qh 8h 8d]
Seat 1: graysonai (button) folded before Flop (didn't bet)
Seat 2: SpaZz0205 (small blind) folded on the Flop
Seat 3: dawwwid70 (big blind) collected ($5.72)
Seat 4: SantiagoWeight folded before Flop (didn't bet)
Seat 5: GrandmasterY folded before Flop (didn't bet)
Seat 6: KingsOfEdm folded before Flop



PokerStars Zoom Hand #195024567635:  Hold'em No Limit ($0.10/$0.25) - 2018/12/29 4:43:50 UTC [2018/12/28 23:43:50 ET]
Table 'Hydra' 6-max Seat #1 is the button
Seat 1: Virus3232 ($25 in chips) 
Seat 2: JeDti ($25 in chips) 
Seat 3: SantiagoWeight ($45.94 in chips) 
Seat 4: TQNYMQNTANA ($57.96 in chips) 
Seat 5: graysonai ($25 in chips) 
Seat 6: reggiedogg31 ($116.45 in chips) 
JeDti: posts small blind $0.10
SantiagoWeight: posts big blind $0.25
*** HOLE CARDS ***
Dealt to SantiagoWeight [Jh Jd]
TQNYMQNTANA: raises $0.50 to $0.75
graysonai: folds 
reggiedogg31: folds 
Virus3232: folds 
JeDti: folds 
SantiagoWeight: calls $0.50
*** FLOP *** [9d Ah Jc]
SantiagoWeight: checks 
TQNYMQNTANA: bets $1
SantiagoWeight: calls $1
*** TURN *** [9d Ah Jc] [8d]
SantiagoWeight: checks 
TQNYMQNTANA: checks 
*** RIVER *** [9d Ah Jc 8d] [6h]
SantiagoWeight: bets $2.50
TQNYMQNTANA: folds 
Uncalled bet ($2.50) returned to SantiagoWeight
SantiagoWeight collected $3.44 from pot
SantiagoWeight: doesn't show hand 
*** SUMMARY ***
Total pot $3.60 | Rake $0.16 
Board [9d Ah Jc 8d 6h]
Seat 1: Virus3232 (button) folded before Flop (didn't bet)
Seat 2: JeDti (small blind) folded before Flop
Seat 3: SantiagoWeight (big blind) collected ($3.44)
Seat 4: TQNYMQNTANA folded on the River
Seat 5: graysonai folded before Flop (didn't bet)
Seat 6: reggiedogg31 folded before Flop (didn't bet)



PokerStars Zoom Hand #195024587610:  Hold'em No Limit ($0.10/$0.25) - 2018/12/29 4:45:03 UTC [2018/12/28 23:45:03 ET]
Table 'Hydra' 6-max Seat #1 is the button
Seat 1: Gonzalit0o ($79.33 in chips) 
Seat 2: SantiagoWeight ($47.63 in chips) 
Seat 3: mililser ($50.39 in chips) 
Seat 4: anatoliy1976 ($73.38 in chips) 
Seat 5: Bonen18 ($66.64 in chips) 
Seat 6: Chrimmpam ($20.86 in chips) 
SantiagoWeight: posts small blind $0.10
mililser: posts big blind $0.25
*** HOLE CARDS ***
Dealt to SantiagoWeight [3h 4c]
anatoliy1976: folds 
Bonen18: folds 
Chrimmpam: folds 
Gonzalit0o: folds 
SantiagoWeight: folds 
Uncalled bet ($0.15) returned to mililser
mililser collected $0.20 from pot
mililser: doesn't show hand 
*** SUMMARY ***
Total pot $0.20 | Rake $0 
Seat 1: Gonzalit0o (button) folded before Flop (didn't bet)
Seat 2: SantiagoWeight (small blind) folded before Flop
Seat 3: mililser (big blind) collected ($0.20)
Seat 4: anatoliy1976 folded before Flop (didn't bet)
Seat 5: Bonen18 folded before Flop (didn't bet)
Seat 6: Chrimmpam folded before Flop (didn't bet)



PokerStars Zoom Hand #195024592977:  Hold'em No Limit ($0.10/$0.25) - 2018/12/29 4:45:23 UTC [2018/12/28 23:45:23 ET]
Table 'Hydra' 6-max Seat #1 is the button
Seat 1: Virus3232 ($25 in chips) 
Seat 2: graysonai ($34.03 in chips) 
Seat 3: Chrimmpam ($12.33 in chips) 
Seat 4: SantiagoWeight ($47.53 in chips) 
Seat 5: Higashi2314 ($25 in chips) 
Seat 6: GrandmasterY ($66.95 in chips) 
graysonai: posts small blind $0.10
Chrimmpam: posts big blind $0.25
*** HOLE CARDS ***
Dealt to SantiagoWeight [Jc Jd]
SantiagoWeight: raises $0.37 to $0.62
Higashi2314: folds 
GrandmasterY: folds 
Virus3232: raises $1.59 to $2.21
graysonai: folds 
Chrimmpam: folds 
SantiagoWeight: calls $1.59
*** FLOP *** [8c 9h As]
SantiagoWeight: checks 
Virus3232: checks 
*** TURN *** [8c 9h As] [9c]
SantiagoWeight: checks 
Virus3232: bets $3
SantiagoWeight: calls $3
*** RIVER *** [8c 9h As 9c] [Th]
SantiagoWeight: checks 
Virus3232: checks 
*** SHOW DOWN ***
SantiagoWeight: shows [Jc Jd] (two pair, Jacks and Nines)
Virus3232: mucks hand 
SantiagoWeight collected $10.29 from pot
*** SUMMARY ***
Total pot $10.77 | Rake $0.48 
Board [8c 9h As 9c Th]
Seat 1: Virus3232 (button) mucked [6s 6d]
Seat 2: graysonai (small blind) folded before Flop
Seat 3: Chrimmpam (big blind) folded before Flop
Seat 4: SantiagoWeight showed [Jc Jd] and won ($10.29) with two pair, Jacks and Nines
Seat 5: Higashi2314 folded before Flop (didn't bet)
Seat 6: GrandmasterY folded before Flop (didn't bet)



PokerStars Zoom Hand #195024619363:  Hold'em No Limit ($0.10/$0.25) - 2018/12/29 4:47:00 UTC [2018/12/28 23:47:00 ET]
Table 'Hydra' 6-max Seat #1 is the button
Seat 1: karapuz1405 ($12.83 in chips) 
Seat 2: Virus3232 ($25.85 in chips) 
Seat 3: deaglepro ($59.38 in chips) 
Seat 4: JeDti ($25 in chips) 
Seat 5: SantiagoWeight ($52.61 in chips) 
Seat 6: ARTBIL ($23.99 in chips) 
Virus3232: posts small blind $0.10
deaglepro: posts big blind $0.25
*** HOLE CARDS ***
Dealt to SantiagoWeight [7s Qd]
JeDti: folds 
SantiagoWeight: folds 
ARTBIL: folds 
karapuz1405: folds 
Virus3232: raises $0.50 to $0.75
deaglepro: folds 
Uncalled bet ($0.50) returned to Virus3232
Virus3232 collected $0.50 from pot
Virus3232: doesn't show hand 
*** SUMMARY ***
Total pot $0.50 | Rake $0 
Seat 1: karapuz1405 (button) folded before Flop (didn't bet)
Seat 2: Virus3232 (small blind) collected ($0.50)
Seat 3: deaglepro (big blind) folded before Flop
Seat 4: JeDti folded before Flop (didn't bet)
Seat 5: SantiagoWeight folded before Flop (didn't bet)
Seat 6: ARTBIL folded before Flop (didn't bet)



PokerStars Zoom Hand #195024628182:  Hold'em No Limit ($0.10/$0.25) - 2018/12/29 4:47:32 UTC [2018/12/28 23:47:32 ET]
Table 'Hydra' 6-max Seat #1 is the button
Seat 1: naxizzle ($100.73 in chips) 
Seat 2: SantiagoWeight ($52.36 in chips) 
Seat 3: Lehared ($32.07 in chips) 
Seat 4: Pardaroxon ($25.55 in chips) 
Seat 5: Bonen18 ($26.36 in chips) 
Seat 6: river plate9 ($39.98 in chips) 
SantiagoWeight: posts small blind $0.10
Lehared: posts big blind $0.25
*** HOLE CARDS ***
Dealt to SantiagoWeight [Tc 7s]
Pardaroxon: folds 
Bonen18: folds 
river plate9: raises $0.50 to $0.75
naxizzle: calls $0.75
SantiagoWeight: folds 
Lehared: folds 
*** FLOP *** [Kh 6d 6h]
river plate9: checks 
naxizzle: checks 
*** TURN *** [Kh 6d 6h] [8h]
river plate9: bets $1
naxizzle: folds 
Uncalled bet ($1) returned to river plate9
river plate9 collected $1.77 from pot
river plate9: doesn't show hand 
*** SUMMARY ***
Total pot $1.85 | Rake $0.08 
Board [Kh 6d 6h 8h]
Seat 1: naxizzle (button) folded on the Turn
Seat 2: SantiagoWeight (small blind) folded before Flop
Seat 3: Lehared (big blind) folded before Flop
Seat 4: Pardaroxon folded before Flop (didn't bet)
Seat 5: Bonen18 folded before Flop (didn't bet)
Seat 6: river plate9 collected ($1.77)



PokerStars Zoom Hand #195024622926:  Hold'em No Limit ($0.10/$0.25) - 2018/12/29 4:47:13 UTC [2018/12/28 23:47:13 ET]
Table 'Hydra' 6-max Seat #1 is the button
Seat 1: Doomdigidoom ($34.93 in chips) 
Seat 2: JeDti ($25 in chips) 
Seat 3: SantiagoWeight ($52.61 in chips) 
Seat 4: zdenekstavic ($48.77 in chips) 
Seat 5: alex3d1985 ($30.83 in chips) 
Seat 6: killerB17 ($36.55 in chips) 
JeDti: posts small blind $0.10
SantiagoWeight: posts big blind $0.25
*** HOLE CARDS ***
Dealt to SantiagoWeight [4c 2d]
zdenekstavic: raises $0.25 to $0.50
alex3d1985: folds 
killerB17: folds 
Doomdigidoom: calls $0.50
JeDti: folds 
SantiagoWeight: folds 
*** FLOP *** [4h Js 5s]
zdenekstavic: checks 
Doomdigidoom: bets $0.50
zdenekstavic: calls $0.50
*** TURN *** [4h Js 5s] [Ac]
zdenekstavic: checks 
Doomdigidoom: bets $0.25
zdenekstavic: calls $0.25
*** RIVER *** [4h Js 5s Ac] [5d]
zdenekstavic: checks 
Doomdigidoom: bets $0.25
zdenekstavic: calls $0.25
*** SHOW DOWN ***
Doomdigidoom: shows [Jh Qd] (two pair, Jacks and Fives)
zdenekstavic: shows [Jc Td] (two pair, Jacks and Fives)
zdenekstavic collected $1.60 from pot
Doomdigidoom collected $1.60 from pot
*** SUMMARY ***
Total pot $3.35 | Rake $0.15 
Board [4h Js 5s Ac 5d]
Seat 1: Doomdigidoom (button) showed [Jh Qd] and won ($1.60) with two pair, Jacks and Fives
Seat 2: JeDti (small blind) folded before Flop
Seat 3: SantiagoWeight (big blind) folded before Flop
Seat 4: zdenekstavic showed [Jc Td] and won ($1.60) with two pair, Jacks and Fives
Seat 5: alex3d1985 folded before Flop (didn't bet)
Seat 6: killerB17 folded before Flop (didn't bet)



PokerStars Zoom Hand #195024632562:  Hold'em No Limit ($0.10/$0.25) - 2018/12/29 4:47:48 UTC [2018/12/28 23:47:48 ET]
Table 'Hydra' 6-max Seat #1 is the button
Seat 1: SantiagoWeight ($52.26 in chips) 
Seat 2: glenn.vaughan ($37.18 in chips) 
Seat 3: TQNYMQNTANA ($25 in chips) 
Seat 4: hamen1990 ($30.19 in chips) 
Seat 5: Lehared ($34.43 in chips) 
Seat 6: asapon ($28.71 in chips) 
glenn.vaughan: posts small blind $0.10
TQNYMQNTANA: posts big blind $0.25
*** HOLE CARDS ***
Dealt to SantiagoWeight [6d 5h]
hamen1990: folds 
Lehared: folds 
asapon: raises $0.37 to $0.62
SantiagoWeight: folds 
glenn.vaughan: folds 
TQNYMQNTANA: folds 
Uncalled bet ($0.37) returned to asapon
asapon collected $0.60 from pot
asapon: doesn't show hand 
*** SUMMARY ***
Total pot $0.60 | Rake $0 
Seat 1: SantiagoWeight (button) folded before Flop (didn't bet)
Seat 2: glenn.vaughan (small blind) folded before Flop
Seat 3: TQNYMQNTANA (big blind) folded before Flop
Seat 4: hamen1990 folded before Flop (didn't bet)
Seat 5: Lehared folded before Flop (didn't bet)
Seat 6: asapon collected ($0.60)



PokerStars Zoom Hand #195024639218:  Hold'em No Limit ($0.10/$0.25) - 2018/12/29 4:48:12 UTC [2018/12/28 23:48:12 ET]
Table 'Hydra' 6-max Seat #1 is the button
Seat 1: Gonzalit0o ($43.65 in chips) 
Seat 2: sensamen ($24.75 in chips) 
Seat 3: dawwwid70 ($44.83 in chips) 
Seat 4: Splodge86 ($12.95 in chips) 
Seat 5: JeDti ($25 in chips) 
Seat 6: SantiagoWeight ($52.26 in chips) 
sensamen: posts small blind $0.10
dawwwid70: posts big blind $0.25
*** HOLE CARDS ***
Dealt to SantiagoWeight [8c Ah]
Splodge86: folds 
JeDti: folds 
SantiagoWeight: raises $0.30 to $0.55
Gonzalit0o: calls $0.55
sensamen: calls $0.45
dawwwid70: calls $0.30
*** FLOP *** [5h Kc Kh]
sensamen: checks 
dawwwid70: checks 
SantiagoWeight: checks 
Gonzalit0o: checks 
*** TURN *** [5h Kc Kh] [Ac]
sensamen: checks 
dawwwid70: checks 
SantiagoWeight: bets $0.53
Gonzalit0o: folds 
sensamen: folds 
dawwwid70: folds 
Uncalled bet ($0.53) returned to SantiagoWeight
SantiagoWeight collected $2.10 from pot
SantiagoWeight: doesn't show hand 
*** SUMMARY ***
Total pot $2.20 | Rake $0.10 
Board [5h Kc Kh Ac]
Seat 1: Gonzalit0o (button) folded on the Turn
Seat 2: sensamen (small blind) folded on the Turn
Seat 3: dawwwid70 (big blind) folded on the Turn
Seat 4: Splodge86 folded before Flop (didn't bet)
Seat 5: JeDti folded before Flop (didn't bet)
Seat 6: SantiagoWeight collected ($2.10)



PokerStars Zoom Hand #195024655401:  Hold'em No Limit ($0.10/$0.25) - 2018/12/29 4:49:11 UTC [2018/12/28 23:49:11 ET]
Table 'Hydra' 6-max Seat #1 is the button
Seat 1: Viiiru ($33.76 in chips) 
Seat 2: TQNYMQNTANA ($57.27 in chips) 
Seat 3: mariopork ($26.01 in chips) 
Seat 4: SantiagoWeight ($53.81 in chips) 
Seat 5: crashbuum ($27.64 in chips) 
Seat 6: Rika_run ($25 in chips) 
TQNYMQNTANA: posts small blind $0.10
mariopork: posts big blind $0.25
*** HOLE CARDS ***
Dealt to SantiagoWeight [Ah 7c]
SantiagoWeight: folds 
crashbuum: folds 
Rika_run: folds 
Viiiru: folds 
TQNYMQNTANA: folds 
Uncalled bet ($0.15) returned to mariopork
mariopork collected $0.20 from pot
mariopork: doesn't show hand 
*** SUMMARY ***
Total pot $0.20 | Rake $0 
Seat 1: Viiiru (button) folded before Flop (didn't bet)
Seat 2: TQNYMQNTANA (small blind) folded before Flop
Seat 3: mariopork (big blind) collected ($0.20)
Seat 4: SantiagoWeight folded before Flop (didn't bet)
Seat 5: crashbuum folded before Flop (didn't bet)
Seat 6: Rika_run folded before Flop (didn't bet)



PokerStars Zoom Hand #195024658915:  Hold'em No Limit ($0.10/$0.25) - 2018/12/29 4:49:24 UTC [2018/12/28 23:49:24 ET]
Table 'Hydra' 6-max Seat #1 is the button
Seat 1: SantiagoWeight ($53.81 in chips) 
Seat 2: deaglepro ($53.64 in chips) 
Seat 3: SmBusBully ($10.34 in chips) 
Seat 4: aa1421b ($38.41 in chips) 
Seat 5: Virus3232 ($40.57 in chips) 
Seat 6: mariopork ($37.61 in chips) 
deaglepro: posts small blind $0.10
SmBusBully: posts big blind $0.25
*** HOLE CARDS ***
Dealt to SantiagoWeight [9c Td]
aa1421b: folds 
Virus3232: folds 
mariopork: folds 
SantiagoWeight: raises $0.30 to $0.55
deaglepro: folds 
SmBusBully: folds 
Uncalled bet ($0.30) returned to SantiagoWeight
SantiagoWeight collected $0.60 from pot
SantiagoWeight: doesn't show hand 
*** SUMMARY ***
Total pot $0.60 | Rake $0 
Seat 1: SantiagoWeight (button) collected ($0.60)
Seat 2: deaglepro (small blind) folded before Flop
Seat 3: SmBusBully (big blind) folded before Flop
Seat 4: aa1421b folded before Flop (didn't bet)
Seat 5: Virus3232 folded before Flop (didn't bet)
Seat 6: mariopork folded before Flop (didn't bet)



PokerStars Zoom Hand #195024669693:  Hold'em No Limit ($0.10/$0.25) - 2018/12/29 4:50:04 UTC [2018/12/28 23:50:04 ET]
Table 'Hydra' 6-max Seat #1 is the button
Seat 1: LastNoma ($38.86 in chips) 
Seat 2: alex3d1985 ($29.53 in chips) 
Seat 3: Nutselas ($25 in chips) 
Seat 4: Bonen18 ($25 in chips) 
Seat 5: SantiagoWeight ($53.91 in chips) 
Seat 6: koichi1210 ($27.03 in chips) 
alex3d1985: posts small blind $0.10
Nutselas: posts big blind $0.25
*** HOLE CARDS ***
Dealt to SantiagoWeight [8s Qd]
Bonen18: folds 
SantiagoWeight: folds 
koichi1210: folds 
LastNoma: folds 
alex3d1985: folds 
Uncalled bet ($0.15) returned to Nutselas
Nutselas collected $0.20 from pot
Nutselas: doesn't show hand 
*** SUMMARY ***
Total pot $0.20 | Rake $0 
Seat 1: LastNoma (button) folded before Flop (didn't bet)
Seat 2: alex3d1985 (small blind) folded before Flop
Seat 3: Nutselas (big blind) collected ($0.20)
Seat 4: Bonen18 folded before Flop (didn't bet)
Seat 5: SantiagoWeight folded before Flop (didn't bet)
Seat 6: koichi1210 folded before Flop (didn't bet)



PokerStars Zoom Hand #195024664581:  Hold'em No Limit ($0.10/$0.25) - 2018/12/29 4:49:45 UTC [2018/12/28 23:49:45 ET]
Table 'Hydra' 6-max Seat #1 is the button
Seat 1: mmeplamondon ($34.13 in chips) 
Seat 2: hamen1990 ($31.07 in chips) 
Seat 3: SantiagoWeight ($54.16 in chips) 
Seat 4: TQNYMQNTANA ($56.82 in chips) 
Seat 5: ryanking99 ($10.08 in chips) 
Seat 6: sikach78 ($18.15 in chips) 
hamen1990: posts small blind $0.10
SantiagoWeight: posts big blind $0.25
*** HOLE CARDS ***
Dealt to SantiagoWeight [6c 8d]
TQNYMQNTANA: raises $0.50 to $0.75
ryanking99: folds 
sikach78: calls $0.75
mmeplamondon: folds 
hamen1990: folds 
SantiagoWeight: folds 
*** FLOP *** [5d 6h 2s]
TQNYMQNTANA: bets $1
sikach78: calls $1
*** TURN *** [5d 6h 2s] [9h]
TQNYMQNTANA: checks 
sikach78: bets $2
TQNYMQNTANA: folds 
Uncalled bet ($2) returned to sikach78
sikach78 collected $3.68 from pot
sikach78: doesn't show hand 
*** SUMMARY ***
Total pot $3.85 | Rake $0.17 
Board [5d 6h 2s 9h]
Seat 1: mmeplamondon (button) folded before Flop (didn't bet)
Seat 2: hamen1990 (small blind) folded before Flop
Seat 3: SantiagoWeight (big blind) folded before Flop
Seat 4: TQNYMQNTANA folded on the Turn
Seat 5: ryanking99 folded before Flop (didn't bet)
Seat 6: sikach78 collected ($3.68)



PokerStars Zoom Hand #195024668097:  Hold'em No Limit ($0.10/$0.25) - 2018/12/29 4:49:58 UTC [2018/12/28 23:49:58 ET]
Table 'Hydra' 6-max Seat #1 is the button
Seat 1: MAKSSSSSS72 ($55.44 in chips) 
Seat 2: G ster24 ($50.61 in chips) 
Seat 3: trillerGTO ($25 in chips) 
Seat 4: Nutselas ($25 in chips) 
Seat 5: SantiagoWeight ($53.91 in chips) 
Seat 6: IMMPORT@L ($18.22 in chips) 
G ster24: posts small blind $0.10
trillerGTO: posts big blind $0.25
*** HOLE CARDS ***
Dealt to SantiagoWeight [5h Ac]
Nutselas: folds 
SantiagoWeight: folds 
IMMPORT@L: folds 
MAKSSSSSS72: folds 
G ster24: raises $0.25 to $0.50
trillerGTO: calls $0.25
*** FLOP *** [8h Jh 4d]
G ster24: checks 
trillerGTO: checks 
*** TURN *** [8h Jh 4d] [8s]
G ster24: bets $0.48
trillerGTO: calls $0.48
*** RIVER *** [8h Jh 4d 8s] [Tc]
G ster24: checks 
trillerGTO: checks 
*** SHOW DOWN ***
G ster24: shows [As 9c] (a pair of Eights)
trillerGTO: shows [6s Ad] (a pair of Eights)
G ster24 collected $0.94 from pot
trillerGTO collected $0.93 from pot
*** SUMMARY ***
Total pot $1.96 | Rake $0.09 
Board [8h Jh 4d 8s Tc]
Seat 1: MAKSSSSSS72 (button) folded before Flop (didn't bet)
Seat 2: G ster24 (small blind) showed [As 9c] and won ($0.94) with a pair of Eights
Seat 3: trillerGTO (big blind) showed [6s Ad] and won ($0.93) with a pair of Eights
Seat 4: Nutselas folded before Flop (didn't bet)
Seat 5: SantiagoWeight folded before Flop (didn't bet)
Seat 6: IMMPORT@L folded before Flop (didn't bet)



PokerStars Zoom Hand #195024663524:  Hold'em No Limit ($0.10/$0.25) - 2018/12/29 4:49:41 UTC [2018/12/28 23:49:41 ET]
Table 'Hydra' 6-max Seat #1 is the button
Seat 1: glenn.vaughan ($36.65 in chips) 
Seat 2: reggiedogg31 ($116.83 in chips) 
Seat 3: river plate9 ($43.61 in chips) 
Seat 4: hames_tj ($25.14 in chips) 
Seat 5: Pardaroxon ($48.81 in chips) 
Seat 6: SantiagoWeight ($54.16 in chips) 
reggiedogg31: posts small blind $0.10
river plate9: posts big blind $0.25
*** HOLE CARDS ***
Dealt to SantiagoWeight [6c Js]
hames_tj: folds 
Pardaroxon: folds 
SantiagoWeight: folds 
glenn.vaughan: calls $0.25
reggiedogg31: calls $0.15
river plate9: raises $0.75 to $1
glenn.vaughan: calls $0.75
reggiedogg31: calls $0.75
*** FLOP *** [Qs 6s Jd]
reggiedogg31: checks 
river plate9: bets $2.50
glenn.vaughan: calls $2.50
reggiedogg31: folds 
*** TURN *** [Qs 6s Jd] [5s]
river plate9: checks 
glenn.vaughan: bets $3.75
river plate9: folds 
Uncalled bet ($3.75) returned to glenn.vaughan
glenn.vaughan collected $7.64 from pot
glenn.vaughan: doesn't show hand 
*** SUMMARY ***
Total pot $8 | Rake $0.36 
Board [Qs 6s Jd 5s]
Seat 1: glenn.vaughan (button) collected ($7.64)
Seat 2: reggiedogg31 (small blind) folded on the Flop
Seat 3: river plate9 (big blind) folded on the Turn
Seat 4: hames_tj folded before Flop (didn't bet)
Seat 5: Pardaroxon folded before Flop (didn't bet)
Seat 6: SantiagoWeight folded before Flop (didn't bet)



PokerStars Zoom Hand #195024670509:  Hold'em No Limit ($0.10/$0.25) - 2018/12/29 4:50:07 UTC [2018/12/28 23:50:07 ET]
Table 'Hydra' 6-max Seat #1 is the button
Seat 1: SantiagoWeight ($53.91 in chips) 
Seat 2: Rika_run ($25.45 in chips) 
Seat 3: Becks Baker ($28.81 in chips) 
Seat 4: Pardaroxon ($48.46 in chips) 
Seat 5: islam1328 ($22.57 in chips) 
Seat 6: Virus3232 ($27.67 in chips) 
Rika_run: posts small blind $0.10
Becks Baker: posts big blind $0.25
*** HOLE CARDS ***
Dealt to SantiagoWeight [8c 7s]
Pardaroxon: raises $0.50 to $0.75
islam1328: calls $0.75
Virus3232: folds 
SantiagoWeight: folds 
Rika_run: folds 
Becks Baker: folds 
*** FLOP *** [2h 5s 7h]
Pardaroxon: bets $1.06
islam1328: folds 
Uncalled bet ($1.06) returned to Pardaroxon
Pardaroxon collected $1.77 from pot
Pardaroxon: doesn't show hand 
*** SUMMARY ***
Total pot $1.85 | Rake $0.08 
Board [2h 5s 7h]
Seat 1: SantiagoWeight (button) folded before Flop (didn't bet)
Seat 2: Rika_run (small blind) folded before Flop
Seat 3: Becks Baker (big blind) folded before Flop
Seat 4: Pardaroxon collected ($1.77)
Seat 5: islam1328 folded on the Flop
Seat 6: Virus3232 folded before Flop (didn't bet)



PokerStars Zoom Hand #195024675031:  Hold'em No Limit ($0.10/$0.25) - 2018/12/29 4:50:24 UTC [2018/12/28 23:50:24 ET]
Table 'Hydra' 6-max Seat #1 is the button
Seat 1: newbieforce ($22.96 in chips) 
Seat 2: SantiagoWeight ($53.91 in chips) 
Seat 3: !P0K3RM3T4L! ($29.57 in chips) 
Seat 4: Becks Baker ($28.56 in chips) 
Seat 5: LastNoma ($26.25 in chips) 
Seat 6: Bonen18 ($94.12 in chips) 
SantiagoWeight: posts small blind $0.10
!P0K3RM3T4L!: posts big blind $0.25
*** HOLE CARDS ***
Dealt to SantiagoWeight [8s 8h]
Becks Baker: folds 
LastNoma: folds 
Bonen18: folds 
newbieforce: folds 
SantiagoWeight: raises $0.50 to $0.75
!P0K3RM3T4L!: calls $0.50
*** FLOP *** [4s 3d 3h]
SantiagoWeight: bets $0.36
!P0K3RM3T4L!: calls $0.36
*** TURN *** [4s 3d 3h] [Td]
SantiagoWeight: bets $1.20
!P0K3RM3T4L!: calls $1.20
*** RIVER *** [4s 3d 3h Td] [Kd]
SantiagoWeight: checks 
!P0K3RM3T4L!: checks 
*** SHOW DOWN ***
SantiagoWeight: shows [8s 8h] (two pair, Eights and Threes)
!P0K3RM3T4L!: mucks hand 
SantiagoWeight collected $4.41 from pot
*** SUMMARY ***
Total pot $4.62 | Rake $0.21 
Board [4s 3d 3h Td Kd]
Seat 1: newbieforce (button) folded before Flop (didn't bet)
Seat 2: SantiagoWeight (small blind) showed [8s 8h] and won ($4.41) with two pair, Eights and Threes
Seat 3: !P0K3RM3T4L! (big blind) mucked [As 7d]
Seat 4: Becks Baker folded before Flop (didn't bet)
Seat 5: LastNoma folded before Flop (didn't bet)
Seat 6: Bonen18 folded before Flop (didn't bet)



PokerStars Zoom Hand #195024692286:  Hold'em No Limit ($0.10/$0.25) - 2018/12/29 4:51:29 UTC [2018/12/28 23:51:29 ET]
Table 'Hydra' 6-max Seat #1 is the button
Seat 1: abbi555 ($43.61 in chips) 
Seat 2: !P0K3RM3T4L! ($27.26 in chips) 
Seat 3: xXBossHossXx ($87.79 in chips) 
Seat 4: SantiagoWeight ($56.01 in chips) 
Seat 5: RoccoQc10 ($19.61 in chips) 
Seat 6: ryanking99 ($9.66 in chips) 
!P0K3RM3T4L!: posts small blind $0.10
xXBossHossXx: posts big blind $0.25
*** HOLE CARDS ***
Dealt to SantiagoWeight [2h 7c]
SantiagoWeight has timed out
SantiagoWeight: folds 
RoccoQc10: folds 
ryanking99: folds 
abbi555: folds 
!P0K3RM3T4L!: raises $0.35 to $0.60
xXBossHossXx: folds 
Uncalled bet ($0.35) returned to !P0K3RM3T4L!
!P0K3RM3T4L! collected $0.50 from pot
!P0K3RM3T4L!: doesn't show hand 
*** SUMMARY ***
Total pot $0.50 | Rake $0 
Seat 1: abbi555 (button) folded before Flop (didn't bet)
Seat 2: !P0K3RM3T4L! (small blind) collected ($0.50)
Seat 3: xXBossHossXx (big blind) folded before Flop
Seat 4: SantiagoWeight folded before Flop (didn't bet)
Seat 5: RoccoQc10 folded before Flop (didn't bet)
Seat 6: ryanking99 folded before Flop (didn't bet)



PokerStars Zoom Hand #195024701734:  Hold'em No Limit ($0.10/$0.25) - 2018/12/29 4:52:05 UTC [2018/12/28 23:52:05 ET]
Table 'Hydra' 6-max Seat #1 is the button
Seat 1: lauriña77 ($37.41 in chips) 
Seat 2: allin969 ($56.52 in chips) 
Seat 3: bengx2 ($25 in chips) 
Seat 4: dk dreadlook ($36.01 in chips) 
Seat 5: JeDti ($25.51 in chips) 
Seat 6: SantiagoWeight ($56.01 in chips) 
allin969: posts small blind $0.10
bengx2: posts big blind $0.25
*** HOLE CARDS ***
Dealt to SantiagoWeight [3d Qh]
dk dreadlook: folds 
JeDti: folds 
SantiagoWeight: folds 
lauriña77: folds 
allin969: folds 
Uncalled bet ($0.15) returned to bengx2
bengx2 collected $0.20 from pot
bengx2: doesn't show hand 
*** SUMMARY ***
Total pot $0.20 | Rake $0 
Seat 1: lauriña77 (button) folded before Flop (didn't bet)
Seat 2: allin969 (small blind) folded before Flop
Seat 3: bengx2 (big blind) collected ($0.20)
Seat 4: dk dreadlook folded before Flop (didn't bet)
Seat 5: JeDti folded before Flop (didn't bet)
Seat 6: SantiagoWeight folded before Flop (didn't bet)



PokerStars Zoom Hand #195024703571:  Hold'em No Limit ($0.10/$0.25) - 2018/12/29 4:52:12 UTC [2018/12/28 23:52:12 ET]
Table 'Hydra' 6-max Seat #1 is the button
Seat 1: hames_tj ($30.06 in chips) 
Seat 2: SantiagoWeight ($56.01 in chips) 
Seat 3: Gonzalit0o ($59.88 in chips) 
Seat 4: koichi1210 ($19.50 in chips) 
Seat 5: glenn.vaughan ($40.44 in chips) 
Seat 6: cheolbeom ($28.89 in chips) 
SantiagoWeight: posts small blind $0.10
Gonzalit0o: posts big blind $0.25
*** HOLE CARDS ***
Dealt to SantiagoWeight [4c 7d]
koichi1210: folds 
glenn.vaughan: calls $0.25
cheolbeom: folds 
hames_tj: folds 
SantiagoWeight: folds 
Gonzalit0o: raises $1 to $1.25
glenn.vaughan: folds 
Uncalled bet ($1) returned to Gonzalit0o
Gonzalit0o collected $0.60 from pot
Gonzalit0o: doesn't show hand 
*** SUMMARY ***
Total pot $0.60 | Rake $0 
Seat 1: hames_tj (button) folded before Flop (didn't bet)
Seat 2: SantiagoWeight (small blind) folded before Flop
Seat 3: Gonzalit0o (big blind) collected ($0.60)
Seat 4: koichi1210 folded before Flop (didn't bet)
Seat 5: glenn.vaughan folded before Flop
Seat 6: cheolbeom folded before Flop (didn't bet)



PokerStars Zoom Hand #195024707446:  Hold'em No Limit ($0.10/$0.25) - 2018/12/29 4:52:27 UTC [2018/12/28 23:52:27 ET]
Table 'Hydra' 6-max Seat #1 is the button
Seat 1: JeDti ($25.26 in chips) 
Seat 2: GQwang ($37.95 in chips) 
Seat 3: SantiagoWeight ($55.91 in chips) 
Seat 4: TQNYMQNTANA ($53.97 in chips) 
Seat 5: xman141 ($93.30 in chips) 
Seat 6: Lehared ($28.59 in chips) 
GQwang: posts small blind $0.10
SantiagoWeight: posts big blind $0.25
*** HOLE CARDS ***
Dealt to SantiagoWeight [Qd 9h]
TQNYMQNTANA: folds 
xman141: folds 
Lehared: raises $0.37 to $0.62
JeDti: folds 
GQwang: folds 
SantiagoWeight: folds 
Uncalled bet ($0.37) returned to Lehared
Lehared collected $0.60 from pot
*** SUMMARY ***
Total pot $0.60 | Rake $0 
Seat 1: JeDti (button) folded before Flop (didn't bet)
Seat 2: GQwang (small blind) folded before Flop
Seat 3: SantiagoWeight (big blind) folded before Flop
Seat 4: TQNYMQNTANA folded before Flop (didn't bet)
Seat 5: xman141 folded before Flop (didn't bet)
Seat 6: Lehared collected ($0.60)



PokerStars Zoom Hand #195024705388:  Hold'em No Limit ($0.10/$0.25) - 2018/12/29 4:52:19 UTC [2018/12/28 23:52:19 ET]
Table 'Hydra' 6-max Seat #1 is the button
Seat 1: cheolbeom ($28.89 in chips) 
Seat 2: xonegab ($24.32 in chips) 
Seat 3: dawwwid70 ($27.34 in chips) 
Seat 4: olegator333 ($24.55 in chips) 
Seat 5: SantiagoWeight ($55.91 in chips) 
Seat 6: Rika_run ($25 in chips) 
xonegab: posts small blind $0.10
dawwwid70: posts big blind $0.25
*** HOLE CARDS ***
Dealt to SantiagoWeight [8d Jd]
olegator333: folds 
SantiagoWeight: folds 
Rika_run: raises $0.32 to $0.57
cheolbeom: folds 
xonegab: calls $0.47
dawwwid70: folds 
*** FLOP *** [Ts 5d Ah]
xonegab: bets $0.25
Rika_run: calls $0.25
*** TURN *** [Ts 5d Ah] [Ac]
xonegab: bets $0.25
Rika_run: calls $0.25
*** RIVER *** [Ts 5d Ah Ac] [6s]
xonegab: bets $0.25
Rika_run: raises $1.55 to $1.80
xonegab: calls $1.55
*** SHOW DOWN ***
Rika_run: shows [Qs Qh] (two pair, Aces and Queens)
xonegab: mucks hand 
Rika_run collected $5.72 from pot
*** SUMMARY ***
Total pot $5.99 | Rake $0.27 
Board [Ts 5d Ah Ac 6s]
Seat 1: cheolbeom (button) folded before Flop (didn't bet)
Seat 2: xonegab (small blind) mucked [Th 5h]
Seat 3: dawwwid70 (big blind) folded before Flop
Seat 4: olegator333 folded before Flop (didn't bet)
Seat 5: SantiagoWeight folded before Flop (didn't bet)
Seat 6: Rika_run showed [Qs Qh] and won ($5.72) with two pair, Aces and Queens



PokerStars Zoom Hand #195024711138:  Hold'em No Limit ($0.10/$0.25) - 2018/12/29 4:52:41 UTC [2018/12/28 23:52:41 ET]
Table 'Hydra' 6-max Seat #1 is the button
Seat 1: _BluDeeN_ ($22.05 in chips) 
Seat 2: TQNYMQNTANA ($25 in chips) 
Seat 3: ivann14 ($41.50 in chips) 
Seat 4: JeDti ($25.26 in chips) 
Seat 5: SantiagoWeight ($55.66 in chips) 
Seat 6: abbi555 ($43.26 in chips) 
TQNYMQNTANA: posts small blind $0.10
ivann14: posts big blind $0.25
*** HOLE CARDS ***
Dealt to SantiagoWeight [2h 7d]
JeDti: folds 
SantiagoWeight: folds 
abbi555: calls $0.25
_BluDeeN_: folds 
TQNYMQNTANA: folds 
ivann14: checks 
*** FLOP *** [3c 5c 3d]
ivann14: checks 
abbi555: checks 
*** TURN *** [3c 5c 3d] [Ah]
ivann14: checks 
abbi555: checks 
*** RIVER *** [3c 5c 3d Ah] [9h]
ivann14: checks 
abbi555: bets $0.75
ivann14: folds 
Uncalled bet ($0.75) returned to abbi555
abbi555 collected $0.57 from pot
abbi555: doesn't show hand 
*** SUMMARY ***
Total pot $0.60 | Rake $0.03 
Board [3c 5c 3d Ah 9h]
Seat 1: _BluDeeN_ (button) folded before Flop (didn't bet)
Seat 2: TQNYMQNTANA (small blind) folded before Flop
Seat 3: ivann14 (big blind) folded on the River
Seat 4: JeDti folded before Flop (didn't bet)
Seat 5: SantiagoWeight folded before Flop (didn't bet)
Seat 6: abbi555 collected ($0.57)



PokerStars Zoom Hand #195024712689:  Hold'em No Limit ($0.10/$0.25) - 2018/12/29 4:52:47 UTC [2018/12/28 23:52:47 ET]
Table 'Hydra' 6-max Seat #1 is the button
Seat 1: SantiagoWeight ($55.66 in chips) 
Seat 2: labattblu ($15.82 in chips) 
Seat 3: !P0K3RM3T4L! ($29.46 in chips) 
Seat 4: TQNYMQNTANA ($25 in chips) 
Seat 5: asapon ($34.56 in chips) 
Seat 6: know you cry ($5.50 in chips) 
labattblu: posts small blind $0.10
!P0K3RM3T4L!: posts big blind $0.25
*** HOLE CARDS ***
Dealt to SantiagoWeight [As 2c]
TQNYMQNTANA: folds 
asapon: folds 
know you cry: folds 
SantiagoWeight: raises $0.30 to $0.55
labattblu: folds 
!P0K3RM3T4L!: calls $0.30
*** FLOP *** [Tc Js 7c]
!P0K3RM3T4L!: checks 
SantiagoWeight: checks 
*** TURN *** [Tc Js 7c] [6h]
!P0K3RM3T4L!: checks 
SantiagoWeight: checks 
*** RIVER *** [Tc Js 7c 6h] [9d]
!P0K3RM3T4L!: checks 
SantiagoWeight: bets $0.80
!P0K3RM3T4L!: folds 
Uncalled bet ($0.80) returned to SantiagoWeight
SantiagoWeight collected $1.15 from pot
SantiagoWeight: doesn't show hand 
*** SUMMARY ***
Total pot $1.20 | Rake $0.05 
Board [Tc Js 7c 6h 9d]
Seat 1: SantiagoWeight (button) collected ($1.15)
Seat 2: labattblu (small blind) folded before Flop
Seat 3: !P0K3RM3T4L! (big blind) folded on the River
Seat 4: TQNYMQNTANA folded before Flop (didn't bet)
Seat 5: asapon folded before Flop (didn't bet)
Seat 6: know you cry folded before Flop (didn't bet)



PokerStars Zoom Hand #195024730655:  Hold'em No Limit ($0.10/$0.25) - 2018/12/29 4:53:56 UTC [2018/12/28 23:53:56 ET]
Table 'Hydra' 6-max Seat #1 is the button
Seat 1: SpaZz0205 ($19.20 in chips) 
Seat 2: deaglepro ($56.40 in chips) 
Seat 3: MoMoney2612 ($25.75 in chips) 
Seat 4: chinaed ($22.97 in chips) 
Seat 5: mariopork ($25 in chips) 
Seat 6: SantiagoWeight ($56.26 in chips) 
deaglepro: posts small blind $0.10
MoMoney2612: posts big blind $0.25
*** HOLE CARDS ***
Dealt to SantiagoWeight [4c 3d]
chinaed: raises $0.50 to $0.75
mariopork: folds 
SantiagoWeight: folds 
SpaZz0205: calls $0.75
deaglepro: folds 
MoMoney2612: folds 
*** FLOP *** [6s 9c Qh]
chinaed: checks 
SpaZz0205: bets $1
chinaed: calls $1
*** TURN *** [6s 9c Qh] [Ac]
chinaed: checks 
SpaZz0205: bets $1.75
chinaed: folds 
Uncalled bet ($1.75) returned to SpaZz0205
SpaZz0205 collected $3.68 from pot
SpaZz0205: doesn't show hand 
*** SUMMARY ***
Total pot $3.85 | Rake $0.17 
Board [6s 9c Qh Ac]
Seat 1: SpaZz0205 (button) collected ($3.68)
Seat 2: deaglepro (small blind) folded before Flop
Seat 3: MoMoney2612 (big blind) folded before Flop
Seat 4: chinaed folded on the Turn
Seat 5: mariopork folded before Flop (didn't bet)
Seat 6: SantiagoWeight folded before Flop (didn't bet)



PokerStars Zoom Hand #195024745526:  Hold'em No Limit ($0.10/$0.25) - 2018/12/29 4:54:53 UTC [2018/12/28 23:54:53 ET]
Table 'Hydra' 6-max Seat #1 is the button
Seat 1: allin969 ($55.93 in chips) 
Seat 2: SantiagoWeight ($56.01 in chips) 
Seat 3: asapon ($34.56 in chips) 
Seat 4: call me??107 ($17.33 in chips) 
Seat 5: zdenekstavic ($58.53 in chips) 
Seat 6: Virus3232 ($27.86 in chips) 
SantiagoWeight: posts small blind $0.10
asapon: posts big blind $0.25
*** HOLE CARDS ***
Dealt to SantiagoWeight [5h 9c]
call me??107: folds 
zdenekstavic: folds 
Virus3232: folds 
allin969: raises $0.60 to $0.85
SantiagoWeight: folds 
asapon: folds 
Uncalled bet ($0.60) returned to allin969
allin969 collected $0.60 from pot
allin969: doesn't show hand 
*** SUMMARY ***
Total pot $0.60 | Rake $0 
Seat 1: allin969 (button) collected ($0.60)
Seat 2: SantiagoWeight (small blind) folded before Flop
Seat 3: asapon (big blind) folded before Flop
Seat 4: call me??107 folded before Flop (didn't bet)
Seat 5: zdenekstavic folded before Flop (didn't bet)
Seat 6: Virus3232 folded before Flop (didn't bet)



PokerStars Zoom Hand #195024749190:  Hold'em No Limit ($0.10/$0.25) - 2018/12/29 4:55:07 UTC [2018/12/28 23:55:07 ET]
Table 'Hydra' 6-max Seat #1 is the button
Seat 1: Gonzalit0o ($74.23 in chips) 
Seat 2: Pardaroxon ($69.72 in chips) 
Seat 3: doza123 ($8.33 in chips) 
Seat 4: dawwwid70 ($27.36 in chips) 
Seat 5: SantiagoWeight ($55.91 in chips) 
Seat 6: Papaya006 ($25 in chips) 
Pardaroxon: posts small blind $0.10
doza123: posts big blind $0.25
*** HOLE CARDS ***
Dealt to SantiagoWeight [7c 8s]
dawwwid70: folds 
SantiagoWeight: folds 
Papaya006: raises $0.50 to $0.75
Gonzalit0o: folds 
Pardaroxon: raises $1.75 to $2.50
doza123: folds 
Papaya006: folds 
Uncalled bet ($1.75) returned to Pardaroxon
Pardaroxon collected $1.75 from pot
Pardaroxon: doesn't show hand 
*** SUMMARY ***
Total pot $1.75 | Rake $0 
Seat 1: Gonzalit0o (button) folded before Flop (didn't bet)
Seat 2: Pardaroxon (small blind) collected ($1.75)
Seat 3: doza123 (big blind) folded before Flop
Seat 4: dawwwid70 folded before Flop (didn't bet)
Seat 5: SantiagoWeight folded before Flop (didn't bet)
Seat 6: Papaya006 folded before Flop



PokerStars Zoom Hand #195024736184:  Hold'em No Limit ($0.10/$0.25) - 2018/12/29 4:54:17 UTC [2018/12/28 23:54:17 ET]
Table 'Hydra' 6-max Seat #1 is the button
Seat 1: ttshead ($73.87 in chips) 
Seat 2: Thermal0007 ($18.07 in chips) 
Seat 3: SantiagoWeight ($56.26 in chips) 
Seat 4: louiskitu ($15.08 in chips) 
Seat 5: Becks Baker ($13.38 in chips) 
Seat 6: _BluDeeN_ ($52.52 in chips) 
Thermal0007: posts small blind $0.10
SantiagoWeight: posts big blind $0.25
*** HOLE CARDS ***
Dealt to SantiagoWeight [Tc Ad]
louiskitu: folds 
Becks Baker: folds 
_BluDeeN_: raises $0.50 to $0.75
ttshead: folds 
Thermal0007: calls $0.65
SantiagoWeight: folds 
*** FLOP *** [8s 3c Ks]
Thermal0007: checks 
_BluDeeN_: bets $1.25
Thermal0007: raises $1.50 to $2.75
_BluDeeN_: calls $1.50
*** TURN *** [8s 3c Ks] [Ac]
Thermal0007: bets $3.46
_BluDeeN_: raises $45.56 to $49.02 and is all-in
Thermal0007: calls $11.11 and is all-in
Uncalled bet ($34.45) returned to _BluDeeN_
*** RIVER *** [8s 3c Ks Ac] [3s]
*** SHOW DOWN ***
Thermal0007: shows [Ah Kh] (two pair, Aces and Kings)
_BluDeeN_: shows [Jh As] (two pair, Aces and Threes)
Thermal0007 collected $34.75 from pot
*** SUMMARY ***
Total pot $36.39 | Rake $1.64 
Board [8s 3c Ks Ac 3s]
Seat 1: ttshead (button) folded before Flop (didn't bet)
Seat 2: Thermal0007 (small blind) showed [Ah Kh] and won ($34.75) with two pair, Aces and Kings
Seat 3: SantiagoWeight (big blind) folded before Flop
Seat 4: louiskitu folded before Flop (didn't bet)
Seat 5: Becks Baker folded before Flop (didn't bet)
Seat 6: _BluDeeN_ showed [Jh As] and lost with two pair, Aces and Threes



PokerStars Zoom Hand #195024751099:  Hold'em No Limit ($0.10/$0.25) - 2018/12/29 4:55:15 UTC [2018/12/28 23:55:15 ET]
Table 'Hydra' 6-max Seat #1 is the button
Seat 1: Papaya006 ($25 in chips) 
Seat 2: JeDti ($33.14 in chips) 
Seat 3: SantiagoWeight ($55.91 in chips) 
Seat 4: mchiefaakk ($7.91 in chips) 
Seat 5: LastNoma ($28.07 in chips) 
Seat 6: !P0K3RM3T4L! ($25 in chips) 
JeDti: posts small blind $0.10
SantiagoWeight: posts big blind $0.25
*** HOLE CARDS ***
Dealt to SantiagoWeight [Ah 3d]
mchiefaakk: folds 
LastNoma: folds 
!P0K3RM3T4L!: folds 
Papaya006: folds 
JeDti: raises $0.30 to $0.55
SantiagoWeight: calls $0.30
*** FLOP *** [Kh 9c Js]
JeDti: checks 
SantiagoWeight: checks 
*** TURN *** [Kh 9c Js] [6d]
JeDti: bets $0.63
SantiagoWeight: folds 
Uncalled bet ($0.63) returned to JeDti
JeDti collected $1.05 from pot
JeDti: doesn't show hand 
*** SUMMARY ***
Total pot $1.10 | Rake $0.05 
Board [Kh 9c Js 6d]
Seat 1: Papaya006 (button) folded before Flop (didn't bet)
Seat 2: JeDti (small blind) collected ($1.05)
Seat 3: SantiagoWeight (big blind) folded on the Turn
Seat 4: mchiefaakk folded before Flop (didn't bet)
Seat 5: LastNoma folded before Flop (didn't bet)
Seat 6: !P0K3RM3T4L! folded before Flop (didn't bet)



PokerStars Zoom Hand #195024764372:  Hold'em No Limit ($0.10/$0.25) - 2018/12/29 4:56:12 UTC [2018/12/28 23:56:12 ET]
Table 'Hydra' 6-max Seat #1 is the button
Seat 1: SantiagoWeight ($55.36 in chips) 
Seat 2: saneeek86 ($24.53 in chips) 
Seat 3: deaglepro ($55.07 in chips) 
Seat 4: call me??107 ($19.84 in chips) 
Seat 5: JeDti ($33.64 in chips) 
Seat 6: 905steelcity ($9.60 in chips) 
saneeek86: posts small blind $0.10
deaglepro: posts big blind $0.25
*** HOLE CARDS ***
Dealt to SantiagoWeight [Jh 6s]
call me??107: raises $0.75 to $1
JeDti: folds 
905steelcity: folds 
SantiagoWeight: folds 
saneeek86: folds 
deaglepro: folds 
Uncalled bet ($0.75) returned to call me??107
call me??107 collected $0.60 from pot
call me??107: doesn't show hand 
*** SUMMARY ***
Total pot $0.60 | Rake $0 
Seat 1: SantiagoWeight (button) folded before Flop (didn't bet)
Seat 2: saneeek86 (small blind) folded before Flop
Seat 3: deaglepro (big blind) folded before Flop
Seat 4: call me??107 collected ($0.60)
Seat 5: JeDti folded before Flop (didn't bet)
Seat 6: 905steelcity folded before Flop (didn't bet)



PokerStars Zoom Hand #195024769969:  Hold'em No Limit ($0.10/$0.25) - 2018/12/29 4:56:36 UTC [2018/12/28 23:56:36 ET]
Table 'Hydra' 6-max Seat #1 is the button
Seat 1: zaneti8722 ($13.12 in chips) 
Seat 2: Papaya006 ($26.94 in chips) 
Seat 3: KAOS914 ($36.45 in chips) 
Seat 4: TQNYMQNTANA ($48.25 in chips) 
Seat 5: ivann14 ($51.78 in chips) 
Seat 6: SantiagoWeight ($55.36 in chips) 
Papaya006: posts small blind $0.10
KAOS914: posts big blind $0.25
*** HOLE CARDS ***
Dealt to SantiagoWeight [5d 8d]
TQNYMQNTANA: folds 
ivann14: folds 
SantiagoWeight: folds 
zaneti8722: folds 
Papaya006: folds 
Uncalled bet ($0.15) returned to KAOS914
KAOS914 collected $0.20 from pot
KAOS914: doesn't show hand 
*** SUMMARY ***
Total pot $0.20 | Rake $0 
Seat 1: zaneti8722 (button) folded before Flop (didn't bet)
Seat 2: Papaya006 (small blind) folded before Flop
Seat 3: KAOS914 (big blind) collected ($0.20)
Seat 4: TQNYMQNTANA folded before Flop (didn't bet)
Seat 5: ivann14 folded before Flop (didn't bet)
Seat 6: SantiagoWeight folded before Flop (didn't bet)



PokerStars Zoom Hand #195024767858:  Hold'em No Limit ($0.10/$0.25) - 2018/12/29 4:56:27 UTC [2018/12/28 23:56:27 ET]
Table 'Hydra' 6-max Seat #1 is the button
Seat 1: ryanking99 ($51.26 in chips) 
Seat 2: MoMoney2612 ($29.38 in chips) 
Seat 3: LastNoma ($25 in chips) 
Seat 4: SantiagoWeight ($55.36 in chips) 
Seat 5: KAOS914 ($36.45 in chips) 
Seat 6: trillerGTO ($22.11 in chips) 
MoMoney2612: posts small blind $0.10
LastNoma: posts big blind $0.25
*** HOLE CARDS ***
Dealt to SantiagoWeight [3h Ts]
SantiagoWeight: folds 
KAOS914: folds 
trillerGTO: folds 
ryanking99: folds 
MoMoney2612: raises $0.50 to $0.75
LastNoma: raises $2.15 to $2.90
MoMoney2612: folds 
Uncalled bet ($2.15) returned to LastNoma
LastNoma collected $1.50 from pot
LastNoma: doesn't show hand 
*** SUMMARY ***
Total pot $1.50 | Rake $0 
Seat 1: ryanking99 (button) folded before Flop (didn't bet)
Seat 2: MoMoney2612 (small blind) folded before Flop
Seat 3: LastNoma (big blind) collected ($1.50)
Seat 4: SantiagoWeight folded before Flop (didn't bet)
Seat 5: KAOS914 folded before Flop (didn't bet)
Seat 6: trillerGTO folded before Flop (didn't bet)



PokerStars Zoom Hand #195024772974:  Hold'em No Limit ($0.10/$0.25) - 2018/12/29 4:56:49 UTC [2018/12/28 23:56:49 ET]
Table 'Hydra' 6-max Seat #1 is the button
Seat 1: Rika_run ($30.51 in chips) 
Seat 2: SantiagoWeight ($55.36 in chips) 
Seat 3: Higashi2314 ($26.54 in chips) 
Seat 4: Vilen1689 ($25 in chips) 
Seat 5: _BluDeeN_ ($20.75 in chips) 
Seat 6: LastNoma ($48.28 in chips) 
SantiagoWeight: posts small blind $0.10
Higashi2314: posts big blind $0.25
*** HOLE CARDS ***
Dealt to SantiagoWeight [9c 6c]
Vilen1689: folds 
_BluDeeN_: raises $0.50 to $0.75
LastNoma: raises $1.85 to $2.60
Rika_run: folds 
SantiagoWeight: folds 
Higashi2314: folds 
_BluDeeN_: folds 
Uncalled bet ($1.85) returned to LastNoma
LastNoma collected $1.85 from pot
LastNoma: doesn't show hand 
*** SUMMARY ***
Total pot $1.85 | Rake $0 
Seat 1: Rika_run (button) folded before Flop (didn't bet)
Seat 2: SantiagoWeight (small blind) folded before Flop
Seat 3: Higashi2314 (big blind) folded before Flop
Seat 4: Vilen1689 folded before Flop (didn't bet)
Seat 5: _BluDeeN_ folded before Flop
Seat 6: LastNoma collected ($1.85)



PokerStars Zoom Hand #195024778972:  Hold'em No Limit ($0.10/$0.25) - 2018/12/29 4:57:15 UTC [2018/12/28 23:57:15 ET]
Table 'Hydra' 6-max Seat #1 is the button
Seat 1: t57571245 ($30.34 in chips) 
Seat 2: winwinboy ($25.10 in chips) 
Seat 3: SantiagoWeight ($55.26 in chips) 
Seat 4: IMMPORT@L ($17.69 in chips) 
Seat 5: Virus3232 ($32.07 in chips) 
Seat 6: hames_tj ($26.51 in chips) 
winwinboy: posts small blind $0.10
SantiagoWeight: posts big blind $0.25
*** HOLE CARDS ***
Dealt to SantiagoWeight [3h 5c]
IMMPORT@L: folds 
Virus3232: folds 
hames_tj: folds 
t57571245: raises $0.50 to $0.75
winwinboy: folds 
SantiagoWeight: folds 
Uncalled bet ($0.50) returned to t57571245
t57571245 collected $0.60 from pot
*** SUMMARY ***
Total pot $0.60 | Rake $0 
Seat 1: t57571245 (button) collected ($0.60)
Seat 2: winwinboy (small blind) folded before Flop
Seat 3: SantiagoWeight (big blind) folded before Flop
Seat 4: IMMPORT@L folded before Flop (didn't bet)
Seat 5: Virus3232 folded before Flop (didn't bet)
Seat 6: hames_tj folded before Flop (didn't bet)



PokerStars Zoom Hand #195024782365:  Hold'em No Limit ($0.10/$0.25) - 2018/12/29 4:57:29 UTC [2018/12/28 23:57:29 ET]
Table 'Hydra' 6-max Seat #1 is the button
Seat 1: hames_tj ($28.31 in chips) 
Seat 2: ttshead ($77.89 in chips) 
Seat 3: cheolbeom ($25.60 in chips) 
Seat 4: trillerGTO ($22.36 in chips) 
Seat 5: SantiagoWeight ($55.01 in chips) 
Seat 6: asapon ($25.35 in chips) 
ttshead: posts small blind $0.10
cheolbeom: posts big blind $0.25
*** HOLE CARDS ***
Dealt to SantiagoWeight [4s Jc]
trillerGTO: folds 
SantiagoWeight: folds 
asapon: folds 
hames_tj: folds 
ttshead: folds 
Uncalled bet ($0.15) returned to cheolbeom
cheolbeom collected $0.20 from pot
cheolbeom: doesn't show hand 
*** SUMMARY ***
Total pot $0.20 | Rake $0 
Seat 1: hames_tj (button) folded before Flop (didn't bet)
Seat 2: ttshead (small blind) folded before Flop
Seat 3: cheolbeom (big blind) collected ($0.20)
Seat 4: trillerGTO folded before Flop (didn't bet)
Seat 5: SantiagoWeight folded before Flop (didn't bet)
Seat 6: asapon folded before Flop (didn't bet)



PokerStars Zoom Hand #195024777873:  Hold'em No Limit ($0.10/$0.25) - 2018/12/29 4:57:10 UTC [2018/12/28 23:57:10 ET]
Table 'Hydra' 6-max Seat #1 is the button
Seat 1: TQNYMQNTANA ($33.23 in chips) 
Seat 2: ryanking99 ($50.01 in chips) 
Seat 3: Virus3232 ($25.35 in chips) 
Seat 4: SantiagoWeight ($55.26 in chips) 
Seat 5: Rika_run ($30.04 in chips) 
Seat 6: KAOS914 ($36.45 in chips) 
ryanking99: posts small blind $0.10
Virus3232: posts big blind $0.25
*** HOLE CARDS ***
Dealt to SantiagoWeight [5c Th]
SantiagoWeight: folds 
Rika_run: folds 
KAOS914: folds 
TQNYMQNTANA: folds 
ryanking99: raises $0.50 to $0.75
Virus3232: raises $1.50 to $2.25
ryanking99: calls $1.50
*** FLOP *** [Qh Kc 2c]
ryanking99: bets $2.28
Virus3232: calls $2.28
*** TURN *** [Qh Kc 2c] [7s]
ryanking99: checks 
Virus3232: bets $5
ryanking99: folds 
Uncalled bet ($5) returned to Virus3232
Virus3232 collected $8.65 from pot
Virus3232: doesn't show hand 
*** SUMMARY ***
Total pot $9.06 | Rake $0.41 
Board [Qh Kc 2c 7s]
Seat 1: TQNYMQNTANA (button) folded before Flop (didn't bet)
Seat 2: ryanking99 (small blind) folded on the Turn
Seat 3: Virus3232 (big blind) collected ($8.65)
Seat 4: SantiagoWeight folded before Flop (didn't bet)
Seat 5: Rika_run folded before Flop (didn't bet)
Seat 6: KAOS914 folded before Flop (didn't bet)



PokerStars Zoom Hand #195024783308:  Hold'em No Limit ($0.10/$0.25) - 2018/12/29 4:57:33 UTC [2018/12/28 23:57:33 ET]
Table 'Hydra' 6-max Seat #1 is the button
Seat 1: Becks Baker ($25.10 in chips) 
Seat 2: bigpower629 ($25 in chips) 
Seat 3: Rika_run ($54.11 in chips) 
Seat 4: SantiagoWeight ($55.01 in chips) 
Seat 5: Higashi2314 ($26.19 in chips) 
Seat 6: hames_tj ($28.31 in chips) 
bigpower629: posts small blind $0.10
Rika_run: posts big blind $0.25
*** HOLE CARDS ***
Dealt to SantiagoWeight [Ks 2h]
SantiagoWeight: folds 
Higashi2314: folds 
hames_tj: folds 
Becks Baker: raises $0.37 to $0.62
bigpower629: folds 
Rika_run: folds 
Uncalled bet ($0.37) returned to Becks Baker
Becks Baker collected $0.60 from pot
Becks Baker: doesn't show hand 
*** SUMMARY ***
Total pot $0.60 | Rake $0 
Seat 1: Becks Baker (button) collected ($0.60)
Seat 2: bigpower629 (small blind) folded before Flop
Seat 3: Rika_run (big blind) folded before Flop
Seat 4: SantiagoWeight folded before Flop (didn't bet)
Seat 5: Higashi2314 folded before Flop (didn't bet)
Seat 6: hames_tj folded before Flop (didn't bet)



PokerStars Zoom Hand #195024775977:  Hold'em No Limit ($0.10/$0.25) - 2018/12/29 4:57:02 UTC [2018/12/28 23:57:02 ET]
Table 'Hydra' 6-max Seat #1 is the button
Seat 1: SantiagoWeight ($55.26 in chips) 
Seat 2: t57571245 ($30.44 in chips) 
Seat 3: asapon ($25 in chips) 
Seat 4: kladde567 ($17.60 in chips) 
Seat 5: columb80 ($25 in chips) 
Seat 6: lauriña77 ($22.82 in chips) 
t57571245: posts small blind $0.10
asapon: posts big blind $0.25
*** HOLE CARDS ***
Dealt to SantiagoWeight [Td Kd]
kladde567: raises $1 to $1.25
columb80: folds 
lauriña77: raises $2.85 to $4.10
SantiagoWeight: folds 
t57571245: folds 
asapon: folds 
kladde567: calls $2.85
*** FLOP *** [8h 6c 6h]
kladde567: checks 
lauriña77: bets $2
kladde567: calls $2
*** TURN *** [8h 6c 6h] [9c]
kladde567: checks 
lauriña77: checks 
*** RIVER *** [8h 6c 6h 9c] [6s]
kladde567: bets $10.25
lauriña77: raises $6.47 to $16.72 and is all-in
kladde567: folds 
Uncalled bet ($6.47) returned to lauriña77
lauriña77 collected $31.56 from pot
lauriña77: doesn't show hand 
*** SUMMARY ***
Total pot $33.05 | Rake $1.49 
Board [8h 6c 6h 9c 6s]
Seat 1: SantiagoWeight (button) folded before Flop (didn't bet)
Seat 2: t57571245 (small blind) folded before Flop
Seat 3: asapon (big blind) folded before Flop
Seat 4: kladde567 folded on the River
Seat 5: columb80 folded before Flop (didn't bet)
Seat 6: lauriña77 collected ($31.56)



PokerStars Zoom Hand #195024784271:  Hold'em No Limit ($0.10/$0.25) - 2018/12/29 4:57:37 UTC [2018/12/28 23:57:37 ET]
Table 'Hydra' 6-max Seat #1 is the button
Seat 1: oksana12422 ($17.88 in chips) 
Seat 2: GrandmasterY ($25.55 in chips) 
Seat 3: papico3 ($25 in chips) 
Seat 4: killerB17 ($36.55 in chips) 
Seat 5: hames_tj ($28.31 in chips) 
Seat 6: SantiagoWeight ($55.01 in chips) 
GrandmasterY: posts small blind $0.10
papico3: posts big blind $0.25
*** HOLE CARDS ***
Dealt to SantiagoWeight [As Ts]
killerB17: folds 
hames_tj: folds 
SantiagoWeight: raises $0.30 to $0.55
oksana12422: folds 
GrandmasterY: calls $0.45
papico3: folds 
*** FLOP *** [Td 8d 4c]
GrandmasterY: checks 
SantiagoWeight: bets $0.86
GrandmasterY: calls $0.86
*** TURN *** [Td 8d 4c] [Js]
GrandmasterY: checks 
SantiagoWeight: checks 
*** RIVER *** [Td 8d 4c Js] [3h]
GrandmasterY: checks 
SantiagoWeight: bets $1.95
GrandmasterY: calls $1.95
*** SHOW DOWN ***
SantiagoWeight: shows [As Ts] (a pair of Tens)
GrandmasterY: mucks hand 
SantiagoWeight collected $6.66 from pot
*** SUMMARY ***
Total pot $6.97 | Rake $0.31 
Board [Td 8d 4c Js 3h]
Seat 1: oksana12422 (button) folded before Flop (didn't bet)
Seat 2: GrandmasterY (small blind) mucked [Kh Th]
Seat 3: papico3 (big blind) folded before Flop
Seat 4: killerB17 folded before Flop (didn't bet)
Seat 5: hames_tj folded before Flop (didn't bet)
Seat 6: SantiagoWeight showed [As Ts] and won ($6.66) with a pair of Tens



PokerStars Zoom Hand #195024800421:  Hold'em No Limit ($0.10/$0.25) - 2018/12/29 4:58:46 UTC [2018/12/28 23:58:46 ET]
Table 'Hydra' 6-max Seat #1 is the button
Seat 1: ivann14 ($33.08 in chips) 
Seat 2: SantiagoWeight ($58.31 in chips) 
Seat 3: Bonen18 ($94.30 in chips) 
Seat 4: amansah ($26.95 in chips) 
Seat 5: mililser ($53.95 in chips) 
Seat 6: reademenweep ($17.01 in chips) 
SantiagoWeight: posts small blind $0.10
Bonen18: posts big blind $0.25
*** HOLE CARDS ***
Dealt to SantiagoWeight [8c 4d]
amansah: folds 
mililser: folds 
reademenweep: calls $0.25
ivann14: folds 
SantiagoWeight: folds 
Bonen18: checks 
*** FLOP *** [2s 7h As]
Bonen18: checks 
reademenweep: bets $0.75
Bonen18: folds 
Uncalled bet ($0.75) returned to reademenweep
reademenweep collected $0.57 from pot
reademenweep: doesn't show hand 
*** SUMMARY ***
Total pot $0.60 | Rake $0.03 
Board [2s 7h As]
Seat 1: ivann14 (button) folded before Flop (didn't bet)
Seat 2: SantiagoWeight (small blind) folded before Flop
Seat 3: Bonen18 (big blind) folded on the Flop
Seat 4: amansah folded before Flop (didn't bet)
Seat 5: mililser folded before Flop (didn't bet)
Seat 6: reademenweep collected ($0.57)



PokerStars Zoom Hand #195024804577:  Hold'em No Limit ($0.10/$0.25) - 2018/12/29 4:59:04 UTC [2018/12/28 23:59:04 ET]
Table 'Hydra' 6-max Seat #1 is the button
Seat 1: _BluDeeN_ ($25.27 in chips) 
Seat 2: bigpower629 ($26.02 in chips) 
Seat 3: SantiagoWeight ($58.21 in chips) 
Seat 4: dawwwid70 ($25.35 in chips) 
Seat 5: Rika_run ($54.47 in chips) 
Seat 6: killerB17 ($35.95 in chips) 
bigpower629: posts small blind $0.10
SantiagoWeight: posts big blind $0.25
*** HOLE CARDS ***
Dealt to SantiagoWeight [2d 6h]
dawwwid70: folds 
Rika_run: raises $0.32 to $0.57
killerB17: folds 
_BluDeeN_: folds 
bigpower629: folds 
SantiagoWeight: folds 
Uncalled bet ($0.32) returned to Rika_run
Rika_run collected $0.60 from pot
*** SUMMARY ***
Total pot $0.60 | Rake $0 
Seat 1: _BluDeeN_ (button) folded before Flop (didn't bet)
Seat 2: bigpower629 (small blind) folded before Flop
Seat 3: SantiagoWeight (big blind) folded before Flop
Seat 4: dawwwid70 folded before Flop (didn't bet)
Seat 5: Rika_run collected ($0.60)
Seat 6: killerB17 folded before Flop (didn't bet)



PokerStars Zoom Hand #195024809912:  Hold'em No Limit ($0.10/$0.25) - 2018/12/29 4:59:27 UTC [2018/12/28 23:59:27 ET]
Table 'Hydra' 6-max Seat #1 is the button
Seat 1: SantiagoWeight ($57.96 in chips) 
Seat 2: t57571245 ($28.69 in chips) 
Seat 3: thedalbgoma ($27.35 in chips) 
Seat 4: _BluDeeN_ ($25.91 in chips) 
Seat 5: KAOS914 ($35.35 in chips) 
Seat 6: columb80 ($25 in chips) 
t57571245: posts small blind $0.10
thedalbgoma: posts big blind $0.25
*** HOLE CARDS ***
Dealt to SantiagoWeight [Qs Ac]
_BluDeeN_: folds 
KAOS914: folds 
columb80: folds 
SantiagoWeight: raises $0.30 to $0.55
t57571245: folds 
thedalbgoma: calls $0.30
*** FLOP *** [Td 5d 2c]
thedalbgoma: checks 
SantiagoWeight: bets $0.25
thedalbgoma: calls $0.25
*** TURN *** [Td 5d 2c] [4s]
thedalbgoma: checks 
SantiagoWeight: checks 
*** RIVER *** [Td 5d 2c 4s] [Jh]
thedalbgoma: checks 
SantiagoWeight: checks 
*** SHOW DOWN ***
thedalbgoma: shows [Ad 6c] (high card Ace)
SantiagoWeight: shows [Qs Ac] (high card Ace - Queen kicker)
SantiagoWeight collected $1.62 from pot
*** SUMMARY ***
Total pot $1.70 | Rake $0.08 
Board [Td 5d 2c 4s Jh]
Seat 1: SantiagoWeight (button) showed [Qs Ac] and won ($1.62) with high card Ace
Seat 2: t57571245 (small blind) folded before Flop
Seat 3: thedalbgoma (big blind) showed [Ad 6c] and lost with high card Ace
Seat 4: _BluDeeN_ folded before Flop (didn't bet)
Seat 5: KAOS914 folded before Flop (didn't bet)
Seat 6: columb80 folded before Flop (didn't bet)



