PokerStars Zoom Hand #195021954284:  Hold'em No Limit ($0.10/$0.25) - 2018/12/29 2:31:00 UTC [2018/12/28 21:31:00 ET]
Table 'Hydra' 6-max Seat #1 is the button
Seat 1: svenduck ($48.77 in chips) 
Seat 2: samioattila ($25.37 in chips) 
Seat 3: SantiagoWeight ($25 in chips) 
Seat 4: jimbonumber1 ($17.98 in chips) 
Seat 5: negreanuNya ($25.35 in chips) 
Seat 6: tightpokerAA ($23.19 in chips) 
samioattila: posts small blind $0.10
SantiagoWeight: posts big blind $0.25
*** HOLE CARDS ***
Dealt to SantiagoWeight [4d Ac]
jimbonumber1: calls $0.25
negreanuNya: folds 
tightpokerAA: folds 
svenduck: folds 
samioattila: folds 
SantiagoWeight: checks 
*** FLOP *** [Qs 7d 6s]
SantiagoWeight: checks 
jimbonumber1: checks 
*** TURN *** [Qs 7d 6s] [Kh]
SantiagoWeight: checks 
jimbonumber1: bets $0.50
SantiagoWeight: folds 
Uncalled bet ($0.50) returned to jimbonumber1
jimbonumber1 collected $0.57 from pot
*** SUMMARY ***
Total pot $0.60 | Rake $0.03 
Board [Qs 7d 6s Kh]
Seat 1: svenduck (button) folded before Flop (didn't bet)
Seat 2: samioattila (small blind) folded before Flop
Seat 3: SantiagoWeight (big blind) folded on the Turn
Seat 4: jimbonumber1 collected ($0.57)
Seat 5: negreanuNya folded before Flop (didn't bet)
Seat 6: tightpokerAA folded before Flop (didn't bet)



PokerStars Zoom Hand #195021965181:  Hold'em No Limit ($0.10/$0.25) - 2018/12/29 2:31:28 UTC [2018/12/28 21:31:28 ET]
Table 'Hydra' 6-max Seat #1 is the button
Seat 1: mistdog ($26.17 in chips) 
Seat 2: SantiagoWeight ($24.75 in chips) 
Seat 3: idontnownow ($37.36 in chips) 
Seat 4: ongravity ($27.27 in chips) 
Seat 5: kounoupiss ($89.12 in chips) 
Seat 6: Aleks Better ($17.03 in chips) 
SantiagoWeight: posts small blind $0.10
idontnownow: posts big blind $0.25
*** HOLE CARDS ***
Dealt to SantiagoWeight [Qd 2d]
ongravity: folds 
kounoupiss: folds 
Aleks Better: folds 
mistdog: folds 
SantiagoWeight: raises $0.50 to $0.75
idontnownow: calls $0.50
*** FLOP *** [4c 8s 7c]
SantiagoWeight: checks 
idontnownow: bets $1.25
SantiagoWeight: folds 
Uncalled bet ($1.25) returned to idontnownow
idontnownow collected $1.43 from pot
idontnownow: doesn't show hand 
*** SUMMARY ***
Total pot $1.50 | Rake $0.07 
Board [4c 8s 7c]
Seat 1: mistdog (button) folded before Flop (didn't bet)
Seat 2: SantiagoWeight (small blind) folded on the Flop
Seat 3: idontnownow (big blind) collected ($1.43)
Seat 4: ongravity folded before Flop (didn't bet)
Seat 5: kounoupiss folded before Flop (didn't bet)
Seat 6: Aleks Better folded before Flop (didn't bet)



PokerStars Zoom Hand #195021977869:  Hold'em No Limit ($0.10/$0.25) - 2018/12/29 2:32:01 UTC [2018/12/28 21:32:01 ET]
Table 'Hydra' 6-max Seat #1 is the button
Seat 1: SantiagoWeight ($24 in chips) 
Seat 2: trillerGTO ($17.21 in chips) 
Seat 3: crescendo34 ($39.47 in chips) 
Seat 4: Butch030 ($81.75 in chips) 
Seat 5: thedemise69 ($6.52 in chips) 
Seat 6: Lacoste_jj ($68.48 in chips) 
trillerGTO: posts small blind $0.10
crescendo34: posts big blind $0.25
*** HOLE CARDS ***
Dealt to SantiagoWeight [7c 3d]
Butch030: folds 
thedemise69: folds 
Lacoste_jj: folds 
SantiagoWeight: folds 
trillerGTO: folds 
Uncalled bet ($0.15) returned to crescendo34
crescendo34 collected $0.20 from pot
crescendo34: doesn't show hand 
*** SUMMARY ***
Total pot $0.20 | Rake $0 
Seat 1: SantiagoWeight (button) folded before Flop (didn't bet)
Seat 2: trillerGTO (small blind) folded before Flop
Seat 3: crescendo34 (big blind) collected ($0.20)
Seat 4: Butch030 folded before Flop (didn't bet)
Seat 5: thedemise69 folded before Flop (didn't bet)
Seat 6: Lacoste_jj folded before Flop (didn't bet)



PokerStars Zoom Hand #195021982169:  Hold'em No Limit ($0.10/$0.25) - 2018/12/29 2:32:12 UTC [2018/12/28 21:32:12 ET]
Table 'Hydra' 6-max Seat #1 is the button
Seat 1: sigaro010 ($34.50 in chips) 
Seat 2: Xp0Hb ($19.84 in chips) 
Seat 3: Cryptoz91 ($26.55 in chips) 
Seat 4: Parsam5 ($28.34 in chips) 
Seat 5: hoodbya!r ($23.88 in chips) 
Seat 6: SantiagoWeight ($24 in chips) 
Xp0Hb: posts small blind $0.10
Cryptoz91: posts big blind $0.25
*** HOLE CARDS ***
Dealt to SantiagoWeight [Kh Kc]
Parsam5: folds 
hoodbya!r: folds 
SantiagoWeight: raises $0.35 to $0.60
sigaro010: folds 
Xp0Hb: folds 
Cryptoz91: folds 
Uncalled bet ($0.35) returned to SantiagoWeight
SantiagoWeight collected $0.60 from pot
SantiagoWeight: doesn't show hand 
*** SUMMARY ***
Total pot $0.60 | Rake $0 
Seat 1: sigaro010 (button) folded before Flop (didn't bet)
Seat 2: Xp0Hb (small blind) folded before Flop
Seat 3: Cryptoz91 (big blind) folded before Flop
Seat 4: Parsam5 folded before Flop (didn't bet)
Seat 5: hoodbya!r folded before Flop (didn't bet)
Seat 6: SantiagoWeight collected ($0.60)



PokerStars Zoom Hand #195021989863:  Hold'em No Limit ($0.10/$0.25) - 2018/12/29 2:32:32 UTC [2018/12/28 21:32:32 ET]
Table 'Hydra' 6-max Seat #1 is the button
Seat 1: armandopinga ($119.84 in chips) 
Seat 2: SantiagoWeight ($24.35 in chips) 
Seat 3: thedemise69 ($6.52 in chips) 
Seat 4: Butch030 ($81.55 in chips) 
Seat 5: Indiaan1625 ($32.76 in chips) 
Seat 6: pokerpienda ($28.08 in chips) 
SantiagoWeight: posts small blind $0.10
thedemise69: posts big blind $0.25
*** HOLE CARDS ***
Dealt to SantiagoWeight [8h Kh]
Butch030: folds 
Indiaan1625: raises $0.60 to $0.85
pokerpienda: folds 
armandopinga: folds 
SantiagoWeight: folds 
thedemise69: folds 
Uncalled bet ($0.60) returned to Indiaan1625
Indiaan1625 collected $0.60 from pot
Indiaan1625: doesn't show hand 
*** SUMMARY ***
Total pot $0.60 | Rake $0 
Seat 1: armandopinga (button) folded before Flop (didn't bet)
Seat 2: SantiagoWeight (small blind) folded before Flop
Seat 3: thedemise69 (big blind) folded before Flop
Seat 4: Butch030 folded before Flop (didn't bet)
Seat 5: Indiaan1625 collected ($0.60)
Seat 6: pokerpienda folded before Flop (didn't bet)



PokerStars Zoom Hand #195021988316:  Hold'em No Limit ($0.10/$0.25) - 2018/12/29 2:32:28 UTC [2018/12/28 21:32:28 ET]
Table 'Hydra' 6-max Seat #1 is the button
Seat 1: svents ($135.41 in chips) 
Seat 2: zhang1zhang ($42.28 in chips) 
Seat 3: negreanuNya ($36.84 in chips) 
Seat 4: hoodbya!r ($18.02 in chips) 
Seat 5: SantiagoWeight ($24.35 in chips) 
Seat 6: bfh26 ($27.77 in chips) 
zhang1zhang: posts small blind $0.10
negreanuNya: posts big blind $0.25
*** HOLE CARDS ***
Dealt to SantiagoWeight [4s 2h]
hoodbya!r: folds 
SantiagoWeight: folds 
bfh26: folds 
svents: raises $0.30 to $0.55
zhang1zhang: folds 
negreanuNya: folds 
Uncalled bet ($0.30) returned to svents
svents collected $0.60 from pot
svents: doesn't show hand 
*** SUMMARY ***
Total pot $0.60 | Rake $0 
Seat 1: svents (button) collected ($0.60)
Seat 2: zhang1zhang (small blind) folded before Flop
Seat 3: negreanuNya (big blind) folded before Flop
Seat 4: hoodbya!r folded before Flop (didn't bet)
Seat 5: SantiagoWeight folded before Flop (didn't bet)
Seat 6: bfh26 folded before Flop (didn't bet)



PokerStars Zoom Hand #195021996047:  Hold'em No Limit ($0.10/$0.25) - 2018/12/29 2:32:48 UTC [2018/12/28 21:32:48 ET]
Table 'Hydra' 6-max Seat #1 is the button
Seat 1: TiltalaMalta ($25.35 in chips) 
Seat 2: davidhw888 ($25 in chips) 
Seat 3: rush.pp ($108.35 in chips) 
Seat 4: SantiagoWeight ($24.25 in chips) 
Seat 5: hoodbya!r ($24.13 in chips) 
Seat 6: Parsam5 ($27.89 in chips) 
davidhw888: posts small blind $0.10
rush.pp: posts big blind $0.25
*** HOLE CARDS ***
Dealt to SantiagoWeight [Qd Kd]
SantiagoWeight: raises $0.50 to $0.75
hoodbya!r: folds 
Parsam5: folds 
TiltalaMalta: raises $1.85 to $2.60
davidhw888: folds 
rush.pp: folds 
SantiagoWeight: calls $1.85
*** FLOP *** [8c As 5h]
SantiagoWeight: checks 
TiltalaMalta: bets $2.60
SantiagoWeight: folds 
Uncalled bet ($2.60) returned to TiltalaMalta
TiltalaMalta collected $5.30 from pot
*** SUMMARY ***
Total pot $5.55 | Rake $0.25 
Board [8c As 5h]
Seat 1: TiltalaMalta (button) collected ($5.30)
Seat 2: davidhw888 (small blind) folded before Flop
Seat 3: rush.pp (big blind) folded before Flop
Seat 4: SantiagoWeight folded on the Flop
Seat 5: hoodbya!r folded before Flop (didn't bet)
Seat 6: Parsam5 folded before Flop (didn't bet)



PokerStars Zoom Hand #195022012105:  Hold'em No Limit ($0.10/$0.25) - 2018/12/29 2:33:30 UTC [2018/12/28 21:33:30 ET]
Table 'Hydra' 6-max Seat #1 is the button
Seat 1: anorectal ($53.46 in chips) 
Seat 2: Becks Baker ($25 in chips) 
Seat 3: SantiagoWeight ($21.65 in chips) 
Seat 4: the_ablist7 ($9.17 in chips) 
Seat 5: aloominat ($15.95 in chips) 
Seat 6: TDAK1509 ($28.13 in chips) 
Becks Baker: posts small blind $0.10
SantiagoWeight: posts big blind $0.25
*** HOLE CARDS ***
Dealt to SantiagoWeight [4h 6c]
the_ablist7: folds 
aloominat: folds 
TDAK1509: folds 
anorectal: raises $0.35 to $0.60
Becks Baker: folds 
SantiagoWeight: folds 
Uncalled bet ($0.35) returned to anorectal
anorectal collected $0.60 from pot
*** SUMMARY ***
Total pot $0.60 | Rake $0 
Seat 1: anorectal (button) collected ($0.60)
Seat 2: Becks Baker (small blind) folded before Flop
Seat 3: SantiagoWeight (big blind) folded before Flop
Seat 4: the_ablist7 folded before Flop (didn't bet)
Seat 5: aloominat folded before Flop (didn't bet)
Seat 6: TDAK1509 folded before Flop (didn't bet)



PokerStars Zoom Hand #195022022666:  Hold'em No Limit ($0.10/$0.25) - 2018/12/29 2:33:58 UTC [2018/12/28 21:33:58 ET]
Table 'Hydra' 6-max Seat #1 is the button
Seat 1: SantiagoWeight ($24.75 in chips) 
Seat 2: benddo ($25.93 in chips) 
Seat 3: Xander_B88 ($67.01 in chips) 
Seat 4: Bujan 07 ($16.42 in chips) 
Seat 5: Archi1024 ($17.06 in chips) 
Seat 6: davidhw888 ($25.68 in chips) 
benddo: posts small blind $0.10
Xander_B88: posts big blind $0.25
*** HOLE CARDS ***
Dealt to SantiagoWeight [6c Jc]
Bujan 07: folds 
Archi1024: folds 
davidhw888: folds 
SantiagoWeight: raises $0.25 to $0.50
benddo: folds 
Xander_B88: calls $0.25
*** FLOP *** [Tc Qh 6h]
Xander_B88: checks 
SantiagoWeight: checks 
*** TURN *** [Tc Qh 6h] [Qd]
Xander_B88: checks 
SantiagoWeight: bets $0.53
Xander_B88: calls $0.53
*** RIVER *** [Tc Qh 6h Qd] [Qs]
Xander_B88: checks 
SantiagoWeight: bets $2.25
Xander_B88: folds 
Uncalled bet ($2.25) returned to SantiagoWeight
SantiagoWeight collected $2.06 from pot
SantiagoWeight: doesn't show hand 
*** SUMMARY ***
Total pot $2.16 | Rake $0.10 
Board [Tc Qh 6h Qd Qs]
Seat 1: SantiagoWeight (button) collected ($2.06)
Seat 2: benddo (small blind) folded before Flop
Seat 3: Xander_B88 (big blind) folded on the River
Seat 4: Bujan 07 folded before Flop (didn't bet)
Seat 5: Archi1024 folded before Flop (didn't bet)
Seat 6: davidhw888 folded before Flop (didn't bet)



PokerStars Zoom Hand #195022052970:  Hold'em No Limit ($0.10/$0.25) - 2018/12/29 2:35:18 UTC [2018/12/28 21:35:18 ET]
Table 'Hydra' 6-max Seat #1 is the button
Seat 1: aromaWin ($58.17 in chips) 
Seat 2: needluck89 ($120.73 in chips) 
Seat 3: Xa4_88 ($39.76 in chips) 
Seat 4: Bujan 07 ($25.24 in chips) 
Seat 5: anorectal ($31.85 in chips) 
Seat 6: SantiagoWeight ($25.78 in chips) 
needluck89: posts small blind $0.10
Xa4_88: posts big blind $0.25
*** HOLE CARDS ***
Dealt to SantiagoWeight [Ad 3s]
Bujan 07: raises $0.50 to $0.75
anorectal: folds 
SantiagoWeight: folds 
aromaWin: folds 
needluck89: folds 
Xa4_88: folds 
Uncalled bet ($0.50) returned to Bujan 07
Bujan 07 collected $0.60 from pot
Bujan 07: doesn't show hand 
*** SUMMARY ***
Total pot $0.60 | Rake $0 
Seat 1: aromaWin (button) folded before Flop (didn't bet)
Seat 2: needluck89 (small blind) folded before Flop
Seat 3: Xa4_88 (big blind) folded before Flop
Seat 4: Bujan 07 collected ($0.60)
Seat 5: anorectal folded before Flop (didn't bet)
Seat 6: SantiagoWeight folded before Flop (didn't bet)



PokerStars Zoom Hand #195022060219:  Hold'em No Limit ($0.10/$0.25) - 2018/12/29 2:35:37 UTC [2018/12/28 21:35:37 ET]
Table 'Hydra' 6-max Seat #1 is the button
Seat 1: samioattila ($51.72 in chips) 
Seat 2: Jwaladas ($7.34 in chips) 
Seat 3: pioneer577 ($22.66 in chips) 
Seat 4: ducsip ($25.56 in chips) 
Seat 5: SantiagoWeight ($25.78 in chips) 
Seat 6: Cryptoz91 ($25 in chips) 
Jwaladas: posts small blind $0.10
pioneer577: posts big blind $0.25
*** HOLE CARDS ***
Dealt to SantiagoWeight [6h Ah]
ducsip: folds 
SantiagoWeight: raises $0.40 to $0.65
Cryptoz91: folds 
samioattila: folds 
Jwaladas: raises $0.40 to $1.05
pioneer577: folds 
SantiagoWeight: calls $0.40
*** FLOP *** [4s 9h 4h]
Jwaladas: bets $0.25
SantiagoWeight: calls $0.25
*** TURN *** [4s 9h 4h] [As]
Jwaladas: bets $2.72
SantiagoWeight: raises $21.76 to $24.48 and is all-in
Jwaladas: calls $3.32 and is all-in
Uncalled bet ($18.44) returned to SantiagoWeight
*** RIVER *** [4s 9h 4h As] [Qc]
*** SHOW DOWN ***
Jwaladas: shows [4c Ac] (a full house, Fours full of Aces)
SantiagoWeight: shows [6h Ah] (two pair, Aces and Fours)
Jwaladas collected $14.26 from pot
*** SUMMARY ***
Total pot $14.93 | Rake $0.67 
Board [4s 9h 4h As Qc]
Seat 1: samioattila (button) folded before Flop (didn't bet)
Seat 2: Jwaladas (small blind) showed [4c Ac] and won ($14.26) with a full house, Fours full of Aces
Seat 3: pioneer577 (big blind) folded before Flop
Seat 4: ducsip folded before Flop (didn't bet)
Seat 5: SantiagoWeight showed [6h Ah] and lost with two pair, Aces and Fours
Seat 6: Cryptoz91 folded before Flop (didn't bet)



PokerStars Zoom Hand #195022083938:  Hold'em No Limit ($0.10/$0.25) - 2018/12/29 2:36:37 UTC [2018/12/28 21:36:37 ET]
Table 'Hydra' 6-max Seat #1 is the button
Seat 1: LupiGonzales ($24.48 in chips) 
Seat 2: davidhw888 ($31.22 in chips) 
Seat 3: SantiagoWeight ($18.44 in chips) 
Seat 4: Butch030 ($80.51 in chips) 
Seat 5: tightpokerAA ($33.15 in chips) 
Seat 6: anorectal ($28.83 in chips) 
davidhw888: posts small blind $0.10
SantiagoWeight: posts big blind $0.25
*** HOLE CARDS ***
Dealt to SantiagoWeight [4d 9d]
Butch030: folds 
tightpokerAA: folds 
anorectal: folds 
LupiGonzales: folds 
davidhw888: raises $0.50 to $0.75
SantiagoWeight: folds 
Uncalled bet ($0.50) returned to davidhw888
davidhw888 collected $0.50 from pot
*** SUMMARY ***
Total pot $0.50 | Rake $0 
Seat 1: LupiGonzales (button) folded before Flop (didn't bet)
Seat 2: davidhw888 (small blind) collected ($0.50)
Seat 3: SantiagoWeight (big blind) folded before Flop
Seat 4: Butch030 folded before Flop (didn't bet)
Seat 5: tightpokerAA folded before Flop (didn't bet)
Seat 6: anorectal folded before Flop (didn't bet)



PokerStars Zoom Hand #195022088585:  Hold'em No Limit ($0.10/$0.25) - 2018/12/29 2:36:49 UTC [2018/12/28 21:36:49 ET]
Table 'Hydra' 6-max Seat #1 is the button
Seat 1: MISTAAJ ($60.76 in chips) 
Seat 2: SantiagoWeight ($18.19 in chips) 
Seat 3: samioattila ($51.37 in chips) 
Seat 4: Kirac99 ($14.62 in chips) 
Seat 5: Z3rbinatti ($93.88 in chips) 
Seat 6: StarBusch ($28.27 in chips) 
SantiagoWeight: posts small blind $0.10
samioattila: posts big blind $0.25
*** HOLE CARDS ***
Dealt to SantiagoWeight [As 4h]
Kirac99 has timed out
Kirac99: folds 
Z3rbinatti: raises $0.37 to $0.62
StarBusch: folds 
MISTAAJ: folds 
SantiagoWeight: folds 
samioattila: raises $2.38 to $3
Z3rbinatti: folds 
Uncalled bet ($2.38) returned to samioattila
samioattila collected $1.34 from pot
samioattila: doesn't show hand 
*** SUMMARY ***
Total pot $1.34 | Rake $0 
Seat 1: MISTAAJ (button) folded before Flop (didn't bet)
Seat 2: SantiagoWeight (small blind) folded before Flop
Seat 3: samioattila (big blind) collected ($1.34)
Seat 4: Kirac99 folded before Flop (didn't bet)
Seat 5: Z3rbinatti folded before Flop
Seat 6: StarBusch folded before Flop (didn't bet)



PokerStars Zoom Hand #195022101859:  Hold'em No Limit ($0.10/$0.25) - 2018/12/29 2:37:24 UTC [2018/12/28 21:37:24 ET]
Table 'Hydra' 6-max Seat #1 is the button
Seat 1: Vilactes ($45.29 in chips) 
Seat 2: mariopork ($34.60 in chips) 
Seat 3: edcon77 ($32.92 in chips) 
Seat 4: SantiagoWeight ($24.90 in chips) 
Seat 5: trillerGTO ($51.03 in chips) 
Seat 6: petanquemeis ($22.69 in chips) 
mariopork: posts small blind $0.10
edcon77: posts big blind $0.25
*** HOLE CARDS ***
Dealt to SantiagoWeight [Qd 6s]
SantiagoWeight: folds 
trillerGTO: folds 
petanquemeis: calls $0.25
Vilactes: folds 
mariopork: folds 
edcon77: checks 
*** FLOP *** [2d 8d 7h]
edcon77: checks 
petanquemeis: bets $0.57
edcon77: folds 
Uncalled bet ($0.57) returned to petanquemeis
petanquemeis collected $0.57 from pot
petanquemeis: doesn't show hand 
*** SUMMARY ***
Total pot $0.60 | Rake $0.03 
Board [2d 8d 7h]
Seat 1: Vilactes (button) folded before Flop (didn't bet)
Seat 2: mariopork (small blind) folded before Flop
Seat 3: edcon77 (big blind) folded on the Flop
Seat 4: SantiagoWeight folded before Flop (didn't bet)
Seat 5: trillerGTO folded before Flop (didn't bet)
Seat 6: petanquemeis collected ($0.57)



PokerStars Zoom Hand #195022104975:  Hold'em No Limit ($0.10/$0.25) - 2018/12/29 2:37:32 UTC [2018/12/28 21:37:32 ET]
Table 'Hydra' 6-max Seat #1 is the button
Seat 1: SantiagoWeight ($24.90 in chips) 
Seat 2: satisfhy_you ($25 in chips) 
Seat 3: Dr.Jekyll197 ($33.64 in chips) 
Seat 4: !P0K3RM3T4L! ($25 in chips) 
Seat 5: FrommyBu ($27.74 in chips) 
Seat 6: anorectal ($25.10 in chips) 
satisfhy_you: posts small blind $0.10
Dr.Jekyll197: posts big blind $0.25
*** HOLE CARDS ***
Dealt to SantiagoWeight [5h Tc]
!P0K3RM3T4L!: folds 
FrommyBu: folds 
anorectal: folds 
SantiagoWeight: folds 
satisfhy_you: folds 
Uncalled bet ($0.15) returned to Dr.Jekyll197
Dr.Jekyll197 collected $0.20 from pot
Dr.Jekyll197: doesn't show hand 
*** SUMMARY ***
Total pot $0.20 | Rake $0 
Seat 1: SantiagoWeight (button) folded before Flop (didn't bet)
Seat 2: satisfhy_you (small blind) folded before Flop
Seat 3: Dr.Jekyll197 (big blind) collected ($0.20)
Seat 4: !P0K3RM3T4L! folded before Flop (didn't bet)
Seat 5: FrommyBu folded before Flop (didn't bet)
Seat 6: anorectal folded before Flop (didn't bet)



PokerStars Zoom Hand #195022111532:  Hold'em No Limit ($0.10/$0.25) - 2018/12/29 2:37:48 UTC [2018/12/28 21:37:48 ET]
Table 'Hydra' 6-max Seat #1 is the button
Seat 1: edcon77 ($32.67 in chips) 
Seat 2: paulieGB ($22.23 in chips) 
Seat 3: ongravity ($94.91 in chips) 
Seat 4: hoodbya!r ($15.03 in chips) 
Seat 5: altum15a ($102.50 in chips) 
Seat 6: SantiagoWeight ($24.90 in chips) 
paulieGB: posts small blind $0.10
ongravity: posts big blind $0.25
*** HOLE CARDS ***
Dealt to SantiagoWeight [9c Ks]
hoodbya!r: folds 
altum15a: folds 
SantiagoWeight: raises $0.25 to $0.50
edcon77: raises $1.35 to $1.85
paulieGB: folds 
ongravity: calls $1.60
SantiagoWeight: folds 
*** FLOP *** [2c 3d Jd]
ongravity: checks 
edcon77: bets $2
ongravity: folds 
Uncalled bet ($2) returned to edcon77
edcon77 collected $4.11 from pot
edcon77: doesn't show hand 
*** SUMMARY ***
Total pot $4.30 | Rake $0.19 
Board [2c 3d Jd]
Seat 1: edcon77 (button) collected ($4.11)
Seat 2: paulieGB (small blind) folded before Flop
Seat 3: ongravity (big blind) folded on the Flop
Seat 4: hoodbya!r folded before Flop (didn't bet)
Seat 5: altum15a folded before Flop (didn't bet)
Seat 6: SantiagoWeight folded before Flop



PokerStars Zoom Hand #195022127919:  Hold'em No Limit ($0.10/$0.25) - 2018/12/29 2:38:30 UTC [2018/12/28 21:38:30 ET]
Table 'Hydra' 6-max Seat #1 is the button
Seat 1: tightpokerAA ($29.90 in chips) 
Seat 2: TQNYMQNTANA ($25.73 in chips) 
Seat 3: ludisima ($28.38 in chips) 
Seat 4: SantiagoWeight ($24.40 in chips) 
Seat 5: crescendo34 ($24.19 in chips) 
Seat 6: MarcoA12 ($15.43 in chips) 
TQNYMQNTANA: posts small blind $0.10
ludisima: posts big blind $0.25
*** HOLE CARDS ***
Dealt to SantiagoWeight [6c 9d]
SantiagoWeight: folds 
crescendo34: folds 
MarcoA12: folds 
tightpokerAA: raises $0.50 to $0.75
TQNYMQNTANA: folds 
ludisima: calls $0.50
*** FLOP *** [4s 3h Kh]
ludisima: checks 
tightpokerAA: bets $0.77
ludisima: calls $0.77
*** TURN *** [4s 3h Kh] [Jd]
ludisima: checks 
tightpokerAA: checks 
*** RIVER *** [4s 3h Kh Jd] [3d]
ludisima: bets $2
tightpokerAA: folds 
Uncalled bet ($2) returned to ludisima
ludisima collected $3 from pot
ludisima: doesn't show hand 
*** SUMMARY ***
Total pot $3.14 | Rake $0.14 
Board [4s 3h Kh Jd 3d]
Seat 1: tightpokerAA (button) folded on the River
Seat 2: TQNYMQNTANA (small blind) folded before Flop
Seat 3: ludisima (big blind) collected ($3)
Seat 4: SantiagoWeight folded before Flop (didn't bet)
Seat 5: crescendo34 folded before Flop (didn't bet)
Seat 6: MarcoA12 folded before Flop (didn't bet)



PokerStars Zoom Hand #195022130262:  Hold'em No Limit ($0.10/$0.25) - 2018/12/29 2:38:36 UTC [2018/12/28 21:38:36 ET]
Table 'Hydra' 6-max Seat #1 is the button
Seat 1: allin969 ($30.93 in chips) 
Seat 2: ChungkingExp ($25 in chips) 
Seat 3: SantiagoWeight ($24.40 in chips) 
Seat 4: TiltalaMalta ($34.07 in chips) 
Seat 5: mariopork ($33.35 in chips) 
Seat 6: lbautista91 ($47.44 in chips) 
ChungkingExp: posts small blind $0.10
SantiagoWeight: posts big blind $0.25
*** HOLE CARDS ***
Dealt to SantiagoWeight [7s 7h]
TiltalaMalta: folds 
mariopork: raises $0.50 to $0.75
lbautista91: calls $0.75
allin969: calls $0.75
ChungkingExp: folds 
SantiagoWeight: calls $0.50
*** FLOP *** [2d Qs Js]
SantiagoWeight: checks 
mariopork: checks 
lbautista91: bets $1.50
allin969: raises $1.50 to $3
SantiagoWeight: folds 
mariopork: folds 
lbautista91: folds 
Uncalled bet ($1.50) returned to allin969
allin969 collected $5.83 from pot
allin969: doesn't show hand 
*** SUMMARY ***
Total pot $6.10 | Rake $0.27 
Board [2d Qs Js]
Seat 1: allin969 (button) collected ($5.83)
Seat 2: ChungkingExp (small blind) folded before Flop
Seat 3: SantiagoWeight (big blind) folded on the Flop
Seat 4: TiltalaMalta folded before Flop (didn't bet)
Seat 5: mariopork folded on the Flop
Seat 6: lbautista91 folded on the Flop



PokerStars Zoom Hand #195022148504:  Hold'em No Limit ($0.10/$0.25) - 2018/12/29 2:39:23 UTC [2018/12/28 21:39:23 ET]
Table 'Hydra' 6-max Seat #1 is the button
Seat 1: rush.pp ($25.69 in chips) 
Seat 2: Dr.Jekyll197 ($28.14 in chips) 
Seat 3: reetskeet ($28.39 in chips) 
Seat 4: anorectal ($30.40 in chips) 
Seat 5: SantiagoWeight ($23.65 in chips) 
Seat 6: ckriszee ($78.35 in chips) 
Dr.Jekyll197: posts small blind $0.10
reetskeet: posts big blind $0.25
*** HOLE CARDS ***
Dealt to SantiagoWeight [Ts 9h]
anorectal: raises $0.35 to $0.60
SantiagoWeight: folds 
ckriszee: folds 
rush.pp: folds 
Dr.Jekyll197: folds 
reetskeet: folds 
Uncalled bet ($0.35) returned to anorectal
anorectal collected $0.60 from pot
anorectal: doesn't show hand 
*** SUMMARY ***
Total pot $0.60 | Rake $0 
Seat 1: rush.pp (button) folded before Flop (didn't bet)
Seat 2: Dr.Jekyll197 (small blind) folded before Flop
Seat 3: reetskeet (big blind) folded before Flop
Seat 4: anorectal collected ($0.60)
Seat 5: SantiagoWeight folded before Flop (didn't bet)
Seat 6: ckriszee folded before Flop (didn't bet)



PokerStars Zoom Hand #195022174404:  Hold'em No Limit ($0.10/$0.25) - 2018/12/29 2:40:30 UTC [2018/12/28 21:40:30 ET]
Table 'Hydra' 6-max Seat #1 is the button
Seat 1: hoodbya!r ($18.09 in chips) 
Seat 2: SantiagoWeight ($23.65 in chips) 
Seat 3: sigaro010 ($40.63 in chips) 
Seat 4: sleapyjoe ($12.62 in chips) 
Seat 5: trillerGTO ($30.80 in chips) 
Seat 6: svents ($160.82 in chips) 
SantiagoWeight: posts small blind $0.10
sigaro010: posts big blind $0.25
*** HOLE CARDS ***
Dealt to SantiagoWeight [2s Js]
sleapyjoe: folds 
trillerGTO: folds 
svents: folds 
hoodbya!r: folds 
SantiagoWeight: raises $0.41 to $0.66
sigaro010: calls $0.41
*** FLOP *** [4h 6c Ad]
SantiagoWeight: bets $0.40
sigaro010: raises $1.60 to $2
SantiagoWeight: folds 
Uncalled bet ($1.60) returned to sigaro010
sigaro010 collected $2.02 from pot
sigaro010: doesn't show hand 
*** SUMMARY ***
Total pot $2.12 | Rake $0.10 
Board [4h 6c Ad]
Seat 1: hoodbya!r (button) folded before Flop (didn't bet)
Seat 2: SantiagoWeight (small blind) folded on the Flop
Seat 3: sigaro010 (big blind) collected ($2.02)
Seat 4: sleapyjoe folded before Flop (didn't bet)
Seat 5: trillerGTO folded before Flop (didn't bet)
Seat 6: svents folded before Flop (didn't bet)



PokerStars Zoom Hand #195022194879:  Hold'em No Limit ($0.10/$0.25) - 2018/12/29 2:41:23 UTC [2018/12/28 21:41:23 ET]
Table 'Hydra' 6-max Seat #1 is the button
Seat 1: SantiagoWeight ($23.94 in chips) 
Seat 2: SDCMan ($39.52 in chips) 
Seat 3: Parsam5 ($27.21 in chips) 
Seat 4: NightHunter2018 ($34.81 in chips) 
Seat 5: SirSatan001 ($36.76 in chips) 
Seat 6: nadal335 ($28.91 in chips) 
SDCMan: posts small blind $0.10
Parsam5: posts big blind $0.25
*** HOLE CARDS ***
Dealt to SantiagoWeight [6d As]
NightHunter2018: folds 
SirSatan001: folds 
nadal335: folds 
SantiagoWeight: raises $0.25 to $0.50
SDCMan: folds 
Parsam5: calls $0.25
*** FLOP *** [9h 3s 2h]
Parsam5: checks 
SantiagoWeight: bets $0.63
Parsam5: calls $0.63
*** TURN *** [9h 3s 2h] [6h]
Parsam5: checks 
SantiagoWeight: bets $1.50
Parsam5: calls $1.50
*** RIVER *** [9h 3s 2h 6h] [Js]
Parsam5: checks 
SantiagoWeight: checks 
*** SHOW DOWN ***
Parsam5: shows [9s Qd] (a pair of Nines)
SantiagoWeight: mucks hand 
Parsam5 collected $5.12 from pot
*** SUMMARY ***
Total pot $5.36 | Rake $0.24 
Board [9h 3s 2h 6h Js]
Seat 1: SantiagoWeight (button) mucked [6d As]
Seat 2: SDCMan (small blind) folded before Flop
Seat 3: Parsam5 (big blind) showed [9s Qd] and won ($5.12) with a pair of Nines
Seat 4: NightHunter2018 folded before Flop (didn't bet)
Seat 5: SirSatan001 folded before Flop (didn't bet)
Seat 6: nadal335 folded before Flop (didn't bet)



PokerStars Zoom Hand #195022217768:  Hold'em No Limit ($0.10/$0.25) - 2018/12/29 2:42:22 UTC [2018/12/28 21:42:22 ET]
Table 'Hydra' 6-max Seat #1 is the button
Seat 1: Parsam5 ($29.70 in chips) 
Seat 2: ivann14 ($76.89 in chips) 
Seat 3: BIGPAIN14 ($57.95 in chips) 
Seat 4: lbautista91 ($19.68 in chips) 
Seat 5: altum15a ($106.15 in chips) 
Seat 6: SantiagoWeight ($21.31 in chips) 
ivann14: posts small blind $0.10
BIGPAIN14: posts big blind $0.25
*** HOLE CARDS ***
Dealt to SantiagoWeight [Ac Ad]
lbautista91: folds 
altum15a: raises $0.25 to $0.50
SantiagoWeight: raises $1.25 to $1.75
Parsam5: folds 
ivann14: folds 
BIGPAIN14: folds 
altum15a: raises $3.85 to $5.60
SantiagoWeight: calls $3.85
*** FLOP *** [Ks 4h 2d]
altum15a: bets $11
SantiagoWeight: raises $4.71 to $15.71 and is all-in
altum15a: calls $4.71
*** TURN *** [Ks 4h 2d] [4c]
*** RIVER *** [Ks 4h 2d 4c] [8d]
*** SHOW DOWN ***
altum15a: shows [As Kh] (two pair, Kings and Fours)
SantiagoWeight: shows [Ac Ad] (two pair, Aces and Fours)
SantiagoWeight collected $41.04 from pot
*** SUMMARY ***
Total pot $42.97 | Rake $1.93 
Board [Ks 4h 2d 4c 8d]
Seat 1: Parsam5 (button) folded before Flop (didn't bet)
Seat 2: ivann14 (small blind) folded before Flop
Seat 3: BIGPAIN14 (big blind) folded before Flop
Seat 4: lbautista91 folded before Flop (didn't bet)
Seat 5: altum15a showed [As Kh] and lost with two pair, Kings and Fours
Seat 6: SantiagoWeight showed [Ac Ad] and won ($41.04) with two pair, Aces and Fours



PokerStars Zoom Hand #195022245334:  Hold'em No Limit ($0.10/$0.25) - 2018/12/29 2:43:34 UTC [2018/12/28 21:43:34 ET]
Table 'Hydra' 6-max Seat #1 is the button
Seat 1: pkr_miracle ($102.09 in chips) 
Seat 2: Becks Baker ($25 in chips) 
Seat 3: ola_Sakala ($33.48 in chips) 
Seat 4: benddo ($56.50 in chips) 
Seat 5: SantiagoWeight ($41.04 in chips) 
Seat 6: TQNYMQNTANA ($25.65 in chips) 
Becks Baker: posts small blind $0.10
ola_Sakala: posts big blind $0.25
*** HOLE CARDS ***
Dealt to SantiagoWeight [9s Td]
benddo: folds 
SantiagoWeight: folds 
TQNYMQNTANA: folds 
pkr_miracle: folds 
Becks Baker: raises $0.50 to $0.75
ola_Sakala: folds 
Uncalled bet ($0.50) returned to Becks Baker
Becks Baker collected $0.50 from pot
Becks Baker: doesn't show hand 
*** SUMMARY ***
Total pot $0.50 | Rake $0 
Seat 1: pkr_miracle (button) folded before Flop (didn't bet)
Seat 2: Becks Baker (small blind) collected ($0.50)
Seat 3: ola_Sakala (big blind) folded before Flop
Seat 4: benddo folded before Flop (didn't bet)
Seat 5: SantiagoWeight folded before Flop (didn't bet)
Seat 6: TQNYMQNTANA folded before Flop (didn't bet)



PokerStars Zoom Hand #195022250310:  Hold'em No Limit ($0.10/$0.25) - 2018/12/29 2:43:47 UTC [2018/12/28 21:43:47 ET]
Table 'Hydra' 6-max Seat #1 is the button
Seat 1: checho0231 ($28.94 in chips) 
Seat 2: SantiagoWeight ($41.04 in chips) 
Seat 3: lbautista91 ($33.69 in chips) 
Seat 4: trillerGTO ($24.65 in chips) 
Seat 5: samioattila ($42.68 in chips) 
Seat 6: sZCzpNtheKot ($25 in chips) 
SantiagoWeight: posts small blind $0.10
lbautista91: posts big blind $0.25
*** HOLE CARDS ***
Dealt to SantiagoWeight [8c 8d]
trillerGTO: folds 
samioattila: folds 
sZCzpNtheKot: raises $0.37 to $0.62
checho0231: folds 
SantiagoWeight: raises $1.63 to $2.25
lbautista91: folds 
sZCzpNtheKot: folds 
Uncalled bet ($1.63) returned to SantiagoWeight
SantiagoWeight collected $1.49 from pot
SantiagoWeight: doesn't show hand 
*** SUMMARY ***
Total pot $1.49 | Rake $0 
Seat 1: checho0231 (button) folded before Flop (didn't bet)
Seat 2: SantiagoWeight (small blind) collected ($1.49)
Seat 3: lbautista91 (big blind) folded before Flop
Seat 4: trillerGTO folded before Flop (didn't bet)
Seat 5: samioattila folded before Flop (didn't bet)
Seat 6: sZCzpNtheKot folded before Flop



PokerStars Zoom Hand #195022269573:  Hold'em No Limit ($0.10/$0.25) - 2018/12/29 2:44:38 UTC [2018/12/28 21:44:38 ET]
Table 'Hydra' 6-max Seat #1 is the button
Seat 1: winwinboy ($25 in chips) 
Seat 2: hoodbya!r ($31.39 in chips) 
Seat 3: SantiagoWeight ($41.91 in chips) 
Seat 4: BeastNBieber ($53.57 in chips) 
Seat 5: crescendo34 ($14.19 in chips) 
Seat 6: nhanminhtri ($25 in chips) 
hoodbya!r: posts small blind $0.10
SantiagoWeight: posts big blind $0.25
*** HOLE CARDS ***
Dealt to SantiagoWeight [6c 4c]
BeastNBieber: folds 
crescendo34: folds 
nhanminhtri: raises $0.37 to $0.62
winwinboy: folds 
hoodbya!r: calls $0.52
SantiagoWeight: calls $0.37
*** FLOP *** [2s 4h Jh]
hoodbya!r: checks 
SantiagoWeight: checks 
nhanminhtri: checks 
*** TURN *** [2s 4h Jh] [9h]
hoodbya!r: checks 
SantiagoWeight: bets $1.68
nhanminhtri: folds 
hoodbya!r: folds 
Uncalled bet ($1.68) returned to SantiagoWeight
SantiagoWeight collected $1.78 from pot
SantiagoWeight: doesn't show hand 
*** SUMMARY ***
Total pot $1.86 | Rake $0.08 
Board [2s 4h Jh 9h]
Seat 1: winwinboy (button) folded before Flop (didn't bet)
Seat 2: hoodbya!r (small blind) folded on the Turn
Seat 3: SantiagoWeight (big blind) collected ($1.78)
Seat 4: BeastNBieber folded before Flop (didn't bet)
Seat 5: crescendo34 folded before Flop (didn't bet)
Seat 6: nhanminhtri folded on the Turn



PokerStars Zoom Hand #195022293897:  Hold'em No Limit ($0.10/$0.25) - 2018/12/29 2:45:42 UTC [2018/12/28 21:45:42 ET]
Table 'Hydra' 6-max Seat #1 is the button
Seat 1: TonnyACE ($24.65 in chips) 
Seat 2: aa1421b ($10.73 in chips) 
Seat 3: jeffwalker23 ($32.89 in chips) 
Seat 4: SantiagoWeight ($43.07 in chips) 
Seat 5: hoodbya!r ($30.77 in chips) 
Seat 6: negreanuNya ($37.89 in chips) 
aa1421b: posts small blind $0.10
jeffwalker23: posts big blind $0.25
*** HOLE CARDS ***
Dealt to SantiagoWeight [2c 9s]
SantiagoWeight: folds 
hoodbya!r: folds 
negreanuNya: folds 
TonnyACE: folds 
aa1421b: folds 
Uncalled bet ($0.15) returned to jeffwalker23
jeffwalker23 collected $0.20 from pot
jeffwalker23: doesn't show hand 
*** SUMMARY ***
Total pot $0.20 | Rake $0 
Seat 1: TonnyACE (button) folded before Flop (didn't bet)
Seat 2: aa1421b (small blind) folded before Flop
Seat 3: jeffwalker23 (big blind) collected ($0.20)
Seat 4: SantiagoWeight folded before Flop (didn't bet)
Seat 5: hoodbya!r folded before Flop (didn't bet)
Seat 6: negreanuNya folded before Flop (didn't bet)



PokerStars Zoom Hand #195022300838:  Hold'em No Limit ($0.10/$0.25) - 2018/12/29 2:45:59 UTC [2018/12/28 21:45:59 ET]
Table 'Hydra' 6-max Seat #1 is the button
Seat 1: SantiagoWeight ($43.07 in chips) 
Seat 2: Z3rbinatti ($113.95 in chips) 
Seat 3: FrommyBu ($26.80 in chips) 
Seat 4: theman120294 ($49.73 in chips) 
Seat 5: aloominat ($29.93 in chips) 
Seat 6: naxizzle ($132.54 in chips) 
Z3rbinatti: posts small blind $0.10
FrommyBu: posts big blind $0.25
*** HOLE CARDS ***
Dealt to SantiagoWeight [Jh Ks]
theman120294: raises $0.50 to $0.75
aloominat: folds 
naxizzle: folds 
SantiagoWeight: folds 
Z3rbinatti: folds 
FrommyBu: raises $2.25 to $3
theman120294: calls $2.25
*** FLOP *** [5d Ts 9c]
FrommyBu: bets $2.92
theman120294: calls $2.92
*** TURN *** [5d Ts 9c] [9d]
FrommyBu: bets $8.55
theman120294: folds 
Uncalled bet ($8.55) returned to FrommyBu
FrommyBu collected $11.40 from pot
FrommyBu: doesn't show hand 
*** SUMMARY ***
Total pot $11.94 | Rake $0.54 
Board [5d Ts 9c 9d]
Seat 1: SantiagoWeight (button) folded before Flop (didn't bet)
Seat 2: Z3rbinatti (small blind) folded before Flop
Seat 3: FrommyBu (big blind) collected ($11.40)
Seat 4: theman120294 folded on the Turn
Seat 5: aloominat folded before Flop (didn't bet)
Seat 6: naxizzle folded before Flop (didn't bet)



PokerStars Zoom Hand #195022317609:  Hold'em No Limit ($0.10/$0.25) - 2018/12/29 2:46:43 UTC [2018/12/28 21:46:43 ET]
Table 'Hydra' 6-max Seat #1 is the button
Seat 1: kounoupiss ($45.51 in chips) 
Seat 2: SirSatan001 ($32.25 in chips) 
Seat 3: franco373513 ($15.59 in chips) 
Seat 4: SantiagoWeight ($43.07 in chips) 
Seat 5: IceAgeDream7 ($107.72 in chips) 
Seat 6: Lehared ($118.11 in chips) 
SirSatan001: posts small blind $0.10
franco373513: posts big blind $0.25
*** HOLE CARDS ***
Dealt to SantiagoWeight [9s Kc]
SantiagoWeight has timed out
SantiagoWeight: folds 
IceAgeDream7: folds 
Lehared: folds 
kounoupiss: raises $0.25 to $0.50
SirSatan001: folds 
franco373513: calls $0.25
*** FLOP *** [Jc Ts 5h]
franco373513: checks 
kounoupiss: bets $0.79
franco373513: folds 
Uncalled bet ($0.79) returned to kounoupiss
kounoupiss collected $1.05 from pot
kounoupiss: doesn't show hand 
*** SUMMARY ***
Total pot $1.10 | Rake $0.05 
Board [Jc Ts 5h]
Seat 1: kounoupiss (button) collected ($1.05)
Seat 2: SirSatan001 (small blind) folded before Flop
Seat 3: franco373513 (big blind) folded on the Flop
Seat 4: SantiagoWeight folded before Flop (didn't bet)
Seat 5: IceAgeDream7 folded before Flop (didn't bet)
Seat 6: Lehared folded before Flop (didn't bet)



PokerStars Zoom Hand #195022307323:  Hold'em No Limit ($0.10/$0.25) - 2018/12/29 2:46:17 UTC [2018/12/28 21:46:17 ET]
Table 'Hydra' 6-max Seat #1 is the button
Seat 1: KAOS914 ($29 in chips) 
Seat 2: BirreteX ($47.28 in chips) 
Seat 3: yobbos ($31.19 in chips) 
Seat 4: samioattila ($47.23 in chips) 
Seat 5: TonnyACE ($23.90 in chips) 
Seat 6: SantiagoWeight ($43.07 in chips) 
BirreteX: posts small blind $0.10
yobbos: posts big blind $0.25
*** HOLE CARDS ***
Dealt to SantiagoWeight [Jh 9c]
samioattila: folds 
TonnyACE: folds 
SantiagoWeight has timed out
SantiagoWeight: folds 
KAOS914: calls $0.25
BirreteX: calls $0.15
yobbos: raises $1 to $1.25
KAOS914: calls $1
BirreteX: calls $1
*** FLOP *** [6c 7h 2h]
BirreteX: checks 
yobbos: bets $1.79
KAOS914: folds 
BirreteX: folds 
Uncalled bet ($1.79) returned to yobbos
yobbos collected $3.58 from pot
yobbos: doesn't show hand 
*** SUMMARY ***
Total pot $3.75 | Rake $0.17 
Board [6c 7h 2h]
Seat 1: KAOS914 (button) folded on the Flop
Seat 2: BirreteX (small blind) folded on the Flop
Seat 3: yobbos (big blind) collected ($3.58)
Seat 4: samioattila folded before Flop (didn't bet)
Seat 5: TonnyACE folded before Flop (didn't bet)
Seat 6: SantiagoWeight folded before Flop (didn't bet)



PokerStars Zoom Hand #195022429205:  Hold'em No Limit ($0.10/$0.25) - 2018/12/29 2:51:18 UTC [2018/12/28 21:51:18 ET]
Table 'Hydra' 6-max Seat #1 is the button
Seat 1: ckriszee ($25 in chips) 
Seat 2: FrommyBu ($27.16 in chips) 
Seat 3: benddo ($82.24 in chips) 
Seat 4: rim975 ($27.83 in chips) 
Seat 5: SantiagoWeight ($43.07 in chips) 
Seat 6: TDAK1509 ($32.39 in chips) 
FrommyBu: posts small blind $0.10
benddo: posts big blind $0.25
*** HOLE CARDS ***
Dealt to SantiagoWeight [Ac Ad]
rim975: folds 
SantiagoWeight: raises $0.37 to $0.62
TDAK1509: folds 
ckriszee: raises $1.38 to $2
FrommyBu: folds 
benddo: folds 
SantiagoWeight: raises $3.25 to $5.25
ckriszee: calls $3.25
*** FLOP *** [Qs 2c 5c]
SantiagoWeight: bets $2.59
ckriszee: calls $2.59
*** TURN *** [Qs 2c 5c] [6h]
SantiagoWeight: bets $8.25
ckriszee: raises $8.91 to $17.16 and is all-in
SantiagoWeight: calls $8.91
*** RIVER *** [Qs 2c 5c 6h] [7c]
*** SHOW DOWN ***
SantiagoWeight: shows [Ac Ad] (a pair of Aces)
ckriszee: shows [5h 4h] (a pair of Fives)
SantiagoWeight collected $48.35 from pot
*** SUMMARY ***
Total pot $50.35 | Rake $2 
Board [Qs 2c 5c 6h 7c]
Seat 1: ckriszee (button) showed [5h 4h] and lost with a pair of Fives
Seat 2: FrommyBu (small blind) folded before Flop
Seat 3: benddo (big blind) folded before Flop
Seat 4: rim975 folded before Flop (didn't bet)
Seat 5: SantiagoWeight showed [Ac Ad] and won ($48.35) with a pair of Aces
Seat 6: TDAK1509 folded before Flop (didn't bet)



PokerStars Zoom Hand #195022477687:  Hold'em No Limit ($0.10/$0.25) - 2018/12/29 2:53:28 UTC [2018/12/28 21:53:28 ET]
Table 'Hydra' 6-max Seat #1 is the button
Seat 1: simytis ($25 in chips) 
Seat 2: SapientiAA ($27.77 in chips) 
Seat 3: SantiagoWeight ($66.42 in chips) 
Seat 4: SDCMan ($25.80 in chips) 
Seat 5: hana1284 ($46.66 in chips) 
Seat 6: sZCzpNtheKot ($25 in chips) 
SapientiAA: posts small blind $0.10
SantiagoWeight: posts big blind $0.25
*** HOLE CARDS ***
Dealt to SantiagoWeight [2s 3s]
SDCMan: folds 
hana1284: folds 
sZCzpNtheKot: folds 
simytis: raises $0.25 to $0.50
SapientiAA: folds 
SantiagoWeight: calls $0.25
*** FLOP *** [Kh 6h 9s]
SantiagoWeight: checks 
simytis: bets $0.50
SantiagoWeight: folds 
Uncalled bet ($0.50) returned to simytis
simytis collected $1.05 from pot
simytis: doesn't show hand 
*** SUMMARY ***
Total pot $1.10 | Rake $0.05 
Board [Kh 6h 9s]
Seat 1: simytis (button) collected ($1.05)
Seat 2: SapientiAA (small blind) folded before Flop
Seat 3: SantiagoWeight (big blind) folded on the Flop
Seat 4: SDCMan folded before Flop (didn't bet)
Seat 5: hana1284 folded before Flop (didn't bet)
Seat 6: sZCzpNtheKot folded before Flop (didn't bet)



PokerStars Zoom Hand #195022497200:  Hold'em No Limit ($0.10/$0.25) - 2018/12/29 2:54:21 UTC [2018/12/28 21:54:21 ET]
Table 'Hydra' 6-max Seat #1 is the button
Seat 1: ivann14 ($25 in chips) 
Seat 2: !P0K3RM3T4L! ($27.94 in chips) 
Seat 3: reggiedogg31 ($112.97 in chips) 
Seat 4: pfunkolstar ($25.68 in chips) 
Seat 5: SantiagoWeight ($65.92 in chips) 
Seat 6: aa1421b ($20.90 in chips) 
!P0K3RM3T4L!: posts small blind $0.10
reggiedogg31: posts big blind $0.25
*** HOLE CARDS ***
Dealt to SantiagoWeight [6s Jh]
pfunkolstar: folds 
SantiagoWeight: folds 
aa1421b: raises $0.50 to $0.75
ivann14: folds 
!P0K3RM3T4L!: folds 
reggiedogg31: folds 
Uncalled bet ($0.50) returned to aa1421b
aa1421b collected $0.60 from pot
aa1421b: doesn't show hand 
*** SUMMARY ***
Total pot $0.60 | Rake $0 
Seat 1: ivann14 (button) folded before Flop (didn't bet)
Seat 2: !P0K3RM3T4L! (small blind) folded before Flop
Seat 3: reggiedogg31 (big blind) folded before Flop
Seat 4: pfunkolstar folded before Flop (didn't bet)
Seat 5: SantiagoWeight folded before Flop (didn't bet)
Seat 6: aa1421b collected ($0.60)



PokerStars Zoom Hand #195022501223:  Hold'em No Limit ($0.10/$0.25) - 2018/12/29 2:54:32 UTC [2018/12/28 21:54:32 ET]
Table 'Hydra' 6-max Seat #1 is the button
Seat 1: mariopork ($32.65 in chips) 
Seat 2: SantiagoWeight ($65.92 in chips) 
Seat 3: Actarusqc ($24.28 in chips) 
Seat 4: call me??107 ($26.68 in chips) 
Seat 5: osa126 ($32.85 in chips) 
Seat 6: Ryoji1029 ($17.59 in chips) 
SantiagoWeight: posts small blind $0.10
Actarusqc: posts big blind $0.25
*** HOLE CARDS ***
Dealt to SantiagoWeight [Jd 6d]
call me??107: raises $0.50 to $0.75
osa126: folds 
Ryoji1029: folds 
mariopork: folds 
SantiagoWeight: folds 
Actarusqc: calls $0.50
*** FLOP *** [Qd 7h 6h]
Actarusqc: checks 
call me??107: checks 
*** TURN *** [Qd 7h 6h] [7d]
Actarusqc: checks 
call me??107: bets $1.53
Actarusqc: calls $1.53
*** RIVER *** [Qd 7h 6h 7d] [Js]
Actarusqc: checks 
call me??107: checks 
*** SHOW DOWN ***
Actarusqc: shows [As 6c] (two pair, Sevens and Sixes)
call me??107: mucks hand 
Actarusqc collected $4.45 from pot
*** SUMMARY ***
Total pot $4.66 | Rake $0.21 
Board [Qd 7h 6h 7d Js]
Seat 1: mariopork (button) folded before Flop (didn't bet)
Seat 2: SantiagoWeight (small blind) folded before Flop
Seat 3: Actarusqc (big blind) showed [As 6c] and won ($4.45) with two pair, Sevens and Sixes
Seat 4: call me??107 mucked [3s 3c]
Seat 5: osa126 folded before Flop (didn't bet)
Seat 6: Ryoji1029 folded before Flop (didn't bet)



PokerStars Zoom Hand #195022505375:  Hold'em No Limit ($0.10/$0.25) - 2018/12/29 2:54:43 UTC [2018/12/28 21:54:43 ET]
Table 'Hydra' 6-max Seat #1 is the button
Seat 1: SantiagoWeight ($65.82 in chips) 
Seat 2: svents ($25.50 in chips) 
Seat 3: Ryoji1029 ($17.59 in chips) 
Seat 4: FrommyBu ($35.42 in chips) 
Seat 5: TQNYMQNTANA ($25 in chips) 
Seat 6: stavro88 ($37.48 in chips) 
svents: posts small blind $0.10
Ryoji1029: posts big blind $0.25
*** HOLE CARDS ***
Dealt to SantiagoWeight [Ts 6h]
FrommyBu: folds 
TQNYMQNTANA: folds 
stavro88: calls $0.25
SantiagoWeight: folds 
svents: calls $0.15
Ryoji1029: raises $1 to $1.25
stavro88: folds 
svents: folds 
Uncalled bet ($1) returned to Ryoji1029
Ryoji1029 collected $0.75 from pot
Ryoji1029: doesn't show hand 
*** SUMMARY ***
Total pot $0.75 | Rake $0 
Seat 1: SantiagoWeight (button) folded before Flop (didn't bet)
Seat 2: svents (small blind) folded before Flop
Seat 3: Ryoji1029 (big blind) collected ($0.75)
Seat 4: FrommyBu folded before Flop (didn't bet)
Seat 5: TQNYMQNTANA folded before Flop (didn't bet)
Seat 6: stavro88 folded before Flop



PokerStars Zoom Hand #195022510636:  Hold'em No Limit ($0.10/$0.25) - 2018/12/29 2:54:56 UTC [2018/12/28 21:54:56 ET]
Table 'Hydra' 6-max Seat #1 is the button
Seat 1: benddo ($77.14 in chips) 
Seat 2: Becks Baker ($26.80 in chips) 
Seat 3: trillerGTO ($24.41 in chips) 
Seat 4: Baboscrubx ($28.53 in chips) 
Seat 5: nhanminhtri ($31.71 in chips) 
Seat 6: SantiagoWeight ($65.82 in chips) 
Becks Baker: posts small blind $0.10
trillerGTO: posts big blind $0.25
*** HOLE CARDS ***
Dealt to SantiagoWeight [5d Js]
Baboscrubx: folds 
nhanminhtri: folds 
SantiagoWeight: folds 
benddo: folds 
Becks Baker: folds 
Uncalled bet ($0.15) returned to trillerGTO
trillerGTO collected $0.20 from pot
trillerGTO: doesn't show hand 
*** SUMMARY ***
Total pot $0.20 | Rake $0 
Seat 1: benddo (button) folded before Flop (didn't bet)
Seat 2: Becks Baker (small blind) folded before Flop
Seat 3: trillerGTO (big blind) collected ($0.20)
Seat 4: Baboscrubx folded before Flop (didn't bet)
Seat 5: nhanminhtri folded before Flop (didn't bet)
Seat 6: SantiagoWeight folded before Flop (didn't bet)



PokerStars Zoom Hand #195022518184:  Hold'em No Limit ($0.10/$0.25) - 2018/12/29 2:55:19 UTC [2018/12/28 21:55:19 ET]
Table 'Hydra' 6-max Seat #1 is the button
Seat 1: Lehared ($45.25 in chips) 
Seat 2: pfunkolstar ($28.92 in chips) 
Seat 3: SantiagoWeight ($65.82 in chips) 
Seat 4: stavro88 ($37.23 in chips) 
Seat 5: ckriszee ($50.76 in chips) 
Seat 6: xXBossHossXx ($25 in chips) 
pfunkolstar: posts small blind $0.10
SantiagoWeight: posts big blind $0.25
*** HOLE CARDS ***
Dealt to SantiagoWeight [4c 9d]
stavro88: calls $0.25
ckriszee: folds 
xXBossHossXx: folds 
Lehared: folds 
pfunkolstar: folds 
SantiagoWeight: checks 
*** FLOP *** [2d 8d Kh]
SantiagoWeight: checks 
stavro88: checks 
*** TURN *** [2d 8d Kh] [7d]
SantiagoWeight: bets $0.68
stavro88 has timed out
stavro88: folds 
Uncalled bet ($0.68) returned to SantiagoWeight
SantiagoWeight collected $0.57 from pot
SantiagoWeight: doesn't show hand 
*** SUMMARY ***
Total pot $0.60 | Rake $0.03 
Board [2d 8d Kh 7d]
Seat 1: Lehared (button) folded before Flop (didn't bet)
Seat 2: pfunkolstar (small blind) folded before Flop
Seat 3: SantiagoWeight (big blind) collected ($0.57)
Seat 4: stavro88 folded on the Turn
Seat 5: ckriszee folded before Flop (didn't bet)
Seat 6: xXBossHossXx folded before Flop (didn't bet)



PokerStars Zoom Hand #195022555962:  Hold'em No Limit ($0.10/$0.25) - 2018/12/29 2:57:16 UTC [2018/12/28 21:57:16 ET]
Table 'Hydra' 6-max Seat #1 is the button
Seat 1: Bujan 07 ($13.11 in chips) 
Seat 2: SapientiAA ($25 in chips) 
Seat 3: glennsterr ($22.48 in chips) 
Seat 4: Z3rbinatti ($114.91 in chips) 
Seat 5: SantiagoWeight ($66.14 in chips) 
Seat 6: Lehared ($115.21 in chips) 
SapientiAA: posts small blind $0.10
glennsterr: posts big blind $0.25
*** HOLE CARDS ***
Dealt to SantiagoWeight [7c Qh]
Z3rbinatti: folds 
SantiagoWeight: folds 
Lehared: raises $0.37 to $0.62
Bujan 07: folds 
SapientiAA: folds 
glennsterr: folds 
Uncalled bet ($0.37) returned to Lehared
Lehared collected $0.60 from pot
Lehared: doesn't show hand 
*** SUMMARY ***
Total pot $0.60 | Rake $0 
Seat 1: Bujan 07 (button) folded before Flop (didn't bet)
Seat 2: SapientiAA (small blind) folded before Flop
Seat 3: glennsterr (big blind) folded before Flop
Seat 4: Z3rbinatti folded before Flop (didn't bet)
Seat 5: SantiagoWeight folded before Flop (didn't bet)
Seat 6: Lehared collected ($0.60)



PokerStars Zoom Hand #195022558756:  Hold'em No Limit ($0.10/$0.25) - 2018/12/29 2:57:25 UTC [2018/12/28 21:57:25 ET]
Table 'Hydra' 6-max Seat #1 is the button
Seat 1: SantiagoWeight ($66.14 in chips) 
Seat 2: Chrimmpam ($16.63 in chips) 
Seat 3: zdena102 ($56.41 in chips) 
Seat 4: svents ($149.88 in chips) 
Seat 5: SapientiAA ($25 in chips) 
Seat 6: cankum ($25.64 in chips) 
Chrimmpam: posts small blind $0.10
zdena102: posts big blind $0.25
*** HOLE CARDS ***
Dealt to SantiagoWeight [Ah 7h]
svents: raises $0.30 to $0.55
SapientiAA: folds 
cankum: folds 
SantiagoWeight: calls $0.55
Chrimmpam: calls $0.45
zdena102: calls $0.30
*** FLOP *** [2h Ks Th]
Chrimmpam: checks 
zdena102: checks 
svents: checks 
SantiagoWeight: bets $1.50
Chrimmpam: folds 
zdena102: folds 
svents: calls $1.50
*** TURN *** [2h Ks Th] [7c]
svents: checks 
SantiagoWeight: bets $4.20
svents: calls $4.20
*** RIVER *** [2h Ks Th 7c] [Tc]
svents: checks 
SantiagoWeight: bets $17.20
svents: folds 
Uncalled bet ($17.20) returned to SantiagoWeight
SantiagoWeight collected $12.99 from pot
SantiagoWeight: doesn't show hand 
*** SUMMARY ***
Total pot $13.60 | Rake $0.61 
Board [2h Ks Th 7c Tc]
Seat 1: SantiagoWeight (button) collected ($12.99)
Seat 2: Chrimmpam (small blind) folded on the Flop
Seat 3: zdena102 (big blind) folded on the Flop
Seat 4: svents folded on the River
Seat 5: SapientiAA folded before Flop (didn't bet)
Seat 6: cankum folded before Flop (didn't bet)



PokerStars Zoom Hand #195022584368:  Hold'em No Limit ($0.10/$0.25) - 2018/12/29 2:58:46 UTC [2018/12/28 21:58:46 ET]
Table 'Hydra' 6-max Seat #1 is the button
Seat 1: ryanking99 ($29.26 in chips) 
Seat 2: SantiagoWeight ($72.88 in chips) 
Seat 3: 6a6JI0 ($8.79 in chips) 
Seat 4: theman120294 ($46.44 in chips) 
Seat 5: ckriszee ($45.81 in chips) 
Seat 6: MISTAAJ ($49.28 in chips) 
SantiagoWeight: posts small blind $0.10
6a6JI0: posts big blind $0.25
*** HOLE CARDS ***
Dealt to SantiagoWeight [7d Kh]
theman120294: folds 
ckriszee: folds 
MISTAAJ: raises $0.50 to $0.75
ryanking99: folds 
SantiagoWeight: folds 
6a6JI0: folds 
Uncalled bet ($0.50) returned to MISTAAJ
MISTAAJ collected $0.60 from pot
MISTAAJ: doesn't show hand 
*** SUMMARY ***
Total pot $0.60 | Rake $0 
Seat 1: ryanking99 (button) folded before Flop (didn't bet)
Seat 2: SantiagoWeight (small blind) folded before Flop
Seat 3: 6a6JI0 (big blind) folded before Flop
Seat 4: theman120294 folded before Flop (didn't bet)
Seat 5: ckriszee folded before Flop (didn't bet)
Seat 6: MISTAAJ collected ($0.60)



PokerStars Zoom Hand #195022591883:  Hold'em No Limit ($0.10/$0.25) - 2018/12/29 2:59:10 UTC [2018/12/28 21:59:10 ET]
Table 'Hydra' 6-max Seat #1 is the button
Seat 1: mariopork ($30.28 in chips) 
Seat 2: FrommyBu ($33.55 in chips) 
Seat 3: _BluDeeN_ ($24.65 in chips) 
Seat 4: zhang1zhang ($25 in chips) 
Seat 5: idontnownow ($68.88 in chips) 
Seat 6: SantiagoWeight ($72.78 in chips) 
FrommyBu: posts small blind $0.10
_BluDeeN_: posts big blind $0.25
*** HOLE CARDS ***
Dealt to SantiagoWeight [Kd 8s]
zhang1zhang: folds 
idontnownow: folds 
SantiagoWeight: raises $0.30 to $0.55
mariopork: folds 
FrommyBu: raises $1.85 to $2.40
_BluDeeN_: folds 
SantiagoWeight: folds 
Uncalled bet ($1.85) returned to FrommyBu
FrommyBu collected $1.35 from pot
FrommyBu: doesn't show hand 
*** SUMMARY ***
Total pot $1.35 | Rake $0 
Seat 1: mariopork (button) folded before Flop (didn't bet)
Seat 2: FrommyBu (small blind) collected ($1.35)
Seat 3: _BluDeeN_ (big blind) folded before Flop
Seat 4: zhang1zhang folded before Flop (didn't bet)
Seat 5: idontnownow folded before Flop (didn't bet)
Seat 6: SantiagoWeight folded before Flop



PokerStars Zoom Hand #195022602736:  Hold'em No Limit ($0.10/$0.25) - 2018/12/29 2:59:44 UTC [2018/12/28 21:59:44 ET]
Table 'Hydra' 6-max Seat #1 is the button
Seat 1: senzorul69 ($26.36 in chips) 
Seat 2: Z3rbinatti ($115.38 in chips) 
Seat 3: TQNYMQNTANA ($25 in chips) 
Seat 4: SantiagoWeight ($72.23 in chips) 
Seat 5: winwinboy ($31.99 in chips) 
Seat 6: MeDoubleJ ($25 in chips) 
Z3rbinatti: posts small blind $0.10
TQNYMQNTANA: posts big blind $0.25
*** HOLE CARDS ***
Dealt to SantiagoWeight [3s 6c]
SantiagoWeight: folds 
winwinboy: folds 
MeDoubleJ: folds 
senzorul69: folds 
Z3rbinatti: raises $0.37 to $0.62
TQNYMQNTANA: folds 
Uncalled bet ($0.37) returned to Z3rbinatti
Z3rbinatti collected $0.50 from pot
Z3rbinatti: doesn't show hand 
*** SUMMARY ***
Total pot $0.50 | Rake $0 
Seat 1: senzorul69 (button) folded before Flop (didn't bet)
Seat 2: Z3rbinatti (small blind) collected ($0.50)
Seat 3: TQNYMQNTANA (big blind) folded before Flop
Seat 4: SantiagoWeight folded before Flop (didn't bet)
Seat 5: winwinboy folded before Flop (didn't bet)
Seat 6: MeDoubleJ folded before Flop (didn't bet)



PokerStars Zoom Hand #195022601131:  Hold'em No Limit ($0.10/$0.25) - 2018/12/29 2:59:39 UTC [2018/12/28 21:59:39 ET]
Table 'Hydra' 6-max Seat #1 is the button
Seat 1: 173fish ($31.33 in chips) 
Seat 2: Bujan 07 ($12.22 in chips) 
Seat 3: FrommyBu ($34.35 in chips) 
Seat 4: SantiagoWeight ($72.23 in chips) 
Seat 5: myrtasaTR ($25 in chips) 
Seat 6: Fujfuj_Mele ($13.79 in chips) 
Bujan 07: posts small blind $0.10
FrommyBu: posts big blind $0.25
*** HOLE CARDS ***
Dealt to SantiagoWeight [Jd 2c]
SantiagoWeight: folds 
myrtasaTR: folds 
Fujfuj_Mele: folds 
173fish: raises $0.50 to $0.75
Bujan 07: folds 
FrommyBu: folds 
Uncalled bet ($0.50) returned to 173fish
173fish collected $0.60 from pot
173fish: doesn't show hand 
*** SUMMARY ***
Total pot $0.60 | Rake $0 
Seat 1: 173fish (button) collected ($0.60)
Seat 2: Bujan 07 (small blind) folded before Flop
Seat 3: FrommyBu (big blind) folded before Flop
Seat 4: SantiagoWeight folded before Flop (didn't bet)
Seat 5: myrtasaTR folded before Flop (didn't bet)
Seat 6: Fujfuj_Mele folded before Flop (didn't bet)



PokerStars Zoom Hand #195022604871:  Hold'em No Limit ($0.10/$0.25) - 2018/12/29 2:59:52 UTC [2018/12/28 21:59:52 ET]
Table 'Hydra' 6-max Seat #1 is the button
Seat 1: GrandmasterY ($25 in chips) 
Seat 2: Cryptoz91 ($40.21 in chips) 
Seat 3: samioattila ($53.97 in chips) 
Seat 4: SantiagoWeight ($72.23 in chips) 
Seat 5: cankum ($25 in chips) 
Seat 6: _BluDeeN_ ($28.84 in chips) 
Cryptoz91: posts small blind $0.10
samioattila: posts big blind $0.25
*** HOLE CARDS ***
Dealt to SantiagoWeight [9c 2d]
SantiagoWeight: folds 
cankum: folds 
_BluDeeN_: raises $0.50 to $0.75
GrandmasterY: folds 
Cryptoz91: folds 
samioattila: folds 
Uncalled bet ($0.50) returned to _BluDeeN_
_BluDeeN_ collected $0.60 from pot
_BluDeeN_: doesn't show hand 
*** SUMMARY ***
Total pot $0.60 | Rake $0 
Seat 1: GrandmasterY (button) folded before Flop (didn't bet)
Seat 2: Cryptoz91 (small blind) folded before Flop
Seat 3: samioattila (big blind) folded before Flop
Seat 4: SantiagoWeight folded before Flop (didn't bet)
Seat 5: cankum folded before Flop (didn't bet)
Seat 6: _BluDeeN_ collected ($0.60)



PokerStars Zoom Hand #195022607461:  Hold'em No Limit ($0.10/$0.25) - 2018/12/29 2:59:59 UTC [2018/12/28 21:59:59 ET]
Table 'Hydra' 6-max Seat #1 is the button
Seat 1: !P0K3RM3T4L! ($25.25 in chips) 
Seat 2: benddo ($83.78 in chips) 
Seat 3: SantiagoWeight ($72.23 in chips) 
Seat 4: Baboscrubx ($31.55 in chips) 
Seat 5: ivann14 ($52.02 in chips) 
Seat 6: mariopork ($30.80 in chips) 
benddo: posts small blind $0.10
SantiagoWeight: posts big blind $0.25
*** HOLE CARDS ***
Dealt to SantiagoWeight [Qc 5d]
Baboscrubx: folds 
ivann14: folds 
mariopork: raises $0.37 to $0.62
!P0K3RM3T4L!: raises $1.17 to $1.79
benddo: folds 
SantiagoWeight: folds 
mariopork: folds 
Uncalled bet ($1.17) returned to !P0K3RM3T4L!
!P0K3RM3T4L! collected $1.59 from pot
!P0K3RM3T4L!: doesn't show hand 
*** SUMMARY ***
Total pot $1.59 | Rake $0 
Seat 1: !P0K3RM3T4L! (button) collected ($1.59)
Seat 2: benddo (small blind) folded before Flop
Seat 3: SantiagoWeight (big blind) folded before Flop
Seat 4: Baboscrubx folded before Flop (didn't bet)
Seat 5: ivann14 folded before Flop (didn't bet)
Seat 6: mariopork folded before Flop



PokerStars Zoom Hand #195022614300:  Hold'em No Limit ($0.10/$0.25) - 2018/12/29 3:00:21 UTC [2018/12/28 22:00:21 ET]
Table 'Hydra' 6-max Seat #1 is the button
Seat 1: aloominat ($18.50 in chips) 
Seat 2: SantiagoWeight ($71.98 in chips) 
Seat 3: anorectal ($57.33 in chips) 
Seat 4: TQNYMQNTANA ($25 in chips) 
Seat 5: cankum ($25.02 in chips) 
Seat 6: ryanking99 ($28.56 in chips) 
SantiagoWeight: posts small blind $0.10
anorectal: posts big blind $0.25
*** HOLE CARDS ***
Dealt to SantiagoWeight [5c Ad]
TQNYMQNTANA: folds 
cankum: folds 
ryanking99: folds 
aloominat: folds 
SantiagoWeight: raises $0.50 to $0.75
anorectal: calls $0.50
*** FLOP *** [Qd 2c 7c]
SantiagoWeight: checks 
anorectal: checks 
*** TURN *** [Qd 2c 7c] [7h]
SantiagoWeight: checks 
anorectal: checks 
*** RIVER *** [Qd 2c 7c 7h] [2s]
SantiagoWeight: checks 
anorectal: checks 
*** SHOW DOWN ***
SantiagoWeight: shows [5c Ad] (two pair, Sevens and Deuces)
anorectal: mucks hand 
SantiagoWeight collected $1.43 from pot
*** SUMMARY ***
Total pot $1.50 | Rake $0.07 
Board [Qd 2c 7c 7h 2s]
Seat 1: aloominat (button) folded before Flop (didn't bet)
Seat 2: SantiagoWeight (small blind) showed [5c Ad] and won ($1.43) with two pair, Sevens and Deuces
Seat 3: anorectal (big blind) mucked [Jh 6h]
Seat 4: TQNYMQNTANA folded before Flop (didn't bet)
Seat 5: cankum folded before Flop (didn't bet)
Seat 6: ryanking99 folded before Flop (didn't bet)



PokerStars Zoom Hand #195022630716:  Hold'em No Limit ($0.10/$0.25) - 2018/12/29 3:01:09 UTC [2018/12/28 22:01:09 ET]
Table 'Hydra' 6-max Seat #1 is the button
Seat 1: Xp0Hb ($24.09 in chips) 
Seat 2: RandomWalk77 ($53.46 in chips) 
Seat 3: mihai_f1986 ($32.65 in chips) 
Seat 4: ckriszee ($25.10 in chips) 
Seat 5: davidhw888 ($27.17 in chips) 
Seat 6: SantiagoWeight ($72.66 in chips) 
RandomWalk77: posts small blind $0.10
mihai_f1986: posts big blind $0.25
*** HOLE CARDS ***
Dealt to SantiagoWeight [5s 8s]
ckriszee: raises $0.35 to $0.60
davidhw888: folds 
SantiagoWeight: folds 
Xp0Hb: folds 
RandomWalk77: folds 
mihai_f1986: folds 
Uncalled bet ($0.35) returned to ckriszee
ckriszee collected $0.60 from pot
ckriszee: doesn't show hand 
*** SUMMARY ***
Total pot $0.60 | Rake $0 
Seat 1: Xp0Hb (button) folded before Flop (didn't bet)
Seat 2: RandomWalk77 (small blind) folded before Flop
Seat 3: mihai_f1986 (big blind) folded before Flop
Seat 4: ckriszee collected ($0.60)
Seat 5: davidhw888 folded before Flop (didn't bet)
Seat 6: SantiagoWeight folded before Flop (didn't bet)



PokerStars Zoom Hand #195022636374:  Hold'em No Limit ($0.10/$0.25) - 2018/12/29 3:01:25 UTC [2018/12/28 22:01:25 ET]
Table 'Hydra' 6-max Seat #1 is the button
Seat 1: SantiagoWeight ($72.66 in chips) 
Seat 2: BärbärKush ($39.21 in chips) 
Seat 3: tightpokerAA ($35.47 in chips) 
Seat 4: garcezinho19 ($15.95 in chips) 
Seat 5: davidhw888 ($43.53 in chips) 
Seat 6: FrommyBu ($33.75 in chips) 
BärbärKush: posts small blind $0.10
tightpokerAA: posts big blind $0.25
*** HOLE CARDS ***
Dealt to SantiagoWeight [9s 3d]
garcezinho19: folds 
davidhw888: folds 
FrommyBu: folds 
SantiagoWeight: folds 
BärbärKush: raises $0.50 to $0.75
tightpokerAA: folds 
Uncalled bet ($0.50) returned to BärbärKush
BärbärKush collected $0.50 from pot
BärbärKush: doesn't show hand 
*** SUMMARY ***
Total pot $0.50 | Rake $0 
Seat 1: SantiagoWeight (button) folded before Flop (didn't bet)
Seat 2: BärbärKush (small blind) collected ($0.50)
Seat 3: tightpokerAA (big blind) folded before Flop
Seat 4: garcezinho19 folded before Flop (didn't bet)
Seat 5: davidhw888 folded before Flop (didn't bet)
Seat 6: FrommyBu folded before Flop (didn't bet)



PokerStars Zoom Hand #195022644250:  Hold'em No Limit ($0.10/$0.25) - 2018/12/29 3:01:47 UTC [2018/12/28 22:01:47 ET]
Table 'Hydra' 6-max Seat #1 is the button
Seat 1: FrommyBu ($33.75 in chips) 
Seat 2: tightpokerAA ($35.22 in chips) 
Seat 3: davidhw888 ($33.71 in chips) 
Seat 4: aloominat ($18.50 in chips) 
Seat 5: SantiagoWeight ($72.41 in chips) 
Seat 6: TQNYMQNTANA ($25.88 in chips) 
tightpokerAA: posts small blind $0.10
davidhw888: posts big blind $0.25
*** HOLE CARDS ***
Dealt to SantiagoWeight [Ks Jd]
aloominat: folds 
SantiagoWeight: raises $0.37 to $0.62
TQNYMQNTANA: folds 
FrommyBu: folds 
tightpokerAA: folds 
davidhw888: folds 
Uncalled bet ($0.37) returned to SantiagoWeight
SantiagoWeight collected $0.60 from pot
SantiagoWeight: doesn't show hand 
*** SUMMARY ***
Total pot $0.60 | Rake $0 
Seat 1: FrommyBu (button) folded before Flop (didn't bet)
Seat 2: tightpokerAA (small blind) folded before Flop
Seat 3: davidhw888 (big blind) folded before Flop
Seat 4: aloominat folded before Flop (didn't bet)
Seat 5: SantiagoWeight collected ($0.60)
Seat 6: TQNYMQNTANA folded before Flop (didn't bet)



PokerStars Zoom Hand #195022639300:  Hold'em No Limit ($0.10/$0.25) - 2018/12/29 3:01:33 UTC [2018/12/28 22:01:33 ET]
Table 'Hydra' 6-max Seat #1 is the button
Seat 1: Jack123985 ($25 in chips) 
Seat 2: KAOS914 ($31.41 in chips) 
Seat 3: SantiagoWeight ($72.66 in chips) 
Seat 4: davidhw888 ($33.81 in chips) 
Seat 5: svents ($66.16 in chips) 
Seat 6: donmarc777 ($22.89 in chips) 
KAOS914: posts small blind $0.10
SantiagoWeight: posts big blind $0.25
*** HOLE CARDS ***
Dealt to SantiagoWeight [4d 5c]
davidhw888: folds 
svents: raises $0.30 to $0.55
donmarc777: calls $0.55
Jack123985: folds 
KAOS914: calls $0.45
SantiagoWeight: folds 
*** FLOP *** [Ks 6h Ts]
KAOS914: bets $1
svents: calls $1
donmarc777: calls $1
*** TURN *** [Ks 6h Ts] [Kd]
KAOS914: checks 
svents: checks 
donmarc777: checks 
*** RIVER *** [Ks 6h Ts Kd] [Tc]
KAOS914: checks 
svents: bets $3.51
donmarc777: folds 
KAOS914: folds 
Uncalled bet ($3.51) returned to svents
svents collected $4.68 from pot
svents: doesn't show hand 
*** SUMMARY ***
Total pot $4.90 | Rake $0.22 
Board [Ks 6h Ts Kd Tc]
Seat 1: Jack123985 (button) folded before Flop (didn't bet)
Seat 2: KAOS914 (small blind) folded on the River
Seat 3: SantiagoWeight (big blind) folded before Flop
Seat 4: davidhw888 folded before Flop (didn't bet)
Seat 5: svents collected ($4.68)
Seat 6: donmarc777 folded on the River



PokerStars Zoom Hand #195022651263:  Hold'em No Limit ($0.10/$0.25) - 2018/12/29 3:02:07 UTC [2018/12/28 22:02:07 ET]
Table 'Hydra' 6-max Seat #1 is the button
Seat 1: samioattila ($51.72 in chips) 
Seat 2: SantiagoWeight ($72.76 in chips) 
Seat 3: 1ownYourUsd ($32.66 in chips) 
Seat 4: franco373513 ($18.41 in chips) 
Seat 5: benddo ($71.19 in chips) 
Seat 6: _BluDeeN_ ($23.48 in chips) 
SantiagoWeight: posts small blind $0.10
1ownYourUsd: posts big blind $0.25
*** HOLE CARDS ***
Dealt to SantiagoWeight [2c 6c]
franco373513: folds 
benddo: raises $0.50 to $0.75
_BluDeeN_: raises $1.85 to $2.60
samioattila: folds 
SantiagoWeight: folds 
1ownYourUsd: folds 
benddo: folds 
Uncalled bet ($1.85) returned to _BluDeeN_
_BluDeeN_ collected $1.85 from pot
_BluDeeN_: doesn't show hand 
*** SUMMARY ***
Total pot $1.85 | Rake $0 
Seat 1: samioattila (button) folded before Flop (didn't bet)
Seat 2: SantiagoWeight (small blind) folded before Flop
Seat 3: 1ownYourUsd (big blind) folded before Flop
Seat 4: franco373513 folded before Flop (didn't bet)
Seat 5: benddo folded before Flop
Seat 6: _BluDeeN_ collected ($1.85)



PokerStars Zoom Hand #195022655997:  Hold'em No Limit ($0.10/$0.25) - 2018/12/29 3:02:19 UTC [2018/12/28 22:02:19 ET]
Table 'Hydra' 6-max Seat #1 is the button
Seat 1: donmarc777 ($21.34 in chips) 
Seat 2: RandomWalk77 ($48.08 in chips) 
Seat 3: _BluDeeN_ ($29.87 in chips) 
Seat 4: assassin0875 ($186.37 in chips) 
Seat 5: ludisima ($51.40 in chips) 
Seat 6: SantiagoWeight ($72.66 in chips) 
RandomWalk77: posts small blind $0.10
_BluDeeN_: posts big blind $0.25
*** HOLE CARDS ***
Dealt to SantiagoWeight [9d 2s]
assassin0875: folds 
ludisima: folds 
SantiagoWeight: folds 
donmarc777: raises $0.25 to $0.50
RandomWalk77: folds 
_BluDeeN_: folds 
Uncalled bet ($0.25) returned to donmarc777
donmarc777 collected $0.60 from pot
donmarc777: doesn't show hand 
*** SUMMARY ***
Total pot $0.60 | Rake $0 
Seat 1: donmarc777 (button) collected ($0.60)
Seat 2: RandomWalk77 (small blind) folded before Flop
Seat 3: _BluDeeN_ (big blind) folded before Flop
Seat 4: assassin0875 folded before Flop (didn't bet)
Seat 5: ludisima folded before Flop (didn't bet)
Seat 6: SantiagoWeight folded before Flop (didn't bet)



PokerStars Zoom Hand #195022649076:  Hold'em No Limit ($0.10/$0.25) - 2018/12/29 3:02:00 UTC [2018/12/28 22:02:00 ET]
Table 'Hydra' 6-max Seat #1 is the button
Seat 1: qing328 ($23.15 in chips) 
Seat 2: samioattila ($36.19 in chips) 
Seat 3: Dr.Jekyll197 ($16.01 in chips) 
Seat 4: SantiagoWeight ($72.76 in chips) 
Seat 5: mariopork ($25.45 in chips) 
Seat 6: negreanuNya ($28.63 in chips) 
samioattila: posts small blind $0.10
Dr.Jekyll197: posts big blind $0.25
*** HOLE CARDS ***
Dealt to SantiagoWeight [Ks 5h]
SantiagoWeight: folds 
mariopork: folds 
negreanuNya: folds 
qing328: folds 
samioattila: raises $0.50 to $0.75
Dr.Jekyll197: calls $0.50
*** FLOP *** [7c Kc 4h]
samioattila: checks 
Dr.Jekyll197: checks 
*** TURN *** [7c Kc 4h] [Ah]
samioattila: checks 
Dr.Jekyll197: checks 
*** RIVER *** [7c Kc 4h Ah] [3s]
samioattila: checks 
Dr.Jekyll197: bets $1.24
samioattila: calls $1.24
*** SHOW DOWN ***
Dr.Jekyll197: shows [As 6s] (a pair of Aces)
samioattila: mucks hand 
Dr.Jekyll197 collected $3.80 from pot
*** SUMMARY ***
Total pot $3.98 | Rake $0.18 
Board [7c Kc 4h Ah 3s]
Seat 1: qing328 (button) folded before Flop (didn't bet)
Seat 2: samioattila (small blind) mucked [8h 8d]
Seat 3: Dr.Jekyll197 (big blind) showed [As 6s] and won ($3.80) with a pair of Aces
Seat 4: SantiagoWeight folded before Flop (didn't bet)
Seat 5: mariopork folded before Flop (didn't bet)
Seat 6: negreanuNya folded before Flop (didn't bet)



PokerStars Zoom Hand #195022659677:  Hold'em No Limit ($0.10/$0.25) - 2018/12/29 3:02:29 UTC [2018/12/28 22:02:29 ET]
Table 'Hydra' 6-max Seat #1 is the button
Seat 1: ryanking99 ($44.45 in chips) 
Seat 2: sZCzpNtheKot ($43.59 in chips) 
Seat 3: MileVoliD49 ($64.16 in chips) 
Seat 4: GrandmasterY ($25 in chips) 
Seat 5: SantiagoWeight ($72.66 in chips) 
Seat 6: Alehan-ev ($25 in chips) 
sZCzpNtheKot: posts small blind $0.10
MileVoliD49: posts big blind $0.25
*** HOLE CARDS ***
Dealt to SantiagoWeight [4h 4s]
GrandmasterY: folds 
SantiagoWeight: raises $0.37 to $0.62
Alehan-ev: folds 
ryanking99: folds 
sZCzpNtheKot: folds 
MileVoliD49: calls $0.37
*** FLOP *** [Qc Ks Jc]
MileVoliD49: checks 
SantiagoWeight: bets $1.28
MileVoliD49: folds 
Uncalled bet ($1.28) returned to SantiagoWeight
SantiagoWeight collected $1.28 from pot
SantiagoWeight: doesn't show hand 
*** SUMMARY ***
Total pot $1.34 | Rake $0.06 
Board [Qc Ks Jc]
Seat 1: ryanking99 (button) folded before Flop (didn't bet)
Seat 2: sZCzpNtheKot (small blind) folded before Flop
Seat 3: MileVoliD49 (big blind) folded on the Flop
Seat 4: GrandmasterY folded before Flop (didn't bet)
Seat 5: SantiagoWeight collected ($1.28)
Seat 6: Alehan-ev folded before Flop (didn't bet)



PokerStars Zoom Hand #195022671835:  Hold'em No Limit ($0.10/$0.25) - 2018/12/29 3:03:02 UTC [2018/12/28 22:03:02 ET]
Table 'Hydra' 6-max Seat #1 is the button
Seat 1: ckriszee ($28.13 in chips) 
Seat 2: gabrielle674 ($18.32 in chips) 
Seat 3: SantiagoWeight ($73.32 in chips) 
Seat 4: myrtasaTR ($25 in chips) 
Seat 5: mariopork ($29.21 in chips) 
Seat 6: TQNYMQNTANA ($31.79 in chips) 
gabrielle674: posts small blind $0.10
SantiagoWeight: posts big blind $0.25
*** HOLE CARDS ***
Dealt to SantiagoWeight [Js 7h]
myrtasaTR: folds 
mariopork: folds 
TQNYMQNTANA: folds 
ckriszee: folds 
gabrielle674: folds 
Uncalled bet ($0.15) returned to SantiagoWeight
SantiagoWeight collected $0.20 from pot
SantiagoWeight: doesn't show hand 
*** SUMMARY ***
Total pot $0.20 | Rake $0 
Seat 1: ckriszee (button) folded before Flop (didn't bet)
Seat 2: gabrielle674 (small blind) folded before Flop
Seat 3: SantiagoWeight (big blind) collected ($0.20)
Seat 4: myrtasaTR folded before Flop (didn't bet)
Seat 5: mariopork folded before Flop (didn't bet)
Seat 6: TQNYMQNTANA folded before Flop (didn't bet)



PokerStars Zoom Hand #195022675889:  Hold'em No Limit ($0.10/$0.25) - 2018/12/29 3:03:13 UTC [2018/12/28 22:03:13 ET]
Table 'Hydra' 6-max Seat #1 is the button
Seat 1: _BluDeeN_ ($35.34 in chips) 
Seat 2: seba6688 ($22.08 in chips) 
Seat 3: anlu0803 ($21.95 in chips) 
Seat 4: SantiagoWeight ($73.42 in chips) 
Seat 5: ckriszee ($28.13 in chips) 
Seat 6: davidhw888 ($28.64 in chips) 
seba6688: posts small blind $0.10
anlu0803: posts big blind $0.25
*** HOLE CARDS ***
Dealt to SantiagoWeight [5s 9d]
SantiagoWeight: folds 
ckriszee: folds 
davidhw888: folds 
_BluDeeN_: folds 
seba6688: raises $0.25 to $0.50
anlu0803: folds 
Uncalled bet ($0.25) returned to seba6688
seba6688 collected $0.50 from pot
seba6688: doesn't show hand 
*** SUMMARY ***
Total pot $0.50 | Rake $0 
Seat 1: _BluDeeN_ (button) folded before Flop (didn't bet)
Seat 2: seba6688 (small blind) collected ($0.50)
Seat 3: anlu0803 (big blind) folded before Flop
Seat 4: SantiagoWeight folded before Flop (didn't bet)
Seat 5: ckriszee folded before Flop (didn't bet)
Seat 6: davidhw888 folded before Flop (didn't bet)



PokerStars Zoom Hand #195022658242:  Hold'em No Limit ($0.10/$0.25) - 2018/12/29 3:02:26 UTC [2018/12/28 22:02:26 ET]
Table 'Hydra' 6-max Seat #1 is the button
Seat 1: SantiagoWeight ($72.66 in chips) 
Seat 2: naxizzle ($120.51 in chips) 
Seat 3: _BluDeeN_ ($27.20 in chips) 
Seat 4: trillerGTO ($34.49 in chips) 
Seat 5: mihai_f1986 ($32.75 in chips) 
Seat 6: KAOS914 ($29.86 in chips) 
naxizzle: posts small blind $0.10
_BluDeeN_: posts big blind $0.25
*** HOLE CARDS ***
Dealt to SantiagoWeight [8s 6h]
trillerGTO: raises $0.50 to $0.75
mihai_f1986: calls $0.75
KAOS914: calls $0.75
SantiagoWeight: folds 
naxizzle: calls $0.65
_BluDeeN_: folds 
*** FLOP *** [Th 7d Tc]
naxizzle: checks 
trillerGTO: checks 
mihai_f1986: checks 
KAOS914: bets $1.55
naxizzle: folds 
trillerGTO: calls $1.55
mihai_f1986: folds 
*** TURN *** [Th 7d Tc] [6c]
trillerGTO: checks 
KAOS914: checks 
*** RIVER *** [Th 7d Tc 6c] [3s]
trillerGTO: bets $4.30
KAOS914: raises $23.26 to $27.56 and is all-in
trillerGTO: folds 
Uncalled bet ($23.26) returned to KAOS914
KAOS914 collected $14.28 from pot
KAOS914: doesn't show hand 
*** SUMMARY ***
Total pot $14.95 | Rake $0.67 
Board [Th 7d Tc 6c 3s]
Seat 1: SantiagoWeight (button) folded before Flop (didn't bet)
Seat 2: naxizzle (small blind) folded on the Flop
Seat 3: _BluDeeN_ (big blind) folded before Flop
Seat 4: trillerGTO folded on the River
Seat 5: mihai_f1986 folded on the Flop
Seat 6: KAOS914 collected ($14.28)



PokerStars Zoom Hand #195022683967:  Hold'em No Limit ($0.10/$0.25) - 2018/12/29 3:03:36 UTC [2018/12/28 22:03:36 ET]
Table 'Hydra' 6-max Seat #1 is the button
Seat 1: Rollout2018 ($14.55 in chips) 
Seat 2: SantiagoWeight ($73.42 in chips) 
Seat 3: yobbos ($53.50 in chips) 
Seat 4: TDAK1509 ($61.55 in chips) 
Seat 5: BärbärKush ($48.10 in chips) 
Seat 6: trillerGTO ($21.03 in chips) 
SantiagoWeight: posts small blind $0.10
yobbos: posts big blind $0.25
*** HOLE CARDS ***
Dealt to SantiagoWeight [6d 2s]
TDAK1509: folds 
BärbärKush: folds 
trillerGTO: folds 
Rollout2018: raises $0.50 to $0.75
SantiagoWeight: folds 
yobbos: calls $0.50
*** FLOP *** [3s Jh 3c]
yobbos: checks 
Rollout2018: bets $1
yobbos: folds 
Uncalled bet ($1) returned to Rollout2018
Rollout2018 collected $1.53 from pot
Rollout2018: doesn't show hand 
*** SUMMARY ***
Total pot $1.60 | Rake $0.07 
Board [3s Jh 3c]
Seat 1: Rollout2018 (button) collected ($1.53)
Seat 2: SantiagoWeight (small blind) folded before Flop
Seat 3: yobbos (big blind) folded on the Flop
Seat 4: TDAK1509 folded before Flop (didn't bet)
Seat 5: BärbärKush folded before Flop (didn't bet)
Seat 6: trillerGTO folded before Flop (didn't bet)



PokerStars Zoom Hand #195022681099:  Hold'em No Limit ($0.10/$0.25) - 2018/12/29 3:03:27 UTC [2018/12/28 22:03:27 ET]
Table 'Hydra' 6-max Seat #1 is the button
Seat 1: simytis ($37.80 in chips) 
Seat 2: Jack123985 ($26.10 in chips) 
Seat 3: Buntar017 ($108.23 in chips) 
Seat 4: _BluDeeN_ ($28.52 in chips) 
Seat 5: Doomdigidoom ($16.07 in chips) 
Seat 6: SantiagoWeight ($73.42 in chips) 
Jack123985: posts small blind $0.10
Buntar017: posts big blind $0.25
*** HOLE CARDS ***
Dealt to SantiagoWeight [Qs 7c]
_BluDeeN_: folds 
Doomdigidoom: folds 
SantiagoWeight: folds 
simytis: folds 
Jack123985: raises $0.50 to $0.75
Buntar017: calls $0.50
*** FLOP *** [Qh 7s 5h]
Jack123985: bets $0.88
Buntar017: calls $0.88
*** TURN *** [Qh 7s 5h] [3h]
Jack123985: checks 
Buntar017: bets $1.50
Jack123985: calls $1.50
*** RIVER *** [Qh 7s 5h 3h] [Ah]
Jack123985: checks 
Buntar017: checks 
*** SHOW DOWN ***
Jack123985: shows [Th Qc] (a flush, Ace high)
Buntar017: mucks hand 
Jack123985 collected $5.98 from pot
*** SUMMARY ***
Total pot $6.26 | Rake $0.28 
Board [Qh 7s 5h 3h Ah]
Seat 1: simytis (button) folded before Flop (didn't bet)
Seat 2: Jack123985 (small blind) showed [Th Qc] and won ($5.98) with a flush, Ace high
Seat 3: Buntar017 (big blind) mucked [6d As]
Seat 4: _BluDeeN_ folded before Flop (didn't bet)
Seat 5: Doomdigidoom folded before Flop (didn't bet)
Seat 6: SantiagoWeight folded before Flop (didn't bet)



PokerStars Zoom Hand #195022685818:  Hold'em No Limit ($0.10/$0.25) - 2018/12/29 3:03:40 UTC [2018/12/28 22:03:40 ET]
Table 'Hydra' 6-max Seat #1 is the button
Seat 1: IceAgeDream7 ($115.72 in chips) 
Seat 2: mariopork ($30.21 in chips) 
Seat 3: SantiagoWeight ($73.32 in chips) 
Seat 4: stavro88 ($26.37 in chips) 
Seat 5: GrandmasterY ($25 in chips) 
Seat 6: negreanuNya ($29.93 in chips) 
mariopork: posts small blind $0.10
SantiagoWeight: posts big blind $0.25
*** HOLE CARDS ***
Dealt to SantiagoWeight [Ts 5d]
stavro88: calls $0.25
GrandmasterY: folds 
negreanuNya: folds 
IceAgeDream7: folds 
mariopork: calls $0.15
SantiagoWeight: checks 
*** FLOP *** [7s Ad 9s]
mariopork: checks 
SantiagoWeight: checks 
stavro88: bets $1.50
mariopork: folds 
SantiagoWeight: folds 
Uncalled bet ($1.50) returned to stavro88
stavro88 collected $0.72 from pot
stavro88: doesn't show hand 
*** SUMMARY ***
Total pot $0.75 | Rake $0.03 
Board [7s Ad 9s]
Seat 1: IceAgeDream7 (button) folded before Flop (didn't bet)
Seat 2: mariopork (small blind) folded on the Flop
Seat 3: SantiagoWeight (big blind) folded on the Flop
Seat 4: stavro88 collected ($0.72)
Seat 5: GrandmasterY folded before Flop (didn't bet)
Seat 6: negreanuNya folded before Flop (didn't bet)



PokerStars Zoom Hand #195022708500:  Hold'em No Limit ($0.10/$0.25) - 2018/12/29 3:04:43 UTC [2018/12/28 22:04:43 ET]
Table 'Hydra' 6-max Seat #1 is the button
Seat 1: SantiagoWeight ($73.07 in chips) 
Seat 2: _BluDeeN_ ($28.52 in chips) 
Seat 3: Jack123985 ($28.95 in chips) 
Seat 4: BIGPAIN14 ($62.50 in chips) 
Seat 5: gamoniusz ($45.75 in chips) 
Seat 6: Lehared ($46.90 in chips) 
_BluDeeN_: posts small blind $0.10
Jack123985: posts big blind $0.25
*** HOLE CARDS ***
Dealt to SantiagoWeight [Ts 8d]
BIGPAIN14: folds 
gamoniusz: raises $0.25 to $0.50
Lehared: folds 
SantiagoWeight: folds 
_BluDeeN_: folds 
Jack123985: raises $1.75 to $2.25
gamoniusz: folds 
Uncalled bet ($1.75) returned to Jack123985
Jack123985 collected $1.10 from pot
Jack123985: doesn't show hand 
*** SUMMARY ***
Total pot $1.10 | Rake $0 
Seat 1: SantiagoWeight (button) folded before Flop (didn't bet)
Seat 2: _BluDeeN_ (small blind) folded before Flop
Seat 3: Jack123985 (big blind) collected ($1.10)
Seat 4: BIGPAIN14 folded before Flop (didn't bet)
Seat 5: gamoniusz folded before Flop
Seat 6: Lehared folded before Flop (didn't bet)



PokerStars Zoom Hand #195022704081:  Hold'em No Limit ($0.10/$0.25) - 2018/12/29 3:04:30 UTC [2018/12/28 22:04:30 ET]
Table 'Hydra' 6-max Seat #1 is the button
Seat 1: Xa4_88 ($48.06 in chips) 
Seat 2: Dbakunwaves ($57.45 in chips) 
Seat 3: SapientiAA ($26.09 in chips) 
Seat 4: SantiagoWeight ($73.07 in chips) 
Seat 5: negreanuNya ($29.93 in chips) 
Seat 6: gamoniusz ($45.85 in chips) 
Dbakunwaves: posts small blind $0.10
SapientiAA: posts big blind $0.25
*** HOLE CARDS ***
Dealt to SantiagoWeight [6h 2d]
SantiagoWeight: folds 
negreanuNya: folds 
gamoniusz: folds 
Xa4_88: raises $0.50 to $0.75
Dbakunwaves: calls $0.65
SapientiAA: folds 
*** FLOP *** [Ah 3s 7d]
Dbakunwaves: checks 
Xa4_88: bets $1
Dbakunwaves: calls $1
*** TURN *** [Ah 3s 7d] [3d]
Dbakunwaves: bets $1.50
Xa4_88: raises $3 to $4.50
Dbakunwaves: calls $3
*** RIVER *** [Ah 3s 7d 3d] [8h]
Dbakunwaves: checks 
Xa4_88: checks 
*** SHOW DOWN ***
Dbakunwaves: shows [Ad 2h] (two pair, Aces and Threes)
Xa4_88: mucks hand 
Dbakunwaves collected $12.18 from pot
*** SUMMARY ***
Total pot $12.75 | Rake $0.57 
Board [Ah 3s 7d 3d 8h]
Seat 1: Xa4_88 (button) mucked [9d Kd]
Seat 2: Dbakunwaves (small blind) showed [Ad 2h] and won ($12.18) with two pair, Aces and Threes
Seat 3: SapientiAA (big blind) folded before Flop
Seat 4: SantiagoWeight folded before Flop (didn't bet)
Seat 5: negreanuNya folded before Flop (didn't bet)
Seat 6: gamoniusz folded before Flop (didn't bet)



PokerStars Zoom Hand #195022714683:  Hold'em No Limit ($0.10/$0.25) - 2018/12/29 3:05:00 UTC [2018/12/28 22:05:00 ET]
Table 'Hydra' 6-max Seat #1 is the button
Seat 1: nathan_eeg ($28.53 in chips) 
Seat 2: negreanuNya ($26.21 in chips) 
Seat 3: armandopinga ($138.82 in chips) 
Seat 4: xXBossHossXx ($30.94 in chips) 
Seat 5: SantiagoWeight ($73.07 in chips) 
Seat 6: TQNYMQNTANA ($25.10 in chips) 
negreanuNya: posts small blind $0.10
armandopinga: posts big blind $0.25
*** HOLE CARDS ***
Dealt to SantiagoWeight [3c Jc]
xXBossHossXx: folds 
SantiagoWeight: folds 
TQNYMQNTANA: folds 
nathan_eeg: folds 
negreanuNya: raises $0.45 to $0.70
armandopinga: folds 
Uncalled bet ($0.45) returned to negreanuNya
negreanuNya collected $0.50 from pot
negreanuNya: doesn't show hand 
*** SUMMARY ***
Total pot $0.50 | Rake $0 
Seat 1: nathan_eeg (button) folded before Flop (didn't bet)
Seat 2: negreanuNya (small blind) collected ($0.50)
Seat 3: armandopinga (big blind) folded before Flop
Seat 4: xXBossHossXx folded before Flop (didn't bet)
Seat 5: SantiagoWeight folded before Flop (didn't bet)
Seat 6: TQNYMQNTANA folded before Flop (didn't bet)



PokerStars Zoom Hand #195022716489:  Hold'em No Limit ($0.10/$0.25) - 2018/12/29 3:05:05 UTC [2018/12/28 22:05:05 ET]
Table 'Hydra' 6-max Seat #1 is the button
Seat 1: MileVoliD49 ($62.69 in chips) 
Seat 2: Parsam5 ($66.17 in chips) 
Seat 3: samioattila ($92.56 in chips) 
Seat 4: SantiagoWeight ($73.07 in chips) 
Seat 5: trillerGTO ($26.49 in chips) 
Seat 6: RandomWalk77 ($70.39 in chips) 
Parsam5: posts small blind $0.10
samioattila: posts big blind $0.25
*** HOLE CARDS ***
Dealt to SantiagoWeight [As 9d]
SantiagoWeight: folds 
trillerGTO: folds 
RandomWalk77: folds 
MileVoliD49: raises $0.25 to $0.50
Parsam5: folds 
samioattila: raises $2.37 to $2.87
MileVoliD49: folds 
Uncalled bet ($2.37) returned to samioattila
samioattila collected $1.10 from pot
samioattila: doesn't show hand 
*** SUMMARY ***
Total pot $1.10 | Rake $0 
Seat 1: MileVoliD49 (button) folded before Flop
Seat 2: Parsam5 (small blind) folded before Flop
Seat 3: samioattila (big blind) collected ($1.10)
Seat 4: SantiagoWeight folded before Flop (didn't bet)
Seat 5: trillerGTO folded before Flop (didn't bet)
Seat 6: RandomWalk77 folded before Flop (didn't bet)



PokerStars Zoom Hand #195022720908:  Hold'em No Limit ($0.10/$0.25) - 2018/12/29 3:05:16 UTC [2018/12/28 22:05:16 ET]
Table 'Hydra' 6-max Seat #1 is the button
Seat 1: zhang1zhang ($51.89 in chips) 
Seat 2: SantiagoWeight ($73.07 in chips) 
Seat 3: winwinboy ($25 in chips) 
Seat 4: benddo ($73.79 in chips) 
Seat 5: simytis ($36.45 in chips) 
Seat 6: BMB8888 ($20.15 in chips) 
SantiagoWeight: posts small blind $0.10
winwinboy: posts big blind $0.25
*** HOLE CARDS ***
Dealt to SantiagoWeight [6s 6d]
benddo: raises $0.50 to $0.75
simytis: folds 
BMB8888: folds 
zhang1zhang: folds 
SantiagoWeight: calls $0.65
winwinboy: calls $0.50
*** FLOP *** [Ah 9d 2d]
SantiagoWeight: checks 
winwinboy: checks 
benddo: bets $1.25
SantiagoWeight: folds 
winwinboy: folds 
Uncalled bet ($1.25) returned to benddo
benddo collected $2.15 from pot
benddo: doesn't show hand 
*** SUMMARY ***
Total pot $2.25 | Rake $0.10 
Board [Ah 9d 2d]
Seat 1: zhang1zhang (button) folded before Flop (didn't bet)
Seat 2: SantiagoWeight (small blind) folded on the Flop
Seat 3: winwinboy (big blind) folded on the Flop
Seat 4: benddo collected ($2.15)
Seat 5: simytis folded before Flop (didn't bet)
Seat 6: BMB8888 folded before Flop (didn't bet)



PokerStars Zoom Hand #195022737648:  Hold'em No Limit ($0.10/$0.25) - 2018/12/29 3:06:03 UTC [2018/12/28 22:06:03 ET]
Table 'Hydra' 6-max Seat #1 is the button
Seat 1: SantiagoWeight ($72.32 in chips) 
Seat 2: samioattila ($48.72 in chips) 
Seat 3: Akkana ($26.06 in chips) 
Seat 4: jfgodtheg ($32 in chips) 
Seat 5: Bujan 07 ($18.73 in chips) 
Seat 6: zdena102 ($52.46 in chips) 
samioattila: posts small blind $0.10
Akkana: posts big blind $0.25
*** HOLE CARDS ***
Dealt to SantiagoWeight [Js 9c]
jfgodtheg: folds 
Bujan 07: raises $0.50 to $0.75
zdena102: folds 
SantiagoWeight: folds 
samioattila: folds 
Akkana: calls $0.50
*** FLOP *** [7c 3d Qc]
Akkana: checks 
Bujan 07: bets $0.75
Akkana: folds 
Uncalled bet ($0.75) returned to Bujan 07
Bujan 07 collected $1.53 from pot
Bujan 07: doesn't show hand 
*** SUMMARY ***
Total pot $1.60 | Rake $0.07 
Board [7c 3d Qc]
Seat 1: SantiagoWeight (button) folded before Flop (didn't bet)
Seat 2: samioattila (small blind) folded before Flop
Seat 3: Akkana (big blind) folded on the Flop
Seat 4: jfgodtheg folded before Flop (didn't bet)
Seat 5: Bujan 07 collected ($1.53)
Seat 6: zdena102 folded before Flop (didn't bet)



PokerStars Zoom Hand #195022746035:  Hold'em No Limit ($0.10/$0.25) - 2018/12/29 3:06:26 UTC [2018/12/28 22:06:26 ET]
Table 'Hydra' 6-max Seat #1 is the button
Seat 1: anlu0803 ($23.05 in chips) 
Seat 2: zhang1zhang ($25 in chips) 
Seat 3: NiceTwise ($19.35 in chips) 
Seat 4: Dr.Jekyll197 ($31.95 in chips) 
Seat 5: HonourMan23 ($32.73 in chips) 
Seat 6: SantiagoWeight ($72.32 in chips) 
zhang1zhang: posts small blind $0.10
NiceTwise: posts big blind $0.25
*** HOLE CARDS ***
Dealt to SantiagoWeight [3h 7h]
Dr.Jekyll197: folds 
HonourMan23: raises $0.30 to $0.55
SantiagoWeight: folds 
anlu0803: calls $0.55
zhang1zhang: folds 
NiceTwise: raises $1.75 to $2.30
HonourMan23: calls $1.75
anlu0803: calls $1.75
*** FLOP *** [2h As 2s]
NiceTwise: bets $5.01
HonourMan23: folds 
anlu0803: calls $5.01
*** TURN *** [2h As 2s] [Ks]
NiceTwise: bets $12.04 and is all-in
anlu0803: calls $12.04
*** RIVER *** [2h As 2s Ks] [5d]
*** SHOW DOWN ***
NiceTwise: shows [Ad Kc] (two pair, Aces and Kings)
anlu0803: shows [2d 2c] (four of a kind, Deuces)
anlu0803 collected $39.25 from pot
*** SUMMARY ***
Total pot $41.10 | Rake $1.85 
Board [2h As 2s Ks 5d]
Seat 1: anlu0803 (button) showed [2d 2c] and won ($39.25) with four of a kind, Deuces
Seat 2: zhang1zhang (small blind) folded before Flop
Seat 3: NiceTwise (big blind) showed [Ad Kc] and lost with two pair, Aces and Kings
Seat 4: Dr.Jekyll197 folded before Flop (didn't bet)
Seat 5: HonourMan23 folded on the Flop
Seat 6: SantiagoWeight folded before Flop (didn't bet)



PokerStars Zoom Hand #195022749231:  Hold'em No Limit ($0.10/$0.25) - 2018/12/29 3:06:34 UTC [2018/12/28 22:06:34 ET]
Table 'Hydra' 6-max Seat #1 is the button
Seat 1: _BluDeeN_ ($28.49 in chips) 
Seat 2: river plate9 ($24.75 in chips) 
Seat 3: SantiagoWeight ($72.32 in chips) 
Seat 4: BirreteX ($28.79 in chips) 
Seat 5: crux1994 ($12.32 in chips) 
Seat 6: franco373513 ($15.25 in chips) 
river plate9: posts small blind $0.10
SantiagoWeight: posts big blind $0.25
*** HOLE CARDS ***
Dealt to SantiagoWeight [8d Qd]
BirreteX: folds 
crux1994: folds 
franco373513: folds 
_BluDeeN_: folds 
river plate9: raises $0.25 to $0.50
SantiagoWeight: calls $0.25
*** FLOP *** [Kh 3s 8s]
river plate9: checks 
SantiagoWeight: bets $0.64
river plate9: raises $0.89 to $1.53
SantiagoWeight: calls $0.89
*** TURN *** [Kh 3s 8s] [Js]
river plate9: bets $2.50
SantiagoWeight: folds 
Uncalled bet ($2.50) returned to river plate9
river plate9 collected $3.88 from pot
*** SUMMARY ***
Total pot $4.06 | Rake $0.18 
Board [Kh 3s 8s Js]
Seat 1: _BluDeeN_ (button) folded before Flop (didn't bet)
Seat 2: river plate9 (small blind) collected ($3.88)
Seat 3: SantiagoWeight (big blind) folded on the Turn
Seat 4: BirreteX folded before Flop (didn't bet)
Seat 5: crux1994 folded before Flop (didn't bet)
Seat 6: franco373513 folded before Flop (didn't bet)



PokerStars Zoom Hand #195022766547:  Hold'em No Limit ($0.10/$0.25) - 2018/12/29 3:07:22 UTC [2018/12/28 22:07:22 ET]
Table 'Hydra' 6-max Seat #1 is the button
Seat 1: tightpokerAA ($25.15 in chips) 
Seat 2: MISTAAJ ($44.17 in chips) 
Seat 3: zhang1zhang ($25 in chips) 
Seat 4: gamoniusz ($44.75 in chips) 
Seat 5: SantiagoWeight ($70.29 in chips) 
Seat 6: armandopinga ($138.92 in chips) 
MISTAAJ: posts small blind $0.10
zhang1zhang: posts big blind $0.25
*** HOLE CARDS ***
Dealt to SantiagoWeight [3h 8c]
gamoniusz: raises $0.25 to $0.50
SantiagoWeight: folds 
armandopinga: folds 
tightpokerAA: folds 
MISTAAJ: folds 
zhang1zhang: folds 
Uncalled bet ($0.25) returned to gamoniusz
gamoniusz collected $0.60 from pot
gamoniusz: doesn't show hand 
*** SUMMARY ***
Total pot $0.60 | Rake $0 
Seat 1: tightpokerAA (button) folded before Flop (didn't bet)
Seat 2: MISTAAJ (small blind) folded before Flop
Seat 3: zhang1zhang (big blind) folded before Flop
Seat 4: gamoniusz collected ($0.60)
Seat 5: SantiagoWeight folded before Flop (didn't bet)
Seat 6: armandopinga folded before Flop (didn't bet)



PokerStars Zoom Hand #195022772926:  Hold'em No Limit ($0.10/$0.25) - 2018/12/29 3:07:40 UTC [2018/12/28 22:07:40 ET]
Table 'Hydra' 6-max Seat #1 is the button
Seat 1: SeniorInv ($8.58 in chips) 
Seat 2: SantiagoWeight ($70.29 in chips) 
Seat 3: anorectal ($64.81 in chips) 
Seat 4: negreanuNya ($27.71 in chips) 
Seat 5: benddo ($72.05 in chips) 
Seat 6: samioattila ($93.43 in chips) 
SantiagoWeight: posts small blind $0.10
anorectal: posts big blind $0.25
*** HOLE CARDS ***
Dealt to SantiagoWeight [9d 3d]
negreanuNya: folds 
benddo: raises $0.50 to $0.75
samioattila: folds 
SeniorInv: folds 
SantiagoWeight: folds 
anorectal: folds 
Uncalled bet ($0.50) returned to benddo
benddo collected $0.60 from pot
benddo: doesn't show hand 
*** SUMMARY ***
Total pot $0.60 | Rake $0 
Seat 1: SeniorInv (button) folded before Flop (didn't bet)
Seat 2: SantiagoWeight (small blind) folded before Flop
Seat 3: anorectal (big blind) folded before Flop
Seat 4: negreanuNya folded before Flop (didn't bet)
Seat 5: benddo collected ($0.60)
Seat 6: samioattila folded before Flop (didn't bet)



PokerStars Zoom Hand #195022770799:  Hold'em No Limit ($0.10/$0.25) - 2018/12/29 3:07:33 UTC [2018/12/28 22:07:33 ET]
Table 'Hydra' 6-max Seat #1 is the button
Seat 1: zekoxxx ($12.82 in chips) 
Seat 2: anlu0803 ($24.75 in chips) 
Seat 3: qing328 ($24.15 in chips) 
Seat 4: TQNYMQNTANA ($30.44 in chips) 
Seat 5: Actarusqc ($30.33 in chips) 
Seat 6: SantiagoWeight ($70.29 in chips) 
anlu0803: posts small blind $0.10
qing328: posts big blind $0.25
*** HOLE CARDS ***
Dealt to SantiagoWeight [Jc 4d]
TQNYMQNTANA: raises $0.50 to $0.75
Actarusqc: folds 
SantiagoWeight: folds 
zekoxxx: calls $0.75
anlu0803: folds 
qing328: folds 
*** FLOP *** [7d 2d Ah]
TQNYMQNTANA: checks 
zekoxxx: bets $0.89
TQNYMQNTANA: folds 
Uncalled bet ($0.89) returned to zekoxxx
zekoxxx collected $1.77 from pot
zekoxxx: doesn't show hand 
*** SUMMARY ***
Total pot $1.85 | Rake $0.08 
Board [7d 2d Ah]
Seat 1: zekoxxx (button) collected ($1.77)
Seat 2: anlu0803 (small blind) folded before Flop
Seat 3: qing328 (big blind) folded before Flop
Seat 4: TQNYMQNTANA folded on the Flop
Seat 5: Actarusqc folded before Flop (didn't bet)
Seat 6: SantiagoWeight folded before Flop (didn't bet)



PokerStars Zoom Hand #195022777976:  Hold'em No Limit ($0.10/$0.25) - 2018/12/29 3:07:53 UTC [2018/12/28 22:07:53 ET]
Table 'Hydra' 6-max Seat #1 is the button
Seat 1: SantiagoWeight ($70.19 in chips) 
Seat 2: Sarcasme ($12.60 in chips) 
Seat 3: river plate9 ($26.60 in chips) 
Seat 4: !P0K3RM3T4L! ($47.86 in chips) 
Seat 5: tightpokerAA ($44.54 in chips) 
Seat 6: anorectal ($60.71 in chips) 
Sarcasme: posts small blind $0.10
river plate9: posts big blind $0.25
*** HOLE CARDS ***
Dealt to SantiagoWeight [7h As]
!P0K3RM3T4L!: folds 
tightpokerAA: folds 
anorectal: folds 
SantiagoWeight: raises $0.30 to $0.55
Sarcasme: folds 
river plate9: folds 
Uncalled bet ($0.30) returned to SantiagoWeight
SantiagoWeight collected $0.60 from pot
SantiagoWeight: doesn't show hand 
*** SUMMARY ***
Total pot $0.60 | Rake $0 
Seat 1: SantiagoWeight (button) collected ($0.60)
Seat 2: Sarcasme (small blind) folded before Flop
Seat 3: river plate9 (big blind) folded before Flop
Seat 4: !P0K3RM3T4L! folded before Flop (didn't bet)
Seat 5: tightpokerAA folded before Flop (didn't bet)
Seat 6: anorectal folded before Flop (didn't bet)



PokerStars Zoom Hand #195022783341:  Hold'em No Limit ($0.10/$0.25) - 2018/12/29 3:08:09 UTC [2018/12/28 22:08:09 ET]
Table 'Hydra' 6-max Seat #1 is the button
Seat 1: djambat ($27.97 in chips) 
Seat 2: Lehared ($115.41 in chips) 
Seat 3: yobbos ($52.85 in chips) 
Seat 4: donmarc777 ($31.51 in chips) 
Seat 5: benddo ($54.23 in chips) 
Seat 6: SantiagoWeight ($70.54 in chips) 
Lehared: posts small blind $0.10
yobbos: posts big blind $0.25
*** HOLE CARDS ***
Dealt to SantiagoWeight [Tc 5d]
donmarc777: folds 
benddo: folds 
SantiagoWeight: folds 
djambat: folds 
Lehared: raises $0.50 to $0.75
yobbos: folds 
Uncalled bet ($0.50) returned to Lehared
Lehared collected $0.50 from pot
Lehared: doesn't show hand 
*** SUMMARY ***
Total pot $0.50 | Rake $0 
Seat 1: djambat (button) folded before Flop (didn't bet)
Seat 2: Lehared (small blind) collected ($0.50)
Seat 3: yobbos (big blind) folded before Flop
Seat 4: donmarc777 folded before Flop (didn't bet)
Seat 5: benddo folded before Flop (didn't bet)
Seat 6: SantiagoWeight folded before Flop (didn't bet)



PokerStars Zoom Hand #195022790454:  Hold'em No Limit ($0.10/$0.25) - 2018/12/29 3:08:28 UTC [2018/12/28 22:08:28 ET]
Table 'Hydra' 6-max Seat #1 is the button
Seat 1: zbuci ($42.60 in chips) 
Seat 2: ducepot15 ($35.95 in chips) 
Seat 3: SantiagoWeight ($70.54 in chips) 
Seat 4: Baboscrubx ($25 in chips) 
Seat 5: call me??107 ($13.31 in chips) 
Seat 6: reggiedogg31 ($113.12 in chips) 
ducepot15: posts small blind $0.10
SantiagoWeight: posts big blind $0.25
*** HOLE CARDS ***
Dealt to SantiagoWeight [7c 4s]
Baboscrubx: raises $0.39 to $0.64
call me??107: raises $12.67 to $13.31 and is all-in
reggiedogg31: folds 
zbuci: folds 
ducepot15: folds 
SantiagoWeight: folds 
Baboscrubx: folds 
Uncalled bet ($12.67) returned to call me??107
call me??107 collected $1.63 from pot
call me??107: doesn't show hand 
*** SUMMARY ***
Total pot $1.63 | Rake $0 
Seat 1: zbuci (button) folded before Flop (didn't bet)
Seat 2: ducepot15 (small blind) folded before Flop
Seat 3: SantiagoWeight (big blind) folded before Flop
Seat 4: Baboscrubx folded before Flop
Seat 5: call me??107 collected ($1.63)
Seat 6: reggiedogg31 folded before Flop (didn't bet)



PokerStars Zoom Hand #195022785832:  Hold'em No Limit ($0.10/$0.25) - 2018/12/29 3:08:16 UTC [2018/12/28 22:08:16 ET]
Table 'Hydra' 6-max Seat #1 is the button
Seat 1: Baboscrubx ($29.58 in chips) 
Seat 2: zhang1zhang ($25.80 in chips) 
Seat 3: anlu0803 ($24.65 in chips) 
Seat 4: SantiagoWeight ($70.54 in chips) 
Seat 5: yobbos ($139.86 in chips) 
Seat 6: cankum ($25 in chips) 
zhang1zhang: posts small blind $0.10
anlu0803: posts big blind $0.25
*** HOLE CARDS ***
Dealt to SantiagoWeight [6s Jc]
SantiagoWeight: folds 
yobbos: folds 
cankum: folds 
Baboscrubx: raises $0.35 to $0.60
zhang1zhang: folds 
anlu0803: calls $0.35
*** FLOP *** [6h 9h 8d]
anlu0803: checks 
Baboscrubx: bets $1
anlu0803: folds 
Uncalled bet ($1) returned to Baboscrubx
Baboscrubx collected $1.24 from pot
Baboscrubx: doesn't show hand 
*** SUMMARY ***
Total pot $1.30 | Rake $0.06 
Board [6h 9h 8d]
Seat 1: Baboscrubx (button) collected ($1.24)
Seat 2: zhang1zhang (small blind) folded before Flop
Seat 3: anlu0803 (big blind) folded on the Flop
Seat 4: SantiagoWeight folded before Flop (didn't bet)
Seat 5: yobbos folded before Flop (didn't bet)
Seat 6: cankum folded before Flop (didn't bet)



PokerStars Zoom Hand #195022796446:  Hold'em No Limit ($0.10/$0.25) - 2018/12/29 3:08:46 UTC [2018/12/28 22:08:46 ET]
Table 'Hydra' 6-max Seat #1 is the button
Seat 1: Dbakunwaves ($88.43 in chips) 
Seat 2: SantiagoWeight ($70.29 in chips) 
Seat 3: BMB8888 ($18.55 in chips) 
Seat 4: nhanminhtri ($32.36 in chips) 
Seat 5: river plate9 ($23.05 in chips) 
Seat 6: SeniorInv ($7.63 in chips) 
SantiagoWeight: posts small blind $0.10
BMB8888: posts big blind $0.25
*** HOLE CARDS ***
Dealt to SantiagoWeight [Qh 9h]
nhanminhtri: folds 
river plate9: folds 
SeniorInv: folds 
Dbakunwaves: raises $1 to $1.25
SantiagoWeight: folds 
BMB8888: folds 
Uncalled bet ($1) returned to Dbakunwaves
Dbakunwaves collected $0.60 from pot
Dbakunwaves: doesn't show hand 
*** SUMMARY ***
Total pot $0.60 | Rake $0 
Seat 1: Dbakunwaves (button) collected ($0.60)
Seat 2: SantiagoWeight (small blind) folded before Flop
Seat 3: BMB8888 (big blind) folded before Flop
Seat 4: nhanminhtri folded before Flop (didn't bet)
Seat 5: river plate9 folded before Flop (didn't bet)
Seat 6: SeniorInv folded before Flop (didn't bet)



PokerStars Zoom Hand #195022803244:  Hold'em No Limit ($0.10/$0.25) - 2018/12/29 3:09:05 UTC [2018/12/28 22:09:05 ET]
Table 'Hydra' 6-max Seat #1 is the button
Seat 1: SantiagoWeight ($70.19 in chips) 
Seat 2: mariopork ($46.42 in chips) 
Seat 3: zdena102 ($47.99 in chips) 
Seat 4: Akkana ($21.85 in chips) 
Seat 5: Dbakunwaves ($88.78 in chips) 
Seat 6: yobbos ($139.51 in chips) 
mariopork: posts small blind $0.10
zdena102: posts big blind $0.25
*** HOLE CARDS ***
Dealt to SantiagoWeight [5h 2s]
Akkana: folds 
Dbakunwaves: folds 
yobbos: folds 
SantiagoWeight: folds 
mariopork: raises $0.50 to $0.75
zdena102: calls $0.50
*** FLOP *** [Jc 9c Jh]
mariopork: bets $0.47
zdena102: calls $0.47
*** TURN *** [Jc 9c Jh] [Qs]
mariopork: checks 
zdena102: bets $0.75
mariopork: calls $0.75
*** RIVER *** [Jc 9c Jh Qs] [8s]
mariopork: checks 
zdena102: checks 
*** SHOW DOWN ***
mariopork: shows [Qh 8h] (two pair, Queens and Jacks)
zdena102: mucks hand 
mariopork collected $3.76 from pot
*** SUMMARY ***
Total pot $3.94 | Rake $0.18 
Board [Jc 9c Jh Qs 8s]
Seat 1: SantiagoWeight (button) folded before Flop (didn't bet)
Seat 2: mariopork (small blind) showed [Qh 8h] and won ($3.76) with two pair, Queens and Jacks
Seat 3: zdena102 (big blind) mucked [Kd 9d]
Seat 4: Akkana folded before Flop (didn't bet)
Seat 5: Dbakunwaves folded before Flop (didn't bet)
Seat 6: yobbos folded before Flop (didn't bet)



PokerStars Zoom Hand #195022807208:  Hold'em No Limit ($0.10/$0.25) - 2018/12/29 3:09:16 UTC [2018/12/28 22:09:16 ET]
Table 'Hydra' 6-max Seat #1 is the button
Seat 1: river plate9 ($25.72 in chips) 
Seat 2: MarcoA12 ($42.49 in chips) 
Seat 3: tightpokerAA ($38.18 in chips) 
Seat 4: MeDoubleJ ($32.98 in chips) 
Seat 5: SantiagoWeight ($70.19 in chips) 
Seat 6: BIGPAIN14 ($60.44 in chips) 
MarcoA12: posts small blind $0.10
tightpokerAA: posts big blind $0.25
*** HOLE CARDS ***
Dealt to SantiagoWeight [Td 6h]
MeDoubleJ: folds 
SantiagoWeight: folds 
BIGPAIN14: folds 
river plate9: raises $0.25 to $0.50
MarcoA12: raises $0.75 to $1.25
tightpokerAA: folds 
river plate9: calls $0.75
*** FLOP *** [3s 3d 7d]
MarcoA12: bets $1.25
river plate9: folds 
Uncalled bet ($1.25) returned to MarcoA12
MarcoA12 collected $2.63 from pot
MarcoA12: doesn't show hand 
*** SUMMARY ***
Total pot $2.75 | Rake $0.12 
Board [3s 3d 7d]
Seat 1: river plate9 (button) folded on the Flop
Seat 2: MarcoA12 (small blind) collected ($2.63)
Seat 3: tightpokerAA (big blind) folded before Flop
Seat 4: MeDoubleJ folded before Flop (didn't bet)
Seat 5: SantiagoWeight folded before Flop (didn't bet)
Seat 6: BIGPAIN14 folded before Flop (didn't bet)



PokerStars Zoom Hand #195022809681:  Hold'em No Limit ($0.10/$0.25) - 2018/12/29 3:09:23 UTC [2018/12/28 22:09:23 ET]
Table 'Hydra' 6-max Seat #1 is the button
Seat 1: GrandmasterY ($27.57 in chips) 
Seat 2: Akkana ($16.11 in chips) 
Seat 3: SantiagoWeight ($70.19 in chips) 
Seat 4: tightpokerAA ($33.59 in chips) 
Seat 5: MISTAAJ ($25.71 in chips) 
Seat 6: ryanking99 ($23.91 in chips) 
Akkana: posts small blind $0.10
SantiagoWeight: posts big blind $0.25
*** HOLE CARDS ***
Dealt to SantiagoWeight [8h 6d]
tightpokerAA: folds 
MISTAAJ: folds 
ryanking99: raises $0.60 to $0.85
GrandmasterY: raises $1.45 to $2.30
Akkana: folds 
SantiagoWeight: folds 
ryanking99: raises $1.45 to $3.75
GrandmasterY: folds 
Uncalled bet ($1.45) returned to ryanking99
ryanking99 collected $4.95 from pot
ryanking99: doesn't show hand 
*** SUMMARY ***
Total pot $4.95 | Rake $0 
Seat 1: GrandmasterY (button) folded before Flop
Seat 2: Akkana (small blind) folded before Flop
Seat 3: SantiagoWeight (big blind) folded before Flop
Seat 4: tightpokerAA folded before Flop (didn't bet)
Seat 5: MISTAAJ folded before Flop (didn't bet)
Seat 6: ryanking99 collected ($4.95)



PokerStars Zoom Hand #195022814312:  Hold'em No Limit ($0.10/$0.25) - 2018/12/29 3:09:36 UTC [2018/12/28 22:09:36 ET]
Table 'Hydra' 6-max Seat #1 is the button
Seat 1: Slim Wolfie ($25 in chips) 
Seat 2: SapientiAA ($25.61 in chips) 
Seat 3: zbuci ($42.25 in chips) 
Seat 4: SantiagoWeight ($69.94 in chips) 
Seat 5: zdena102 ($46.02 in chips) 
Seat 6: mariopork ($48.21 in chips) 
SapientiAA: posts small blind $0.10
zbuci: posts big blind $0.25
*** HOLE CARDS ***
Dealt to SantiagoWeight [5d Kc]
SantiagoWeight: folds 
zdena102: folds 
mariopork: folds 
Slim Wolfie: raises $0.37 to $0.62
SapientiAA: raises $1.49 to $2.11
zbuci: folds 
Slim Wolfie: folds 
Uncalled bet ($1.49) returned to SapientiAA
SapientiAA collected $1.49 from pot
SapientiAA: doesn't show hand 
*** SUMMARY ***
Total pot $1.49 | Rake $0 
Seat 1: Slim Wolfie (button) folded before Flop
Seat 2: SapientiAA (small blind) collected ($1.49)
Seat 3: zbuci (big blind) folded before Flop
Seat 4: SantiagoWeight folded before Flop (didn't bet)
Seat 5: zdena102 folded before Flop (didn't bet)
Seat 6: mariopork folded before Flop (didn't bet)



PokerStars Zoom Hand #195022821130:  Hold'em No Limit ($0.10/$0.25) - 2018/12/29 3:09:55 UTC [2018/12/28 22:09:55 ET]
Table 'Hydra' 6-max Seat #1 is the button
Seat 1: Baboscrubx ($35.71 in chips) 
Seat 2: benddo ($104.95 in chips) 
Seat 3: G ster24 ($25 in chips) 
Seat 4: mistdog ($32.08 in chips) 
Seat 5: Dr.Jekyll197 ($31.59 in chips) 
Seat 6: SantiagoWeight ($69.84 in chips) 
benddo: posts small blind $0.10
G ster24: posts big blind $0.25
*** HOLE CARDS ***
Dealt to SantiagoWeight [9s 6c]
mistdog: folds 
Dr.Jekyll197: folds 
SantiagoWeight: folds 
Baboscrubx: folds 
benddo: folds 
Uncalled bet ($0.15) returned to G ster24
G ster24 collected $0.20 from pot
G ster24: doesn't show hand 
*** SUMMARY ***
Total pot $0.20 | Rake $0 
Seat 1: Baboscrubx (button) folded before Flop (didn't bet)
Seat 2: benddo (small blind) folded before Flop
Seat 3: G ster24 (big blind) collected ($0.20)
Seat 4: mistdog folded before Flop (didn't bet)
Seat 5: Dr.Jekyll197 folded before Flop (didn't bet)
Seat 6: SantiagoWeight folded before Flop (didn't bet)



PokerStars Zoom Hand #195022818681:  Hold'em No Limit ($0.10/$0.25) - 2018/12/29 3:09:48 UTC [2018/12/28 22:09:48 ET]
Table 'Hydra' 6-max Seat #1 is the button
Seat 1: Baboscrubx ($30.22 in chips) 
Seat 2: SantiagoWeight ($69.94 in chips) 
Seat 3: SeniorInv ($8.53 in chips) 
Seat 4: anorectal ($63.45 in chips) 
Seat 5: Xa4_88 ($70.28 in chips) 
Seat 6: assassin0875 ($177.97 in chips) 
SantiagoWeight: posts small blind $0.10
SeniorInv: posts big blind $0.25
*** HOLE CARDS ***
Dealt to SantiagoWeight [5h Js]
anorectal: raises $0.55 to $0.80
Xa4_88: folds 
assassin0875: calls $0.80
Baboscrubx: folds 
SantiagoWeight: folds 
SeniorInv: calls $0.55
*** FLOP *** [3c 7h 4d]
SeniorInv: checks 
anorectal: bets $1.91
assassin0875: calls $1.91
SeniorInv: folds 
*** TURN *** [3c 7h 4d] [5d]
anorectal: bets $3.32
assassin0875: calls $3.32
*** RIVER *** [3c 7h 4d 5d] [9c]
anorectal: checks 
assassin0875: checks 
*** SHOW DOWN ***
anorectal: shows [Ad 7d] (a pair of Sevens)
assassin0875: shows [9d 8s] (a pair of Nines)
assassin0875 collected $12.38 from pot
*** SUMMARY ***
Total pot $12.96 | Rake $0.58 
Board [3c 7h 4d 5d 9c]
Seat 1: Baboscrubx (button) folded before Flop (didn't bet)
Seat 2: SantiagoWeight (small blind) folded before Flop
Seat 3: SeniorInv (big blind) folded on the Flop
Seat 4: anorectal showed [Ad 7d] and lost with a pair of Sevens
Seat 5: Xa4_88 folded before Flop (didn't bet)
Seat 6: assassin0875 showed [9d 8s] and won ($12.38) with a pair of Nines



PokerStars Zoom Hand #195022824394:  Hold'em No Limit ($0.10/$0.25) - 2018/12/29 3:10:03 UTC [2018/12/28 22:10:03 ET]
Table 'Hydra' 6-max Seat #1 is the button
Seat 1: zdenekstavic ($19.16 in chips) 
Seat 2: _BluDeeN_ ($24.30 in chips) 
Seat 3: qing328 ($25.86 in chips) 
Seat 4: SapientiAA ($26.48 in chips) 
Seat 5: SantiagoWeight ($69.84 in chips) 
Seat 6: Pardaroxon ($25 in chips) 
_BluDeeN_: posts small blind $0.10
qing328: posts big blind $0.25
*** HOLE CARDS ***
Dealt to SantiagoWeight [5c 8d]
SapientiAA: raises $0.25 to $0.50
SantiagoWeight: folds 
Pardaroxon: folds 
zdenekstavic: folds 
_BluDeeN_: folds 
qing328: folds 
Uncalled bet ($0.25) returned to SapientiAA
SapientiAA collected $0.60 from pot
SapientiAA: doesn't show hand 
*** SUMMARY ***
Total pot $0.60 | Rake $0 
Seat 1: zdenekstavic (button) folded before Flop (didn't bet)
Seat 2: _BluDeeN_ (small blind) folded before Flop
Seat 3: qing328 (big blind) folded before Flop
Seat 4: SapientiAA collected ($0.60)
Seat 5: SantiagoWeight folded before Flop (didn't bet)
Seat 6: Pardaroxon folded before Flop (didn't bet)



PokerStars Zoom Hand #195022834347:  Hold'em No Limit ($0.10/$0.25) - 2018/12/29 3:10:31 UTC [2018/12/28 22:10:31 ET]
Table 'Hydra' 6-max Seat #1 is the button
Seat 1: G ster24 ($25 in chips) 
Seat 2: SantiagoWeight ($69.84 in chips) 
Seat 3: aldoalb0207 ($46.67 in chips) 
Seat 4: pokerpienda ($7.54 in chips) 
Seat 5: MISTAAJ ($38.35 in chips) 
Seat 6: Gf Chipz ($17.25 in chips) 
SantiagoWeight: posts small blind $0.10
aldoalb0207: posts big blind $0.25
*** HOLE CARDS ***
Dealt to SantiagoWeight [2d 4d]
pokerpienda: raises $0.25 to $0.50
MISTAAJ: folds 
Gf Chipz: folds 
G ster24: raises $0.25 to $0.75
SantiagoWeight: folds 
aldoalb0207: calls $0.50
pokerpienda: calls $0.25
*** FLOP *** [Td 7s Ad]
aldoalb0207: checks 
pokerpienda: checks 
G ster24: bets $2.24
aldoalb0207: calls $2.24
pokerpienda: folds 
*** TURN *** [Td 7s Ad] [2h]
aldoalb0207: checks 
G ster24: bets $6.52
aldoalb0207: folds 
Uncalled bet ($6.52) returned to G ster24
G ster24 collected $6.52 from pot
G ster24: doesn't show hand 
*** SUMMARY ***
Total pot $6.83 | Rake $0.31 
Board [Td 7s Ad 2h]
Seat 1: G ster24 (button) collected ($6.52)
Seat 2: SantiagoWeight (small blind) folded before Flop
Seat 3: aldoalb0207 (big blind) folded on the Turn
Seat 4: pokerpienda folded on the Flop
Seat 5: MISTAAJ folded before Flop (didn't bet)
Seat 6: Gf Chipz folded before Flop (didn't bet)



PokerStars Zoom Hand #195022838270:  Hold'em No Limit ($0.10/$0.25) - 2018/12/29 3:10:42 UTC [2018/12/28 22:10:42 ET]
Table 'Hydra' 6-max Seat #1 is the button
Seat 1: zdena102 ($46.27 in chips) 
Seat 2: theman120294 ($47.16 in chips) 
Seat 3: SantiagoWeight ($69.74 in chips) 
Seat 4: benddo ($50.48 in chips) 
Seat 5: Basebob ($25 in chips) 
Seat 6: BMB8888 ($23.48 in chips) 
theman120294: posts small blind $0.10
SantiagoWeight: posts big blind $0.25
*** HOLE CARDS ***
Dealt to SantiagoWeight [2s 8c]
benddo: folds 
Basebob: folds 
BMB8888: folds 
zdena102: folds 
theman120294: raises $0.50 to $0.75
SantiagoWeight: folds 
Uncalled bet ($0.50) returned to theman120294
theman120294 collected $0.50 from pot
theman120294: doesn't show hand 
*** SUMMARY ***
Total pot $0.50 | Rake $0 
Seat 1: zdena102 (button) folded before Flop (didn't bet)
Seat 2: theman120294 (small blind) collected ($0.50)
Seat 3: SantiagoWeight (big blind) folded before Flop
Seat 4: benddo folded before Flop (didn't bet)
Seat 5: Basebob folded before Flop (didn't bet)
Seat 6: BMB8888 folded before Flop (didn't bet)



PokerStars Zoom Hand #195022828253:  Hold'em No Limit ($0.10/$0.25) - 2018/12/29 3:10:15 UTC [2018/12/28 22:10:15 ET]
Table 'Hydra' 6-max Seat #1 is the button
Seat 1: HansMSM ($42.01 in chips) 
Seat 2: ryanking99 ($40.66 in chips) 
Seat 3: Xp0Hb ($28.61 in chips) 
Seat 4: SantiagoWeight ($69.84 in chips) 
Seat 5: deaglepro ($56.93 in chips) 
Seat 6: ivann14 ($28.13 in chips) 
ryanking99: posts small blind $0.10
Xp0Hb: posts big blind $0.25
*** HOLE CARDS ***
Dealt to SantiagoWeight [3h Qd]
SantiagoWeight: folds 
deaglepro: raises $0.50 to $0.75
ivann14: folds 
HansMSM: folds 
ryanking99: raises $2.50 to $3.25
Xp0Hb: folds 
deaglepro: calls $2.50
*** FLOP *** [4c 5c 6d]
ryanking99: checks 
deaglepro: bets $2.75
ryanking99: raises $34.66 to $37.41 and is all-in
deaglepro: folds 
Uncalled bet ($34.66) returned to ryanking99
ryanking99 collected $11.70 from pot
ryanking99: doesn't show hand 
*** SUMMARY ***
Total pot $12.25 | Rake $0.55 
Board [4c 5c 6d]
Seat 1: HansMSM (button) folded before Flop (didn't bet)
Seat 2: ryanking99 (small blind) collected ($11.70)
Seat 3: Xp0Hb (big blind) folded before Flop
Seat 4: SantiagoWeight folded before Flop (didn't bet)
Seat 5: deaglepro folded on the Flop
Seat 6: ivann14 folded before Flop (didn't bet)



PokerStars Zoom Hand #195022846395:  Hold'em No Limit ($0.10/$0.25) - 2018/12/29 3:11:05 UTC [2018/12/28 22:11:05 ET]
Table 'Hydra' 6-max Seat #1 is the button
Seat 1: SantiagoWeight ($69.49 in chips) 
Seat 2: Xander_B88 ($55.12 in chips) 
Seat 3: _BluDeeN_ ($24.10 in chips) 
Seat 4: yobbos ($29.11 in chips) 
Seat 5: Xp0Hb ($27.61 in chips) 
Seat 6: 365DaysSucesful ($25 in chips) 
Xander_B88: posts small blind $0.10
_BluDeeN_: posts big blind $0.25
*** HOLE CARDS ***
Dealt to SantiagoWeight [Ks 3h]
yobbos: folds 
Xp0Hb: folds 
365DaysSucesful: folds 
SantiagoWeight: folds 
Xander_B88: folds 
Uncalled bet ($0.15) returned to _BluDeeN_
_BluDeeN_ collected $0.20 from pot
_BluDeeN_: doesn't show hand 
*** SUMMARY ***
Total pot $0.20 | Rake $0 
Seat 1: SantiagoWeight (button) folded before Flop (didn't bet)
Seat 2: Xander_B88 (small blind) folded before Flop
Seat 3: _BluDeeN_ (big blind) collected ($0.20)
Seat 4: yobbos folded before Flop (didn't bet)
Seat 5: Xp0Hb folded before Flop (didn't bet)
Seat 6: 365DaysSucesful folded before Flop (didn't bet)



PokerStars Zoom Hand #195022854582:  Hold'em No Limit ($0.10/$0.25) - 2018/12/29 3:11:28 UTC [2018/12/28 22:11:28 ET]
Table 'Hydra' 6-max Seat #1 is the button
Seat 1: ckriszee ($37.97 in chips) 
Seat 2: zdenekstavic ($19.48 in chips) 
Seat 3: aldoalb0207 ($42.58 in chips) 
Seat 4: jeffwalker23 ($41.08 in chips) 
Seat 5: Basebob ($25 in chips) 
Seat 6: SantiagoWeight ($69.49 in chips) 
zdenekstavic: posts small blind $0.10
aldoalb0207: posts big blind $0.25
*** HOLE CARDS ***
Dealt to SantiagoWeight [8h 9c]
jeffwalker23: folds 
Basebob: folds 
SantiagoWeight: folds 
ckriszee: folds 
zdenekstavic: calls $0.15
aldoalb0207: checks 
*** FLOP *** [Qh 4s 5c]
zdenekstavic: bets $0.48
aldoalb0207: folds 
Uncalled bet ($0.48) returned to zdenekstavic
zdenekstavic collected $0.48 from pot
zdenekstavic: doesn't show hand 
*** SUMMARY ***
Total pot $0.50 | Rake $0.02 
Board [Qh 4s 5c]
Seat 1: ckriszee (button) folded before Flop (didn't bet)
Seat 2: zdenekstavic (small blind) collected ($0.48)
Seat 3: aldoalb0207 (big blind) folded on the Flop
Seat 4: jeffwalker23 folded before Flop (didn't bet)
Seat 5: Basebob folded before Flop (didn't bet)
Seat 6: SantiagoWeight folded before Flop (didn't bet)



PokerStars Zoom Hand #195022858780:  Hold'em No Limit ($0.10/$0.25) - 2018/12/29 3:11:40 UTC [2018/12/28 22:11:40 ET]
Table 'Hydra' 6-max Seat #1 is the button
Seat 1: Xp0Hb ($26.61 in chips) 
Seat 2: trillerGTO ($25.10 in chips) 
Seat 3: Chrimmpam ($20.43 in chips) 
Seat 4: SantiagoWeight ($69.49 in chips) 
Seat 5: river plate9 ($22.45 in chips) 
Seat 6: Parsam5 ($65.91 in chips) 
trillerGTO: posts small blind $0.10
Chrimmpam: posts big blind $0.25
*** HOLE CARDS ***
Dealt to SantiagoWeight [Kd Jc]
SantiagoWeight: raises $0.42 to $0.67
river plate9: folds 
Parsam5: folds 
Xp0Hb: folds 
trillerGTO: folds 
Chrimmpam: folds 
Uncalled bet ($0.42) returned to SantiagoWeight
SantiagoWeight collected $0.60 from pot
SantiagoWeight: doesn't show hand 
*** SUMMARY ***
Total pot $0.60 | Rake $0 
Seat 1: Xp0Hb (button) folded before Flop (didn't bet)
Seat 2: trillerGTO (small blind) folded before Flop
Seat 3: Chrimmpam (big blind) folded before Flop
Seat 4: SantiagoWeight collected ($0.60)
Seat 5: river plate9 folded before Flop (didn't bet)
Seat 6: Parsam5 folded before Flop (didn't bet)



PokerStars Zoom Hand #195022870672:  Hold'em No Limit ($0.10/$0.25) - 2018/12/29 3:12:14 UTC [2018/12/28 22:12:14 ET]
Table 'Hydra' 6-max Seat #1 is the button
Seat 1: SantiagoWeight ($69.84 in chips) 
Seat 2: Gf Chipz ($16.50 in chips) 
Seat 3: ckriszee ($70.04 in chips) 
Seat 4: Lehared ($66.17 in chips) 
Seat 5: Basebob ($25.78 in chips) 
Seat 6: trillerGTO ($31.33 in chips) 
Gf Chipz: posts small blind $0.10
ckriszee: posts big blind $0.25
*** HOLE CARDS ***
Dealt to SantiagoWeight [6c Qd]
Lehared: folds 
Basebob: folds 
trillerGTO: folds 
SantiagoWeight: folds 
Gf Chipz: folds 
Uncalled bet ($0.15) returned to ckriszee
ckriszee collected $0.20 from pot
ckriszee: doesn't show hand 
*** SUMMARY ***
Total pot $0.20 | Rake $0 
Seat 1: SantiagoWeight (button) folded before Flop (didn't bet)
Seat 2: Gf Chipz (small blind) folded before Flop
Seat 3: ckriszee (big blind) collected ($0.20)
Seat 4: Lehared folded before Flop (didn't bet)
Seat 5: Basebob folded before Flop (didn't bet)
Seat 6: trillerGTO folded before Flop (didn't bet)



PokerStars Zoom Hand #195022867153:  Hold'em No Limit ($0.10/$0.25) - 2018/12/29 3:12:04 UTC [2018/12/28 22:12:04 ET]
Table 'Hydra' 6-max Seat #1 is the button
Seat 1: TQNYMQNTANA ($26.90 in chips) 
Seat 2: zbuci ($40.65 in chips) 
Seat 3: benddo ($49.06 in chips) 
Seat 4: Chrimmpam ($20.18 in chips) 
Seat 5: SantiagoWeight ($69.84 in chips) 
Seat 6: !P0K3RM3T4L! ($51.44 in chips) 
zbuci: posts small blind $0.10
benddo: posts big blind $0.25
*** HOLE CARDS ***
Dealt to SantiagoWeight [Th Qh]
Chrimmpam: raises $0.60 to $0.85
SantiagoWeight: folds 
!P0K3RM3T4L!: folds 
TQNYMQNTANA: calls $0.85
zbuci: folds 
benddo: folds 
*** FLOP *** [5h 9d 5c]
Chrimmpam: bets $1.50
TQNYMQNTANA: folds 
Uncalled bet ($1.50) returned to Chrimmpam
Chrimmpam collected $1.96 from pot
Chrimmpam: doesn't show hand 
*** SUMMARY ***
Total pot $2.05 | Rake $0.09 
Board [5h 9d 5c]
Seat 1: TQNYMQNTANA (button) folded on the Flop
Seat 2: zbuci (small blind) folded before Flop
Seat 3: benddo (big blind) folded before Flop
Seat 4: Chrimmpam collected ($1.96)
Seat 5: SantiagoWeight folded before Flop (didn't bet)
Seat 6: !P0K3RM3T4L! folded before Flop (didn't bet)



PokerStars Zoom Hand #195022875258:  Hold'em No Limit ($0.10/$0.25) - 2018/12/29 3:12:28 UTC [2018/12/28 22:12:28 ET]
Table 'Hydra' 6-max Seat #1 is the button
Seat 1: alex3d1985 ($24.65 in chips) 
Seat 2: Slim Wolfie ($37.25 in chips) 
Seat 3: SantiagoWeight ($69.84 in chips) 
Seat 4: !P0K3RM3T4L! ($55.31 in chips) 
Seat 5: abbi555 ($28.80 in chips) 
Seat 6: tightpokerAA ($25.88 in chips) 
Slim Wolfie: posts small blind $0.10
SantiagoWeight: posts big blind $0.25
*** HOLE CARDS ***
Dealt to SantiagoWeight [8d 7d]
!P0K3RM3T4L!: folds 
abbi555: folds 
tightpokerAA: raises $0.50 to $0.75
alex3d1985: folds 
Slim Wolfie: folds 
SantiagoWeight: calls $0.50
*** FLOP *** [As 2d Jd]
SantiagoWeight: checks 
tightpokerAA: bets $0.77
SantiagoWeight: calls $0.77
*** TURN *** [As 2d Jd] [6d]
SantiagoWeight: checks 
tightpokerAA: bets $1.50
SantiagoWeight: raises $4.20 to $5.70
tightpokerAA: calls $4.20
*** RIVER *** [As 2d Jd 6d] [Jc]
SantiagoWeight: bets $61.80
tightpokerAA: folds 
Uncalled bet ($61.80) returned to SantiagoWeight
SantiagoWeight collected $13.89 from pot
SantiagoWeight: doesn't show hand 
*** SUMMARY ***
Total pot $14.54 | Rake $0.65 
Board [As 2d Jd 6d Jc]
Seat 1: alex3d1985 (button) folded before Flop (didn't bet)
Seat 2: Slim Wolfie (small blind) folded before Flop
Seat 3: SantiagoWeight (big blind) collected ($13.89)
Seat 4: !P0K3RM3T4L! folded before Flop (didn't bet)
Seat 5: abbi555 folded before Flop (didn't bet)
Seat 6: tightpokerAA folded on the River



PokerStars Zoom Hand #195022910154:  Hold'em No Limit ($0.10/$0.25) - 2018/12/29 3:14:06 UTC [2018/12/28 22:14:06 ET]
Table 'Hydra' 6-max Seat #1 is the button
Seat 1: BnanaBread13 ($25 in chips) 
Seat 2: _BluDeeN_ ($41.12 in chips) 
Seat 3: franco373513 ($13.74 in chips) 
Seat 4: Lehared ($52.86 in chips) 
Seat 5: SantiagoWeight ($76.51 in chips) 
Seat 6: ckriszee ($34.92 in chips) 
_BluDeeN_: posts small blind $0.10
franco373513: posts big blind $0.25
*** HOLE CARDS ***
Dealt to SantiagoWeight [Ks Qc]
Lehared: folds 
SantiagoWeight: raises $0.37 to $0.62
ckriszee: folds 
BnanaBread13: folds 
_BluDeeN_: folds 
franco373513: calls $0.37
*** FLOP *** [2h 4h 9s]
franco373513: checks 
SantiagoWeight: bets $0.32
franco373513: calls $0.32
*** TURN *** [2h 4h 9s] [Ah]
franco373513: checks 
SantiagoWeight: bets $1.26
franco373513: folds 
Uncalled bet ($1.26) returned to SantiagoWeight
SantiagoWeight collected $1.89 from pot
SantiagoWeight: doesn't show hand 
*** SUMMARY ***
Total pot $1.98 | Rake $0.09 
Board [2h 4h 9s Ah]
Seat 1: BnanaBread13 (button) folded before Flop (didn't bet)
Seat 2: _BluDeeN_ (small blind) folded before Flop
Seat 3: franco373513 (big blind) folded on the Turn
Seat 4: Lehared folded before Flop (didn't bet)
Seat 5: SantiagoWeight collected ($1.89)
Seat 6: ckriszee folded before Flop (didn't bet)



PokerStars Zoom Hand #195022932414:  Hold'em No Limit ($0.10/$0.25) - 2018/12/29 3:15:10 UTC [2018/12/28 22:15:10 ET]
Table 'Hydra' 6-max Seat #1 is the button
Seat 1: abbi555 ($27.10 in chips) 
Seat 2: ryanking99 ($45.44 in chips) 
Seat 3: mariopork ($26.60 in chips) 
Seat 4: SantiagoWeight ($77.46 in chips) 
Seat 5: qing328 ($32.20 in chips) 
Seat 6: Nutselas ($25 in chips) 
ryanking99: posts small blind $0.10
mariopork: posts big blind $0.25
*** HOLE CARDS ***
Dealt to SantiagoWeight [Kc Qs]
SantiagoWeight: raises $0.50 to $0.75
qing328: folds 
Nutselas: folds 
abbi555: folds 
ryanking99: folds 
mariopork: calls $0.50
*** FLOP *** [3c 4h 8h]
mariopork: checks 
SantiagoWeight: bets $0.90
mariopork: folds 
Uncalled bet ($0.90) returned to SantiagoWeight
SantiagoWeight collected $1.53 from pot
SantiagoWeight: doesn't show hand 
*** SUMMARY ***
Total pot $1.60 | Rake $0.07 
Board [3c 4h 8h]
Seat 1: abbi555 (button) folded before Flop (didn't bet)
Seat 2: ryanking99 (small blind) folded before Flop
Seat 3: mariopork (big blind) folded on the Flop
Seat 4: SantiagoWeight collected ($1.53)
Seat 5: qing328 folded before Flop (didn't bet)
Seat 6: Nutselas folded before Flop (didn't bet)



PokerStars Zoom Hand #195022952675:  Hold'em No Limit ($0.10/$0.25) - 2018/12/29 3:16:08 UTC [2018/12/28 22:16:08 ET]
Table 'Hydra' 6-max Seat #1 is the button
Seat 1: Gf Chipz ($15.31 in chips) 
Seat 2: pokerpienda ($10.14 in chips) 
Seat 3: 365DaysSucesful ($16.89 in chips) 
Seat 4: yobbos ($119.22 in chips) 
Seat 5: ivann14 ($77.52 in chips) 
Seat 6: SantiagoWeight ($78.14 in chips) 
pokerpienda: posts small blind $0.10
365DaysSucesful: posts big blind $0.25
*** HOLE CARDS ***
Dealt to SantiagoWeight [2d Th]
yobbos: folds 
ivann14: folds 
SantiagoWeight: folds 
Gf Chipz: raises $0.50 to $0.75
pokerpienda: folds 
365DaysSucesful: folds 
Uncalled bet ($0.50) returned to Gf Chipz
Gf Chipz collected $0.60 from pot
Gf Chipz: doesn't show hand 
*** SUMMARY ***
Total pot $0.60 | Rake $0 
Seat 1: Gf Chipz (button) collected ($0.60)
Seat 2: pokerpienda (small blind) folded before Flop
Seat 3: 365DaysSucesful (big blind) folded before Flop
Seat 4: yobbos folded before Flop (didn't bet)
Seat 5: ivann14 folded before Flop (didn't bet)
Seat 6: SantiagoWeight folded before Flop (didn't bet)



PokerStars Zoom Hand #195022954808:  Hold'em No Limit ($0.10/$0.25) - 2018/12/29 3:16:14 UTC [2018/12/28 22:16:14 ET]
Table 'Hydra' 6-max Seat #1 is the button
Seat 1: aa1421b ($32.62 in chips) 
Seat 2: Xp0Hb ($25.08 in chips) 
Seat 3: ckriszee ($78.07 in chips) 
Seat 4: ivann14 ($77.52 in chips) 
Seat 5: SantiagoWeight ($78.14 in chips) 
Seat 6: Dr.Jekyll197 ($38.06 in chips) 
Xp0Hb: posts small blind $0.10
ckriszee: posts big blind $0.25
*** HOLE CARDS ***
Dealt to SantiagoWeight [6h 8d]
ivann14: folds 
SantiagoWeight: folds 
Dr.Jekyll197: folds 
aa1421b: folds 
Xp0Hb: folds 
Uncalled bet ($0.15) returned to ckriszee
ckriszee collected $0.20 from pot
ckriszee: doesn't show hand 
*** SUMMARY ***
Total pot $0.20 | Rake $0 
Seat 1: aa1421b (button) folded before Flop (didn't bet)
Seat 2: Xp0Hb (small blind) folded before Flop
Seat 3: ckriszee (big blind) collected ($0.20)
Seat 4: ivann14 folded before Flop (didn't bet)
Seat 5: SantiagoWeight folded before Flop (didn't bet)
Seat 6: Dr.Jekyll197 folded before Flop (didn't bet)



PokerStars Zoom Hand #195022946800:  Hold'em No Limit ($0.10/$0.25) - 2018/12/29 3:15:51 UTC [2018/12/28 22:15:51 ET]
Table 'Hydra' 6-max Seat #1 is the button
Seat 1: 365DaysSucesful ($16.99 in chips) 
Seat 2: SantiagoWeight ($78.24 in chips) 
Seat 3: Sirfredulrik ($25.77 in chips) 
Seat 4: GQwang ($29.01 in chips) 
Seat 5: 1ownYourUsd ($32.06 in chips) 
Seat 6: Parsam5 ($48.55 in chips) 
SantiagoWeight: posts small blind $0.10
Sirfredulrik: posts big blind $0.25
*** HOLE CARDS ***
Dealt to SantiagoWeight [4c 6d]
GQwang: folds 
1ownYourUsd: raises $0.50 to $0.75
Parsam5: folds 
365DaysSucesful: folds 
SantiagoWeight: folds 
Sirfredulrik: calls $0.50
*** FLOP *** [9h Kh 5s]
Sirfredulrik: checks 
1ownYourUsd: bets $0.67
Sirfredulrik: calls $0.67
*** TURN *** [9h Kh 5s] [Ah]
Sirfredulrik: checks 
1ownYourUsd: checks 
*** RIVER *** [9h Kh 5s Ah] [2d]
Sirfredulrik: bets $1.66
1ownYourUsd: folds 
Uncalled bet ($1.66) returned to Sirfredulrik
Sirfredulrik collected $2.81 from pot
Sirfredulrik: doesn't show hand 
*** SUMMARY ***
Total pot $2.94 | Rake $0.13 
Board [9h Kh 5s Ah 2d]
Seat 1: 365DaysSucesful (button) folded before Flop (didn't bet)
Seat 2: SantiagoWeight (small blind) folded before Flop
Seat 3: Sirfredulrik (big blind) collected ($2.81)
Seat 4: GQwang folded before Flop (didn't bet)
Seat 5: 1ownYourUsd folded on the River
Seat 6: Parsam5 folded before Flop (didn't bet)



PokerStars Zoom Hand #195022949236:  Hold'em No Limit ($0.10/$0.25) - 2018/12/29 3:15:57 UTC [2018/12/28 22:15:57 ET]
Table 'Hydra' 6-max Seat #1 is the button
Seat 1: SantiagoWeight ($78.14 in chips) 
Seat 2: zdenekstavic ($40.90 in chips) 
Seat 3: _BluDeeN_ ($24.90 in chips) 
Seat 4: reggiedogg31 ($116.39 in chips) 
Seat 5: BnanaBread13 ($29.48 in chips) 
Seat 6: GrandmasterY ($25 in chips) 
zdenekstavic: posts small blind $0.10
_BluDeeN_: posts big blind $0.25
*** HOLE CARDS ***
Dealt to SantiagoWeight [2d 5s]
reggiedogg31: folds 
BnanaBread13: folds 
GrandmasterY: raises $0.50 to $0.75
SantiagoWeight: folds 
zdenekstavic: calls $0.65
_BluDeeN_: folds 
*** FLOP *** [9s 7d 4h]
zdenekstavic: checks 
GrandmasterY: checks 
*** TURN *** [9s 7d 4h] [8h]
zdenekstavic: bets $0.25
GrandmasterY: calls $0.25
*** RIVER *** [9s 7d 4h 8h] [6c]
zdenekstavic: bets $1.08
GrandmasterY: folds 
Uncalled bet ($1.08) returned to zdenekstavic
zdenekstavic collected $2.15 from pot
zdenekstavic: doesn't show hand 
*** SUMMARY ***
Total pot $2.25 | Rake $0.10 
Board [9s 7d 4h 8h 6c]
Seat 1: SantiagoWeight (button) folded before Flop (didn't bet)
Seat 2: zdenekstavic (small blind) collected ($2.15)
Seat 3: _BluDeeN_ (big blind) folded before Flop
Seat 4: reggiedogg31 folded before Flop (didn't bet)
Seat 5: BnanaBread13 folded before Flop (didn't bet)
Seat 6: GrandmasterY folded on the River



PokerStars Zoom Hand #195022959680:  Hold'em No Limit ($0.10/$0.25) - 2018/12/29 3:16:27 UTC [2018/12/28 22:16:27 ET]
Table 'Hydra' 6-max Seat #1 is the button
Seat 1: Jack123985 ($25 in chips) 
Seat 2: SantiagoWeight ($78.14 in chips) 
Seat 3: HonourMan23 ($33.28 in chips) 
Seat 4: 365DaysSucesful ($16.64 in chips) 
Seat 5: negreanuNya ($36.23 in chips) 
Seat 6: gamnai88 ($8.76 in chips) 
SantiagoWeight: posts small blind $0.10
HonourMan23: posts big blind $0.25
*** HOLE CARDS ***
Dealt to SantiagoWeight [2d 7d]
365DaysSucesful: folds 
negreanuNya: raises $0.35 to $0.60
gamnai88: folds 
Jack123985: calls $0.60
SantiagoWeight: folds 
HonourMan23: folds 
*** FLOP *** [9c Kh Jc]
negreanuNya: bets $1
Jack123985: folds 
Uncalled bet ($1) returned to negreanuNya
negreanuNya collected $1.48 from pot
negreanuNya: doesn't show hand 
*** SUMMARY ***
Total pot $1.55 | Rake $0.07 
Board [9c Kh Jc]
Seat 1: Jack123985 (button) folded on the Flop
Seat 2: SantiagoWeight (small blind) folded before Flop
Seat 3: HonourMan23 (big blind) folded before Flop
Seat 4: 365DaysSucesful folded before Flop (didn't bet)
Seat 5: negreanuNya collected ($1.48)
Seat 6: gamnai88 folded before Flop (didn't bet)



PokerStars Zoom Hand #195022968119:  Hold'em No Limit ($0.10/$0.25) - 2018/12/29 3:16:52 UTC [2018/12/28 22:16:52 ET]
Table 'Hydra' 6-max Seat #1 is the button
Seat 1: yobbos ($118.70 in chips) 
Seat 2: Lehared ($112.11 in chips) 
Seat 3: SantiagoWeight ($78.04 in chips) 
Seat 4: abbi555 ($26.30 in chips) 
Seat 5: moderi ($29.77 in chips) 
Seat 6: Gongyong ($25 in chips) 
Lehared: posts small blind $0.10
SantiagoWeight: posts big blind $0.25
*** HOLE CARDS ***
Dealt to SantiagoWeight [Qh 8d]
abbi555: folds 
moderi: folds 
Gongyong: folds 
yobbos: raises $0.37 to $0.62
Lehared: folds 
SantiagoWeight: folds 
Uncalled bet ($0.37) returned to yobbos
yobbos collected $0.60 from pot
yobbos: doesn't show hand 
*** SUMMARY ***
Total pot $0.60 | Rake $0 
Seat 1: yobbos (button) collected ($0.60)
Seat 2: Lehared (small blind) folded before Flop
Seat 3: SantiagoWeight (big blind) folded before Flop
Seat 4: abbi555 folded before Flop (didn't bet)
Seat 5: moderi folded before Flop (didn't bet)
Seat 6: Gongyong folded before Flop (didn't bet)



PokerStars Zoom Hand #195022986850:  Hold'em No Limit ($0.10/$0.25) - 2018/12/29 3:17:45 UTC [2018/12/28 22:17:45 ET]
Table 'Hydra' 6-max Seat #1 is the button
Seat 1: SantiagoWeight ($77.79 in chips) 
Seat 2: Actarusqc ($49.18 in chips) 
Seat 3: yobbos ($118.95 in chips) 
Seat 4: sigaro010 ($37.74 in chips) 
Seat 5: franco373513 ($15.52 in chips) 
Seat 6: davidhw888 ($18.74 in chips) 
Actarusqc: posts small blind $0.10
yobbos: posts big blind $0.25
*** HOLE CARDS ***
Dealt to SantiagoWeight [As Tc]
sigaro010: raises $0.50 to $0.75
franco373513: folds 
davidhw888: calls $0.75
SantiagoWeight: folds 
Actarusqc: calls $0.65
yobbos: calls $0.50
*** FLOP *** [7d Kh 4h]
Actarusqc: checks 
yobbos: checks 
sigaro010: bets $1.89
davidhw888: folds 
Actarusqc: folds 
yobbos: folds 
Uncalled bet ($1.89) returned to sigaro010
sigaro010 collected $2.86 from pot
sigaro010: doesn't show hand 
*** SUMMARY ***
Total pot $3 | Rake $0.14 
Board [7d Kh 4h]
Seat 1: SantiagoWeight (button) folded before Flop (didn't bet)
Seat 2: Actarusqc (small blind) folded on the Flop
Seat 3: yobbos (big blind) folded on the Flop
Seat 4: sigaro010 collected ($2.86)
Seat 5: franco373513 folded before Flop (didn't bet)
Seat 6: davidhw888 folded on the Flop



PokerStars Zoom Hand #195022989964:  Hold'em No Limit ($0.10/$0.25) - 2018/12/29 3:17:54 UTC [2018/12/28 22:17:54 ET]
Table 'Hydra' 6-max Seat #1 is the button
Seat 1: river plate9 ($30.79 in chips) 
Seat 2: reademenweep ($21.57 in chips) 
Seat 3: Pardaroxon ($25.36 in chips) 
Seat 4: SantiagoWeight ($77.79 in chips) 
Seat 5: nhanminhtri ($29.97 in chips) 
Seat 6: Nutselas ($28.66 in chips) 
reademenweep: posts small blind $0.10
Pardaroxon: posts big blind $0.25
*** HOLE CARDS ***
Dealt to SantiagoWeight [5h 4h]
SantiagoWeight: folds 
nhanminhtri: folds 
Nutselas: raises $0.50 to $0.75
river plate9: folds 
reademenweep: folds 
Pardaroxon: folds 
Uncalled bet ($0.50) returned to Nutselas
Nutselas collected $0.60 from pot
Nutselas: doesn't show hand 
*** SUMMARY ***
Total pot $0.60 | Rake $0 
Seat 1: river plate9 (button) folded before Flop (didn't bet)
Seat 2: reademenweep (small blind) folded before Flop
Seat 3: Pardaroxon (big blind) folded before Flop
Seat 4: SantiagoWeight folded before Flop (didn't bet)
Seat 5: nhanminhtri folded before Flop (didn't bet)
Seat 6: Nutselas collected ($0.60)



PokerStars Zoom Hand #195022974808:  Hold'em No Limit ($0.10/$0.25) - 2018/12/29 3:17:11 UTC [2018/12/28 22:17:11 ET]
Table 'Hydra' 6-max Seat #1 is the button
Seat 1: anorectal ($81.25 in chips) 
Seat 2: _BluDeeN_ ($24.65 in chips) 
Seat 3: mariopork ($37.79 in chips) 
Seat 4: yobbos ($30.65 in chips) 
Seat 5: ckriszee ($27.15 in chips) 
Seat 6: SantiagoWeight ($77.79 in chips) 
_BluDeeN_: posts small blind $0.10
mariopork: posts big blind $0.25
*** HOLE CARDS ***
Dealt to SantiagoWeight [2d 9h]
yobbos: raises $0.50 to $0.75
ckriszee: folds 
SantiagoWeight: folds 
anorectal: calls $0.75
_BluDeeN_: raises $2.50 to $3.25
mariopork: folds 
yobbos: folds 
anorectal: calls $2.50
*** FLOP *** [5s 7s Ad]
_BluDeeN_: bets $3.25
anorectal: calls $3.25
*** TURN *** [5s 7s Ad] [Kc]
_BluDeeN_: bets $6.75
anorectal: calls $6.75
*** RIVER *** [5s 7s Ad Kc] [6s]
_BluDeeN_: checks 
anorectal: bets $14.44
_BluDeeN_: folds 
Uncalled bet ($14.44) returned to anorectal
anorectal collected $26.26 from pot
anorectal: doesn't show hand 
*** SUMMARY ***
Total pot $27.50 | Rake $1.24 
Board [5s 7s Ad Kc 6s]
Seat 1: anorectal (button) collected ($26.26)
Seat 2: _BluDeeN_ (small blind) folded on the River
Seat 3: mariopork (big blind) folded before Flop
Seat 4: yobbos folded before Flop
Seat 5: ckriszee folded before Flop (didn't bet)
Seat 6: SantiagoWeight folded before Flop (didn't bet)



PokerStars Zoom Hand #195022992813:  Hold'em No Limit ($0.10/$0.25) - 2018/12/29 3:18:02 UTC [2018/12/28 22:18:02 ET]
Table 'Hydra' 6-max Seat #1 is the button
Seat 1: nhanminhtri ($29.97 in chips) 
Seat 2: CrazieFreddy ($23.40 in chips) 
Seat 3: SantiagoWeight ($77.79 in chips) 
Seat 4: seba6688 ($10.90 in chips) 
Seat 5: river plate9 ($19.70 in chips) 
Seat 6: !P0K3RM3T4L! ($66.84 in chips) 
CrazieFreddy: posts small blind $0.10
SantiagoWeight: posts big blind $0.25
*** HOLE CARDS ***
Dealt to SantiagoWeight [Kh 7s]
seba6688: folds 
river plate9: folds 
!P0K3RM3T4L!: folds 
nhanminhtri: raises $0.37 to $0.62
CrazieFreddy: folds 
SantiagoWeight: calls $0.37
*** FLOP *** [6h 6c 6s]
SantiagoWeight: checks 
nhanminhtri: bets $0.70
SantiagoWeight: folds 
Uncalled bet ($0.70) returned to nhanminhtri
nhanminhtri collected $1.28 from pot
nhanminhtri: doesn't show hand 
*** SUMMARY ***
Total pot $1.34 | Rake $0.06 
Board [6h 6c 6s]
Seat 1: nhanminhtri (button) collected ($1.28)
Seat 2: CrazieFreddy (small blind) folded before Flop
Seat 3: SantiagoWeight (big blind) folded on the Flop
Seat 4: seba6688 folded before Flop (didn't bet)
Seat 5: river plate9 folded before Flop (didn't bet)
Seat 6: !P0K3RM3T4L! folded before Flop (didn't bet)



PokerStars Zoom Hand #195022979509:  Hold'em No Limit ($0.10/$0.25) - 2018/12/29 3:17:24 UTC [2018/12/28 22:17:24 ET]
Table 'Hydra' 6-max Seat #1 is the button
Seat 1: abbi555 ($25.95 in chips) 
Seat 2: BMB8888 ($53.31 in chips) 
Seat 3: Xa4_88 ($72.79 in chips) 
Seat 4: SantiagoWeight ($77.79 in chips) 
Seat 5: nhanminhtri ($35.63 in chips) 
Seat 6: yobbos ($66.35 in chips) 
BMB8888: posts small blind $0.10
Xa4_88: posts big blind $0.25
*** HOLE CARDS ***
Dealt to SantiagoWeight [4h 8c]
SantiagoWeight has timed out
SantiagoWeight: folds 
nhanminhtri: folds 
yobbos: raises $0.37 to $0.62
abbi555: folds 
BMB8888: calls $0.52
Xa4_88: calls $0.37
*** FLOP *** [Ks 7d 4c]
BMB8888: checks 
Xa4_88: checks 
yobbos: bets $0.89
BMB8888: calls $0.89
Xa4_88: calls $0.89
*** TURN *** [Ks 7d 4c] [6h]
BMB8888: checks 
Xa4_88: checks 
yobbos: bets $2.75
BMB8888: raises $49.05 to $51.80 and is all-in
Xa4_88: folds 
yobbos: folds 
Uncalled bet ($49.05) returned to BMB8888
BMB8888 collected $9.58 from pot
BMB8888: doesn't show hand 
*** SUMMARY ***
Total pot $10.03 | Rake $0.45 
Board [Ks 7d 4c 6h]
Seat 1: abbi555 (button) folded before Flop (didn't bet)
Seat 2: BMB8888 (small blind) collected ($9.58)
Seat 3: Xa4_88 (big blind) folded on the Turn
Seat 4: SantiagoWeight folded before Flop (didn't bet)
Seat 5: nhanminhtri folded before Flop (didn't bet)
Seat 6: yobbos folded on the Turn



PokerStars Zoom Hand #195023008089:  Hold'em No Limit ($0.10/$0.25) - 2018/12/29 3:18:46 UTC [2018/12/28 22:18:46 ET]
Table 'Hydra' 6-max Seat #1 is the button
Seat 1: osa126 ($28.16 in chips) 
Seat 2: Duky358 ($25.10 in chips) 
Seat 3: rim975 ($15.35 in chips) 
Seat 4: PITS316 ($18.60 in chips) 
Seat 5: SantiagoWeight ($77.17 in chips) 
Seat 6: seba6688 ($10.80 in chips) 
Duky358: posts small blind $0.10
rim975: posts big blind $0.25
*** HOLE CARDS ***
Dealt to SantiagoWeight [7c Ac]
PITS316: folds 
SantiagoWeight: raises $0.37 to $0.62
seba6688: folds 
osa126: calls $0.62
Duky358: folds 
rim975: folds 
*** FLOP *** [3s 6c 3h]
SantiagoWeight: bets $0.38
osa126: folds 
Uncalled bet ($0.38) returned to SantiagoWeight
SantiagoWeight collected $1.52 from pot
SantiagoWeight: doesn't show hand 
*** SUMMARY ***
Total pot $1.59 | Rake $0.07 
Board [3s 6c 3h]
Seat 1: osa126 (button) folded on the Flop
Seat 2: Duky358 (small blind) folded before Flop
Seat 3: rim975 (big blind) folded before Flop
Seat 4: PITS316 folded before Flop (didn't bet)
Seat 5: SantiagoWeight collected ($1.52)
Seat 6: seba6688 folded before Flop (didn't bet)



PokerStars Zoom Hand #195023016796:  Hold'em No Limit ($0.10/$0.25) - 2018/12/29 3:19:11 UTC [2018/12/28 22:19:11 ET]
Table 'Hydra' 6-max Seat #1 is the button
Seat 1: --LeGaaNs-- ($48.41 in chips) 
Seat 2: SantiagoWeight ($78.07 in chips) 
Seat 3: nhanminhtri ($29.61 in chips) 
Seat 4: Dr.Jekyll197 ($35.15 in chips) 
Seat 5: Duky358 ($25 in chips) 
Seat 6: !P0K3RM3T4L! ($65.99 in chips) 
SantiagoWeight: posts small blind $0.10
nhanminhtri: posts big blind $0.25
*** HOLE CARDS ***
Dealt to SantiagoWeight [2c 8s]
Dr.Jekyll197: raises $0.50 to $0.75
Duky358: folds 
!P0K3RM3T4L!: folds 
--LeGaaNs--: folds 
SantiagoWeight: folds 
nhanminhtri: folds 
Uncalled bet ($0.50) returned to Dr.Jekyll197
Dr.Jekyll197 collected $0.60 from pot
Dr.Jekyll197: doesn't show hand 
*** SUMMARY ***
Total pot $0.60 | Rake $0 
Seat 1: --LeGaaNs-- (button) folded before Flop (didn't bet)
Seat 2: SantiagoWeight (small blind) folded before Flop
Seat 3: nhanminhtri (big blind) folded before Flop
Seat 4: Dr.Jekyll197 collected ($0.60)
Seat 5: Duky358 folded before Flop (didn't bet)
Seat 6: !P0K3RM3T4L! folded before Flop (didn't bet)



PokerStars Zoom Hand #195023025034:  Hold'em No Limit ($0.10/$0.25) - 2018/12/29 3:19:35 UTC [2018/12/28 22:19:35 ET]
Table 'Hydra' 6-max Seat #1 is the button
Seat 1: SantiagoWeight ($77.97 in chips) 
Seat 2: HansMSM ($29.07 in chips) 
Seat 3: Party4Arthy ($82.18 in chips) 
Seat 4: BnanaBread13 ($25 in chips) 
Seat 5: franco373513 ($14.17 in chips) 
Seat 6: Kirac99 ($13.46 in chips) 
HansMSM: posts small blind $0.10
Party4Arthy: posts big blind $0.25
*** HOLE CARDS ***
Dealt to SantiagoWeight [4h Qs]
BnanaBread13: folds 
franco373513: folds 
Kirac99: folds 
SantiagoWeight: folds 
HansMSM: raises $0.55 to $0.80
Party4Arthy has timed out
Party4Arthy: folds 
Uncalled bet ($0.55) returned to HansMSM
HansMSM collected $0.50 from pot
HansMSM: doesn't show hand 
*** SUMMARY ***
Total pot $0.50 | Rake $0 
Seat 1: SantiagoWeight (button) folded before Flop (didn't bet)
Seat 2: HansMSM (small blind) collected ($0.50)
Seat 3: Party4Arthy (big blind) folded before Flop
Seat 4: BnanaBread13 folded before Flop (didn't bet)
Seat 5: franco373513 folded before Flop (didn't bet)
Seat 6: Kirac99 folded before Flop (didn't bet)



PokerStars Zoom Hand #195023035277:  Hold'em No Limit ($0.10/$0.25) - 2018/12/29 3:20:05 UTC [2018/12/28 22:20:05 ET]
Table 'Hydra' 6-max Seat #1 is the button
Seat 1: abbi555 ($26.81 in chips) 
Seat 2: Antwerken ($13 in chips) 
Seat 3: SantiagoWeight ($77.97 in chips) 
Seat 4: pfunkolstar ($25 in chips) 
Seat 5: miru877 ($26.36 in chips) 
Seat 6: Xp0Hb ($25.81 in chips) 
Antwerken: posts small blind $0.10
SantiagoWeight: posts big blind $0.25
*** HOLE CARDS ***
Dealt to SantiagoWeight [Td 7c]
pfunkolstar: raises $0.37 to $0.62
miru877: folds 
Xp0Hb: folds 
abbi555: folds 
Antwerken: folds 
SantiagoWeight: folds 
Uncalled bet ($0.37) returned to pfunkolstar
pfunkolstar collected $0.60 from pot
*** SUMMARY ***
Total pot $0.60 | Rake $0 
Seat 1: abbi555 (button) folded before Flop (didn't bet)
Seat 2: Antwerken (small blind) folded before Flop
Seat 3: SantiagoWeight (big blind) folded before Flop
Seat 4: pfunkolstar collected ($0.60)
Seat 5: miru877 folded before Flop (didn't bet)
Seat 6: Xp0Hb folded before Flop (didn't bet)



PokerStars Zoom Hand #195023030178:  Hold'em No Limit ($0.10/$0.25) - 2018/12/29 3:19:50 UTC [2018/12/28 22:19:50 ET]
Table 'Hydra' 6-max Seat #1 is the button
Seat 1: killerB17 ($34.56 in chips) 
Seat 2: MarcoA12 ($61.61 in chips) 
Seat 3: numbernine5 ($33.61 in chips) 
Seat 4: zdena102 ($15.47 in chips) 
Seat 5: TQNYMQNTANA ($108.23 in chips) 
Seat 6: SantiagoWeight ($77.97 in chips) 
MarcoA12: posts small blind $0.10
numbernine5: posts big blind $0.25
*** HOLE CARDS ***
Dealt to SantiagoWeight [4s Qs]
zdena102: raises $0.25 to $0.50
TQNYMQNTANA: folds 
SantiagoWeight: folds 
killerB17: folds 
MarcoA12: calls $0.40
numbernine5: folds 
*** FLOP *** [5c 6s 5d]
MarcoA12: checks 
zdena102: bets $0.75
MarcoA12: calls $0.75
*** TURN *** [5c 6s 5d] [7d]
MarcoA12: checks 
zdena102: bets $1
MarcoA12: raises $1 to $2
zdena102: calls $1
*** RIVER *** [5c 6s 5d 7d] [Qh]
MarcoA12: bets $6.50
zdena102: folds 
Uncalled bet ($6.50) returned to MarcoA12
MarcoA12 collected $6.45 from pot
MarcoA12: doesn't show hand 
*** SUMMARY ***
Total pot $6.75 | Rake $0.30 
Board [5c 6s 5d 7d Qh]
Seat 1: killerB17 (button) folded before Flop (didn't bet)
Seat 2: MarcoA12 (small blind) collected ($6.45)
Seat 3: numbernine5 (big blind) folded before Flop
Seat 4: zdena102 folded on the River
Seat 5: TQNYMQNTANA folded before Flop (didn't bet)
Seat 6: SantiagoWeight folded before Flop (didn't bet)



PokerStars Zoom Hand #195023040773:  Hold'em No Limit ($0.10/$0.25) - 2018/12/29 3:20:21 UTC [2018/12/28 22:20:21 ET]
Table 'Hydra' 6-max Seat #1 is the button
Seat 1: angipoker ($12.95 in chips) 
Seat 2: numbernine5 ($32.61 in chips) 
Seat 3: Xp0Hb ($25.71 in chips) 
Seat 4: nhanminhtri ($41.76 in chips) 
Seat 5: SantiagoWeight ($77.72 in chips) 
Seat 6: pfunkolstar ($26.15 in chips) 
numbernine5: posts small blind $0.10
Xp0Hb: posts big blind $0.25
*** HOLE CARDS ***
Dealt to SantiagoWeight [7s Ad]
nhanminhtri: folds 
SantiagoWeight: folds 
pfunkolstar: raises $0.37 to $0.62
angipoker: calls $0.62
numbernine5: raises $1.86 to $2.48
Xp0Hb: folds 
pfunkolstar: folds 
angipoker: folds 
Uncalled bet ($1.86) returned to numbernine5
numbernine5 collected $2.11 from pot
numbernine5: doesn't show hand 
*** SUMMARY ***
Total pot $2.11 | Rake $0 
Seat 1: angipoker (button) folded before Flop
Seat 2: numbernine5 (small blind) collected ($2.11)
Seat 3: Xp0Hb (big blind) folded before Flop
Seat 4: nhanminhtri folded before Flop (didn't bet)
Seat 5: SantiagoWeight folded before Flop (didn't bet)
Seat 6: pfunkolstar folded before Flop



PokerStars Zoom Hand #195023042486:  Hold'em No Limit ($0.10/$0.25) - 2018/12/29 3:20:26 UTC [2018/12/28 22:20:26 ET]
Table 'Hydra' 6-max Seat #1 is the button
Seat 1: 1ownYourUsd ($37 in chips) 
Seat 2: SantiagoWeight ($77.72 in chips) 
Seat 3: HonourMan23 ($31.83 in chips) 
Seat 4: zxlazy ($19.68 in chips) 
Seat 5: TQNYMQNTANA ($107.88 in chips) 
Seat 6: gift-cloud9 ($25 in chips) 
SantiagoWeight: posts small blind $0.10
HonourMan23: posts big blind $0.25
*** HOLE CARDS ***
Dealt to SantiagoWeight [8d Js]
zxlazy: folds 
TQNYMQNTANA: raises $0.50 to $0.75
gift-cloud9: folds 
1ownYourUsd: calls $0.75
SantiagoWeight: folds 
HonourMan23: folds 
*** FLOP *** [9h 9d 2s]
TQNYMQNTANA: checks 
1ownYourUsd: checks 
*** TURN *** [9h 9d 2s] [2c]
TQNYMQNTANA: bets $1
1ownYourUsd: folds 
Uncalled bet ($1) returned to TQNYMQNTANA
TQNYMQNTANA collected $1.77 from pot
TQNYMQNTANA: doesn't show hand 
*** SUMMARY ***
Total pot $1.85 | Rake $0.08 
Board [9h 9d 2s 2c]
Seat 1: 1ownYourUsd (button) folded on the Turn
Seat 2: SantiagoWeight (small blind) folded before Flop
Seat 3: HonourMan23 (big blind) folded before Flop
Seat 4: zxlazy folded before Flop (didn't bet)
Seat 5: TQNYMQNTANA collected ($1.77)
Seat 6: gift-cloud9 folded before Flop (didn't bet)



PokerStars Zoom Hand #195023052146:  Hold'em No Limit ($0.10/$0.25) - 2018/12/29 3:20:54 UTC [2018/12/28 22:20:54 ET]
Table 'Hydra' 6-max Seat #1 is the button
Seat 1: SantiagoWeight ($77.62 in chips) 
Seat 2: angipoker ($13.16 in chips) 
Seat 3: --LeGaaNs-- ($48.62 in chips) 
Seat 4: Bujan 07 ($19.17 in chips) 
Seat 5: Parsam5 ($50.98 in chips) 
Seat 6: SirSatan001 ($25.86 in chips) 
angipoker: posts small blind $0.10
--LeGaaNs--: posts big blind $0.25
*** HOLE CARDS ***
Dealt to SantiagoWeight [Th Ad]
Bujan 07: folds 
Parsam5: folds 
SirSatan001: raises $0.50 to $0.75
SantiagoWeight: calls $0.75
angipoker: folds 
--LeGaaNs--: folds 
*** FLOP *** [8s 8c Qd]
SirSatan001: bets $0.89
SantiagoWeight: folds 
Uncalled bet ($0.89) returned to SirSatan001
SirSatan001 collected $1.77 from pot
*** SUMMARY ***
Total pot $1.85 | Rake $0.08 
Board [8s 8c Qd]
Seat 1: SantiagoWeight (button) folded on the Flop
Seat 2: angipoker (small blind) folded before Flop
Seat 3: --LeGaaNs-- (big blind) folded before Flop
Seat 4: Bujan 07 folded before Flop (didn't bet)
Seat 5: Parsam5 folded before Flop (didn't bet)
Seat 6: SirSatan001 collected ($1.77)



PokerStars Zoom Hand #195023079638:  Hold'em No Limit ($0.10/$0.25) - 2018/12/29 3:22:14 UTC [2018/12/28 22:22:14 ET]
Table 'Hydra' 6-max Seat #1 is the button
Seat 1: Ovanes911 ($22.05 in chips) 
Seat 2: yobbos ($25 in chips) 
Seat 3: SantiagoWeight ($76.25 in chips) 
Seat 4: BnanaBread13 ($25.10 in chips) 
Seat 5: angipoker ($13.30 in chips) 
Seat 6: Aescul@pius ($26.31 in chips) 
yobbos: posts small blind $0.10
SantiagoWeight: posts big blind $0.25
*** HOLE CARDS ***
Dealt to SantiagoWeight [6h Kd]
BnanaBread13: folds 
angipoker: folds 
Aescul@pius: raises $0.25 to $0.50
Ovanes911: folds 
yobbos: folds 
SantiagoWeight: folds 
Uncalled bet ($0.25) returned to Aescul@pius
Aescul@pius collected $0.60 from pot
*** SUMMARY ***
Total pot $0.60 | Rake $0 
Seat 1: Ovanes911 (button) folded before Flop (didn't bet)
Seat 2: yobbos (small blind) folded before Flop
Seat 3: SantiagoWeight (big blind) folded before Flop
Seat 4: BnanaBread13 folded before Flop (didn't bet)
Seat 5: angipoker folded before Flop (didn't bet)
Seat 6: Aescul@pius collected ($0.60)



PokerStars Zoom Hand #195023085753:  Hold'em No Limit ($0.10/$0.25) - 2018/12/29 3:22:32 UTC [2018/12/28 22:22:32 ET]
Table 'Hydra' 6-max Seat #1 is the button
Seat 1: cankum ($25.34 in chips) 
Seat 2: SantiagoWeight ($76 in chips) 
Seat 3: negreanuNya ($43.46 in chips) 
Seat 4: G ster24 ($24.46 in chips) 
Seat 5: TQNYMQNTANA ($108.90 in chips) 
Seat 6: Lehared ($53.31 in chips) 
SantiagoWeight: posts small blind $0.10
negreanuNya: posts big blind $0.25
*** HOLE CARDS ***
Dealt to SantiagoWeight [5h 4c]
G ster24: raises $0.25 to $0.50
TQNYMQNTANA: folds 
Lehared: folds 
cankum: folds 
SantiagoWeight: folds 
negreanuNya: folds 
Uncalled bet ($0.25) returned to G ster24
G ster24 collected $0.60 from pot
G ster24: doesn't show hand 
*** SUMMARY ***
Total pot $0.60 | Rake $0 
Seat 1: cankum (button) folded before Flop (didn't bet)
Seat 2: SantiagoWeight (small blind) folded before Flop
Seat 3: negreanuNya (big blind) folded before Flop
Seat 4: G ster24 collected ($0.60)
Seat 5: TQNYMQNTANA folded before Flop (didn't bet)
Seat 6: Lehared folded before Flop (didn't bet)



PokerStars Zoom Hand #195023089213:  Hold'em No Limit ($0.10/$0.25) - 2018/12/29 3:22:42 UTC [2018/12/28 22:22:42 ET]
Table 'Hydra' 6-max Seat #1 is the button
Seat 1: aldoalb0207 ($58.76 in chips) 
Seat 2: IceAgeDream7 ($24.51 in chips) 
Seat 3: Rollout2018 ($21.60 in chips) 
Seat 4: zxlazy ($18.82 in chips) 
Seat 5: SantiagoWeight ($75.90 in chips) 
Seat 6: GrandmasterY ($25 in chips) 
IceAgeDream7: posts small blind $0.10
Rollout2018: posts big blind $0.25
*** HOLE CARDS ***
Dealt to SantiagoWeight [7c Ks]
zxlazy: raises $0.40 to $0.65
SantiagoWeight: folds 
GrandmasterY: folds 
aldoalb0207: folds 
IceAgeDream7: folds 
Rollout2018: folds 
Uncalled bet ($0.40) returned to zxlazy
zxlazy collected $0.60 from pot
zxlazy: doesn't show hand 
*** SUMMARY ***
Total pot $0.60 | Rake $0 
Seat 1: aldoalb0207 (button) folded before Flop (didn't bet)
Seat 2: IceAgeDream7 (small blind) folded before Flop
Seat 3: Rollout2018 (big blind) folded before Flop
Seat 4: zxlazy collected ($0.60)
Seat 5: SantiagoWeight folded before Flop (didn't bet)
Seat 6: GrandmasterY folded before Flop (didn't bet)



PokerStars Zoom Hand #195023066909:  Hold'em No Limit ($0.10/$0.25) - 2018/12/29 3:21:37 UTC [2018/12/28 22:21:37 ET]
Table 'Hydra' 6-max Seat #1 is the button
Seat 1: GQwang ($32.85 in chips) 
Seat 2: TDAK1509 ($65.41 in chips) 
Seat 3: zdena102 ($10.72 in chips) 
Seat 4: miru877 ($23.42 in chips) 
Seat 5: Jack123985 ($25 in chips) 
Seat 6: SantiagoWeight ($76.87 in chips) 
TDAK1509: posts small blind $0.10
zdena102: posts big blind $0.25
*** HOLE CARDS ***
Dealt to SantiagoWeight [Kd Qh]
miru877: folds 
Jack123985: raises $0.37 to $0.62
SantiagoWeight: calls $0.62
GQwang: raises $1.96 to $2.58
TDAK1509: folds 
zdena102: folds 
Jack123985: calls $1.96
SantiagoWeight: folds 
*** FLOP *** [6h 5s Kc]
Jack123985: checks 
GQwang: checks 
*** TURN *** [6h 5s Kc] [Ks]
Jack123985: checks 
GQwang: checks 
*** RIVER *** [6h 5s Kc Ks] [Jc]
Jack123985: bets $1.93
GQwang: calls $1.93
*** SHOW DOWN ***
Jack123985: shows [Jh Ah] (two pair, Kings and Jacks)
GQwang: mucks hand 
Jack123985 collected $9.54 from pot
*** SUMMARY ***
Total pot $9.99 | Rake $0.45 
Board [6h 5s Kc Ks Jc]
Seat 1: GQwang (button) mucked [8h 8d]
Seat 2: TDAK1509 (small blind) folded before Flop
Seat 3: zdena102 (big blind) folded before Flop
Seat 4: miru877 folded before Flop (didn't bet)
Seat 5: Jack123985 showed [Jh Ah] and won ($9.54) with two pair, Kings and Jacks
Seat 6: SantiagoWeight folded before Flop



PokerStars Zoom Hand #195023090898:  Hold'em No Limit ($0.10/$0.25) - 2018/12/29 3:22:47 UTC [2018/12/28 22:22:47 ET]
Table 'Hydra' 6-max Seat #1 is the button
Seat 1: SantiagoWeight ($75.90 in chips) 
Seat 2: Baboscrubx ($31.74 in chips) 
Seat 3: Unclesmoll ($5.38 in chips) 
Seat 4: SirSatan001 ($24.26 in chips) 
Seat 5: Parsam5 ($69.03 in chips) 
Seat 6: nhanminhtri ($25.35 in chips) 
Baboscrubx: posts small blind $0.10
Unclesmoll: posts big blind $0.25
*** HOLE CARDS ***
Dealt to SantiagoWeight [4d 9c]
SirSatan001: raises $0.25 to $0.50
Parsam5: raises $1.50 to $2
nhanminhtri: folds 
SantiagoWeight: folds 
Baboscrubx: folds 
Unclesmoll: folds 
SirSatan001: folds 
Uncalled bet ($1.50) returned to Parsam5
Parsam5 collected $1.35 from pot
Parsam5: doesn't show hand 
*** SUMMARY ***
Total pot $1.35 | Rake $0 
Seat 1: SantiagoWeight (button) folded before Flop (didn't bet)
Seat 2: Baboscrubx (small blind) folded before Flop
Seat 3: Unclesmoll (big blind) folded before Flop
Seat 4: SirSatan001 folded before Flop
Seat 5: Parsam5 collected ($1.35)
Seat 6: nhanminhtri folded before Flop (didn't bet)



PokerStars Zoom Hand #195023094334:  Hold'em No Limit ($0.10/$0.25) - 2018/12/29 3:22:57 UTC [2018/12/28 22:22:57 ET]
Table 'Hydra' 6-max Seat #1 is the button
Seat 1: Party4Arthy ($79.22 in chips) 
Seat 2: Mrs_Squeeze ($33.66 in chips) 
Seat 3: crux1994 ($21.06 in chips) 
Seat 4: SantiagoWeight ($75.90 in chips) 
Seat 5: osa126 ($25.45 in chips) 
Seat 6: mayadelrey ($57.13 in chips) 
Mrs_Squeeze: posts small blind $0.10
crux1994: posts big blind $0.25
*** HOLE CARDS ***
Dealt to SantiagoWeight [Td 8s]
SantiagoWeight: folds 
osa126: raises $0.50 to $0.75
mayadelrey: folds 
Party4Arthy: folds 
Mrs_Squeeze: folds 
crux1994: folds 
Uncalled bet ($0.50) returned to osa126
osa126 collected $0.60 from pot
osa126: doesn't show hand 
*** SUMMARY ***
Total pot $0.60 | Rake $0 
Seat 1: Party4Arthy (button) folded before Flop (didn't bet)
Seat 2: Mrs_Squeeze (small blind) folded before Flop
Seat 3: crux1994 (big blind) folded before Flop
Seat 4: SantiagoWeight folded before Flop (didn't bet)
Seat 5: osa126 collected ($0.60)
Seat 6: mayadelrey folded before Flop (didn't bet)



PokerStars Zoom Hand #195023095984:  Hold'em No Limit ($0.10/$0.25) - 2018/12/29 3:23:02 UTC [2018/12/28 22:23:02 ET]
Table 'Hydra' 6-max Seat #1 is the button
Seat 1: nhanminhtri ($29.21 in chips) 
Seat 2: SirSatan001 ($23.76 in chips) 
Seat 3: Lehared ($53.21 in chips) 
Seat 4: gaffer31 ($20.65 in chips) 
Seat 5: SantiagoWeight ($75.90 in chips) 
Seat 6: yobbos ($25.10 in chips) 
SirSatan001: posts small blind $0.10
Lehared: posts big blind $0.25
*** HOLE CARDS ***
Dealt to SantiagoWeight [9s 5h]
gaffer31: raises $0.50 to $0.75
SantiagoWeight: folds 
yobbos: folds 
nhanminhtri: folds 
SirSatan001: folds 
Lehared: folds 
Uncalled bet ($0.50) returned to gaffer31
gaffer31 collected $0.60 from pot
gaffer31: doesn't show hand 
*** SUMMARY ***
Total pot $0.60 | Rake $0 
Seat 1: nhanminhtri (button) folded before Flop (didn't bet)
Seat 2: SirSatan001 (small blind) folded before Flop
Seat 3: Lehared (big blind) folded before Flop
Seat 4: gaffer31 collected ($0.60)
Seat 5: SantiagoWeight folded before Flop (didn't bet)
Seat 6: yobbos folded before Flop (didn't bet)



PokerStars Zoom Hand #195023092913:  Hold'em No Limit ($0.10/$0.25) - 2018/12/29 3:22:53 UTC [2018/12/28 22:22:53 ET]
Table 'Hydra' 6-max Seat #1 is the button
Seat 1: seba6688 ($13.15 in chips) 
Seat 2: nhanminhtri ($30.20 in chips) 
Seat 3: Viiiru ($25 in chips) 
Seat 4: anorectal ($35.17 in chips) 
Seat 5: Lehared ($53.21 in chips) 
Seat 6: SantiagoWeight ($75.90 in chips) 
nhanminhtri: posts small blind $0.10
Viiiru: posts big blind $0.25
*** HOLE CARDS ***
Dealt to SantiagoWeight [6c 3h]
anorectal: raises $0.45 to $0.70
Lehared: folds 
SantiagoWeight: folds 
seba6688: calls $0.70
nhanminhtri: calls $0.60
Viiiru: folds 
*** FLOP *** [7h 3s Qc]
nhanminhtri: checks 
anorectal: bets $2.91
seba6688: folds 
nhanminhtri: folds 
Uncalled bet ($2.91) returned to anorectal
anorectal collected $2.24 from pot
anorectal: doesn't show hand 
*** SUMMARY ***
Total pot $2.35 | Rake $0.11 
Board [7h 3s Qc]
Seat 1: seba6688 (button) folded on the Flop
Seat 2: nhanminhtri (small blind) folded on the Flop
Seat 3: Viiiru (big blind) folded before Flop
Seat 4: anorectal collected ($2.24)
Seat 5: Lehared folded before Flop (didn't bet)
Seat 6: SantiagoWeight folded before Flop (didn't bet)



PokerStars Zoom Hand #195023065182:  Hold'em No Limit ($0.10/$0.25) - 2018/12/29 3:21:32 UTC [2018/12/28 22:21:32 ET]
Table 'Hydra' 6-max Seat #1 is the button
Seat 1: sZCzpNtheKot ($27.97 in chips) 
Seat 2: kyracarmen ($26.95 in chips) 
Seat 3: naxizzle ($134.75 in chips) 
Seat 4: SantiagoWeight ($76.87 in chips) 
Seat 5: Nutselas ($25 in chips) 
Seat 6: anlu0803 ($24.65 in chips) 
kyracarmen: posts small blind $0.10
naxizzle: posts big blind $0.25
*** HOLE CARDS ***
Dealt to SantiagoWeight [Tc 8c]
SantiagoWeight: folds 
Nutselas: raises $0.50 to $0.75
anlu0803: folds 
sZCzpNtheKot: raises $1.50 to $2.25
kyracarmen: calls $2.15
naxizzle: folds 
Nutselas: calls $1.50
*** FLOP *** [Js 2s Qd]
kyracarmen: checks 
Nutselas: checks 
sZCzpNtheKot: bets $3.54
kyracarmen: calls $3.54
Nutselas: folds 
*** TURN *** [Js 2s Qd] [4c]
kyracarmen: checks 
sZCzpNtheKot: bets $7.13
kyracarmen: raises $14.03 to $21.16 and is all-in
sZCzpNtheKot: calls $14.03
*** RIVER *** [Js 2s Qd 4c] [6d]
*** SHOW DOWN ***
kyracarmen: shows [As Ah] (a pair of Aces)
sZCzpNtheKot: shows [Qs Kd] (a pair of Queens)
kyracarmen collected $54.40 from pot
*** SUMMARY ***
Total pot $56.40 | Rake $2 
Board [Js 2s Qd 4c 6d]
Seat 1: sZCzpNtheKot (button) showed [Qs Kd] and lost with a pair of Queens
Seat 2: kyracarmen (small blind) showed [As Ah] and won ($54.40) with a pair of Aces
Seat 3: naxizzle (big blind) folded before Flop
Seat 4: SantiagoWeight folded before Flop (didn't bet)
Seat 5: Nutselas folded on the Flop
Seat 6: anlu0803 folded before Flop (didn't bet)



PokerStars Zoom Hand #195023112303:  Hold'em No Limit ($0.10/$0.25) - 2018/12/29 3:23:37 UTC [2018/12/28 22:23:37 ET]
Table 'Hydra' 6-max Seat #1 is the button
Seat 1: SantiagoWeight ($75.80 in chips) 
Seat 2: ryanking99 ($15.59 in chips) 
Seat 3: davidhw888 ($21.34 in chips) 
Seat 4: SirSatan001 ($23.41 in chips) 
Seat 5: sZCzpNtheKot ($25 in chips) 
Seat 6: TQNYMQNTANA ($27.83 in chips) 
ryanking99: posts small blind $0.10
davidhw888: posts big blind $0.25
*** HOLE CARDS ***
Dealt to SantiagoWeight [Kd 5s]
SirSatan001: folds 
sZCzpNtheKot: raises $0.37 to $0.62
TQNYMQNTANA: folds 
SantiagoWeight: folds 
ryanking99: folds 
davidhw888: folds 
Uncalled bet ($0.37) returned to sZCzpNtheKot
sZCzpNtheKot collected $0.60 from pot
sZCzpNtheKot: doesn't show hand 
*** SUMMARY ***
Total pot $0.60 | Rake $0 
Seat 1: SantiagoWeight (button) folded before Flop (didn't bet)
Seat 2: ryanking99 (small blind) folded before Flop
Seat 3: davidhw888 (big blind) folded before Flop
Seat 4: SirSatan001 folded before Flop (didn't bet)
Seat 5: sZCzpNtheKot collected ($0.60)
Seat 6: TQNYMQNTANA folded before Flop (didn't bet)



PokerStars Zoom Hand #195023116973:  Hold'em No Limit ($0.10/$0.25) - 2018/12/29 3:23:51 UTC [2018/12/28 22:23:51 ET]
Table 'Hydra' 6-max Seat #1 is the button
Seat 1: miru877 ($25 in chips) 
Seat 2: Baboscrubx ($31.74 in chips) 
Seat 3: SantiagoWeight ($75.80 in chips) 
Seat 4: negreanuNya ($25 in chips) 
Seat 5: nhanminhtri ($29.40 in chips) 
Seat 6: Pardaroxon ($55.77 in chips) 
Baboscrubx: posts small blind $0.10
SantiagoWeight: posts big blind $0.25
*** HOLE CARDS ***
Dealt to SantiagoWeight [Td 4s]
negreanuNya: raises $0.35 to $0.60
nhanminhtri: folds 
Pardaroxon: folds 
miru877: folds 
Baboscrubx: folds 
SantiagoWeight: folds 
Uncalled bet ($0.35) returned to negreanuNya
negreanuNya collected $0.60 from pot
*** SUMMARY ***
Total pot $0.60 | Rake $0 
Seat 1: miru877 (button) folded before Flop (didn't bet)
Seat 2: Baboscrubx (small blind) folded before Flop
Seat 3: SantiagoWeight (big blind) folded before Flop
Seat 4: negreanuNya collected ($0.60)
Seat 5: nhanminhtri folded before Flop (didn't bet)
Seat 6: Pardaroxon folded before Flop (didn't bet)



PokerStars Zoom Hand #195023129090:  Hold'em No Limit ($0.10/$0.25) - 2018/12/29 3:24:27 UTC [2018/12/28 22:24:27 ET]
Table 'Hydra' 6-max Seat #1 is the button
Seat 1: ryanking99 ($52.90 in chips) 
Seat 2: yobbos ($133.23 in chips) 
Seat 3: mistdog ($43.11 in chips) 
Seat 4: Mrs_Squeeze ($33.06 in chips) 
Seat 5: SantiagoWeight ($75.55 in chips) 
Seat 6: call me??107 ($42.36 in chips) 
yobbos: posts small blind $0.10
mistdog: posts big blind $0.25
*** HOLE CARDS ***
Dealt to SantiagoWeight [Jc Ad]
Mrs_Squeeze: folds 
SantiagoWeight: raises $0.37 to $0.62
call me??107: folds 
ryanking99: folds 
yobbos: folds 
mistdog: folds 
Uncalled bet ($0.37) returned to SantiagoWeight
SantiagoWeight collected $0.60 from pot
SantiagoWeight: doesn't show hand 
*** SUMMARY ***
Total pot $0.60 | Rake $0 
Seat 1: ryanking99 (button) folded before Flop (didn't bet)
Seat 2: yobbos (small blind) folded before Flop
Seat 3: mistdog (big blind) folded before Flop
Seat 4: Mrs_Squeeze folded before Flop (didn't bet)
Seat 5: SantiagoWeight collected ($0.60)
Seat 6: call me??107 folded before Flop (didn't bet)



PokerStars Zoom Hand #195023097364:  Hold'em No Limit ($0.10/$0.25) - 2018/12/29 3:23:06 UTC [2018/12/28 22:23:06 ET]
Table 'Hydra' 6-max Seat #1 is the button
Seat 1: Mandu_xiii ($25 in chips) 
Seat 2: SantiagoWeight ($75.90 in chips) 
Seat 3: SirSatan001 ($23.66 in chips) 
Seat 4: Chellabro ($31.12 in chips) 
Seat 5: Mrs_Squeeze ($33.56 in chips) 
Seat 6: Kirac99 ($17.46 in chips) 
SantiagoWeight: posts small blind $0.10
SirSatan001: posts big blind $0.25
*** HOLE CARDS ***
Dealt to SantiagoWeight [Qd Js]
Chellabro: calls $0.25
Mrs_Squeeze: calls $0.25
Kirac99: folds 
Mandu_xiii: raises $1 to $1.25
SantiagoWeight: folds 
SirSatan001: folds 
Chellabro: raises $1 to $2.25
Mrs_Squeeze: folds 
Mandu_xiii: calls $1
*** FLOP *** [2h Kd 6c]
Chellabro: bets $1.50
Mandu_xiii: calls $1.50
*** TURN *** [2h Kd 6c] [7s]
Chellabro: bets $2
Mandu_xiii: calls $2
*** RIVER *** [2h Kd 6c 7s] [6s]
Chellabro: bets $2
Mandu_xiii: calls $2
*** SHOW DOWN ***
Chellabro: shows [Ad Ac] (two pair, Aces and Sixes)
Mandu_xiii: mucks hand 
Chellabro collected $15.38 from pot
*** SUMMARY ***
Total pot $16.10 | Rake $0.72 
Board [2h Kd 6c 7s 6s]
Seat 1: Mandu_xiii (button) mucked [Kc Td]
Seat 2: SantiagoWeight (small blind) folded before Flop
Seat 3: SirSatan001 (big blind) folded before Flop
Seat 4: Chellabro showed [Ad Ac] and won ($15.38) with two pair, Aces and Sixes
Seat 5: Mrs_Squeeze folded before Flop
Seat 6: Kirac99 folded before Flop (didn't bet)



PokerStars Zoom Hand #195023134492:  Hold'em No Limit ($0.10/$0.25) - 2018/12/29 3:24:43 UTC [2018/12/28 22:24:43 ET]
Table 'Hydra' 6-max Seat #1 is the button
Seat 1: nhanminhtri ($28.86 in chips) 
Seat 2: Renner32 ($27.02 in chips) 
Seat 3: myrtasaTR ($25 in chips) 
Seat 4: SantiagoWeight ($75.90 in chips) 
Seat 5: davidhw888 ($23.63 in chips) 
Seat 6: BirreteX ($27.71 in chips) 
Renner32: posts small blind $0.10
myrtasaTR: posts big blind $0.25
*** HOLE CARDS ***
Dealt to SantiagoWeight [6s Jh]
SantiagoWeight: folds 
davidhw888: folds 
BirreteX: folds 
nhanminhtri: folds 
Renner32: folds 
Uncalled bet ($0.15) returned to myrtasaTR
myrtasaTR collected $0.20 from pot
myrtasaTR: doesn't show hand 
*** SUMMARY ***
Total pot $0.20 | Rake $0 
Seat 1: nhanminhtri (button) folded before Flop (didn't bet)
Seat 2: Renner32 (small blind) folded before Flop
Seat 3: myrtasaTR (big blind) collected ($0.20)
Seat 4: SantiagoWeight folded before Flop (didn't bet)
Seat 5: davidhw888 folded before Flop (didn't bet)
Seat 6: BirreteX folded before Flop (didn't bet)



PokerStars Zoom Hand #195023125434:  Hold'em No Limit ($0.10/$0.25) - 2018/12/29 3:24:16 UTC [2018/12/28 22:24:16 ET]
Table 'Hydra' 6-max Seat #1 is the button
Seat 1: christulio ($6.43 in chips) 
Seat 2: zhang1zhang ($25.10 in chips) 
Seat 3: numbernine5 ($38.39 in chips) 
Seat 4: Aescul@pius ($27.77 in chips) 
Seat 5: ckriszee ($41.25 in chips) 
Seat 6: SantiagoWeight ($75.55 in chips) 
zhang1zhang: posts small blind $0.10
numbernine5: posts big blind $0.25
*** HOLE CARDS ***
Dealt to SantiagoWeight [Ts 4s]
Aescul@pius: folds 
ckriszee: folds 
SantiagoWeight: folds 
christulio: folds 
zhang1zhang: raises $0.50 to $0.75
numbernine5: calls $0.50
*** FLOP *** [Qc Kh 8c]
zhang1zhang: checks 
numbernine5: bets $0.79
zhang1zhang: calls $0.79
*** TURN *** [Qc Kh 8c] [9h]
zhang1zhang: checks 
numbernine5: checks 
*** RIVER *** [Qc Kh 8c 9h] [3h]
zhang1zhang: bets $2.50
numbernine5: folds 
Uncalled bet ($2.50) returned to zhang1zhang
zhang1zhang collected $2.94 from pot
zhang1zhang: doesn't show hand 
*** SUMMARY ***
Total pot $3.08 | Rake $0.14 
Board [Qc Kh 8c 9h 3h]
Seat 1: christulio (button) folded before Flop (didn't bet)
Seat 2: zhang1zhang (small blind) collected ($2.94)
Seat 3: numbernine5 (big blind) folded on the River
Seat 4: Aescul@pius folded before Flop (didn't bet)
Seat 5: ckriszee folded before Flop (didn't bet)
Seat 6: SantiagoWeight folded before Flop (didn't bet)



PokerStars Zoom Hand #195023136463:  Hold'em No Limit ($0.10/$0.25) - 2018/12/29 3:24:49 UTC [2018/12/28 22:24:49 ET]
Table 'Hydra' 6-max Seat #1 is the button
Seat 1: Acetime74 ($12.32 in chips) 
Seat 2: mistdog ($42.86 in chips) 
Seat 3: SantiagoWeight ($75.90 in chips) 
Seat 4: GrandmasterY ($25 in chips) 
Seat 5: Bujan 07 ($20.64 in chips) 
Seat 6: Ovanes911 ($23.94 in chips) 
mistdog: posts small blind $0.10
SantiagoWeight: posts big blind $0.25
*** HOLE CARDS ***
Dealt to SantiagoWeight [Kh 5s]
GrandmasterY: folds 
Bujan 07: folds 
Ovanes911: folds 
Acetime74: folds 
mistdog: folds 
Uncalled bet ($0.15) returned to SantiagoWeight
SantiagoWeight collected $0.20 from pot
SantiagoWeight: doesn't show hand 
*** SUMMARY ***
Total pot $0.20 | Rake $0 
Seat 1: Acetime74 (button) folded before Flop (didn't bet)
Seat 2: mistdog (small blind) folded before Flop
Seat 3: SantiagoWeight (big blind) collected ($0.20)
Seat 4: GrandmasterY folded before Flop (didn't bet)
Seat 5: Bujan 07 folded before Flop (didn't bet)
Seat 6: Ovanes911 folded before Flop (didn't bet)



PokerStars Zoom Hand #195023139757:  Hold'em No Limit ($0.10/$0.25) - 2018/12/29 3:24:59 UTC [2018/12/28 22:24:59 ET]
Table 'Hydra' 6-max Seat #1 is the button
Seat 1: _BluDeeN_ ($53.50 in chips) 
Seat 2: SantiagoWeight ($76 in chips) 
Seat 3: MISTAAJ ($18.31 in chips) 
Seat 4: river plate9 ($21.90 in chips) 
Seat 5: mistdog ($46.80 in chips) 
Seat 6: Renner32 ($26.92 in chips) 
SantiagoWeight: posts small blind $0.10
MISTAAJ: posts big blind $0.25
*** HOLE CARDS ***
Dealt to SantiagoWeight [5h 6s]
river plate9: folds 
mistdog: folds 
Renner32: folds 
_BluDeeN_: folds 
SantiagoWeight: folds 
Uncalled bet ($0.15) returned to MISTAAJ
MISTAAJ collected $0.20 from pot
MISTAAJ: doesn't show hand 
*** SUMMARY ***
Total pot $0.20 | Rake $0 
Seat 1: _BluDeeN_ (button) folded before Flop (didn't bet)
Seat 2: SantiagoWeight (small blind) folded before Flop
Seat 3: MISTAAJ (big blind) collected ($0.20)
Seat 4: river plate9 folded before Flop (didn't bet)
Seat 5: mistdog folded before Flop (didn't bet)
Seat 6: Renner32 folded before Flop (didn't bet)



PokerStars Zoom Hand #195023147462:  Hold'em No Limit ($0.10/$0.25) - 2018/12/29 3:25:22 UTC [2018/12/28 22:25:22 ET]
Table 'Hydra' 6-max Seat #1 is the button
Seat 1: Pardaroxon ($27.94 in chips) 
Seat 2: Kirac99 ($17.77 in chips) 
Seat 3: abbi555 ($26.90 in chips) 
Seat 4: Lehared ($51.36 in chips) 
Seat 5: SantiagoWeight ($75.90 in chips) 
Seat 6: angipoker ($13.06 in chips) 
Kirac99: posts small blind $0.10
abbi555: posts big blind $0.25
*** HOLE CARDS ***
Dealt to SantiagoWeight [4c 6d]
Lehared: folds 
SantiagoWeight: folds 
angipoker: folds 
Pardaroxon: folds 
Kirac99: raises $0.50 to $0.75
abbi555: folds 
Uncalled bet ($0.50) returned to Kirac99
Kirac99 collected $0.50 from pot
Kirac99: doesn't show hand 
*** SUMMARY ***
Total pot $0.50 | Rake $0 
Seat 1: Pardaroxon (button) folded before Flop (didn't bet)
Seat 2: Kirac99 (small blind) collected ($0.50)
Seat 3: abbi555 (big blind) folded before Flop
Seat 4: Lehared folded before Flop (didn't bet)
Seat 5: SantiagoWeight folded before Flop (didn't bet)
Seat 6: angipoker folded before Flop (didn't bet)



PokerStars Zoom Hand #195023149451:  Hold'em No Limit ($0.10/$0.25) - 2018/12/29 3:25:28 UTC [2018/12/28 22:25:28 ET]
Table 'Hydra' 6-max Seat #1 is the button
Seat 1: SantiagoWeight ($75.90 in chips) 
Seat 2: nadal335 ($61.74 in chips) 
Seat 3: GrandmasterY ($25 in chips) 
Seat 4: reademenweep ($19.05 in chips) 
Seat 5: Lehared ($50.23 in chips) 
Seat 6: MISTAAJ ($34.11 in chips) 
nadal335: posts small blind $0.10
GrandmasterY: posts big blind $0.25
*** HOLE CARDS ***
Dealt to SantiagoWeight [8c 7c]
reademenweep: folds 
Lehared: raises $0.37 to $0.62
MISTAAJ: folds 
SantiagoWeight: calls $0.62
nadal335: folds 
GrandmasterY: folds 
*** FLOP *** [8h 8s 5h]
Lehared: bets $0.82
SantiagoWeight: calls $0.82
*** TURN *** [8h 8s 5h] [Ac]
Lehared: checks 
SantiagoWeight: checks 
*** RIVER *** [8h 8s 5h Ac] [3c]
Lehared: bets $2.37
SantiagoWeight: raises $7.82 to $10.19
Lehared: calls $7.82
*** SHOW DOWN ***
SantiagoWeight: shows [8c 7c] (three of a kind, Eights)
Lehared: mucks hand 
SantiagoWeight collected $22.55 from pot
*** SUMMARY ***
Total pot $23.61 | Rake $1.06 
Board [8h 8s 5h Ac 3c]
Seat 1: SantiagoWeight (button) showed [8c 7c] and won ($22.55) with three of a kind, Eights
Seat 2: nadal335 (small blind) folded before Flop
Seat 3: GrandmasterY (big blind) folded before Flop
Seat 4: reademenweep folded before Flop (didn't bet)
Seat 5: Lehared mucked [7d Ad]
Seat 6: MISTAAJ folded before Flop (didn't bet)



PokerStars Zoom Hand #195023193227:  Hold'em No Limit ($0.10/$0.25) - 2018/12/29 3:27:41 UTC [2018/12/28 22:27:41 ET]
Table 'Hydra' 6-max Seat #1 is the button
Seat 1: !P0K3RM3T4L! ($25.84 in chips) 
Seat 2: CAPTAINSKA ($19.96 in chips) 
Seat 3: Lehared ($38.60 in chips) 
Seat 4: Kirac99 ($20.01 in chips) 
Seat 5: Baboscrubx ($25 in chips) 
Seat 6: SantiagoWeight ($86.82 in chips) 
CAPTAINSKA: posts small blind $0.10
Lehared: posts big blind $0.25
*** HOLE CARDS ***
Dealt to SantiagoWeight [5c Kd]
Kirac99: folds 
Baboscrubx: folds 
SantiagoWeight: folds 
!P0K3RM3T4L!: raises $0.35 to $0.60
CAPTAINSKA: raises $1.90 to $2.50
Lehared: folds 
!P0K3RM3T4L!: folds 
Uncalled bet ($1.90) returned to CAPTAINSKA
CAPTAINSKA collected $1.45 from pot
CAPTAINSKA: doesn't show hand 
*** SUMMARY ***
Total pot $1.45 | Rake $0 
Seat 1: !P0K3RM3T4L! (button) folded before Flop
Seat 2: CAPTAINSKA (small blind) collected ($1.45)
Seat 3: Lehared (big blind) folded before Flop
Seat 4: Kirac99 folded before Flop (didn't bet)
Seat 5: Baboscrubx folded before Flop (didn't bet)
Seat 6: SantiagoWeight folded before Flop (didn't bet)



PokerStars Zoom Hand #195023195851:  Hold'em No Limit ($0.10/$0.25) - 2018/12/29 3:27:49 UTC [2018/12/28 22:27:49 ET]
Table 'Hydra' 6-max Seat #1 is the button
Seat 1: Pardaroxon ($54.10 in chips) 
Seat 2: call me??107 ($9.62 in chips) 
Seat 3: Antwerken ($16.79 in chips) 
Seat 4: golf7287 ($31.14 in chips) 
Seat 5: SantiagoWeight ($86.82 in chips) 
Seat 6: davidhw888 ($23.50 in chips) 
call me??107: posts small blind $0.10
Antwerken: posts big blind $0.25
*** HOLE CARDS ***
Dealt to SantiagoWeight [9s 8d]
golf7287: folds 
SantiagoWeight: folds 
davidhw888: folds 
Pardaroxon: raises $0.25 to $0.50
call me??107: raises $1.25 to $1.75
Antwerken: folds 
Pardaroxon: folds 
Uncalled bet ($1.25) returned to call me??107
call me??107 collected $1.25 from pot
call me??107: doesn't show hand 
*** SUMMARY ***
Total pot $1.25 | Rake $0 
Seat 1: Pardaroxon (button) folded before Flop
Seat 2: call me??107 (small blind) collected ($1.25)
Seat 3: Antwerken (big blind) folded before Flop
Seat 4: golf7287 folded before Flop (didn't bet)
Seat 5: SantiagoWeight folded before Flop (didn't bet)
Seat 6: davidhw888 folded before Flop (didn't bet)



PokerStars Zoom Hand #195023207476:  Hold'em No Limit ($0.10/$0.25) - 2018/12/29 3:28:24 UTC [2018/12/28 22:28:24 ET]
Table 'Hydra' 6-max Seat #1 is the button
Seat 1: Lehared ($71.70 in chips) 
Seat 2: SantiagoWeight ($86.57 in chips) 
Seat 3: Renner32 ($26.90 in chips) 
Seat 4: ckriszee ($41.22 in chips) 
Seat 5: alex3d1985 ($51.98 in chips) 
Seat 6: ivann14 ($78.44 in chips) 
SantiagoWeight: posts small blind $0.10
Renner32: posts big blind $0.25
*** HOLE CARDS ***
Dealt to SantiagoWeight [7d 3s]
ckriszee: folds 
alex3d1985: raises $0.50 to $0.75
ivann14: folds 
Lehared: folds 
SantiagoWeight: folds 
Renner32: folds 
Uncalled bet ($0.50) returned to alex3d1985
alex3d1985 collected $0.60 from pot
alex3d1985: doesn't show hand 
*** SUMMARY ***
Total pot $0.60 | Rake $0 
Seat 1: Lehared (button) folded before Flop (didn't bet)
Seat 2: SantiagoWeight (small blind) folded before Flop
Seat 3: Renner32 (big blind) folded before Flop
Seat 4: ckriszee folded before Flop (didn't bet)
Seat 5: alex3d1985 collected ($0.60)
Seat 6: ivann14 folded before Flop (didn't bet)



PokerStars Zoom Hand #195023200825:  Hold'em No Limit ($0.10/$0.25) - 2018/12/29 3:28:04 UTC [2018/12/28 22:28:04 ET]
Table 'Hydra' 6-max Seat #1 is the button
Seat 1: yobbos ($68.46 in chips) 
Seat 2: aa1421b ($34.99 in chips) 
Seat 3: SantiagoWeight ($86.82 in chips) 
Seat 4: pfunkolstar ($25.60 in chips) 
Seat 5: davidhw888 ($17.26 in chips) 
Seat 6: Baboscrubx ($25 in chips) 
aa1421b: posts small blind $0.10
SantiagoWeight: posts big blind $0.25
*** HOLE CARDS ***
Dealt to SantiagoWeight [Qc 2d]
pfunkolstar: folds 
davidhw888: folds 
Baboscrubx: raises $0.39 to $0.64
yobbos: calls $0.64
aa1421b: folds 
SantiagoWeight: folds 
*** FLOP *** [Ks 9s Th]
Baboscrubx: bets $0.79
yobbos: folds 
Uncalled bet ($0.79) returned to Baboscrubx
Baboscrubx collected $1.56 from pot
Baboscrubx: doesn't show hand 
*** SUMMARY ***
Total pot $1.63 | Rake $0.07 
Board [Ks 9s Th]
Seat 1: yobbos (button) folded on the Flop
Seat 2: aa1421b (small blind) folded before Flop
Seat 3: SantiagoWeight (big blind) folded before Flop
Seat 4: pfunkolstar folded before Flop (didn't bet)
Seat 5: davidhw888 folded before Flop (didn't bet)
Seat 6: Baboscrubx collected ($1.56)



PokerStars Zoom Hand #195023209465:  Hold'em No Limit ($0.10/$0.25) - 2018/12/29 3:28:30 UTC [2018/12/28 22:28:30 ET]
Table 'Hydra' 6-max Seat #1 is the button
Seat 1: ^J0K3RST@RS! ($25.10 in chips) 
Seat 2: qing328 ($36.71 in chips) 
Seat 3: TQNYMQNTANA ($103.78 in chips) 
Seat 4: SantiagoWeight ($86.47 in chips) 
Seat 5: Viiiru ($30.26 in chips) 
Seat 6: Josip1119 ($28.94 in chips) 
qing328: posts small blind $0.10
TQNYMQNTANA: posts big blind $0.25
*** HOLE CARDS ***
Dealt to SantiagoWeight [Th 9h]
SantiagoWeight: raises $0.42 to $0.67
Viiiru: folds 
Josip1119: folds 
^J0K3RST@RS!: folds 
qing328 has timed out
qing328: folds 
TQNYMQNTANA: folds 
Uncalled bet ($0.42) returned to SantiagoWeight
SantiagoWeight collected $0.60 from pot
SantiagoWeight: doesn't show hand 
*** SUMMARY ***
Total pot $0.60 | Rake $0 
Seat 1: ^J0K3RST@RS! (button) folded before Flop (didn't bet)
Seat 2: qing328 (small blind) folded before Flop
Seat 3: TQNYMQNTANA (big blind) folded before Flop
Seat 4: SantiagoWeight collected ($0.60)
Seat 5: Viiiru folded before Flop (didn't bet)
Seat 6: Josip1119 folded before Flop (didn't bet)



PokerStars Zoom Hand #195023234466:  Hold'em No Limit ($0.10/$0.25) - 2018/12/29 3:29:45 UTC [2018/12/28 22:29:45 ET]
Table 'Hydra' 6-max Seat #1 is the button
Seat 1: zbuci ($31.49 in chips) 
Seat 2: KrishnaRadha ($24.65 in chips) 
Seat 3: Slim Wolfie ($26.79 in chips) 
Seat 4: SantiagoWeight ($86.82 in chips) 
Seat 5: Viiiru ($29.41 in chips) 
Seat 6: golf7287 ($27.60 in chips) 
KrishnaRadha: posts small blind $0.10
Slim Wolfie: posts big blind $0.25
*** HOLE CARDS ***
Dealt to SantiagoWeight [8c Jc]
SantiagoWeight: folds 
Viiiru: folds 
golf7287: folds 
zbuci: folds 
KrishnaRadha: raises $0.50 to $0.75
Slim Wolfie: folds 
Uncalled bet ($0.50) returned to KrishnaRadha
KrishnaRadha collected $0.50 from pot
KrishnaRadha: doesn't show hand 
*** SUMMARY ***
Total pot $0.50 | Rake $0 
Seat 1: zbuci (button) folded before Flop (didn't bet)
Seat 2: KrishnaRadha (small blind) collected ($0.50)
Seat 3: Slim Wolfie (big blind) folded before Flop
Seat 4: SantiagoWeight folded before Flop (didn't bet)
Seat 5: Viiiru folded before Flop (didn't bet)
Seat 6: golf7287 folded before Flop (didn't bet)



PokerStars Zoom Hand #195023240095:  Hold'em No Limit ($0.10/$0.25) - 2018/12/29 3:30:02 UTC [2018/12/28 22:30:02 ET]
Table 'Hydra' 6-max Seat #1 is the button
Seat 1: _BluDeeN_ ($25.35 in chips) 
Seat 2: Lehared ($89.38 in chips) 
Seat 3: SantiagoWeight ($86.82 in chips) 
Seat 4: aa1421b ($34.99 in chips) 
Seat 5: ttshead ($64.60 in chips) 
Seat 6: davidhw888 ($33.04 in chips) 
Lehared: posts small blind $0.10
SantiagoWeight: posts big blind $0.25
*** HOLE CARDS ***
Dealt to SantiagoWeight [3s 6c]
aa1421b: raises $0.50 to $0.75
ttshead: folds 
davidhw888: calls $0.75
_BluDeeN_: folds 
Lehared: folds 
SantiagoWeight: folds 
*** FLOP *** [Th Kd 6h]
aa1421b: bets $1.50
davidhw888: folds 
Uncalled bet ($1.50) returned to aa1421b
aa1421b collected $1.77 from pot
aa1421b: doesn't show hand 
*** SUMMARY ***
Total pot $1.85 | Rake $0.08 
Board [Th Kd 6h]
Seat 1: _BluDeeN_ (button) folded before Flop (didn't bet)
Seat 2: Lehared (small blind) folded before Flop
Seat 3: SantiagoWeight (big blind) folded before Flop
Seat 4: aa1421b collected ($1.77)
Seat 5: ttshead folded before Flop (didn't bet)
Seat 6: davidhw888 folded on the Flop



PokerStars Zoom Hand #195023247860:  Hold'em No Limit ($0.10/$0.25) - 2018/12/29 3:30:25 UTC [2018/12/28 22:30:25 ET]
Table 'Hydra' 6-max Seat #1 is the button
Seat 1: SantiagoWeight ($86.57 in chips) 
Seat 2: Ovanes911 ($23.56 in chips) 
Seat 3: nhanminhtri ($26.64 in chips) 
Seat 4: gaffer31 ($18.75 in chips) 
Seat 5: Dr.Jekyll197 ($37.83 in chips) 
Seat 6: numbernine5 ($42.99 in chips) 
Ovanes911: posts small blind $0.10
nhanminhtri: posts big blind $0.25
*** HOLE CARDS ***
Dealt to SantiagoWeight [Qd Ad]
gaffer31: folds 
Dr.Jekyll197: folds 
numbernine5: folds 
SantiagoWeight: raises $0.30 to $0.55
Ovanes911: folds 
nhanminhtri: calls $0.30
*** FLOP *** [2s 2d 8d]
nhanminhtri: checks 
SantiagoWeight: bets $0.29
nhanminhtri: folds 
Uncalled bet ($0.29) returned to SantiagoWeight
SantiagoWeight collected $1.15 from pot
SantiagoWeight: doesn't show hand 
*** SUMMARY ***
Total pot $1.20 | Rake $0.05 
Board [2s 2d 8d]
Seat 1: SantiagoWeight (button) collected ($1.15)
Seat 2: Ovanes911 (small blind) folded before Flop
Seat 3: nhanminhtri (big blind) folded on the Flop
Seat 4: gaffer31 folded before Flop (didn't bet)
Seat 5: Dr.Jekyll197 folded before Flop (didn't bet)
Seat 6: numbernine5 folded before Flop (didn't bet)



PokerStars Zoom Hand #195023262823:  Hold'em No Limit ($0.10/$0.25) - 2018/12/29 3:31:10 UTC [2018/12/28 22:31:10 ET]
Table 'Hydra' 6-max Seat #1 is the button
Seat 1: Nutselas ($30.16 in chips) 
Seat 2: HansMSM ($27.41 in chips) 
Seat 3: osa126 ($25 in chips) 
Seat 4: Lehared ($27.64 in chips) 
Seat 5: negreanuNya ($26.60 in chips) 
Seat 6: SantiagoWeight ($87.17 in chips) 
HansMSM: posts small blind $0.10
osa126: posts big blind $0.25
*** HOLE CARDS ***
Dealt to SantiagoWeight [Jd As]
Lehared: folds 
negreanuNya: folds 
SantiagoWeight: raises $0.30 to $0.55
Nutselas: folds 
HansMSM: folds 
osa126: calls $0.30
*** FLOP *** [6d 8c Qc]
osa126: checks 
SantiagoWeight: bets $0.70
osa126: folds 
Uncalled bet ($0.70) returned to SantiagoWeight
SantiagoWeight collected $1.15 from pot
SantiagoWeight: doesn't show hand 
*** SUMMARY ***
Total pot $1.20 | Rake $0.05 
Board [6d 8c Qc]
Seat 1: Nutselas (button) folded before Flop (didn't bet)
Seat 2: HansMSM (small blind) folded before Flop
Seat 3: osa126 (big blind) folded on the Flop
Seat 4: Lehared folded before Flop (didn't bet)
Seat 5: negreanuNya folded before Flop (didn't bet)
Seat 6: SantiagoWeight collected ($1.15)



PokerStars Zoom Hand #195023276124:  Hold'em No Limit ($0.10/$0.25) - 2018/12/29 3:31:50 UTC [2018/12/28 22:31:50 ET]
Table 'Hydra' 6-max Seat #1 is the button
Seat 1: gannelinn ($23.45 in chips) 
Seat 2: Renner32 ($26.43 in chips) 
Seat 3: Slim Wolfie ($25 in chips) 
Seat 4: SantiagoWeight ($87.77 in chips) 
Seat 5: negreanuNya ($25 in chips) 
Seat 6: franco373513 ($24.54 in chips) 
Renner32: posts small blind $0.10
Slim Wolfie: posts big blind $0.25
*** HOLE CARDS ***
Dealt to SantiagoWeight [Qc 6c]
SantiagoWeight: folds 
negreanuNya: folds 
franco373513: calls $0.25
gannelinn: raises $0.87 to $1.12
Renner32: folds 
Slim Wolfie: folds 
franco373513: calls $0.87
*** FLOP *** [Ac Th Qh]
franco373513: checks 
gannelinn: checks 
*** TURN *** [Ac Th Qh] [5s]
franco373513: checks 
gannelinn: checks 
*** RIVER *** [Ac Th Qh 5s] [Td]
franco373513: checks 
gannelinn: checks 
*** SHOW DOWN ***
franco373513: shows [9h 8h] (a pair of Tens)
gannelinn: shows [7c 7h] (two pair, Tens and Sevens)
gannelinn collected $2.47 from pot
*** SUMMARY ***
Total pot $2.59 | Rake $0.12 
Board [Ac Th Qh 5s Td]
Seat 1: gannelinn (button) showed [7c 7h] and won ($2.47) with two pair, Tens and Sevens
Seat 2: Renner32 (small blind) folded before Flop
Seat 3: Slim Wolfie (big blind) folded before Flop
Seat 4: SantiagoWeight folded before Flop (didn't bet)
Seat 5: negreanuNya folded before Flop (didn't bet)
Seat 6: franco373513 showed [9h 8h] and lost with a pair of Tens



PokerStars Zoom Hand #195023280890:  Hold'em No Limit ($0.10/$0.25) - 2018/12/29 3:32:04 UTC [2018/12/28 22:32:04 ET]
Table 'Hydra' 6-max Seat #1 is the button
Seat 1: golf7287 ($31.20 in chips) 
Seat 2: Dr.Jekyll197 ($39.06 in chips) 
Seat 3: MoMoney2612 ($25.61 in chips) 
Seat 4: KrishnaRadha ($25.43 in chips) 
Seat 5: SantiagoWeight ($87.67 in chips) 
Seat 6: mayadelrey ($67.24 in chips) 
Dr.Jekyll197: posts small blind $0.10
MoMoney2612: posts big blind $0.25
*** HOLE CARDS ***
Dealt to SantiagoWeight [8s Kc]
KrishnaRadha: folds 
SantiagoWeight: folds 
mayadelrey: folds 
golf7287: folds 
Dr.Jekyll197: folds 
Uncalled bet ($0.15) returned to MoMoney2612
MoMoney2612 collected $0.20 from pot
MoMoney2612: doesn't show hand 
*** SUMMARY ***
Total pot $0.20 | Rake $0 
Seat 1: golf7287 (button) folded before Flop (didn't bet)
Seat 2: Dr.Jekyll197 (small blind) folded before Flop
Seat 3: MoMoney2612 (big blind) collected ($0.20)
Seat 4: KrishnaRadha folded before Flop (didn't bet)
Seat 5: SantiagoWeight folded before Flop (didn't bet)
Seat 6: mayadelrey folded before Flop (didn't bet)



PokerStars Zoom Hand #195023278130:  Hold'em No Limit ($0.10/$0.25) - 2018/12/29 3:31:56 UTC [2018/12/28 22:31:56 ET]
Table 'Hydra' 6-max Seat #1 is the button
Seat 1: Gf Chipz ($41.27 in chips) 
Seat 2: SantiagoWeight ($87.77 in chips) 
Seat 3: Chrimmpam ($16.92 in chips) 
Seat 4: KILLLAKONG11 ($15.98 in chips) 
Seat 5: davidhw888 ($16.60 in chips) 
Seat 6: ttshead ($64.15 in chips) 
SantiagoWeight: posts small blind $0.10
Chrimmpam: posts big blind $0.25
*** HOLE CARDS ***
Dealt to SantiagoWeight [5d 3h]
KILLLAKONG11: raises $0.50 to $0.75
davidhw888: folds 
ttshead: folds 
Gf Chipz: folds 
SantiagoWeight: folds 
Chrimmpam: calls $0.50
*** FLOP *** [2d Ah Kh]
Chrimmpam: checks 
KILLLAKONG11: checks 
*** TURN *** [2d Ah Kh] [Th]
Chrimmpam: bets $0.75
KILLLAKONG11: calls $0.75
*** RIVER *** [2d Ah Kh Th] [6d]
Chrimmpam: bets $1.25
KILLLAKONG11: calls $1.25
*** SHOW DOWN ***
Chrimmpam: shows [As Qh] (a pair of Aces)
KILLLAKONG11: mucks hand 
Chrimmpam collected $5.35 from pot
*** SUMMARY ***
Total pot $5.60 | Rake $0.25 
Board [2d Ah Kh Th 6d]
Seat 1: Gf Chipz (button) folded before Flop (didn't bet)
Seat 2: SantiagoWeight (small blind) folded before Flop
Seat 3: Chrimmpam (big blind) showed [As Qh] and won ($5.35) with a pair of Aces
Seat 4: KILLLAKONG11 mucked [4c Ad]
Seat 5: davidhw888 folded before Flop (didn't bet)
Seat 6: ttshead folded before Flop (didn't bet)



PokerStars Zoom Hand #195023282892:  Hold'em No Limit ($0.10/$0.25) - 2018/12/29 3:32:10 UTC [2018/12/28 22:32:10 ET]
Table 'Hydra' 6-max Seat #1 is the button
Seat 1: Dbakunwaves ($114.78 in chips) 
Seat 2: graysonai ($25 in chips) 
Seat 3: Lehared ($74.36 in chips) 
Seat 4: miru877 ($26.03 in chips) 
Seat 5: Dr.Jekyll197 ($38.96 in chips) 
Seat 6: SantiagoWeight ($87.67 in chips) 
graysonai: posts small blind $0.10
Lehared: posts big blind $0.25
*** HOLE CARDS ***
Dealt to SantiagoWeight [6s 6d]
miru877: raises $0.50 to $0.75
Dr.Jekyll197: folds 
SantiagoWeight: calls $0.75
Dbakunwaves: folds 
graysonai: folds 
Lehared: folds 
*** FLOP *** [Kc Jd 8d]
miru877: bets $0.89
SantiagoWeight: folds 
Uncalled bet ($0.89) returned to miru877
miru877 collected $1.77 from pot
miru877: doesn't show hand 
*** SUMMARY ***
Total pot $1.85 | Rake $0.08 
Board [Kc Jd 8d]
Seat 1: Dbakunwaves (button) folded before Flop (didn't bet)
Seat 2: graysonai (small blind) folded before Flop
Seat 3: Lehared (big blind) folded before Flop
Seat 4: miru877 collected ($1.77)
Seat 5: Dr.Jekyll197 folded before Flop (didn't bet)
Seat 6: SantiagoWeight folded on the Flop



PokerStars Zoom Hand #195023294546:  Hold'em No Limit ($0.10/$0.25) - 2018/12/29 3:32:45 UTC [2018/12/28 22:32:45 ET]
Table 'Hydra' 6-max Seat #1 is the button
Seat 1: SantiagoWeight ($86.92 in chips) 
Seat 2: franco373513 ($22.74 in chips) 
Seat 3: Jack123985 ($28.36 in chips) 
Seat 4: Nutselas ($38.89 in chips) 
Seat 5: cankum ($36.41 in chips) 
Seat 6: reademenweep ($15.35 in chips) 
franco373513: posts small blind $0.10
Jack123985: posts big blind $0.25
*** HOLE CARDS ***
Dealt to SantiagoWeight [3s 5s]
Nutselas: folds 
cankum: raises $0.37 to $0.62
reademenweep: folds 
SantiagoWeight: folds 
franco373513: folds 
Jack123985: folds 
Uncalled bet ($0.37) returned to cankum
cankum collected $0.60 from pot
cankum: doesn't show hand 
*** SUMMARY ***
Total pot $0.60 | Rake $0 
Seat 1: SantiagoWeight (button) folded before Flop (didn't bet)
Seat 2: franco373513 (small blind) folded before Flop
Seat 3: Jack123985 (big blind) folded before Flop
Seat 4: Nutselas folded before Flop (didn't bet)
Seat 5: cankum collected ($0.60)
Seat 6: reademenweep folded before Flop (didn't bet)



PokerStars Zoom Hand #195023298170:  Hold'em No Limit ($0.10/$0.25) - 2018/12/29 3:32:56 UTC [2018/12/28 22:32:56 ET]
Table 'Hydra' 6-max Seat #1 is the button
Seat 1: gaffer31 ($22.66 in chips) 
Seat 2: angipoker ($14.03 in chips) 
Seat 3: SantiagoWeight ($86.92 in chips) 
Seat 4: mariopork ($25 in chips) 
Seat 5: nhanminhtri ($25 in chips) 
Seat 6: jeffwalker23 ($70.56 in chips) 
angipoker: posts small blind $0.10
SantiagoWeight: posts big blind $0.25
*** HOLE CARDS ***
Dealt to SantiagoWeight [2s 8c]
mariopork: folds 
nhanminhtri: folds 
jeffwalker23: folds 
gaffer31: folds 
angipoker: folds 
Uncalled bet ($0.15) returned to SantiagoWeight
SantiagoWeight collected $0.20 from pot
SantiagoWeight: doesn't show hand 
*** SUMMARY ***
Total pot $0.20 | Rake $0 
Seat 1: gaffer31 (button) folded before Flop (didn't bet)
Seat 2: angipoker (small blind) folded before Flop
Seat 3: SantiagoWeight (big blind) collected ($0.20)
Seat 4: mariopork folded before Flop (didn't bet)
Seat 5: nhanminhtri folded before Flop (didn't bet)
Seat 6: jeffwalker23 folded before Flop (didn't bet)



PokerStars Zoom Hand #195023311184:  Hold'em No Limit ($0.10/$0.25) - 2018/12/29 3:33:35 UTC [2018/12/28 22:33:35 ET]
Table 'Hydra' 6-max Seat #1 is the button
Seat 1: SantiagoWeight ($86.92 in chips) 
Seat 2: ivann14 ($31.80 in chips) 
Seat 3: abbi555 ($27.56 in chips) 
Seat 4: miru877 ($24.76 in chips) 
Seat 5: Pardaroxon ($51.74 in chips) 
Seat 6: _BluDeeN_ ($24.63 in chips) 
ivann14: posts small blind $0.10
abbi555: posts big blind $0.25
*** HOLE CARDS ***
Dealt to SantiagoWeight [Ah 9d]
miru877: folds 
Pardaroxon: raises $0.50 to $0.75
_BluDeeN_: folds 
SantiagoWeight: folds 
ivann14: folds 
abbi555: folds 
Uncalled bet ($0.50) returned to Pardaroxon
Pardaroxon collected $0.60 from pot
Pardaroxon: doesn't show hand 
*** SUMMARY ***
Total pot $0.60 | Rake $0 
Seat 1: SantiagoWeight (button) folded before Flop (didn't bet)
Seat 2: ivann14 (small blind) folded before Flop
Seat 3: abbi555 (big blind) folded before Flop
Seat 4: miru877 folded before Flop (didn't bet)
Seat 5: Pardaroxon collected ($0.60)
Seat 6: _BluDeeN_ folded before Flop (didn't bet)



PokerStars Zoom Hand #195023306833:  Hold'em No Limit ($0.10/$0.25) - 2018/12/29 3:33:22 UTC [2018/12/28 22:33:22 ET]
Table 'Hydra' 6-max Seat #1 is the button
Seat 1: assassin0875 ($180.64 in chips) 
Seat 2: Xp0Hb ($25.17 in chips) 
Seat 3: franco373513 ($22.64 in chips) 
Seat 4: ckriszee ($40.84 in chips) 
Seat 5: SantiagoWeight ($86.92 in chips) 
Seat 6: petanquemeis ($27.67 in chips) 
Xp0Hb: posts small blind $0.10
franco373513: posts big blind $0.25
*** HOLE CARDS ***
Dealt to SantiagoWeight [3d 7c]
ckriszee: folds 
SantiagoWeight: folds 
petanquemeis: raises $0.60 to $0.85
assassin0875: calls $0.85
Xp0Hb: folds 
franco373513: folds 
*** FLOP *** [9d Jh Kh]
petanquemeis: checks 
assassin0875: checks 
*** TURN *** [9d Jh Kh] [Ts]
petanquemeis: checks 
assassin0875: checks 
*** RIVER *** [9d Jh Kh Ts] [4h]
petanquemeis: checks 
assassin0875: checks 
*** SHOW DOWN ***
petanquemeis: shows [Ac Kd] (a pair of Kings)
assassin0875: mucks hand 
petanquemeis collected $1.96 from pot
*** SUMMARY ***
Total pot $2.05 | Rake $0.09 
Board [9d Jh Kh Ts 4h]
Seat 1: assassin0875 (button) mucked [5h 5s]
Seat 2: Xp0Hb (small blind) folded before Flop
Seat 3: franco373513 (big blind) folded before Flop
Seat 4: ckriszee folded before Flop (didn't bet)
Seat 5: SantiagoWeight folded before Flop (didn't bet)
Seat 6: petanquemeis showed [Ac Kd] and won ($1.96) with a pair of Kings



PokerStars Zoom Hand #195023302137:  Hold'em No Limit ($0.10/$0.25) - 2018/12/29 3:33:08 UTC [2018/12/28 22:33:08 ET]
Table 'Hydra' 6-max Seat #1 is the button
Seat 1: zzzMASTERzzz ($24.33 in chips) 
Seat 2: SantiagoWeight ($87.02 in chips) 
Seat 3: graysonai ($25.35 in chips) 
Seat 4: negreanuNya ($37.98 in chips) 
Seat 5: Lehared ($27.14 in chips) 
Seat 6: FSK78 ($33.99 in chips) 
SantiagoWeight: posts small blind $0.10
graysonai: posts big blind $0.25
*** HOLE CARDS ***
Dealt to SantiagoWeight [4c Kc]
negreanuNya: folds 
Lehared: raises $0.37 to $0.62
FSK78: folds 
zzzMASTERzzz: folds 
SantiagoWeight: folds 
graysonai: calls $0.37
*** FLOP *** [5c 2c As]
graysonai: checks 
Lehared: checks 
*** TURN *** [5c 2c As] [8c]
graysonai: bets $0.42
Lehared: calls $0.42
*** RIVER *** [5c 2c As 8c] [Jh]
graysonai: bets $1.04
Lehared: raises $2.25 to $3.29
graysonai: calls $2.25
*** SHOW DOWN ***
Lehared: shows [Jd Jc] (three of a kind, Jacks)
graysonai: shows [7c 9c] (a flush, Nine high)
graysonai collected $8.37 from pot
*** SUMMARY ***
Total pot $8.76 | Rake $0.39 
Board [5c 2c As 8c Jh]
Seat 1: zzzMASTERzzz (button) folded before Flop (didn't bet)
Seat 2: SantiagoWeight (small blind) folded before Flop
Seat 3: graysonai (big blind) showed [7c 9c] and won ($8.37) with a flush, Nine high
Seat 4: negreanuNya folded before Flop (didn't bet)
Seat 5: Lehared showed [Jd Jc] and lost with three of a kind, Jacks
Seat 6: FSK78 folded before Flop (didn't bet)



PokerStars Zoom Hand #195023314538:  Hold'em No Limit ($0.10/$0.25) - 2018/12/29 3:33:45 UTC [2018/12/28 22:33:45 ET]
Table 'Hydra' 6-max Seat #1 is the button
Seat 1: ivann14 ($73.37 in chips) 
Seat 2: franco373513 ($22.39 in chips) 
Seat 3: TQNYMQNTANA ($25 in chips) 
Seat 4: SantiagoWeight ($86.92 in chips) 
Seat 5: davidhw888 ($31.07 in chips) 
Seat 6: mariopork ($43.71 in chips) 
franco373513: posts small blind $0.10
TQNYMQNTANA: posts big blind $0.25
*** HOLE CARDS ***
Dealt to SantiagoWeight [Kd Js]
SantiagoWeight: raises $0.42 to $0.67
davidhw888: folds 
mariopork: folds 
ivann14: folds 
franco373513: calls $0.57
TQNYMQNTANA: folds 
*** FLOP *** [8h 2s Qs]
franco373513: checks 
SantiagoWeight: bets $0.38
franco373513: calls $0.38
*** TURN *** [8h 2s Qs] [8s]
franco373513: checks 
SantiagoWeight: bets $1.49
franco373513: folds 
Uncalled bet ($1.49) returned to SantiagoWeight
SantiagoWeight collected $2.24 from pot
SantiagoWeight: doesn't show hand 
*** SUMMARY ***
Total pot $2.35 | Rake $0.11 
Board [8h 2s Qs 8s]
Seat 1: ivann14 (button) folded before Flop (didn't bet)
Seat 2: franco373513 (small blind) folded on the Turn
Seat 3: TQNYMQNTANA (big blind) folded before Flop
Seat 4: SantiagoWeight collected ($2.24)
Seat 5: davidhw888 folded before Flop (didn't bet)
Seat 6: mariopork folded before Flop (didn't bet)



PokerStars Zoom Hand #195023337821:  Hold'em No Limit ($0.10/$0.25) - 2018/12/29 3:34:55 UTC [2018/12/28 22:34:55 ET]
Table 'Hydra' 6-max Seat #1 is the button
Seat 1: !P0K3RM3T4L! ($25 in chips) 
Seat 2: ivann14 ($72.75 in chips) 
Seat 3: davidhw888 ($29.22 in chips) 
Seat 4: Bujan 07 ($9.70 in chips) 
Seat 5: zzzMASTERzzz ($20.56 in chips) 
Seat 6: SantiagoWeight ($88.11 in chips) 
ivann14: posts small blind $0.10
davidhw888: posts big blind $0.25
*** HOLE CARDS ***
Dealt to SantiagoWeight [Jd Kh]
Bujan 07: folds 
zzzMASTERzzz: folds 
SantiagoWeight: raises $0.30 to $0.55
!P0K3RM3T4L!: folds 
ivann14: calls $0.45
davidhw888: folds 
*** FLOP *** [6c 8s 5c]
ivann14: checks 
SantiagoWeight: checks 
*** TURN *** [6c 8s 5c] [Th]
ivann14: checks 
SantiagoWeight: bets $0.86
ivann14: raises $3.64 to $4.50
SantiagoWeight: folds 
Uncalled bet ($3.64) returned to ivann14
ivann14 collected $2.93 from pot
*** SUMMARY ***
Total pot $3.07 | Rake $0.14 
Board [6c 8s 5c Th]
Seat 1: !P0K3RM3T4L! (button) folded before Flop (didn't bet)
Seat 2: ivann14 (small blind) collected ($2.93)
Seat 3: davidhw888 (big blind) folded before Flop
Seat 4: Bujan 07 folded before Flop (didn't bet)
Seat 5: zzzMASTERzzz folded before Flop (didn't bet)
Seat 6: SantiagoWeight folded on the Turn



PokerStars Zoom Hand #195023365425:  Hold'em No Limit ($0.10/$0.25) - 2018/12/29 3:36:19 UTC [2018/12/28 22:36:19 ET]
Table 'Hydra' 6-max Seat #1 is the button
Seat 1: Lehared ($74.32 in chips) 
Seat 2: golf7287 ($39.03 in chips) 
Seat 3: SantiagoWeight ($86.70 in chips) 
Seat 4: pirosiky ($52.65 in chips) 
Seat 5: sigaro010 ($77.62 in chips) 
Seat 6: numbernine5 ($57.12 in chips) 
golf7287: posts small blind $0.10
SantiagoWeight: posts big blind $0.25
*** HOLE CARDS ***
Dealt to SantiagoWeight [9d Kh]
pirosiky: folds 
sigaro010: raises $0.50 to $0.75
numbernine5: folds 
Lehared: folds 
golf7287: calls $0.65
SantiagoWeight: folds 
*** FLOP *** [9s 8s Jh]
golf7287: checks 
sigaro010: bets $1.10
golf7287: calls $1.10
*** TURN *** [9s 8s Jh] [6s]
golf7287: checks 
sigaro010: bets $1.62
golf7287: calls $1.62
*** RIVER *** [9s 8s Jh 6s] [2h]
golf7287: checks 
sigaro010: checks 
*** SHOW DOWN ***
golf7287: shows [As Jd] (a pair of Jacks)
sigaro010: shows [9h 8h] (two pair, Nines and Eights)
sigaro010 collected $6.87 from pot
*** SUMMARY ***
Total pot $7.19 | Rake $0.32 
Board [9s 8s Jh 6s 2h]
Seat 1: Lehared (button) folded before Flop (didn't bet)
Seat 2: golf7287 (small blind) showed [As Jd] and lost with a pair of Jacks
Seat 3: SantiagoWeight (big blind) folded before Flop
Seat 4: pirosiky folded before Flop (didn't bet)
Seat 5: sigaro010 showed [9h 8h] and won ($6.87) with two pair, Nines and Eights
Seat 6: numbernine5 folded before Flop (didn't bet)



PokerStars Zoom Hand #195023369922:  Hold'em No Limit ($0.10/$0.25) - 2018/12/29 3:36:33 UTC [2018/12/28 22:36:33 ET]
Table 'Hydra' 6-max Seat #1 is the button
Seat 1: SantiagoWeight ($86.45 in chips) 
Seat 2: kyracarmen ($50.77 in chips) 
Seat 3: numbernine5 ($57.12 in chips) 
Seat 4: angipoker ($13.90 in chips) 
Seat 5: ^J0K3RST@RS! ($21.10 in chips) 
Seat 6: NL_BYreg ($43.93 in chips) 
kyracarmen: posts small blind $0.10
numbernine5: posts big blind $0.25
*** HOLE CARDS ***
Dealt to SantiagoWeight [5d 9d]
angipoker: folds 
^J0K3RST@RS!: folds 
NL_BYreg: folds 
SantiagoWeight: raises $0.30 to $0.55
kyracarmen: folds 
numbernine5: calls $0.30
*** FLOP *** [4s Tc 2h]
numbernine5: checks 
SantiagoWeight: bets $0.29
numbernine5: calls $0.29
*** TURN *** [4s Tc 2h] [7h]
numbernine5: checks 
SantiagoWeight: checks 
*** RIVER *** [4s Tc 2h 7h] [3s]
numbernine5: bets $0.94
SantiagoWeight: folds 
Uncalled bet ($0.94) returned to numbernine5
numbernine5 collected $1.70 from pot
numbernine5: doesn't show hand 
*** SUMMARY ***
Total pot $1.78 | Rake $0.08 
Board [4s Tc 2h 7h 3s]
Seat 1: SantiagoWeight (button) folded on the River
Seat 2: kyracarmen (small blind) folded before Flop
Seat 3: numbernine5 (big blind) collected ($1.70)
Seat 4: angipoker folded before Flop (didn't bet)
Seat 5: ^J0K3RST@RS! folded before Flop (didn't bet)
Seat 6: NL_BYreg folded before Flop (didn't bet)



PokerStars Zoom Hand #195023386525:  Hold'em No Limit ($0.10/$0.25) - 2018/12/29 3:37:24 UTC [2018/12/28 22:37:24 ET]
Table 'Hydra' 6-max Seat #1 is the button
Seat 1: Bujan 07 ($8.38 in chips) 
Seat 2: SantiagoWeight ($85.61 in chips) 
Seat 3: graysonai ($25.73 in chips) 
Seat 4: pfunkolstar ($25.04 in chips) 
Seat 5: gaffer31 ($31.48 in chips) 
Seat 6: winwinboy ($25.35 in chips) 
SantiagoWeight: posts small blind $0.10
graysonai: posts big blind $0.25
*** HOLE CARDS ***
Dealt to SantiagoWeight [8d Jh]
pfunkolstar: folds 
gaffer31: folds 
winwinboy: folds 
Bujan 07: folds 
SantiagoWeight: folds 
Uncalled bet ($0.15) returned to graysonai
graysonai collected $0.20 from pot
graysonai: doesn't show hand 
*** SUMMARY ***
Total pot $0.20 | Rake $0 
Seat 1: Bujan 07 (button) folded before Flop (didn't bet)
Seat 2: SantiagoWeight (small blind) folded before Flop
Seat 3: graysonai (big blind) collected ($0.20)
Seat 4: pfunkolstar folded before Flop (didn't bet)
Seat 5: gaffer31 folded before Flop (didn't bet)
Seat 6: winwinboy folded before Flop (didn't bet)



PokerStars Zoom Hand #195023394034:  Hold'em No Limit ($0.10/$0.25) - 2018/12/29 3:37:47 UTC [2018/12/28 22:37:47 ET]
Table 'Hydra' 6-max Seat #1 is the button
Seat 1: MoMoney2612 ($25 in chips) 
Seat 2: numbernine5 ($58.33 in chips) 
Seat 3: giftbox1 ($11.43 in chips) 
Seat 4: negreanuNya ($29.35 in chips) 
Seat 5: yobbos ($71.94 in chips) 
Seat 6: SantiagoWeight ($85.51 in chips) 
numbernine5: posts small blind $0.10
giftbox1: posts big blind $0.25
*** HOLE CARDS ***
Dealt to SantiagoWeight [7c 9c]
negreanuNya: folds 
yobbos: folds 
SantiagoWeight: raises $0.30 to $0.55
MoMoney2612: folds 
numbernine5: raises $1.65 to $2.20
giftbox1: folds 
SantiagoWeight: folds 
Uncalled bet ($1.65) returned to numbernine5
numbernine5 collected $1.35 from pot
numbernine5: doesn't show hand 
*** SUMMARY ***
Total pot $1.35 | Rake $0 
Seat 1: MoMoney2612 (button) folded before Flop (didn't bet)
Seat 2: numbernine5 (small blind) collected ($1.35)
Seat 3: giftbox1 (big blind) folded before Flop
Seat 4: negreanuNya folded before Flop (didn't bet)
Seat 5: yobbos folded before Flop (didn't bet)
Seat 6: SantiagoWeight folded before Flop



PokerStars Zoom Hand #195023403022:  Hold'em No Limit ($0.10/$0.25) - 2018/12/29 3:38:15 UTC [2018/12/28 22:38:15 ET]
Table 'Hydra' 6-max Seat #1 is the button
Seat 1: MoMoney2612 ($25.92 in chips) 
Seat 2: Slim Wolfie ($31.02 in chips) 
Seat 3: negreanuNya ($29.12 in chips) 
Seat 4: nadal335 ($35.40 in chips) 
Seat 5: SantiagoWeight ($84.96 in chips) 
Seat 6: sigaro010 ($81.09 in chips) 
Slim Wolfie: posts small blind $0.10
negreanuNya: posts big blind $0.25
*** HOLE CARDS ***
Dealt to SantiagoWeight [6s Qh]
nadal335: folds 
SantiagoWeight: folds 
sigaro010: folds 
MoMoney2612: folds 
Slim Wolfie: raises $0.50 to $0.75
negreanuNya: folds 
Uncalled bet ($0.50) returned to Slim Wolfie
Slim Wolfie collected $0.50 from pot
Slim Wolfie: doesn't show hand 
*** SUMMARY ***
Total pot $0.50 | Rake $0 
Seat 1: MoMoney2612 (button) folded before Flop (didn't bet)
Seat 2: Slim Wolfie (small blind) collected ($0.50)
Seat 3: negreanuNya (big blind) folded before Flop
Seat 4: nadal335 folded before Flop (didn't bet)
Seat 5: SantiagoWeight folded before Flop (didn't bet)
Seat 6: sigaro010 folded before Flop (didn't bet)



PokerStars Zoom Hand #195023404596:  Hold'em No Limit ($0.10/$0.25) - 2018/12/29 3:38:20 UTC [2018/12/28 22:38:20 ET]
Table 'Hydra' 6-max Seat #1 is the button
Seat 1: kakashi_zion ($25.13 in chips) 
Seat 2: mariopork ($25.35 in chips) 
Seat 3: SantiagoWeight ($84.96 in chips) 
Seat 4: ckriszee ($27.67 in chips) 
Seat 5: zdena102 ($15.36 in chips) 
Seat 6: gannelinn ($39.72 in chips) 
mariopork: posts small blind $0.10
SantiagoWeight: posts big blind $0.25
*** HOLE CARDS ***
Dealt to SantiagoWeight [4s Qc]
ckriszee: folds 
zdena102: folds 
gannelinn: folds 
kakashi_zion: raises $0.50 to $0.75
mariopork: folds 
SantiagoWeight: folds 
Uncalled bet ($0.50) returned to kakashi_zion
kakashi_zion collected $0.60 from pot
kakashi_zion: doesn't show hand 
*** SUMMARY ***
Total pot $0.60 | Rake $0 
Seat 1: kakashi_zion (button) collected ($0.60)
Seat 2: mariopork (small blind) folded before Flop
Seat 3: SantiagoWeight (big blind) folded before Flop
Seat 4: ckriszee folded before Flop (didn't bet)
Seat 5: zdena102 folded before Flop (didn't bet)
Seat 6: gannelinn folded before Flop (didn't bet)



PokerStars Zoom Hand #195023409441:  Hold'em No Limit ($0.10/$0.25) - 2018/12/29 3:38:35 UTC [2018/12/28 22:38:35 ET]
Table 'Hydra' 6-max Seat #1 is the button
Seat 1: KeySssi ($25 in chips) 
Seat 2: ivann14 ($30.26 in chips) 
Seat 3: kakashi_zion ($25.48 in chips) 
Seat 4: HonourMan23 ($66.22 in chips) 
Seat 5: SantiagoWeight ($84.71 in chips) 
Seat 6: deaglepro ($63.99 in chips) 
ivann14: posts small blind $0.10
kakashi_zion: posts big blind $0.25
*** HOLE CARDS ***
Dealt to SantiagoWeight [4h 2h]
HonourMan23: folds 
SantiagoWeight: folds 
deaglepro: folds 
KeySssi: folds 
ivann14: folds 
Uncalled bet ($0.15) returned to kakashi_zion
kakashi_zion collected $0.20 from pot
kakashi_zion: doesn't show hand 
*** SUMMARY ***
Total pot $0.20 | Rake $0 
Seat 1: KeySssi (button) folded before Flop (didn't bet)
Seat 2: ivann14 (small blind) folded before Flop
Seat 3: kakashi_zion (big blind) collected ($0.20)
Seat 4: HonourMan23 folded before Flop (didn't bet)
Seat 5: SantiagoWeight folded before Flop (didn't bet)
Seat 6: deaglepro folded before Flop (didn't bet)



PokerStars Zoom Hand #195023412982:  Hold'em No Limit ($0.10/$0.25) - 2018/12/29 3:38:46 UTC [2018/12/28 22:38:46 ET]
Table 'Hydra' 6-max Seat #1 is the button
Seat 1: Nutselas ($26.03 in chips) 
Seat 2: Renner32 ($23.03 in chips) 
Seat 3: Pardaroxon ($25 in chips) 
Seat 4: SantiagoWeight ($84.71 in chips) 
Seat 5: negreanuNya ($35.87 in chips) 
Seat 6: 1ownYourUsd ($43.51 in chips) 
Renner32: posts small blind $0.10
Pardaroxon: posts big blind $0.25
*** HOLE CARDS ***
Dealt to SantiagoWeight [Qh Qs]
SantiagoWeight: raises $0.42 to $0.67
negreanuNya: folds 
1ownYourUsd: calls $0.67
Nutselas: folds 
Renner32: folds 
Pardaroxon: folds 
*** FLOP *** [4c 2d 6h]
SantiagoWeight: bets $1.10
1ownYourUsd: calls $1.10
*** TURN *** [4c 2d 6h] [6s]
SantiagoWeight: bets $3.70
1ownYourUsd: folds 
Uncalled bet ($3.70) returned to SantiagoWeight
SantiagoWeight collected $3.71 from pot
SantiagoWeight: doesn't show hand 
*** SUMMARY ***
Total pot $3.89 | Rake $0.18 
Board [4c 2d 6h 6s]
Seat 1: Nutselas (button) folded before Flop (didn't bet)
Seat 2: Renner32 (small blind) folded before Flop
Seat 3: Pardaroxon (big blind) folded before Flop
Seat 4: SantiagoWeight collected ($3.71)
Seat 5: negreanuNya folded before Flop (didn't bet)
Seat 6: 1ownYourUsd folded on the Turn



PokerStars Zoom Hand #195023432343:  Hold'em No Limit ($0.10/$0.25) - 2018/12/29 3:39:46 UTC [2018/12/28 22:39:46 ET]
Table 'Hydra' 6-max Seat #1 is the button
Seat 1: SantiagoWeight ($86.65 in chips) 
Seat 2: tariko1980 ($26.34 in chips) 
Seat 3: giftbox1 ($4.98 in chips) 
Seat 4: --LeGaaNs-- ($50.60 in chips) 
Seat 5: SirSatan001 ($20.54 in chips) 
Seat 6: abbi555 ($27.86 in chips) 
tariko1980: posts small blind $0.10
giftbox1: posts big blind $0.25
*** HOLE CARDS ***
Dealt to SantiagoWeight [Ah 7d]
--LeGaaNs--: folds 
SirSatan001: raises $0.50 to $0.75
abbi555: folds 
SantiagoWeight: folds 
tariko1980: calls $0.65
giftbox1: calls $0.50
*** FLOP *** [4h Kc 9d]
tariko1980: checks 
giftbox1: bets $1.08
SirSatan001: folds 
tariko1980: calls $1.08
*** TURN *** [4h Kc 9d] [5s]
tariko1980: checks 
giftbox1: bets $2.11
tariko1980: calls $2.11
*** RIVER *** [4h Kc 9d 5s] [Jh]
tariko1980: checks 
giftbox1: checks 
*** SHOW DOWN ***
tariko1980: shows [7c 7s] (a pair of Sevens)
giftbox1: shows [6d Kd] (a pair of Kings)
giftbox1 collected $8.24 from pot
*** SUMMARY ***
Total pot $8.63 | Rake $0.39 
Board [4h Kc 9d 5s Jh]
Seat 1: SantiagoWeight (button) folded before Flop (didn't bet)
Seat 2: tariko1980 (small blind) showed [7c 7s] and lost with a pair of Sevens
Seat 3: giftbox1 (big blind) showed [6d Kd] and won ($8.24) with a pair of Kings
Seat 4: --LeGaaNs-- folded before Flop (didn't bet)
Seat 5: SirSatan001 folded on the Flop
Seat 6: abbi555 folded before Flop (didn't bet)



PokerStars Zoom Hand #195023437230:  Hold'em No Limit ($0.10/$0.25) - 2018/12/29 3:40:01 UTC [2018/12/28 22:40:01 ET]
Table 'Hydra' 6-max Seat #1 is the button
Seat 1: alex3d1985 ($46.32 in chips) 
Seat 2: SantiagoWeight ($86.65 in chips) 
Seat 3: !P0K3RM3T4L! ($32.33 in chips) 
Seat 4: Chellabro ($44.28 in chips) 
Seat 5: davidhw888 ($30.31 in chips) 
Seat 6: Gf Chipz ($30.83 in chips) 
SantiagoWeight: posts small blind $0.10
!P0K3RM3T4L!: posts big blind $0.25
*** HOLE CARDS ***
Dealt to SantiagoWeight [Tc 5h]
Chellabro: folds 
davidhw888: folds 
Gf Chipz: raises $0.75 to $1
alex3d1985: calls $1
SantiagoWeight: folds 
!P0K3RM3T4L!: folds 
*** FLOP *** [9s Jc 2s]
Gf Chipz: bets $1.25
alex3d1985: folds 
Uncalled bet ($1.25) returned to Gf Chipz
Gf Chipz collected $2.24 from pot
Gf Chipz: doesn't show hand 
*** SUMMARY ***
Total pot $2.35 | Rake $0.11 
Board [9s Jc 2s]
Seat 1: alex3d1985 (button) folded on the Flop
Seat 2: SantiagoWeight (small blind) folded before Flop
Seat 3: !P0K3RM3T4L! (big blind) folded before Flop
Seat 4: Chellabro folded before Flop (didn't bet)
Seat 5: davidhw888 folded before Flop (didn't bet)
Seat 6: Gf Chipz collected ($2.24)



PokerStars Zoom Hand #195023443296:  Hold'em No Limit ($0.10/$0.25) - 2018/12/29 3:40:20 UTC [2018/12/28 22:40:20 ET]
Table 'Hydra' 6-max Seat #1 is the button
Seat 1: miru877 ($28.03 in chips) 
Seat 2: davidhw888 ($43.49 in chips) 
Seat 3: winwinboy ($25.35 in chips) 
Seat 4: zdenekstavic ($40.04 in chips) 
Seat 5: SantiagoWeight ($86.55 in chips) 
Seat 6: yobbos ($68.13 in chips) 
davidhw888: posts small blind $0.10
winwinboy: posts big blind $0.25
*** HOLE CARDS ***
Dealt to SantiagoWeight [Th Ah]
zdenekstavic: folds 
SantiagoWeight: raises $0.37 to $0.62
yobbos: raises $1.38 to $2
miru877: folds 
davidhw888: folds 
winwinboy: folds 
SantiagoWeight: calls $1.38
*** FLOP *** [2h 3d 3c]
SantiagoWeight: checks 
yobbos: bets $1.41
SantiagoWeight: calls $1.41
*** TURN *** [2h 3d 3c] [Qc]
SantiagoWeight: checks 
yobbos: bets $3.43
SantiagoWeight: folds 
Uncalled bet ($3.43) returned to yobbos
yobbos collected $6.85 from pot
yobbos: doesn't show hand 
*** SUMMARY ***
Total pot $7.17 | Rake $0.32 
Board [2h 3d 3c Qc]
Seat 1: miru877 (button) folded before Flop (didn't bet)
Seat 2: davidhw888 (small blind) folded before Flop
Seat 3: winwinboy (big blind) folded before Flop
Seat 4: zdenekstavic folded before Flop (didn't bet)
Seat 5: SantiagoWeight folded on the Turn
Seat 6: yobbos collected ($6.85)



PokerStars Zoom Hand #195023471064:  Hold'em No Limit ($0.10/$0.25) - 2018/12/29 3:41:47 UTC [2018/12/28 22:41:47 ET]
Table 'Hydra' 6-max Seat #1 is the button
Seat 1: franco373513 ($15.37 in chips) 
Seat 2: zbuci ($27.37 in chips) 
Seat 3: GrandmasterY ($29.43 in chips) 
Seat 4: SantiagoWeight ($83.14 in chips) 
Seat 5: SirSatan001 ($17.51 in chips) 
Seat 6: Slim Wolfie ($29.22 in chips) 
zbuci: posts small blind $0.10
GrandmasterY: posts big blind $0.25
*** HOLE CARDS ***
Dealt to SantiagoWeight [9h Tc]
SantiagoWeight: folds 
SirSatan001: folds 
Slim Wolfie: folds 
franco373513: folds 
zbuci: folds 
Uncalled bet ($0.15) returned to GrandmasterY
GrandmasterY collected $0.20 from pot
GrandmasterY: doesn't show hand 
*** SUMMARY ***
Total pot $0.20 | Rake $0 
Seat 1: franco373513 (button) folded before Flop (didn't bet)
Seat 2: zbuci (small blind) folded before Flop
Seat 3: GrandmasterY (big blind) collected ($0.20)
Seat 4: SantiagoWeight folded before Flop (didn't bet)
Seat 5: SirSatan001 folded before Flop (didn't bet)
Seat 6: Slim Wolfie folded before Flop (didn't bet)



PokerStars Zoom Hand #195023466071:  Hold'em No Limit ($0.10/$0.25) - 2018/12/29 3:41:31 UTC [2018/12/28 22:41:31 ET]
Table 'Hydra' 6-max Seat #1 is the button
Seat 1: _BluDeeN_ ($32.47 in chips) 
Seat 2: MileVoliD49 ($59.23 in chips) 
Seat 3: KeySssi ($25 in chips) 
Seat 4: aa1421b ($42.88 in chips) 
Seat 5: SunMiXaMiXS ($11.25 in chips) 
Seat 6: SantiagoWeight ($83.14 in chips) 
MileVoliD49: posts small blind $0.10
KeySssi: posts big blind $0.25
*** HOLE CARDS ***
Dealt to SantiagoWeight [7h Qc]
aa1421b: folds 
SunMiXaMiXS: folds 
SantiagoWeight: folds 
_BluDeeN_: folds 
MileVoliD49: folds 
Uncalled bet ($0.15) returned to KeySssi
KeySssi collected $0.20 from pot
KeySssi: doesn't show hand 
*** SUMMARY ***
Total pot $0.20 | Rake $0 
Seat 1: _BluDeeN_ (button) folded before Flop (didn't bet)
Seat 2: MileVoliD49 (small blind) folded before Flop
Seat 3: KeySssi (big blind) collected ($0.20)
Seat 4: aa1421b folded before Flop (didn't bet)
Seat 5: SunMiXaMiXS folded before Flop (didn't bet)
Seat 6: SantiagoWeight folded before Flop (didn't bet)



PokerStars Zoom Hand #195023473991:  Hold'em No Limit ($0.10/$0.25) - 2018/12/29 3:41:56 UTC [2018/12/28 22:41:56 ET]
Table 'Hydra' 6-max Seat #1 is the button
Seat 1: KrishnaRadha ($32.39 in chips) 
Seat 2: ckriszee ($28.89 in chips) 
Seat 3: deaglepro ($64.77 in chips) 
Seat 4: Nutselas ($30.43 in chips) 
Seat 5: SantiagoWeight ($83.14 in chips) 
Seat 6: nhanminhtri ($35.56 in chips) 
ckriszee: posts small blind $0.10
deaglepro: posts big blind $0.25
*** HOLE CARDS ***
Dealt to SantiagoWeight [Td 5h]
Nutselas: folds 
SantiagoWeight: folds 
nhanminhtri: folds 
KrishnaRadha: folds 
ckriszee: raises $0.55 to $0.80
deaglepro: folds 
Uncalled bet ($0.55) returned to ckriszee
ckriszee collected $0.50 from pot
ckriszee: doesn't show hand 
*** SUMMARY ***
Total pot $0.50 | Rake $0 
Seat 1: KrishnaRadha (button) folded before Flop (didn't bet)
Seat 2: ckriszee (small blind) collected ($0.50)
Seat 3: deaglepro (big blind) folded before Flop
Seat 4: Nutselas folded before Flop (didn't bet)
Seat 5: SantiagoWeight folded before Flop (didn't bet)
Seat 6: nhanminhtri folded before Flop (didn't bet)



PokerStars Zoom Hand #195023476584:  Hold'em No Limit ($0.10/$0.25) - 2018/12/29 3:42:04 UTC [2018/12/28 22:42:04 ET]
Table 'Hydra' 6-max Seat #1 is the button
Seat 1: MoMoney2612 ($25.61 in chips) 
Seat 2: SunMiXaMiXS ($11 in chips) 
Seat 3: SantiagoWeight ($83.14 in chips) 
Seat 4: TQNYMQNTANA ($27.06 in chips) 
Seat 5: ttshead ($59.80 in chips) 
Seat 6: winwinboy ($29.15 in chips) 
SunMiXaMiXS: posts small blind $0.10
SantiagoWeight: posts big blind $0.25
*** HOLE CARDS ***
Dealt to SantiagoWeight [7d As]
TQNYMQNTANA: folds 
ttshead: folds 
winwinboy: folds 
MoMoney2612: folds 
SunMiXaMiXS: folds 
Uncalled bet ($0.15) returned to SantiagoWeight
SantiagoWeight collected $0.20 from pot
SantiagoWeight: doesn't show hand 
*** SUMMARY ***
Total pot $0.20 | Rake $0 
Seat 1: MoMoney2612 (button) folded before Flop (didn't bet)
Seat 2: SunMiXaMiXS (small blind) folded before Flop
Seat 3: SantiagoWeight (big blind) collected ($0.20)
Seat 4: TQNYMQNTANA folded before Flop (didn't bet)
Seat 5: ttshead folded before Flop (didn't bet)
Seat 6: winwinboy folded before Flop (didn't bet)



PokerStars Zoom Hand #195023479737:  Hold'em No Limit ($0.10/$0.25) - 2018/12/29 3:42:14 UTC [2018/12/28 22:42:14 ET]
Table 'Hydra' 6-max Seat #1 is the button
Seat 1: --LeGaaNs-- ($50.20 in chips) 
Seat 2: SantiagoWeight ($83.24 in chips) 
Seat 3: fishnm2018 ($22.24 in chips) 
Seat 4: reademenweep ($21.11 in chips) 
Seat 5: ryanking99 ($51.51 in chips) 
Seat 6: ckriszee ($29.14 in chips) 
SantiagoWeight: posts small blind $0.10
fishnm2018: posts big blind $0.25
*** HOLE CARDS ***
Dealt to SantiagoWeight [6h 3d]
reademenweep: folds 
ryanking99: folds 
ckriszee: raises $0.35 to $0.60
--LeGaaNs--: folds 
SantiagoWeight: folds 
fishnm2018: folds 
Uncalled bet ($0.35) returned to ckriszee
ckriszee collected $0.60 from pot
ckriszee: doesn't show hand 
*** SUMMARY ***
Total pot $0.60 | Rake $0 
Seat 1: --LeGaaNs-- (button) folded before Flop (didn't bet)
Seat 2: SantiagoWeight (small blind) folded before Flop
Seat 3: fishnm2018 (big blind) folded before Flop
Seat 4: reademenweep folded before Flop (didn't bet)
Seat 5: ryanking99 folded before Flop (didn't bet)
Seat 6: ckriszee collected ($0.60)



PokerStars Zoom Hand #195023483240:  Hold'em No Limit ($0.10/$0.25) - 2018/12/29 3:42:25 UTC [2018/12/28 22:42:25 ET]
Table 'Hydra' 6-max Seat #1 is the button
Seat 1: SantiagoWeight ($83.14 in chips) 
Seat 2: Unclesmoll ($8.29 in chips) 
Seat 3: Bujan 07 ($9.85 in chips) 
Seat 4: nhanminhtri ($35.46 in chips) 
Seat 5: negreanuNya ($29.45 in chips) 
Seat 6: Albratros2 ($26.15 in chips) 
Unclesmoll: posts small blind $0.10
Bujan 07: posts big blind $0.25
*** HOLE CARDS ***
Dealt to SantiagoWeight [7c Th]
nhanminhtri: folds 
negreanuNya: folds 
Albratros2: folds 
SantiagoWeight: folds 
Unclesmoll: raises $0.50 to $0.75
Bujan 07: folds 
Uncalled bet ($0.50) returned to Unclesmoll
Unclesmoll collected $0.50 from pot
Unclesmoll: doesn't show hand 
*** SUMMARY ***
Total pot $0.50 | Rake $0 
Seat 1: SantiagoWeight (button) folded before Flop (didn't bet)
Seat 2: Unclesmoll (small blind) collected ($0.50)
Seat 3: Bujan 07 (big blind) folded before Flop
Seat 4: nhanminhtri folded before Flop (didn't bet)
Seat 5: negreanuNya folded before Flop (didn't bet)
Seat 6: Albratros2 folded before Flop (didn't bet)



PokerStars Zoom Hand #195023492547:  Hold'em No Limit ($0.10/$0.25) - 2018/12/29 3:42:54 UTC [2018/12/28 22:42:54 ET]
Table 'Hydra' 6-max Seat #1 is the button
Seat 1: ^J0K3RST@RS! ($17.52 in chips) 
Seat 2: golf7287 ($25.10 in chips) 
Seat 3: SantiagoWeight ($83.14 in chips) 
Seat 4: ivann14 ($29.19 in chips) 
Seat 5: winwinboy ($25.28 in chips) 
Seat 6: qing328 ($25 in chips) 
golf7287: posts small blind $0.10
SantiagoWeight: posts big blind $0.25
*** HOLE CARDS ***
Dealt to SantiagoWeight [Jd Ks]
ivann14: folds 
winwinboy: folds 
qing328: folds 
^J0K3RST@RS!: folds 
golf7287: folds 
Uncalled bet ($0.15) returned to SantiagoWeight
SantiagoWeight collected $0.20 from pot
SantiagoWeight: doesn't show hand 
*** SUMMARY ***
Total pot $0.20 | Rake $0 
Seat 1: ^J0K3RST@RS! (button) folded before Flop (didn't bet)
Seat 2: golf7287 (small blind) folded before Flop
Seat 3: SantiagoWeight (big blind) collected ($0.20)
Seat 4: ivann14 folded before Flop (didn't bet)
Seat 5: winwinboy folded before Flop (didn't bet)
Seat 6: qing328 folded before Flop (didn't bet)



PokerStars Zoom Hand #195023489378:  Hold'em No Limit ($0.10/$0.25) - 2018/12/29 3:42:44 UTC [2018/12/28 22:42:44 ET]
Table 'Hydra' 6-max Seat #1 is the button
Seat 1: checho0231 ($28.94 in chips) 
Seat 2: Albratros2 ($26.15 in chips) 
Seat 3: cankum ($71.85 in chips) 
Seat 4: SantiagoWeight ($83.14 in chips) 
Seat 5: franco373513 ($14.30 in chips) 
Seat 6: MileVoliD49 ($58.43 in chips) 
Albratros2: posts small blind $0.10
cankum: posts big blind $0.25
*** HOLE CARDS ***
Dealt to SantiagoWeight [5h 4s]
SantiagoWeight: folds 
franco373513: folds 
MileVoliD49: folds 
checho0231: folds 
Albratros2: calls $0.15
cankum: checks 
*** FLOP *** [2h 8c Ad]
Albratros2: checks 
cankum: checks 
*** TURN *** [2h 8c Ad] [3c]
Albratros2: checks 
cankum: checks 
*** RIVER *** [2h 8c Ad 3c] [8s]
Albratros2: checks 
cankum: checks 
*** SHOW DOWN ***
Albratros2: shows [Kd 9c] (a pair of Eights)
cankum: mucks hand 
Albratros2 collected $0.48 from pot
*** SUMMARY ***
Total pot $0.50 | Rake $0.02 
Board [2h 8c Ad 3c 8s]
Seat 1: checho0231 (button) folded before Flop (didn't bet)
Seat 2: Albratros2 (small blind) showed [Kd 9c] and won ($0.48) with a pair of Eights
Seat 3: cankum (big blind) mucked [9h 6h]
Seat 4: SantiagoWeight folded before Flop (didn't bet)
Seat 5: franco373513 folded before Flop (didn't bet)
Seat 6: MileVoliD49 folded before Flop (didn't bet)



PokerStars Zoom Hand #195023503574:  Hold'em No Limit ($0.10/$0.25) - 2018/12/29 3:43:29 UTC [2018/12/28 22:43:29 ET]
Table 'Hydra' 6-max Seat #1 is the button
Seat 1: SantiagoWeight ($83.24 in chips) 
Seat 2: TQNYMQNTANA ($36.93 in chips) 
Seat 3: !P0K3RM3T4L! ($56.57 in chips) 
Seat 4: zzzMASTERzzz ($15.44 in chips) 
Seat 5: alex3d1985 ($46.18 in chips) 
Seat 6: negreanuNya ($37.07 in chips) 
TQNYMQNTANA: posts small blind $0.10
!P0K3RM3T4L!: posts big blind $0.25
*** HOLE CARDS ***
Dealt to SantiagoWeight [Qh 9s]
zzzMASTERzzz: folds 
alex3d1985: raises $0.75 to $1
negreanuNya: folds 
SantiagoWeight: folds 
TQNYMQNTANA: folds 
!P0K3RM3T4L!: folds 
Uncalled bet ($0.75) returned to alex3d1985
alex3d1985 collected $0.60 from pot
alex3d1985: doesn't show hand 
*** SUMMARY ***
Total pot $0.60 | Rake $0 
Seat 1: SantiagoWeight (button) folded before Flop (didn't bet)
Seat 2: TQNYMQNTANA (small blind) folded before Flop
Seat 3: !P0K3RM3T4L! (big blind) folded before Flop
Seat 4: zzzMASTERzzz folded before Flop (didn't bet)
Seat 5: alex3d1985 collected ($0.60)
Seat 6: negreanuNya folded before Flop (didn't bet)



PokerStars Zoom Hand #195023486493:  Hold'em No Limit ($0.10/$0.25) - 2018/12/29 3:42:35 UTC [2018/12/28 22:42:35 ET]
Table 'Hydra' 6-max Seat #1 is the button
Seat 1: Lehared ($79.72 in chips) 
Seat 2: kakashi_zion ($26.81 in chips) 
Seat 3: Renner32 ($25.35 in chips) 
Seat 4: yobbos ($27.83 in chips) 
Seat 5: miru877 ($26.93 in chips) 
Seat 6: SantiagoWeight ($83.14 in chips) 
kakashi_zion: posts small blind $0.10
Renner32: posts big blind $0.25
*** HOLE CARDS ***
Dealt to SantiagoWeight [5h 8c]
yobbos: folds 
miru877: folds 
SantiagoWeight: folds 
Lehared: raises $0.37 to $0.62
kakashi_zion: calls $0.52
Renner32: folds 
*** FLOP *** [Jh 6h 9h]
kakashi_zion: checks 
Lehared: bets $0.77
kakashi_zion: calls $0.77
*** TURN *** [Jh 6h 9h] [5c]
kakashi_zion: checks 
Lehared: bets $4.34
kakashi_zion: calls $4.34
*** RIVER *** [Jh 6h 9h 5c] [5d]
kakashi_zion: bets $2
Lehared: folds 
Uncalled bet ($2) returned to kakashi_zion
kakashi_zion collected $11.18 from pot
kakashi_zion: doesn't show hand 
*** SUMMARY ***
Total pot $11.71 | Rake $0.53 
Board [Jh 6h 9h 5c 5d]
Seat 1: Lehared (button) folded on the River
Seat 2: kakashi_zion (small blind) collected ($11.18)
Seat 3: Renner32 (big blind) folded before Flop
Seat 4: yobbos folded before Flop (didn't bet)
Seat 5: miru877 folded before Flop (didn't bet)
Seat 6: SantiagoWeight folded before Flop (didn't bet)



PokerStars Zoom Hand #195023499463:  Hold'em No Limit ($0.10/$0.25) - 2018/12/29 3:43:16 UTC [2018/12/28 22:43:16 ET]
Table 'Hydra' 6-max Seat #1 is the button
Seat 1: davidhw888 ($30.48 in chips) 
Seat 2: Basebob ($29.43 in chips) 
Seat 3: reetskeet ($29.54 in chips) 
Seat 4: crux1994 ($19.41 in chips) 
Seat 5: FSK78 ($87.86 in chips) 
Seat 6: SantiagoWeight ($83.24 in chips) 
Basebob: posts small blind $0.10
reetskeet: posts big blind $0.25
*** HOLE CARDS ***
Dealt to SantiagoWeight [2c Qs]
crux1994: folds 
FSK78: folds 
SantiagoWeight: folds 
davidhw888: folds 
Basebob: calls $0.15
reetskeet: checks 
*** FLOP *** [9s 6d 8s]
Basebob: bets $0.48
reetskeet: calls $0.48
*** TURN *** [9s 6d 8s] [4h]
Basebob: bets $0.70
reetskeet: raises $2.70 to $3.40
Basebob: calls $2.70
*** RIVER *** [9s 6d 8s 4h] [4d]
Basebob: checks 
reetskeet: bets $6.25
Basebob: calls $6.25
*** SHOW DOWN ***
reetskeet: shows [5c 7s] (a straight, Five to Nine)
Basebob: mucks hand 
reetskeet collected $19.83 from pot
*** SUMMARY ***
Total pot $20.76 | Rake $0.93 
Board [9s 6d 8s 4h 4d]
Seat 1: davidhw888 (button) folded before Flop (didn't bet)
Seat 2: Basebob (small blind) mucked [9d Ts]
Seat 3: reetskeet (big blind) showed [5c 7s] and won ($19.83) with a straight, Five to Nine
Seat 4: crux1994 folded before Flop (didn't bet)
Seat 5: FSK78 folded before Flop (didn't bet)
Seat 6: SantiagoWeight folded before Flop (didn't bet)



PokerStars Zoom Hand #195023508697:  Hold'em No Limit ($0.10/$0.25) - 2018/12/29 3:43:45 UTC [2018/12/28 22:43:45 ET]
Table 'Hydra' 6-max Seat #1 is the button
Seat 1: angipoker ($13.10 in chips) 
Seat 2: SantiagoWeight ($83.24 in chips) 
Seat 3: MoMoney2612 ($25 in chips) 
Seat 4: osa126 ($65.65 in chips) 
Seat 5: xXBossHossXx ($32.87 in chips) 
Seat 6: xman141 ($39.60 in chips) 
SantiagoWeight: posts small blind $0.10
MoMoney2612: posts big blind $0.25
*** HOLE CARDS ***
Dealt to SantiagoWeight [3h 6c]
osa126: folds 
xXBossHossXx: raises $0.50 to $0.75
xman141: folds 
angipoker: folds 
SantiagoWeight: folds 
MoMoney2612: folds 
Uncalled bet ($0.50) returned to xXBossHossXx
xXBossHossXx collected $0.60 from pot
xXBossHossXx: doesn't show hand 
*** SUMMARY ***
Total pot $0.60 | Rake $0 
Seat 1: angipoker (button) folded before Flop (didn't bet)
Seat 2: SantiagoWeight (small blind) folded before Flop
Seat 3: MoMoney2612 (big blind) folded before Flop
Seat 4: osa126 folded before Flop (didn't bet)
Seat 5: xXBossHossXx collected ($0.60)
Seat 6: xman141 folded before Flop (didn't bet)



PokerStars Zoom Hand #195023513481:  Hold'em No Limit ($0.10/$0.25) - 2018/12/29 3:44:00 UTC [2018/12/28 22:44:00 ET]
Table 'Hydra' 6-max Seat #1 is the button
Seat 1: ssrace ($32.38 in chips) 
Seat 2: Bujan 07 ($10.29 in chips) 
Seat 3: Dbakunwaves ($113.09 in chips) 
Seat 4: SantiagoWeight ($83.14 in chips) 
Seat 5: Pardaroxon ($54.76 in chips) 
Seat 6: Albratros2 ($25.88 in chips) 
Bujan 07: posts small blind $0.10
Dbakunwaves: posts big blind $0.25
*** HOLE CARDS ***
Dealt to SantiagoWeight [5s Ac]
SantiagoWeight: folds 
Pardaroxon: folds 
Albratros2: folds 
ssrace: folds 
Bujan 07: raises $0.50 to $0.75
Dbakunwaves: folds 
Uncalled bet ($0.50) returned to Bujan 07
Bujan 07 collected $0.50 from pot
Bujan 07: doesn't show hand 
*** SUMMARY ***
Total pot $0.50 | Rake $0 
Seat 1: ssrace (button) folded before Flop (didn't bet)
Seat 2: Bujan 07 (small blind) collected ($0.50)
Seat 3: Dbakunwaves (big blind) folded before Flop
Seat 4: SantiagoWeight folded before Flop (didn't bet)
Seat 5: Pardaroxon folded before Flop (didn't bet)
Seat 6: Albratros2 folded before Flop (didn't bet)



PokerStars Zoom Hand #195023518217:  Hold'em No Limit ($0.10/$0.25) - 2018/12/29 3:44:15 UTC [2018/12/28 22:44:15 ET]
Table 'Hydra' 6-max Seat #1 is the button
Seat 1: Chrimmpam ($18.94 in chips) 
Seat 2: zzzMASTERzzz ($16.53 in chips) 
Seat 3: SantiagoWeight ($83.14 in chips) 
Seat 4: pfunkolstar ($26.73 in chips) 
Seat 5: 1ownYourUsd ($53.74 in chips) 
Seat 6: Hamer1987 ($26.69 in chips) 
zzzMASTERzzz: posts small blind $0.10
SantiagoWeight: posts big blind $0.25
*** HOLE CARDS ***
Dealt to SantiagoWeight [9d Td]
pfunkolstar: raises $0.37 to $0.62
1ownYourUsd: calls $0.62
Hamer1987: folds 
Chrimmpam: folds 
zzzMASTERzzz: folds 
SantiagoWeight: calls $0.37
*** FLOP *** [Kc As 6h]
SantiagoWeight: checks 
pfunkolstar: checks 
1ownYourUsd: bets $1
SantiagoWeight: folds 
pfunkolstar: folds 
Uncalled bet ($1) returned to 1ownYourUsd
1ownYourUsd collected $1.87 from pot
1ownYourUsd: doesn't show hand 
*** SUMMARY ***
Total pot $1.96 | Rake $0.09 
Board [Kc As 6h]
Seat 1: Chrimmpam (button) folded before Flop (didn't bet)
Seat 2: zzzMASTERzzz (small blind) folded before Flop
Seat 3: SantiagoWeight (big blind) folded on the Flop
Seat 4: pfunkolstar folded on the Flop
Seat 5: 1ownYourUsd collected ($1.87)
Seat 6: Hamer1987 folded before Flop (didn't bet)



PokerStars Zoom Hand #195023514747:  Hold'em No Limit ($0.10/$0.25) - 2018/12/29 3:44:04 UTC [2018/12/28 22:44:04 ET]
Table 'Hydra' 6-max Seat #1 is the button
Seat 1: cankum ($25 in chips) 
Seat 2: vigos king ($58.80 in chips) 
Seat 3: landromede ($23.12 in chips) 
Seat 4: fishnm2018 ($21.64 in chips) 
Seat 5: SantiagoWeight ($83.14 in chips) 
Seat 6: HansMSM ($53.46 in chips) 
vigos king: posts small blind $0.10
landromede: posts big blind $0.25
*** HOLE CARDS ***
Dealt to SantiagoWeight [Td Kh]
fishnm2018: folds 
SantiagoWeight: folds 
HansMSM: raises $0.45 to $0.70
cankum: folds 
vigos king: calls $0.60
landromede: folds 
*** FLOP *** [Kc Jc 2c]
vigos king: checks 
HansMSM: bets $0.52
vigos king: folds 
Uncalled bet ($0.52) returned to HansMSM
HansMSM collected $1.58 from pot
HansMSM: doesn't show hand 
*** SUMMARY ***
Total pot $1.65 | Rake $0.07 
Board [Kc Jc 2c]
Seat 1: cankum (button) folded before Flop (didn't bet)
Seat 2: vigos king (small blind) folded on the Flop
Seat 3: landromede (big blind) folded before Flop
Seat 4: fishnm2018 folded before Flop (didn't bet)
Seat 5: SantiagoWeight folded before Flop (didn't bet)
Seat 6: HansMSM collected ($1.58)



PokerStars Zoom Hand #195023526244:  Hold'em No Limit ($0.10/$0.25) - 2018/12/29 3:44:40 UTC [2018/12/28 22:44:40 ET]
Table 'Hydra' 6-max Seat #1 is the button
Seat 1: miru877 ($26.58 in chips) 
Seat 2: reetskeet ($39.45 in chips) 
Seat 3: franco373513 ($12.05 in chips) 
Seat 4: SantiagoWeight ($82.52 in chips) 
Seat 5: Ovanes911 ($16.09 in chips) 
Seat 6: GrandmasterY ($44.42 in chips) 
reetskeet: posts small blind $0.10
franco373513: posts big blind $0.25
*** HOLE CARDS ***
Dealt to SantiagoWeight [8h 8s]
SantiagoWeight: raises $0.42 to $0.67
Ovanes911: folds 
GrandmasterY: calls $0.67
miru877: raises $2.36 to $3.03
reetskeet: folds 
franco373513: folds 
SantiagoWeight: folds 
GrandmasterY: folds 
Uncalled bet ($2.36) returned to miru877
miru877 collected $2.36 from pot
miru877: doesn't show hand 
*** SUMMARY ***
Total pot $2.36 | Rake $0 
Seat 1: miru877 (button) collected ($2.36)
Seat 2: reetskeet (small blind) folded before Flop
Seat 3: franco373513 (big blind) folded before Flop
Seat 4: SantiagoWeight folded before Flop
Seat 5: Ovanes911 folded before Flop (didn't bet)
Seat 6: GrandmasterY folded before Flop



PokerStars Zoom Hand #195023544004:  Hold'em No Limit ($0.10/$0.25) - 2018/12/29 3:45:20 UTC [2018/12/28 22:45:20 ET]
Table 'Hydra' 6-max Seat #1 is the button
Seat 1: KeySssi ($25 in chips) 
Seat 2: SantiagoWeight ($81.85 in chips) 
Seat 3: pRoma66 ($29.89 in chips) 
Seat 4: miru877 ($25.35 in chips) 
Seat 5: ryanking99 ($33.18 in chips) 
Seat 6: _BluDeeN_ ($30.57 in chips) 
SantiagoWeight: posts small blind $0.10
pRoma66: posts big blind $0.25
*** HOLE CARDS ***
Dealt to SantiagoWeight [2d 4c]
miru877: folds 
ryanking99: raises $0.31 to $0.56
_BluDeeN_: folds 
KeySssi: folds 
SantiagoWeight: folds 
pRoma66: folds 
Uncalled bet ($0.31) returned to ryanking99
ryanking99 collected $0.60 from pot
ryanking99: doesn't show hand 
*** SUMMARY ***
Total pot $0.60 | Rake $0 
Seat 1: KeySssi (button) folded before Flop (didn't bet)
Seat 2: SantiagoWeight (small blind) folded before Flop
Seat 3: pRoma66 (big blind) folded before Flop
Seat 4: miru877 folded before Flop (didn't bet)
Seat 5: ryanking99 collected ($0.60)
Seat 6: _BluDeeN_ folded before Flop (didn't bet)



PokerStars Zoom Hand #195023554001:  Hold'em No Limit ($0.10/$0.25) - 2018/12/29 3:45:52 UTC [2018/12/28 22:45:52 ET]
Table 'Hydra' 6-max Seat #1 is the button
Seat 1: numbernine5 ($57.04 in chips) 
Seat 2: Mandu_xiii ($28.42 in chips) 
Seat 3: KeySssi ($25 in chips) 
Seat 4: Baboscrubx ($32.21 in chips) 
Seat 5: razil_999 ($25.47 in chips) 
Seat 6: SantiagoWeight ($81.75 in chips) 
Mandu_xiii: posts small blind $0.10
KeySssi: posts big blind $0.25
*** HOLE CARDS ***
Dealt to SantiagoWeight [5c Jd]
Baboscrubx: folds 
razil_999: folds 
SantiagoWeight: folds 
numbernine5: folds 
Mandu_xiii: folds 
Uncalled bet ($0.15) returned to KeySssi
KeySssi collected $0.20 from pot
KeySssi: doesn't show hand 
*** SUMMARY ***
Total pot $0.20 | Rake $0 
Seat 1: numbernine5 (button) folded before Flop (didn't bet)
Seat 2: Mandu_xiii (small blind) folded before Flop
Seat 3: KeySssi (big blind) collected ($0.20)
Seat 4: Baboscrubx folded before Flop (didn't bet)
Seat 5: razil_999 folded before Flop (didn't bet)
Seat 6: SantiagoWeight folded before Flop (didn't bet)



PokerStars Zoom Hand #195023549553:  Hold'em No Limit ($0.10/$0.25) - 2018/12/29 3:45:38 UTC [2018/12/28 22:45:38 ET]
Table 'Hydra' 6-max Seat #1 is the button
Seat 1: SantiagoWeight ($81.75 in chips) 
Seat 2: Basebob ($26.26 in chips) 
Seat 3: franco373513 ($10.70 in chips) 
Seat 4: miru877 ($28.27 in chips) 
Seat 5: Dr.Jekyll197 ($16.32 in chips) 
Seat 6: mariopork ($68.79 in chips) 
Basebob: posts small blind $0.10
franco373513: posts big blind $0.25
*** HOLE CARDS ***
Dealt to SantiagoWeight [Qs Kh]
miru877: raises $0.50 to $0.75
Dr.Jekyll197: folds 
mariopork: raises $1.50 to $2.25
SantiagoWeight: folds 
Basebob: folds 
franco373513: folds 
miru877: calls $1.50
*** FLOP *** [5c 2c 7s]
miru877: checks 
mariopork: bets $1.53
miru877: calls $1.53
*** TURN *** [5c 2c 7s] [Kc]
miru877: checks 
mariopork: bets $4.98
miru877: folds 
Uncalled bet ($4.98) returned to mariopork
mariopork collected $7.55 from pot
mariopork: doesn't show hand 
*** SUMMARY ***
Total pot $7.91 | Rake $0.36 
Board [5c 2c 7s Kc]
Seat 1: SantiagoWeight (button) folded before Flop (didn't bet)
Seat 2: Basebob (small blind) folded before Flop
Seat 3: franco373513 (big blind) folded before Flop
Seat 4: miru877 folded on the Turn
Seat 5: Dr.Jekyll197 folded before Flop (didn't bet)
Seat 6: mariopork collected ($7.55)



PokerStars Zoom Hand #195023560674:  Hold'em No Limit ($0.10/$0.25) - 2018/12/29 3:46:13 UTC [2018/12/28 22:46:13 ET]
Table 'Hydra' 6-max Seat #1 is the button
Seat 1: GrandmasterY ($50.10 in chips) 
Seat 2: Lehared ($25 in chips) 
Seat 3: !P0K3RM3T4L! ($31.06 in chips) 
Seat 4: landromede ($14.83 in chips) 
Seat 5: SantiagoWeight ($81.75 in chips) 
Seat 6: kudlaj ($22.65 in chips) 
Lehared: posts small blind $0.10
!P0K3RM3T4L!: posts big blind $0.25
*** HOLE CARDS ***
Dealt to SantiagoWeight [9c Kd]
landromede: raises $0.25 to $0.50
SantiagoWeight: folds 
kudlaj: folds 
GrandmasterY: folds 
Lehared: folds 
!P0K3RM3T4L!: calls $0.25
*** FLOP *** [Tc Kh 5s]
!P0K3RM3T4L!: checks 
landromede: checks 
*** TURN *** [Tc Kh 5s] [7c]
!P0K3RM3T4L!: bets $0.82
landromede: folds 
Uncalled bet ($0.82) returned to !P0K3RM3T4L!
!P0K3RM3T4L! collected $1.05 from pot
!P0K3RM3T4L!: doesn't show hand 
*** SUMMARY ***
Total pot $1.10 | Rake $0.05 
Board [Tc Kh 5s 7c]
Seat 1: GrandmasterY (button) folded before Flop (didn't bet)
Seat 2: Lehared (small blind) folded before Flop
Seat 3: !P0K3RM3T4L! (big blind) collected ($1.05)
Seat 4: landromede folded on the Turn
Seat 5: SantiagoWeight folded before Flop (didn't bet)
Seat 6: kudlaj folded before Flop (didn't bet)



PokerStars Zoom Hand #195023563138:  Hold'em No Limit ($0.10/$0.25) - 2018/12/29 3:46:21 UTC [2018/12/28 22:46:21 ET]
Table 'Hydra' 6-max Seat #1 is the button
Seat 1: Baboscrubx ($26.14 in chips) 
Seat 2: Lehared ($25 in chips) 
Seat 3: SantiagoWeight ($81.75 in chips) 
Seat 4: G ster24 ($38.15 in chips) 
Seat 5: _BluDeeN_ ($30.47 in chips) 
Seat 6: gaffer31 ($27.68 in chips) 
Lehared: posts small blind $0.10
SantiagoWeight: posts big blind $0.25
*** HOLE CARDS ***
Dealt to SantiagoWeight [As Qh]
G ster24: folds 
_BluDeeN_: raises $0.50 to $0.75
gaffer31: folds 
Baboscrubx: folds 
Lehared: folds 
SantiagoWeight: calls $0.50
*** FLOP *** [2c Kh 8s]
SantiagoWeight: checks 
_BluDeeN_: bets $1.25
SantiagoWeight: calls $1.25
*** TURN *** [2c Kh 8s] [4h]
SantiagoWeight: checks 
_BluDeeN_: bets $3.50
SantiagoWeight: folds 
Uncalled bet ($3.50) returned to _BluDeeN_
_BluDeeN_ collected $3.92 from pot
*** SUMMARY ***
Total pot $4.10 | Rake $0.18 
Board [2c Kh 8s 4h]
Seat 1: Baboscrubx (button) folded before Flop (didn't bet)
Seat 2: Lehared (small blind) folded before Flop
Seat 3: SantiagoWeight (big blind) folded on the Turn
Seat 4: G ster24 folded before Flop (didn't bet)
Seat 5: _BluDeeN_ collected ($3.92)
Seat 6: gaffer31 folded before Flop (didn't bet)



PokerStars Zoom Hand #195023587973:  Hold'em No Limit ($0.10/$0.25) - 2018/12/29 3:47:40 UTC [2018/12/28 22:47:40 ET]
Table 'Hydra' 6-max Seat #1 is the button
Seat 1: SantiagoWeight ($79.75 in chips) 
Seat 2: mariopork ($28.87 in chips) 
Seat 3: Lehared ($26.08 in chips) 
Seat 4: CrazieFreddy ($7.27 in chips) 
Seat 5: ryanking99 ($38.36 in chips) 
Seat 6: yobbos ($140.94 in chips) 
mariopork: posts small blind $0.10
Lehared: posts big blind $0.25
*** HOLE CARDS ***
Dealt to SantiagoWeight [Qd 2s]
CrazieFreddy: folds 
ryanking99: folds 
yobbos: folds 
SantiagoWeight: folds 
mariopork: folds 
Uncalled bet ($0.15) returned to Lehared
Lehared collected $0.20 from pot
Lehared: doesn't show hand 
*** SUMMARY ***
Total pot $0.20 | Rake $0 
Seat 1: SantiagoWeight (button) folded before Flop (didn't bet)
Seat 2: mariopork (small blind) folded before Flop
Seat 3: Lehared (big blind) collected ($0.20)
Seat 4: CrazieFreddy folded before Flop (didn't bet)
Seat 5: ryanking99 folded before Flop (didn't bet)
Seat 6: yobbos folded before Flop (didn't bet)



PokerStars Zoom Hand #195023589546:  Hold'em No Limit ($0.10/$0.25) - 2018/12/29 3:47:45 UTC [2018/12/28 22:47:45 ET]
Table 'Hydra' 6-max Seat #1 is the button
Seat 1: Bujan 07 ($9.40 in chips) 
Seat 2: HansMSM ($29.10 in chips) 
Seat 3: 1ownYourUsd ($54.85 in chips) 
Seat 4: SantiagoWeight ($79.75 in chips) 
Seat 5: CrazieFreddy ($7.27 in chips) 
Seat 6: anorectal ($25 in chips) 
HansMSM: posts small blind $0.10
1ownYourUsd: posts big blind $0.25
*** HOLE CARDS ***
Dealt to SantiagoWeight [Ks Th]
SantiagoWeight: folds 
CrazieFreddy: folds 
anorectal: folds 
Bujan 07: raises $0.50 to $0.75
HansMSM: folds 
1ownYourUsd: folds 
Uncalled bet ($0.50) returned to Bujan 07
Bujan 07 collected $0.60 from pot
Bujan 07: doesn't show hand 
*** SUMMARY ***
Total pot $0.60 | Rake $0 
Seat 1: Bujan 07 (button) collected ($0.60)
Seat 2: HansMSM (small blind) folded before Flop
Seat 3: 1ownYourUsd (big blind) folded before Flop
Seat 4: SantiagoWeight folded before Flop (didn't bet)
Seat 5: CrazieFreddy folded before Flop (didn't bet)
Seat 6: anorectal folded before Flop (didn't bet)



PokerStars Zoom Hand #195023595502:  Hold'em No Limit ($0.10/$0.25) - 2018/12/29 3:48:04 UTC [2018/12/28 22:48:04 ET]
Table 'Hydra' 6-max Seat #1 is the button
Seat 1: Unclesmoll ($30.46 in chips) 
Seat 2: SantiagoWeight ($79.75 in chips) 
Seat 3: mayadelrey ($74.71 in chips) 
Seat 4: davidhw888 ($22.88 in chips) 
Seat 5: aa1421b ($41.33 in chips) 
Seat 6: Lehared ($71.95 in chips) 
SantiagoWeight: posts small blind $0.10
mayadelrey: posts big blind $0.25
*** HOLE CARDS ***
Dealt to SantiagoWeight [2s 9d]
davidhw888: folds 
aa1421b: raises $0.50 to $0.75
Lehared: folds 
Unclesmoll: folds 
SantiagoWeight: folds 
mayadelrey: calls $0.50
*** FLOP *** [3d 4c Kc]
mayadelrey: checks 
aa1421b: bets $1.25
mayadelrey: folds 
Uncalled bet ($1.25) returned to aa1421b
aa1421b collected $1.53 from pot
aa1421b: doesn't show hand 
*** SUMMARY ***
Total pot $1.60 | Rake $0.07 
Board [3d 4c Kc]
Seat 1: Unclesmoll (button) folded before Flop (didn't bet)
Seat 2: SantiagoWeight (small blind) folded before Flop
Seat 3: mayadelrey (big blind) folded on the Flop
Seat 4: davidhw888 folded before Flop (didn't bet)
Seat 5: aa1421b collected ($1.53)
Seat 6: Lehared folded before Flop (didn't bet)



PokerStars Zoom Hand #195023610638:  Hold'em No Limit ($0.10/$0.25) - 2018/12/29 3:48:53 UTC [2018/12/28 22:48:53 ET]
Table 'Hydra' 6-max Seat #1 is the button
Seat 1: mariopork ($26.83 in chips) 
Seat 2: call me??107 ($7.74 in chips) 
Seat 3: Pardaroxon ($49.86 in chips) 
Seat 4: Nutselas ($25 in chips) 
Seat 5: Viiiru ($69.02 in chips) 
Seat 6: SantiagoWeight ($79.40 in chips) 
call me??107: posts small blind $0.10
Pardaroxon: posts big blind $0.25
*** HOLE CARDS ***
Dealt to SantiagoWeight [Ts Qc]
Nutselas: folds 
Viiiru: folds 
SantiagoWeight: raises $0.30 to $0.55
mariopork: folds 
call me??107: folds 
Pardaroxon: raises $1.55 to $2.10
SantiagoWeight: folds 
Uncalled bet ($1.55) returned to Pardaroxon
Pardaroxon collected $1.20 from pot
Pardaroxon: doesn't show hand 
*** SUMMARY ***
Total pot $1.20 | Rake $0 
Seat 1: mariopork (button) folded before Flop (didn't bet)
Seat 2: call me??107 (small blind) folded before Flop
Seat 3: Pardaroxon (big blind) collected ($1.20)
Seat 4: Nutselas folded before Flop (didn't bet)
Seat 5: Viiiru folded before Flop (didn't bet)
Seat 6: SantiagoWeight folded before Flop



PokerStars Zoom Hand #195023598854:  Hold'em No Limit ($0.10/$0.25) - 2018/12/29 3:48:15 UTC [2018/12/28 22:48:15 ET]
Table 'Hydra' 6-max Seat #1 is the button
Seat 1: Slim Wolfie ($25 in chips) 
Seat 2: reno484 ($21.51 in chips) 
Seat 3: SantiagoWeight ($79.65 in chips) 
Seat 4: aldoalb0207 ($47.60 in chips) 
Seat 5: Party4Arthy ($54.37 in chips) 
Seat 6: nadal335 ($25.10 in chips) 
reno484: posts small blind $0.10
SantiagoWeight: posts big blind $0.25
*** HOLE CARDS ***
Dealt to SantiagoWeight [8s Js]
aldoalb0207: raises $0.25 to $0.50
Party4Arthy has timed out
Party4Arthy: folds 
nadal335: folds 
Slim Wolfie: raises $1.25 to $1.75
reno484: folds 
SantiagoWeight: folds 
aldoalb0207: calls $1.25
*** FLOP *** [Ah Ts Kc]
aldoalb0207: checks 
Slim Wolfie: bets $1.22
aldoalb0207: calls $1.22
*** TURN *** [Ah Ts Kc] [Ad]
aldoalb0207: checks 
Slim Wolfie: bets $2
aldoalb0207: folds 
Uncalled bet ($2) returned to Slim Wolfie
Slim Wolfie collected $6.01 from pot
Slim Wolfie: doesn't show hand 
*** SUMMARY ***
Total pot $6.29 | Rake $0.28 
Board [Ah Ts Kc Ad]
Seat 1: Slim Wolfie (button) collected ($6.01)
Seat 2: reno484 (small blind) folded before Flop
Seat 3: SantiagoWeight (big blind) folded before Flop
Seat 4: aldoalb0207 folded on the Turn
Seat 5: Party4Arthy folded before Flop (didn't bet)
Seat 6: nadal335 folded before Flop (didn't bet)



PokerStars Zoom Hand #195023621738:  Hold'em No Limit ($0.10/$0.25) - 2018/12/29 3:49:29 UTC [2018/12/28 22:49:29 ET]
Table 'Hydra' 6-max Seat #1 is the button
Seat 1: GrandmasterY ($56.79 in chips) 
Seat 2: tariko1980 ($20.97 in chips) 
Seat 3: mariopork ($26.83 in chips) 
Seat 4: kakashi_zion ($30.21 in chips) 
Seat 5: SantiagoWeight ($78.85 in chips) 
Seat 6: zhang1zhang ($25.48 in chips) 
tariko1980: posts small blind $0.10
mariopork: posts big blind $0.25
*** HOLE CARDS ***
Dealt to SantiagoWeight [7d 7c]
kakashi_zion: folds 
SantiagoWeight: raises $0.37 to $0.62
zhang1zhang: folds 
GrandmasterY: folds 
tariko1980: folds 
mariopork: folds 
Uncalled bet ($0.37) returned to SantiagoWeight
SantiagoWeight collected $0.60 from pot
SantiagoWeight: doesn't show hand 
*** SUMMARY ***
Total pot $0.60 | Rake $0 
Seat 1: GrandmasterY (button) folded before Flop (didn't bet)
Seat 2: tariko1980 (small blind) folded before Flop
Seat 3: mariopork (big blind) folded before Flop
Seat 4: kakashi_zion folded before Flop (didn't bet)
Seat 5: SantiagoWeight collected ($0.60)
Seat 6: zhang1zhang folded before Flop (didn't bet)



PokerStars Zoom Hand #195023626434:  Hold'em No Limit ($0.10/$0.25) - 2018/12/29 3:49:44 UTC [2018/12/28 22:49:44 ET]
Table 'Hydra' 6-max Seat #1 is the button
Seat 1: graysonai ($36.48 in chips) 
Seat 2: SantiagoWeight ($79.20 in chips) 
Seat 3: Chrimmpam ($16.11 in chips) 
Seat 4: ivann14 ($72.40 in chips) 
Seat 5: kakashi_zion ($30.11 in chips) 
Seat 6: lovintalbi ($59.69 in chips) 
SantiagoWeight: posts small blind $0.10
Chrimmpam: posts big blind $0.25
*** HOLE CARDS ***
Dealt to SantiagoWeight [2c Qh]
ivann14: raises $0.50 to $0.75
kakashi_zion: folds 
lovintalbi: folds 
graysonai: folds 
SantiagoWeight: folds 
Chrimmpam: folds 
Uncalled bet ($0.50) returned to ivann14
ivann14 collected $0.60 from pot
ivann14: doesn't show hand 
*** SUMMARY ***
Total pot $0.60 | Rake $0 
Seat 1: graysonai (button) folded before Flop (didn't bet)
Seat 2: SantiagoWeight (small blind) folded before Flop
Seat 3: Chrimmpam (big blind) folded before Flop
Seat 4: ivann14 collected ($0.60)
Seat 5: kakashi_zion folded before Flop (didn't bet)
Seat 6: lovintalbi folded before Flop (didn't bet)



PokerStars Zoom Hand #195023631893:  Hold'em No Limit ($0.10/$0.25) - 2018/12/29 3:50:02 UTC [2018/12/28 22:50:02 ET]
Table 'Hydra' 6-max Seat #1 is the button
Seat 1: davidhw888 ($23.30 in chips) 
Seat 2: mariopork ($26.58 in chips) 
Seat 3: deaglepro ($74.03 in chips) 
Seat 4: KeySssi ($25 in chips) 
Seat 5: nhanminhtri ($27.55 in chips) 
Seat 6: SantiagoWeight ($79.10 in chips) 
mariopork: posts small blind $0.10
deaglepro: posts big blind $0.25
*** HOLE CARDS ***
Dealt to SantiagoWeight [4h 7c]
KeySssi: folds 
nhanminhtri: raises $0.50 to $0.75
SantiagoWeight: folds 
davidhw888: folds 
mariopork: folds 
deaglepro: calls $0.50
*** FLOP *** [3d 9d 6c]
deaglepro: checks 
nhanminhtri: bets $1.15
deaglepro: folds 
Uncalled bet ($1.15) returned to nhanminhtri
nhanminhtri collected $1.53 from pot
nhanminhtri: doesn't show hand 
*** SUMMARY ***
Total pot $1.60 | Rake $0.07 
Board [3d 9d 6c]
Seat 1: davidhw888 (button) folded before Flop (didn't bet)
Seat 2: mariopork (small blind) folded before Flop
Seat 3: deaglepro (big blind) folded on the Flop
Seat 4: KeySssi folded before Flop (didn't bet)
Seat 5: nhanminhtri collected ($1.53)
Seat 6: SantiagoWeight folded before Flop (didn't bet)



PokerStars Zoom Hand #195023639608:  Hold'em No Limit ($0.10/$0.25) - 2018/12/29 3:50:27 UTC [2018/12/28 22:50:27 ET]
Table 'Hydra' 6-max Seat #1 is the button
Seat 1: SantiagoWeight ($78.85 in chips) 
Seat 2: mariopork ($43.50 in chips) 
Seat 3: _BluDeeN_ ($32.35 in chips) 
Seat 4: BIGPAIN14 ($28.17 in chips) 
Seat 5: 88*SaaS*99 ($14.26 in chips) 
Seat 6: yobbos ($142.58 in chips) 
mariopork: posts small blind $0.10
_BluDeeN_: posts big blind $0.25
*** HOLE CARDS ***
Dealt to SantiagoWeight [3s 3d]
BIGPAIN14: folds 
88*SaaS*99: raises $0.60 to $0.85
yobbos: folds 
SantiagoWeight: folds 
mariopork: folds 
_BluDeeN_: folds 
Uncalled bet ($0.60) returned to 88*SaaS*99
88*SaaS*99 collected $0.60 from pot
88*SaaS*99: doesn't show hand 
*** SUMMARY ***
Total pot $0.60 | Rake $0 
Seat 1: SantiagoWeight (button) folded before Flop (didn't bet)
Seat 2: mariopork (small blind) folded before Flop
Seat 3: _BluDeeN_ (big blind) folded before Flop
Seat 4: BIGPAIN14 folded before Flop (didn't bet)
Seat 5: 88*SaaS*99 collected ($0.60)
Seat 6: yobbos folded before Flop (didn't bet)



PokerStars Zoom Hand #195023634638:  Hold'em No Limit ($0.10/$0.25) - 2018/12/29 3:50:11 UTC [2018/12/28 22:50:11 ET]
Table 'Hydra' 6-max Seat #1 is the button
Seat 1: ckriszee ($28.03 in chips) 
Seat 2: 666erkan ($22.10 in chips) 
Seat 3: SantiagoWeight ($79.10 in chips) 
Seat 4: miru877 ($23.96 in chips) 
Seat 5: trttt74 ($22.12 in chips) 
Seat 6: Viiiru ($29.90 in chips) 
666erkan: posts small blind $0.10
SantiagoWeight: posts big blind $0.25
*** HOLE CARDS ***
Dealt to SantiagoWeight [6h 2d]
miru877: folds 
trttt74: raises $0.37 to $0.62
Viiiru: folds 
ckriszee: folds 
666erkan: calls $0.52
SantiagoWeight: folds 
*** FLOP *** [7h 4s 3s]
666erkan: checks 
trttt74: bets $0.75
666erkan: calls $0.75
*** TURN *** [7h 4s 3s] [Jh]
666erkan: checks 
trttt74: bets $0.75
666erkan: calls $0.75
*** RIVER *** [7h 4s 3s Jh] [9c]
666erkan: checks 
trttt74: checks 
*** SHOW DOWN ***
666erkan: shows [Kd Ad] (high card Ace)
trttt74: mucks hand 
666erkan collected $4.29 from pot
*** SUMMARY ***
Total pot $4.49 | Rake $0.20 
Board [7h 4s 3s Jh 9c]
Seat 1: ckriszee (button) folded before Flop (didn't bet)
Seat 2: 666erkan (small blind) showed [Kd Ad] and won ($4.29) with high card Ace
Seat 3: SantiagoWeight (big blind) folded before Flop
Seat 4: miru877 folded before Flop (didn't bet)
Seat 5: trttt74 mucked [Ks 8s]
Seat 6: Viiiru folded before Flop (didn't bet)



PokerStars Zoom Hand #195023648500:  Hold'em No Limit ($0.10/$0.25) - 2018/12/29 3:50:56 UTC [2018/12/28 22:50:56 ET]
Table 'Hydra' 6-max Seat #1 is the button
Seat 1: reggiedogg31 ($96.57 in chips) 
Seat 2: kakashi_zion ($30.11 in chips) 
Seat 3: ssrace ($33.95 in chips) 
Seat 4: GrandmasterY ($45.72 in chips) 
Seat 5: SantiagoWeight ($78.85 in chips) 
Seat 6: 666erkan ($24.27 in chips) 
kakashi_zion: posts small blind $0.10
ssrace: posts big blind $0.25
*** HOLE CARDS ***
Dealt to SantiagoWeight [Th Qd]
GrandmasterY: folds 
SantiagoWeight: folds 
666erkan: folds 
reggiedogg31: folds 
kakashi_zion: folds 
Uncalled bet ($0.15) returned to ssrace
ssrace collected $0.20 from pot
ssrace: doesn't show hand 
*** SUMMARY ***
Total pot $0.20 | Rake $0 
Seat 1: reggiedogg31 (button) folded before Flop (didn't bet)
Seat 2: kakashi_zion (small blind) folded before Flop
Seat 3: ssrace (big blind) collected ($0.20)
Seat 4: GrandmasterY folded before Flop (didn't bet)
Seat 5: SantiagoWeight folded before Flop (didn't bet)
Seat 6: 666erkan folded before Flop (didn't bet)



PokerStars Zoom Hand #195023646636:  Hold'em No Limit ($0.10/$0.25) - 2018/12/29 3:50:50 UTC [2018/12/28 22:50:50 ET]
Table 'Hydra' 6-max Seat #1 is the button
Seat 1: donmarc777 ($91.28 in chips) 
Seat 2: gustavotaina ($11.90 in chips) 
Seat 3: Paasinha ($40.88 in chips) 
Seat 4: SantiagoWeight ($78.85 in chips) 
Seat 5: FSK78 ($70.10 in chips) 
Seat 6: anorectal ($26.41 in chips) 
gustavotaina: posts small blind $0.10
Paasinha: posts big blind $0.25
*** HOLE CARDS ***
Dealt to SantiagoWeight [7h 6d]
SantiagoWeight: folds 
FSK78: raises $0.77 to $1.02
anorectal: raises $1.78 to $2.80
donmarc777: calls $2.80
gustavotaina: folds 
Paasinha: folds 
FSK78: calls $1.78
*** FLOP *** [7s 3c 8s]
FSK78: checks 
anorectal: bets $6.69
donmarc777: folds 
FSK78: folds 
Uncalled bet ($6.69) returned to anorectal
anorectal collected $8.36 from pot
anorectal: doesn't show hand 
*** SUMMARY ***
Total pot $8.75 | Rake $0.39 
Board [7s 3c 8s]
Seat 1: donmarc777 (button) folded on the Flop
Seat 2: gustavotaina (small blind) folded before Flop
Seat 3: Paasinha (big blind) folded before Flop
Seat 4: SantiagoWeight folded before Flop (didn't bet)
Seat 5: FSK78 folded on the Flop
Seat 6: anorectal collected ($8.36)



PokerStars Zoom Hand #195023652481:  Hold'em No Limit ($0.10/$0.25) - 2018/12/29 3:51:09 UTC [2018/12/28 22:51:09 ET]
Table 'Hydra' 6-max Seat #1 is the button
Seat 1: Unclesmoll ($29.68 in chips) 
Seat 2: Bonen18 ($25 in chips) 
Seat 3: 666erkan ($24.27 in chips) 
Seat 4: river plate9 ($25.83 in chips) 
Seat 5: ColinCaine ($8.96 in chips) 
Seat 6: SantiagoWeight ($78.85 in chips) 
Bonen18: posts small blind $0.10
666erkan: posts big blind $0.25
*** HOLE CARDS ***
Dealt to SantiagoWeight [4h 8c]
river plate9: raises $0.25 to $0.50
ColinCaine: folds 
SantiagoWeight: folds 
Unclesmoll: raises $1.35 to $1.85
Bonen18: folds 
666erkan: folds 
river plate9: raises $4.05 to $5.90
Unclesmoll: raises $23.78 to $29.68 and is all-in
river plate9: calls $19.93 and is all-in
Uncalled bet ($3.85) returned to Unclesmoll
*** FLOP *** [7h 6c 7d]
*** TURN *** [7h 6c 7d] [5d]
*** RIVER *** [7h 6c 7d 5d] [Jc]
*** SHOW DOWN ***
river plate9: shows [Kd Ah] (a pair of Sevens)
Unclesmoll: shows [Ks Ad] (a pair of Sevens)
river plate9 collected $25.01 from pot
Unclesmoll collected $25 from pot
*** SUMMARY ***
Total pot $52.01 | Rake $2 
Board [7h 6c 7d 5d Jc]
Seat 1: Unclesmoll (button) showed [Ks Ad] and won ($25) with a pair of Sevens
Seat 2: Bonen18 (small blind) folded before Flop
Seat 3: 666erkan (big blind) folded before Flop
Seat 4: river plate9 showed [Kd Ah] and won ($25.01) with a pair of Sevens
Seat 5: ColinCaine folded before Flop (didn't bet)
Seat 6: SantiagoWeight folded before Flop (didn't bet)



PokerStars Zoom Hand #195023662287:  Hold'em No Limit ($0.10/$0.25) - 2018/12/29 3:51:41 UTC [2018/12/28 22:51:41 ET]
Table 'Hydra' 6-max Seat #1 is the button
Seat 1: mariopork ($34.53 in chips) 
Seat 2: pirosiky ($76.96 in chips) 
Seat 3: SantiagoWeight ($78.85 in chips) 
Seat 4: ivann14 ($64.22 in chips) 
Seat 5: Viiiru ($70.84 in chips) 
Seat 6: Mrs_Squeeze ($17.41 in chips) 
pirosiky: posts small blind $0.10
SantiagoWeight: posts big blind $0.25
*** HOLE CARDS ***
Dealt to SantiagoWeight [8c 9c]
ivann14 has timed out
ivann14: folds 
Viiiru: folds 
Mrs_Squeeze: folds 
mariopork: folds 
pirosiky: folds 
Uncalled bet ($0.15) returned to SantiagoWeight
SantiagoWeight collected $0.20 from pot
SantiagoWeight: doesn't show hand 
*** SUMMARY ***
Total pot $0.20 | Rake $0 
Seat 1: mariopork (button) folded before Flop (didn't bet)
Seat 2: pirosiky (small blind) folded before Flop
Seat 3: SantiagoWeight (big blind) collected ($0.20)
Seat 4: ivann14 folded before Flop (didn't bet)
Seat 5: Viiiru folded before Flop (didn't bet)
Seat 6: Mrs_Squeeze folded before Flop (didn't bet)



PokerStars Zoom Hand #195023656099:  Hold'em No Limit ($0.10/$0.25) - 2018/12/29 3:51:21 UTC [2018/12/28 22:51:21 ET]
Table 'Hydra' 6-max Seat #1 is the button
Seat 1: Renner32 ($22.78 in chips) 
Seat 2: 88*SaaS*99 ($14.93 in chips) 
Seat 3: hippo8529 ($12.50 in chips) 
Seat 4: SantiagoWeight ($78.85 in chips) 
Seat 5: ivann14 ($26.41 in chips) 
Seat 6: Bonen18 ($26.03 in chips) 
88*SaaS*99: posts small blind $0.10
hippo8529: posts big blind $0.25
*** HOLE CARDS ***
Dealt to SantiagoWeight [9c 8s]
SantiagoWeight: folds 
ivann14: folds 
Bonen18: folds 
Renner32: folds 
88*SaaS*99: raises $0.50 to $0.75
hippo8529: raises $0.50 to $1.25
88*SaaS*99: calls $0.50
*** FLOP *** [4c 2h Tc]
88*SaaS*99: checks 
hippo8529: bets $1.50
88*SaaS*99: calls $1.50
*** TURN *** [4c 2h Tc] [Td]
88*SaaS*99: checks 
hippo8529: bets $0.25
88*SaaS*99: calls $0.25
*** RIVER *** [4c 2h Tc Td] [Js]
88*SaaS*99: checks 
hippo8529: checks 
*** SHOW DOWN ***
88*SaaS*99: shows [Ac 6d] (a pair of Tens)
hippo8529: shows [4s 3s] (two pair, Tens and Fours)
hippo8529 collected $5.73 from pot
*** SUMMARY ***
Total pot $6 | Rake $0.27 
Board [4c 2h Tc Td Js]
Seat 1: Renner32 (button) folded before Flop (didn't bet)
Seat 2: 88*SaaS*99 (small blind) showed [Ac 6d] and lost with a pair of Tens
Seat 3: hippo8529 (big blind) showed [4s 3s] and won ($5.73) with two pair, Tens and Fours
Seat 4: SantiagoWeight folded before Flop (didn't bet)
Seat 5: ivann14 folded before Flop (didn't bet)
Seat 6: Bonen18 folded before Flop (didn't bet)



PokerStars Zoom Hand #195023658018:  Hold'em No Limit ($0.10/$0.25) - 2018/12/29 3:51:27 UTC [2018/12/28 22:51:27 ET]
Table 'Hydra' 6-max Seat #1 is the button
Seat 1: Bonen18 ($25 in chips) 
Seat 2: Virus3232 ($25 in chips) 
Seat 3: aa1421b ($44.07 in chips) 
Seat 4: Lehared ($85.12 in chips) 
Seat 5: SantiagoWeight ($78.85 in chips) 
Seat 6: Pardaroxon ($25 in chips) 
Virus3232: posts small blind $0.10
aa1421b: posts big blind $0.25
*** HOLE CARDS ***
Dealt to SantiagoWeight [2d 7s]
Lehared: folds 
SantiagoWeight: folds 
Pardaroxon: folds 
Bonen18: raises $0.27 to $0.52
Virus3232: raises $1.29 to $1.81
aa1421b: folds 
Bonen18: calls $1.29
*** FLOP *** [9c Qc 4c]
Virus3232: checks 
Bonen18: bets $1.22
Virus3232: calls $1.22
*** TURN *** [9c Qc 4c] [6h]
Virus3232: checks 
Bonen18: bets $3.62
Virus3232: calls $3.62
*** RIVER *** [9c Qc 4c 6h] [7c]
Virus3232: bets $5.50
Bonen18: raises $12.85 to $18.35 and is all-in
Virus3232: folds 
Uncalled bet ($12.85) returned to Bonen18
Bonen18 collected $23.45 from pot
Bonen18: doesn't show hand 
*** SUMMARY ***
Total pot $24.55 | Rake $1.10 
Board [9c Qc 4c 6h 7c]
Seat 1: Bonen18 (button) collected ($23.45)
Seat 2: Virus3232 (small blind) folded on the River
Seat 3: aa1421b (big blind) folded before Flop
Seat 4: Lehared folded before Flop (didn't bet)
Seat 5: SantiagoWeight folded before Flop (didn't bet)
Seat 6: Pardaroxon folded before Flop (didn't bet)



PokerStars Zoom Hand #195023674202:  Hold'em No Limit ($0.10/$0.25) - 2018/12/29 3:52:20 UTC [2018/12/28 22:52:20 ET]
Table 'Hydra' 6-max Seat #1 is the button
Seat 1: SantiagoWeight ($78.85 in chips) 
Seat 2: deaglepro ($72.03 in chips) 
Seat 3: 2poiRiver ($24.63 in chips) 
Seat 4: naxizzle ($115.50 in chips) 
Seat 5: Xp0Hb ($40.23 in chips) 
Seat 6: Bonen18 ($29.07 in chips) 
deaglepro: posts small blind $0.10
2poiRiver: posts big blind $0.25
*** HOLE CARDS ***
Dealt to SantiagoWeight [4h Jc]
naxizzle: folds 
Xp0Hb: folds 
Bonen18: folds 
SantiagoWeight: folds 
deaglepro: folds 
Uncalled bet ($0.15) returned to 2poiRiver
2poiRiver collected $0.20 from pot
2poiRiver: doesn't show hand 
*** SUMMARY ***
Total pot $0.20 | Rake $0 
Seat 1: SantiagoWeight (button) folded before Flop (didn't bet)
Seat 2: deaglepro (small blind) folded before Flop
Seat 3: 2poiRiver (big blind) collected ($0.20)
Seat 4: naxizzle folded before Flop (didn't bet)
Seat 5: Xp0Hb folded before Flop (didn't bet)
Seat 6: Bonen18 folded before Flop (didn't bet)



PokerStars Zoom Hand #195023669276:  Hold'em No Limit ($0.10/$0.25) - 2018/12/29 3:52:04 UTC [2018/12/28 22:52:04 ET]
Table 'Hydra' 6-max Seat #1 is the button
Seat 1: pirosiky ($25 in chips) 
Seat 2: SantiagoWeight ($78.95 in chips) 
Seat 3: bwim ($20.80 in chips) 
Seat 4: nadal335 ($30.65 in chips) 
Seat 5: gaffer31 ($18.80 in chips) 
Seat 6: Pardaroxon ($25.87 in chips) 
SantiagoWeight: posts small blind $0.10
bwim: posts big blind $0.25
*** HOLE CARDS ***
Dealt to SantiagoWeight [6c 2h]
nadal335: raises $0.50 to $0.75
gaffer31: raises $0.50 to $1.25
Pardaroxon: raises $2.55 to $3.80
pirosiky: folds 
SantiagoWeight: folds 
bwim: folds 
nadal335: folds 
gaffer31: calls $2.55
*** FLOP *** [Kh 4d 4c]
gaffer31: bets $15 and is all-in
Pardaroxon: calls $15
*** TURN *** [Kh 4d 4c] [6d]
*** RIVER *** [Kh 4d 4c 6d] [As]
*** SHOW DOWN ***
gaffer31: shows [4s 5c] (three of a kind, Fours)
Pardaroxon: shows [Ad Ac] (a full house, Aces full of Fours)
Pardaroxon collected $36.96 from pot
*** SUMMARY ***
Total pot $38.70 | Rake $1.74 
Board [Kh 4d 4c 6d As]
Seat 1: pirosiky (button) folded before Flop (didn't bet)
Seat 2: SantiagoWeight (small blind) folded before Flop
Seat 3: bwim (big blind) folded before Flop
Seat 4: nadal335 folded before Flop
Seat 5: gaffer31 showed [4s 5c] and lost with three of a kind, Fours
Seat 6: Pardaroxon showed [Ad Ac] and won ($36.96) with a full house, Aces full of Fours



PokerStars Zoom Hand #195023677830:  Hold'em No Limit ($0.10/$0.25) - 2018/12/29 3:52:32 UTC [2018/12/28 22:52:32 ET]
Table 'Hydra' 6-max Seat #1 is the button
Seat 1: bwim ($21.81 in chips) 
Seat 2: GrandmasterY ($53.32 in chips) 
Seat 3: Virus3232 ($25 in chips) 
Seat 4: reggiedogg31 ($96.30 in chips) 
Seat 5: SantiagoWeight ($78.85 in chips) 
Seat 6: CrazieFreddy ($12.55 in chips) 
GrandmasterY: posts small blind $0.10
Virus3232: posts big blind $0.25
*** HOLE CARDS ***
Dealt to SantiagoWeight [8c 9h]
reggiedogg31: raises $0.50 to $0.75
SantiagoWeight: folds 
CrazieFreddy: folds 
bwim: calls $0.75
GrandmasterY: folds 
Virus3232: folds 
*** FLOP *** [Qs 8s Ac]
reggiedogg31: checks 
bwim: checks 
*** TURN *** [Qs 8s Ac] [6s]
reggiedogg31: checks 
bwim: bets $1
reggiedogg31: folds 
Uncalled bet ($1) returned to bwim
bwim collected $1.77 from pot
bwim: doesn't show hand 
*** SUMMARY ***
Total pot $1.85 | Rake $0.08 
Board [Qs 8s Ac 6s]
Seat 1: bwim (button) collected ($1.77)
Seat 2: GrandmasterY (small blind) folded before Flop
Seat 3: Virus3232 (big blind) folded before Flop
Seat 4: reggiedogg31 folded on the Turn
Seat 5: SantiagoWeight folded before Flop (didn't bet)
Seat 6: CrazieFreddy folded before Flop (didn't bet)



PokerStars Zoom Hand #195023682099:  Hold'em No Limit ($0.10/$0.25) - 2018/12/29 3:52:46 UTC [2018/12/28 22:52:46 ET]
Table 'Hydra' 6-max Seat #1 is the button
Seat 1: ivann14 ($64.12 in chips) 
Seat 2: xman141 ($41.32 in chips) 
Seat 3: KeySssi ($54.44 in chips) 
Seat 4: Virus3232 ($26.40 in chips) 
Seat 5: GrandmasterY ($53.22 in chips) 
Seat 6: SantiagoWeight ($78.85 in chips) 
xman141: posts small blind $0.10
KeySssi: posts big blind $0.25
*** HOLE CARDS ***
Dealt to SantiagoWeight [5h 5c]
Virus3232: folds 
GrandmasterY: folds 
SantiagoWeight: raises $0.30 to $0.55
ivann14: folds 
xman141: folds 
KeySssi: raises $1.45 to $2
SantiagoWeight: calls $1.45
*** FLOP *** [Js Qs 8s]
KeySssi: checks 
SantiagoWeight: checks 
*** TURN *** [Js Qs 8s] [As]
KeySssi: checks 
SantiagoWeight: checks 
*** RIVER *** [Js Qs 8s As] [Kc]
KeySssi: checks 
SantiagoWeight: checks 
*** SHOW DOWN ***
KeySssi: shows [Ac Qd] (two pair, Aces and Queens)
SantiagoWeight: mucks hand 
KeySssi collected $3.92 from pot
*** SUMMARY ***
Total pot $4.10 | Rake $0.18 
Board [Js Qs 8s As Kc]
Seat 1: ivann14 (button) folded before Flop (didn't bet)
Seat 2: xman141 (small blind) folded before Flop
Seat 3: KeySssi (big blind) showed [Ac Qd] and won ($3.92) with two pair, Aces and Queens
Seat 4: Virus3232 folded before Flop (didn't bet)
Seat 5: GrandmasterY folded before Flop (didn't bet)
Seat 6: SantiagoWeight mucked [5h 5c]



PokerStars Zoom Hand #195023707059:  Hold'em No Limit ($0.10/$0.25) - 2018/12/29 3:54:08 UTC [2018/12/28 22:54:08 ET]
Table 'Hydra' 6-max Seat #1 is the button
Seat 1: golf7287 ($35.40 in chips) 
Seat 2: ttshead ($51.64 in chips) 
Seat 3: yobbos ($125.28 in chips) 
Seat 4: SantiagoWeight ($76.85 in chips) 
Seat 5: BIGPAIN14 ($44.15 in chips) 
Seat 6: _BluDeeN_ ($36.93 in chips) 
ttshead: posts small blind $0.10
yobbos: posts big blind $0.25
*** HOLE CARDS ***
Dealt to SantiagoWeight [Ts Ah]
SantiagoWeight: raises $0.42 to $0.67
BIGPAIN14: folds 
_BluDeeN_: raises $1.69 to $2.36
golf7287: folds 
ttshead: folds 
yobbos: folds 
SantiagoWeight: folds 
Uncalled bet ($1.69) returned to _BluDeeN_
_BluDeeN_ collected $1.69 from pot
*** SUMMARY ***
Total pot $1.69 | Rake $0 
Seat 1: golf7287 (button) folded before Flop (didn't bet)
Seat 2: ttshead (small blind) folded before Flop
Seat 3: yobbos (big blind) folded before Flop
Seat 4: SantiagoWeight folded before Flop
Seat 5: BIGPAIN14 folded before Flop (didn't bet)
Seat 6: _BluDeeN_ collected ($1.69)



PokerStars Zoom Hand #195023718166:  Hold'em No Limit ($0.10/$0.25) - 2018/12/29 3:54:45 UTC [2018/12/28 22:54:45 ET]
Table 'Hydra' 6-max Seat #1 is the button
Seat 1: anorectal ($25 in chips) 
Seat 2: nhanminhtri ($25 in chips) 
Seat 3: SantiagoWeight ($76.18 in chips) 
Seat 4: yobbos ($125.38 in chips) 
Seat 5: miru877 ($24.65 in chips) 
Seat 6: Pardaroxon ($48.85 in chips) 
nhanminhtri: posts small blind $0.10
SantiagoWeight: posts big blind $0.25
*** HOLE CARDS ***
Dealt to SantiagoWeight [7d Th]
yobbos: folds 
miru877: folds 
Pardaroxon: folds 
anorectal: folds 
nhanminhtri: folds 
Uncalled bet ($0.15) returned to SantiagoWeight
SantiagoWeight collected $0.20 from pot
SantiagoWeight: doesn't show hand 
*** SUMMARY ***
Total pot $0.20 | Rake $0 
Seat 1: anorectal (button) folded before Flop (didn't bet)
Seat 2: nhanminhtri (small blind) folded before Flop
Seat 3: SantiagoWeight (big blind) collected ($0.20)
Seat 4: yobbos folded before Flop (didn't bet)
Seat 5: miru877 folded before Flop (didn't bet)
Seat 6: Pardaroxon folded before Flop (didn't bet)



PokerStars Zoom Hand #195023721171:  Hold'em No Limit ($0.10/$0.25) - 2018/12/29 3:54:55 UTC [2018/12/28 22:54:55 ET]
Table 'Hydra' 6-max Seat #1 is the button
Seat 1: Fobos113 ($23.45 in chips) 
Seat 2: SantiagoWeight ($76.28 in chips) 
Seat 3: KingsOfEdm ($40.02 in chips) 
Seat 4: Lehared ($25.32 in chips) 
Seat 5: ryanking99 ($19.65 in chips) 
Seat 6: lovintalbi ($26.05 in chips) 
SantiagoWeight: posts small blind $0.10
KingsOfEdm: posts big blind $0.25
*** HOLE CARDS ***
Dealt to SantiagoWeight [7d Ad]
Lehared: folds 
ryanking99: folds 
lovintalbi: folds 
Fobos113: folds 
SantiagoWeight: raises $0.50 to $0.75
KingsOfEdm has timed out
KingsOfEdm: folds 
Uncalled bet ($0.50) returned to SantiagoWeight
SantiagoWeight collected $0.50 from pot
SantiagoWeight: doesn't show hand 
*** SUMMARY ***
Total pot $0.50 | Rake $0 
Seat 1: Fobos113 (button) folded before Flop (didn't bet)
Seat 2: SantiagoWeight (small blind) collected ($0.50)
Seat 3: KingsOfEdm (big blind) folded before Flop
Seat 4: Lehared folded before Flop (didn't bet)
Seat 5: ryanking99 folded before Flop (didn't bet)
Seat 6: lovintalbi folded before Flop (didn't bet)



PokerStars Zoom Hand #195023735762:  Hold'em No Limit ($0.10/$0.25) - 2018/12/29 3:55:48 UTC [2018/12/28 22:55:48 ET]
Table 'Hydra' 6-max Seat #1 is the button
Seat 1: SantiagoWeight ($76.53 in chips) 
Seat 2: zbuci ($22.09 in chips) 
Seat 3: yobbos ($45.12 in chips) 
Seat 4: Virus3232 ($25.34 in chips) 
Seat 5: Doomdigidoom ($28.23 in chips) 
Seat 6: aa1421b ($45.56 in chips) 
zbuci: posts small blind $0.10
yobbos: posts big blind $0.25
*** HOLE CARDS ***
Dealt to SantiagoWeight [Kd 5c]
Virus3232: folds 
Doomdigidoom: raises $0.25 to $0.50
aa1421b: folds 
SantiagoWeight: folds 
zbuci: folds 
yobbos: calls $0.25
*** FLOP *** [Ad As Th]
yobbos: checks 
Doomdigidoom: bets $0.75
yobbos: folds 
Uncalled bet ($0.75) returned to Doomdigidoom
Doomdigidoom collected $1.05 from pot
Doomdigidoom: doesn't show hand 
*** SUMMARY ***
Total pot $1.10 | Rake $0.05 
Board [Ad As Th]
Seat 1: SantiagoWeight (button) folded before Flop (didn't bet)
Seat 2: zbuci (small blind) folded before Flop
Seat 3: yobbos (big blind) folded on the Flop
Seat 4: Virus3232 folded before Flop (didn't bet)
Seat 5: Doomdigidoom collected ($1.05)
Seat 6: aa1421b folded before Flop (didn't bet)



PokerStars Zoom Hand #195023743297:  Hold'em No Limit ($0.10/$0.25) - 2018/12/29 3:56:16 UTC [2018/12/28 22:56:16 ET]
Table 'Hydra' 6-max Seat #1 is the button
Seat 1: dithflo ($16.90 in chips) 
Seat 2: SantiagoWeight ($76.53 in chips) 
Seat 3: nhanminhtri ($25 in chips) 
Seat 4: --LeGaaNs-- ($85.79 in chips) 
Seat 5: Guard poker ($25.48 in chips) 
Seat 6: Lehared ($25 in chips) 
SantiagoWeight: posts small blind $0.10
nhanminhtri: posts big blind $0.25
*** HOLE CARDS ***
Dealt to SantiagoWeight [Ks 6s]
--LeGaaNs--: folds 
Guard poker: folds 
Lehared: folds 
dithflo: folds 
SantiagoWeight: raises $0.50 to $0.75
nhanminhtri: folds 
Uncalled bet ($0.50) returned to SantiagoWeight
SantiagoWeight collected $0.50 from pot
SantiagoWeight: doesn't show hand 
*** SUMMARY ***
Total pot $0.50 | Rake $0 
Seat 1: dithflo (button) folded before Flop (didn't bet)
Seat 2: SantiagoWeight (small blind) collected ($0.50)
Seat 3: nhanminhtri (big blind) folded before Flop
Seat 4: --LeGaaNs-- folded before Flop (didn't bet)
Seat 5: Guard poker folded before Flop (didn't bet)
Seat 6: Lehared folded before Flop (didn't bet)



PokerStars Zoom Hand #195023738457:  Hold'em No Limit ($0.10/$0.25) - 2018/12/29 3:55:58 UTC [2018/12/28 22:55:58 ET]
Table 'Hydra' 6-max Seat #1 is the button
Seat 1: Guard poker ($25.48 in chips) 
Seat 2: osa126 ($68.52 in chips) 
Seat 3: mariopork ($41.03 in chips) 
Seat 4: bigm2261 ($13.25 in chips) 
Seat 5: lovintalbi ($66.30 in chips) 
Seat 6: SantiagoWeight ($76.53 in chips) 
osa126: posts small blind $0.10
mariopork: posts big blind $0.25
*** HOLE CARDS ***
Dealt to SantiagoWeight [4h Td]
bigm2261: folds 
lovintalbi: folds 
SantiagoWeight: folds 
Guard poker: folds 
osa126: raises $0.50 to $0.75
mariopork: calls $0.50
*** FLOP *** [5c 8d 5s]
osa126: checks 
mariopork: checks 
*** TURN *** [5c 8d 5s] [Jh]
osa126: checks 
mariopork: checks 
*** RIVER *** [5c 8d 5s Jh] [Qc]
osa126: checks 
mariopork: bets $0.80
osa126: folds 
Uncalled bet ($0.80) returned to mariopork
mariopork collected $1.43 from pot
mariopork: doesn't show hand 
*** SUMMARY ***
Total pot $1.50 | Rake $0.07 
Board [5c 8d 5s Jh Qc]
Seat 1: Guard poker (button) folded before Flop (didn't bet)
Seat 2: osa126 (small blind) folded on the River
Seat 3: mariopork (big blind) collected ($1.43)
Seat 4: bigm2261 folded before Flop (didn't bet)
Seat 5: lovintalbi folded before Flop (didn't bet)
Seat 6: SantiagoWeight folded before Flop (didn't bet)



PokerStars Zoom Hand #195023739541:  Hold'em No Limit ($0.10/$0.25) - 2018/12/29 3:56:02 UTC [2018/12/28 22:56:02 ET]
Table 'Hydra' 6-max Seat #1 is the button
Seat 1: Fishnoobking ($19.20 in chips) 
Seat 2: Bujan 07 ($31.57 in chips) 
Seat 3: alex3d1985 ($42.97 in chips) 
Seat 4: SantiagoWeight ($76.53 in chips) 
Seat 5: naxizzle ($115.54 in chips) 
Seat 6: aldoalb0207 ($80.27 in chips) 
Bujan 07: posts small blind $0.10
alex3d1985: posts big blind $0.25
*** HOLE CARDS ***
Dealt to SantiagoWeight [7h 8c]
SantiagoWeight: folds 
naxizzle: raises $0.85 to $1.10
aldoalb0207: calls $1.10
Fishnoobking: folds 
Bujan 07: folds 
alex3d1985: folds 
*** FLOP *** [3c 2h 4d]
naxizzle: bets $2
aldoalb0207: calls $2
*** TURN *** [3c 2h 4d] [5d]
naxizzle: bets $6.25
aldoalb0207: folds 
Uncalled bet ($6.25) returned to naxizzle
naxizzle collected $6.26 from pot
naxizzle: doesn't show hand 
*** SUMMARY ***
Total pot $6.55 | Rake $0.29 
Board [3c 2h 4d 5d]
Seat 1: Fishnoobking (button) folded before Flop (didn't bet)
Seat 2: Bujan 07 (small blind) folded before Flop
Seat 3: alex3d1985 (big blind) folded before Flop
Seat 4: SantiagoWeight folded before Flop (didn't bet)
Seat 5: naxizzle collected ($6.26)
Seat 6: aldoalb0207 folded on the Turn



PokerStars Zoom Hand #195023747762:  Hold'em No Limit ($0.10/$0.25) - 2018/12/29 3:56:32 UTC [2018/12/28 22:56:32 ET]
Table 'Hydra' 6-max Seat #1 is the button
Seat 1: denisss1801 ($19.04 in chips) 
Seat 2: TQNYMQNTANA ($25.37 in chips) 
Seat 3: SantiagoWeight ($76.78 in chips) 
Seat 4: ivann14 ($26.02 in chips) 
Seat 5: KeySssi ($25.65 in chips) 
Seat 6: river plate9 ($27.01 in chips) 
TQNYMQNTANA: posts small blind $0.10
SantiagoWeight: posts big blind $0.25
*** HOLE CARDS ***
Dealt to SantiagoWeight [3c 8s]
ivann14: raises $0.50 to $0.75
KeySssi: folds 
river plate9: folds 
denisss1801: folds 
TQNYMQNTANA: folds 
SantiagoWeight: folds 
Uncalled bet ($0.50) returned to ivann14
ivann14 collected $0.60 from pot
ivann14: doesn't show hand 
*** SUMMARY ***
Total pot $0.60 | Rake $0 
Seat 1: denisss1801 (button) folded before Flop (didn't bet)
Seat 2: TQNYMQNTANA (small blind) folded before Flop
Seat 3: SantiagoWeight (big blind) folded before Flop
Seat 4: ivann14 collected ($0.60)
Seat 5: KeySssi folded before Flop (didn't bet)
Seat 6: river plate9 folded before Flop (didn't bet)



PokerStars Zoom Hand #195023759617:  Hold'em No Limit ($0.10/$0.25) - 2018/12/29 3:57:16 UTC [2018/12/28 22:57:16 ET]
Table 'Hydra' 6-max Seat #1 is the button
Seat 1: bwim ($25.51 in chips) 
Seat 2: nadal335 ($28.93 in chips) 
Seat 3: Albratros2 ($35.75 in chips) 
Seat 4: Mrs_Squeeze ($19.87 in chips) 
Seat 5: SantiagoWeight ($76.53 in chips) 
Seat 6: Guard poker ($25.38 in chips) 
nadal335: posts small blind $0.10
Albratros2: posts big blind $0.25
*** HOLE CARDS ***
Dealt to SantiagoWeight [Th 3h]
Mrs_Squeeze: folds 
SantiagoWeight: folds 
Guard poker: folds 
bwim: raises $0.50 to $0.75
nadal335: folds 
Albratros2: calls $0.50
*** FLOP *** [9c Td 9h]
Albratros2: bets $0.25
bwim: folds 
Uncalled bet ($0.25) returned to Albratros2
Albratros2 collected $1.53 from pot
Albratros2: doesn't show hand 
*** SUMMARY ***
Total pot $1.60 | Rake $0.07 
Board [9c Td 9h]
Seat 1: bwim (button) folded on the Flop
Seat 2: nadal335 (small blind) folded before Flop
Seat 3: Albratros2 (big blind) collected ($1.53)
Seat 4: Mrs_Squeeze folded before Flop (didn't bet)
Seat 5: SantiagoWeight folded before Flop (didn't bet)
Seat 6: Guard poker folded before Flop (didn't bet)



PokerStars Zoom Hand #195023755900:  Hold'em No Limit ($0.10/$0.25) - 2018/12/29 3:57:02 UTC [2018/12/28 22:57:02 ET]
Table 'Hydra' 6-max Seat #1 is the button
Seat 1: SantiagoWeight ($76.53 in chips) 
Seat 2: ivann14 ($62.99 in chips) 
Seat 3: kiteboard26 ($30.95 in chips) 
Seat 4: _BluDeeN_ ($32.33 in chips) 
Seat 5: ineedmoeny ($19.43 in chips) 
Seat 6: osa126 ($68.12 in chips) 
ivann14: posts small blind $0.10
kiteboard26: posts big blind $0.25
*** HOLE CARDS ***
Dealt to SantiagoWeight [5h 8c]
_BluDeeN_: folds 
ineedmoeny: folds 
osa126: folds 
SantiagoWeight: folds 
ivann14: raises $0.50 to $0.75
kiteboard26: calls $0.50
*** FLOP *** [7d 9d Qd]
ivann14: checks 
kiteboard26: bets $1.43
ivann14: calls $1.43
*** TURN *** [7d 9d Qd] [8s]
ivann14: checks 
kiteboard26: checks 
*** RIVER *** [7d 9d Qd 8s] [Tc]
ivann14: checks 
kiteboard26: checks 
*** SHOW DOWN ***
ivann14: shows [6d 4d] (a flush, Queen high)
kiteboard26: mucks hand 
ivann14 collected $4.16 from pot
*** SUMMARY ***
Total pot $4.36 | Rake $0.20 
Board [7d 9d Qd 8s Tc]
Seat 1: SantiagoWeight (button) folded before Flop (didn't bet)
Seat 2: ivann14 (small blind) showed [6d 4d] and won ($4.16) with a flush, Queen high
Seat 3: kiteboard26 (big blind) mucked [Ts 2c]
Seat 4: _BluDeeN_ folded before Flop (didn't bet)
Seat 5: ineedmoeny folded before Flop (didn't bet)
Seat 6: osa126 folded before Flop (didn't bet)



PokerStars Zoom Hand #195023762598:  Hold'em No Limit ($0.10/$0.25) - 2018/12/29 3:57:27 UTC [2018/12/28 22:57:27 ET]
Table 'Hydra' 6-max Seat #1 is the button
Seat 1: nhanminhtri ($25.35 in chips) 
Seat 2: Party4Arthy ($61.53 in chips) 
Seat 3: onhoang87 ($27.03 in chips) 
Seat 4: SantiagoWeight ($76.53 in chips) 
Seat 5: HonourMan23 ($77.04 in chips) 
Seat 6: tagan7 ($22.03 in chips) 
Party4Arthy: posts small blind $0.10
onhoang87: posts big blind $0.25
*** HOLE CARDS ***
Dealt to SantiagoWeight [8h 9d]
SantiagoWeight: folds 
HonourMan23: folds 
tagan7: folds 
nhanminhtri: raises $0.37 to $0.62
Party4Arthy: folds 
onhoang87: folds 
Uncalled bet ($0.37) returned to nhanminhtri
nhanminhtri collected $0.60 from pot
nhanminhtri: doesn't show hand 
*** SUMMARY ***
Total pot $0.60 | Rake $0 
Seat 1: nhanminhtri (button) collected ($0.60)
Seat 2: Party4Arthy (small blind) folded before Flop
Seat 3: onhoang87 (big blind) folded before Flop
Seat 4: SantiagoWeight folded before Flop (didn't bet)
Seat 5: HonourMan23 folded before Flop (didn't bet)
Seat 6: tagan7 folded before Flop (didn't bet)



PokerStars Zoom Hand #195023765585:  Hold'em No Limit ($0.10/$0.25) - 2018/12/29 3:57:38 UTC [2018/12/28 22:57:38 ET]
Table 'Hydra' 6-max Seat #1 is the button
Seat 1: Fishnoobking ($19.56 in chips) 
Seat 2: CrazieFreddy ($12.74 in chips) 
Seat 3: nhanminhtri ($26.43 in chips) 
Seat 4: 666erkan ($18.53 in chips) 
Seat 5: SantiagoWeight ($76.53 in chips) 
Seat 6: Becks Baker ($25.35 in chips) 
CrazieFreddy: posts small blind $0.10
nhanminhtri: posts big blind $0.25
*** HOLE CARDS ***
Dealt to SantiagoWeight [3d Kd]
666erkan: folds 
SantiagoWeight has timed out
SantiagoWeight: folds 
Becks Baker: folds 
Fishnoobking: raises $0.50 to $0.75
CrazieFreddy: calls $0.65
nhanminhtri: folds 
*** FLOP *** [7c Jd 3h]
CrazieFreddy: checks 
Fishnoobking: bets $0.75
CrazieFreddy: calls $0.75
*** TURN *** [7c Jd 3h] [Qh]
CrazieFreddy: checks 
Fishnoobking: bets $2
CrazieFreddy: calls $2
*** RIVER *** [7c Jd 3h Qh] [5c]
CrazieFreddy: checks 
Fishnoobking: bets $16.06 and is all-in
CrazieFreddy: folds 
Uncalled bet ($16.06) returned to Fishnoobking
Fishnoobking collected $6.92 from pot
Fishnoobking: doesn't show hand 
*** SUMMARY ***
Total pot $7.25 | Rake $0.33 
Board [7c Jd 3h Qh 5c]
Seat 1: Fishnoobking (button) collected ($6.92)
Seat 2: CrazieFreddy (small blind) folded on the River
Seat 3: nhanminhtri (big blind) folded before Flop
Seat 4: 666erkan folded before Flop (didn't bet)
Seat 5: SantiagoWeight folded before Flop (didn't bet)
Seat 6: Becks Baker folded before Flop (didn't bet)



PokerStars Zoom Hand #195023776914:  Hold'em No Limit ($0.10/$0.25) - 2018/12/29 3:58:20 UTC [2018/12/28 22:58:20 ET]
Table 'Hydra' 6-max Seat #1 is the button
Seat 1: HonourMan23 ($76.69 in chips) 
Seat 2: SantiagoWeight ($76.53 in chips) 
Seat 3: Renner32 ($40.75 in chips) 
Seat 4: Bonen18 ($26.80 in chips) 
Seat 5: MileVoliD49 ($29.51 in chips) 
Seat 6: deaglepro ($72.54 in chips) 
SantiagoWeight: posts small blind $0.10
Renner32: posts big blind $0.25
*** HOLE CARDS ***
Dealt to SantiagoWeight [Th 3d]
Bonen18: folds 
MileVoliD49: folds 
deaglepro: raises $0.60 to $0.85
HonourMan23: folds 
SantiagoWeight: folds 
Renner32: folds 
Uncalled bet ($0.60) returned to deaglepro
deaglepro collected $0.60 from pot
deaglepro: doesn't show hand 
*** SUMMARY ***
Total pot $0.60 | Rake $0 
Seat 1: HonourMan23 (button) folded before Flop (didn't bet)
Seat 2: SantiagoWeight (small blind) folded before Flop
Seat 3: Renner32 (big blind) folded before Flop
Seat 4: Bonen18 folded before Flop (didn't bet)
Seat 5: MileVoliD49 folded before Flop (didn't bet)
Seat 6: deaglepro collected ($0.60)



PokerStars Zoom Hand #195023780176:  Hold'em No Limit ($0.10/$0.25) - 2018/12/29 3:58:32 UTC [2018/12/28 22:58:32 ET]
Table 'Hydra' 6-max Seat #1 is the button
Seat 1: CrazieFreddy ($9.74 in chips) 
Seat 2: zbuci ($22.09 in chips) 
Seat 3: Bonen18 ($33.97 in chips) 
Seat 4: river plate9 ($39.74 in chips) 
Seat 5: Guard poker ($25.10 in chips) 
Seat 6: SantiagoWeight ($76.43 in chips) 
zbuci: posts small blind $0.10
Bonen18: posts big blind $0.25
*** HOLE CARDS ***
Dealt to SantiagoWeight [Th Kc]
river plate9: folds 
Guard poker: folds 
SantiagoWeight: raises $0.30 to $0.55
CrazieFreddy: folds 
zbuci: folds 
Bonen18: folds 
Uncalled bet ($0.30) returned to SantiagoWeight
SantiagoWeight collected $0.60 from pot
SantiagoWeight: doesn't show hand 
*** SUMMARY ***
Total pot $0.60 | Rake $0 
Seat 1: CrazieFreddy (button) folded before Flop (didn't bet)
Seat 2: zbuci (small blind) folded before Flop
Seat 3: Bonen18 (big blind) folded before Flop
Seat 4: river plate9 folded before Flop (didn't bet)
Seat 5: Guard poker folded before Flop (didn't bet)
Seat 6: SantiagoWeight collected ($0.60)



PokerStars Zoom Hand #195023783658:  Hold'em No Limit ($0.10/$0.25) - 2018/12/29 3:58:45 UTC [2018/12/28 22:58:45 ET]
Table 'Hydra' 6-max Seat #1 is the button
Seat 1: Ovanes911 ($30.77 in chips) 
Seat 2: nhanminhtri ($25 in chips) 
Seat 3: SantiagoWeight ($76.78 in chips) 
Seat 4: gonih ($24.20 in chips) 
Seat 5: myrtasaTR ($36.72 in chips) 
Seat 6: ruiken ($31.65 in chips) 
nhanminhtri: posts small blind $0.10
SantiagoWeight: posts big blind $0.25
*** HOLE CARDS ***
Dealt to SantiagoWeight [Ah 2s]
gonih: folds 
myrtasaTR: folds 
ruiken: folds 
Ovanes911: folds 
nhanminhtri: folds 
Uncalled bet ($0.15) returned to SantiagoWeight
SantiagoWeight collected $0.20 from pot
SantiagoWeight: doesn't show hand 
*** SUMMARY ***
Total pot $0.20 | Rake $0 
Seat 1: Ovanes911 (button) folded before Flop (didn't bet)
Seat 2: nhanminhtri (small blind) folded before Flop
Seat 3: SantiagoWeight (big blind) collected ($0.20)
Seat 4: gonih folded before Flop (didn't bet)
Seat 5: myrtasaTR folded before Flop (didn't bet)
Seat 6: ruiken folded before Flop (didn't bet)



PokerStars Zoom Hand #195023786066:  Hold'em No Limit ($0.10/$0.25) - 2018/12/29 3:58:54 UTC [2018/12/28 22:58:54 ET]
Table 'Hydra' 6-max Seat #1 is the button
Seat 1: SantiagoWeight ($76.88 in chips) 
Seat 2: Bujan 07 ($35.42 in chips) 
Seat 3: DUDA3553 ($27.46 in chips) 
Seat 4: Virus3232 ($32.68 in chips) 
Seat 5: mariopork ($45.48 in chips) 
Seat 6: osa126 ($66.77 in chips) 
Bujan 07: posts small blind $0.10
DUDA3553: posts big blind $0.25
*** HOLE CARDS ***
Dealt to SantiagoWeight [8d 7c]
Virus3232: folds 
mariopork: folds 
osa126: folds 
SantiagoWeight: raises $0.30 to $0.55
Bujan 07: folds 
DUDA3553: folds 
Uncalled bet ($0.30) returned to SantiagoWeight
SantiagoWeight collected $0.60 from pot
SantiagoWeight: doesn't show hand 
*** SUMMARY ***
Total pot $0.60 | Rake $0 
Seat 1: SantiagoWeight (button) collected ($0.60)
Seat 2: Bujan 07 (small blind) folded before Flop
Seat 3: DUDA3553 (big blind) folded before Flop
Seat 4: Virus3232 folded before Flop (didn't bet)
Seat 5: mariopork folded before Flop (didn't bet)
Seat 6: osa126 folded before Flop (didn't bet)



PokerStars Zoom Hand #195023790008:  Hold'em No Limit ($0.10/$0.25) - 2018/12/29 3:59:09 UTC [2018/12/28 22:59:09 ET]
Table 'Hydra' 6-max Seat #1 is the button
Seat 1: Nutselas ($25 in chips) 
Seat 2: Lehared ($25 in chips) 
Seat 3: LLiarrr ($27.66 in chips) 
Seat 4: Fishnoobking ($21.99 in chips) 
Seat 5: SantiagoWeight ($77.23 in chips) 
Seat 6: GrandmasterY ($50.92 in chips) 
Lehared: posts small blind $0.10
LLiarrr: posts big blind $0.25
*** HOLE CARDS ***
Dealt to SantiagoWeight [4s 3d]
Fishnoobking: folds 
SantiagoWeight: folds 
GrandmasterY: folds 
Nutselas: folds 
Lehared: raises $0.50 to $0.75
LLiarrr: raises $1.50 to $2.25
Lehared: folds 
Uncalled bet ($1.50) returned to LLiarrr
LLiarrr collected $1.50 from pot
LLiarrr: doesn't show hand 
*** SUMMARY ***
Total pot $1.50 | Rake $0 
Seat 1: Nutselas (button) folded before Flop (didn't bet)
Seat 2: Lehared (small blind) folded before Flop
Seat 3: LLiarrr (big blind) collected ($1.50)
Seat 4: Fishnoobking folded before Flop (didn't bet)
Seat 5: SantiagoWeight folded before Flop (didn't bet)
Seat 6: GrandmasterY folded before Flop (didn't bet)



PokerStars Zoom Hand #195023792164:  Hold'em No Limit ($0.10/$0.25) - 2018/12/29 3:59:17 UTC [2018/12/28 22:59:17 ET]
Table 'Hydra' 6-max Seat #1 is the button
Seat 1: Mrs_Squeeze ($18.82 in chips) 
Seat 2: bigm2261 ($15.43 in chips) 
Seat 3: Nutselas ($34.44 in chips) 
Seat 4: tariko1980 ($32 in chips) 
Seat 5: moderi ($23.39 in chips) 
Seat 6: SantiagoWeight ($77.23 in chips) 
bigm2261: posts small blind $0.10
Nutselas: posts big blind $0.25
*** HOLE CARDS ***
Dealt to SantiagoWeight [Qh 8d]
tariko1980: calls $0.25
moderi: calls $0.25
SantiagoWeight: folds 
Mrs_Squeeze: folds 
bigm2261: folds 
Nutselas: checks 
*** FLOP *** [5d 4d Td]
Nutselas: checks 
tariko1980: checks 
moderi: checks 
*** TURN *** [5d 4d Td] [5h]
Nutselas: bets $1.75
tariko1980: folds 
moderi: folds 
Uncalled bet ($1.75) returned to Nutselas
Nutselas collected $0.81 from pot
Nutselas: doesn't show hand 
*** SUMMARY ***
Total pot $0.85 | Rake $0.04 
Board [5d 4d Td 5h]
Seat 1: Mrs_Squeeze (button) folded before Flop (didn't bet)
Seat 2: bigm2261 (small blind) folded before Flop
Seat 3: Nutselas (big blind) collected ($0.81)
Seat 4: tariko1980 folded on the Turn
Seat 5: moderi folded on the Turn
Seat 6: SantiagoWeight folded before Flop (didn't bet)



PokerStars Zoom Hand #195023797999:  Hold'em No Limit ($0.10/$0.25) - 2018/12/29 3:59:39 UTC [2018/12/28 22:59:39 ET]
Table 'Hydra' 6-max Seat #1 is the button
Seat 1: SantiagoWeight ($77.13 in chips) 
Seat 2: ssrace ($39.32 in chips) 
Seat 3: Lehared ($25 in chips) 
Seat 4: KeySssi ($25.31 in chips) 
Seat 5: gustavotaina ($5.12 in chips) 
Seat 6: ColinCaine ($17.45 in chips) 
ssrace: posts small blind $0.10
Lehared: posts big blind $0.25
*** HOLE CARDS ***
Dealt to SantiagoWeight [4s 3c]
KeySssi: raises $0.50 to $0.75
gustavotaina: folds 
ColinCaine: folds 
SantiagoWeight: folds 
ssrace: folds 
Lehared: folds 
Uncalled bet ($0.50) returned to KeySssi
KeySssi collected $0.60 from pot
KeySssi: doesn't show hand 
*** SUMMARY ***
Total pot $0.60 | Rake $0 
Seat 1: SantiagoWeight (button) folded before Flop (didn't bet)
Seat 2: ssrace (small blind) folded before Flop
Seat 3: Lehared (big blind) folded before Flop
Seat 4: KeySssi collected ($0.60)
Seat 5: gustavotaina folded before Flop (didn't bet)
Seat 6: ColinCaine folded before Flop (didn't bet)



PokerStars Zoom Hand #195023794013:  Hold'em No Limit ($0.10/$0.25) - 2018/12/29 3:59:24 UTC [2018/12/28 22:59:24 ET]
Table 'Hydra' 6-max Seat #1 is the button
Seat 1: pkr_miracle ($19.96 in chips) 
Seat 2: SantiagoWeight ($77.23 in chips) 
Seat 3: gonih ($23.75 in chips) 
Seat 4: 666erkan ($18.61 in chips) 
Seat 5: KeySssi ($25.31 in chips) 
Seat 6: BIGPAIN14 ($21.11 in chips) 
SantiagoWeight: posts small blind $0.10
gonih: posts big blind $0.25
*** HOLE CARDS ***
Dealt to SantiagoWeight [7s Ks]
666erkan: folds 
KeySssi: folds 
BIGPAIN14: folds 
pkr_miracle: raises $0.75 to $1
SantiagoWeight: folds 
gonih: calls $0.75
*** FLOP *** [Jd Qc Td]
gonih: checks 
pkr_miracle: bets $1.01
gonih: calls $1.01
*** TURN *** [Jd Qc Td] [Tc]
gonih: checks 
pkr_miracle: checks 
*** RIVER *** [Jd Qc Td Tc] [Ah]
gonih: bets $0.25
pkr_miracle: calls $0.25
*** SHOW DOWN ***
gonih: shows [Kh Qh] (a straight, Ten to Ace)
pkr_miracle: mucks hand 
gonih collected $4.41 from pot
*** SUMMARY ***
Total pot $4.62 | Rake $0.21 
Board [Jd Qc Td Tc Ah]
Seat 1: pkr_miracle (button) mucked [2s Ac]
Seat 2: SantiagoWeight (small blind) folded before Flop
Seat 3: gonih (big blind) showed [Kh Qh] and won ($4.41) with a straight, Ten to Ace
Seat 4: 666erkan folded before Flop (didn't bet)
Seat 5: KeySssi folded before Flop (didn't bet)
Seat 6: BIGPAIN14 folded before Flop (didn't bet)



PokerStars Zoom Hand #195023801511:  Hold'em No Limit ($0.10/$0.25) - 2018/12/29 3:59:52 UTC [2018/12/28 22:59:52 ET]
Table 'Hydra' 6-max Seat #1 is the button
Seat 1: cwreinbold ($25.13 in chips) 
Seat 2: river plate9 ($36.89 in chips) 
Seat 3: SantiagoWeight ($77.13 in chips) 
Seat 4: Lehared ($25 in chips) 
Seat 5: Pardaroxon ($46.19 in chips) 
Seat 6: CrazieFreddy ($10.66 in chips) 
river plate9: posts small blind $0.10
SantiagoWeight: posts big blind $0.25
*** HOLE CARDS ***
Dealt to SantiagoWeight [As Ks]
Lehared: raises $0.37 to $0.62
Pardaroxon: folds 
CrazieFreddy: folds 
cwreinbold: folds 
river plate9: folds 
SantiagoWeight: raises $1.98 to $2.60
Lehared: folds 
Uncalled bet ($1.98) returned to SantiagoWeight
SantiagoWeight collected $1.34 from pot
SantiagoWeight: doesn't show hand 
*** SUMMARY ***
Total pot $1.34 | Rake $0 
Seat 1: cwreinbold (button) folded before Flop (didn't bet)
Seat 2: river plate9 (small blind) folded before Flop
Seat 3: SantiagoWeight (big blind) collected ($1.34)
Seat 4: Lehared folded before Flop
Seat 5: Pardaroxon folded before Flop (didn't bet)
Seat 6: CrazieFreddy folded before Flop (didn't bet)



PokerStars Zoom Hand #195023808025:  Hold'em No Limit ($0.10/$0.25) - 2018/12/29 4:00:16 UTC [2018/12/28 23:00:16 ET]
Table 'Hydra' 6-max Seat #1 is the button
Seat 1: gonih ($25.90 in chips) 
Seat 2: DUDA3553 ($27.56 in chips) 
Seat 3: BRSOB79 ($27.61 in chips) 
Seat 4: SantiagoWeight ($77.85 in chips) 
Seat 5: Ovanes911 ($27.37 in chips) 
Seat 6: Becks Baker ($25.09 in chips) 
DUDA3553: posts small blind $0.10
BRSOB79: posts big blind $0.25
*** HOLE CARDS ***
Dealt to SantiagoWeight [Kc Qd]
SantiagoWeight: raises $0.42 to $0.67
Ovanes911: folds 
Becks Baker: folds 
gonih: folds 
DUDA3553: folds 
BRSOB79: folds 
Uncalled bet ($0.42) returned to SantiagoWeight
SantiagoWeight collected $0.60 from pot
SantiagoWeight: doesn't show hand 
*** SUMMARY ***
Total pot $0.60 | Rake $0 
Seat 1: gonih (button) folded before Flop (didn't bet)
Seat 2: DUDA3553 (small blind) folded before Flop
Seat 3: BRSOB79 (big blind) folded before Flop
Seat 4: SantiagoWeight collected ($0.60)
Seat 5: Ovanes911 folded before Flop (didn't bet)
Seat 6: Becks Baker folded before Flop (didn't bet)



PokerStars Zoom Hand #195023810729:  Hold'em No Limit ($0.10/$0.25) - 2018/12/29 4:00:26 UTC [2018/12/28 23:00:26 ET]
Table 'Hydra' 6-max Seat #1 is the button
Seat 1: zbuci ($20.58 in chips) 
Seat 2: Nutselas ($29.22 in chips) 
Seat 3: MileVoliD49 ($33.84 in chips) 
Seat 4: GrandmasterY ($37.97 in chips) 
Seat 5: SantiagoWeight ($78.20 in chips) 
Seat 6: graysonai ($36.81 in chips) 
Nutselas: posts small blind $0.10
MileVoliD49: posts big blind $0.25
*** HOLE CARDS ***
Dealt to SantiagoWeight [Ac 8h]
GrandmasterY: folds 
SantiagoWeight: folds 
graysonai: folds 
zbuci: folds 
Nutselas: folds 
Uncalled bet ($0.15) returned to MileVoliD49
MileVoliD49 collected $0.20 from pot
MileVoliD49: doesn't show hand 
*** SUMMARY ***
Total pot $0.20 | Rake $0 
Seat 1: zbuci (button) folded before Flop (didn't bet)
Seat 2: Nutselas (small blind) folded before Flop
Seat 3: MileVoliD49 (big blind) collected ($0.20)
Seat 4: GrandmasterY folded before Flop (didn't bet)
Seat 5: SantiagoWeight folded before Flop (didn't bet)
Seat 6: graysonai folded before Flop (didn't bet)



PokerStars Zoom Hand #195023812358:  Hold'em No Limit ($0.10/$0.25) - 2018/12/29 4:00:32 UTC [2018/12/28 23:00:32 ET]
Table 'Hydra' 6-max Seat #1 is the button
Seat 1: clashwizard23 ($29.27 in chips) 
Seat 2: Lehared ($25 in chips) 
Seat 3: TQNYMQNTANA ($25 in chips) 
Seat 4: SantiagoWeight ($78.20 in chips) 
Seat 5: naxizzle ($119.33 in chips) 
Seat 6: KeySssi ($25.98 in chips) 
Lehared: posts small blind $0.10
TQNYMQNTANA: posts big blind $0.25
*** HOLE CARDS ***
Dealt to SantiagoWeight [Kh 4d]
SantiagoWeight: folds 
naxizzle: folds 
KeySssi: folds 
clashwizard23: raises $0.50 to $0.75
Lehared: raises $1.75 to $2.50
TQNYMQNTANA: folds 
clashwizard23: folds 
Uncalled bet ($1.75) returned to Lehared
Lehared collected $1.75 from pot
Lehared: doesn't show hand 
*** SUMMARY ***
Total pot $1.75 | Rake $0 
Seat 1: clashwizard23 (button) folded before Flop
Seat 2: Lehared (small blind) collected ($1.75)
Seat 3: TQNYMQNTANA (big blind) folded before Flop
Seat 4: SantiagoWeight folded before Flop (didn't bet)
Seat 5: naxizzle folded before Flop (didn't bet)
Seat 6: KeySssi folded before Flop (didn't bet)



PokerStars Zoom Hand #195023815249:  Hold'em No Limit ($0.10/$0.25) - 2018/12/29 4:00:42 UTC [2018/12/28 23:00:42 ET]
Table 'Hydra' 6-max Seat #1 is the button
Seat 1: qing328 ($23.95 in chips) 
Seat 2: ol_2face ($22.70 in chips) 
Seat 3: ColinCaine ($14.95 in chips) 
Seat 4: SantiagoWeight ($78.20 in chips) 
Seat 5: dan_iasi ($43.59 in chips) 
Seat 6: Fobos113 ($24.65 in chips) 
ol_2face: posts small blind $0.10
ColinCaine: posts big blind $0.25
*** HOLE CARDS ***
Dealt to SantiagoWeight [7d 8d]
SantiagoWeight: raises $0.42 to $0.67
dan_iasi: folds 
Fobos113: folds 
qing328: folds 
ol_2face: folds 
ColinCaine: calls $0.42
*** FLOP *** [Jd 9s 2c]
ColinCaine: checks 
SantiagoWeight: bets $0.92
ColinCaine: folds 
Uncalled bet ($0.92) returned to SantiagoWeight
SantiagoWeight collected $1.38 from pot
SantiagoWeight: doesn't show hand 
*** SUMMARY ***
Total pot $1.44 | Rake $0.06 
Board [Jd 9s 2c]
Seat 1: qing328 (button) folded before Flop (didn't bet)
Seat 2: ol_2face (small blind) folded before Flop
Seat 3: ColinCaine (big blind) folded on the Flop
Seat 4: SantiagoWeight collected ($1.38)
Seat 5: dan_iasi folded before Flop (didn't bet)
Seat 6: Fobos113 folded before Flop (didn't bet)



PokerStars Zoom Hand #195023824562:  Hold'em No Limit ($0.10/$0.25) - 2018/12/29 4:01:14 UTC [2018/12/28 23:01:14 ET]
Table 'Hydra' 6-max Seat #1 is the button
Seat 1: BRSOB79 ($27.26 in chips) 
Seat 2: SantiagoWeight ($78.91 in chips) 
Seat 3: nhanminhtri ($25.36 in chips) 
Seat 4: pirosiky ($25 in chips) 
Seat 5: HansMSM ($55.42 in chips) 
Seat 6: ineedmoeny ($44.08 in chips) 
SantiagoWeight: posts small blind $0.10
nhanminhtri: posts big blind $0.25
*** HOLE CARDS ***
Dealt to SantiagoWeight [6s 9s]
pirosiky: folds 
HansMSM: raises $0.45 to $0.70
ineedmoeny: folds 
BRSOB79: folds 
SantiagoWeight: folds 
nhanminhtri: folds 
Uncalled bet ($0.45) returned to HansMSM
HansMSM collected $0.60 from pot
HansMSM: doesn't show hand 
*** SUMMARY ***
Total pot $0.60 | Rake $0 
Seat 1: BRSOB79 (button) folded before Flop (didn't bet)
Seat 2: SantiagoWeight (small blind) folded before Flop
Seat 3: nhanminhtri (big blind) folded before Flop
Seat 4: pirosiky folded before Flop (didn't bet)
Seat 5: HansMSM collected ($0.60)
Seat 6: ineedmoeny folded before Flop (didn't bet)



PokerStars Zoom Hand #195023832236:  Hold'em No Limit ($0.10/$0.25) - 2018/12/29 4:01:40 UTC [2018/12/28 23:01:40 ET]
Table 'Hydra' 6-max Seat #1 is the button
Seat 1: SantiagoWeight ($78.81 in chips) 
Seat 2: simy96704 ($16.68 in chips) 
Seat 3: TQNYMQNTANA ($26.63 in chips) 
Seat 4: reggiedogg31 ($90.67 in chips) 
Seat 5: xman141 ($35.72 in chips) 
Seat 6: nadal335 ($31.10 in chips) 
simy96704: posts small blind $0.10
TQNYMQNTANA: posts big blind $0.25
*** HOLE CARDS ***
Dealt to SantiagoWeight [6h 5c]
reggiedogg31: folds 
xman141: raises $0.25 to $0.50
nadal335: raises $0.75 to $1.25
SantiagoWeight: folds 
simy96704: calls $1.15
TQNYMQNTANA: folds 
xman141: calls $0.75
*** FLOP *** [Th 9h 6s]
simy96704: checks 
xman141: checks 
nadal335: checks 
*** TURN *** [Th 9h 6s] [8c]
simy96704: checks 
xman141: bets $2.75
nadal335: raises $5.25 to $8
simy96704: folds 
xman141: folds 
Uncalled bet ($5.25) returned to nadal335
nadal335 collected $9.07 from pot
nadal335: doesn't show hand 
*** SUMMARY ***
Total pot $9.50 | Rake $0.43 
Board [Th 9h 6s 8c]
Seat 1: SantiagoWeight (button) folded before Flop (didn't bet)
Seat 2: simy96704 (small blind) folded on the Turn
Seat 3: TQNYMQNTANA (big blind) folded before Flop
Seat 4: reggiedogg31 folded before Flop (didn't bet)
Seat 5: xman141 folded on the Turn
Seat 6: nadal335 collected ($9.07)



PokerStars Zoom Hand #195023834539:  Hold'em No Limit ($0.10/$0.25) - 2018/12/29 4:01:48 UTC [2018/12/28 23:01:48 ET]
Table 'Hydra' 6-max Seat #1 is the button
Seat 1: nhanminhtri ($25.01 in chips) 
Seat 2: ruiken ($39.65 in chips) 
Seat 3: SantiagoWeight ($78.81 in chips) 
Seat 4: dan_iasi ($25.25 in chips) 
Seat 5: river plate9 ($56.83 in chips) 
Seat 6: vigos king ($51.89 in chips) 
ruiken: posts small blind $0.10
SantiagoWeight: posts big blind $0.25
*** HOLE CARDS ***
Dealt to SantiagoWeight [As 2s]
dan_iasi: folds 
river plate9: folds 
vigos king: raises $0.37 to $0.62
nhanminhtri: folds 
ruiken: folds 
SantiagoWeight: calls $0.37
*** FLOP *** [Ts Ac Jc]
SantiagoWeight: checks 
vigos king: bets $0.95
SantiagoWeight: calls $0.95
*** TURN *** [Ts Ac Jc] [Th]
SantiagoWeight: checks 
vigos king: bets $1.42
SantiagoWeight: calls $1.42
*** RIVER *** [Ts Ac Jc Th] [6d]
SantiagoWeight: checks 
vigos king: checks 
*** SHOW DOWN ***
SantiagoWeight: shows [As 2s] (two pair, Aces and Tens)
vigos king: mucks hand 
SantiagoWeight collected $5.81 from pot
*** SUMMARY ***
Total pot $6.08 | Rake $0.27 
Board [Ts Ac Jc Th 6d]
Seat 1: nhanminhtri (button) folded before Flop (didn't bet)
Seat 2: ruiken (small blind) folded before Flop
Seat 3: SantiagoWeight (big blind) showed [As 2s] and won ($5.81) with two pair, Aces and Tens
Seat 4: dan_iasi folded before Flop (didn't bet)
Seat 5: river plate9 folded before Flop (didn't bet)
Seat 6: vigos king mucked [3h 3s]



PokerStars Zoom Hand #195023857147:  Hold'em No Limit ($0.10/$0.25) - 2018/12/29 4:03:05 UTC [2018/12/28 23:03:05 ET]
Table 'Hydra' 6-max Seat #1 is the button
Seat 1: myrtasaTR ($30.32 in chips) 
Seat 2: SantiagoWeight ($81.63 in chips) 
Seat 3: zdenekstavic ($42.10 in chips) 
Seat 4: Chrimmpam ($14.86 in chips) 
Seat 5: vigos king ($48.90 in chips) 
Seat 6: dan_iasi ($44.46 in chips) 
SantiagoWeight: posts small blind $0.10
zdenekstavic: posts big blind $0.25
*** HOLE CARDS ***
Dealt to SantiagoWeight [5d Qd]
Chrimmpam: raises $0.60 to $0.85
vigos king: folds 
dan_iasi: folds 
myrtasaTR: folds 
SantiagoWeight: folds 
zdenekstavic: calls $0.60
*** FLOP *** [Ts 6d 4d]
zdenekstavic: checks 
Chrimmpam: bets $1.75
zdenekstavic: folds 
Uncalled bet ($1.75) returned to Chrimmpam
Chrimmpam collected $1.72 from pot
Chrimmpam: doesn't show hand 
*** SUMMARY ***
Total pot $1.80 | Rake $0.08 
Board [Ts 6d 4d]
Seat 1: myrtasaTR (button) folded before Flop (didn't bet)
Seat 2: SantiagoWeight (small blind) folded before Flop
Seat 3: zdenekstavic (big blind) folded on the Flop
Seat 4: Chrimmpam collected ($1.72)
Seat 5: vigos king folded before Flop (didn't bet)
Seat 6: dan_iasi folded before Flop (didn't bet)



PokerStars Zoom Hand #195023865462:  Hold'em No Limit ($0.10/$0.25) - 2018/12/29 4:03:33 UTC [2018/12/28 23:03:33 ET]
Table 'Hydra' 6-max Seat #1 is the button
Seat 1: Lehared ($25 in chips) 
Seat 2: TQNYMQNTANA ($25.38 in chips) 
Seat 3: _BluDeeN_ ($59.98 in chips) 
Seat 4: GrandmasterY ($58.92 in chips) 
Seat 5: reademenweep ($20.14 in chips) 
Seat 6: SantiagoWeight ($81.53 in chips) 
TQNYMQNTANA: posts small blind $0.10
_BluDeeN_: posts big blind $0.25
*** HOLE CARDS ***
Dealt to SantiagoWeight [9d 6d]
GrandmasterY: folds 
reademenweep: folds 
SantiagoWeight: folds 
Lehared: folds 
TQNYMQNTANA: folds 
Uncalled bet ($0.15) returned to _BluDeeN_
_BluDeeN_ collected $0.20 from pot
_BluDeeN_: doesn't show hand 
*** SUMMARY ***
Total pot $0.20 | Rake $0 
Seat 1: Lehared (button) folded before Flop (didn't bet)
Seat 2: TQNYMQNTANA (small blind) folded before Flop
Seat 3: _BluDeeN_ (big blind) collected ($0.20)
Seat 4: GrandmasterY folded before Flop (didn't bet)
Seat 5: reademenweep folded before Flop (didn't bet)
Seat 6: SantiagoWeight folded before Flop (didn't bet)



PokerStars Zoom Hand #195023873238:  Hold'em No Limit ($0.10/$0.25) - 2018/12/29 4:03:59 UTC [2018/12/28 23:03:59 ET]
Table 'Hydra' 6-max Seat #1 is the button
Seat 1: 777jsmith ($16.50 in chips) 
Seat 2: mariopork ($27.37 in chips) 
Seat 3: SantiagoWeight ($81.53 in chips) 
Seat 4: qing328 ($27.09 in chips) 
Seat 5: dan_iasi ($52.15 in chips) 
Seat 6: mojsza1 ($16.35 in chips) 
mariopork: posts small blind $0.10
SantiagoWeight: posts big blind $0.25
*** HOLE CARDS ***
Dealt to SantiagoWeight [Td Ah]
qing328: folds 
dan_iasi: folds 
mojsza1 has timed out
mojsza1: folds 
777jsmith: folds 
mariopork: folds 
Uncalled bet ($0.15) returned to SantiagoWeight
SantiagoWeight collected $0.20 from pot
SantiagoWeight: doesn't show hand 
*** SUMMARY ***
Total pot $0.20 | Rake $0 
Seat 1: 777jsmith (button) folded before Flop (didn't bet)
Seat 2: mariopork (small blind) folded before Flop
Seat 3: SantiagoWeight (big blind) collected ($0.20)
Seat 4: qing328 folded before Flop (didn't bet)
Seat 5: dan_iasi folded before Flop (didn't bet)
Seat 6: mojsza1 folded before Flop (didn't bet)



PokerStars Zoom Hand #195023861039:  Hold'em No Limit ($0.10/$0.25) - 2018/12/29 4:03:18 UTC [2018/12/28 23:03:18 ET]
Table 'Hydra' 6-max Seat #1 is the button
Seat 1: RESTRICTED.CR17 ($25.93 in chips) 
Seat 2: DUDA3553 ($27 in chips) 
Seat 3: Elapostador33 ($47.72 in chips) 
Seat 4: qing328 ($23.15 in chips) 
Seat 5: miru877 ($27.88 in chips) 
Seat 6: SantiagoWeight ($81.53 in chips) 
DUDA3553: posts small blind $0.10
Elapostador33: posts big blind $0.25
*** HOLE CARDS ***
Dealt to SantiagoWeight [7h Tc]
qing328: folds 
miru877: raises $0.50 to $0.75
SantiagoWeight: folds 
RESTRICTED.CR17: folds 
DUDA3553: folds 
Elapostador33 has timed out
Elapostador33: folds 
Uncalled bet ($0.50) returned to miru877
miru877 collected $0.60 from pot
miru877: doesn't show hand 
*** SUMMARY ***
Total pot $0.60 | Rake $0 
Seat 1: RESTRICTED.CR17 (button) folded before Flop (didn't bet)
Seat 2: DUDA3553 (small blind) folded before Flop
Seat 3: Elapostador33 (big blind) folded before Flop
Seat 4: qing328 folded before Flop (didn't bet)
Seat 5: miru877 collected ($0.60)
Seat 6: SantiagoWeight folded before Flop (didn't bet)



PokerStars Zoom Hand #195023881880:  Hold'em No Limit ($0.10/$0.25) - 2018/12/29 4:04:28 UTC [2018/12/28 23:04:28 ET]
Table 'Hydra' 6-max Seat #1 is the button
Seat 1: Pardaroxon ($46.61 in chips) 
Seat 2: 666erkan ($13.21 in chips) 
Seat 3: winwinboy ($25.61 in chips) 
Seat 4: Dbakunwaves ($49.44 in chips) 
Seat 5: davidhw888 ($33.62 in chips) 
Seat 6: SantiagoWeight ($81.63 in chips) 
666erkan: posts small blind $0.10
winwinboy: posts big blind $0.25
*** HOLE CARDS ***
Dealt to SantiagoWeight [4c 7d]
Dbakunwaves: raises $1 to $1.25
davidhw888: folds 
SantiagoWeight: folds 
Pardaroxon: folds 
666erkan: calls $1.15
winwinboy: folds 
*** FLOP *** [Ah 2c 6h]
666erkan: checks 
Dbakunwaves: checks 
*** TURN *** [Ah 2c 6h] [4h]
666erkan: checks 
Dbakunwaves: bets $1.75
666erkan: folds 
Uncalled bet ($1.75) returned to Dbakunwaves
Dbakunwaves collected $2.63 from pot
Dbakunwaves: doesn't show hand 
*** SUMMARY ***
Total pot $2.75 | Rake $0.12 
Board [Ah 2c 6h 4h]
Seat 1: Pardaroxon (button) folded before Flop (didn't bet)
Seat 2: 666erkan (small blind) folded on the Turn
Seat 3: winwinboy (big blind) folded before Flop
Seat 4: Dbakunwaves collected ($2.63)
Seat 5: davidhw888 folded before Flop (didn't bet)
Seat 6: SantiagoWeight folded before Flop (didn't bet)



PokerStars Zoom Hand #195023888351:  Hold'em No Limit ($0.10/$0.25) - 2018/12/29 4:04:50 UTC [2018/12/28 23:04:50 ET]
Table 'Hydra' 6-max Seat #1 is the button
Seat 1: onhoang87 ($22.02 in chips) 
Seat 2: ineedmoeny ($45.53 in chips) 
Seat 3: dawwwid70 ($25 in chips) 
Seat 4: Renner32 ($38.87 in chips) 
Seat 5: SantiagoWeight ($81.63 in chips) 
Seat 6: osa126 ($64.80 in chips) 
ineedmoeny: posts small blind $0.10
dawwwid70: posts big blind $0.25
*** HOLE CARDS ***
Dealt to SantiagoWeight [9c 9s]
Renner32: folds 
SantiagoWeight: raises $0.37 to $0.62
osa126: folds 
onhoang87: folds 
ineedmoeny: folds 
dawwwid70: calls $0.37
*** FLOP *** [Qc 4c 4s]
dawwwid70: checks 
SantiagoWeight: bets $0.32
dawwwid70: folds 
Uncalled bet ($0.32) returned to SantiagoWeight
SantiagoWeight collected $1.28 from pot
SantiagoWeight: doesn't show hand 
*** SUMMARY ***
Total pot $1.34 | Rake $0.06 
Board [Qc 4c 4s]
Seat 1: onhoang87 (button) folded before Flop (didn't bet)
Seat 2: ineedmoeny (small blind) folded before Flop
Seat 3: dawwwid70 (big blind) folded on the Flop
Seat 4: Renner32 folded before Flop (didn't bet)
Seat 5: SantiagoWeight collected ($1.28)
Seat 6: osa126 folded before Flop (didn't bet)



PokerStars Zoom Hand #195023896530:  Hold'em No Limit ($0.10/$0.25) - 2018/12/29 4:05:17 UTC [2018/12/28 23:05:17 ET]
Table 'Hydra' 6-max Seat #1 is the button
Seat 1: SantiagoWeight ($82.29 in chips) 
Seat 2: franco373513 ($17.54 in chips) 
Seat 3: nhanminhtri ($28.25 in chips) 
Seat 4: graysonai ($25 in chips) 
Seat 5: mililser ($24.65 in chips) 
Seat 6: Virus3232 ($28.06 in chips) 
franco373513: posts small blind $0.10
nhanminhtri: posts big blind $0.25
*** HOLE CARDS ***
Dealt to SantiagoWeight [Ah 8s]
graysonai: folds 
mililser: folds 
Virus3232: folds 
SantiagoWeight: raises $0.30 to $0.55
franco373513: calls $0.45
nhanminhtri: folds 
*** FLOP *** [Jd 2h 4s]
franco373513: checks 
SantiagoWeight: bets $0.32
franco373513: calls $0.32
*** TURN *** [Jd 2h 4s] [6s]
franco373513: checks 
SantiagoWeight: checks 
*** RIVER *** [Jd 2h 4s 6s] [Js]
franco373513: checks 
SantiagoWeight: checks 
*** SHOW DOWN ***
franco373513: shows [Ad 9c] (a pair of Jacks)
SantiagoWeight: mucks hand 
franco373513 collected $1.90 from pot
*** SUMMARY ***
Total pot $1.99 | Rake $0.09 
Board [Jd 2h 4s 6s Js]
Seat 1: SantiagoWeight (button) mucked [Ah 8s]
Seat 2: franco373513 (small blind) showed [Ad 9c] and won ($1.90) with a pair of Jacks
Seat 3: nhanminhtri (big blind) folded before Flop
Seat 4: graysonai folded before Flop (didn't bet)
Seat 5: mililser folded before Flop (didn't bet)
Seat 6: Virus3232 folded before Flop (didn't bet)



PokerStars Zoom Hand #195023913314:  Hold'em No Limit ($0.10/$0.25) - 2018/12/29 4:06:14 UTC [2018/12/28 23:06:14 ET]
Table 'Hydra' 6-max Seat #1 is the button
Seat 1: franco373513 ($18.57 in chips) 
Seat 2: SantiagoWeight ($81.42 in chips) 
Seat 3: kakashi_zion ($20.33 in chips) 
Seat 4: mariopork ($47.60 in chips) 
Seat 5: ivann14 ($25 in chips) 
Seat 6: abbi555 ($36.27 in chips) 
SantiagoWeight: posts small blind $0.10
kakashi_zion: posts big blind $0.25
*** HOLE CARDS ***
Dealt to SantiagoWeight [2h Kh]
mariopork: folds 
ivann14: folds 
abbi555: folds 
franco373513: folds 
SantiagoWeight: raises $0.50 to $0.75
kakashi_zion: calls $0.50
*** FLOP *** [Ac 6h Qh]
SantiagoWeight: bets $0.36
kakashi_zion: folds 
Uncalled bet ($0.36) returned to SantiagoWeight
SantiagoWeight collected $1.43 from pot
SantiagoWeight: doesn't show hand 
*** SUMMARY ***
Total pot $1.50 | Rake $0.07 
Board [Ac 6h Qh]
Seat 1: franco373513 (button) folded before Flop (didn't bet)
Seat 2: SantiagoWeight (small blind) collected ($1.43)
Seat 3: kakashi_zion (big blind) folded on the Flop
Seat 4: mariopork folded before Flop (didn't bet)
Seat 5: ivann14 folded before Flop (didn't bet)
Seat 6: abbi555 folded before Flop (didn't bet)



PokerStars Zoom Hand #195023927149:  Hold'em No Limit ($0.10/$0.25) - 2018/12/29 4:07:01 UTC [2018/12/28 23:07:01 ET]
Table 'Hydra' 6-max Seat #1 is the button
Seat 1: 777jsmith ($16.65 in chips) 
Seat 2: TQNYMQNTANA ($25.45 in chips) 
Seat 3: winwinboy ($25.95 in chips) 
Seat 4: SantiagoWeight ($82.10 in chips) 
Seat 5: dan_iasi ($43.84 in chips) 
Seat 6: mariopork ($88.64 in chips) 
TQNYMQNTANA: posts small blind $0.10
winwinboy: posts big blind $0.25
*** HOLE CARDS ***
Dealt to SantiagoWeight [8h Qs]
SantiagoWeight: folds 
dan_iasi: folds 
mariopork: folds 
777jsmith: folds 
TQNYMQNTANA: folds 
Uncalled bet ($0.15) returned to winwinboy
winwinboy collected $0.20 from pot
winwinboy: doesn't show hand 
*** SUMMARY ***
Total pot $0.20 | Rake $0 
Seat 1: 777jsmith (button) folded before Flop (didn't bet)
Seat 2: TQNYMQNTANA (small blind) folded before Flop
Seat 3: winwinboy (big blind) collected ($0.20)
Seat 4: SantiagoWeight folded before Flop (didn't bet)
Seat 5: dan_iasi folded before Flop (didn't bet)
Seat 6: mariopork folded before Flop (didn't bet)



PokerStars Zoom Hand #195023931927:  Hold'em No Limit ($0.10/$0.25) - 2018/12/29 4:07:17 UTC [2018/12/28 23:07:17 ET]
Table 'Hydra' 6-max Seat #1 is the button
Seat 1: SantiagoWeight ($81.85 in chips) 
Seat 2: Fobos113 ($13.26 in chips) 
Seat 3: nabechan814 ($24.86 in chips) 
Seat 4: Virus3232 ($26.35 in chips) 
Seat 5: mariopork ($88.54 in chips) 
Seat 6: davidhw888 ($30.66 in chips) 
Fobos113: posts small blind $0.10
nabechan814: posts big blind $0.25
*** HOLE CARDS ***
Dealt to SantiagoWeight [Th 7c]
Virus3232: raises $0.60 to $0.85
mariopork: folds 
davidhw888: folds 
SantiagoWeight: folds 
Fobos113: folds 
nabechan814: folds 
Uncalled bet ($0.60) returned to Virus3232
Virus3232 collected $0.60 from pot
Virus3232: doesn't show hand 
*** SUMMARY ***
Total pot $0.60 | Rake $0 
Seat 1: SantiagoWeight (button) folded before Flop (didn't bet)
Seat 2: Fobos113 (small blind) folded before Flop
Seat 3: nabechan814 (big blind) folded before Flop
Seat 4: Virus3232 collected ($0.60)
Seat 5: mariopork folded before Flop (didn't bet)
Seat 6: davidhw888 folded before Flop (didn't bet)



PokerStars Zoom Hand #195023928381:  Hold'em No Limit ($0.10/$0.25) - 2018/12/29 4:07:05 UTC [2018/12/28 23:07:05 ET]
Table 'Hydra' 6-max Seat #1 is the button
Seat 1: razil_999 ($29.51 in chips) 
Seat 2: dithflo ($13.73 in chips) 
Seat 3: SantiagoWeight ($82.10 in chips) 
Seat 4: davidhw888 ($29.34 in chips) 
Seat 5: MrSod420 ($24.05 in chips) 
Seat 6: Albratros2 ($25.20 in chips) 
dithflo: posts small blind $0.10
SantiagoWeight: posts big blind $0.25
*** HOLE CARDS ***
Dealt to SantiagoWeight [Kh 3d]
davidhw888: raises $0.50 to $0.75
MrSod420: folds 
Albratros2: calls $0.75
razil_999: folds 
dithflo: folds 
SantiagoWeight: folds 
*** FLOP *** [6s Qd 4c]
davidhw888: bets $1.77
Albratros2: raises $1.77 to $3.54
davidhw888: calls $1.77
*** TURN *** [6s Qd 4c] [Ks]
davidhw888: checks 
Albratros2: checks 
*** RIVER *** [6s Qd 4c Ks] [Ah]
davidhw888: bets $6.90
Albratros2: calls $6.90
*** SHOW DOWN ***
davidhw888: shows [Ad Kd] (two pair, Aces and Kings)
Albratros2: mucks hand 
davidhw888 collected $21.71 from pot
*** SUMMARY ***
Total pot $22.73 | Rake $1.02 
Board [6s Qd 4c Ks Ah]
Seat 1: razil_999 (button) folded before Flop (didn't bet)
Seat 2: dithflo (small blind) folded before Flop
Seat 3: SantiagoWeight (big blind) folded before Flop
Seat 4: davidhw888 showed [Ad Kd] and won ($21.71) with two pair, Aces and Kings
Seat 5: MrSod420 folded before Flop (didn't bet)
Seat 6: Albratros2 mucked [Jh Qh]



PokerStars Zoom Hand #195023924806:  Hold'em No Limit ($0.10/$0.25) - 2018/12/29 4:06:53 UTC [2018/12/28 23:06:53 ET]
Table 'Hydra' 6-max Seat #1 is the button
Seat 1: nhanminhtri ($25 in chips) 
Seat 2: pkr_miracle ($23.22 in chips) 
Seat 3: aa1421b ($46.20 in chips) 
Seat 4: dawwwid70 ($26.44 in chips) 
Seat 5: SantiagoWeight ($82.10 in chips) 
Seat 6: kakashi_zion ($19.58 in chips) 
pkr_miracle: posts small blind $0.10
aa1421b: posts big blind $0.25
*** HOLE CARDS ***
Dealt to SantiagoWeight [Jd 7c]
dawwwid70: folds 
SantiagoWeight: folds 
kakashi_zion: folds 
nhanminhtri: raises $0.37 to $0.62
pkr_miracle: raises $1.49 to $2.11
aa1421b: folds 
nhanminhtri: calls $1.49
*** FLOP *** [3c 7d 8s]
pkr_miracle: bets $2.14
nhanminhtri: folds 
Uncalled bet ($2.14) returned to pkr_miracle
pkr_miracle collected $4.27 from pot
pkr_miracle: doesn't show hand 
*** SUMMARY ***
Total pot $4.47 | Rake $0.20 
Board [3c 7d 8s]
Seat 1: nhanminhtri (button) folded on the Flop
Seat 2: pkr_miracle (small blind) collected ($4.27)
Seat 3: aa1421b (big blind) folded before Flop
Seat 4: dawwwid70 folded before Flop (didn't bet)
Seat 5: SantiagoWeight folded before Flop (didn't bet)
Seat 6: kakashi_zion folded before Flop (didn't bet)



PokerStars Zoom Hand #195023935125:  Hold'em No Limit ($0.10/$0.25) - 2018/12/29 4:07:28 UTC [2018/12/28 23:07:28 ET]
Table 'Hydra' 6-max Seat #1 is the button
Seat 1: 666erkan ($11.91 in chips) 
Seat 2: TQNYMQNTANA ($33.86 in chips) 
Seat 3: call me??107 ($12.50 in chips) 
Seat 4: BRSOB79 ($31.58 in chips) 
Seat 5: Chrimmpam ($24.59 in chips) 
Seat 6: SantiagoWeight ($81.85 in chips) 
TQNYMQNTANA: posts small blind $0.10
call me??107: posts big blind $0.25
*** HOLE CARDS ***
Dealt to SantiagoWeight [Kd Ks]
BRSOB79: folds 
Chrimmpam: folds 
SantiagoWeight: raises $0.30 to $0.55
666erkan: folds 
TQNYMQNTANA: folds 
call me??107: raises $1.20 to $1.75
SantiagoWeight: raises $3.15 to $4.90
call me??107: raises $7.60 to $12.50 and is all-in
SantiagoWeight: calls $7.60
*** FLOP *** [9c Js 2h]
*** TURN *** [9c Js 2h] [9h]
*** RIVER *** [9c Js 2h 9h] [4d]
*** SHOW DOWN ***
call me??107: shows [Ac Ah] (two pair, Aces and Nines)
SantiagoWeight: shows [Kd Ks] (two pair, Kings and Nines)
call me??107 collected $23.97 from pot
*** SUMMARY ***
Total pot $25.10 | Rake $1.13 
Board [9c Js 2h 9h 4d]
Seat 1: 666erkan (button) folded before Flop (didn't bet)
Seat 2: TQNYMQNTANA (small blind) folded before Flop
Seat 3: call me??107 (big blind) showed [Ac Ah] and won ($23.97) with two pair, Aces and Nines
Seat 4: BRSOB79 folded before Flop (didn't bet)
Seat 5: Chrimmpam folded before Flop (didn't bet)
Seat 6: SantiagoWeight showed [Kd Ks] and lost with two pair, Kings and Nines



PokerStars Zoom Hand #195023951543:  Hold'em No Limit ($0.10/$0.25) - 2018/12/29 4:08:24 UTC [2018/12/28 23:08:24 ET]
Table 'Hydra' 6-max Seat #1 is the button
Seat 1: hamen1990 ($24.50 in chips) 
Seat 2: Party4Arthy ($33.01 in chips) 
Seat 3: nhanminhtri ($25 in chips) 
Seat 4: SantiagoWeight ($69.35 in chips) 
Seat 5: TQNYMQNTANA ($34.11 in chips) 
Seat 6: LLiarrr ($25.15 in chips) 
Party4Arthy: posts small blind $0.10
nhanminhtri: posts big blind $0.25
*** HOLE CARDS ***
Dealt to SantiagoWeight [As Qs]
SantiagoWeight: raises $0.42 to $0.67
TQNYMQNTANA: folds 
LLiarrr: folds 
hamen1990: calls $0.67
Party4Arthy: folds 
nhanminhtri: calls $0.42
*** FLOP *** [2c Ks Qd]
nhanminhtri: checks 
SantiagoWeight: checks 
hamen1990: checks 
*** TURN *** [2c Ks Qd] [4c]
nhanminhtri: checks 
SantiagoWeight: bets $1.35
hamen1990: folds 
nhanminhtri: folds 
Uncalled bet ($1.35) returned to SantiagoWeight
SantiagoWeight collected $2.02 from pot
SantiagoWeight: doesn't show hand 
*** SUMMARY ***
Total pot $2.11 | Rake $0.09 
Board [2c Ks Qd 4c]
Seat 1: hamen1990 (button) folded on the Turn
Seat 2: Party4Arthy (small blind) folded before Flop
Seat 3: nhanminhtri (big blind) folded on the Turn
Seat 4: SantiagoWeight collected ($2.02)
Seat 5: TQNYMQNTANA folded before Flop (didn't bet)
Seat 6: LLiarrr folded before Flop (didn't bet)



PokerStars Zoom Hand #195023972836:  Hold'em No Limit ($0.10/$0.25) - 2018/12/29 4:09:37 UTC [2018/12/28 23:09:37 ET]
Table 'Hydra' 6-max Seat #1 is the button
Seat 1: NS123456 ($14.32 in chips) 
Seat 2: SantiagoWeight ($70.70 in chips) 
Seat 3: gustavotaina ($9.54 in chips) 
Seat 4: davidhw888 ($37.19 in chips) 
Seat 5: tariko1980 ($15.97 in chips) 
Seat 6: 666erkan ($12.08 in chips) 
SantiagoWeight: posts small blind $0.10
gustavotaina: posts big blind $0.25
*** HOLE CARDS ***
Dealt to SantiagoWeight [5d Qd]
davidhw888: folds 
tariko1980: folds 
666erkan: folds 
NS123456: raises $0.37 to $0.62
SantiagoWeight: folds 
gustavotaina: calls $0.37
*** FLOP *** [2s 7s 6c]
gustavotaina: checks 
NS123456: bets $0.90
gustavotaina: calls $0.90
*** TURN *** [2s 7s 6c] [Tc]
gustavotaina: checks 
NS123456: bets $2.20
gustavotaina: calls $2.20
*** RIVER *** [2s 7s 6c Tc] [4s]
gustavotaina: bets $5.82 and is all-in
NS123456: calls $5.82
*** SHOW DOWN ***
gustavotaina: shows [Qs Js] (a flush, Queen high)
NS123456: shows [Ah As] (a pair of Aces)
gustavotaina collected $18.32 from pot
*** SUMMARY ***
Total pot $19.18 | Rake $0.86 
Board [2s 7s 6c Tc 4s]
Seat 1: NS123456 (button) showed [Ah As] and lost with a pair of Aces
Seat 2: SantiagoWeight (small blind) folded before Flop
Seat 3: gustavotaina (big blind) showed [Qs Js] and won ($18.32) with a flush, Queen high
Seat 4: davidhw888 folded before Flop (didn't bet)
Seat 5: tariko1980 folded before Flop (didn't bet)
Seat 6: 666erkan folded before Flop (didn't bet)



PokerStars Zoom Hand #195023978780:  Hold'em No Limit ($0.10/$0.25) - 2018/12/29 4:09:58 UTC [2018/12/28 23:09:58 ET]
Table 'Hydra' 6-max Seat #1 is the button
Seat 1: Chellabro ($29.02 in chips) 
Seat 2: vulcandog ($7.26 in chips) 
Seat 3: ivann14 ($55.13 in chips) 
Seat 4: GrandmasterY ($31.62 in chips) 
Seat 5: SantiagoWeight ($70.60 in chips) 
Seat 6: trttt74 ($21.88 in chips) 
vulcandog: posts small blind $0.10
ivann14: posts big blind $0.25
*** HOLE CARDS ***
Dealt to SantiagoWeight [Qh Kh]
GrandmasterY: raises $0.50 to $0.75
SantiagoWeight: calls $0.75
trttt74: calls $0.75
Chellabro: folds 
vulcandog: folds 
ivann14: folds 
*** FLOP *** [2c Ad 3s]
GrandmasterY: checks 
SantiagoWeight: bets $1.10
trttt74: calls $1.10
GrandmasterY: folds 
*** TURN *** [2c Ad 3s] [6d]
SantiagoWeight: bets $2.50
trttt74: raises $3.03 to $5.53
SantiagoWeight: folds 
Uncalled bet ($3.03) returned to trttt74
trttt74 collected $9.36 from pot
*** SUMMARY ***
Total pot $9.80 | Rake $0.44 
Board [2c Ad 3s 6d]
Seat 1: Chellabro (button) folded before Flop (didn't bet)
Seat 2: vulcandog (small blind) folded before Flop
Seat 3: ivann14 (big blind) folded before Flop
Seat 4: GrandmasterY folded on the Flop
Seat 5: SantiagoWeight folded on the Turn
Seat 6: trttt74 collected ($9.36)



PokerStars Zoom Hand #195024002762:  Hold'em No Limit ($0.10/$0.25) - 2018/12/29 4:11:10 UTC [2018/12/28 23:11:10 ET]
Table 'Hydra' 6-max Seat #1 is the button
Seat 1: 2poiRiver ($22.74 in chips) 
Seat 2: dan_iasi ($71.24 in chips) 
Seat 3: SantiagoWeight ($66.25 in chips) 
Seat 4: Chrimmpam ($20.87 in chips) 
Seat 5: ivann14 ($54.78 in chips) 
Seat 6: KrishnaRadha ($37.07 in chips) 
dan_iasi: posts small blind $0.10
SantiagoWeight: posts big blind $0.25
*** HOLE CARDS ***
Dealt to SantiagoWeight [4d Jh]
Chrimmpam: folds 
ivann14: folds 
KrishnaRadha: folds 
2poiRiver: folds 
dan_iasi: raises $0.50 to $0.75
SantiagoWeight: folds 
Uncalled bet ($0.50) returned to dan_iasi
dan_iasi collected $0.50 from pot
*** SUMMARY ***
Total pot $0.50 | Rake $0 
Seat 1: 2poiRiver (button) folded before Flop (didn't bet)
Seat 2: dan_iasi (small blind) collected ($0.50)
Seat 3: SantiagoWeight (big blind) folded before Flop
Seat 4: Chrimmpam folded before Flop (didn't bet)
Seat 5: ivann14 folded before Flop (didn't bet)
Seat 6: KrishnaRadha folded before Flop (didn't bet)



PokerStars Zoom Hand #195024007049:  Hold'em No Limit ($0.10/$0.25) - 2018/12/29 4:11:25 UTC [2018/12/28 23:11:25 ET]
Table 'Hydra' 6-max Seat #1 is the button
Seat 1: SantiagoWeight ($66 in chips) 
Seat 2: cwreinbold ($38.55 in chips) 
Seat 3: qing328 ($25 in chips) 
Seat 4: tariko1980 ($29.22 in chips) 
Seat 5: Actarusqc ($23.87 in chips) 
Seat 6: Breedijkie ($50.82 in chips) 
cwreinbold: posts small blind $0.10
qing328: posts big blind $0.25
*** HOLE CARDS ***
Dealt to SantiagoWeight [Td 4s]
tariko1980: folds 
Actarusqc: folds 
Breedijkie: raises $0.50 to $0.75
SantiagoWeight: folds 
cwreinbold: folds 
qing328: folds 
Uncalled bet ($0.50) returned to Breedijkie
Breedijkie collected $0.60 from pot
Breedijkie: doesn't show hand 
*** SUMMARY ***
Total pot $0.60 | Rake $0 
Seat 1: SantiagoWeight (button) folded before Flop (didn't bet)
Seat 2: cwreinbold (small blind) folded before Flop
Seat 3: qing328 (big blind) folded before Flop
Seat 4: tariko1980 folded before Flop (didn't bet)
Seat 5: Actarusqc folded before Flop (didn't bet)
Seat 6: Breedijkie collected ($0.60)



PokerStars Zoom Hand #195024011387:  Hold'em No Limit ($0.10/$0.25) - 2018/12/29 4:11:40 UTC [2018/12/28 23:11:40 ET]
Table 'Hydra' 6-max Seat #1 is the button
Seat 1: Bonen18 ($34.80 in chips) 
Seat 2: SantiagoWeight ($66 in chips) 
Seat 3: nadal335 ($57.70 in chips) 
Seat 4: GrandmasterY ($43.56 in chips) 
Seat 5: dawwwid70 ($27.54 in chips) 
Seat 6: cankum ($25 in chips) 
SantiagoWeight: posts small blind $0.10
nadal335: posts big blind $0.25
*** HOLE CARDS ***
Dealt to SantiagoWeight [8h Qs]
GrandmasterY: folds 
dawwwid70: folds 
cankum: folds 
Bonen18: folds 
SantiagoWeight: raises $0.50 to $0.75
nadal335: raises $1.50 to $2.25
SantiagoWeight: folds 
Uncalled bet ($1.50) returned to nadal335
nadal335 collected $1.50 from pot
*** SUMMARY ***
Total pot $1.50 | Rake $0 
Seat 1: Bonen18 (button) folded before Flop (didn't bet)
Seat 2: SantiagoWeight (small blind) folded before Flop
Seat 3: nadal335 (big blind) collected ($1.50)
Seat 4: GrandmasterY folded before Flop (didn't bet)
Seat 5: dawwwid70 folded before Flop (didn't bet)
Seat 6: cankum folded before Flop (didn't bet)



PokerStars Zoom Hand #195024020801:  Hold'em No Limit ($0.10/$0.25) - 2018/12/29 4:12:12 UTC [2018/12/28 23:12:12 ET]
Table 'Hydra' 6-max Seat #1 is the button
Seat 1: GrandmasterY ($43.66 in chips) 
Seat 2: ssrace ($40.67 in chips) 
Seat 3: davidhw888 ($44.26 in chips) 
Seat 4: SantiagoWeight ($65.25 in chips) 
Seat 5: TDAK1509 ($44.59 in chips) 
Seat 6: Lehared ($29.42 in chips) 
ssrace: posts small blind $0.10
davidhw888: posts big blind $0.25
*** HOLE CARDS ***
Dealt to SantiagoWeight [9h 6c]
SantiagoWeight: folds 
TDAK1509: folds 
Lehared: raises $0.37 to $0.62
GrandmasterY: folds 
ssrace: folds 
davidhw888: folds 
Uncalled bet ($0.37) returned to Lehared
Lehared collected $0.60 from pot
Lehared: doesn't show hand 
*** SUMMARY ***
Total pot $0.60 | Rake $0 
Seat 1: GrandmasterY (button) folded before Flop (didn't bet)
Seat 2: ssrace (small blind) folded before Flop
Seat 3: davidhw888 (big blind) folded before Flop
Seat 4: SantiagoWeight folded before Flop (didn't bet)
Seat 5: TDAK1509 folded before Flop (didn't bet)
Seat 6: Lehared collected ($0.60)



PokerStars Zoom Hand #195024022276:  Hold'em No Limit ($0.10/$0.25) - 2018/12/29 4:12:17 UTC [2018/12/28 23:12:17 ET]
Table 'Hydra' 6-max Seat #1 is the button
Seat 1: KeySssi ($25.10 in chips) 
Seat 2: Bonen18 ($26.93 in chips) 
Seat 3: razil_999 ($19.28 in chips) 
Seat 4: dan_iasi ($71.59 in chips) 
Seat 5: dawwwid70 ($27.54 in chips) 
Seat 6: SantiagoWeight ($65.25 in chips) 
Bonen18: posts small blind $0.10
razil_999: posts big blind $0.25
*** HOLE CARDS ***
Dealt to SantiagoWeight [7c Kh]
dan_iasi: folds 
dawwwid70: folds 
SantiagoWeight: raises $0.30 to $0.55
KeySssi: folds 
Bonen18: folds 
razil_999: folds 
Uncalled bet ($0.30) returned to SantiagoWeight
SantiagoWeight collected $0.60 from pot
SantiagoWeight: doesn't show hand 
*** SUMMARY ***
Total pot $0.60 | Rake $0 
Seat 1: KeySssi (button) folded before Flop (didn't bet)
Seat 2: Bonen18 (small blind) folded before Flop
Seat 3: razil_999 (big blind) folded before Flop
Seat 4: dan_iasi folded before Flop (didn't bet)
Seat 5: dawwwid70 folded before Flop (didn't bet)
Seat 6: SantiagoWeight collected ($0.60)



PokerStars Zoom Hand #195024026954:  Hold'em No Limit ($0.10/$0.25) - 2018/12/29 4:12:33 UTC [2018/12/28 23:12:33 ET]
Table 'Hydra' 6-max Seat #1 is the button
Seat 1: Unclesmoll ($12.78 in chips) 
Seat 2: aa1421b ($47.59 in chips) 
Seat 3: river plate9 ($32.90 in chips) 
Seat 4: Nutselas ($25 in chips) 
Seat 5: SantiagoWeight ($65.60 in chips) 
Seat 6: kaizin727 ($23.60 in chips) 
aa1421b: posts small blind $0.10
river plate9: posts big blind $0.25
*** HOLE CARDS ***
Dealt to SantiagoWeight [9s 4c]
Nutselas: folds 
SantiagoWeight: folds 
kaizin727: folds 
Unclesmoll: raises $0.50 to $0.75
aa1421b: folds 
river plate9: folds 
Uncalled bet ($0.50) returned to Unclesmoll
Unclesmoll collected $0.60 from pot
Unclesmoll: doesn't show hand 
*** SUMMARY ***
Total pot $0.60 | Rake $0 
Seat 1: Unclesmoll (button) collected ($0.60)
Seat 2: aa1421b (small blind) folded before Flop
Seat 3: river plate9 (big blind) folded before Flop
Seat 4: Nutselas folded before Flop (didn't bet)
Seat 5: SantiagoWeight folded before Flop (didn't bet)
Seat 6: kaizin727 folded before Flop (didn't bet)



PokerStars Zoom Hand #195024034227:  Hold'em No Limit ($0.10/$0.25) - 2018/12/29 4:12:58 UTC [2018/12/28 23:12:58 ET]
Table 'Hydra' 6-max Seat #1 is the button
Seat 1: river plate9 ($32.65 in chips) 
Seat 2: ivann14 ($26.41 in chips) 
Seat 3: qing328 ($24.79 in chips) 
Seat 4: naxizzle ($106.72 in chips) 
Seat 5: ssrace ($39.57 in chips) 
Seat 6: SantiagoWeight ($64.93 in chips) 
ivann14: posts small blind $0.10
qing328: posts big blind $0.25
*** HOLE CARDS ***
Dealt to SantiagoWeight [Kd Tc]
naxizzle: folds 
ssrace: raises $0.25 to $0.50
SantiagoWeight: folds 
river plate9: folds 
ivann14: folds 
qing328: folds 
Uncalled bet ($0.25) returned to ssrace
ssrace collected $0.60 from pot
ssrace: doesn't show hand 
*** SUMMARY ***
Total pot $0.60 | Rake $0 
Seat 1: river plate9 (button) folded before Flop (didn't bet)
Seat 2: ivann14 (small blind) folded before Flop
Seat 3: qing328 (big blind) folded before Flop
Seat 4: naxizzle folded before Flop (didn't bet)
Seat 5: ssrace collected ($0.60)
Seat 6: SantiagoWeight folded before Flop (didn't bet)



PokerStars Zoom Hand #195024028122:  Hold'em No Limit ($0.10/$0.25) - 2018/12/29 4:12:37 UTC [2018/12/28 23:12:37 ET]
Table 'Hydra' 6-max Seat #1 is the button
Seat 1: davidhw888 ($12.68 in chips) 
Seat 2: ruiken ($26.50 in chips) 
Seat 3: Gonzalit0o ($25 in chips) 
Seat 4: SantiagoWeight ($65.60 in chips) 
Seat 5: Doomdigidoom ($39.96 in chips) 
Seat 6: BRSOB79 ($27.07 in chips) 
ruiken: posts small blind $0.10
Gonzalit0o: posts big blind $0.25
*** HOLE CARDS ***
Dealt to SantiagoWeight [Ks Jh]
SantiagoWeight: raises $0.42 to $0.67
Doomdigidoom: calls $0.67
BRSOB79: folds 
davidhw888: raises $12.01 to $12.68 and is all-in
ruiken: folds 
Gonzalit0o: folds 
SantiagoWeight: folds 
Doomdigidoom: folds 
Uncalled bet ($12.01) returned to davidhw888
davidhw888 collected $2.36 from pot
davidhw888: doesn't show hand 
*** SUMMARY ***
Total pot $2.36 | Rake $0 
Seat 1: davidhw888 (button) collected ($2.36)
Seat 2: ruiken (small blind) folded before Flop
Seat 3: Gonzalit0o (big blind) folded before Flop
Seat 4: SantiagoWeight folded before Flop
Seat 5: Doomdigidoom folded before Flop
Seat 6: BRSOB79 folded before Flop (didn't bet)



PokerStars Zoom Hand #195024036880:  Hold'em No Limit ($0.10/$0.25) - 2018/12/29 4:13:07 UTC [2018/12/28 23:13:07 ET]
Table 'Hydra' 6-max Seat #1 is the button
Seat 1: Unclesmoll ($12.78 in chips) 
Seat 2: ritchy99 ($25.10 in chips) 
Seat 3: SantiagoWeight ($64.93 in chips) 
Seat 4: the_ablist7 ($21.30 in chips) 
Seat 5: Lehared ($83.50 in chips) 
Seat 6: graysonai ($49.93 in chips) 
ritchy99: posts small blind $0.10
SantiagoWeight: posts big blind $0.25
*** HOLE CARDS ***
Dealt to SantiagoWeight [Jd 9c]
the_ablist7: folds 
Lehared: folds 
graysonai: folds 
Unclesmoll: folds 
ritchy99: folds 
Uncalled bet ($0.15) returned to SantiagoWeight
SantiagoWeight collected $0.20 from pot
SantiagoWeight: doesn't show hand 
*** SUMMARY ***
Total pot $0.20 | Rake $0 
Seat 1: Unclesmoll (button) folded before Flop (didn't bet)
Seat 2: ritchy99 (small blind) folded before Flop
Seat 3: SantiagoWeight (big blind) collected ($0.20)
Seat 4: the_ablist7 folded before Flop (didn't bet)
Seat 5: Lehared folded before Flop (didn't bet)
Seat 6: graysonai folded before Flop (didn't bet)



PokerStars Zoom Hand #195024040406:  Hold'em No Limit ($0.10/$0.25) - 2018/12/29 4:13:19 UTC [2018/12/28 23:13:19 ET]
Table 'Hydra' 6-max Seat #1 is the button
Seat 1: TQNYMQNTANA ($29.29 in chips) 
Seat 2: BRSOB79 ($27.07 in chips) 
Seat 3: heromn ($23.43 in chips) 
Seat 4: SantiagoWeight ($65.03 in chips) 
Seat 5: dawwwid70 ($25 in chips) 
Seat 6: pirosiky ($66.98 in chips) 
BRSOB79: posts small blind $0.10
heromn: posts big blind $0.25
*** HOLE CARDS ***
Dealt to SantiagoWeight [5c 5d]
SantiagoWeight: raises $0.42 to $0.67
dawwwid70: folds 
pirosiky has timed out
pirosiky: folds 
TQNYMQNTANA: folds 
BRSOB79: folds 
heromn: folds 
Uncalled bet ($0.42) returned to SantiagoWeight
SantiagoWeight collected $0.60 from pot
SantiagoWeight: doesn't show hand 
*** SUMMARY ***
Total pot $0.60 | Rake $0 
Seat 1: TQNYMQNTANA (button) folded before Flop (didn't bet)
Seat 2: BRSOB79 (small blind) folded before Flop
Seat 3: heromn (big blind) folded before Flop
Seat 4: SantiagoWeight collected ($0.60)
Seat 5: dawwwid70 folded before Flop (didn't bet)
Seat 6: pirosiky folded before Flop (didn't bet)



PokerStars Zoom Hand #195024047911:  Hold'em No Limit ($0.10/$0.25) - 2018/12/29 4:13:45 UTC [2018/12/28 23:13:45 ET]
Table 'Hydra' 6-max Seat #1 is the button
Seat 1: SantiagoWeight ($65.38 in chips) 
Seat 2: davidhw888 ($44.63 in chips) 
Seat 3: jfgodtheg ($23.79 in chips) 
Seat 4: G ster24 ($43.42 in chips) 
Seat 5: vulcandog ($26.11 in chips) 
Seat 6: dan_iasi ($54.39 in chips) 
davidhw888: posts small blind $0.10
jfgodtheg: posts big blind $0.25
*** HOLE CARDS ***
Dealt to SantiagoWeight [4d 8s]
G ster24: folds 
vulcandog: raises $0.25 to $0.50
dan_iasi: folds 
SantiagoWeight: folds 
davidhw888: folds 
jfgodtheg: calls $0.25
*** FLOP *** [5h 6s 2d]
jfgodtheg: checks 
vulcandog: checks 
*** TURN *** [5h 6s 2d] [Ah]
jfgodtheg: checks 
vulcandog: bets $0.53
jfgodtheg: folds 
Uncalled bet ($0.53) returned to vulcandog
vulcandog collected $1.05 from pot
vulcandog: doesn't show hand 
*** SUMMARY ***
Total pot $1.10 | Rake $0.05 
Board [5h 6s 2d Ah]
Seat 1: SantiagoWeight (button) folded before Flop (didn't bet)
Seat 2: davidhw888 (small blind) folded before Flop
Seat 3: jfgodtheg (big blind) folded on the Turn
Seat 4: G ster24 folded before Flop (didn't bet)
Seat 5: vulcandog collected ($1.05)
Seat 6: dan_iasi folded before Flop (didn't bet)



PokerStars Zoom Hand #195024058694:  Hold'em No Limit ($0.10/$0.25) - 2018/12/29 4:14:22 UTC [2018/12/28 23:14:22 ET]
Table 'Hydra' 6-max Seat #1 is the button
Seat 1: osa126 ($67.15 in chips) 
Seat 2: Dimvov ($12.15 in chips) 
Seat 3: SantiagoWeight ($65.28 in chips) 
Seat 4: Breedijkie ($53.45 in chips) 
Seat 5: qing328 ($26.03 in chips) 
Seat 6: athos 007 ($35.14 in chips) 
Dimvov: posts small blind $0.10
SantiagoWeight: posts big blind $0.25
*** HOLE CARDS ***
Dealt to SantiagoWeight [7s Jd]
Breedijkie: folds 
qing328: folds 
athos 007: raises $0.25 to $0.50
osa126: folds 
Dimvov: folds 
SantiagoWeight: folds 
Uncalled bet ($0.25) returned to athos 007
athos 007 collected $0.60 from pot
athos 007: doesn't show hand 
*** SUMMARY ***
Total pot $0.60 | Rake $0 
Seat 1: osa126 (button) folded before Flop (didn't bet)
Seat 2: Dimvov (small blind) folded before Flop
Seat 3: SantiagoWeight (big blind) folded before Flop
Seat 4: Breedijkie folded before Flop (didn't bet)
Seat 5: qing328 folded before Flop (didn't bet)
Seat 6: athos 007 collected ($0.60)



PokerStars Zoom Hand #195024053806:  Hold'em No Limit ($0.10/$0.25) - 2018/12/29 4:14:05 UTC [2018/12/28 23:14:05 ET]
Table 'Hydra' 6-max Seat #1 is the button
Seat 1: aa1421b ($47.24 in chips) 
Seat 2: cheolbeom ($30.08 in chips) 
Seat 3: mariopork ($32.57 in chips) 
Seat 4: mililser ($26.39 in chips) 
Seat 5: davidhw888 ($44.53 in chips) 
Seat 6: SantiagoWeight ($65.28 in chips) 
cheolbeom: posts small blind $0.10
mariopork: posts big blind $0.25
*** HOLE CARDS ***
Dealt to SantiagoWeight [5c 2h]
mililser: folds 
davidhw888: folds 
SantiagoWeight: folds 
aa1421b: folds 
cheolbeom: raises $0.50 to $0.75
mariopork: raises $1.55 to $2.30
cheolbeom: folds 
Uncalled bet ($1.55) returned to mariopork
mariopork collected $1.50 from pot
mariopork: doesn't show hand 
*** SUMMARY ***
Total pot $1.50 | Rake $0 
Seat 1: aa1421b (button) folded before Flop (didn't bet)
Seat 2: cheolbeom (small blind) folded before Flop
Seat 3: mariopork (big blind) collected ($1.50)
Seat 4: mililser folded before Flop (didn't bet)
Seat 5: davidhw888 folded before Flop (didn't bet)
Seat 6: SantiagoWeight folded before Flop (didn't bet)



PokerStars Zoom Hand #195024051134:  Hold'em No Limit ($0.10/$0.25) - 2018/12/29 4:13:56 UTC [2018/12/28 23:13:56 ET]
Table 'Hydra' 6-max Seat #1 is the button
Seat 1: dawwwid70 ($26.94 in chips) 
Seat 2: SantiagoWeight ($65.38 in chips) 
Seat 3: pirosiky ($66.98 in chips) 
Seat 4: Party4Arthy ($36.57 in chips) 
Seat 5: skePokerske ($12.64 in chips) 
Seat 6: qing328 ($24.09 in chips) 
SantiagoWeight: posts small blind $0.10
pirosiky: posts big blind $0.25
*** HOLE CARDS ***
Dealt to SantiagoWeight [3h Jh]
Party4Arthy: folds 
skePokerske: raises $0.25 to $0.50
qing328: folds 
dawwwid70: folds 
SantiagoWeight: folds 
pirosiky: calls $0.25
*** FLOP *** [3c Tc Qh]
pirosiky: checks 
skePokerske: bets $0.90
pirosiky: calls $0.90
*** TURN *** [3c Tc Qh] [2h]
pirosiky: checks 
skePokerske: bets $1.14
pirosiky: calls $1.14
*** RIVER *** [3c Tc Qh 2h] [Kc]
pirosiky: checks 
skePokerske: bets $10.10 and is all-in
pirosiky: folds 
Uncalled bet ($10.10) returned to skePokerske
skePokerske collected $4.95 from pot
skePokerske: doesn't show hand 
*** SUMMARY ***
Total pot $5.18 | Rake $0.23 
Board [3c Tc Qh 2h Kc]
Seat 1: dawwwid70 (button) folded before Flop (didn't bet)
Seat 2: SantiagoWeight (small blind) folded before Flop
Seat 3: pirosiky (big blind) folded on the River
Seat 4: Party4Arthy folded before Flop (didn't bet)
Seat 5: skePokerske collected ($4.95)
Seat 6: qing328 folded before Flop (didn't bet)



PokerStars Zoom Hand #195024062152:  Hold'em No Limit ($0.10/$0.25) - 2018/12/29 4:14:34 UTC [2018/12/28 23:14:34 ET]
Table 'Hydra' 6-max Seat #1 is the button
Seat 1: SantiagoWeight ($65.03 in chips) 
Seat 2: qing328 ($24.19 in chips) 
Seat 3: vigos king ($34.51 in chips) 
Seat 4: ryanking99 ($47.61 in chips) 
Seat 5: cheolbeom ($26.62 in chips) 
Seat 6: anlu0803 ($20.95 in chips) 
qing328: posts small blind $0.10
vigos king: posts big blind $0.25
*** HOLE CARDS ***
Dealt to SantiagoWeight [9h Ad]
ryanking99: folds 
cheolbeom: folds 
anlu0803: folds 
SantiagoWeight: raises $0.30 to $0.55
qing328: folds 
vigos king: folds 
Uncalled bet ($0.30) returned to SantiagoWeight
SantiagoWeight collected $0.60 from pot
SantiagoWeight: doesn't show hand 
*** SUMMARY ***
Total pot $0.60 | Rake $0 
Seat 1: SantiagoWeight (button) collected ($0.60)
Seat 2: qing328 (small blind) folded before Flop
Seat 3: vigos king (big blind) folded before Flop
Seat 4: ryanking99 folded before Flop (didn't bet)
Seat 5: cheolbeom folded before Flop (didn't bet)
Seat 6: anlu0803 folded before Flop (didn't bet)



PokerStars Zoom Hand #195024068773:  Hold'em No Limit ($0.10/$0.25) - 2018/12/29 4:14:57 UTC [2018/12/28 23:14:57 ET]
Table 'Hydra' 6-max Seat #1 is the button
Seat 1: dan_iasi ($54.04 in chips) 
Seat 2: ivann14 ($58.76 in chips) 
Seat 3: BIGPAIN14 ($34.57 in chips) 
Seat 4: graysonai ($25.70 in chips) 
Seat 5: SantiagoWeight ($65.38 in chips) 
Seat 6: ol_2face ($81.68 in chips) 
ivann14: posts small blind $0.10
BIGPAIN14: posts big blind $0.25
*** HOLE CARDS ***
Dealt to SantiagoWeight [3d 2h]
graysonai: raises $0.30 to $0.55
SantiagoWeight: folds 
ol_2face: folds 
dan_iasi: folds 
ivann14: folds 
BIGPAIN14: folds 
Uncalled bet ($0.30) returned to graysonai
graysonai collected $0.60 from pot
graysonai: doesn't show hand 
*** SUMMARY ***
Total pot $0.60 | Rake $0 
Seat 1: dan_iasi (button) folded before Flop (didn't bet)
Seat 2: ivann14 (small blind) folded before Flop
Seat 3: BIGPAIN14 (big blind) folded before Flop
Seat 4: graysonai collected ($0.60)
Seat 5: SantiagoWeight folded before Flop (didn't bet)
Seat 6: ol_2face folded before Flop (didn't bet)



PokerStars Zoom Hand #195024071450:  Hold'em No Limit ($0.10/$0.25) - 2018/12/29 4:15:06 UTC [2018/12/28 23:15:06 ET]
Table 'Hydra' 6-max Seat #1 is the button
Seat 1: mililser ($26.14 in chips) 
Seat 2: SantiagoWeight ($65.38 in chips) 
Seat 3: mariopork ($48.69 in chips) 
Seat 4: Buntar017 ($18.37 in chips) 
Seat 5: zdenekstavic ($42.57 in chips) 
Seat 6: Elapostador33 ($17.94 in chips) 
SantiagoWeight: posts small blind $0.10
mariopork: posts big blind $0.25
*** HOLE CARDS ***
Dealt to SantiagoWeight [Kd 5s]
Buntar017: folds 
zdenekstavic: folds 
Elapostador33: raises $0.60 to $0.85
mililser: folds 
SantiagoWeight: folds 
mariopork: folds 
Uncalled bet ($0.60) returned to Elapostador33
Elapostador33 collected $0.60 from pot
Elapostador33: doesn't show hand 
*** SUMMARY ***
Total pot $0.60 | Rake $0 
Seat 1: mililser (button) folded before Flop (didn't bet)
Seat 2: SantiagoWeight (small blind) folded before Flop
Seat 3: mariopork (big blind) folded before Flop
Seat 4: Buntar017 folded before Flop (didn't bet)
Seat 5: zdenekstavic folded before Flop (didn't bet)
Seat 6: Elapostador33 collected ($0.60)



PokerStars Zoom Hand #195024075283:  Hold'em No Limit ($0.10/$0.25) - 2018/12/29 4:15:19 UTC [2018/12/28 23:15:19 ET]
Table 'Hydra' 6-max Seat #1 is the button
Seat 1: abbi555 ($36.23 in chips) 
Seat 2: dawwwid70 ($26.34 in chips) 
Seat 3: franco373513 ($13.15 in chips) 
Seat 4: mariopork ($25.25 in chips) 
Seat 5: 2poiRiver ($23.74 in chips) 
Seat 6: SantiagoWeight ($65.28 in chips) 
dawwwid70: posts small blind $0.10
franco373513: posts big blind $0.25
*** HOLE CARDS ***
Dealt to SantiagoWeight [5d 9h]
mariopork: folds 
2poiRiver: folds 
SantiagoWeight: folds 
abbi555: raises $0.50 to $0.75
dawwwid70: folds 
franco373513: folds 
Uncalled bet ($0.50) returned to abbi555
abbi555 collected $0.60 from pot
abbi555: doesn't show hand 
*** SUMMARY ***
Total pot $0.60 | Rake $0 
Seat 1: abbi555 (button) collected ($0.60)
Seat 2: dawwwid70 (small blind) folded before Flop
Seat 3: franco373513 (big blind) folded before Flop
Seat 4: mariopork folded before Flop (didn't bet)
Seat 5: 2poiRiver folded before Flop (didn't bet)
Seat 6: SantiagoWeight folded before Flop (didn't bet)



PokerStars Zoom Hand #195024080516:  Hold'em No Limit ($0.10/$0.25) - 2018/12/29 4:15:37 UTC [2018/12/28 23:15:37 ET]
Table 'Hydra' 6-max Seat #1 is the button
Seat 1: SantiagoWeight ($65.28 in chips) 
Seat 2: ruiken ($28.12 in chips) 
Seat 3: tchiwas ($25 in chips) 
Seat 4: 2poiRiver ($23.74 in chips) 
Seat 5: mariopork ($48.34 in chips) 
Seat 6: Dimvov ($13.51 in chips) 
ruiken: posts small blind $0.10
tchiwas: posts big blind $0.25
*** HOLE CARDS ***
Dealt to SantiagoWeight [4d 3c]
2poiRiver: folds 
mariopork: folds 
Dimvov: folds 
SantiagoWeight: folds 
ruiken: raises $0.50 to $0.75
tchiwas: raises $1.50 to $2.25
ruiken: calls $1.50
*** FLOP *** [Jd As 2s]
ruiken: checks 
tchiwas: bets $2.15
ruiken: calls $2.15
*** TURN *** [Jd As 2s] [Jc]
ruiken: checks 
tchiwas: checks 
*** RIVER *** [Jd As 2s Jc] [Ac]
ruiken: bets $8.40
tchiwas: folds 
Uncalled bet ($8.40) returned to ruiken
ruiken collected $8.40 from pot
ruiken: doesn't show hand 
*** SUMMARY ***
Total pot $8.80 | Rake $0.40 
Board [Jd As 2s Jc Ac]
Seat 1: SantiagoWeight (button) folded before Flop (didn't bet)
Seat 2: ruiken (small blind) collected ($8.40)
Seat 3: tchiwas (big blind) folded on the River
Seat 4: 2poiRiver folded before Flop (didn't bet)
Seat 5: mariopork folded before Flop (didn't bet)
Seat 6: Dimvov folded before Flop (didn't bet)



PokerStars Zoom Hand #195024085705:  Hold'em No Limit ($0.10/$0.25) - 2018/12/29 4:15:55 UTC [2018/12/28 23:15:55 ET]
Table 'Hydra' 6-max Seat #1 is the button
Seat 1: call me??107 ($19.95 in chips) 
Seat 2: SantiagoWeight ($65.28 in chips) 
Seat 3: mariopork ($48.34 in chips) 
Seat 4: anlu0803 ($22.28 in chips) 
Seat 5: Gonzalit0o ($35.73 in chips) 
Seat 6: paulieGB ($23.55 in chips) 
SantiagoWeight: posts small blind $0.10
mariopork: posts big blind $0.25
*** HOLE CARDS ***
Dealt to SantiagoWeight [Ac 4h]
anlu0803: raises $0.25 to $0.50
Gonzalit0o: folds 
paulieGB: folds 
call me??107: folds 
SantiagoWeight: folds 
mariopork: folds 
Uncalled bet ($0.25) returned to anlu0803
anlu0803 collected $0.60 from pot
anlu0803: doesn't show hand 
*** SUMMARY ***
Total pot $0.60 | Rake $0 
Seat 1: call me??107 (button) folded before Flop (didn't bet)
Seat 2: SantiagoWeight (small blind) folded before Flop
Seat 3: mariopork (big blind) folded before Flop
Seat 4: anlu0803 collected ($0.60)
Seat 5: Gonzalit0o folded before Flop (didn't bet)
Seat 6: paulieGB folded before Flop (didn't bet)



PokerStars Zoom Hand #195024091288:  Hold'em No Limit ($0.10/$0.25) - 2018/12/29 4:16:14 UTC [2018/12/28 23:16:14 ET]
Table 'Hydra' 6-max Seat #1 is the button
Seat 1: Dbakunwaves ($58.42 in chips) 
Seat 2: MileVoliD49 ($28.24 in chips) 
Seat 3: SantiagoWeight ($65.18 in chips) 
Seat 4: ryanking99 ($25.26 in chips) 
Seat 5: mariopork ($47.99 in chips) 
Seat 6: cheolbeom ($29.43 in chips) 
MileVoliD49: posts small blind $0.10
SantiagoWeight: posts big blind $0.25
*** HOLE CARDS ***
Dealt to SantiagoWeight [Ks 2d]
ryanking99: folds 
mariopork: folds 
cheolbeom: raises $0.50 to $0.75
Dbakunwaves: calls $0.75
MileVoliD49: folds 
SantiagoWeight: folds 
*** FLOP *** [5c 9c Js]
cheolbeom: checks 
Dbakunwaves: checks 
*** TURN *** [5c 9c Js] [6c]
cheolbeom: bets $1.33
Dbakunwaves: folds 
Uncalled bet ($1.33) returned to cheolbeom
cheolbeom collected $1.77 from pot
cheolbeom: doesn't show hand 
*** SUMMARY ***
Total pot $1.85 | Rake $0.08 
Board [5c 9c Js 6c]
Seat 1: Dbakunwaves (button) folded on the Turn
Seat 2: MileVoliD49 (small blind) folded before Flop
Seat 3: SantiagoWeight (big blind) folded before Flop
Seat 4: ryanking99 folded before Flop (didn't bet)
Seat 5: mariopork folded before Flop (didn't bet)
Seat 6: cheolbeom collected ($1.77)



PokerStars Zoom Hand #195024097161:  Hold'em No Limit ($0.10/$0.25) - 2018/12/29 4:16:34 UTC [2018/12/28 23:16:34 ET]
Table 'Hydra' 6-max Seat #1 is the button
Seat 1: vulcandog ($12.03 in chips) 
Seat 2: _BluDeeN_ ($25 in chips) 
Seat 3: landromede ($38.20 in chips) 
Seat 4: SantiagoWeight ($64.93 in chips) 
Seat 5: mililser ($25.44 in chips) 
Seat 6: KeySssi ($25 in chips) 
_BluDeeN_: posts small blind $0.10
landromede: posts big blind $0.25
*** HOLE CARDS ***
Dealt to SantiagoWeight [9c 8h]
SantiagoWeight: folds 
mililser: folds 
KeySssi: folds 
vulcandog: folds 
_BluDeeN_: folds 
Uncalled bet ($0.15) returned to landromede
landromede collected $0.20 from pot
landromede: doesn't show hand 
*** SUMMARY ***
Total pot $0.20 | Rake $0 
Seat 1: vulcandog (button) folded before Flop (didn't bet)
Seat 2: _BluDeeN_ (small blind) folded before Flop
Seat 3: landromede (big blind) collected ($0.20)
Seat 4: SantiagoWeight folded before Flop (didn't bet)
Seat 5: mililser folded before Flop (didn't bet)
Seat 6: KeySssi folded before Flop (didn't bet)



PokerStars Zoom Hand #195024100656:  Hold'em No Limit ($0.10/$0.25) - 2018/12/29 4:16:46 UTC [2018/12/28 23:16:46 ET]
Table 'Hydra' 6-max Seat #1 is the button
Seat 1: !P0K3RM3T4L! ($26.01 in chips) 
Seat 2: BIGPAIN14 ($31.78 in chips) 
Seat 3: sigaro010 ($20.28 in chips) 
Seat 4: SantiagoWeight ($64.93 in chips) 
Seat 5: river plate9 ($39.96 in chips) 
Seat 6: mililser ($22.64 in chips) 
BIGPAIN14: posts small blind $0.10
sigaro010: posts big blind $0.25
*** HOLE CARDS ***
Dealt to SantiagoWeight [7h 7d]
SantiagoWeight: raises $0.42 to $0.67
river plate9: folds 
mililser: folds 
!P0K3RM3T4L!: folds 
BIGPAIN14: calls $0.57
sigaro010: folds 
*** FLOP *** [5s 2c 2h]
BIGPAIN14: checks 
SantiagoWeight: bets $0.38
BIGPAIN14: calls $0.38
*** TURN *** [5s 2c 2h] [Js]
BIGPAIN14: checks 
SantiagoWeight: bets $1.30
BIGPAIN14: calls $1.30
*** RIVER *** [5s 2c 2h Js] [Td]
BIGPAIN14: checks 
SantiagoWeight: checks 
*** SHOW DOWN ***
BIGPAIN14: shows [Ts Qs] (two pair, Tens and Deuces)
SantiagoWeight: mucks hand 
BIGPAIN14 collected $4.73 from pot
*** SUMMARY ***
Total pot $4.95 | Rake $0.22 
Board [5s 2c 2h Js Td]
Seat 1: !P0K3RM3T4L! (button) folded before Flop (didn't bet)
Seat 2: BIGPAIN14 (small blind) showed [Ts Qs] and won ($4.73) with two pair, Tens and Deuces
Seat 3: sigaro010 (big blind) folded before Flop
Seat 4: SantiagoWeight mucked [7h 7d]
Seat 5: river plate9 folded before Flop (didn't bet)
Seat 6: mililser folded before Flop (didn't bet)



PokerStars Zoom Hand #195024095103:  Hold'em No Limit ($0.10/$0.25) - 2018/12/29 4:16:27 UTC [2018/12/28 23:16:27 ET]
Table 'Hydra' 6-max Seat #1 is the button
Seat 1: ivann14 ($61.15 in chips) 
Seat 2: leoval1010 ($12.60 in chips) 
Seat 3: Nutselas ($27.16 in chips) 
Seat 4: Bonen18 ($32.76 in chips) 
Seat 5: SantiagoWeight ($64.93 in chips) 
Seat 6: dan_iasi ($55.51 in chips) 
leoval1010: posts small blind $0.10
Nutselas: posts big blind $0.25
*** HOLE CARDS ***
Dealt to SantiagoWeight [2h 8c]
Bonen18: raises $0.40 to $0.65
SantiagoWeight: folds 
dan_iasi: folds 
ivann14: folds 
leoval1010: calls $0.55
Nutselas: folds 
*** FLOP *** [Ts Qs 6h]
leoval1010: checks 
Bonen18: bets $0.89
leoval1010: calls $0.89
*** TURN *** [Ts Qs 6h] [Ac]
leoval1010: checks 
Bonen18: checks 
*** RIVER *** [Ts Qs 6h Ac] [Kc]
leoval1010: checks 
Bonen18: bets $2.39
leoval1010: calls $2.39
*** SHOW DOWN ***
Bonen18: shows [Ah Jd] (a straight, Ten to Ace)
leoval1010: mucks hand 
Bonen18 collected $7.75 from pot
*** SUMMARY ***
Total pot $8.11 | Rake $0.36 
Board [Ts Qs 6h Ac Kc]
Seat 1: ivann14 (button) folded before Flop (didn't bet)
Seat 2: leoval1010 (small blind) mucked [Kh Th]
Seat 3: Nutselas (big blind) folded before Flop
Seat 4: Bonen18 showed [Ah Jd] and won ($7.75) with a straight, Ten to Ace
Seat 5: SantiagoWeight folded before Flop (didn't bet)
Seat 6: dan_iasi folded before Flop (didn't bet)



PokerStars Zoom Hand #195024123119:  Hold'em No Limit ($0.10/$0.25) - 2018/12/29 4:18:03 UTC [2018/12/28 23:18:03 ET]
Table 'Hydra' 6-max Seat #1 is the button
Seat 1: SantiagoWeight ($62.33 in chips) 
Seat 2: mililser ($22.04 in chips) 
Seat 3: trttt74 ($30.27 in chips) 
Seat 4: Viiiru ($26.74 in chips) 
Seat 5: landromede ($38.55 in chips) 
Seat 6: alex3d1985 ($15.91 in chips) 
mililser: posts small blind $0.10
trttt74: posts big blind $0.25
*** HOLE CARDS ***
Dealt to SantiagoWeight [8c 9c]
Viiiru: folds 
landromede: calls $0.25
alex3d1985: folds 
SantiagoWeight: raises $0.75 to $1
mililser: folds 
trttt74: folds 
landromede: folds 
Uncalled bet ($0.75) returned to SantiagoWeight
SantiagoWeight collected $0.85 from pot
SantiagoWeight: doesn't show hand 
*** SUMMARY ***
Total pot $0.85 | Rake $0 
Seat 1: SantiagoWeight (button) collected ($0.85)
Seat 2: mililser (small blind) folded before Flop
Seat 3: trttt74 (big blind) folded before Flop
Seat 4: Viiiru folded before Flop (didn't bet)
Seat 5: landromede folded before Flop
Seat 6: alex3d1985 folded before Flop (didn't bet)



PokerStars Zoom Hand #195024119364:  Hold'em No Limit ($0.10/$0.25) - 2018/12/29 4:17:50 UTC [2018/12/28 23:17:50 ET]
Table 'Hydra' 6-max Seat #1 is the button
Seat 1: qing328 ($24.26 in chips) 
Seat 2: river plate9 ($40.49 in chips) 
Seat 3: SantiagoWeight ($62.58 in chips) 
Seat 4: dan_iasi ($71.46 in chips) 
Seat 5: zdenekstavic ($39.05 in chips) 
Seat 6: studly71 ($10.78 in chips) 
river plate9: posts small blind $0.10
SantiagoWeight: posts big blind $0.25
*** HOLE CARDS ***
Dealt to SantiagoWeight [6d Th]
dan_iasi: raises $0.50 to $0.75
zdenekstavic: calls $0.75
studly71: raises $1.50 to $2.25
qing328: folds 
river plate9: folds 
SantiagoWeight: folds 
dan_iasi: calls $1.50
zdenekstavic: folds 
*** FLOP *** [Ah 2h Jc]
dan_iasi: checks 
studly71: bets $2.25
dan_iasi: calls $2.25
*** TURN *** [Ah 2h Jc] [3h]
dan_iasi: bets $5.11
studly71: raises $1.17 to $6.28 and is all-in
dan_iasi: calls $1.17
*** RIVER *** [Ah 2h Jc 3h] [4s]
*** SHOW DOWN ***
dan_iasi: shows [2d 2s] (three of a kind, Deuces)
studly71: shows [As Kh] (a pair of Aces)
dan_iasi collected $21.64 from pot
*** SUMMARY ***
Total pot $22.66 | Rake $1.02 
Board [Ah 2h Jc 3h 4s]
Seat 1: qing328 (button) folded before Flop (didn't bet)
Seat 2: river plate9 (small blind) folded before Flop
Seat 3: SantiagoWeight (big blind) folded before Flop
Seat 4: dan_iasi showed [2d 2s] and won ($21.64) with three of a kind, Deuces
Seat 5: zdenekstavic folded before Flop
Seat 6: studly71 showed [As Kh] and lost with a pair of Aces



PokerStars Zoom Hand #195024131795:  Hold'em No Limit ($0.10/$0.25) - 2018/12/29 4:18:33 UTC [2018/12/28 23:18:33 ET]
Table 'Hydra' 6-max Seat #1 is the button
Seat 1: KrishnaRadha ($68.81 in chips) 
Seat 2: SantiagoWeight ($62.93 in chips) 
Seat 3: Jameson11 ($17.70 in chips) 
Seat 4: naxizzle ($107.34 in chips) 
Seat 5: BRSOB79 ($25 in chips) 
Seat 6: tariko1980 ($24.34 in chips) 
SantiagoWeight: posts small blind $0.10
Jameson11: posts big blind $0.25
*** HOLE CARDS ***
Dealt to SantiagoWeight [Td Jd]
naxizzle: folds 
BRSOB79: folds 
tariko1980: folds 
KrishnaRadha: folds 
SantiagoWeight: raises $0.50 to $0.75
Jameson11: folds 
Uncalled bet ($0.50) returned to SantiagoWeight
SantiagoWeight collected $0.50 from pot
SantiagoWeight: doesn't show hand 
*** SUMMARY ***
Total pot $0.50 | Rake $0 
Seat 1: KrishnaRadha (button) folded before Flop (didn't bet)
Seat 2: SantiagoWeight (small blind) collected ($0.50)
Seat 3: Jameson11 (big blind) folded before Flop
Seat 4: naxizzle folded before Flop (didn't bet)
Seat 5: BRSOB79 folded before Flop (didn't bet)
Seat 6: tariko1980 folded before Flop (didn't bet)



PokerStars Zoom Hand #195024130648:  Hold'em No Limit ($0.10/$0.25) - 2018/12/29 4:18:29 UTC [2018/12/28 23:18:29 ET]
Table 'Hydra' 6-max Seat #1 is the button
Seat 1: razil_999 ($21.07 in chips) 
Seat 2: graysonai ($27.88 in chips) 
Seat 3: xonegab ($29.08 in chips) 
Seat 4: SantiagoWeight ($62.93 in chips) 
Seat 5: TDAK1509 ($39.15 in chips) 
Seat 6: qing328 ($23.24 in chips) 
graysonai: posts small blind $0.10
xonegab: posts big blind $0.25
*** HOLE CARDS ***
Dealt to SantiagoWeight [4s 8c]
SantiagoWeight: folds 
TDAK1509: folds 
qing328: folds 
razil_999: folds 
graysonai: raises $0.50 to $0.75
xonegab: calls $0.50
*** FLOP *** [2d 3h Ac]
graysonai: bets $0.47
xonegab: calls $0.47
*** TURN *** [2d 3h Ac] [6d]
graysonai: bets $2.56
xonegab: folds 
Uncalled bet ($2.56) returned to graysonai
graysonai collected $2.33 from pot
graysonai: doesn't show hand 
*** SUMMARY ***
Total pot $2.44 | Rake $0.11 
Board [2d 3h Ac 6d]
Seat 1: razil_999 (button) folded before Flop (didn't bet)
Seat 2: graysonai (small blind) collected ($2.33)
Seat 3: xonegab (big blind) folded on the Turn
Seat 4: SantiagoWeight folded before Flop (didn't bet)
Seat 5: TDAK1509 folded before Flop (didn't bet)
Seat 6: qing328 folded before Flop (didn't bet)



PokerStars Zoom Hand #195024144160:  Hold'em No Limit ($0.10/$0.25) - 2018/12/29 4:19:16 UTC [2018/12/28 23:19:16 ET]
Table 'Hydra' 6-max Seat #1 is the button
Seat 1: TQNYMQNTANA ($27.21 in chips) 
Seat 2: dan_iasi ($56.24 in chips) 
Seat 3: zbuci ($34.51 in chips) 
Seat 4: mariopork ($84.93 in chips) 
Seat 5: BIGPAIN14 ($33.31 in chips) 
Seat 6: SantiagoWeight ($63.18 in chips) 
dan_iasi: posts small blind $0.10
zbuci: posts big blind $0.25
*** HOLE CARDS ***
Dealt to SantiagoWeight [Js Jh]
mariopork: folds 
BIGPAIN14: folds 
SantiagoWeight: raises $0.30 to $0.55
TQNYMQNTANA: calls $0.55
dan_iasi: folds 
zbuci: folds 
*** FLOP *** [8c Qc 4c]
SantiagoWeight: bets $0.35
TQNYMQNTANA: folds 
Uncalled bet ($0.35) returned to SantiagoWeight
SantiagoWeight collected $1.38 from pot
SantiagoWeight: doesn't show hand 
*** SUMMARY ***
Total pot $1.45 | Rake $0.07 
Board [8c Qc 4c]
Seat 1: TQNYMQNTANA (button) folded on the Flop
Seat 2: dan_iasi (small blind) folded before Flop
Seat 3: zbuci (big blind) folded before Flop
Seat 4: mariopork folded before Flop (didn't bet)
Seat 5: BIGPAIN14 folded before Flop (didn't bet)
Seat 6: SantiagoWeight collected ($1.38)



PokerStars Zoom Hand #195024135776:  Hold'em No Limit ($0.10/$0.25) - 2018/12/29 4:18:47 UTC [2018/12/28 23:18:47 ET]
Table 'Hydra' 6-max Seat #1 is the button
Seat 1: !P0K3RM3T4L! ($25.91 in chips) 
Seat 2: 666erkan ($17.72 in chips) 
Seat 3: mililser ($24.64 in chips) 
Seat 4: graysonai ($25 in chips) 
Seat 5: GQwang ($47.37 in chips) 
Seat 6: SantiagoWeight ($63.18 in chips) 
666erkan: posts small blind $0.10
mililser: posts big blind $0.25
*** HOLE CARDS ***
Dealt to SantiagoWeight [2h 2c]
graysonai: folds 
GQwang: folds 
SantiagoWeight has timed out
SantiagoWeight: folds 
!P0K3RM3T4L!: raises $0.35 to $0.60
666erkan: calls $0.50
mililser: folds 
*** FLOP *** [2d 3h Kd]
666erkan: checks 
!P0K3RM3T4L!: bets $0.47
666erkan: calls $0.47
*** TURN *** [2d 3h Kd] [8c]
666erkan: checks 
!P0K3RM3T4L!: checks 
*** RIVER *** [2d 3h Kd 8c] [Ac]
666erkan: bets $2.28
!P0K3RM3T4L!: folds 
Uncalled bet ($2.28) returned to 666erkan
666erkan collected $2.28 from pot
666erkan: doesn't show hand 
*** SUMMARY ***
Total pot $2.39 | Rake $0.11 
Board [2d 3h Kd 8c Ac]
Seat 1: !P0K3RM3T4L! (button) folded on the River
Seat 2: 666erkan (small blind) collected ($2.28)
Seat 3: mililser (big blind) folded before Flop
Seat 4: graysonai folded before Flop (didn't bet)
Seat 5: GQwang folded before Flop (didn't bet)
Seat 6: SantiagoWeight folded before Flop (didn't bet)



PokerStars Zoom Hand #195024154354:  Hold'em No Limit ($0.10/$0.25) - 2018/12/29 4:19:51 UTC [2018/12/28 23:19:51 ET]
Table 'Hydra' 6-max Seat #1 is the button
Seat 1: Higashi2314 ($25 in chips) 
Seat 2: papico3 ($25 in chips) 
Seat 3: mililser ($24.29 in chips) 
Seat 4: razil_999 ($21.74 in chips) 
Seat 5: SantiagoWeight ($64.01 in chips) 
Seat 6: ruiken ($33.27 in chips) 
papico3: posts small blind $0.10
mililser: posts big blind $0.25
*** HOLE CARDS ***
Dealt to SantiagoWeight [Ks 8c]
razil_999: folds 
SantiagoWeight: folds 
ruiken: folds 
Higashi2314: folds 
papico3: raises $0.50 to $0.75
mililser: folds 
Uncalled bet ($0.50) returned to papico3
papico3 collected $0.50 from pot
papico3: doesn't show hand 
*** SUMMARY ***
Total pot $0.50 | Rake $0 
Seat 1: Higashi2314 (button) folded before Flop (didn't bet)
Seat 2: papico3 (small blind) collected ($0.50)
Seat 3: mililser (big blind) folded before Flop
Seat 4: razil_999 folded before Flop (didn't bet)
Seat 5: SantiagoWeight folded before Flop (didn't bet)
Seat 6: ruiken folded before Flop (didn't bet)



PokerStars Zoom Hand #195024161557:  Hold'em No Limit ($0.10/$0.25) - 2018/12/29 4:20:16 UTC [2018/12/28 23:20:16 ET]
Table 'Hydra' 6-max Seat #1 is the button
Seat 1: alex3d1985 ($14.86 in chips) 
Seat 2: SantiagoWeight ($63.76 in chips) 
Seat 3: Elapostador33 ($28.69 in chips) 
Seat 4: ryanking99 ($30.18 in chips) 
Seat 5: Chellabro ($15.09 in chips) 
Seat 6: 666erkan ($18.93 in chips) 
SantiagoWeight: posts small blind $0.10
Elapostador33: posts big blind $0.25
*** HOLE CARDS ***
Dealt to SantiagoWeight [3d Kc]
ryanking99: folds 
Chellabro: folds 
666erkan: folds 
alex3d1985: folds 
SantiagoWeight: folds 
Uncalled bet ($0.15) returned to Elapostador33
Elapostador33 collected $0.20 from pot
Elapostador33: doesn't show hand 
*** SUMMARY ***
Total pot $0.20 | Rake $0 
Seat 1: alex3d1985 (button) folded before Flop (didn't bet)
Seat 2: SantiagoWeight (small blind) folded before Flop
Seat 3: Elapostador33 (big blind) collected ($0.20)
Seat 4: ryanking99 folded before Flop (didn't bet)
Seat 5: Chellabro folded before Flop (didn't bet)
Seat 6: 666erkan folded before Flop (didn't bet)



PokerStars Zoom Hand #195024157201:  Hold'em No Limit ($0.10/$0.25) - 2018/12/29 4:20:01 UTC [2018/12/28 23:20:01 ET]
Table 'Hydra' 6-max Seat #1 is the button
Seat 1: Gonzalit0o ($25 in chips) 
Seat 2: Gongyong ($28.65 in chips) 
Seat 3: SantiagoWeight ($64.01 in chips) 
Seat 4: franco373513 ($12.52 in chips) 
Seat 5: TQNYMQNTANA ($26.41 in chips) 
Seat 6: anlu0803 ($14.44 in chips) 
Gongyong: posts small blind $0.10
SantiagoWeight: posts big blind $0.25
*** HOLE CARDS ***
Dealt to SantiagoWeight [4d 6s]
franco373513: calls $0.25
TQNYMQNTANA: folds 
anlu0803: folds 
Gonzalit0o: raises $0.50 to $0.75
Gongyong: folds 
SantiagoWeight: folds 
franco373513: calls $0.50
*** FLOP *** [Qh 7s 3h]
franco373513: checks 
Gonzalit0o: bets $0.75
franco373513: calls $0.75
*** TURN *** [Qh 7s 3h] [4s]
franco373513: checks 
Gonzalit0o: bets $3
franco373513: calls $3
*** RIVER *** [Qh 7s 3h 4s] [Jh]
franco373513: checks 
Gonzalit0o: checks 
*** SHOW DOWN ***
franco373513: shows [As 3s] (a pair of Threes)
Gonzalit0o: shows [Qd Ad] (a pair of Queens)
Gonzalit0o collected $8.93 from pot
*** SUMMARY ***
Total pot $9.35 | Rake $0.42 
Board [Qh 7s 3h 4s Jh]
Seat 1: Gonzalit0o (button) showed [Qd Ad] and won ($8.93) with a pair of Queens
Seat 2: Gongyong (small blind) folded before Flop
Seat 3: SantiagoWeight (big blind) folded before Flop
Seat 4: franco373513 showed [As 3s] and lost with a pair of Threes
Seat 5: TQNYMQNTANA folded before Flop (didn't bet)
Seat 6: anlu0803 folded before Flop (didn't bet)



PokerStars Zoom Hand #195024170129:  Hold'em No Limit ($0.10/$0.25) - 2018/12/29 4:20:46 UTC [2018/12/28 23:20:46 ET]
Table 'Hydra' 6-max Seat #1 is the button
Seat 1: sigaro010 ($40.51 in chips) 
Seat 2: MileVoliD49 ($27.74 in chips) 
Seat 3: qing328 ($19.66 in chips) 
Seat 4: SantiagoWeight ($63.66 in chips) 
Seat 5: Lehared ($39.81 in chips) 
Seat 6: TQNYMQNTANA ($25.96 in chips) 
MileVoliD49: posts small blind $0.10
qing328: posts big blind $0.25
*** HOLE CARDS ***
Dealt to SantiagoWeight [3h 7s]
SantiagoWeight: folds 
Lehared: folds 
TQNYMQNTANA: folds 
sigaro010: folds 
MileVoliD49: folds 
Uncalled bet ($0.15) returned to qing328
qing328 collected $0.20 from pot
qing328: doesn't show hand 
*** SUMMARY ***
Total pot $0.20 | Rake $0 
Seat 1: sigaro010 (button) folded before Flop (didn't bet)
Seat 2: MileVoliD49 (small blind) folded before Flop
Seat 3: qing328 (big blind) collected ($0.20)
Seat 4: SantiagoWeight folded before Flop (didn't bet)
Seat 5: Lehared folded before Flop (didn't bet)
Seat 6: TQNYMQNTANA folded before Flop (didn't bet)



PokerStars Zoom Hand #195024164998:  Hold'em No Limit ($0.10/$0.25) - 2018/12/29 4:20:28 UTC [2018/12/28 23:20:28 ET]
Table 'Hydra' 6-max Seat #1 is the button
Seat 1: nabechan814 ($26.85 in chips) 
Seat 2: 666erkan ($18.93 in chips) 
Seat 3: playazhate ($25 in chips) 
Seat 4: ivann14 ($25 in chips) 
Seat 5: SantiagoWeight ($63.66 in chips) 
Seat 6: mariopork ($39.37 in chips) 
666erkan: posts small blind $0.10
playazhate: posts big blind $0.25
*** HOLE CARDS ***
Dealt to SantiagoWeight [7s 5h]
ivann14: folds 
SantiagoWeight: folds 
mariopork: raises $0.37 to $0.62
nabechan814: folds 
666erkan: calls $0.52
playazhate: folds 
*** FLOP *** [Ks 5d Qh]
666erkan: checks 
mariopork: bets $0.47
666erkan: calls $0.47
*** TURN *** [Ks 5d Qh] [Kd]
666erkan: checks 
mariopork: checks 
*** RIVER *** [Ks 5d Qh Kd] [2s]
666erkan: checks 
mariopork: bets $0.70
666erkan: folds 
Uncalled bet ($0.70) returned to mariopork
mariopork collected $2.32 from pot
mariopork: doesn't show hand 
*** SUMMARY ***
Total pot $2.43 | Rake $0.11 
Board [Ks 5d Qh Kd 2s]
Seat 1: nabechan814 (button) folded before Flop (didn't bet)
Seat 2: 666erkan (small blind) folded on the River
Seat 3: playazhate (big blind) folded before Flop
Seat 4: ivann14 folded before Flop (didn't bet)
Seat 5: SantiagoWeight folded before Flop (didn't bet)
Seat 6: mariopork collected ($2.32)



PokerStars Zoom Hand #195024172987:  Hold'em No Limit ($0.10/$0.25) - 2018/12/29 4:20:56 UTC [2018/12/28 23:20:56 ET]
Table 'Hydra' 6-max Seat #1 is the button
Seat 1: playazhate ($25 in chips) 
Seat 2: Lehared ($27.50 in chips) 
Seat 3: killerB17 ($34.57 in chips) 
Seat 4: Nutselas ($84.75 in chips) 
Seat 5: SantiagoWeight ($63.66 in chips) 
Seat 6: heromn ($21.16 in chips) 
Lehared: posts small blind $0.10
killerB17: posts big blind $0.25
*** HOLE CARDS ***
Dealt to SantiagoWeight [5c 2h]
Nutselas: folds 
SantiagoWeight: folds 
heromn: folds 
playazhate: folds 
Lehared: folds 
Uncalled bet ($0.15) returned to killerB17
killerB17 collected $0.20 from pot
killerB17: doesn't show hand 
*** SUMMARY ***
Total pot $0.20 | Rake $0 
Seat 1: playazhate (button) folded before Flop (didn't bet)
Seat 2: Lehared (small blind) folded before Flop
Seat 3: killerB17 (big blind) collected ($0.20)
Seat 4: Nutselas folded before Flop (didn't bet)
Seat 5: SantiagoWeight folded before Flop (didn't bet)
Seat 6: heromn folded before Flop (didn't bet)



PokerStars Zoom Hand #195024166950:  Hold'em No Limit ($0.10/$0.25) - 2018/12/29 4:20:35 UTC [2018/12/28 23:20:35 ET]
Table 'Hydra' 6-max Seat #1 is the button
Seat 1: SantiagoWeight ($63.66 in chips) 
Seat 2: gustavotaina ($14.62 in chips) 
Seat 3: _BluDeeN_ ($24.25 in chips) 
Seat 4: Suit3dGapp3r ($25 in chips) 
Seat 5: --LeGaaNs-- ($80.82 in chips) 
Seat 6: Buntar017 ($15.39 in chips) 
gustavotaina: posts small blind $0.10
_BluDeeN_: posts big blind $0.25
*** HOLE CARDS ***
Dealt to SantiagoWeight [Kd 5d]
Suit3dGapp3r: raises $0.45 to $0.70
--LeGaaNs--: calls $0.70
Buntar017: calls $0.70
SantiagoWeight: folds 
gustavotaina: folds 
_BluDeeN_: folds 
*** FLOP *** [7s Td Ks]
Suit3dGapp3r: checks 
--LeGaaNs--: bets $1.17
Buntar017: calls $1.17
Suit3dGapp3r: folds 
*** TURN *** [7s Td Ks] [Ts]
--LeGaaNs--: checks 
Buntar017: bets $2.50
--LeGaaNs--: calls $2.50
*** RIVER *** [7s Td Ks Ts] [9s]
--LeGaaNs--: checks 
Buntar017: bets $11.02 and is all-in
--LeGaaNs--: folds 
Uncalled bet ($11.02) returned to Buntar017
Buntar017 collected $9.35 from pot
Buntar017: doesn't show hand 
*** SUMMARY ***
Total pot $9.79 | Rake $0.44 
Board [7s Td Ks Ts 9s]
Seat 1: SantiagoWeight (button) folded before Flop (didn't bet)
Seat 2: gustavotaina (small blind) folded before Flop
Seat 3: _BluDeeN_ (big blind) folded before Flop
Seat 4: Suit3dGapp3r folded on the Flop
Seat 5: --LeGaaNs-- folded on the River
Seat 6: Buntar017 collected ($9.35)



PokerStars Zoom Hand #195024177025:  Hold'em No Limit ($0.10/$0.25) - 2018/12/29 4:21:10 UTC [2018/12/28 23:21:10 ET]
Table 'Hydra' 6-max Seat #1 is the button
Seat 1: SantiagoWeight ($63.66 in chips) 
Seat 2: the_ablist7 ($18.96 in chips) 
Seat 3: mililser ($24.29 in chips) 
Seat 4: clashwizard23 ($37.74 in chips) 
Seat 5: cheolbeom ($28.14 in chips) 
Seat 6: _BluDeeN_ ($27.52 in chips) 
the_ablist7: posts small blind $0.10
mililser: posts big blind $0.25
*** HOLE CARDS ***
Dealt to SantiagoWeight [Ks Jc]
clashwizard23: raises $0.50 to $0.75
cheolbeom: folds 
_BluDeeN_: folds 
SantiagoWeight: raises $1.25 to $2
the_ablist7: calls $1.90
mililser: folds 
clashwizard23: folds 
*** FLOP *** [2c Qc 5s]
the_ablist7: checks 
SantiagoWeight: bets $1.20
the_ablist7: raises $1.55 to $2.75
SantiagoWeight: calls $1.55
*** TURN *** [2c Qc 5s] [Ts]
the_ablist7: checks 
SantiagoWeight: bets $12.04
the_ablist7: folds 
Uncalled bet ($12.04) returned to SantiagoWeight
SantiagoWeight collected $10.03 from pot
SantiagoWeight: doesn't show hand 
*** SUMMARY ***
Total pot $10.50 | Rake $0.47 
Board [2c Qc 5s Ts]
Seat 1: SantiagoWeight (button) collected ($10.03)
Seat 2: the_ablist7 (small blind) folded on the Turn
Seat 3: mililser (big blind) folded before Flop
Seat 4: clashwizard23 folded before Flop
Seat 5: cheolbeom folded before Flop (didn't bet)
Seat 6: _BluDeeN_ folded before Flop (didn't bet)



PokerStars Zoom Hand #195024196605:  Hold'em No Limit ($0.10/$0.25) - 2018/12/29 4:22:18 UTC [2018/12/28 23:22:18 ET]
Table 'Hydra' 6-max Seat #1 is the button
Seat 1: ttshead ($55.53 in chips) 
Seat 2: mariopork ($25.94 in chips) 
Seat 3: SantiagoWeight ($68.94 in chips) 
Seat 4: Renner32 ($31.42 in chips) 
Seat 5: MileVoliD49 ($25.73 in chips) 
Seat 6: TQNYMQNTANA ($27.29 in chips) 
mariopork: posts small blind $0.10
SantiagoWeight: posts big blind $0.25
*** HOLE CARDS ***
Dealt to SantiagoWeight [Kd 5c]
Renner32: folds 
MileVoliD49: raises $0.50 to $0.75
TQNYMQNTANA: folds 
ttshead: folds 
mariopork: folds 
SantiagoWeight: folds 
Uncalled bet ($0.50) returned to MileVoliD49
MileVoliD49 collected $0.60 from pot
MileVoliD49: doesn't show hand 
*** SUMMARY ***
Total pot $0.60 | Rake $0 
Seat 1: ttshead (button) folded before Flop (didn't bet)
Seat 2: mariopork (small blind) folded before Flop
Seat 3: SantiagoWeight (big blind) folded before Flop
Seat 4: Renner32 folded before Flop (didn't bet)
Seat 5: MileVoliD49 collected ($0.60)
Seat 6: TQNYMQNTANA folded before Flop (didn't bet)



PokerStars Zoom Hand #195024201018:  Hold'em No Limit ($0.10/$0.25) - 2018/12/29 4:22:33 UTC [2018/12/28 23:22:33 ET]
Table 'Hydra' 6-max Seat #1 is the button
Seat 1: aa1421b ($41.32 in chips) 
Seat 2: GrandmasterY ($25 in chips) 
Seat 3: pirosiky ($56.88 in chips) 
Seat 4: qing328 ($26.81 in chips) 
Seat 5: Mixxxxer599 ($26.41 in chips) 
Seat 6: SantiagoWeight ($68.69 in chips) 
GrandmasterY: posts small blind $0.10
pirosiky: posts big blind $0.25
*** HOLE CARDS ***
Dealt to SantiagoWeight [Qh 2c]
qing328: folds 
Mixxxxer599: raises $0.37 to $0.62
SantiagoWeight: folds 
aa1421b: folds 
GrandmasterY: folds 
pirosiky: calls $0.37
*** FLOP *** [7d 2s 6s]
pirosiky: checks 
Mixxxxer599: checks 
*** TURN *** [7d 2s 6s] [Jd]
pirosiky: checks 
Mixxxxer599: bets $0.76
pirosiky: calls $0.76
*** RIVER *** [7d 2s 6s Jd] [8s]
pirosiky: checks 
Mixxxxer599: checks 
*** SHOW DOWN ***
pirosiky: shows [7c 8c] (two pair, Eights and Sevens)
Mixxxxer599: mucks hand 
pirosiky collected $2.73 from pot
*** SUMMARY ***
Total pot $2.86 | Rake $0.13 
Board [7d 2s 6s Jd 8s]
Seat 1: aa1421b (button) folded before Flop (didn't bet)
Seat 2: GrandmasterY (small blind) folded before Flop
Seat 3: pirosiky (big blind) showed [7c 8c] and won ($2.73) with two pair, Eights and Sevens
Seat 4: qing328 folded before Flop (didn't bet)
Seat 5: Mixxxxer599 mucked [Th As]
Seat 6: SantiagoWeight folded before Flop (didn't bet)



PokerStars Zoom Hand #195024204793:  Hold'em No Limit ($0.10/$0.25) - 2018/12/29 4:22:46 UTC [2018/12/28 23:22:46 ET]
Table 'Hydra' 6-max Seat #1 is the button
Seat 1: mariopork ($25.94 in chips) 
Seat 2: SantiagoWeight ($68.69 in chips) 
Seat 3: ivann14 ($71.78 in chips) 
Seat 4: killerB17 ($34.67 in chips) 
Seat 5: dan_iasi ($86.96 in chips) 
Seat 6: Dbakunwaves ($61.70 in chips) 
SantiagoWeight: posts small blind $0.10
ivann14: posts big blind $0.25
*** HOLE CARDS ***
Dealt to SantiagoWeight [Kd As]
killerB17: folds 
dan_iasi: folds 
Dbakunwaves: calls $0.25
mariopork: folds 
SantiagoWeight: raises $1.15 to $1.40
ivann14: folds 
Dbakunwaves: folds 
Uncalled bet ($1.15) returned to SantiagoWeight
SantiagoWeight collected $0.75 from pot
SantiagoWeight: doesn't show hand 
*** SUMMARY ***
Total pot $0.75 | Rake $0 
Seat 1: mariopork (button) folded before Flop (didn't bet)
Seat 2: SantiagoWeight (small blind) collected ($0.75)
Seat 3: ivann14 (big blind) folded before Flop
Seat 4: killerB17 folded before Flop (didn't bet)
Seat 5: dan_iasi folded before Flop (didn't bet)
Seat 6: Dbakunwaves folded before Flop



PokerStars Zoom Hand #195024217509:  Hold'em No Limit ($0.10/$0.25) - 2018/12/29 4:23:30 UTC [2018/12/28 23:23:30 ET]
Table 'Hydra' 6-max Seat #1 is the button
Seat 1: anlu0803 ($29.69 in chips) 
Seat 2: Viiiru ($25.97 in chips) 
Seat 3: denisss1801 ($26.68 in chips) 
Seat 4: Lehared ($43.18 in chips) 
Seat 5: nabechan814 ($23.84 in chips) 
Seat 6: SantiagoWeight ($69.19 in chips) 
Viiiru: posts small blind $0.10
denisss1801: posts big blind $0.25
*** HOLE CARDS ***
Dealt to SantiagoWeight [5s 9s]
Lehared: folds 
nabechan814: folds 
SantiagoWeight: folds 
anlu0803: raises $0.25 to $0.50
Viiiru: folds 
denisss1801: folds 
Uncalled bet ($0.25) returned to anlu0803
anlu0803 collected $0.60 from pot
anlu0803: doesn't show hand 
*** SUMMARY ***
Total pot $0.60 | Rake $0 
Seat 1: anlu0803 (button) collected ($0.60)
Seat 2: Viiiru (small blind) folded before Flop
Seat 3: denisss1801 (big blind) folded before Flop
Seat 4: Lehared folded before Flop (didn't bet)
Seat 5: nabechan814 folded before Flop (didn't bet)
Seat 6: SantiagoWeight folded before Flop (didn't bet)



PokerStars Zoom Hand #195024218927:  Hold'em No Limit ($0.10/$0.25) - 2018/12/29 4:23:35 UTC [2018/12/28 23:23:35 ET]
Table 'Hydra' 6-max Seat #1 is the button
Seat 1: qing328 ($21.59 in chips) 
Seat 2: IMMPORT@L ($12.63 in chips) 
Seat 3: Gongyong ($28.23 in chips) 
Seat 4: SantiagoWeight ($69.19 in chips) 
Seat 5: skePokerske ($16.08 in chips) 
Seat 6: ritchy99 ($22.01 in chips) 
IMMPORT@L: posts small blind $0.10
Gongyong: posts big blind $0.25
*** HOLE CARDS ***
Dealt to SantiagoWeight [6s Jd]
SantiagoWeight: folds 
skePokerske: calls $0.25
ritchy99: folds 
qing328: folds 
IMMPORT@L: folds 
Gongyong: checks 
*** FLOP *** [Qh 8d Qc]
Gongyong: checks 
skePokerske: bets $2.61
Gongyong: folds 
Uncalled bet ($2.61) returned to skePokerske
skePokerske collected $0.57 from pot
skePokerske: doesn't show hand 
*** SUMMARY ***
Total pot $0.60 | Rake $0.03 
Board [Qh 8d Qc]
Seat 1: qing328 (button) folded before Flop (didn't bet)
Seat 2: IMMPORT@L (small blind) folded before Flop
Seat 3: Gongyong (big blind) folded on the Flop
Seat 4: SantiagoWeight folded before Flop (didn't bet)
Seat 5: skePokerske collected ($0.57)
Seat 6: ritchy99 folded before Flop (didn't bet)



PokerStars Zoom Hand #195024220066:  Hold'em No Limit ($0.10/$0.25) - 2018/12/29 4:23:39 UTC [2018/12/28 23:23:39 ET]
Table 'Hydra' 6-max Seat #1 is the button
Seat 1: nabechan814 ($22.29 in chips) 
Seat 2: dan_iasi ($40.70 in chips) 
Seat 3: IMMPORT@L ($12.53 in chips) 
Seat 4: SantiagoWeight ($69.19 in chips) 
Seat 5: LastNoma ($25 in chips) 
Seat 6: ruiken ($34.96 in chips) 
dan_iasi: posts small blind $0.10
IMMPORT@L: posts big blind $0.25
*** HOLE CARDS ***
Dealt to SantiagoWeight [3c 4h]
SantiagoWeight: folds 
LastNoma: raises $0.33 to $0.58
ruiken: folds 
nabechan814: calls $0.58
dan_iasi: folds 
IMMPORT@L: calls $0.33
*** FLOP *** [Ac Th Qd]
IMMPORT@L: checks 
LastNoma: checks 
nabechan814: bets $0.88
IMMPORT@L: folds 
LastNoma: folds 
Uncalled bet ($0.88) returned to nabechan814
nabechan814 collected $1.76 from pot
nabechan814: doesn't show hand 
*** SUMMARY ***
Total pot $1.84 | Rake $0.08 
Board [Ac Th Qd]
Seat 1: nabechan814 (button) collected ($1.76)
Seat 2: dan_iasi (small blind) folded before Flop
Seat 3: IMMPORT@L (big blind) folded on the Flop
Seat 4: SantiagoWeight folded before Flop (didn't bet)
Seat 5: LastNoma folded on the Flop
Seat 6: ruiken folded before Flop (didn't bet)



PokerStars Zoom Hand #195024223451:  Hold'em No Limit ($0.10/$0.25) - 2018/12/29 4:23:51 UTC [2018/12/28 23:23:51 ET]
Table 'Hydra' 6-max Seat #1 is the button
Seat 1: naxizzle ($107.23 in chips) 
Seat 2: papico3 ($26.46 in chips) 
Seat 3: SantiagoWeight ($69.19 in chips) 
Seat 4: paulieGB ($26.62 in chips) 
Seat 5: vulcandog ($9.03 in chips) 
Seat 6: louiskitu ($25.35 in chips) 
papico3: posts small blind $0.10
SantiagoWeight: posts big blind $0.25
*** HOLE CARDS ***
Dealt to SantiagoWeight [Td 2s]
paulieGB: folds 
vulcandog: folds 
louiskitu: folds 
naxizzle: raises $1.10 to $1.35
papico3: folds 
SantiagoWeight: folds 
Uncalled bet ($1.10) returned to naxizzle
naxizzle collected $0.60 from pot
naxizzle: doesn't show hand 
*** SUMMARY ***
Total pot $0.60 | Rake $0 
Seat 1: naxizzle (button) collected ($0.60)
Seat 2: papico3 (small blind) folded before Flop
Seat 3: SantiagoWeight (big blind) folded before Flop
Seat 4: paulieGB folded before Flop (didn't bet)
Seat 5: vulcandog folded before Flop (didn't bet)
Seat 6: louiskitu folded before Flop (didn't bet)



PokerStars Zoom Hand #195024231208:  Hold'em No Limit ($0.10/$0.25) - 2018/12/29 4:24:18 UTC [2018/12/28 23:24:18 ET]
Table 'Hydra' 6-max Seat #1 is the button
Seat 1: SantiagoWeight ($68.94 in chips) 
Seat 2: Bonen18 ($25 in chips) 
Seat 3: Chrimmpam ($30 in chips) 
Seat 4: Party4Arthy ($33.31 in chips) 
Seat 5: nabechan814 ($23.49 in chips) 
Seat 6: Dimvov ($9.71 in chips) 
Bonen18: posts small blind $0.10
Chrimmpam: posts big blind $0.25
*** HOLE CARDS ***
Dealt to SantiagoWeight [3h Qd]
Party4Arthy: folds 
nabechan814: folds 
Dimvov: folds 
SantiagoWeight: folds 
Bonen18: folds 
Uncalled bet ($0.15) returned to Chrimmpam
Chrimmpam collected $0.20 from pot
Chrimmpam: doesn't show hand 
*** SUMMARY ***
Total pot $0.20 | Rake $0 
Seat 1: SantiagoWeight (button) folded before Flop (didn't bet)
Seat 2: Bonen18 (small blind) folded before Flop
Seat 3: Chrimmpam (big blind) collected ($0.20)
Seat 4: Party4Arthy folded before Flop (didn't bet)
Seat 5: nabechan814 folded before Flop (didn't bet)
Seat 6: Dimvov folded before Flop (didn't bet)



PokerStars Zoom Hand #195024234286:  Hold'em No Limit ($0.10/$0.25) - 2018/12/29 4:24:29 UTC [2018/12/28 23:24:29 ET]
Table 'Hydra' 6-max Seat #1 is the button
Seat 1: denisss1801 ($25.98 in chips) 
Seat 2: SantiagoWeight ($68.94 in chips) 
Seat 3: Chrimmpam ($23.78 in chips) 
Seat 4: Lehared ($42.34 in chips) 
Seat 5: thecity1729 ($17.05 in chips) 
Seat 6: Breedijkie ($58.48 in chips) 
SantiagoWeight: posts small blind $0.10
Chrimmpam: posts big blind $0.25
*** HOLE CARDS ***
Dealt to SantiagoWeight [3c 2c]
Lehared: folds 
thecity1729: raises $0.25 to $0.50
Breedijkie: calls $0.50
denisss1801: folds 
SantiagoWeight: folds 
Chrimmpam: folds 
*** FLOP *** [9h 7s 5d]
thecity1729: checks 
Breedijkie: checks 
*** TURN *** [9h 7s 5d] [Ts]
thecity1729: checks 
Breedijkie: checks 
*** RIVER *** [9h 7s 5d Ts] [Th]
thecity1729: bets $16.55 and is all-in
Breedijkie: folds 
Uncalled bet ($16.55) returned to thecity1729
thecity1729 collected $1.29 from pot
thecity1729: doesn't show hand 
*** SUMMARY ***
Total pot $1.35 | Rake $0.06 
Board [9h 7s 5d Ts Th]
Seat 1: denisss1801 (button) folded before Flop (didn't bet)
Seat 2: SantiagoWeight (small blind) folded before Flop
Seat 3: Chrimmpam (big blind) folded before Flop
Seat 4: Lehared folded before Flop (didn't bet)
Seat 5: thecity1729 collected ($1.29)
Seat 6: Breedijkie folded on the River



PokerStars Zoom Hand #195024237956:  Hold'em No Limit ($0.10/$0.25) - 2018/12/29 4:24:42 UTC [2018/12/28 23:24:42 ET]
Table 'Hydra' 6-max Seat #1 is the button
Seat 1: janluise ($26.84 in chips) 
Seat 2: louiskitu ($24.60 in chips) 
Seat 3: SantiagoWeight ($68.84 in chips) 
Seat 4: cheolbeom ($27.07 in chips) 
Seat 5: Becks Baker ($49.49 in chips) 
Seat 6: Guard poker ($30.22 in chips) 
louiskitu: posts small blind $0.10
SantiagoWeight: posts big blind $0.25
*** HOLE CARDS ***
Dealt to SantiagoWeight [Th Jh]
cheolbeom: folds 
Becks Baker: raises $0.37 to $0.62
Guard poker: folds 
janluise: folds 
louiskitu: folds 
SantiagoWeight: calls $0.37
*** FLOP *** [Ac 5h Ah]
SantiagoWeight: checks 
Becks Baker: bets $0.64
SantiagoWeight: calls $0.64
*** TURN *** [Ac 5h Ah] [Jc]
SantiagoWeight: checks 
Becks Baker: checks 
*** RIVER *** [Ac 5h Ah Jc] [5c]
SantiagoWeight: bets $1.67
Becks Baker: folds 
Uncalled bet ($1.67) returned to SantiagoWeight
SantiagoWeight collected $2.50 from pot
SantiagoWeight: doesn't show hand 
*** SUMMARY ***
Total pot $2.62 | Rake $0.12 
Board [Ac 5h Ah Jc 5c]
Seat 1: janluise (button) folded before Flop (didn't bet)
Seat 2: louiskitu (small blind) folded before Flop
Seat 3: SantiagoWeight (big blind) collected ($2.50)
Seat 4: cheolbeom folded before Flop (didn't bet)
Seat 5: Becks Baker folded on the River
Seat 6: Guard poker folded before Flop (didn't bet)



PokerStars Zoom Hand #195024262770:  Hold'em No Limit ($0.10/$0.25) - 2018/12/29 4:26:09 UTC [2018/12/28 23:26:09 ET]
Table 'Hydra' 6-max Seat #1 is the button
Seat 1: cheolbeom ($41 in chips) 
Seat 2: ruiken ($35.32 in chips) 
Seat 3: glenn.vaughan ($23.90 in chips) 
Seat 4: SantiagoWeight ($70.08 in chips) 
Seat 5: Fobos113 ($24 in chips) 
Seat 6: mariopork ($25 in chips) 
ruiken: posts small blind $0.10
glenn.vaughan: posts big blind $0.25
*** HOLE CARDS ***
Dealt to SantiagoWeight [Td 7s]
SantiagoWeight: folds 
Fobos113: folds 
mariopork: folds 
cheolbeom: folds 
ruiken: folds 
Uncalled bet ($0.15) returned to glenn.vaughan
glenn.vaughan collected $0.20 from pot
glenn.vaughan: doesn't show hand 
*** SUMMARY ***
Total pot $0.20 | Rake $0 
Seat 1: cheolbeom (button) folded before Flop (didn't bet)
Seat 2: ruiken (small blind) folded before Flop
Seat 3: glenn.vaughan (big blind) collected ($0.20)
Seat 4: SantiagoWeight folded before Flop (didn't bet)
Seat 5: Fobos113 folded before Flop (didn't bet)
Seat 6: mariopork folded before Flop (didn't bet)



PokerStars Zoom Hand #195024260560:  Hold'em No Limit ($0.10/$0.25) - 2018/12/29 4:26:01 UTC [2018/12/28 23:26:01 ET]
Table 'Hydra' 6-max Seat #1 is the button
Seat 1: razil_999 ($23.27 in chips) 
Seat 2: zdenekstavic ($34.82 in chips) 
Seat 3: alex3d1985 ($10.38 in chips) 
Seat 4: TQNYMQNTANA ($27.18 in chips) 
Seat 5: SantiagoWeight ($70.08 in chips) 
Seat 6: zbuci ($77.76 in chips) 
zdenekstavic: posts small blind $0.10
alex3d1985: posts big blind $0.25
*** HOLE CARDS ***
Dealt to SantiagoWeight [2s 9h]
TQNYMQNTANA: folds 
SantiagoWeight: folds 
zbuci: calls $0.25
razil_999: folds 
zdenekstavic: folds 
alex3d1985: checks 
*** FLOP *** [9d 4c 4h]
alex3d1985: checks 
zbuci: checks 
*** TURN *** [9d 4c 4h] [Ad]
alex3d1985: checks 
zbuci: checks 
*** RIVER *** [9d 4c 4h Ad] [Ah]
alex3d1985: checks 
zbuci: checks 
*** SHOW DOWN ***
alex3d1985: shows [Jh 5h] (two pair, Aces and Fours)
zbuci: shows [6s Ks] (two pair, Aces and Fours - King kicker)
zbuci collected $0.57 from pot
*** SUMMARY ***
Total pot $0.60 | Rake $0.03 
Board [9d 4c 4h Ad Ah]
Seat 1: razil_999 (button) folded before Flop (didn't bet)
Seat 2: zdenekstavic (small blind) folded before Flop
Seat 3: alex3d1985 (big blind) showed [Jh 5h] and lost with two pair, Aces and Fours
Seat 4: TQNYMQNTANA folded before Flop (didn't bet)
Seat 5: SantiagoWeight folded before Flop (didn't bet)
Seat 6: zbuci showed [6s Ks] and won ($0.57) with two pair, Aces and Fours



PokerStars Zoom Hand #195024264204:  Hold'em No Limit ($0.10/$0.25) - 2018/12/29 4:26:14 UTC [2018/12/28 23:26:14 ET]
Table 'Hydra' 6-max Seat #1 is the button
Seat 1: SantiagoWeight ($70.08 in chips) 
Seat 2: dan_iasi ($125.85 in chips) 
Seat 3: G ster24 ($14.86 in chips) 
Seat 4: norwat ($31.24 in chips) 
Seat 5: cheolbeom ($41 in chips) 
Seat 6: Chellabro ($7.64 in chips) 
dan_iasi: posts small blind $0.10
G ster24: posts big blind $0.25
*** HOLE CARDS ***
Dealt to SantiagoWeight [5s 5h]
norwat: folds 
cheolbeom: folds 
Chellabro: calls $0.25
SantiagoWeight: calls $0.25
dan_iasi: calls $0.15
G ster24: checks 
*** FLOP *** [Jd Td Ts]
dan_iasi: checks 
G ster24: checks 
Chellabro: checks 
SantiagoWeight: checks 
*** TURN *** [Jd Td Ts] [3s]
dan_iasi: checks 
G ster24: checks 
Chellabro: checks 
SantiagoWeight: bets $0.50
dan_iasi: folds 
G ster24: folds 
Chellabro: folds 
Uncalled bet ($0.50) returned to SantiagoWeight
SantiagoWeight collected $0.96 from pot
SantiagoWeight: doesn't show hand 
*** SUMMARY ***
Total pot $1 | Rake $0.04 
Board [Jd Td Ts 3s]
Seat 1: SantiagoWeight (button) collected ($0.96)
Seat 2: dan_iasi (small blind) folded on the Turn
Seat 3: G ster24 (big blind) folded on the Turn
Seat 4: norwat folded before Flop (didn't bet)
Seat 5: cheolbeom folded before Flop (didn't bet)
Seat 6: Chellabro folded on the Turn



PokerStars Zoom Hand #195024282694:  Hold'em No Limit ($0.10/$0.25) - 2018/12/29 4:27:20 UTC [2018/12/28 23:27:20 ET]
Table 'Hydra' 6-max Seat #1 is the button
Seat 1: mililser ($20.64 in chips) 
Seat 2: SantiagoWeight ($70.79 in chips) 
Seat 3: Higashi2314 ($29.92 in chips) 
Seat 4: Wieb84 ($25.09 in chips) 
Seat 5: TQNYMQNTANA ($25 in chips) 
Seat 6: karbool ($22.24 in chips) 
SantiagoWeight: posts small blind $0.10
Higashi2314: posts big blind $0.25
*** HOLE CARDS ***
Dealt to SantiagoWeight [9s 6s]
Wieb84: folds 
TQNYMQNTANA: folds 
karbool: folds 
mililser: folds 
SantiagoWeight: raises $0.50 to $0.75
Higashi2314: calls $0.50
*** FLOP *** [7d 3h 4d]
SantiagoWeight: checks 
Higashi2314: checks 
*** TURN *** [7d 3h 4d] [5d]
SantiagoWeight: bets $0.70
Higashi2314: folds 
Uncalled bet ($0.70) returned to SantiagoWeight
SantiagoWeight collected $1.43 from pot
SantiagoWeight: doesn't show hand 
*** SUMMARY ***
Total pot $1.50 | Rake $0.07 
Board [7d 3h 4d 5d]
Seat 1: mililser (button) folded before Flop (didn't bet)
Seat 2: SantiagoWeight (small blind) collected ($1.43)
Seat 3: Higashi2314 (big blind) folded on the Turn
Seat 4: Wieb84 folded before Flop (didn't bet)
Seat 5: TQNYMQNTANA folded before Flop (didn't bet)
Seat 6: karbool folded before Flop (didn't bet)



PokerStars Zoom Hand #195024306439:  Hold'em No Limit ($0.10/$0.25) - 2018/12/29 4:28:12 UTC [2018/12/28 23:28:12 ET]
Table 'Hydra' 6-max Seat #1 is the button
Seat 1: ryanking99 ($51.31 in chips) 
Seat 2: G ster24 ($16.30 in chips) 
Seat 3: nabechan814 ($25.16 in chips) 
Seat 4: river plate9 ($39.70 in chips) 
Seat 5: lovintalbi ($84.29 in chips) 
Seat 6: SantiagoWeight ($71.47 in chips) 
G ster24: posts small blind $0.10
nabechan814: posts big blind $0.25
*** HOLE CARDS ***
Dealt to SantiagoWeight [6s 9d]
river plate9: folds 
lovintalbi: folds 
SantiagoWeight: folds 
ryanking99: folds 
G ster24: folds 
Uncalled bet ($0.15) returned to nabechan814
nabechan814 collected $0.20 from pot
nabechan814: doesn't show hand 
*** SUMMARY ***
Total pot $0.20 | Rake $0 
Seat 1: ryanking99 (button) folded before Flop (didn't bet)
Seat 2: G ster24 (small blind) folded before Flop
Seat 3: nabechan814 (big blind) collected ($0.20)
Seat 4: river plate9 folded before Flop (didn't bet)
Seat 5: lovintalbi folded before Flop (didn't bet)
Seat 6: SantiagoWeight folded before Flop (didn't bet)



PokerStars Zoom Hand #195024313938:  Hold'em No Limit ($0.10/$0.25) - 2018/12/29 4:28:38 UTC [2018/12/28 23:28:38 ET]
Table 'Hydra' 6-max Seat #1 is the button
Seat 1: Higashi2314 ($30.02 in chips) 
Seat 2: ineedmoeny ($23.65 in chips) 
Seat 3: gustavotaina ($13.72 in chips) 
Seat 4: Viiiru ($26 in chips) 
Seat 5: SantiagoWeight ($71.47 in chips) 
Seat 6: denisss1801 ($29.85 in chips) 
ineedmoeny: posts small blind $0.10
gustavotaina: posts big blind $0.25
*** HOLE CARDS ***
Dealt to SantiagoWeight [3c 7d]
Viiiru: raises $0.50 to $0.75
SantiagoWeight: folds 
denisss1801: folds 
Higashi2314: folds 
ineedmoeny: folds 
gustavotaina: folds 
Uncalled bet ($0.50) returned to Viiiru
Viiiru collected $0.60 from pot
Viiiru: doesn't show hand 
*** SUMMARY ***
Total pot $0.60 | Rake $0 
Seat 1: Higashi2314 (button) folded before Flop (didn't bet)
Seat 2: ineedmoeny (small blind) folded before Flop
Seat 3: gustavotaina (big blind) folded before Flop
Seat 4: Viiiru collected ($0.60)
Seat 5: SantiagoWeight folded before Flop (didn't bet)
Seat 6: denisss1801 folded before Flop (didn't bet)



PokerStars Zoom Hand #195024307890:  Hold'em No Limit ($0.10/$0.25) - 2018/12/29 4:28:17 UTC [2018/12/28 23:28:17 ET]
Table 'Hydra' 6-max Seat #1 is the button
Seat 1: anlu0803 ($28.95 in chips) 
Seat 2: Chrimmpam ($60.26 in chips) 
Seat 3: RoccoQc10 ($20.88 in chips) 
Seat 4: ryanking99 ($51.31 in chips) 
Seat 5: louiskitu ($22.76 in chips) 
Seat 6: SantiagoWeight ($71.47 in chips) 
Chrimmpam: posts small blind $0.10
RoccoQc10: posts big blind $0.25
*** HOLE CARDS ***
Dealt to SantiagoWeight [8c Qs]
ryanking99: folds 
louiskitu: folds 
SantiagoWeight: folds 
anlu0803: raises $0.25 to $0.50
Chrimmpam: folds 
RoccoQc10: calls $0.25
*** FLOP *** [Jh 2s 9c]
RoccoQc10: checks 
anlu0803: checks 
*** TURN *** [Jh 2s 9c] [7c]
RoccoQc10: checks 
anlu0803: bets $1
RoccoQc10: calls $1
*** RIVER *** [Jh 2s 9c 7c] [4c]
RoccoQc10: checks 
anlu0803: checks 
*** SHOW DOWN ***
RoccoQc10: shows [8h 8d] (a pair of Eights)
anlu0803: mucks hand 
RoccoQc10 collected $2.96 from pot
*** SUMMARY ***
Total pot $3.10 | Rake $0.14 
Board [Jh 2s 9c 7c 4c]
Seat 1: anlu0803 (button) mucked [4h 6h]
Seat 2: Chrimmpam (small blind) folded before Flop
Seat 3: RoccoQc10 (big blind) showed [8h 8d] and won ($2.96) with a pair of Eights
Seat 4: ryanking99 folded before Flop (didn't bet)
Seat 5: louiskitu folded before Flop (didn't bet)
Seat 6: SantiagoWeight folded before Flop (didn't bet)



PokerStars Zoom Hand #195024315604:  Hold'em No Limit ($0.10/$0.25) - 2018/12/29 4:28:44 UTC [2018/12/28 23:28:44 ET]
Table 'Hydra' 6-max Seat #1 is the button
Seat 1: ineedmoeny ($23.55 in chips) 
Seat 2: louiskitu ($23.51 in chips) 
Seat 3: SantiagoWeight ($71.47 in chips) 
Seat 4: razil_999 ($21.91 in chips) 
Seat 5: TQNYMQNTANA ($25.25 in chips) 
Seat 6: dk dreadlook ($23.55 in chips) 
louiskitu: posts small blind $0.10
SantiagoWeight: posts big blind $0.25
*** HOLE CARDS ***
Dealt to SantiagoWeight [7d 8c]
razil_999: folds 
TQNYMQNTANA: folds 
dk dreadlook: folds 
ineedmoeny: raises $0.50 to $0.75
louiskitu: calls $0.65
SantiagoWeight: folds 
*** FLOP *** [2d 4d Js]
louiskitu: checks 
ineedmoeny: bets $1
louiskitu: folds 
Uncalled bet ($1) returned to ineedmoeny
ineedmoeny collected $1.67 from pot
ineedmoeny: doesn't show hand 
*** SUMMARY ***
Total pot $1.75 | Rake $0.08 
Board [2d 4d Js]
Seat 1: ineedmoeny (button) collected ($1.67)
Seat 2: louiskitu (small blind) folded on the Flop
Seat 3: SantiagoWeight (big blind) folded before Flop
Seat 4: razil_999 folded before Flop (didn't bet)
Seat 5: TQNYMQNTANA folded before Flop (didn't bet)
Seat 6: dk dreadlook folded before Flop (didn't bet)



PokerStars Zoom Hand #195024328067:  Hold'em No Limit ($0.10/$0.25) - 2018/12/29 4:29:28 UTC [2018/12/28 23:29:28 ET]
Table 'Hydra' 6-max Seat #1 is the button
Seat 1: Viiiru ($26.70 in chips) 
Seat 2: ineedmoeny ($24.22 in chips) 
Seat 3: lovintalbi ($86.44 in chips) 
Seat 4: SantiagoWeight ($71.12 in chips) 
Seat 5: Nutselas ($91.58 in chips) 
Seat 6: xXBossHossXx ($27.80 in chips) 
ineedmoeny: posts small blind $0.10
lovintalbi: posts big blind $0.25
*** HOLE CARDS ***
Dealt to SantiagoWeight [Jh 4c]
SantiagoWeight: folds 
Nutselas: folds 
xXBossHossXx: folds 
Viiiru: folds 
ineedmoeny: folds 
Uncalled bet ($0.15) returned to lovintalbi
lovintalbi collected $0.20 from pot
lovintalbi: doesn't show hand 
*** SUMMARY ***
Total pot $0.20 | Rake $0 
Seat 1: Viiiru (button) folded before Flop (didn't bet)
Seat 2: ineedmoeny (small blind) folded before Flop
Seat 3: lovintalbi (big blind) collected ($0.20)
Seat 4: SantiagoWeight folded before Flop (didn't bet)
Seat 5: Nutselas folded before Flop (didn't bet)
Seat 6: xXBossHossXx folded before Flop (didn't bet)



PokerStars Zoom Hand #195024320171:  Hold'em No Limit ($0.10/$0.25) - 2018/12/29 4:29:00 UTC [2018/12/28 23:29:00 ET]
Table 'Hydra' 6-max Seat #1 is the button
Seat 1: Becks Baker ($24.15 in chips) 
Seat 2: SantiagoWeight ($71.22 in chips) 
Seat 3: Jameson11 ($12.80 in chips) 
Seat 4: kiteboard26 ($19.30 in chips) 
Seat 5: anlu0803 ($27.45 in chips) 
Seat 6: RoccoQc10 ($22.34 in chips) 
SantiagoWeight: posts small blind $0.10
Jameson11: posts big blind $0.25
*** HOLE CARDS ***
Dealt to SantiagoWeight [Kh 3s]
kiteboard26: raises $0.50 to $0.75
anlu0803: folds 
RoccoQc10: calls $0.75
Becks Baker: folds 
SantiagoWeight: folds 
Jameson11: folds 
*** FLOP *** [Jd 6c 3d]
kiteboard26: bets $1.77
RoccoQc10: calls $1.77
*** TURN *** [Jd 6c 3d] [5s]
kiteboard26: checks 
RoccoQc10: bets $2.50
kiteboard26: calls $2.50
*** RIVER *** [Jd 6c 3d 5s] [4h]
kiteboard26: bets $14.28 and is all-in
RoccoQc10: folds 
Uncalled bet ($14.28) returned to kiteboard26
kiteboard26 collected $9.92 from pot
kiteboard26: doesn't show hand 
*** SUMMARY ***
Total pot $10.39 | Rake $0.47 
Board [Jd 6c 3d 5s 4h]
Seat 1: Becks Baker (button) folded before Flop (didn't bet)
Seat 2: SantiagoWeight (small blind) folded before Flop
Seat 3: Jameson11 (big blind) folded before Flop
Seat 4: kiteboard26 collected ($9.92)
Seat 5: anlu0803 folded before Flop (didn't bet)
Seat 6: RoccoQc10 folded on the River



PokerStars Zoom Hand #195024326065:  Hold'em No Limit ($0.10/$0.25) - 2018/12/29 4:29:21 UTC [2018/12/28 23:29:21 ET]
Table 'Hydra' 6-max Seat #1 is the button
Seat 1: SantiagoWeight ($71.12 in chips) 
Seat 2: mariopork ($42.19 in chips) 
Seat 3: Breedijkie ($50.58 in chips) 
Seat 4: louiskitu ($22.76 in chips) 
Seat 5: cankum ($30.41 in chips) 
Seat 6: qing328 ($22.90 in chips) 
mariopork: posts small blind $0.10
Breedijkie: posts big blind $0.25
*** HOLE CARDS ***
Dealt to SantiagoWeight [2h 3s]
louiskitu: raises $0.50 to $0.75
cankum: calls $0.75
qing328: folds 
SantiagoWeight: folds 
mariopork: folds 
Breedijkie: folds 
*** FLOP *** [5d 9d 9s]
louiskitu: bets $0.89
cankum: raises $0.89 to $1.78
louiskitu: calls $0.89
*** TURN *** [5d 9d 9s] [Kd]
louiskitu: checks 
cankum: bets $2
louiskitu: folds 
Uncalled bet ($2) returned to cankum
cankum collected $5.17 from pot
cankum: doesn't show hand 
*** SUMMARY ***
Total pot $5.41 | Rake $0.24 
Board [5d 9d 9s Kd]
Seat 1: SantiagoWeight (button) folded before Flop (didn't bet)
Seat 2: mariopork (small blind) folded before Flop
Seat 3: Breedijkie (big blind) folded before Flop
Seat 4: louiskitu folded on the Turn
Seat 5: cankum collected ($5.17)
Seat 6: qing328 folded before Flop (didn't bet)



PokerStars Zoom Hand #195024330842:  Hold'em No Limit ($0.10/$0.25) - 2018/12/29 4:29:38 UTC [2018/12/28 23:29:38 ET]
Table 'Hydra' 6-max Seat #1 is the button
Seat 1: Gonzalit0o ($28.33 in chips) 
Seat 2: jyujyu1326 ($17.05 in chips) 
Seat 3: SantiagoWeight ($71.12 in chips) 
Seat 4: bestitest542 ($41.02 in chips) 
Seat 5: zbuci ($77.60 in chips) 
Seat 6: Fobos113 ($22.60 in chips) 
jyujyu1326: posts small blind $0.10
SantiagoWeight: posts big blind $0.25
*** HOLE CARDS ***
Dealt to SantiagoWeight [Ac 2h]
bestitest542: folds 
zbuci: folds 
Fobos113: raises $0.50 to $0.75
Gonzalit0o: folds 
jyujyu1326: folds 
SantiagoWeight: folds 
Uncalled bet ($0.50) returned to Fobos113
Fobos113 collected $0.60 from pot
*** SUMMARY ***
Total pot $0.60 | Rake $0 
Seat 1: Gonzalit0o (button) folded before Flop (didn't bet)
Seat 2: jyujyu1326 (small blind) folded before Flop
Seat 3: SantiagoWeight (big blind) folded before Flop
Seat 4: bestitest542 folded before Flop (didn't bet)
Seat 5: zbuci folded before Flop (didn't bet)
Seat 6: Fobos113 collected ($0.60)



PokerStars Zoom Hand #195024329699:  Hold'em No Limit ($0.10/$0.25) - 2018/12/29 4:29:34 UTC [2018/12/28 23:29:34 ET]
Table 'Hydra' 6-max Seat #1 is the button
Seat 1: ricpoitras ($25 in chips) 
Seat 2: Aco80 ($29.10 in chips) 
Seat 3: river plate9 ($40.72 in chips) 
Seat 4: mariopork ($36.05 in chips) 
Seat 5: SantiagoWeight ($71.12 in chips) 
Seat 6: Bonen18 ($32.51 in chips) 
Aco80: posts small blind $0.10
river plate9: posts big blind $0.25
*** HOLE CARDS ***
Dealt to SantiagoWeight [2d 7d]
mariopork: raises $0.50 to $0.75
SantiagoWeight: folds 
Bonen18: folds 
ricpoitras: folds 
Aco80: folds 
river plate9: calls $0.50
*** FLOP *** [5c 8d 9h]
river plate9: checks 
mariopork: bets $0.50
river plate9: calls $0.50
*** TURN *** [5c 8d 9h] [6h]
river plate9: checks 
mariopork: checks 
*** RIVER *** [5c 8d 9h 6h] [Jh]
river plate9: checks 
mariopork: bets $1
river plate9: calls $1
*** SHOW DOWN ***
mariopork: shows [Tc Td] (a pair of Tens)
river plate9: mucks hand 
mariopork collected $4.39 from pot
*** SUMMARY ***
Total pot $4.60 | Rake $0.21 
Board [5c 8d 9h 6h Jh]
Seat 1: ricpoitras (button) folded before Flop (didn't bet)
Seat 2: Aco80 (small blind) folded before Flop
Seat 3: river plate9 (big blind) mucked [3c 3d]
Seat 4: mariopork showed [Tc Td] and won ($4.39) with a pair of Tens
Seat 5: SantiagoWeight folded before Flop (didn't bet)
Seat 6: Bonen18 folded before Flop (didn't bet)



PokerStars Zoom Hand #195024339882:  Hold'em No Limit ($0.10/$0.25) - 2018/12/29 4:30:10 UTC [2018/12/28 23:30:10 ET]
Table 'Hydra' 6-max Seat #1 is the button
Seat 1: SantiagoWeight ($70.87 in chips) 
Seat 2: Suit3dGapp3r ($26.38 in chips) 
Seat 3: Chellabro ($9.25 in chips) 
Seat 4: ttshead ($69.02 in chips) 
Seat 5: Gonzalit0o ($27.50 in chips) 
Seat 6: Aco80 ($35.90 in chips) 
Suit3dGapp3r: posts small blind $0.10
Chellabro: posts big blind $0.25
*** HOLE CARDS ***
Dealt to SantiagoWeight [8c 4s]
ttshead: raises $0.43 to $0.68
Gonzalit0o: calls $0.68
Aco80: folds 
SantiagoWeight: folds 
Suit3dGapp3r: folds 
Chellabro: folds 
*** FLOP *** [5c 3s 6c]
ttshead: bets $0.73
Gonzalit0o: calls $0.73
*** TURN *** [5c 3s 6c] [4d]
ttshead: checks 
Gonzalit0o: bets $1
ttshead: calls $1
*** RIVER *** [5c 3s 6c 4d] [Ac]
ttshead: checks 
Gonzalit0o: bets $3.71
ttshead: folds 
Uncalled bet ($3.71) returned to Gonzalit0o
Gonzalit0o collected $4.94 from pot
Gonzalit0o: doesn't show hand 
*** SUMMARY ***
Total pot $5.17 | Rake $0.23 
Board [5c 3s 6c 4d Ac]
Seat 1: SantiagoWeight (button) folded before Flop (didn't bet)
Seat 2: Suit3dGapp3r (small blind) folded before Flop
Seat 3: Chellabro (big blind) folded before Flop
Seat 4: ttshead folded on the River
Seat 5: Gonzalit0o collected ($4.94)
Seat 6: Aco80 folded before Flop (didn't bet)



PokerStars Zoom Hand #195024345984:  Hold'em No Limit ($0.10/$0.25) - 2018/12/29 4:30:32 UTC [2018/12/28 23:30:32 ET]
Table 'Hydra' 6-max Seat #1 is the button
Seat 1: Renner32 ($59.26 in chips) 
Seat 2: zdenekstavic ($31.57 in chips) 
Seat 3: Jameson11 ($12.80 in chips) 
Seat 4: Zaebca ($20.65 in chips) 
Seat 5: SantiagoWeight ($70.77 in chips) 
Seat 6: zaneti8722 ($23.30 in chips) 
zdenekstavic: posts small blind $0.10
Jameson11: posts big blind $0.25
*** HOLE CARDS ***
Dealt to SantiagoWeight [Ad 9c]
Zaebca: raises $0.50 to $0.75
SantiagoWeight has timed out
SantiagoWeight: folds 
zaneti8722: folds 
Renner32: folds 
zdenekstavic: folds 
Jameson11: folds 
Uncalled bet ($0.50) returned to Zaebca
Zaebca collected $0.60 from pot
Zaebca: doesn't show hand 
*** SUMMARY ***
Total pot $0.60 | Rake $0 
Seat 1: Renner32 (button) folded before Flop (didn't bet)
Seat 2: zdenekstavic (small blind) folded before Flop
Seat 3: Jameson11 (big blind) folded before Flop
Seat 4: Zaebca collected ($0.60)
Seat 5: SantiagoWeight folded before Flop (didn't bet)
Seat 6: zaneti8722 folded before Flop (didn't bet)



PokerStars Zoom Hand #195024342924:  Hold'em No Limit ($0.10/$0.25) - 2018/12/29 4:30:21 UTC [2018/12/28 23:30:21 ET]
Table 'Hydra' 6-max Seat #1 is the button
Seat 1: leoval1010 ($31.14 in chips) 
Seat 2: SantiagoWeight ($70.87 in chips) 
Seat 3: onhoang87 ($22.56 in chips) 
Seat 4: xonegab ($38.18 in chips) 
Seat 5: Gonzalit0o ($34 in chips) 
Seat 6: Suit3dGapp3r ($26.28 in chips) 
SantiagoWeight: posts small blind $0.10
onhoang87: posts big blind $0.25
*** HOLE CARDS ***
Dealt to SantiagoWeight [Qs 5c]
xonegab: calls $0.25
Gonzalit0o: folds 
Suit3dGapp3r: raises $0.85 to $1.10
leoval1010: folds 
SantiagoWeight: folds 
onhoang87: folds 
xonegab: calls $0.85
*** FLOP *** [9d Tc 8h]
xonegab: checks 
Suit3dGapp3r: checks 
*** TURN *** [9d Tc 8h] [Th]
xonegab: bets $1.25
Suit3dGapp3r: folds 
Uncalled bet ($1.25) returned to xonegab
xonegab collected $2.44 from pot
xonegab: doesn't show hand 
*** SUMMARY ***
Total pot $2.55 | Rake $0.11 
Board [9d Tc 8h Th]
Seat 1: leoval1010 (button) folded before Flop (didn't bet)
Seat 2: SantiagoWeight (small blind) folded before Flop
Seat 3: onhoang87 (big blind) folded before Flop
Seat 4: xonegab collected ($2.44)
Seat 5: Gonzalit0o folded before Flop (didn't bet)
Seat 6: Suit3dGapp3r folded on the Turn



PokerStars Zoom Hand #195024358113:  Hold'em No Limit ($0.10/$0.25) - 2018/12/29 4:31:15 UTC [2018/12/28 23:31:15 ET]
Table 'Hydra' 6-max Seat #1 is the button
Seat 1: Mixxxxer599 ($22.57 in chips) 
Seat 2: cheolbeom ($39.65 in chips) 
Seat 3: onhoang87 ($24.14 in chips) 
Seat 4: SantiagoWeight ($70.77 in chips) 
Seat 5: ineedmoeny ($22.30 in chips) 
Seat 6: !P0K3RM3T4L! ($25 in chips) 
cheolbeom: posts small blind $0.10
onhoang87: posts big blind $0.25
*** HOLE CARDS ***
Dealt to SantiagoWeight [5s 7c]
SantiagoWeight: folds 
ineedmoeny: folds 
!P0K3RM3T4L!: folds 
Mixxxxer599: raises $0.37 to $0.62
cheolbeom: folds 
onhoang87: calls $0.37
*** FLOP *** [4h 9s Th]
onhoang87: checks 
Mixxxxer599: bets $0.62
onhoang87: folds 
Uncalled bet ($0.62) returned to Mixxxxer599
Mixxxxer599 collected $1.28 from pot
Mixxxxer599: doesn't show hand 
*** SUMMARY ***
Total pot $1.34 | Rake $0.06 
Board [4h 9s Th]
Seat 1: Mixxxxer599 (button) collected ($1.28)
Seat 2: cheolbeom (small blind) folded before Flop
Seat 3: onhoang87 (big blind) folded on the Flop
Seat 4: SantiagoWeight folded before Flop (didn't bet)
Seat 5: ineedmoeny folded before Flop (didn't bet)
Seat 6: !P0K3RM3T4L! folded before Flop (didn't bet)



PokerStars Zoom Hand #195024359217:  Hold'em No Limit ($0.10/$0.25) - 2018/12/29 4:31:19 UTC [2018/12/28 23:31:19 ET]
Table 'Hydra' 6-max Seat #1 is the button
Seat 1: Lehared ($25 in chips) 
Seat 2: louiskitu ($21.68 in chips) 
Seat 3: reggiedogg31 ($121.25 in chips) 
Seat 4: cheolbeom ($31.33 in chips) 
Seat 5: mililser ($18.77 in chips) 
Seat 6: SantiagoWeight ($70.77 in chips) 
louiskitu: posts small blind $0.10
reggiedogg31: posts big blind $0.25
*** HOLE CARDS ***
Dealt to SantiagoWeight [5c 2d]
cheolbeom: folds 
mililser: folds 
SantiagoWeight: folds 
Lehared: raises $0.37 to $0.62
louiskitu: folds 
reggiedogg31: calls $0.37
*** FLOP *** [5s Kd Qd]
reggiedogg31: checks 
Lehared: checks 
*** TURN *** [5s Kd Qd] [Tc]
reggiedogg31: bets $0.50
Lehared: folds 
Uncalled bet ($0.50) returned to reggiedogg31
reggiedogg31 collected $1.28 from pot
reggiedogg31: doesn't show hand 
*** SUMMARY ***
Total pot $1.34 | Rake $0.06 
Board [5s Kd Qd Tc]
Seat 1: Lehared (button) folded on the Turn
Seat 2: louiskitu (small blind) folded before Flop
Seat 3: reggiedogg31 (big blind) collected ($1.28)
Seat 4: cheolbeom folded before Flop (didn't bet)
Seat 5: mililser folded before Flop (didn't bet)
Seat 6: SantiagoWeight folded before Flop (didn't bet)



PokerStars Zoom Hand #195024355851:  Hold'em No Limit ($0.10/$0.25) - 2018/12/29 4:31:07 UTC [2018/12/28 23:31:07 ET]
Table 'Hydra' 6-max Seat #1 is the button
Seat 1: deaglepro ($51.86 in chips) 
Seat 2: ineedmoeny ($22.40 in chips) 
Seat 3: Splodge86 ($22.90 in chips) 
Seat 4: clashwizard23 ($27.67 in chips) 
Seat 5: hamen1990 ($24.95 in chips) 
Seat 6: SantiagoWeight ($70.77 in chips) 
ineedmoeny: posts small blind $0.10
Splodge86: posts big blind $0.25
*** HOLE CARDS ***
Dealt to SantiagoWeight [Qc 7c]
clashwizard23: folds 
hamen1990: raises $0.50 to $0.75
SantiagoWeight: folds 
deaglepro: folds 
ineedmoeny: folds 
Splodge86: calls $0.50
*** FLOP *** [Js Kh 9c]
Splodge86: checks 
hamen1990: bets $1
Splodge86: folds 
Uncalled bet ($1) returned to hamen1990
hamen1990 collected $1.53 from pot
hamen1990: doesn't show hand 
*** SUMMARY ***
Total pot $1.60 | Rake $0.07 
Board [Js Kh 9c]
Seat 1: deaglepro (button) folded before Flop (didn't bet)
Seat 2: ineedmoeny (small blind) folded before Flop
Seat 3: Splodge86 (big blind) folded on the Flop
Seat 4: clashwizard23 folded before Flop (didn't bet)
Seat 5: hamen1990 collected ($1.53)
Seat 6: SantiagoWeight folded before Flop (didn't bet)



PokerStars Zoom Hand #195024360313:  Hold'em No Limit ($0.10/$0.25) - 2018/12/29 4:31:23 UTC [2018/12/28 23:31:23 ET]
Table 'Hydra' 6-max Seat #1 is the button
Seat 1: trttt74 ($59.18 in chips) 
Seat 2: Bonen18 ($26.68 in chips) 
Seat 3: SantiagoWeight ($70.77 in chips) 
Seat 4: mililser ($18.77 in chips) 
Seat 5: gustavotaina ($17.44 in chips) 
Seat 6: anlu0803 ($26.02 in chips) 
Bonen18: posts small blind $0.10
SantiagoWeight: posts big blind $0.25
*** HOLE CARDS ***
Dealt to SantiagoWeight [5c Kc]
mililser: folds 
gustavotaina: raises $0.75 to $1
anlu0803: calls $1
trttt74: folds 
Bonen18: folds 
SantiagoWeight: folds 
*** FLOP *** [8d Qs 3s]
gustavotaina: bets $1
anlu0803: folds 
Uncalled bet ($1) returned to gustavotaina
gustavotaina collected $2.24 from pot
gustavotaina: doesn't show hand 
*** SUMMARY ***
Total pot $2.35 | Rake $0.11 
Board [8d Qs 3s]
Seat 1: trttt74 (button) folded before Flop (didn't bet)
Seat 2: Bonen18 (small blind) folded before Flop
Seat 3: SantiagoWeight (big blind) folded before Flop
Seat 4: mililser folded before Flop (didn't bet)
Seat 5: gustavotaina collected ($2.24)
Seat 6: anlu0803 folded on the Flop



PokerStars Zoom Hand #195024366207:  Hold'em No Limit ($0.10/$0.25) - 2018/12/29 4:31:44 UTC [2018/12/28 23:31:44 ET]
Table 'Hydra' 6-max Seat #1 is the button
Seat 1: SantiagoWeight ($70.52 in chips) 
Seat 2: Viiiru ($37.45 in chips) 
Seat 3: ritchy99 ($25.07 in chips) 
Seat 4: mariopork ($25 in chips) 
Seat 5: Sco0oter ($23.62 in chips) 
Seat 6: Lehared ($25 in chips) 
Viiiru: posts small blind $0.10
ritchy99: posts big blind $0.25
*** HOLE CARDS ***
Dealt to SantiagoWeight [6d 6h]
mariopork: folds 
Sco0oter: folds 
Lehared: folds 
SantiagoWeight: raises $0.30 to $0.55
Viiiru: folds 
ritchy99: folds 
Uncalled bet ($0.30) returned to SantiagoWeight
SantiagoWeight collected $0.60 from pot
SantiagoWeight: doesn't show hand 
*** SUMMARY ***
Total pot $0.60 | Rake $0 
Seat 1: SantiagoWeight (button) collected ($0.60)
Seat 2: Viiiru (small blind) folded before Flop
Seat 3: ritchy99 (big blind) folded before Flop
Seat 4: mariopork folded before Flop (didn't bet)
Seat 5: Sco0oter folded before Flop (didn't bet)
Seat 6: Lehared folded before Flop (didn't bet)



PokerStars Zoom Hand #195024372611:  Hold'em No Limit ($0.10/$0.25) - 2018/12/29 4:32:07 UTC [2018/12/28 23:32:07 ET]
Table 'Hydra' 6-max Seat #1 is the button
Seat 1: Suit3dGapp3r ($26.33 in chips) 
Seat 2: xonegab ($36.98 in chips) 
Seat 3: janluise ($28.90 in chips) 
Seat 4: Zaebca ($21 in chips) 
Seat 5: SantiagoWeight ($70.87 in chips) 
Seat 6: cheolbeom ($25 in chips) 
xonegab: posts small blind $0.10
janluise: posts big blind $0.25
*** HOLE CARDS ***
Dealt to SantiagoWeight [Js Kh]
Zaebca: folds 
SantiagoWeight: raises $0.37 to $0.62
cheolbeom: folds 
Suit3dGapp3r: folds 
xonegab: calls $0.52
janluise: folds 
*** FLOP *** [Qd Ad 6d]
xonegab: bets $0.75
SantiagoWeight: folds 
Uncalled bet ($0.75) returned to xonegab
xonegab collected $1.42 from pot
*** SUMMARY ***
Total pot $1.49 | Rake $0.07 
Board [Qd Ad 6d]
Seat 1: Suit3dGapp3r (button) folded before Flop (didn't bet)
Seat 2: xonegab (small blind) collected ($1.42)
Seat 3: janluise (big blind) folded before Flop
Seat 4: Zaebca folded before Flop (didn't bet)
Seat 5: SantiagoWeight folded on the Flop
Seat 6: cheolbeom folded before Flop (didn't bet)



PokerStars Zoom Hand #195024377711:  Hold'em No Limit ($0.10/$0.25) - 2018/12/29 4:32:25 UTC [2018/12/28 23:32:25 ET]
Table 'Hydra' 6-max Seat #1 is the button
Seat 1: FarrOut1 ($8.12 in chips) 
Seat 2: SantiagoWeight ($70.25 in chips) 
Seat 3: zdenekstavic ($31.83 in chips) 
Seat 4: trttt74 ($60.57 in chips) 
Seat 5: bestitest542 ($41.40 in chips) 
Seat 6: louiskitu ($38.31 in chips) 
SantiagoWeight: posts small blind $0.10
zdenekstavic: posts big blind $0.25
*** HOLE CARDS ***
Dealt to SantiagoWeight [2s Ad]
trttt74: raises $0.60 to $0.85
bestitest542: folds 
louiskitu: folds 
FarrOut1: folds 
SantiagoWeight: folds 
zdenekstavic: calls $0.60
*** FLOP *** [4d Td Qd]
zdenekstavic: checks 
trttt74: bets $0.72
zdenekstavic: calls $0.72
*** TURN *** [4d Td Qd] [5d]
zdenekstavic: checks 
trttt74: checks 
*** RIVER *** [4d Td Qd 5d] [5c]
zdenekstavic: bets $0.75
trttt74: calls $0.75
*** SHOW DOWN ***
zdenekstavic: shows [Ts Jd] (a flush, Queen high)
trttt74: mucks hand 
zdenekstavic collected $4.53 from pot
*** SUMMARY ***
Total pot $4.74 | Rake $0.21 
Board [4d Td Qd 5d 5c]
Seat 1: FarrOut1 (button) folded before Flop (didn't bet)
Seat 2: SantiagoWeight (small blind) folded before Flop
Seat 3: zdenekstavic (big blind) showed [Ts Jd] and won ($4.53) with a flush, Queen high
Seat 4: trttt74 mucked [8h 8c]
Seat 5: bestitest542 folded before Flop (didn't bet)
Seat 6: louiskitu folded before Flop (didn't bet)



PokerStars Zoom Hand #195024384794:  Hold'em No Limit ($0.10/$0.25) - 2018/12/29 4:32:50 UTC [2018/12/28 23:32:50 ET]
Table 'Hydra' 6-max Seat #1 is the button
Seat 1: Lehared ($25.10 in chips) 
Seat 2: louiskitu ($21.33 in chips) 
Seat 3: Shiltz17 ($16 in chips) 
Seat 4: papico3 ($25 in chips) 
Seat 5: RESTRICTED.CR17 ($36.22 in chips) 
Seat 6: SantiagoWeight ($70.15 in chips) 
louiskitu: posts small blind $0.10
Shiltz17: posts big blind $0.25
*** HOLE CARDS ***
Dealt to SantiagoWeight [6c Kh]
papico3: folds 
RESTRICTED.CR17: folds 
SantiagoWeight: folds 
Lehared: folds 
louiskitu: raises $0.50 to $0.75
Shiltz17: folds 
Uncalled bet ($0.50) returned to louiskitu
louiskitu collected $0.50 from pot
louiskitu: doesn't show hand 
*** SUMMARY ***
Total pot $0.50 | Rake $0 
Seat 1: Lehared (button) folded before Flop (didn't bet)
Seat 2: louiskitu (small blind) collected ($0.50)
Seat 3: Shiltz17 (big blind) folded before Flop
Seat 4: papico3 folded before Flop (didn't bet)
Seat 5: RESTRICTED.CR17 folded before Flop (didn't bet)
Seat 6: SantiagoWeight folded before Flop (didn't bet)



PokerStars Zoom Hand #195024383368:  Hold'em No Limit ($0.10/$0.25) - 2018/12/29 4:32:45 UTC [2018/12/28 23:32:45 ET]
Table 'Hydra' 6-max Seat #1 is the button
Seat 1: uggsthelad ($19.56 in chips) 
Seat 2: RESTRICTED.CR17 ($36.32 in chips) 
Seat 3: zaneti8722 ($23.70 in chips) 
Seat 4: graysonai ($39.92 in chips) 
Seat 5: SantiagoWeight ($70.15 in chips) 
Seat 6: abbi555 ($42.33 in chips) 
RESTRICTED.CR17: posts small blind $0.10
zaneti8722: posts big blind $0.25
*** HOLE CARDS ***
Dealt to SantiagoWeight [2s 9c]
graysonai: folds 
SantiagoWeight: folds 
abbi555: raises $0.25 to $0.50
uggsthelad: raises $1.85 to $2.35
RESTRICTED.CR17: folds 
zaneti8722: folds 
abbi555: folds 
Uncalled bet ($1.85) returned to uggsthelad
uggsthelad collected $1.35 from pot
uggsthelad: doesn't show hand 
*** SUMMARY ***
Total pot $1.35 | Rake $0 
Seat 1: uggsthelad (button) collected ($1.35)
Seat 2: RESTRICTED.CR17 (small blind) folded before Flop
Seat 3: zaneti8722 (big blind) folded before Flop
Seat 4: graysonai folded before Flop (didn't bet)
Seat 5: SantiagoWeight folded before Flop (didn't bet)
Seat 6: abbi555 folded before Flop



PokerStars Zoom Hand #195024390053:  Hold'em No Limit ($0.10/$0.25) - 2018/12/29 4:33:09 UTC [2018/12/28 23:33:09 ET]
Table 'Hydra' 6-max Seat #1 is the button
Seat 1: trttt74 ($31.02 in chips) 
Seat 2: cankum ($29.54 in chips) 
Seat 3: SantiagoWeight ($70.15 in chips) 
Seat 4: Nutselas ($39.61 in chips) 
Seat 5: FarrOut1 ($8.12 in chips) 
Seat 6: mariopork ($26.04 in chips) 
cankum: posts small blind $0.10
SantiagoWeight: posts big blind $0.25
*** HOLE CARDS ***
Dealt to SantiagoWeight [5c 4h]
Nutselas: folds 
FarrOut1: raises $0.60 to $0.85
mariopork: raises $1.70 to $2.55
trttt74: folds 
cankum: folds 
SantiagoWeight: folds 
FarrOut1: calls $1.70
*** FLOP *** [Tc 6d 4s]
FarrOut1: checks 
mariopork: bets $9.60
FarrOut1: calls $5.57 and is all-in
Uncalled bet ($4.03) returned to mariopork
*** TURN *** [Tc 6d 4s] [5d]
*** RIVER *** [Tc 6d 4s 5d] [Qs]
*** SHOW DOWN ***
FarrOut1: shows [Kc As] (high card Ace)
mariopork: shows [Kd Ac] (high card Ace)
FarrOut1 collected $7.92 from pot
mariopork collected $7.92 from pot
*** SUMMARY ***
Total pot $16.59 | Rake $0.75 
Board [Tc 6d 4s 5d Qs]
Seat 1: trttt74 (button) folded before Flop (didn't bet)
Seat 2: cankum (small blind) folded before Flop
Seat 3: SantiagoWeight (big blind) folded before Flop
Seat 4: Nutselas folded before Flop (didn't bet)
Seat 5: FarrOut1 showed [Kc As] and won ($7.92) with high card Ace
Seat 6: mariopork showed [Kd Ac] and won ($7.92) with high card Ace



PokerStars Zoom Hand #195024394524:  Hold'em No Limit ($0.10/$0.25) - 2018/12/29 4:33:25 UTC [2018/12/28 23:33:25 ET]
Table 'Hydra' 6-max Seat #1 is the button
Seat 1: call me??107 ($12.50 in chips) 
Seat 2: Gonzalit0o ($32.59 in chips) 
Seat 3: razil_999 ($23.67 in chips) 
Seat 4: SantiagoWeight ($69.90 in chips) 
Seat 5: Lehared ($25.85 in chips) 
Seat 6: ttshead ($67.57 in chips) 
Gonzalit0o: posts small blind $0.10
razil_999: posts big blind $0.25
*** HOLE CARDS ***
Dealt to SantiagoWeight [Qc Ac]
SantiagoWeight: raises $0.42 to $0.67
Lehared: folds 
ttshead: folds 
call me??107: calls $0.67
Gonzalit0o: folds 
razil_999: calls $0.42
*** FLOP *** [7s 5s 9d]
razil_999: checks 
SantiagoWeight: checks 
call me??107: bets $2.02
razil_999: folds 
SantiagoWeight: folds 
Uncalled bet ($2.02) returned to call me??107
call me??107 collected $2.02 from pot
*** SUMMARY ***
Total pot $2.11 | Rake $0.09 
Board [7s 5s 9d]
Seat 1: call me??107 (button) collected ($2.02)
Seat 2: Gonzalit0o (small blind) folded before Flop
Seat 3: razil_999 (big blind) folded on the Flop
Seat 4: SantiagoWeight folded on the Flop
Seat 5: Lehared folded before Flop (didn't bet)
Seat 6: ttshead folded before Flop (didn't bet)



PokerStars Zoom Hand #195024404195:  Hold'em No Limit ($0.10/$0.25) - 2018/12/29 4:33:59 UTC [2018/12/28 23:33:59 ET]
Table 'Hydra' 6-max Seat #1 is the button
Seat 1: SantiagoWeight ($69.23 in chips) 
Seat 2: Shiltz17 ($15 in chips) 
Seat 3: graysonai ($40.27 in chips) 
Seat 4: Viiiru ($25.85 in chips) 
Seat 5: dawwwid70 ($25 in chips) 
Seat 6: Chrimmpam ($30.59 in chips) 
Shiltz17: posts small blind $0.10
graysonai: posts big blind $0.25
*** HOLE CARDS ***
Dealt to SantiagoWeight [Kc 3d]
Viiiru: folds 
dawwwid70: folds 
Chrimmpam: folds 
SantiagoWeight: folds 
Shiltz17: raises $0.50 to $0.75
graysonai: folds 
Uncalled bet ($0.50) returned to Shiltz17
Shiltz17 collected $0.50 from pot
Shiltz17: doesn't show hand 
*** SUMMARY ***
Total pot $0.50 | Rake $0 
Seat 1: SantiagoWeight (button) folded before Flop (didn't bet)
Seat 2: Shiltz17 (small blind) collected ($0.50)
Seat 3: graysonai (big blind) folded before Flop
Seat 4: Viiiru folded before Flop (didn't bet)
Seat 5: dawwwid70 folded before Flop (didn't bet)
Seat 6: Chrimmpam folded before Flop (didn't bet)



PokerStars Zoom Hand #195024408333:  Hold'em No Limit ($0.10/$0.25) - 2018/12/29 4:34:14 UTC [2018/12/28 23:34:14 ET]
Table 'Hydra' 6-max Seat #1 is the button
Seat 1: alex3d1985 ($16.64 in chips) 
Seat 2: SantiagoWeight ($69.23 in chips) 
Seat 3: FarrOut1 ($7.92 in chips) 
Seat 4: Mixxxxer599 ($24.47 in chips) 
Seat 5: zbuci ($31.47 in chips) 
Seat 6: gustavotaina ($15.43 in chips) 
SantiagoWeight: posts small blind $0.10
FarrOut1: posts big blind $0.25
*** HOLE CARDS ***
Dealt to SantiagoWeight [Ah 9s]
Mixxxxer599: folds 
zbuci: folds 
gustavotaina: folds 
alex3d1985: folds 
SantiagoWeight: raises $0.50 to $0.75
FarrOut1: calls $0.50
*** FLOP *** [3c Ad Tc]
SantiagoWeight: bets $0.50
FarrOut1: folds 
Uncalled bet ($0.50) returned to SantiagoWeight
SantiagoWeight collected $1.43 from pot
SantiagoWeight: doesn't show hand 
*** SUMMARY ***
Total pot $1.50 | Rake $0.07 
Board [3c Ad Tc]
Seat 1: alex3d1985 (button) folded before Flop (didn't bet)
Seat 2: SantiagoWeight (small blind) collected ($1.43)
Seat 3: FarrOut1 (big blind) folded on the Flop
Seat 4: Mixxxxer599 folded before Flop (didn't bet)
Seat 5: zbuci folded before Flop (didn't bet)
Seat 6: gustavotaina folded before Flop (didn't bet)



PokerStars Zoom Hand #195024407229:  Hold'em No Limit ($0.10/$0.25) - 2018/12/29 4:34:10 UTC [2018/12/28 23:34:10 ET]
Table 'Hydra' 6-max Seat #1 is the button
Seat 1: onhoang87 ($12.78 in chips) 
Seat 2: alex3d1985 ($16.74 in chips) 
Seat 3: abbi555 ($41.73 in chips) 
Seat 4: SantiagoWeight ($69.23 in chips) 
Seat 5: Party4Arthy ($30.48 in chips) 
Seat 6: pkr_miracle ($62.37 in chips) 
alex3d1985: posts small blind $0.10
abbi555: posts big blind $0.25
*** HOLE CARDS ***
Dealt to SantiagoWeight [9c 5s]
SantiagoWeight: folds 
Party4Arthy: folds 
pkr_miracle: raises $0.25 to $0.50
onhoang87: calls $0.50
alex3d1985: folds 
abbi555: folds 
*** FLOP *** [2c 3h 4h]
pkr_miracle: checks 
onhoang87: checks 
*** TURN *** [2c 3h 4h] [3d]
pkr_miracle: checks 
onhoang87: checks 
*** RIVER *** [2c 3h 4h 3d] [6d]
pkr_miracle: checks 
onhoang87: bets $1.25
pkr_miracle: folds 
Uncalled bet ($1.25) returned to onhoang87
onhoang87 collected $1.29 from pot
onhoang87: doesn't show hand 
*** SUMMARY ***
Total pot $1.35 | Rake $0.06 
Board [2c 3h 4h 3d 6d]
Seat 1: onhoang87 (button) collected ($1.29)
Seat 2: alex3d1985 (small blind) folded before Flop
Seat 3: abbi555 (big blind) folded before Flop
Seat 4: SantiagoWeight folded before Flop (didn't bet)
Seat 5: Party4Arthy folded before Flop (didn't bet)
Seat 6: pkr_miracle folded on the River



PokerStars Zoom Hand #195024415835:  Hold'em No Limit ($0.10/$0.25) - 2018/12/29 4:34:41 UTC [2018/12/28 23:34:41 ET]
Table 'Hydra' 6-max Seat #1 is the button
Seat 1: Viiiru ($34.25 in chips) 
Seat 2: tariko1980 ($41.05 in chips) 
Seat 3: SantiagoWeight ($69.91 in chips) 
Seat 4: razil_999 ($22.65 in chips) 
Seat 5: Chrimmpam ($30.49 in chips) 
Seat 6: IMMPORT@L ($12.77 in chips) 
tariko1980: posts small blind $0.10
SantiagoWeight: posts big blind $0.25
*** HOLE CARDS ***
Dealt to SantiagoWeight [Tc 9s]
razil_999: folds 
Chrimmpam: folds 
IMMPORT@L: folds 
Viiiru: folds 
tariko1980: calls $0.15
SantiagoWeight: checks 
*** FLOP *** [6d Ts 5s]
tariko1980: checks 
SantiagoWeight: bets $0.32
tariko1980: calls $0.32
*** TURN *** [6d Ts 5s] [4c]
tariko1980: checks 
SantiagoWeight: bets $0.80
tariko1980: calls $0.80
*** RIVER *** [6d Ts 5s 4c] [Qd]
tariko1980: checks 
SantiagoWeight: checks 
*** SHOW DOWN ***
tariko1980: shows [7s 7h] (a pair of Sevens)
SantiagoWeight: shows [Tc 9s] (a pair of Tens)
SantiagoWeight collected $2.62 from pot
*** SUMMARY ***
Total pot $2.74 | Rake $0.12 
Board [6d Ts 5s 4c Qd]
Seat 1: Viiiru (button) folded before Flop (didn't bet)
Seat 2: tariko1980 (small blind) showed [7s 7h] and lost with a pair of Sevens
Seat 3: SantiagoWeight (big blind) showed [Tc 9s] and won ($2.62) with a pair of Tens
Seat 4: razil_999 folded before Flop (didn't bet)
Seat 5: Chrimmpam folded before Flop (didn't bet)
Seat 6: IMMPORT@L folded before Flop (didn't bet)



PokerStars Zoom Hand #195024427236:  Hold'em No Limit ($0.10/$0.25) - 2018/12/29 4:35:22 UTC [2018/12/28 23:35:22 ET]
Table 'Hydra' 6-max Seat #1 is the button
Seat 1: Chrimmpam ($23.53 in chips) 
Seat 2: zbuci ($31.22 in chips) 
Seat 3: trttt74 ($35.93 in chips) 
Seat 4: amansah ($12.34 in chips) 
Seat 5: TQNYMQNTANA ($54.62 in chips) 
Seat 6: SantiagoWeight ($71.16 in chips) 
zbuci: posts small blind $0.10
trttt74: posts big blind $0.25
*** HOLE CARDS ***
Dealt to SantiagoWeight [2d 7s]
amansah: folds 
TQNYMQNTANA: folds 
SantiagoWeight: folds 
Chrimmpam: raises $0.60 to $0.85
zbuci: folds 
trttt74: folds 
Uncalled bet ($0.60) returned to Chrimmpam
Chrimmpam collected $0.60 from pot
Chrimmpam: doesn't show hand 
*** SUMMARY ***
Total pot $0.60 | Rake $0 
Seat 1: Chrimmpam (button) collected ($0.60)
Seat 2: zbuci (small blind) folded before Flop
Seat 3: trttt74 (big blind) folded before Flop
Seat 4: amansah folded before Flop (didn't bet)
Seat 5: TQNYMQNTANA folded before Flop (didn't bet)
Seat 6: SantiagoWeight folded before Flop (didn't bet)



PokerStars Zoom Hand #195024429448:  Hold'em No Limit ($0.10/$0.25) - 2018/12/29 4:35:30 UTC [2018/12/28 23:35:30 ET]
Table 'Hydra' 6-max Seat #1 is the button
Seat 1: inujara4 ($25.32 in chips) 
Seat 2: Guard poker ($30.51 in chips) 
Seat 3: FarrOut1 ($7.94 in chips) 
Seat 4: GrandmasterY ($35.01 in chips) 
Seat 5: SantiagoWeight ($71.16 in chips) 
Seat 6: ricpoitras ($27.04 in chips) 
Guard poker: posts small blind $0.10
FarrOut1: posts big blind $0.25
*** HOLE CARDS ***
Dealt to SantiagoWeight [5s As]
GrandmasterY: folds 
SantiagoWeight: raises $0.37 to $0.62
ricpoitras: folds 
inujara4: folds 
Guard poker: folds 
FarrOut1: calls $0.37
*** FLOP *** [Ah 8s 4c]
FarrOut1: checks 
SantiagoWeight: bets $0.32
FarrOut1: folds 
Uncalled bet ($0.32) returned to SantiagoWeight
SantiagoWeight collected $1.28 from pot
SantiagoWeight: doesn't show hand 
*** SUMMARY ***
Total pot $1.34 | Rake $0.06 
Board [Ah 8s 4c]
Seat 1: inujara4 (button) folded before Flop (didn't bet)
Seat 2: Guard poker (small blind) folded before Flop
Seat 3: FarrOut1 (big blind) folded on the Flop
Seat 4: GrandmasterY folded before Flop (didn't bet)
Seat 5: SantiagoWeight collected ($1.28)
Seat 6: ricpoitras folded before Flop (didn't bet)



PokerStars Zoom Hand #195024441052:  Hold'em No Limit ($0.10/$0.25) - 2018/12/29 4:36:12 UTC [2018/12/28 23:36:12 ET]
Table 'Hydra' 6-max Seat #1 is the button
Seat 1: dawwwid70 ($31.02 in chips) 
Seat 2: GrandmasterY ($35.11 in chips) 
Seat 3: Gonzalit0o ($45.36 in chips) 
Seat 4: SantiagoWeight ($71.82 in chips) 
Seat 5: Mixxxxer599 ($14.97 in chips) 
Seat 6: Higashi2314 ($25.35 in chips) 
GrandmasterY: posts small blind $0.10
Gonzalit0o: posts big blind $0.25
*** HOLE CARDS ***
Dealt to SantiagoWeight [6d Ad]
SantiagoWeight: raises $0.42 to $0.67
Mixxxxer599: folds 
Higashi2314: folds 
dawwwid70: folds 
GrandmasterY: folds 
Gonzalit0o: folds 
Uncalled bet ($0.42) returned to SantiagoWeight
SantiagoWeight collected $0.60 from pot
SantiagoWeight: doesn't show hand 
*** SUMMARY ***
Total pot $0.60 | Rake $0 
Seat 1: dawwwid70 (button) folded before Flop (didn't bet)
Seat 2: GrandmasterY (small blind) folded before Flop
Seat 3: Gonzalit0o (big blind) folded before Flop
Seat 4: SantiagoWeight collected ($0.60)
Seat 5: Mixxxxer599 folded before Flop (didn't bet)
Seat 6: Higashi2314 folded before Flop (didn't bet)



PokerStars Zoom Hand #195024449038:  Hold'em No Limit ($0.10/$0.25) - 2018/12/29 4:36:41 UTC [2018/12/28 23:36:41 ET]
Table 'Hydra' 6-max Seat #1 is the button
Seat 1: SantiagoWeight ($72.17 in chips) 
Seat 2: ritchy99 ($14.12 in chips) 
Seat 3: Chrimmpam ($19.39 in chips) 
Seat 4: anatoliy1976 ($49.67 in chips) 
Seat 5: Guard poker ($25.06 in chips) 
Seat 6: Virus3232 ($29.84 in chips) 
ritchy99: posts small blind $0.10
Chrimmpam: posts big blind $0.25
*** HOLE CARDS ***
Dealt to SantiagoWeight [7d Th]
anatoliy1976: folds 
Guard poker: raises $0.50 to $0.75
Virus3232: folds 
SantiagoWeight: folds 
ritchy99: folds 
Chrimmpam: folds 
Uncalled bet ($0.50) returned to Guard poker
Guard poker collected $0.60 from pot
Guard poker: doesn't show hand 
*** SUMMARY ***
Total pot $0.60 | Rake $0 
Seat 1: SantiagoWeight (button) folded before Flop (didn't bet)
Seat 2: ritchy99 (small blind) folded before Flop
Seat 3: Chrimmpam (big blind) folded before Flop
Seat 4: anatoliy1976 folded before Flop (didn't bet)
Seat 5: Guard poker collected ($0.60)
Seat 6: Virus3232 folded before Flop (didn't bet)



PokerStars Zoom Hand #195024452823:  Hold'em No Limit ($0.10/$0.25) - 2018/12/29 4:36:55 UTC [2018/12/28 23:36:55 ET]
Table 'Hydra' 6-max Seat #1 is the button
Seat 1: IMMPORT@L ($16.04 in chips) 
Seat 2: SantiagoWeight ($72.17 in chips) 
Seat 3: Chellabro ($8.02 in chips) 
Seat 4: ttshead ($67.07 in chips) 
Seat 5: Dbakunwaves ($37.13 in chips) 
Seat 6: GrandmasterY ($32.61 in chips) 
SantiagoWeight: posts small blind $0.10
Chellabro: posts big blind $0.25
*** HOLE CARDS ***
Dealt to SantiagoWeight [Ks 2h]
ttshead: folds 
Dbakunwaves: calls $0.25
GrandmasterY: folds 
IMMPORT@L: folds 
SantiagoWeight: folds 
Chellabro: checks 
*** FLOP *** [8h 8d 6c]
Chellabro: checks 
Dbakunwaves: checks 
*** TURN *** [8h 8d 6c] [3c]
Chellabro: checks 
Dbakunwaves: checks 
*** RIVER *** [8h 8d 6c 3c] [Ts]
Chellabro: checks 
Dbakunwaves: checks 
*** SHOW DOWN ***
Chellabro: shows [5c 5s] (two pair, Eights and Fives)
Dbakunwaves: mucks hand 
Chellabro collected $0.57 from pot
*** SUMMARY ***
Total pot $0.60 | Rake $0.03 
Board [8h 8d 6c 3c Ts]
Seat 1: IMMPORT@L (button) folded before Flop (didn't bet)
Seat 2: SantiagoWeight (small blind) folded before Flop
Seat 3: Chellabro (big blind) showed [5c 5s] and won ($0.57) with two pair, Eights and Fives
Seat 4: ttshead folded before Flop (didn't bet)
Seat 5: Dbakunwaves mucked [Jc 2c]
Seat 6: GrandmasterY folded before Flop (didn't bet)



PokerStars Zoom Hand #195024456608:  Hold'em No Limit ($0.10/$0.25) - 2018/12/29 4:37:09 UTC [2018/12/28 23:37:09 ET]
Table 'Hydra' 6-max Seat #1 is the button
Seat 1: mariopork ($39.94 in chips) 
Seat 2: ARTBIL ($22.96 in chips) 
Seat 3: razil_999 ($18.82 in chips) 
Seat 4: SantiagoWeight ($72.07 in chips) 
Seat 5: Lehared ($25 in chips) 
Seat 6: Nutselas ($25 in chips) 
ARTBIL: posts small blind $0.10
razil_999: posts big blind $0.25
*** HOLE CARDS ***
Dealt to SantiagoWeight [Ts Ah]
SantiagoWeight: raises $0.42 to $0.67
Lehared: folds 
Nutselas: folds 
mariopork: folds 
ARTBIL: folds 
razil_999: calls $0.42
*** FLOP *** [7c 9h 4s]
razil_999: checks 
SantiagoWeight: bets $0.92
razil_999: folds 
Uncalled bet ($0.92) returned to SantiagoWeight
SantiagoWeight collected $1.38 from pot
SantiagoWeight: doesn't show hand 
*** SUMMARY ***
Total pot $1.44 | Rake $0.06 
Board [7c 9h 4s]
Seat 1: mariopork (button) folded before Flop (didn't bet)
Seat 2: ARTBIL (small blind) folded before Flop
Seat 3: razil_999 (big blind) folded on the Flop
Seat 4: SantiagoWeight collected ($1.38)
Seat 5: Lehared folded before Flop (didn't bet)
Seat 6: Nutselas folded before Flop (didn't bet)



PokerStars Zoom Hand #195024467372:  Hold'em No Limit ($0.10/$0.25) - 2018/12/29 4:37:48 UTC [2018/12/28 23:37:48 ET]
Table 'Hydra' 6-max Seat #1 is the button
Seat 1: razil_999 ($18.15 in chips) 
Seat 2: cashwillis17 ($17.57 in chips) 
Seat 3: SantiagoWeight ($72.78 in chips) 
Seat 4: Higashi2314 ($25 in chips) 
Seat 5: Becks Baker ($26.55 in chips) 
Seat 6: TQNYMQNTANA ($28.04 in chips) 
cashwillis17: posts small blind $0.10
SantiagoWeight: posts big blind $0.25
*** HOLE CARDS ***
Dealt to SantiagoWeight [6s Ks]
Higashi2314: raises $0.50 to $0.75
Becks Baker: folds 
TQNYMQNTANA: folds 
razil_999: folds 
cashwillis17: folds 
SantiagoWeight: folds 
Uncalled bet ($0.50) returned to Higashi2314
Higashi2314 collected $0.60 from pot
*** SUMMARY ***
Total pot $0.60 | Rake $0 
Seat 1: razil_999 (button) folded before Flop (didn't bet)
Seat 2: cashwillis17 (small blind) folded before Flop
Seat 3: SantiagoWeight (big blind) folded before Flop
Seat 4: Higashi2314 collected ($0.60)
Seat 5: Becks Baker folded before Flop (didn't bet)
Seat 6: TQNYMQNTANA folded before Flop (didn't bet)



PokerStars Zoom Hand #195024465176:  Hold'em No Limit ($0.10/$0.25) - 2018/12/29 4:37:40 UTC [2018/12/28 23:37:40 ET]
Table 'Hydra' 6-max Seat #1 is the button
Seat 1: dk dreadlook ($32.04 in chips) 
Seat 2: lovintalbi ($90.03 in chips) 
Seat 3: karapuz1405 ($23.85 in chips) 
Seat 4: tariko1980 ($32.91 in chips) 
Seat 5: SantiagoWeight ($72.78 in chips) 
Seat 6: xman141 ($92.96 in chips) 
lovintalbi: posts small blind $0.10
karapuz1405: posts big blind $0.25
*** HOLE CARDS ***
Dealt to SantiagoWeight [2d 4h]
tariko1980: folds 
SantiagoWeight: folds 
xman141: raises $0.50 to $0.75
dk dreadlook: calls $0.75
lovintalbi: folds 
karapuz1405: calls $0.50
*** FLOP *** [Qc 3h 4c]
karapuz1405: checks 
xman141: bets $1
dk dreadlook: folds 
karapuz1405: folds 
Uncalled bet ($1) returned to xman141
xman141 collected $2.24 from pot
xman141: doesn't show hand 
*** SUMMARY ***
Total pot $2.35 | Rake $0.11 
Board [Qc 3h 4c]
Seat 1: dk dreadlook (button) folded on the Flop
Seat 2: lovintalbi (small blind) folded before Flop
Seat 3: karapuz1405 (big blind) folded on the Flop
Seat 4: tariko1980 folded before Flop (didn't bet)
Seat 5: SantiagoWeight folded before Flop (didn't bet)
Seat 6: xman141 collected ($2.24)



PokerStars Zoom Hand #195024470421:  Hold'em No Limit ($0.10/$0.25) - 2018/12/29 4:37:59 UTC [2018/12/28 23:37:59 ET]
Table 'Hydra' 6-max Seat #1 is the button
Seat 1: Virus3232 ($27.39 in chips) 
Seat 2: SantiagoWeight ($72.53 in chips) 
Seat 3: Igrok0609 ($15.97 in chips) 
Seat 4: Elapostador33 ($44.11 in chips) 
Seat 5: Wieb84 ($30.46 in chips) 
Seat 6: papico3 ($27.25 in chips) 
SantiagoWeight: posts small blind $0.10
Igrok0609: posts big blind $0.25
*** HOLE CARDS ***
Dealt to SantiagoWeight [Qd 6s]
Elapostador33: calls $0.25
Wieb84: folds 
papico3: raises $0.95 to $1.20
Virus3232: calls $1.20
SantiagoWeight: folds 
Igrok0609: raises $3.95 to $5.15
Elapostador33: folds 
papico3: folds 
Virus3232: folds 
Uncalled bet ($3.95) returned to Igrok0609
Igrok0609 collected $3.95 from pot
Igrok0609: doesn't show hand 
*** SUMMARY ***
Total pot $3.95 | Rake $0 
Seat 1: Virus3232 (button) folded before Flop
Seat 2: SantiagoWeight (small blind) folded before Flop
Seat 3: Igrok0609 (big blind) collected ($3.95)
Seat 4: Elapostador33 folded before Flop
Seat 5: Wieb84 folded before Flop (didn't bet)
Seat 6: papico3 folded before Flop



PokerStars Zoom Hand #195024478432:  Hold'em No Limit ($0.10/$0.25) - 2018/12/29 4:38:28 UTC [2018/12/28 23:38:28 ET]
Table 'Hydra' 6-max Seat #1 is the button
Seat 1: SantiagoWeight ($72.43 in chips) 
Seat 2: Thermal0007 ($21.72 in chips) 
Seat 3: zbuci ($13.85 in chips) 
Seat 4: ARTBIL ($24.65 in chips) 
Seat 5: !P0K3RM3T4L! ($25.01 in chips) 
Seat 6: IMMPORT@L ($21.05 in chips) 
Thermal0007: posts small blind $0.10
zbuci: posts big blind $0.25
*** HOLE CARDS ***
Dealt to SantiagoWeight [5c 4h]
ARTBIL: folds 
!P0K3RM3T4L!: folds 
IMMPORT@L: folds 
SantiagoWeight: folds 
Thermal0007: folds 
Uncalled bet ($0.15) returned to zbuci
zbuci collected $0.20 from pot
zbuci: doesn't show hand 
*** SUMMARY ***
Total pot $0.20 | Rake $0 
Seat 1: SantiagoWeight (button) folded before Flop (didn't bet)
Seat 2: Thermal0007 (small blind) folded before Flop
Seat 3: zbuci (big blind) collected ($0.20)
Seat 4: ARTBIL folded before Flop (didn't bet)
Seat 5: !P0K3RM3T4L! folded before Flop (didn't bet)
Seat 6: IMMPORT@L folded before Flop (didn't bet)



PokerStars Zoom Hand #195024483193:  Hold'em No Limit ($0.10/$0.25) - 2018/12/29 4:38:45 UTC [2018/12/28 23:38:45 ET]
Table 'Hydra' 6-max Seat #1 is the button
Seat 1: IMMPORT@L ($20.95 in chips) 
Seat 2: ryanking99 ($22.87 in chips) 
Seat 3: razil_999 ($18.15 in chips) 
Seat 4: Guard poker ($25 in chips) 
Seat 5: amansah ($18.60 in chips) 
Seat 6: SantiagoWeight ($72.43 in chips) 
ryanking99: posts small blind $0.10
razil_999: posts big blind $0.25
*** HOLE CARDS ***
Dealt to SantiagoWeight [Jc 9c]
Guard poker: folds 
amansah: folds 
SantiagoWeight: raises $0.35 to $0.60
IMMPORT@L: calls $0.60
ryanking99: folds 
razil_999: calls $0.35
*** FLOP *** [Tc 6d 3c]
razil_999: checks 
SantiagoWeight: bets $1.21
IMMPORT@L: calls $1.21
razil_999: folds 
*** TURN *** [Tc 6d 3c] [Ad]
SantiagoWeight: bets $2.75
IMMPORT@L: folds 
Uncalled bet ($2.75) returned to SantiagoWeight
SantiagoWeight collected $4.13 from pot
SantiagoWeight: doesn't show hand 
*** SUMMARY ***
Total pot $4.32 | Rake $0.19 
Board [Tc 6d 3c Ad]
Seat 1: IMMPORT@L (button) folded on the Turn
Seat 2: ryanking99 (small blind) folded before Flop
Seat 3: razil_999 (big blind) folded on the Flop
Seat 4: Guard poker folded before Flop (didn't bet)
Seat 5: amansah folded before Flop (didn't bet)
Seat 6: SantiagoWeight collected ($4.13)



PokerStars Zoom Hand #195024503044:  Hold'em No Limit ($0.10/$0.25) - 2018/12/29 4:39:56 UTC [2018/12/28 23:39:56 ET]
Table 'Hydra' 6-max Seat #1 is the button
Seat 1: thedalbgoma ($24.30 in chips) 
Seat 2: davidhw888 ($24.75 in chips) 
Seat 3: IMMPORT@L ($19.14 in chips) 
Seat 4: !P0K3RM3T4L! ($25 in chips) 
Seat 5: Lehared ($25.25 in chips) 
Seat 6: SantiagoWeight ($74.75 in chips) 
davidhw888: posts small blind $0.10
IMMPORT@L: posts big blind $0.25
*** HOLE CARDS ***
Dealt to SantiagoWeight [Jc 3h]
!P0K3RM3T4L!: folds 
Lehared: folds 
SantiagoWeight: folds 
thedalbgoma: raises $0.50 to $0.75
davidhw888: folds 
IMMPORT@L: calls $0.50
*** FLOP *** [4d Jh 5d]
IMMPORT@L: checks 
thedalbgoma: bets $1
IMMPORT@L: folds 
Uncalled bet ($1) returned to thedalbgoma
thedalbgoma collected $1.53 from pot
thedalbgoma: doesn't show hand 
*** SUMMARY ***
Total pot $1.60 | Rake $0.07 
Board [4d Jh 5d]
Seat 1: thedalbgoma (button) collected ($1.53)
Seat 2: davidhw888 (small blind) folded before Flop
Seat 3: IMMPORT@L (big blind) folded on the Flop
Seat 4: !P0K3RM3T4L! folded before Flop (didn't bet)
Seat 5: Lehared folded before Flop (didn't bet)
Seat 6: SantiagoWeight folded before Flop (didn't bet)



PokerStars Zoom Hand #195024509467:  Hold'em No Limit ($0.10/$0.25) - 2018/12/29 4:40:19 UTC [2018/12/28 23:40:19 ET]
Table 'Hydra' 6-max Seat #1 is the button
Seat 1: asapon ($29.93 in chips) 
Seat 2: Bonen18 ($47.98 in chips) 
Seat 3: SantiagoWeight ($74.75 in chips) 
Seat 4: !P0K3RM3T4L! ($25 in chips) 
Seat 5: Virus3232 ($28.33 in chips) 
Seat 6: mililser ($48.64 in chips) 
Bonen18: posts small blind $0.10
SantiagoWeight: posts big blind $0.25
*** HOLE CARDS ***
Dealt to SantiagoWeight [5h 7s]
!P0K3RM3T4L!: raises $0.35 to $0.60
Virus3232: folds 
mililser: folds 
asapon: folds 
Bonen18: folds 
SantiagoWeight: folds 
Uncalled bet ($0.35) returned to !P0K3RM3T4L!
!P0K3RM3T4L! collected $0.60 from pot
!P0K3RM3T4L!: doesn't show hand 
*** SUMMARY ***
Total pot $0.60 | Rake $0 
Seat 1: asapon (button) folded before Flop (didn't bet)
Seat 2: Bonen18 (small blind) folded before Flop
Seat 3: SantiagoWeight (big blind) folded before Flop
Seat 4: !P0K3RM3T4L! collected ($0.60)
Seat 5: Virus3232 folded before Flop (didn't bet)
Seat 6: mililser folded before Flop (didn't bet)



PokerStars Zoom Hand #195024504442:  Hold'em No Limit ($0.10/$0.25) - 2018/12/29 4:40:01 UTC [2018/12/28 23:40:01 ET]
Table 'Hydra' 6-max Seat #1 is the button
Seat 1: TQNYMQNTANA ($55.64 in chips) 
Seat 2: river plate9 ($25.89 in chips) 
Seat 3: xman141 ($92.85 in chips) 
Seat 4: JeDti ($27.44 in chips) 
Seat 5: SantiagoWeight ($74.75 in chips) 
Seat 6: Bonen18 ($47.98 in chips) 
river plate9: posts small blind $0.10
xman141: posts big blind $0.25
*** HOLE CARDS ***
Dealt to SantiagoWeight [2h Kd]
JeDti: folds 
SantiagoWeight: folds 
Bonen18: folds 
TQNYMQNTANA: raises $0.50 to $0.75
river plate9: folds 
xman141: calls $0.50
*** FLOP *** [6c 5s Th]
xman141: checks 
TQNYMQNTANA: checks 
*** TURN *** [6c 5s Th] [Qs]
xman141: checks 
TQNYMQNTANA: checks 
*** RIVER *** [6c 5s Th Qs] [2s]
xman141: bets $1
TQNYMQNTANA: folds 
Uncalled bet ($1) returned to xman141
xman141 collected $1.53 from pot
xman141: doesn't show hand 
*** SUMMARY ***
Total pot $1.60 | Rake $0.07 
Board [6c 5s Th Qs 2s]
Seat 1: TQNYMQNTANA (button) folded on the River
Seat 2: river plate9 (small blind) folded before Flop
Seat 3: xman141 (big blind) collected ($1.53)
Seat 4: JeDti folded before Flop (didn't bet)
Seat 5: SantiagoWeight folded before Flop (didn't bet)
Seat 6: Bonen18 folded before Flop (didn't bet)



PokerStars Zoom Hand #195024514660:  Hold'em No Limit ($0.10/$0.25) - 2018/12/29 4:40:38 UTC [2018/12/28 23:40:38 ET]
Table 'Hydra' 6-max Seat #1 is the button
Seat 1: ivann14 ($25 in chips) 
Seat 2: razil_999 ($16.80 in chips) 
Seat 3: Splodge86 ($21.33 in chips) 
Seat 4: SantiagoWeight ($74.50 in chips) 
Seat 5: ryanking99 ($19.61 in chips) 
Seat 6: graysonai ($43.31 in chips) 
razil_999: posts small blind $0.10
Splodge86: posts big blind $0.25
*** HOLE CARDS ***
Dealt to SantiagoWeight [3h 7c]
SantiagoWeight: folds 
ryanking99: raises $0.31 to $0.56
graysonai: folds 
ivann14: folds 
razil_999: folds 
Splodge86: folds 
Uncalled bet ($0.31) returned to ryanking99
ryanking99 collected $0.60 from pot
ryanking99: doesn't show hand 
*** SUMMARY ***
Total pot $0.60 | Rake $0 
Seat 1: ivann14 (button) folded before Flop (didn't bet)
Seat 2: razil_999 (small blind) folded before Flop
Seat 3: Splodge86 (big blind) folded before Flop
Seat 4: SantiagoWeight folded before Flop (didn't bet)
Seat 5: ryanking99 collected ($0.60)
Seat 6: graysonai folded before Flop (didn't bet)



PokerStars Zoom Hand #195024516084:  Hold'em No Limit ($0.10/$0.25) - 2018/12/29 4:40:43 UTC [2018/12/28 23:40:43 ET]
Table 'Hydra' 6-max Seat #1 is the button
Seat 1: SantiagoWeight ($74.50 in chips) 
Seat 2: killerB17 ($34.42 in chips) 
Seat 3: ivann14 ($37.08 in chips) 
Seat 4: Guard poker ($28.30 in chips) 
Seat 5: graysonai ($25 in chips) 
Seat 6: dawwwid70 ($29.16 in chips) 
killerB17: posts small blind $0.10
ivann14: posts big blind $0.25
*** HOLE CARDS ***
Dealt to SantiagoWeight [Kc 4s]
Guard poker: folds 
graysonai: folds 
dawwwid70: folds 
SantiagoWeight: folds 
killerB17: folds 
Uncalled bet ($0.15) returned to ivann14
ivann14 collected $0.20 from pot
ivann14: doesn't show hand 
*** SUMMARY ***
Total pot $0.20 | Rake $0 
Seat 1: SantiagoWeight (button) folded before Flop (didn't bet)
Seat 2: killerB17 (small blind) folded before Flop
Seat 3: ivann14 (big blind) collected ($0.20)
Seat 4: Guard poker folded before Flop (didn't bet)
Seat 5: graysonai folded before Flop (didn't bet)
Seat 6: dawwwid70 folded before Flop (didn't bet)



PokerStars Zoom Hand #195024525974:  Hold'em No Limit ($0.10/$0.25) - 2018/12/29 4:41:19 UTC [2018/12/28 23:41:19 ET]
Table 'Hydra' 6-max Seat #1 is the button
Seat 1: abbi555 ($42.77 in chips) 
Seat 2: Pardaroxon ($25 in chips) 
Seat 3: t57571245 ($35.08 in chips) 
Seat 4: mariopork ($25.80 in chips) 
Seat 5: Bonen18 ($35.82 in chips) 
Seat 6: SantiagoWeight ($74.40 in chips) 
Pardaroxon: posts small blind $0.10
t57571245: posts big blind $0.25
*** HOLE CARDS ***
Dealt to SantiagoWeight [7s 8h]
mariopork: folds 
Bonen18: folds 
SantiagoWeight: folds 
abbi555: folds 
Pardaroxon: folds 
Uncalled bet ($0.15) returned to t57571245
t57571245 collected $0.20 from pot
t57571245: doesn't show hand 
*** SUMMARY ***
Total pot $0.20 | Rake $0 
Seat 1: abbi555 (button) folded before Flop (didn't bet)
Seat 2: Pardaroxon (small blind) folded before Flop
Seat 3: t57571245 (big blind) collected ($0.20)
Seat 4: mariopork folded before Flop (didn't bet)
Seat 5: Bonen18 folded before Flop (didn't bet)
Seat 6: SantiagoWeight folded before Flop (didn't bet)



PokerStars Zoom Hand #195024529298:  Hold'em No Limit ($0.10/$0.25) - 2018/12/29 4:41:31 UTC [2018/12/28 23:41:31 ET]
Table 'Hydra' 6-max Seat #1 is the button
Seat 1: Gonzalit0o ($83.95 in chips) 
Seat 2: Virus3232 ($25.87 in chips) 
Seat 3: SantiagoWeight ($74.40 in chips) 
Seat 4: Chrimmpam ($29.18 in chips) 
Seat 5: asapon ($29.23 in chips) 
Seat 6: Shiltz17 ($49.70 in chips) 
Virus3232: posts small blind $0.10
SantiagoWeight: posts big blind $0.25
*** HOLE CARDS ***
Dealt to SantiagoWeight [8d Jc]
Chrimmpam: raises $0.60 to $0.85
asapon: folds 
Shiltz17: folds 
Gonzalit0o: folds 
Virus3232: folds 
SantiagoWeight: folds 
Uncalled bet ($0.60) returned to Chrimmpam
Chrimmpam collected $0.60 from pot
Chrimmpam: doesn't show hand 
*** SUMMARY ***
Total pot $0.60 | Rake $0 
Seat 1: Gonzalit0o (button) folded before Flop (didn't bet)
Seat 2: Virus3232 (small blind) folded before Flop
Seat 3: SantiagoWeight (big blind) folded before Flop
Seat 4: Chrimmpam collected ($0.60)
Seat 5: asapon folded before Flop (didn't bet)
Seat 6: Shiltz17 folded before Flop (didn't bet)



PokerStars Zoom Hand #195024521822:  Hold'em No Limit ($0.10/$0.25) - 2018/12/29 4:41:04 UTC [2018/12/28 23:41:04 ET]
Table 'Hydra' 6-max Seat #1 is the button
Seat 1: dawwwid70 ($28.81 in chips) 
Seat 2: !P0K3RM3T4L! ($25 in chips) 
Seat 3: hames_tj ($25 in chips) 
Seat 4: Higashi2314 ($25 in chips) 
Seat 5: SantiagoWeight ($74.50 in chips) 
Seat 6: razil_999 ($15.45 in chips) 
!P0K3RM3T4L!: posts small blind $0.10
hames_tj: posts big blind $0.25
*** HOLE CARDS ***
Dealt to SantiagoWeight [8s Tc]
Higashi2314: raises $0.50 to $0.75
SantiagoWeight: folds 
razil_999: folds 
dawwwid70: folds 
!P0K3RM3T4L!: calls $0.65
hames_tj: folds 
*** FLOP *** [Kd 4s Jd]
!P0K3RM3T4L!: checks 
Higashi2314: bets $0.55
!P0K3RM3T4L!: calls $0.55
*** TURN *** [Kd 4s Jd] [5c]
!P0K3RM3T4L!: checks 
Higashi2314: bets $3.10
!P0K3RM3T4L!: calls $3.10
*** RIVER *** [Kd 4s Jd 5c] [8c]
!P0K3RM3T4L!: checks 
Higashi2314: checks 
*** SHOW DOWN ***
!P0K3RM3T4L!: shows [Kh As] (a pair of Kings)
Higashi2314: mucks hand 
!P0K3RM3T4L! collected $8.64 from pot
*** SUMMARY ***
Total pot $9.05 | Rake $0.41 
Board [Kd 4s Jd 5c 8c]
Seat 1: dawwwid70 (button) folded before Flop (didn't bet)
Seat 2: !P0K3RM3T4L! (small blind) showed [Kh As] and won ($8.64) with a pair of Kings
Seat 3: hames_tj (big blind) folded before Flop
Seat 4: Higashi2314 mucked [Ad 8d]
Seat 5: SantiagoWeight folded before Flop (didn't bet)
Seat 6: razil_999 folded before Flop (didn't bet)



PokerStars Zoom Hand #195024523756:  Hold'em No Limit ($0.10/$0.25) - 2018/12/29 4:41:11 UTC [2018/12/28 23:41:11 ET]
Table 'Hydra' 6-max Seat #1 is the button
Seat 1: Lehared ($25 in chips) 
Seat 2: SantiagoWeight ($74.50 in chips) 
Seat 3: ivann14 ($25 in chips) 
Seat 4: MAKSSSSSS72 ($23.05 in chips) 
Seat 5: 2poiRiver ($13.15 in chips) 
Seat 6: graysonai ($43.06 in chips) 
SantiagoWeight: posts small blind $0.10
ivann14: posts big blind $0.25
*** HOLE CARDS ***
Dealt to SantiagoWeight [Qh 2d]
MAKSSSSSS72: folds 
2poiRiver: folds 
graysonai: raises $0.30 to $0.55
Lehared: folds 
SantiagoWeight: folds 
ivann14: calls $0.30
*** FLOP *** [As Ac 3c]
ivann14: checks 
graysonai: checks 
*** TURN *** [As Ac 3c] [Kd]
ivann14: checks 
graysonai: bets $0.38
ivann14: calls $0.38
*** RIVER *** [As Ac 3c Kd] [8h]
ivann14: bets $1.05
graysonai: raises $4.37 to $5.42
ivann14: folds 
Uncalled bet ($4.37) returned to graysonai
graysonai collected $3.88 from pot
graysonai: doesn't show hand 
*** SUMMARY ***
Total pot $4.06 | Rake $0.18 
Board [As Ac 3c Kd 8h]
Seat 1: Lehared (button) folded before Flop (didn't bet)
Seat 2: SantiagoWeight (small blind) folded before Flop
Seat 3: ivann14 (big blind) folded on the River
Seat 4: MAKSSSSSS72 folded before Flop (didn't bet)
Seat 5: 2poiRiver folded before Flop (didn't bet)
Seat 6: graysonai collected ($3.88)



PokerStars Zoom Hand #195024535206:  Hold'em No Limit ($0.10/$0.25) - 2018/12/29 4:41:52 UTC [2018/12/28 23:41:52 ET]
Table 'Hydra' 6-max Seat #1 is the button
Seat 1: Suit3dGapp3r ($26.75 in chips) 
Seat 2: SantiagoWeight ($74.15 in chips) 
Seat 3: mariopork ($38.29 in chips) 
Seat 4: lovintalbi ($94.39 in chips) 
Seat 5: Thermal0007 ($22.07 in chips) 
Seat 6: kurb1234 ($19.78 in chips) 
SantiagoWeight: posts small blind $0.10
mariopork: posts big blind $0.25
*** HOLE CARDS ***
Dealt to SantiagoWeight [2h 9s]
lovintalbi: folds 
Thermal0007: folds 
kurb1234: folds 
Suit3dGapp3r: folds 
SantiagoWeight: folds 
Uncalled bet ($0.15) returned to mariopork
mariopork collected $0.20 from pot
*** SUMMARY ***
Total pot $0.20 | Rake $0 
Seat 1: Suit3dGapp3r (button) folded before Flop (didn't bet)
Seat 2: SantiagoWeight (small blind) folded before Flop
Seat 3: mariopork (big blind) collected ($0.20)
Seat 4: lovintalbi folded before Flop (didn't bet)
Seat 5: Thermal0007 folded before Flop (didn't bet)
Seat 6: kurb1234 folded before Flop (didn't bet)



PokerStars Zoom Hand #195024532436:  Hold'em No Limit ($0.10/$0.25) - 2018/12/29 4:41:42 UTC [2018/12/28 23:41:42 ET]
Table 'Hydra' 6-max Seat #1 is the button
Seat 1: 2poiRiver ($13.75 in chips) 
Seat 2: SmBusBully ($24.91 in chips) 
Seat 3: mililser ($48.64 in chips) 
Seat 4: SantiagoWeight ($74.15 in chips) 
Seat 5: Gonzalit0o ($83.95 in chips) 
Seat 6: mariopork ($38.29 in chips) 
SmBusBully: posts small blind $0.10
mililser: posts big blind $0.25
*** HOLE CARDS ***
Dealt to SantiagoWeight [7s 6d]
SantiagoWeight: folds 
Gonzalit0o: raises $0.50 to $0.75
mariopork: folds 
2poiRiver: folds 
SmBusBully: calls $0.65
mililser: folds 
*** FLOP *** [3c 6h Qd]
SmBusBully: checks 
Gonzalit0o: checks 
*** TURN *** [3c 6h Qd] [7c]
SmBusBully: bets $1.67
Gonzalit0o: calls $1.67
*** RIVER *** [3c 6h Qd 7c] [Th]
SmBusBully: checks 
Gonzalit0o: bets $1.60
SmBusBully: calls $1.60
*** SHOW DOWN ***
Gonzalit0o: shows [9c Jc] (high card Queen)
SmBusBully: shows [6c 8c] (a pair of Sixes)
SmBusBully collected $7.92 from pot
*** SUMMARY ***
Total pot $8.29 | Rake $0.37 
Board [3c 6h Qd 7c Th]
Seat 1: 2poiRiver (button) folded before Flop (didn't bet)
Seat 2: SmBusBully (small blind) showed [6c 8c] and won ($7.92) with a pair of Sixes
Seat 3: mililser (big blind) folded before Flop
Seat 4: SantiagoWeight folded before Flop (didn't bet)
Seat 5: Gonzalit0o showed [9c Jc] and lost with high card Queen
Seat 6: mariopork folded before Flop (didn't bet)



PokerStars Zoom Hand #195024551751:  Hold'em No Limit ($0.10/$0.25) - 2018/12/29 4:42:52 UTC [2018/12/28 23:42:52 ET]
Table 'Hydra' 6-max Seat #1 is the button
Seat 1: dawwwid70 ($25 in chips) 
Seat 2: LastNoma ($25 in chips) 
Seat 3: Guard poker ($26.70 in chips) 
Seat 4: Pardaroxon ($41.77 in chips) 
Seat 5: SantiagoWeight ($74.05 in chips) 
Seat 6: sikach78 ($6.09 in chips) 
LastNoma: posts small blind $0.10
Guard poker: posts big blind $0.25
*** HOLE CARDS ***
Dealt to SantiagoWeight [Ts 7h]
Pardaroxon: folds 
SantiagoWeight: folds 
sikach78: folds 
dawwwid70: folds 
LastNoma: folds 
Uncalled bet ($0.15) returned to Guard poker
Guard poker collected $0.20 from pot
Guard poker: doesn't show hand 
*** SUMMARY ***
Total pot $0.20 | Rake $0 
Seat 1: dawwwid70 (button) folded before Flop (didn't bet)
Seat 2: LastNoma (small blind) folded before Flop
Seat 3: Guard poker (big blind) collected ($0.20)
Seat 4: Pardaroxon folded before Flop (didn't bet)
Seat 5: SantiagoWeight folded before Flop (didn't bet)
Seat 6: sikach78 folded before Flop (didn't bet)



PokerStars Zoom Hand #195024542707:  Hold'em No Limit ($0.10/$0.25) - 2018/12/29 4:42:19 UTC [2018/12/28 23:42:19 ET]
Table 'Hydra' 6-max Seat #1 is the button
Seat 1: SantiagoWeight ($74.05 in chips) 
Seat 2: !P0K3RM3T4L! ($29.24 in chips) 
Seat 3: JeDti ($43.84 in chips) 
Seat 4: cheolbeom ($29.72 in chips) 
Seat 5: Bonen18 ($25.32 in chips) 
Seat 6: Sco0oter ($15.54 in chips) 
!P0K3RM3T4L!: posts small blind $0.10
JeDti: posts big blind $0.25
*** HOLE CARDS ***
Dealt to SantiagoWeight [Jh Qh]
cheolbeom: folds 
Bonen18: raises $0.50 to $0.75
Sco0oter: folds 
SantiagoWeight: folds 
!P0K3RM3T4L!: folds 
JeDti: calls $0.50
*** FLOP *** [7h 3c Kd]
JeDti: bets $0.61
Bonen18: folds 
Uncalled bet ($0.61) returned to JeDti
JeDti collected $1.53 from pot
JeDti: doesn't show hand 
*** SUMMARY ***
Total pot $1.60 | Rake $0.07 
Board [7h 3c Kd]
Seat 1: SantiagoWeight (button) folded before Flop (didn't bet)
Seat 2: !P0K3RM3T4L! (small blind) folded before Flop
Seat 3: JeDti (big blind) collected ($1.53)
Seat 4: cheolbeom folded before Flop (didn't bet)
Seat 5: Bonen18 folded on the Flop
Seat 6: Sco0oter folded before Flop (didn't bet)



PokerStars Zoom Hand #195024548155:  Hold'em No Limit ($0.10/$0.25) - 2018/12/29 4:42:39 UTC [2018/12/28 23:42:39 ET]
Table 'Hydra' 6-max Seat #1 is the button
Seat 1: TQNYMQNTANA ($25.36 in chips) 
Seat 2: Wieb84 ($25 in chips) 
Seat 3: !P0K3RM3T4L! ($29.14 in chips) 
Seat 4: mariopork ($101.43 in chips) 
Seat 5: ivann14 ($32.90 in chips) 
Seat 6: SantiagoWeight ($74.05 in chips) 
Wieb84: posts small blind $0.10
!P0K3RM3T4L!: posts big blind $0.25
*** HOLE CARDS ***
Dealt to SantiagoWeight [Tc 3h]
mariopork: folds 
ivann14: folds 
SantiagoWeight: folds 
TQNYMQNTANA: raises $0.50 to $0.75
Wieb84: raises $2 to $2.75
!P0K3RM3T4L!: folds 
TQNYMQNTANA: folds 
Uncalled bet ($2) returned to Wieb84
Wieb84 collected $1.75 from pot
Wieb84: doesn't show hand 
*** SUMMARY ***
Total pot $1.75 | Rake $0 
Seat 1: TQNYMQNTANA (button) folded before Flop
Seat 2: Wieb84 (small blind) collected ($1.75)
Seat 3: !P0K3RM3T4L! (big blind) folded before Flop
Seat 4: mariopork folded before Flop (didn't bet)
Seat 5: ivann14 folded before Flop (didn't bet)
Seat 6: SantiagoWeight folded before Flop (didn't bet)



PokerStars Zoom Hand #195024540258:  Hold'em No Limit ($0.10/$0.25) - 2018/12/29 4:42:10 UTC [2018/12/28 23:42:10 ET]
Table 'Hydra' 6-max Seat #1 is the button
Seat 1: Buntar017 ($20.67 in chips) 
Seat 2: Bonen18 ($48.73 in chips) 
Seat 3: Virus3232 ($28.33 in chips) 
Seat 4: SantiagoWeight ($74.05 in chips) 
Seat 5: JeDti ($26.74 in chips) 
Seat 6: Doomdigidoom ($43.48 in chips) 
Bonen18: posts small blind $0.10
Virus3232: posts big blind $0.25
*** HOLE CARDS ***
Dealt to SantiagoWeight [9s 3h]
SantiagoWeight: folds 
JeDti: raises $0.36 to $0.61
Doomdigidoom: folds 
Buntar017: folds 
Bonen18: folds 
Virus3232: calls $0.36
*** FLOP *** [Tc Qc Qs]
Virus3232: checks 
JeDti: bets $0.76
Virus3232: raises $1.99 to $2.75
JeDti: calls $1.99
*** TURN *** [Tc Qc Qs] [5c]
Virus3232: checks 
JeDti: bets $4.36
Virus3232: calls $4.36
*** RIVER *** [Tc Qc Qs 5c] [4c]
Virus3232: checks 
JeDti: bets $7.57
Virus3232: folds 
Uncalled bet ($7.57) returned to JeDti
JeDti collected $14.84 from pot
JeDti: doesn't show hand 
*** SUMMARY ***
Total pot $15.54 | Rake $0.70 
Board [Tc Qc Qs 5c 4c]
Seat 1: Buntar017 (button) folded before Flop (didn't bet)
Seat 2: Bonen18 (small blind) folded before Flop
Seat 3: Virus3232 (big blind) folded on the River
Seat 4: SantiagoWeight folded before Flop (didn't bet)
Seat 5: JeDti collected ($14.84)
Seat 6: Doomdigidoom folded before Flop (didn't bet)



PokerStars Zoom Hand #195024555346:  Hold'em No Limit ($0.10/$0.25) - 2018/12/29 4:43:05 UTC [2018/12/28 23:43:05 ET]
Table 'Hydra' 6-max Seat #1 is the button
Seat 1: zdenekstavic ($44.93 in chips) 
Seat 2: graysonai ($34.58 in chips) 
Seat 3: SantiagoWeight ($74.05 in chips) 
Seat 4: RESTRICTED.CR17 ($42.20 in chips) 
Seat 5: Gonzalit0o ($54.30 in chips) 
Seat 6: Guard poker ($33.13 in chips) 
graysonai: posts small blind $0.10
SantiagoWeight: posts big blind $0.25
*** HOLE CARDS ***
Dealt to SantiagoWeight [As 2d]
RESTRICTED.CR17: folds 
Gonzalit0o: raises $0.50 to $0.75
Guard poker: folds 
zdenekstavic: calls $0.75
graysonai: folds 
SantiagoWeight: folds 
*** FLOP *** [Qd 4d 9c]
Gonzalit0o: checks 
zdenekstavic: checks 
*** TURN *** [Qd 4d 9c] [7s]
Gonzalit0o: checks 
zdenekstavic: bets $1.77
Gonzalit0o: folds 
Uncalled bet ($1.77) returned to zdenekstavic
zdenekstavic collected $1.77 from pot
zdenekstavic: doesn't show hand 
*** SUMMARY ***
Total pot $1.85 | Rake $0.08 
Board [Qd 4d 9c 7s]
Seat 1: zdenekstavic (button) collected ($1.77)
Seat 2: graysonai (small blind) folded before Flop
Seat 3: SantiagoWeight (big blind) folded before Flop
Seat 4: RESTRICTED.CR17 folded before Flop (didn't bet)
Seat 5: Gonzalit0o folded on the Turn
Seat 6: Guard poker folded before Flop (didn't bet)



PokerStars Zoom Hand #195024560020:  Hold'em No Limit ($0.10/$0.25) - 2018/12/29 4:43:22 UTC [2018/12/28 23:43:22 ET]
Table 'Hydra' 6-max Seat #1 is the button
Seat 1: SantiagoWeight ($73.80 in chips) 
Seat 2: graysonai ($25 in chips) 
Seat 3: asapon ($28.45 in chips) 
Seat 4: alex3d1985 ($34.08 in chips) 
Seat 5: call me??107 ($44.65 in chips) 
Seat 6: Suit3dGapp3r ($26.75 in chips) 
graysonai: posts small blind $0.10
asapon: posts big blind $0.25
*** HOLE CARDS ***
Dealt to SantiagoWeight [Qc Ac]
alex3d1985: folds 
call me??107: folds 
Suit3dGapp3r: folds 
SantiagoWeight: raises $0.30 to $0.55
graysonai: folds 
asapon: folds 
Uncalled bet ($0.30) returned to SantiagoWeight
SantiagoWeight collected $0.60 from pot
SantiagoWeight: doesn't show hand 
*** SUMMARY ***
Total pot $0.60 | Rake $0 
Seat 1: SantiagoWeight (button) collected ($0.60)
Seat 2: graysonai (small blind) folded before Flop
Seat 3: asapon (big blind) folded before Flop
Seat 4: alex3d1985 folded before Flop (didn't bet)
Seat 5: call me??107 folded before Flop (didn't bet)
Seat 6: Suit3dGapp3r folded before Flop (didn't bet)



PokerStars Zoom Hand #195024566562:  Hold'em No Limit ($0.10/$0.25) - 2018/12/29 4:43:46 UTC [2018/12/28 23:43:46 ET]
Table 'Hydra' 6-max Seat #1 is the button
Seat 1: ARTBIL ($23.82 in chips) 
Seat 2: SantiagoWeight ($74.15 in chips) 
Seat 3: Pardaroxon ($25.85 in chips) 
Seat 4: papico3 ($25.31 in chips) 
Seat 5: dk dreadlook ($37.64 in chips) 
Seat 6: Wieb84 ($27.11 in chips) 
SantiagoWeight: posts small blind $0.10
Pardaroxon: posts big blind $0.25
*** HOLE CARDS ***
Dealt to SantiagoWeight [Tc Js]
papico3: folds 
dk dreadlook: folds 
Wieb84: raises $0.25 to $0.50
ARTBIL: folds 
SantiagoWeight: raises $1.50 to $2
Pardaroxon: folds 
Wieb84: calls $1.50
*** FLOP *** [4s 7c 6d]
SantiagoWeight: checks 
Wieb84: checks 
*** TURN *** [4s 7c 6d] [5d]
SantiagoWeight: checks 
Wieb84: bets $3.05
SantiagoWeight: folds 
Uncalled bet ($3.05) returned to Wieb84
Wieb84 collected $4.06 from pot
Wieb84: doesn't show hand 
*** SUMMARY ***
Total pot $4.25 | Rake $0.19 
Board [4s 7c 6d 5d]
Seat 1: ARTBIL (button) folded before Flop (didn't bet)
Seat 2: SantiagoWeight (small blind) folded on the Turn
Seat 3: Pardaroxon (big blind) folded before Flop
Seat 4: papico3 folded before Flop (didn't bet)
Seat 5: dk dreadlook folded before Flop (didn't bet)
Seat 6: Wieb84 collected ($4.06)



PokerStars Zoom Hand #195024586230:  Hold'em No Limit ($0.10/$0.25) - 2018/12/29 4:44:58 UTC [2018/12/28 23:44:58 ET]
Table 'Hydra' 6-max Seat #1 is the button
Seat 1: koichi1210 ($24.65 in chips) 
Seat 2: tariko1980 ($7.01 in chips) 
Seat 3: TQNYMQNTANA ($25.57 in chips) 
Seat 4: Gonzalit0o ($46.78 in chips) 
Seat 5: SantiagoWeight ($72.15 in chips) 
Seat 6: SpaZz0205 ($24.31 in chips) 
tariko1980: posts small blind $0.10
TQNYMQNTANA: posts big blind $0.25
*** HOLE CARDS ***
Dealt to SantiagoWeight [9c 9s]
Gonzalit0o: folds 
SantiagoWeight: raises $0.37 to $0.62
SpaZz0205: folds 
koichi1210: folds 
tariko1980: folds 
TQNYMQNTANA: folds 
Uncalled bet ($0.37) returned to SantiagoWeight
SantiagoWeight collected $0.60 from pot
SantiagoWeight: doesn't show hand 
*** SUMMARY ***
Total pot $0.60 | Rake $0 
Seat 1: koichi1210 (button) folded before Flop (didn't bet)
Seat 2: tariko1980 (small blind) folded before Flop
Seat 3: TQNYMQNTANA (big blind) folded before Flop
Seat 4: Gonzalit0o folded before Flop (didn't bet)
Seat 5: SantiagoWeight collected ($0.60)
Seat 6: SpaZz0205 folded before Flop (didn't bet)



PokerStars Zoom Hand #195024590273:  Hold'em No Limit ($0.10/$0.25) - 2018/12/29 4:45:13 UTC [2018/12/28 23:45:13 ET]
Table 'Hydra' 6-max Seat #1 is the button
Seat 1: xXBossHossXx ($72.91 in chips) 
Seat 2: bigpower629 ($25 in chips) 
Seat 3: cheolbeom ($26.72 in chips) 
Seat 4: SantiagoWeight ($72.50 in chips) 
Seat 5: TQNYMQNTANA ($25.32 in chips) 
Seat 6: dk dreadlook ($37.36 in chips) 
bigpower629: posts small blind $0.10
cheolbeom: posts big blind $0.25
*** HOLE CARDS ***
Dealt to SantiagoWeight [3h Ac]
SantiagoWeight: folds 
TQNYMQNTANA: folds 
dk dreadlook: folds 
xXBossHossXx: folds 
bigpower629: raises $0.50 to $0.75
cheolbeom: calls $0.50
*** FLOP *** [9s 4h 6h]
bigpower629: bets $1.06
cheolbeom: calls $1.06
*** TURN *** [9s 4h 6h] [3d]
bigpower629: bets $2.25
cheolbeom: calls $2.25
*** RIVER *** [9s 4h 6h 3d] [7s]
bigpower629: checks 
cheolbeom: checks 
*** SHOW DOWN ***
bigpower629: shows [5c 6c] (a straight, Three to Seven)
cheolbeom: mucks hand 
bigpower629 collected $7.75 from pot
*** SUMMARY ***
Total pot $8.12 | Rake $0.37 
Board [9s 4h 6h 3d 7s]
Seat 1: xXBossHossXx (button) folded before Flop (didn't bet)
Seat 2: bigpower629 (small blind) showed [5c 6c] and won ($7.75) with a straight, Three to Seven
Seat 3: cheolbeom (big blind) mucked [Ts 9d]
Seat 4: SantiagoWeight folded before Flop (didn't bet)
Seat 5: TQNYMQNTANA folded before Flop (didn't bet)
Seat 6: dk dreadlook folded before Flop (didn't bet)



PokerStars Zoom Hand #195024597332:  Hold'em No Limit ($0.10/$0.25) - 2018/12/29 4:45:39 UTC [2018/12/28 23:45:39 ET]
Table 'Hydra' 6-max Seat #1 is the button
Seat 1: Lehared ($33.09 in chips) 
Seat 2: Viiiru ($60.50 in chips) 
Seat 3: SantiagoWeight ($72.50 in chips) 
Seat 4: karapuz1405 ($6.35 in chips) 
Seat 5: killerB17 ($37.65 in chips) 
Seat 6: asapon ($30.03 in chips) 
Viiiru: posts small blind $0.10
SantiagoWeight: posts big blind $0.25
*** HOLE CARDS ***
Dealt to SantiagoWeight [6h Tc]
karapuz1405: folds 
killerB17: folds 
asapon: folds 
Lehared: raises $0.37 to $0.62
Viiiru: folds 
SantiagoWeight: folds 
Uncalled bet ($0.37) returned to Lehared
Lehared collected $0.60 from pot
Lehared: doesn't show hand 
*** SUMMARY ***
Total pot $0.60 | Rake $0 
Seat 1: Lehared (button) collected ($0.60)
Seat 2: Viiiru (small blind) folded before Flop
Seat 3: SantiagoWeight (big blind) folded before Flop
Seat 4: karapuz1405 folded before Flop (didn't bet)
Seat 5: killerB17 folded before Flop (didn't bet)
Seat 6: asapon folded before Flop (didn't bet)



PokerStars Zoom Hand #195024593268:  Hold'em No Limit ($0.10/$0.25) - 2018/12/29 4:45:24 UTC [2018/12/28 23:45:24 ET]
Table 'Hydra' 6-max Seat #1 is the button
Seat 1: ARTBIL ($25.73 in chips) 
Seat 2: allin969 ($36.92 in chips) 
Seat 3: TQNYMQNTANA ($56.21 in chips) 
Seat 4: amansah ($19.42 in chips) 
Seat 5: LastNoma ($25.62 in chips) 
Seat 6: SantiagoWeight ($72.50 in chips) 
allin969: posts small blind $0.10
TQNYMQNTANA: posts big blind $0.25
*** HOLE CARDS ***
Dealt to SantiagoWeight [6d Kh]
amansah: raises $0.25 to $0.50
LastNoma: folds 
SantiagoWeight: folds 
ARTBIL: folds 
allin969: folds 
TQNYMQNTANA: raises $1 to $1.50
amansah: raises $5.75 to $7.25
TQNYMQNTANA: folds 
Uncalled bet ($5.75) returned to amansah
amansah collected $3.10 from pot
amansah: doesn't show hand 
*** SUMMARY ***
Total pot $3.10 | Rake $0 
Seat 1: ARTBIL (button) folded before Flop (didn't bet)
Seat 2: allin969 (small blind) folded before Flop
Seat 3: TQNYMQNTANA (big blind) folded before Flop
Seat 4: amansah collected ($3.10)
Seat 5: LastNoma folded before Flop (didn't bet)
Seat 6: SantiagoWeight folded before Flop (didn't bet)



PokerStars Zoom Hand #195024605180:  Hold'em No Limit ($0.10/$0.25) - 2018/12/29 4:46:08 UTC [2018/12/28 23:46:08 ET]
Table 'Hydra' 6-max Seat #1 is the button
Seat 1: ivann14 ($25 in chips) 
Seat 2: SantiagoWeight ($72.25 in chips) 
Seat 3: BADMEDICINEM ($23.45 in chips) 
Seat 4: Lehared ($33.44 in chips) 
Seat 5: Viiiru ($60.40 in chips) 
Seat 6: cheolbeom ($33.59 in chips) 
SantiagoWeight: posts small blind $0.10
BADMEDICINEM: posts big blind $0.25
*** HOLE CARDS ***
Dealt to SantiagoWeight [8c 8d]
Lehared: folds 
Viiiru: folds 
cheolbeom: folds 
ivann14: raises $0.25 to $0.50
SantiagoWeight: raises $1.30 to $1.80
BADMEDICINEM: folds 
ivann14: folds 
Uncalled bet ($1.30) returned to SantiagoWeight
SantiagoWeight collected $1.25 from pot
SantiagoWeight: doesn't show hand 
*** SUMMARY ***
Total pot $1.25 | Rake $0 
Seat 1: ivann14 (button) folded before Flop
Seat 2: SantiagoWeight (small blind) collected ($1.25)
Seat 3: BADMEDICINEM (big blind) folded before Flop
Seat 4: Lehared folded before Flop (didn't bet)
Seat 5: Viiiru folded before Flop (didn't bet)
Seat 6: cheolbeom folded before Flop (didn't bet)



PokerStars Zoom Hand #195024618821:  Hold'em No Limit ($0.10/$0.25) - 2018/12/29 4:46:58 UTC [2018/12/28 23:46:58 ET]
Table 'Hydra' 6-max Seat #1 is the button
Seat 1: crashbuum ($30.04 in chips) 
Seat 2: BADMEDICINEM ($22.85 in chips) 
Seat 3: daveo1008 ($34.51 in chips) 
Seat 4: bestitest542 ($14.27 in chips) 
Seat 5: SantiagoWeight ($73 in chips) 
Seat 6: Gonzalit0o ($46.43 in chips) 
BADMEDICINEM: posts small blind $0.10
daveo1008: posts big blind $0.25
*** HOLE CARDS ***
Dealt to SantiagoWeight [Jc 9s]
bestitest542: folds 
SantiagoWeight: folds 
Gonzalit0o: folds 
crashbuum: folds 
BADMEDICINEM: folds 
Uncalled bet ($0.15) returned to daveo1008
daveo1008 collected $0.20 from pot
daveo1008: doesn't show hand 
*** SUMMARY ***
Total pot $0.20 | Rake $0 
Seat 1: crashbuum (button) folded before Flop (didn't bet)
Seat 2: BADMEDICINEM (small blind) folded before Flop
Seat 3: daveo1008 (big blind) collected ($0.20)
Seat 4: bestitest542 folded before Flop (didn't bet)
Seat 5: SantiagoWeight folded before Flop (didn't bet)
Seat 6: Gonzalit0o folded before Flop (didn't bet)



PokerStars Zoom Hand #195024622927:  Hold'em No Limit ($0.10/$0.25) - 2018/12/29 4:47:13 UTC [2018/12/28 23:47:13 ET]
Table 'Hydra' 6-max Seat #1 is the button
Seat 1: Elapostador33 ($38.37 in chips) 
Seat 2: dk dreadlook ($34.76 in chips) 
Seat 3: SantiagoWeight ($73 in chips) 
Seat 4: labattblu ($16.76 in chips) 
Seat 5: river plate9 ($40.08 in chips) 
Seat 6: TQNYMQNTANA ($58.02 in chips) 
dk dreadlook: posts small blind $0.10
SantiagoWeight: posts big blind $0.25
*** HOLE CARDS ***
Dealt to SantiagoWeight [Kh Tc]
labattblu: folds 
river plate9: folds 
TQNYMQNTANA: raises $0.50 to $0.75
Elapostador33: calls $0.75
dk dreadlook: folds 
SantiagoWeight: folds 
*** FLOP *** [6h Ks 8h]
TQNYMQNTANA: checks 
Elapostador33: bets $1.25
TQNYMQNTANA: folds 
Uncalled bet ($1.25) returned to Elapostador33
Elapostador33 collected $1.77 from pot
Elapostador33: doesn't show hand 
*** SUMMARY ***
Total pot $1.85 | Rake $0.08 
Board [6h Ks 8h]
Seat 1: Elapostador33 (button) collected ($1.77)
Seat 2: dk dreadlook (small blind) folded before Flop
Seat 3: SantiagoWeight (big blind) folded before Flop
Seat 4: labattblu folded before Flop (didn't bet)
Seat 5: river plate9 folded before Flop (didn't bet)
Seat 6: TQNYMQNTANA folded on the Flop



PokerStars Zoom Hand #195024615224:  Hold'em No Limit ($0.10/$0.25) - 2018/12/29 4:46:45 UTC [2018/12/28 23:46:45 ET]
Table 'Hydra' 6-max Seat #1 is the button
Seat 1: SantiagoWeight ($73 in chips) 
Seat 2: RoccoQc10 ($21.87 in chips) 
Seat 3: reggiedogg31 ($114.90 in chips) 
Seat 4: Bonen18 ($66.24 in chips) 
Seat 5: sikach78 ($25.04 in chips) 
Seat 6: pirosiky ($60.82 in chips) 
RoccoQc10: posts small blind $0.10
reggiedogg31: posts big blind $0.25
*** HOLE CARDS ***
Dealt to SantiagoWeight [3s 6d]
Bonen18: folds 
sikach78: folds 
pirosiky: folds 
SantiagoWeight: folds 
RoccoQc10: calls $0.15
reggiedogg31: checks 
*** FLOP *** [Kc 4s Jd]
RoccoQc10: checks 
reggiedogg31: checks 
*** TURN *** [Kc 4s Jd] [3d]
RoccoQc10: checks 
reggiedogg31: bets $0.50
RoccoQc10: folds 
Uncalled bet ($0.50) returned to reggiedogg31
reggiedogg31 collected $0.48 from pot
reggiedogg31: doesn't show hand 
*** SUMMARY ***
Total pot $0.50 | Rake $0.02 
Board [Kc 4s Jd 3d]
Seat 1: SantiagoWeight (button) folded before Flop (didn't bet)
Seat 2: RoccoQc10 (small blind) folded on the Turn
Seat 3: reggiedogg31 (big blind) collected ($0.48)
Seat 4: Bonen18 folded before Flop (didn't bet)
Seat 5: sikach78 folded before Flop (didn't bet)
Seat 6: pirosiky folded before Flop (didn't bet)



PokerStars Zoom Hand #195024627385:  Hold'em No Limit ($0.10/$0.25) - 2018/12/29 4:47:29 UTC [2018/12/28 23:47:29 ET]
Table 'Hydra' 6-max Seat #1 is the button
Seat 1: Lehared ($34.43 in chips) 
Seat 2: allin969 ($34.02 in chips) 
Seat 3: 905steelcity ($18.05 in chips) 
Seat 4: Gonzalit0o ($85.79 in chips) 
Seat 5: ARTBIL ($23.89 in chips) 
Seat 6: SantiagoWeight ($72.75 in chips) 
allin969: posts small blind $0.10
905steelcity: posts big blind $0.25
*** HOLE CARDS ***
Dealt to SantiagoWeight [Ks Th]
Gonzalit0o: folds 
ARTBIL: raises $0.50 to $0.75
SantiagoWeight: folds 
Lehared: folds 
allin969: folds 
905steelcity: calls $0.50
*** FLOP *** [8d Qh 9s]
905steelcity: checks 
ARTBIL: bets $1.02
905steelcity: calls $1.02
*** TURN *** [8d Qh 9s] [Td]
905steelcity: checks 
ARTBIL: bets $2.32
905steelcity: calls $2.32
*** RIVER *** [8d Qh 9s Td] [6c]
905steelcity: checks 
ARTBIL: bets $5.27
905steelcity: folds 
Uncalled bet ($5.27) returned to ARTBIL
ARTBIL collected $7.91 from pot
ARTBIL: doesn't show hand 
*** SUMMARY ***
Total pot $8.28 | Rake $0.37 
Board [8d Qh 9s Td 6c]
Seat 1: Lehared (button) folded before Flop (didn't bet)
Seat 2: allin969 (small blind) folded before Flop
Seat 3: 905steelcity (big blind) folded on the River
Seat 4: Gonzalit0o folded before Flop (didn't bet)
Seat 5: ARTBIL collected ($7.91)
Seat 6: SantiagoWeight folded before Flop (didn't bet)



PokerStars Zoom Hand #195024632273:  Hold'em No Limit ($0.10/$0.25) - 2018/12/29 4:47:47 UTC [2018/12/28 23:47:47 ET]
Table 'Hydra' 6-max Seat #1 is the button
Seat 1: labattblu ($17.11 in chips) 
Seat 2: reggiedogg31 ($115.13 in chips) 
Seat 3: sensamen ($25 in chips) 
Seat 4: SantiagoWeight ($72.75 in chips) 
Seat 5: louiskitu ($37.11 in chips) 
Seat 6: hames_tj ($26.24 in chips) 
reggiedogg31: posts small blind $0.10
sensamen: posts big blind $0.25
*** HOLE CARDS ***
Dealt to SantiagoWeight [8c Tc]
SantiagoWeight has timed out
SantiagoWeight: folds 
louiskitu: folds 
hames_tj: folds 
labattblu: raises $0.25 to $0.50
reggiedogg31: folds 
sensamen: folds 
Uncalled bet ($0.25) returned to labattblu
labattblu collected $0.60 from pot
labattblu: doesn't show hand 
*** SUMMARY ***
Total pot $0.60 | Rake $0 
Seat 1: labattblu (button) collected ($0.60)
Seat 2: reggiedogg31 (small blind) folded before Flop
Seat 3: sensamen (big blind) folded before Flop
Seat 4: SantiagoWeight folded before Flop (didn't bet)
Seat 5: louiskitu folded before Flop (didn't bet)
Seat 6: hames_tj folded before Flop (didn't bet)



PokerStars Zoom Hand #195024638420:  Hold'em No Limit ($0.10/$0.25) - 2018/12/29 4:48:09 UTC [2018/12/28 23:48:09 ET]
Table 'Hydra' 6-max Seat #1 is the button
Seat 1: Rika_run ($32.91 in chips) 
Seat 2: koichi1210 ($25.78 in chips) 
Seat 3: graysonai ($59.40 in chips) 
Seat 4: SantiagoWeight ($72.75 in chips) 
Seat 5: !P0K3RM3T4L! ($29.83 in chips) 
Seat 6: ryanking99 ($47.80 in chips) 
koichi1210: posts small blind $0.10
graysonai: posts big blind $0.25
*** HOLE CARDS ***
Dealt to SantiagoWeight [4c 9d]
SantiagoWeight: folds 
!P0K3RM3T4L!: folds 
ryanking99: folds 
Rika_run: raises $0.31 to $0.56
koichi1210: calls $0.46
graysonai: folds 
*** FLOP *** [Tc 3c 4d]
koichi1210: checks 
Rika_run: bets $0.44
koichi1210: raises $1.27 to $1.71
Rika_run: folds 
Uncalled bet ($1.27) returned to koichi1210
koichi1210 collected $2.15 from pot
koichi1210: doesn't show hand 
*** SUMMARY ***
Total pot $2.25 | Rake $0.10 
Board [Tc 3c 4d]
Seat 1: Rika_run (button) folded on the Flop
Seat 2: koichi1210 (small blind) collected ($2.15)
Seat 3: graysonai (big blind) folded before Flop
Seat 4: SantiagoWeight folded before Flop (didn't bet)
Seat 5: !P0K3RM3T4L! folded before Flop (didn't bet)
Seat 6: ryanking99 folded before Flop (didn't bet)



PokerStars Zoom Hand #195024641471:  Hold'em No Limit ($0.10/$0.25) - 2018/12/29 4:48:20 UTC [2018/12/28 23:48:20 ET]
Table 'Hydra' 6-max Seat #1 is the button
Seat 1: SantiagoWeight ($72.75 in chips) 
Seat 2: asapon ($27.80 in chips) 
Seat 3: hames_tj ($30.97 in chips) 
Seat 4: mariopork ($37.11 in chips) 
Seat 5: dk dreadlook ($37.86 in chips) 
Seat 6: Bonen18 ($26.13 in chips) 
asapon: posts small blind $0.10
hames_tj: posts big blind $0.25
*** HOLE CARDS ***
Dealt to SantiagoWeight [9s 6s]
mariopork: folds 
dk dreadlook: folds 
Bonen18: folds 
SantiagoWeight: raises $0.30 to $0.55
asapon: folds 
hames_tj: calls $0.30
*** FLOP *** [Ks 3d Jh]
hames_tj: checks 
SantiagoWeight: bets $0.29
hames_tj: calls $0.29
*** TURN *** [Ks 3d Jh] [Th]
hames_tj: checks 
SantiagoWeight: checks 
*** RIVER *** [Ks 3d Jh Th] [7d]
hames_tj: checks 
SantiagoWeight: bets $1.30
hames_tj: folds 
Uncalled bet ($1.30) returned to SantiagoWeight
SantiagoWeight collected $1.70 from pot
SantiagoWeight: doesn't show hand 
*** SUMMARY ***
Total pot $1.78 | Rake $0.08 
Board [Ks 3d Jh Th 7d]
Seat 1: SantiagoWeight (button) collected ($1.70)
Seat 2: asapon (small blind) folded before Flop
Seat 3: hames_tj (big blind) folded on the River
Seat 4: mariopork folded before Flop (didn't bet)
Seat 5: dk dreadlook folded before Flop (didn't bet)
Seat 6: Bonen18 folded before Flop (didn't bet)



PokerStars Zoom Hand #195024668096:  Hold'em No Limit ($0.10/$0.25) - 2018/12/29 4:49:58 UTC [2018/12/28 23:49:58 ET]
Table 'Hydra' 6-max Seat #1 is the button
Seat 1: Viiiru ($33.41 in chips) 
Seat 2: SantiagoWeight ($73.61 in chips) 
Seat 3: trillerGTO ($25 in chips) 
Seat 4: ricpoitras ($32.96 in chips) 
Seat 5: Gonzalit0o ($35.03 in chips) 
Seat 6: bigpower629 ($25.35 in chips) 
SantiagoWeight: posts small blind $0.10
trillerGTO: posts big blind $0.25
*** HOLE CARDS ***
Dealt to SantiagoWeight [9s 9d]
ricpoitras: folds 
Gonzalit0o: raises $0.50 to $0.75
bigpower629: calls $0.75
Viiiru: folds 
SantiagoWeight: calls $0.65
trillerGTO: folds 
*** FLOP *** [Ac Qc Ah]
SantiagoWeight: checks 
Gonzalit0o: bets $0.79
bigpower629: calls $0.79
SantiagoWeight: folds 
*** TURN *** [Ac Qc Ah] [Qd]
Gonzalit0o: bets $1.29
bigpower629: raises $3.37 to $4.66
Gonzalit0o: calls $3.37
*** RIVER *** [Ac Qc Ah Qd] [Jc]
Gonzalit0o: checks 
bigpower629: bets $9.47
Gonzalit0o: raises $9.47 to $18.94
bigpower629: calls $9.47
*** SHOW DOWN ***
Gonzalit0o: shows [Th Ad] (a full house, Aces full of Queens)
bigpower629: shows [Ts As] (a full house, Aces full of Queens)
Gonzalit0o collected $24.64 from pot
bigpower629 collected $24.64 from pot
*** SUMMARY ***
Total pot $51.28 | Rake $2 
Board [Ac Qc Ah Qd Jc]
Seat 1: Viiiru (button) folded before Flop (didn't bet)
Seat 2: SantiagoWeight (small blind) folded on the Flop
Seat 3: trillerGTO (big blind) folded before Flop
Seat 4: ricpoitras folded before Flop (didn't bet)
Seat 5: Gonzalit0o showed [Th Ad] and won ($24.64) with a full house, Aces full of Queens
Seat 6: bigpower629 showed [Ts As] and won ($24.64) with a full house, Aces full of Queens



PokerStars Zoom Hand #195024684374:  Hold'em No Limit ($0.10/$0.25) - 2018/12/29 4:50:59 UTC [2018/12/28 23:50:59 ET]
Table 'Hydra' 6-max Seat #1 is the button
Seat 1: trillerGTO ($24.85 in chips) 
Seat 2: SpaZz0205 ($17.33 in chips) 
Seat 3: mariopork ($33.50 in chips) 
Seat 4: SantiagoWeight ($72.86 in chips) 
Seat 5: graysonai ($32.48 in chips) 
Seat 6: asapon ($25.35 in chips) 
SpaZz0205: posts small blind $0.10
mariopork: posts big blind $0.25
*** HOLE CARDS ***
Dealt to SantiagoWeight [9c 6c]
SantiagoWeight: folds 
graysonai: raises $0.30 to $0.55
asapon: folds 
trillerGTO: folds 
SpaZz0205: raises $0.30 to $0.85
mariopork: folds 
graysonai: calls $0.30
*** FLOP *** [5c 3c 8s]
SpaZz0205: checks 
graysonai: checks 
*** TURN *** [5c 3c 8s] [Jc]
SpaZz0205: bets $1
graysonai: folds 
Uncalled bet ($1) returned to SpaZz0205
SpaZz0205 collected $1.86 from pot
SpaZz0205: doesn't show hand 
*** SUMMARY ***
Total pot $1.95 | Rake $0.09 
Board [5c 3c 8s Jc]
Seat 1: trillerGTO (button) folded before Flop (didn't bet)
Seat 2: SpaZz0205 (small blind) collected ($1.86)
Seat 3: mariopork (big blind) folded before Flop
Seat 4: SantiagoWeight folded before Flop (didn't bet)
Seat 5: graysonai folded on the Turn
Seat 6: asapon folded before Flop (didn't bet)



PokerStars Zoom Hand #195024686502:  Hold'em No Limit ($0.10/$0.25) - 2018/12/29 4:51:07 UTC [2018/12/28 23:51:07 ET]
Table 'Hydra' 6-max Seat #1 is the button
Seat 1: asapon ($53.75 in chips) 
Seat 2: ARTBIL ($24.01 in chips) 
Seat 3: SantiagoWeight ($72.86 in chips) 
Seat 4: oksana12422 ($15.79 in chips) 
Seat 5: BRSOB79 ($25 in chips) 
Seat 6: zaneti8722 ($6.77 in chips) 
ARTBIL: posts small blind $0.10
SantiagoWeight: posts big blind $0.25
*** HOLE CARDS ***
Dealt to SantiagoWeight [Qh Qd]
oksana12422: folds 
BRSOB79: folds 
zaneti8722: folds 
asapon: raises $0.27 to $0.52
ARTBIL: calls $0.42
SantiagoWeight: raises $2.88 to $3.40
asapon: calls $2.88
ARTBIL: calls $2.88
*** FLOP *** [4s 2d Ah]
ARTBIL: checks 
SantiagoWeight: bets $2.44
asapon: folds 
ARTBIL: calls $2.44
*** TURN *** [4s 2d Ah] [9d]
ARTBIL: checks 
SantiagoWeight: checks 
*** RIVER *** [4s 2d Ah 9d] [2c]
ARTBIL: checks 
SantiagoWeight: checks 
*** SHOW DOWN ***
ARTBIL: shows [5h 5s] (two pair, Fives and Deuces)
SantiagoWeight: shows [Qh Qd] (two pair, Queens and Deuces)
SantiagoWeight collected $14.40 from pot
*** SUMMARY ***
Total pot $15.08 | Rake $0.68 
Board [4s 2d Ah 9d 2c]
Seat 1: asapon (button) folded on the Flop
Seat 2: ARTBIL (small blind) showed [5h 5s] and lost with two pair, Fives and Deuces
Seat 3: SantiagoWeight (big blind) showed [Qh Qd] and won ($14.40) with two pair, Queens and Deuces
Seat 4: oksana12422 folded before Flop (didn't bet)
Seat 5: BRSOB79 folded before Flop (didn't bet)
Seat 6: zaneti8722 folded before Flop (didn't bet)



PokerStars Zoom Hand #195024718148:  Hold'em No Limit ($0.10/$0.25) - 2018/12/29 4:53:08 UTC [2018/12/28 23:53:08 ET]
Table 'Hydra' 6-max Seat #1 is the button
Seat 1: reggiedogg31 ($109.52 in chips) 
Seat 2: zbuci ($13.78 in chips) 
Seat 3: koichi1210 ($22.05 in chips) 
Seat 4: xman141 ($93.89 in chips) 
Seat 5: Thermal0007 ($18.07 in chips) 
Seat 6: SantiagoWeight ($81.42 in chips) 
zbuci: posts small blind $0.10
koichi1210: posts big blind $0.25
*** HOLE CARDS ***
Dealt to SantiagoWeight [Ks 7s]
xman141: folds 
Thermal0007: raises $0.25 to $0.50
SantiagoWeight: folds 
reggiedogg31: folds 
zbuci: folds 
koichi1210: folds 
Uncalled bet ($0.25) returned to Thermal0007
Thermal0007 collected $0.60 from pot
Thermal0007: doesn't show hand 
*** SUMMARY ***
Total pot $0.60 | Rake $0 
Seat 1: reggiedogg31 (button) folded before Flop (didn't bet)
Seat 2: zbuci (small blind) folded before Flop
Seat 3: koichi1210 (big blind) folded before Flop
Seat 4: xman141 folded before Flop (didn't bet)
Seat 5: Thermal0007 collected ($0.60)
Seat 6: SantiagoWeight folded before Flop (didn't bet)



PokerStars Zoom Hand #195024721861:  Hold'em No Limit ($0.10/$0.25) - 2018/12/29 4:53:22 UTC [2018/12/28 23:53:22 ET]
Table 'Hydra' 6-max Seat #1 is the button
Seat 1: mariopork ($123.01 in chips) 
Seat 2: SantiagoWeight ($81.42 in chips) 
Seat 3: KAOS914 ($25.47 in chips) 
Seat 4: xXBossHossXx ($87.19 in chips) 
Seat 5: TQNYMQNTANA ($34.43 in chips) 
Seat 6: ryanking99 ($5.76 in chips) 
SantiagoWeight: posts small blind $0.10
KAOS914: posts big blind $0.25
*** HOLE CARDS ***
Dealt to SantiagoWeight [2s Ac]
xXBossHossXx: raises $0.50 to $0.75
TQNYMQNTANA: folds 
ryanking99: folds 
mariopork: folds 
SantiagoWeight: folds 
KAOS914: folds 
Uncalled bet ($0.50) returned to xXBossHossXx
xXBossHossXx collected $0.60 from pot
xXBossHossXx: doesn't show hand 
*** SUMMARY ***
Total pot $0.60 | Rake $0 
Seat 1: mariopork (button) folded before Flop (didn't bet)
Seat 2: SantiagoWeight (small blind) folded before Flop
Seat 3: KAOS914 (big blind) folded before Flop
Seat 4: xXBossHossXx collected ($0.60)
Seat 5: TQNYMQNTANA folded before Flop (didn't bet)
Seat 6: ryanking99 folded before Flop (didn't bet)



PokerStars Zoom Hand #195024727352:  Hold'em No Limit ($0.10/$0.25) - 2018/12/29 4:53:43 UTC [2018/12/28 23:53:43 ET]
Table 'Hydra' 6-max Seat #1 is the button
Seat 1: dawwwid70 ($87.34 in chips) 
Seat 2: mariopork ($25 in chips) 
Seat 3: Elapostador33 ($54.34 in chips) 
Seat 4: ivann14 ($41.25 in chips) 
Seat 5: Nutselas ($68.65 in chips) 
Seat 6: SantiagoWeight ($81.32 in chips) 
mariopork: posts small blind $0.10
Elapostador33: posts big blind $0.25
*** HOLE CARDS ***
Dealt to SantiagoWeight [Kd Ts]
ivann14: raises $0.50 to $0.75
Nutselas: folds 
SantiagoWeight: folds 
dawwwid70: folds 
mariopork: folds 
Elapostador33: folds 
Uncalled bet ($0.50) returned to ivann14
ivann14 collected $0.60 from pot
ivann14: doesn't show hand 
*** SUMMARY ***
Total pot $0.60 | Rake $0 
Seat 1: dawwwid70 (button) folded before Flop (didn't bet)
Seat 2: mariopork (small blind) folded before Flop
Seat 3: Elapostador33 (big blind) folded before Flop
Seat 4: ivann14 collected ($0.60)
Seat 5: Nutselas folded before Flop (didn't bet)
Seat 6: SantiagoWeight folded before Flop (didn't bet)



PokerStars Zoom Hand #195024730654:  Hold'em No Limit ($0.10/$0.25) - 2018/12/29 4:53:56 UTC [2018/12/28 23:53:56 ET]
Table 'Hydra' 6-max Seat #1 is the button
Seat 1: SantiagoWeight ($81.32 in chips) 
Seat 2: LastNoma ($25.10 in chips) 
Seat 3: t57571245 ($33.03 in chips) 
Seat 4: reggiedogg31 ($109.02 in chips) 
Seat 5: trillerGTO ($23.22 in chips) 
Seat 6: koichi1210 ($26.23 in chips) 
LastNoma: posts small blind $0.10
t57571245: posts big blind $0.25
*** HOLE CARDS ***
Dealt to SantiagoWeight [Qd As]
reggiedogg31: folds 
trillerGTO: folds 
koichi1210: folds 
SantiagoWeight: raises $0.30 to $0.55
LastNoma: folds 
t57571245: calls $0.30
*** FLOP *** [4s 4d 6s]
t57571245: checks 
SantiagoWeight: bets $0.29
t57571245: calls $0.29
*** TURN *** [4s 4d 6s] [5s]
t57571245: checks 
SantiagoWeight: bets $1.50
t57571245: folds 
Uncalled bet ($1.50) returned to SantiagoWeight
SantiagoWeight collected $1.70 from pot
SantiagoWeight: doesn't show hand 
*** SUMMARY ***
Total pot $1.78 | Rake $0.08 
Board [4s 4d 6s 5s]
Seat 1: SantiagoWeight (button) collected ($1.70)
Seat 2: LastNoma (small blind) folded before Flop
Seat 3: t57571245 (big blind) folded on the Turn
Seat 4: reggiedogg31 folded before Flop (didn't bet)
Seat 5: trillerGTO folded before Flop (didn't bet)
Seat 6: koichi1210 folded before Flop (didn't bet)



PokerStars Zoom Hand #195024749430:  Hold'em No Limit ($0.10/$0.25) - 2018/12/29 4:55:08 UTC [2018/12/28 23:55:08 ET]
Table 'Hydra' 6-max Seat #1 is the button
Seat 1: louiskitu ($15.99 in chips) 
Seat 2: zbuci ($15.46 in chips) 
Seat 3: SantiagoWeight ($82.18 in chips) 
Seat 4: Buntar017 ($60.61 in chips) 
Seat 5: LastNoma ($46.18 in chips) 
Seat 6: ritchy99 ($30.67 in chips) 
zbuci: posts small blind $0.10
SantiagoWeight: posts big blind $0.25
*** HOLE CARDS ***
Dealt to SantiagoWeight [5c Ad]
Buntar017: raises $0.50 to $0.75
LastNoma: folds 
ritchy99: folds 
louiskitu: folds 
zbuci: folds 
SantiagoWeight: folds 
Uncalled bet ($0.50) returned to Buntar017
Buntar017 collected $0.60 from pot
*** SUMMARY ***
Total pot $0.60 | Rake $0 
Seat 1: louiskitu (button) folded before Flop (didn't bet)
Seat 2: zbuci (small blind) folded before Flop
Seat 3: SantiagoWeight (big blind) folded before Flop
Seat 4: Buntar017 collected ($0.60)
Seat 5: LastNoma folded before Flop (didn't bet)
Seat 6: ritchy99 folded before Flop (didn't bet)



PokerStars Zoom Hand #195024747352:  Hold'em No Limit ($0.10/$0.25) - 2018/12/29 4:55:00 UTC [2018/12/28 23:55:00 ET]
Table 'Hydra' 6-max Seat #1 is the button
Seat 1: Papaya006 ($25.07 in chips) 
Seat 2: Rika_run ($27.65 in chips) 
Seat 3: louiskitu ($35.17 in chips) 
Seat 4: sikach78 ($16.85 in chips) 
Seat 5: SantiagoWeight ($82.18 in chips) 
Seat 6: Bonen18 ($63.84 in chips) 
Rika_run: posts small blind $0.10
louiskitu: posts big blind $0.25
*** HOLE CARDS ***
Dealt to SantiagoWeight [Ts 5d]
sikach78: raises $0.25 to $0.50
SantiagoWeight: folds 
Bonen18: folds 
Papaya006: folds 
Rika_run: folds 
louiskitu: calls $0.25
*** FLOP *** [As 9d 9c]
louiskitu: checks 
sikach78: bets $0.75
louiskitu: folds 
Uncalled bet ($0.75) returned to sikach78
sikach78 collected $1.05 from pot
sikach78: doesn't show hand 
*** SUMMARY ***
Total pot $1.10 | Rake $0.05 
Board [As 9d 9c]
Seat 1: Papaya006 (button) folded before Flop (didn't bet)
Seat 2: Rika_run (small blind) folded before Flop
Seat 3: louiskitu (big blind) folded on the Flop
Seat 4: sikach78 collected ($1.05)
Seat 5: SantiagoWeight folded before Flop (didn't bet)
Seat 6: Bonen18 folded before Flop (didn't bet)



PokerStars Zoom Hand #195024752224:  Hold'em No Limit ($0.10/$0.25) - 2018/12/29 4:55:20 UTC [2018/12/28 23:55:20 ET]
Table 'Hydra' 6-max Seat #1 is the button
Seat 1: mchiefaakk ($7.91 in chips) 
Seat 2: asapon ($25 in chips) 
Seat 3: Chrimmpam ($16.64 in chips) 
Seat 4: LastNoma ($28.07 in chips) 
Seat 5: SantiagoWeight ($81.93 in chips) 
Seat 6: Virus3232 ($32.42 in chips) 
asapon: posts small blind $0.10
Chrimmpam: posts big blind $0.25
*** HOLE CARDS ***
Dealt to SantiagoWeight [Jh 7s]
LastNoma: folds 
SantiagoWeight: folds 
Virus3232: folds 
mchiefaakk: folds 
asapon: folds 
Uncalled bet ($0.15) returned to Chrimmpam
Chrimmpam collected $0.20 from pot
Chrimmpam: doesn't show hand 
*** SUMMARY ***
Total pot $0.20 | Rake $0 
Seat 1: mchiefaakk (button) folded before Flop (didn't bet)
Seat 2: asapon (small blind) folded before Flop
Seat 3: Chrimmpam (big blind) collected ($0.20)
Seat 4: LastNoma folded before Flop (didn't bet)
Seat 5: SantiagoWeight folded before Flop (didn't bet)
Seat 6: Virus3232 folded before Flop (didn't bet)



PokerStars Zoom Hand #195024753618:  Hold'em No Limit ($0.10/$0.25) - 2018/12/29 4:55:26 UTC [2018/12/28 23:55:26 ET]
Table 'Hydra' 6-max Seat #1 is the button
Seat 1: zdenekstavic ($58.18 in chips) 
Seat 2: alex3d1985 ($23.33 in chips) 
Seat 3: ttshead ($76.62 in chips) 
Seat 4: SantiagoWeight ($81.93 in chips) 
Seat 5: !P0K3RM3T4L! ($25 in chips) 
Seat 6: sikach78 ($17.40 in chips) 
alex3d1985: posts small blind $0.10
ttshead: posts big blind $0.25
*** HOLE CARDS ***
Dealt to SantiagoWeight [2d 5h]
SantiagoWeight: folds 
!P0K3RM3T4L!: folds 
sikach78: folds 
zdenekstavic: folds 
alex3d1985: folds 
Uncalled bet ($0.15) returned to ttshead
ttshead collected $0.20 from pot
ttshead: doesn't show hand 
*** SUMMARY ***
Total pot $0.20 | Rake $0 
Seat 1: zdenekstavic (button) folded before Flop (didn't bet)
Seat 2: alex3d1985 (small blind) folded before Flop
Seat 3: ttshead (big blind) collected ($0.20)
Seat 4: SantiagoWeight folded before Flop (didn't bet)
Seat 5: !P0K3RM3T4L! folded before Flop (didn't bet)
Seat 6: sikach78 folded before Flop (didn't bet)



PokerStars Zoom Hand #195024757121:  Hold'em No Limit ($0.10/$0.25) - 2018/12/29 4:55:41 UTC [2018/12/28 23:55:41 ET]
Table 'Hydra' 6-max Seat #1 is the button
Seat 1: glenn.vaughan ($38.63 in chips) 
Seat 2: SantiagoWeight ($81.93 in chips) 
Seat 3: deaglepro ($55.42 in chips) 
Seat 4: graysonai ($34.30 in chips) 
Seat 5: _BluDeeN_ ($34.45 in chips) 
Seat 6: Thermal0007 ($34.75 in chips) 
SantiagoWeight: posts small blind $0.10
deaglepro: posts big blind $0.25
*** HOLE CARDS ***
Dealt to SantiagoWeight [4c 6d]
graysonai: folds 
_BluDeeN_: folds 
Thermal0007: folds 
glenn.vaughan: raises $0.60 to $0.85
SantiagoWeight: folds 
deaglepro: folds 
Uncalled bet ($0.60) returned to glenn.vaughan
glenn.vaughan collected $0.60 from pot
glenn.vaughan: doesn't show hand 
*** SUMMARY ***
Total pot $0.60 | Rake $0 
Seat 1: glenn.vaughan (button) collected ($0.60)
Seat 2: SantiagoWeight (small blind) folded before Flop
Seat 3: deaglepro (big blind) folded before Flop
Seat 4: graysonai folded before Flop (didn't bet)
Seat 5: _BluDeeN_ folded before Flop (didn't bet)
Seat 6: Thermal0007 folded before Flop (didn't bet)



PokerStars Zoom Hand #195024760588:  Hold'em No Limit ($0.10/$0.25) - 2018/12/29 4:55:56 UTC [2018/12/28 23:55:56 ET]
Table 'Hydra' 6-max Seat #1 is the button
Seat 1: SantiagoWeight ($81.83 in chips) 
Seat 2: islam1328 ($46.30 in chips) 
Seat 3: papico3 ($25.40 in chips) 
Seat 4: LastNoma ($47.93 in chips) 
Seat 5: Higashi2314 ($46.92 in chips) 
Seat 6: Bonen18 ($25.16 in chips) 
islam1328: posts small blind $0.10
papico3: posts big blind $0.25
*** HOLE CARDS ***
Dealt to SantiagoWeight [2h Js]
LastNoma: folds 
Higashi2314: raises $0.50 to $0.75
Bonen18: folds 
SantiagoWeight: folds 
islam1328: folds 
papico3: folds 
Uncalled bet ($0.50) returned to Higashi2314
Higashi2314 collected $0.60 from pot
Higashi2314: doesn't show hand 
*** SUMMARY ***
Total pot $0.60 | Rake $0 
Seat 1: SantiagoWeight (button) folded before Flop (didn't bet)
Seat 2: islam1328 (small blind) folded before Flop
Seat 3: papico3 (big blind) folded before Flop
Seat 4: LastNoma folded before Flop (didn't bet)
Seat 5: Higashi2314 collected ($0.60)
Seat 6: Bonen18 folded before Flop (didn't bet)



PokerStars Zoom Hand #195024768598:  Hold'em No Limit ($0.10/$0.25) - 2018/12/29 4:56:30 UTC [2018/12/28 23:56:30 ET]
Table 'Hydra' 6-max Seat #1 is the button
Seat 1: TQNYMQNTANA ($53.04 in chips) 
Seat 2: GrandmasterY ($25 in chips) 
Seat 3: Rika_run ($30.41 in chips) 
Seat 4: SantiagoWeight ($81.58 in chips) 
Seat 5: deaglepro ($54.82 in chips) 
Seat 6: dawwwid70 ($25 in chips) 
GrandmasterY: posts small blind $0.10
Rika_run: posts big blind $0.25
*** HOLE CARDS ***
Dealt to SantiagoWeight [Ks 4s]
SantiagoWeight: folds 
deaglepro: folds 
dawwwid70: folds 
TQNYMQNTANA: folds 
GrandmasterY: folds 
Uncalled bet ($0.15) returned to Rika_run
Rika_run collected $0.20 from pot
Rika_run: doesn't show hand 
*** SUMMARY ***
Total pot $0.20 | Rake $0 
Seat 1: TQNYMQNTANA (button) folded before Flop (didn't bet)
Seat 2: GrandmasterY (small blind) folded before Flop
Seat 3: Rika_run (big blind) collected ($0.20)
Seat 4: SantiagoWeight folded before Flop (didn't bet)
Seat 5: deaglepro folded before Flop (didn't bet)
Seat 6: dawwwid70 folded before Flop (didn't bet)



PokerStars Zoom Hand #195024764373:  Hold'em No Limit ($0.10/$0.25) - 2018/12/29 4:56:12 UTC [2018/12/28 23:56:12 ET]
Table 'Hydra' 6-max Seat #1 is the button
Seat 1: lauriña77 ($40.55 in chips) 
Seat 2: xonegab ($16.05 in chips) 
Seat 3: SantiagoWeight ($81.83 in chips) 
Seat 4: !P0K3RM3T4L! ($25 in chips) 
Seat 5: urgok83 ($16.67 in chips) 
Seat 6: Becks Baker ($25 in chips) 
xonegab: posts small blind $0.10
SantiagoWeight: posts big blind $0.25
*** HOLE CARDS ***
Dealt to SantiagoWeight [3c 2h]
!P0K3RM3T4L!: raises $0.35 to $0.60
urgok83: folds 
Becks Baker: folds 
lauriña77: calls $0.60
xonegab: raises $0.35 to $0.95
SantiagoWeight: folds 
!P0K3RM3T4L!: calls $0.35
lauriña77: calls $0.35
*** FLOP *** [9c Ah 6h]
xonegab: checks 
!P0K3RM3T4L!: checks 
lauriña77: checks 
*** TURN *** [9c Ah 6h] [8h]
xonegab: bets $1.50
!P0K3RM3T4L!: folds 
lauriña77: calls $1.50
*** RIVER *** [9c Ah 6h 8h] [7h]
xonegab: bets $3
lauriña77: calls $3
*** SHOW DOWN ***
xonegab: shows [Ad Th] (a flush, Ace high)
lauriña77: mucks hand 
xonegab collected $11.56 from pot
*** SUMMARY ***
Total pot $12.10 | Rake $0.54 
Board [9c Ah 6h 8h 7h]
Seat 1: lauriña77 (button) mucked [8c 5c]
Seat 2: xonegab (small blind) showed [Ad Th] and won ($11.56) with a flush, Ace high
Seat 3: SantiagoWeight (big blind) folded before Flop
Seat 4: !P0K3RM3T4L! folded on the Turn
Seat 5: urgok83 folded before Flop (didn't bet)
Seat 6: Becks Baker folded before Flop (didn't bet)



PokerStars Zoom Hand #195024770196:  Hold'em No Limit ($0.10/$0.25) - 2018/12/29 4:56:37 UTC [2018/12/28 23:56:37 ET]
Table 'Hydra' 6-max Seat #1 is the button
Seat 1: zbuci ($30.29 in chips) 
Seat 2: TQNYMQNTANA ($53.04 in chips) 
Seat 3: Virus3232 ($29.76 in chips) 
Seat 4: KAOS914 ($26.81 in chips) 
Seat 5: SantiagoWeight ($81.58 in chips) 
Seat 6: oksana12422 ($17 in chips) 
TQNYMQNTANA: posts small blind $0.10
Virus3232: posts big blind $0.25
*** HOLE CARDS ***
Dealt to SantiagoWeight [8d 2s]
KAOS914: raises $0.50 to $0.75
SantiagoWeight: folds 
oksana12422: folds 
zbuci: folds 
TQNYMQNTANA: folds 
Virus3232: calls $0.50
*** FLOP *** [Ad 5s 7d]
Virus3232: checks 
KAOS914: bets $1
Virus3232: calls $1
*** TURN *** [Ad 5s 7d] [8c]
Virus3232: checks 
KAOS914: checks 
*** RIVER *** [Ad 5s 7d 8c] [9d]
Virus3232: checks 
KAOS914: checks 
*** SHOW DOWN ***
Virus3232: shows [As 9h] (two pair, Aces and Nines)
KAOS914: mucks hand 
Virus3232 collected $3.44 from pot
*** SUMMARY ***
Total pot $3.60 | Rake $0.16 
Board [Ad 5s 7d 8c 9d]
Seat 1: zbuci (button) folded before Flop (didn't bet)
Seat 2: TQNYMQNTANA (small blind) folded before Flop
Seat 3: Virus3232 (big blind) showed [As 9h] and won ($3.44) with two pair, Aces and Nines
Seat 4: KAOS914 mucked [Js Kh]
Seat 5: SantiagoWeight folded before Flop (didn't bet)
Seat 6: oksana12422 folded before Flop (didn't bet)



PokerStars Zoom Hand #195024774816:  Hold'em No Limit ($0.10/$0.25) - 2018/12/29 4:56:57 UTC [2018/12/28 23:56:57 ET]
Table 'Hydra' 6-max Seat #1 is the button
Seat 1: xXBossHossXx ($87.29 in chips) 
Seat 2: SantiagoWeight ($81.58 in chips) 
Seat 3: Gonzalit0o ($34.09 in chips) 
Seat 4: LastNoma ($25.75 in chips) 
Seat 5: MoMoney2612 ($28.63 in chips) 
Seat 6: RESTRICTED.CR17 ($15.09 in chips) 
SantiagoWeight: posts small blind $0.10
Gonzalit0o: posts big blind $0.25
*** HOLE CARDS ***
Dealt to SantiagoWeight [5c 6h]
LastNoma: folds 
MoMoney2612: folds 
RESTRICTED.CR17: folds 
xXBossHossXx: raises $0.50 to $0.75
SantiagoWeight: folds 
Gonzalit0o: folds 
Uncalled bet ($0.50) returned to xXBossHossXx
xXBossHossXx collected $0.60 from pot
xXBossHossXx: doesn't show hand 
*** SUMMARY ***
Total pot $0.60 | Rake $0 
Seat 1: xXBossHossXx (button) collected ($0.60)
Seat 2: SantiagoWeight (small blind) folded before Flop
Seat 3: Gonzalit0o (big blind) folded before Flop
Seat 4: LastNoma folded before Flop (didn't bet)
Seat 5: MoMoney2612 folded before Flop (didn't bet)
Seat 6: RESTRICTED.CR17 folded before Flop (didn't bet)



PokerStars Zoom Hand #195024773208:  Hold'em No Limit ($0.10/$0.25) - 2018/12/29 4:56:50 UTC [2018/12/28 23:56:50 ET]
Table 'Hydra' 6-max Seat #1 is the button
Seat 1: doza123 ($16.66 in chips) 
Seat 2: Virus3232 ($32.17 in chips) 
Seat 3: zbuci ($30.29 in chips) 
Seat 4: asapon ($25 in chips) 
Seat 5: oksana12422 ($16.75 in chips) 
Seat 6: SantiagoWeight ($81.58 in chips) 
Virus3232: posts small blind $0.10
zbuci: posts big blind $0.25
*** HOLE CARDS ***
Dealt to SantiagoWeight [8d 7h]
asapon: folds 
oksana12422: folds 
SantiagoWeight: folds 
doza123: raises $0.50 to $0.75
Virus3232: folds 
zbuci: calls $0.50
*** FLOP *** [7d 9h Jc]
zbuci: bets $0.77
doza123: folds 
Uncalled bet ($0.77) returned to zbuci
zbuci collected $1.53 from pot
zbuci: doesn't show hand 
*** SUMMARY ***
Total pot $1.60 | Rake $0.07 
Board [7d 9h Jc]
Seat 1: doza123 (button) folded on the Flop
Seat 2: Virus3232 (small blind) folded before Flop
Seat 3: zbuci (big blind) collected ($1.53)
Seat 4: asapon folded before Flop (didn't bet)
Seat 5: oksana12422 folded before Flop (didn't bet)
Seat 6: SantiagoWeight folded before Flop (didn't bet)



PokerStars Zoom Hand #195024782604:  Hold'em No Limit ($0.10/$0.25) - 2018/12/29 4:57:30 UTC [2018/12/28 23:57:30 ET]
Table 'Hydra' 6-max Seat #1 is the button
Seat 1: graysonai ($69.30 in chips) 
Seat 2: Gonzalit0o ($40.55 in chips) 
Seat 3: SantiagoWeight ($81.48 in chips) 
Seat 4: Thermal0007 ($34.25 in chips) 
Seat 5: mililser ($54.30 in chips) 
Seat 6: alex3d1985 ($19.73 in chips) 
Gonzalit0o: posts small blind $0.10
SantiagoWeight: posts big blind $0.25
*** HOLE CARDS ***
Dealt to SantiagoWeight [5s Js]
Thermal0007: folds 
mililser: folds 
alex3d1985: folds 
graysonai: folds 
Gonzalit0o: folds 
Uncalled bet ($0.15) returned to SantiagoWeight
SantiagoWeight collected $0.20 from pot
SantiagoWeight: doesn't show hand 
*** SUMMARY ***
Total pot $0.20 | Rake $0 
Seat 1: graysonai (button) folded before Flop (didn't bet)
Seat 2: Gonzalit0o (small blind) folded before Flop
Seat 3: SantiagoWeight (big blind) collected ($0.20)
Seat 4: Thermal0007 folded before Flop (didn't bet)
Seat 5: mililser folded before Flop (didn't bet)
Seat 6: alex3d1985 folded before Flop (didn't bet)



PokerStars Zoom Hand #195024779474:  Hold'em No Limit ($0.10/$0.25) - 2018/12/29 4:57:17 UTC [2018/12/28 23:57:17 ET]
Table 'Hydra' 6-max Seat #1 is the button
Seat 1: hames_tj ($25.35 in chips) 
Seat 2: zbuci ($31.07 in chips) 
Seat 3: sikach78 ($18.03 in chips) 
Seat 4: Bonen18 ($25 in chips) 
Seat 5: KAOS914 ($36.45 in chips) 
Seat 6: SantiagoWeight ($81.48 in chips) 
zbuci: posts small blind $0.10
sikach78: posts big blind $0.25
*** HOLE CARDS ***
Dealt to SantiagoWeight [2d 3s]
Bonen18: folds 
KAOS914: folds 
SantiagoWeight: folds 
hames_tj: raises $0.35 to $0.60
zbuci: folds 
sikach78: calls $0.35
*** FLOP *** [9d Kc Ah]
sikach78: checks 
hames_tj: bets $0.41
sikach78: folds 
Uncalled bet ($0.41) returned to hames_tj
hames_tj collected $1.24 from pot
hames_tj: doesn't show hand 
*** SUMMARY ***
Total pot $1.30 | Rake $0.06 
Board [9d Kc Ah]
Seat 1: hames_tj (button) collected ($1.24)
Seat 2: zbuci (small blind) folded before Flop
Seat 3: sikach78 (big blind) folded on the Flop
Seat 4: Bonen18 folded before Flop (didn't bet)
Seat 5: KAOS914 folded before Flop (didn't bet)
Seat 6: SantiagoWeight folded before Flop (didn't bet)



PokerStars Zoom Hand #195024776915:  Hold'em No Limit ($0.10/$0.25) - 2018/12/29 4:57:06 UTC [2018/12/28 23:57:06 ET]
Table 'Hydra' 6-max Seat #1 is the button
Seat 1: SantiagoWeight ($81.48 in chips) 
Seat 2: RESTRICTED.CR17 ($15.09 in chips) 
Seat 3: GrandmasterY ($25 in chips) 
Seat 4: SpaZz0205 ($25.35 in chips) 
Seat 5: Becks Baker ($25 in chips) 
Seat 6: Rika_run ($53.86 in chips) 
RESTRICTED.CR17: posts small blind $0.10
GrandmasterY: posts big blind $0.25
*** HOLE CARDS ***
Dealt to SantiagoWeight [2h 5h]
SpaZz0205: raises $0.60 to $0.85
Becks Baker: folds 
Rika_run: folds 
SantiagoWeight: folds 
RESTRICTED.CR17: calls $0.75
GrandmasterY: calls $0.60
*** FLOP *** [9h 8h 5s]
RESTRICTED.CR17: checks 
GrandmasterY: checks 
SpaZz0205: bets $1.25
RESTRICTED.CR17: raises $1.75 to $3
GrandmasterY: folds 
SpaZz0205: calls $1.75
*** TURN *** [9h 8h 5s] [2c]
RESTRICTED.CR17: checks 
SpaZz0205: checks 
*** RIVER *** [9h 8h 5s 2c] [6h]
RESTRICTED.CR17: bets $11.24 and is all-in
SpaZz0205: folds 
Uncalled bet ($11.24) returned to RESTRICTED.CR17
RESTRICTED.CR17 collected $8.17 from pot
RESTRICTED.CR17: doesn't show hand 
*** SUMMARY ***
Total pot $8.55 | Rake $0.38 
Board [9h 8h 5s 2c 6h]
Seat 1: SantiagoWeight (button) folded before Flop (didn't bet)
Seat 2: RESTRICTED.CR17 (small blind) collected ($8.17)
Seat 3: GrandmasterY (big blind) folded on the Flop
Seat 4: SpaZz0205 folded on the River
Seat 5: Becks Baker folded before Flop (didn't bet)
Seat 6: Rika_run folded before Flop (didn't bet)



PokerStars Zoom Hand #195024785748:  Hold'em No Limit ($0.10/$0.25) - 2018/12/29 4:57:43 UTC [2018/12/28 23:57:43 ET]
Table 'Hydra' 6-max Seat #1 is the button
Seat 1: Bonen18 ($25 in chips) 
Seat 2: LastNoma ($25.50 in chips) 
Seat 3: Guard poker ($56.40 in chips) 
Seat 4: SantiagoWeight ($81.58 in chips) 
Seat 5: Gonzalit0o ($40.45 in chips) 
Seat 6: MoMoney2612 ($47.74 in chips) 
LastNoma: posts small blind $0.10
Guard poker: posts big blind $0.25
*** HOLE CARDS ***
Dealt to SantiagoWeight [2c 4c]
SantiagoWeight: folds 
Gonzalit0o: folds 
MoMoney2612: raises $0.31 to $0.56
Bonen18: folds 
LastNoma: folds 
Guard poker: calls $0.31
*** FLOP *** [Kc Ks Ts]
Guard poker: checks 
MoMoney2612: checks 
*** TURN *** [Kc Ks Ts] [8s]
Guard poker: checks 
MoMoney2612: bets $0.37
Guard poker: folds 
Uncalled bet ($0.37) returned to MoMoney2612
MoMoney2612 collected $1.17 from pot
MoMoney2612: doesn't show hand 
*** SUMMARY ***
Total pot $1.22 | Rake $0.05 
Board [Kc Ks Ts 8s]
Seat 1: Bonen18 (button) folded before Flop (didn't bet)
Seat 2: LastNoma (small blind) folded before Flop
Seat 3: Guard poker (big blind) folded on the Turn
Seat 4: SantiagoWeight folded before Flop (didn't bet)
Seat 5: Gonzalit0o folded before Flop (didn't bet)
Seat 6: MoMoney2612 collected ($1.17)



PokerStars Zoom Hand #195024789705:  Hold'em No Limit ($0.10/$0.25) - 2018/12/29 4:58:00 UTC [2018/12/28 23:58:00 ET]
Table 'Hydra' 6-max Seat #1 is the button
Seat 1: cheolbeom ($25.70 in chips) 
Seat 2: Papaya006 ($25 in chips) 
Seat 3: hames_tj ($25.99 in chips) 
Seat 4: KAOS914 ($24.06 in chips) 
Seat 5: SantiagoWeight ($81.58 in chips) 
Seat 6: zbuci ($83.43 in chips) 
Papaya006: posts small blind $0.10
hames_tj: posts big blind $0.25
*** HOLE CARDS ***
Dealt to SantiagoWeight [8c 8h]
KAOS914: folds 
SantiagoWeight: raises $0.37 to $0.62
zbuci: calls $0.62
cheolbeom: calls $0.62
Papaya006: raises $2.88 to $3.50
hames_tj: folds 
SantiagoWeight: calls $2.88
zbuci: folds 
cheolbeom: calls $2.88
*** FLOP *** [5h 3s 2d]
Papaya006: bets $5.50
SantiagoWeight: folds 
cheolbeom: calls $5.50
*** TURN *** [5h 3s 2d] [Td]
Papaya006: checks 
cheolbeom: bets $7.05
Papaya006: calls $7.05
*** RIVER *** [5h 3s 2d Td] [Th]
Papaya006: checks 
cheolbeom: bets $9.65 and is all-in
Papaya006: folds 
Uncalled bet ($9.65) returned to cheolbeom
cheolbeom collected $34.83 from pot
cheolbeom: doesn't show hand 
*** SUMMARY ***
Total pot $36.47 | Rake $1.64 
Board [5h 3s 2d Td Th]
Seat 1: cheolbeom (button) collected ($34.83)
Seat 2: Papaya006 (small blind) folded on the River
Seat 3: hames_tj (big blind) folded before Flop
Seat 4: KAOS914 folded before Flop (didn't bet)
Seat 5: SantiagoWeight folded on the Flop
Seat 6: zbuci folded before Flop



PokerStars Zoom Hand #195024803883:  Hold'em No Limit ($0.10/$0.25) - 2018/12/29 4:59:01 UTC [2018/12/28 23:59:01 ET]
Table 'Hydra' 6-max Seat #1 is the button
Seat 1: TQNYMQNTANA ($52.96 in chips) 
Seat 2: SantiagoWeight ($78.08 in chips) 
Seat 3: JeDti ($36.44 in chips) 
Seat 4: hide3298 ($23.85 in chips) 
Seat 5: davidhw888 ($23.59 in chips) 
Seat 6: ivann14 ($40.11 in chips) 
SantiagoWeight: posts small blind $0.10
JeDti: posts big blind $0.25
*** HOLE CARDS ***
Dealt to SantiagoWeight [5d 3s]
hide3298: folds 
davidhw888: raises $0.50 to $0.75
ivann14: raises $1.50 to $2.25
TQNYMQNTANA: folds 
SantiagoWeight: folds 
JeDti: folds 
davidhw888: folds 
Uncalled bet ($1.50) returned to ivann14
ivann14 collected $1.85 from pot
ivann14: doesn't show hand 
*** SUMMARY ***
Total pot $1.85 | Rake $0 
Seat 1: TQNYMQNTANA (button) folded before Flop (didn't bet)
Seat 2: SantiagoWeight (small blind) folded before Flop
Seat 3: JeDti (big blind) folded before Flop
Seat 4: hide3298 folded before Flop (didn't bet)
Seat 5: davidhw888 folded before Flop
Seat 6: ivann14 collected ($1.85)



PokerStars Zoom Hand #195024812691:  Hold'em No Limit ($0.10/$0.25) - 2018/12/29 4:59:39 UTC [2018/12/28 23:59:39 ET]
Table 'Hydra' 6-max Seat #1 is the button
Seat 1: SantiagoWeight ($77.98 in chips) 
Seat 2: Vilen1689 ($25.23 in chips) 
Seat 3: Nutselas ($40.17 in chips) 
Seat 4: ttshead ($76.59 in chips) 
Seat 5: _BluDeeN_ ($25.02 in chips) 
Seat 6: JeDti ($59.66 in chips) 
Vilen1689: posts small blind $0.10
Nutselas: posts big blind $0.25
*** HOLE CARDS ***
Dealt to SantiagoWeight [3c Kc]
ttshead: folds 
_BluDeeN_: folds 
JeDti: raises $0.36 to $0.61
SantiagoWeight: folds 
Vilen1689: raises $1.79 to $2.40
Nutselas: folds 
JeDti: folds 
Uncalled bet ($1.79) returned to Vilen1689
Vilen1689 collected $1.47 from pot
Vilen1689: doesn't show hand 
*** SUMMARY ***
Total pot $1.47 | Rake $0 
Seat 1: SantiagoWeight (button) folded before Flop (didn't bet)
Seat 2: Vilen1689 (small blind) collected ($1.47)
Seat 3: Nutselas (big blind) folded before Flop
Seat 4: ttshead folded before Flop (didn't bet)
Seat 5: _BluDeeN_ folded before Flop (didn't bet)
Seat 6: JeDti folded before Flop



PokerStars Zoom Hand #195024810834:  Hold'em No Limit ($0.10/$0.25) - 2018/12/29 4:59:31 UTC [2018/12/28 23:59:31 ET]
Table 'Hydra' 6-max Seat #1 is the button
Seat 1: Papaya006 ($33.28 in chips) 
Seat 2: Rika_run ($28.72 in chips) 
Seat 3: hide3298 ($23.85 in chips) 
Seat 4: hames_tj ($25.69 in chips) 
Seat 5: SpaZz0205 ($22.84 in chips) 
Seat 6: SantiagoWeight ($77.98 in chips) 
Rika_run: posts small blind $0.10
hide3298: posts big blind $0.25
*** HOLE CARDS ***
Dealt to SantiagoWeight [3h 9s]
hames_tj: folds 
SpaZz0205: raises $0.50 to $0.75
SantiagoWeight: folds 
Papaya006: folds 
Rika_run: folds 
hide3298: calls $0.50
*** FLOP *** [3s 8d 8c]
hide3298: checks 
SpaZz0205: bets $0.75
hide3298: calls $0.75
*** TURN *** [3s 8d 8c] [2d]
hide3298: checks 
SpaZz0205: bets $1.50
hide3298: calls $1.50
*** RIVER *** [3s 8d 8c 2d] [7d]
hide3298: checks 
SpaZz0205: bets $3.50
hide3298: raises $3.50 to $7
SpaZz0205: raises $12.84 to $19.84 and is all-in
hide3298: calls $12.84
*** SHOW DOWN ***
SpaZz0205: shows [9d Kd] (a flush, King high)
hide3298: shows [Ad Td] (a flush, Ace high)
hide3298 collected $43.78 from pot
*** SUMMARY ***
Total pot $45.78 | Rake $2 
Board [3s 8d 8c 2d 7d]
Seat 1: Papaya006 (button) folded before Flop (didn't bet)
Seat 2: Rika_run (small blind) folded before Flop
Seat 3: hide3298 (big blind) showed [Ad Td] and won ($43.78) with a flush, Ace high
Seat 4: hames_tj folded before Flop (didn't bet)
Seat 5: SpaZz0205 showed [9d Kd] and lost with a flush, King high
Seat 6: SantiagoWeight folded before Flop (didn't bet)



