PokerStars Hand #228672734303:  Hold'em No Limit ($0.25/$0.50 USD) - 2021/07/30 0:00:02 ET
Table 'Laodamia II' 9-max Seat #3 is the button
Seat 1: I oguz han I ($47.25 in chips) 
Seat 2: xobit26 ($66.73 in chips) 
Seat 3: Millten ($50 in chips) 
Seat 4: monkeypokerdirt ($41.59 in chips) 
Seat 5: Jesterclown ($83.50 in chips) 
Seat 6: TR1CKTR1CK ($45.63 in chips) 
Seat 7: pudge.3096 ($129.04 in chips) 
Seat 8: undergr0undY ($50 in chips) 
Seat 9: rovara ($56.68 in chips) 
monkeypokerdirt: posts small blind $0.25
Jesterclown: posts big blind $0.50
*** HOLE CARDS ***
TR1CKTR1CK: folds 
pudge.3096: raises $0.75 to $1.25
undergr0undY: folds 
rovara: folds 
I oguz han I: folds 
xobit26: folds 
Millten: folds 
monkeypokerdirt: calls $1
Jesterclown: folds 
*** FLOP *** [9c 6s Th]
monkeypokerdirt: checks 
pudge.3096: checks 
*** TURN *** [9c 6s Th] [Js]
monkeypokerdirt: bets $1.43
pudge.3096: raises $2.86 to $4.29
monkeypokerdirt: folds 
Uncalled bet ($2.86) returned to pudge.3096
pudge.3096 collected $5.57 from pot
pudge.3096: doesn't show hand 
*** SUMMARY ***
Total pot $5.86 | Rake $0.29 
Board [9c 6s Th Js]
Seat 1: I oguz han I folded before Flop (didn't bet)
Seat 2: xobit26 folded before Flop (didn't bet)
Seat 3: Millten (button) folded before Flop (didn't bet)
Seat 4: monkeypokerdirt (small blind) folded on the Turn
Seat 5: Jesterclown (big blind) folded before Flop
Seat 6: TR1CKTR1CK folded before Flop (didn't bet)
Seat 7: pudge.3096 collected ($5.57)
Seat 8: undergr0undY folded before Flop (didn't bet)
Seat 9: rovara folded before Flop (didn't bet)



PokerStars Hand #228672745367:  Hold'em No Limit ($0.25/$0.50 USD) - 2021/07/30 0:01:16 ET
Table 'Laodamia II' 9-max Seat #4 is the button
Seat 1: I oguz han I ($47.25 in chips) 
Seat 2: xobit26 ($66.73 in chips) 
Seat 3: Millten ($50 in chips) 
Seat 4: monkeypokerdirt ($38.91 in chips) 
Seat 5: Jesterclown ($83 in chips) 
Seat 6: TR1CKTR1CK ($45.63 in chips) 
Seat 7: pudge.3096 ($131.93 in chips) 
Seat 8: undergr0undY ($50 in chips) 
Seat 9: rovara ($56.68 in chips) 
Jesterclown: posts small blind $0.25
TR1CKTR1CK: posts big blind $0.50
*** HOLE CARDS ***
pudge.3096: folds 
undergr0undY: folds 
rovara: raises $0.75 to $1.25
I oguz han I: folds 
xobit26: folds 
Millten: folds 
monkeypokerdirt: folds 
Jesterclown: folds 
TR1CKTR1CK: folds 
Uncalled bet ($0.75) returned to rovara
rovara collected $1.25 from pot
*** SUMMARY ***
Total pot $1.25 | Rake $0 
Seat 1: I oguz han I folded before Flop (didn't bet)
Seat 2: xobit26 folded before Flop (didn't bet)
Seat 3: Millten folded before Flop (didn't bet)
Seat 4: monkeypokerdirt (button) folded before Flop (didn't bet)
Seat 5: Jesterclown (small blind) folded before Flop
Seat 6: TR1CKTR1CK (big blind) folded before Flop
Seat 7: pudge.3096 folded before Flop (didn't bet)
Seat 8: undergr0undY folded before Flop (didn't bet)
Seat 9: rovara collected ($1.25)



PokerStars Hand #228672750652:  Hold'em No Limit ($0.25/$0.50 USD) - 2021/07/30 0:01:49 ET
Table 'Laodamia II' 9-max Seat #5 is the button
Seat 1: I oguz han I ($47.25 in chips) 
Seat 2: xobit26 ($66.73 in chips) 
Seat 3: Millten ($50 in chips) 
Seat 4: monkeypokerdirt ($38.91 in chips) 
Seat 5: Jesterclown ($82.75 in chips) 
Seat 6: TR1CKTR1CK ($45.13 in chips) 
Seat 7: pudge.3096 ($131.93 in chips) 
Seat 8: undergr0undY ($50 in chips) 
Seat 9: rovara ($57.43 in chips) 
TR1CKTR1CK: posts small blind $0.25
pudge.3096: posts big blind $0.50
*** HOLE CARDS ***
undergr0undY: folds 
rovara: folds 
I oguz han I: folds 
xobit26: raises $1 to $1.50
Millten: folds 
monkeypokerdirt: folds 
Jesterclown: folds 
TR1CKTR1CK: folds 
pudge.3096: folds 
Uncalled bet ($1) returned to xobit26
xobit26 collected $1.25 from pot
xobit26: doesn't show hand 
*** SUMMARY ***
Total pot $1.25 | Rake $0 
Seat 1: I oguz han I folded before Flop (didn't bet)
Seat 2: xobit26 collected ($1.25)
Seat 3: Millten folded before Flop (didn't bet)
Seat 4: monkeypokerdirt folded before Flop (didn't bet)
Seat 5: Jesterclown (button) folded before Flop (didn't bet)
Seat 6: TR1CKTR1CK (small blind) folded before Flop
Seat 7: pudge.3096 (big blind) folded before Flop
Seat 8: undergr0undY folded before Flop (didn't bet)
Seat 9: rovara folded before Flop (didn't bet)



PokerStars Hand #228672753970:  Hold'em No Limit ($0.25/$0.50 USD) - 2021/07/30 0:02:09 ET
Table 'Laodamia II' 9-max Seat #6 is the button
Seat 1: I oguz han I ($47.25 in chips) 
Seat 2: xobit26 ($67.48 in chips) 
Seat 3: Millten ($50 in chips) 
Seat 4: monkeypokerdirt ($38.91 in chips) 
Seat 5: Jesterclown ($82.75 in chips) 
Seat 6: TR1CKTR1CK ($44.88 in chips) 
Seat 7: pudge.3096 ($131.43 in chips) 
Seat 8: undergr0undY ($50 in chips) 
Seat 9: rovara ($57.43 in chips) 
pudge.3096: posts small blind $0.25
undergr0undY: posts big blind $0.50
*** HOLE CARDS ***
rovara: raises $0.75 to $1.25
I oguz han I: folds 
xobit26: folds 
Millten: folds 
monkeypokerdirt: folds 
Jesterclown: folds 
TR1CKTR1CK: folds 
pudge.3096: folds 
undergr0undY: folds 
Uncalled bet ($0.75) returned to rovara
rovara collected $1.25 from pot
*** SUMMARY ***
Total pot $1.25 | Rake $0 
Seat 1: I oguz han I folded before Flop (didn't bet)
Seat 2: xobit26 folded before Flop (didn't bet)
Seat 3: Millten folded before Flop (didn't bet)
Seat 4: monkeypokerdirt folded before Flop (didn't bet)
Seat 5: Jesterclown folded before Flop (didn't bet)
Seat 6: TR1CKTR1CK (button) folded before Flop (didn't bet)
Seat 7: pudge.3096 (small blind) folded before Flop
Seat 8: undergr0undY (big blind) folded before Flop
Seat 9: rovara collected ($1.25)



PokerStars Hand #228672756686:  Hold'em No Limit ($0.25/$0.50 USD) - 2021/07/30 0:02:27 ET
Table 'Laodamia II' 9-max Seat #7 is the button
Seat 1: I oguz han I ($47.25 in chips) 
Seat 2: xobit26 ($67.48 in chips) 
Seat 3: Millten ($50 in chips) 
Seat 4: monkeypokerdirt ($38.91 in chips) 
Seat 5: Jesterclown ($82.75 in chips) 
Seat 6: TR1CKTR1CK ($44.88 in chips) 
Seat 7: pudge.3096 ($131.18 in chips) 
Seat 8: undergr0undY ($50 in chips) 
Seat 9: rovara ($58.18 in chips) 
undergr0undY: posts small blind $0.25
rovara: posts big blind $0.50
*** HOLE CARDS ***
I oguz han I: folds 
xobit26: folds 
Millten: folds 
monkeypokerdirt: folds 
Jesterclown: folds 
TR1CKTR1CK: folds 
pudge.3096: raises $0.75 to $1.25
undergr0undY: folds 
rovara: folds 
Uncalled bet ($0.75) returned to pudge.3096
pudge.3096 collected $1.25 from pot
pudge.3096: doesn't show hand 
*** SUMMARY ***
Total pot $1.25 | Rake $0 
Seat 1: I oguz han I folded before Flop (didn't bet)
Seat 2: xobit26 folded before Flop (didn't bet)
Seat 3: Millten folded before Flop (didn't bet)
Seat 4: monkeypokerdirt folded before Flop (didn't bet)
Seat 5: Jesterclown folded before Flop (didn't bet)
Seat 6: TR1CKTR1CK folded before Flop (didn't bet)
Seat 7: pudge.3096 (button) collected ($1.25)
Seat 8: undergr0undY (small blind) folded before Flop
Seat 9: rovara (big blind) folded before Flop



PokerStars Hand #228672760024:  Hold'em No Limit ($0.25/$0.50 USD) - 2021/07/30 0:02:48 ET
Table 'Laodamia II' 9-max Seat #8 is the button
Seat 1: I oguz han I ($47.25 in chips) 
Seat 2: xobit26 ($67.48 in chips) 
Seat 3: Millten ($50 in chips) 
Seat 4: monkeypokerdirt ($38.91 in chips) 
Seat 5: Jesterclown ($82.75 in chips) 
Seat 6: TR1CKTR1CK ($44.88 in chips) 
Seat 7: pudge.3096 ($131.93 in chips) 
Seat 8: undergr0undY ($50 in chips) 
Seat 9: rovara ($57.68 in chips) 
rovara: posts small blind $0.25
I oguz han I: posts big blind $0.50
*** HOLE CARDS ***
xobit26: raises $1 to $1.50
Millten: folds 
monkeypokerdirt: folds 
Jesterclown: raises $3 to $4.50
TR1CKTR1CK: folds 
pudge.3096: folds 
undergr0undY: folds 
rovara: folds 
I oguz han I: folds 
xobit26: calls $3
*** FLOP *** [5c Tc 6d]
xobit26: checks 
Jesterclown: bets $4
xobit26: calls $4
*** TURN *** [5c Tc 6d] [8d]
xobit26: checks 
Jesterclown: checks 
*** RIVER *** [5c Tc 6d 8d] [Th]
xobit26: bets $6.75
Jesterclown: calls $6.75
*** SHOW DOWN ***
xobit26: shows [Qd Qh] (two pair, Queens and Tens)
Jesterclown: shows [Qs Qc] (two pair, Queens and Tens)
xobit26 collected $14.85 from pot
Jesterclown collected $14.84 from pot
*** SUMMARY ***
Total pot $31.25 | Rake $1.56 
Board [5c Tc 6d 8d Th]
Seat 1: I oguz han I (big blind) folded before Flop
Seat 2: xobit26 showed [Qd Qh] and won ($14.85) with two pair, Queens and Tens
Seat 3: Millten folded before Flop (didn't bet)
Seat 4: monkeypokerdirt folded before Flop (didn't bet)
Seat 5: Jesterclown showed [Qs Qc] and won ($14.84) with two pair, Queens and Tens
Seat 6: TR1CKTR1CK folded before Flop (didn't bet)
Seat 7: pudge.3096 folded before Flop (didn't bet)
Seat 8: undergr0undY (button) folded before Flop (didn't bet)
Seat 9: rovara (small blind) folded before Flop



PokerStars Hand #228672771158:  Hold'em No Limit ($0.25/$0.50 USD) - 2021/07/30 0:03:57 ET
Table 'Laodamia II' 9-max Seat #9 is the button
Seat 1: I oguz han I ($46.75 in chips) 
Seat 2: xobit26 ($67.08 in chips) 
Seat 3: Millten ($50 in chips) 
Seat 4: monkeypokerdirt ($38.91 in chips) 
Seat 5: Jesterclown ($82.34 in chips) 
Seat 6: TR1CKTR1CK ($44.88 in chips) 
Seat 7: pudge.3096 ($131.93 in chips) 
Seat 8: undergr0undY ($50 in chips) 
Seat 9: rovara ($57.43 in chips) 
I oguz han I: posts small blind $0.25
xobit26: posts big blind $0.50
*** HOLE CARDS ***
Millten: folds 
monkeypokerdirt: calls $0.50
Jesterclown: folds 
TR1CKTR1CK: folds 
pudge.3096: folds 
undergr0undY: raises $1.50 to $2
rovara: folds 
I oguz han I: folds 
xobit26: folds 
monkeypokerdirt: calls $1.50
*** FLOP *** [8s Qc Ac]
monkeypokerdirt: checks 
undergr0undY: checks 
*** TURN *** [8s Qc Ac] [9c]
monkeypokerdirt: checks 
undergr0undY: bets $1.13
monkeypokerdirt: folds 
Uncalled bet ($1.13) returned to undergr0undY
undergr0undY collected $4.51 from pot
*** SUMMARY ***
Total pot $4.75 | Rake $0.24 
Board [8s Qc Ac 9c]
Seat 1: I oguz han I (small blind) folded before Flop
Seat 2: xobit26 (big blind) folded before Flop
Seat 3: Millten folded before Flop (didn't bet)
Seat 4: monkeypokerdirt folded on the Turn
Seat 5: Jesterclown folded before Flop (didn't bet)
Seat 6: TR1CKTR1CK folded before Flop (didn't bet)
Seat 7: pudge.3096 folded before Flop (didn't bet)
Seat 8: undergr0undY collected ($4.51)
Seat 9: rovara (button) folded before Flop (didn't bet)



PokerStars Hand #228672781816:  Hold'em No Limit ($0.25/$0.50 USD) - 2021/07/30 0:04:36 ET
Table 'Laodamia II' 9-max Seat #1 is the button
Seat 1: I oguz han I ($46.50 in chips) 
Seat 2: xobit26 ($66.58 in chips) 
Seat 3: Millten ($50 in chips) 
Seat 4: monkeypokerdirt ($36.91 in chips) 
Seat 5: Jesterclown ($82.34 in chips) 
Seat 6: TR1CKTR1CK ($44.88 in chips) 
Seat 7: pudge.3096 ($131.93 in chips) 
Seat 8: undergr0undY ($52.51 in chips) 
Seat 9: rovara ($57.43 in chips) 
xobit26: posts small blind $0.25
Millten: posts big blind $0.50
*** HOLE CARDS ***
monkeypokerdirt: folds 
Jesterclown: folds 
TR1CKTR1CK: folds 
pudge.3096: folds 
undergr0undY: folds 
rovara: raises $0.75 to $1.25
I oguz han I: folds 
xobit26: folds 
Millten: folds 
Uncalled bet ($0.75) returned to rovara
rovara collected $1.25 from pot
*** SUMMARY ***
Total pot $1.25 | Rake $0 
Seat 1: I oguz han I (button) folded before Flop (didn't bet)
Seat 2: xobit26 (small blind) folded before Flop
Seat 3: Millten (big blind) folded before Flop
Seat 4: monkeypokerdirt folded before Flop (didn't bet)
Seat 5: Jesterclown folded before Flop (didn't bet)
Seat 6: TR1CKTR1CK folded before Flop (didn't bet)
Seat 7: pudge.3096 folded before Flop (didn't bet)
Seat 8: undergr0undY folded before Flop (didn't bet)
Seat 9: rovara collected ($1.25)



PokerStars Hand #228672784275:  Hold'em No Limit ($0.25/$0.50 USD) - 2021/07/30 0:04:51 ET
Table 'Laodamia II' 9-max Seat #2 is the button
Seat 1: I oguz han I ($46.50 in chips) 
Seat 2: xobit26 ($66.33 in chips) 
Seat 3: Millten ($50 in chips) 
Seat 4: monkeypokerdirt ($36.91 in chips) 
Seat 5: Jesterclown ($82.34 in chips) 
Seat 6: TR1CKTR1CK ($44.88 in chips) 
Seat 7: pudge.3096 ($131.93 in chips) 
Seat 8: undergr0undY ($52.51 in chips) 
Seat 9: rovara ($58.18 in chips) 
Millten: posts small blind $0.25
monkeypokerdirt: posts big blind $0.50
*** HOLE CARDS ***
Jesterclown: folds 
TR1CKTR1CK: folds 
pudge.3096: raises $0.75 to $1.25
undergr0undY: folds 
rovara: folds 
I oguz han I: folds 
xobit26: raises $2.75 to $4
Millten: folds 
monkeypokerdirt: folds 
pudge.3096: calls $2.75
*** FLOP *** [6c 3d 9c]
pudge.3096: checks 
xobit26: bets $5.81
pudge.3096: folds 
Uncalled bet ($5.81) returned to xobit26
xobit26 collected $8.31 from pot
xobit26: doesn't show hand 
*** SUMMARY ***
Total pot $8.75 | Rake $0.44 
Board [6c 3d 9c]
Seat 1: I oguz han I folded before Flop (didn't bet)
Seat 2: xobit26 (button) collected ($8.31)
Seat 3: Millten (small blind) folded before Flop
Seat 4: monkeypokerdirt (big blind) folded before Flop
Seat 5: Jesterclown folded before Flop (didn't bet)
Seat 6: TR1CKTR1CK folded before Flop (didn't bet)
Seat 7: pudge.3096 folded on the Flop
Seat 8: undergr0undY folded before Flop (didn't bet)
Seat 9: rovara folded before Flop (didn't bet)



PokerStars Hand #228672790457:  Hold'em No Limit ($0.25/$0.50 USD) - 2021/07/30 0:05:30 ET
Table 'Laodamia II' 9-max Seat #3 is the button
Seat 1: I oguz han I ($46.50 in chips) 
Seat 2: xobit26 ($70.64 in chips) 
Seat 3: Millten ($50 in chips) 
Seat 4: monkeypokerdirt ($36.41 in chips) 
Seat 5: Jesterclown ($82.34 in chips) 
Seat 6: TR1CKTR1CK ($44.88 in chips) 
Seat 7: pudge.3096 ($127.93 in chips) 
Seat 8: undergr0undY ($52.51 in chips) 
Seat 9: rovara ($58.18 in chips) 
monkeypokerdirt: posts small blind $0.25
Jesterclown: posts big blind $0.50
*** HOLE CARDS ***
TR1CKTR1CK has timed out
TR1CKTR1CK: folds 
pudge.3096: folds 
undergr0undY: folds 
rovara: folds 
I oguz han I: folds 
xobit26: raises $0.75 to $1.25
Millten: folds 
monkeypokerdirt: folds 
Jesterclown: folds 
Uncalled bet ($0.75) returned to xobit26
xobit26 collected $1.25 from pot
xobit26: doesn't show hand 
*** SUMMARY ***
Total pot $1.25 | Rake $0 
Seat 1: I oguz han I folded before Flop (didn't bet)
Seat 2: xobit26 collected ($1.25)
Seat 3: Millten (button) folded before Flop (didn't bet)
Seat 4: monkeypokerdirt (small blind) folded before Flop
Seat 5: Jesterclown (big blind) folded before Flop
Seat 6: TR1CKTR1CK folded before Flop (didn't bet)
Seat 7: pudge.3096 folded before Flop (didn't bet)
Seat 8: undergr0undY folded before Flop (didn't bet)
Seat 9: rovara folded before Flop (didn't bet)



PokerStars Hand #228672795367:  Hold'em No Limit ($0.25/$0.50 USD) - 2021/07/30 0:06:00 ET
Table 'Laodamia II' 9-max Seat #4 is the button
Seat 1: I oguz han I ($46.50 in chips) 
Seat 2: xobit26 ($71.39 in chips) 
Seat 3: Millten ($50 in chips) 
Seat 4: monkeypokerdirt ($36.16 in chips) 
Seat 5: Jesterclown ($81.84 in chips) 
Seat 6: TR1CKTR1CK ($44.88 in chips) 
Seat 7: pudge.3096 ($127.93 in chips) 
Seat 8: undergr0undY ($52.51 in chips) 
Seat 9: rovara ($58.18 in chips) 
Jesterclown: posts small blind $0.25
TR1CKTR1CK: posts big blind $0.50
*** HOLE CARDS ***
pudge.3096: folds 
undergr0undY: folds 
rovara: raises $0.75 to $1.25
I oguz han I: folds 
xobit26: folds 
Millten: folds 
monkeypokerdirt: calls $1.25
Jesterclown: folds 
TR1CKTR1CK: raises $3.75 to $5
rovara: folds 
monkeypokerdirt: folds 
Uncalled bet ($3.75) returned to TR1CKTR1CK
TR1CKTR1CK collected $4 from pot
*** SUMMARY ***
Total pot $4 | Rake $0 
Seat 1: I oguz han I folded before Flop (didn't bet)
Seat 2: xobit26 folded before Flop (didn't bet)
Seat 3: Millten folded before Flop (didn't bet)
Seat 4: monkeypokerdirt (button) folded before Flop
Seat 5: Jesterclown (small blind) folded before Flop
Seat 6: TR1CKTR1CK (big blind) collected ($4)
Seat 7: pudge.3096 folded before Flop (didn't bet)
Seat 8: undergr0undY folded before Flop (didn't bet)
Seat 9: rovara folded before Flop



PokerStars Hand #228672801841:  Hold'em No Limit ($0.25/$0.50 USD) - 2021/07/30 0:06:40 ET
Table 'Laodamia II' 9-max Seat #5 is the button
Seat 1: I oguz han I ($46.50 in chips) 
Seat 2: xobit26 ($71.39 in chips) 
Seat 3: Millten ($50 in chips) 
Seat 4: monkeypokerdirt ($34.91 in chips) 
Seat 5: Jesterclown ($81.59 in chips) 
Seat 6: TR1CKTR1CK ($47.63 in chips) 
Seat 7: pudge.3096 ($127.93 in chips) 
Seat 8: undergr0undY ($52.51 in chips) 
Seat 9: rovara ($56.93 in chips) 
TR1CKTR1CK: posts small blind $0.25
pudge.3096: posts big blind $0.50
*** HOLE CARDS ***
undergr0undY: folds 
rovara: folds 
I oguz han I: raises $1 to $1.50
xobit26: folds 
Millten: folds 
monkeypokerdirt: folds 
Jesterclown: folds 
TR1CKTR1CK: folds 
pudge.3096: folds 
Uncalled bet ($1) returned to I oguz han I
I oguz han I collected $1.25 from pot
I oguz han I: doesn't show hand 
*** SUMMARY ***
Total pot $1.25 | Rake $0 
Seat 1: I oguz han I collected ($1.25)
Seat 2: xobit26 folded before Flop (didn't bet)
Seat 3: Millten folded before Flop (didn't bet)
Seat 4: monkeypokerdirt folded before Flop (didn't bet)
Seat 5: Jesterclown (button) folded before Flop (didn't bet)
Seat 6: TR1CKTR1CK (small blind) folded before Flop
Seat 7: pudge.3096 (big blind) folded before Flop
Seat 8: undergr0undY folded before Flop (didn't bet)
Seat 9: rovara folded before Flop (didn't bet)



PokerStars Hand #228672806610:  Hold'em No Limit ($0.25/$0.50 USD) - 2021/07/30 0:07:10 ET
Table 'Laodamia II' 9-max Seat #6 is the button
Seat 1: I oguz han I ($47.25 in chips) 
Seat 2: xobit26 ($71.39 in chips) 
Seat 3: Millten ($50 in chips) 
Seat 4: monkeypokerdirt ($34.91 in chips) 
Seat 5: Jesterclown ($81.59 in chips) 
Seat 6: TR1CKTR1CK ($47.38 in chips) 
Seat 7: pudge.3096 ($127.43 in chips) 
Seat 8: undergr0undY ($52.51 in chips) 
Seat 9: rovara ($56.93 in chips) 
pudge.3096: posts small blind $0.25
undergr0undY: posts big blind $0.50
*** HOLE CARDS ***
rovara: folds 
I oguz han I: folds 
xobit26: folds 
Millten: raises $0.90 to $1.40
monkeypokerdirt: calls $1.40
Jesterclown: folds 
TR1CKTR1CK: folds 
pudge.3096: folds 
undergr0undY: raises $5.60 to $7
Millten: folds 
monkeypokerdirt: folds 
Uncalled bet ($5.60) returned to undergr0undY
undergr0undY collected $4.45 from pot
*** SUMMARY ***
Total pot $4.45 | Rake $0 
Seat 1: I oguz han I folded before Flop (didn't bet)
Seat 2: xobit26 folded before Flop (didn't bet)
Seat 3: Millten folded before Flop
Seat 4: monkeypokerdirt folded before Flop
Seat 5: Jesterclown folded before Flop (didn't bet)
Seat 6: TR1CKTR1CK (button) folded before Flop (didn't bet)
Seat 7: pudge.3096 (small blind) folded before Flop
Seat 8: undergr0undY (big blind) collected ($4.45)
Seat 9: rovara folded before Flop (didn't bet)



PokerStars Hand #228672814278:  Hold'em No Limit ($0.25/$0.50 USD) - 2021/07/30 0:07:57 ET
Table 'Laodamia II' 9-max Seat #7 is the button
Seat 1: I oguz han I ($47.25 in chips) 
Seat 2: xobit26 ($71.39 in chips) 
Seat 3: Millten ($50 in chips) 
Seat 4: monkeypokerdirt ($33.51 in chips) 
Seat 5: Jesterclown ($81.59 in chips) 
Seat 6: TR1CKTR1CK ($47.38 in chips) 
Seat 7: pudge.3096 ($127.18 in chips) 
Seat 8: undergr0undY ($55.56 in chips) 
Seat 9: rovara ($56.93 in chips) 
undergr0undY: posts small blind $0.25
rovara: posts big blind $0.50
*** HOLE CARDS ***
I oguz han I: folds 
xobit26: folds 
Millten: folds 
monkeypokerdirt: folds 
Jesterclown: folds 
TR1CKTR1CK: raises $1 to $1.50
pudge.3096: folds 
undergr0undY: folds 
rovara: folds 
Uncalled bet ($1) returned to TR1CKTR1CK
TR1CKTR1CK collected $1.25 from pot
*** SUMMARY ***
Total pot $1.25 | Rake $0 
Seat 1: I oguz han I folded before Flop (didn't bet)
Seat 2: xobit26 folded before Flop (didn't bet)
Seat 3: Millten folded before Flop (didn't bet)
Seat 4: monkeypokerdirt folded before Flop (didn't bet)
Seat 5: Jesterclown folded before Flop (didn't bet)
Seat 6: TR1CKTR1CK collected ($1.25)
Seat 7: pudge.3096 (button) folded before Flop (didn't bet)
Seat 8: undergr0undY (small blind) folded before Flop
Seat 9: rovara (big blind) folded before Flop



PokerStars Hand #228672820369:  Hold'em No Limit ($0.25/$0.50 USD) - 2021/07/30 0:08:35 ET
Table 'Laodamia II' 9-max Seat #8 is the button
Seat 1: I oguz han I ($47.25 in chips) 
Seat 2: xobit26 ($71.39 in chips) 
Seat 3: Millten ($50 in chips) 
Seat 4: monkeypokerdirt ($33.51 in chips) 
Seat 5: Jesterclown ($81.59 in chips) 
Seat 6: TR1CKTR1CK ($48.13 in chips) 
Seat 7: pudge.3096 ($127.18 in chips) 
Seat 8: undergr0undY ($55.31 in chips) 
Seat 9: rovara ($56.43 in chips) 
rovara: posts small blind $0.25
I oguz han I: posts big blind $0.50
*** HOLE CARDS ***
xobit26: folds 
Millten: folds 
monkeypokerdirt: folds 
Jesterclown: folds 
TR1CKTR1CK has timed out
TR1CKTR1CK: folds 
pudge.3096: folds 
undergr0undY: folds 
rovara: raises $1 to $1.50
I oguz han I: calls $1
*** FLOP *** [7c 2c 4c]
rovara: checks 
I oguz han I: bets $1.50
rovara: folds 
Uncalled bet ($1.50) returned to I oguz han I
I oguz han I collected $2.85 from pot
I oguz han I: doesn't show hand 
*** SUMMARY ***
Total pot $3 | Rake $0.15 
Board [7c 2c 4c]
Seat 1: I oguz han I (big blind) collected ($2.85)
Seat 2: xobit26 folded before Flop (didn't bet)
Seat 3: Millten folded before Flop (didn't bet)
Seat 4: monkeypokerdirt folded before Flop (didn't bet)
Seat 5: Jesterclown folded before Flop (didn't bet)
Seat 6: TR1CKTR1CK folded before Flop (didn't bet)
Seat 7: pudge.3096 folded before Flop (didn't bet)
Seat 8: undergr0undY (button) folded before Flop (didn't bet)
Seat 9: rovara (small blind) folded on the Flop



PokerStars Hand #228672826543:  Hold'em No Limit ($0.25/$0.50 USD) - 2021/07/30 0:09:14 ET
Table 'Laodamia II' 9-max Seat #9 is the button
Seat 1: I oguz han I ($48.60 in chips) 
Seat 2: xobit26 ($71.39 in chips) 
Seat 3: Millten ($50 in chips) 
Seat 4: monkeypokerdirt ($33.51 in chips) 
Seat 5: Jesterclown ($81.59 in chips) 
Seat 6: TR1CKTR1CK ($48.13 in chips) 
Seat 7: pudge.3096 ($127.18 in chips) 
Seat 8: undergr0undY ($55.31 in chips) 
Seat 9: rovara ($54.93 in chips) 
I oguz han I: posts small blind $0.25
xobit26: posts big blind $0.50
*** HOLE CARDS ***
Millten: folds 
monkeypokerdirt: folds 
Jesterclown: folds 
TR1CKTR1CK: folds 
pudge.3096: folds 
undergr0undY: folds 
rovara: folds 
I oguz han I: folds 
Uncalled bet ($0.25) returned to xobit26
xobit26 collected $0.50 from pot
xobit26: doesn't show hand 
*** SUMMARY ***
Total pot $0.50 | Rake $0 
Seat 1: I oguz han I (small blind) folded before Flop
Seat 2: xobit26 (big blind) collected ($0.50)
Seat 3: Millten folded before Flop (didn't bet)
Seat 4: monkeypokerdirt folded before Flop (didn't bet)
Seat 5: Jesterclown folded before Flop (didn't bet)
Seat 6: TR1CKTR1CK folded before Flop (didn't bet)
Seat 7: pudge.3096 folded before Flop (didn't bet)
Seat 8: undergr0undY folded before Flop (didn't bet)
Seat 9: rovara (button) folded before Flop (didn't bet)



PokerStars Hand #228672832380:  Hold'em No Limit ($0.25/$0.50 USD) - 2021/07/30 0:09:50 ET
Table 'Laodamia II' 9-max Seat #1 is the button
Seat 1: I oguz han I ($48.35 in chips) 
Seat 2: xobit26 ($71.64 in chips) 
Seat 3: Millten ($50 in chips) 
Seat 4: monkeypokerdirt ($33.51 in chips) 
Seat 5: Jesterclown ($81.59 in chips) 
Seat 6: TR1CKTR1CK ($48.13 in chips) 
Seat 7: pudge.3096 ($127.18 in chips) 
Seat 8: undergr0undY ($55.31 in chips) 
Seat 9: rovara ($54.93 in chips) 
xobit26: posts small blind $0.25
Millten: posts big blind $0.50
*** HOLE CARDS ***
monkeypokerdirt: folds 
Jesterclown: folds 
TR1CKTR1CK: folds 
pudge.3096: folds 
undergr0undY: folds 
rovara: folds 
I oguz han I: folds 
xobit26: raises $1 to $1.50
Millten: calls $1
*** FLOP *** [9s 5h 6h]
xobit26: checks 
Millten: bets $1.45
xobit26: folds 
Uncalled bet ($1.45) returned to Millten
Millten collected $2.85 from pot
Millten: doesn't show hand 
*** SUMMARY ***
Total pot $3 | Rake $0.15 
Board [9s 5h 6h]
Seat 1: I oguz han I (button) folded before Flop (didn't bet)
Seat 2: xobit26 (small blind) folded on the Flop
Seat 3: Millten (big blind) collected ($2.85)
Seat 4: monkeypokerdirt folded before Flop (didn't bet)
Seat 5: Jesterclown folded before Flop (didn't bet)
Seat 6: TR1CKTR1CK folded before Flop (didn't bet)
Seat 7: pudge.3096 folded before Flop (didn't bet)
Seat 8: undergr0undY folded before Flop (didn't bet)
Seat 9: rovara folded before Flop (didn't bet)



PokerStars Hand #228672840074:  Hold'em No Limit ($0.25/$0.50 USD) - 2021/07/30 0:10:38 ET
Table 'Laodamia II' 9-max Seat #2 is the button
Seat 1: I oguz han I ($48.35 in chips) 
Seat 2: xobit26 ($70.14 in chips) 
Seat 3: Millten ($51.35 in chips) 
Seat 4: monkeypokerdirt ($33.51 in chips) 
Seat 5: Jesterclown ($81.59 in chips) 
Seat 6: TR1CKTR1CK ($48.13 in chips) 
Seat 7: pudge.3096 ($127.18 in chips) 
Seat 8: undergr0undY ($55.31 in chips) 
Seat 9: rovara ($54.93 in chips) 
Millten: posts small blind $0.25
monkeypokerdirt: posts big blind $0.50
*** HOLE CARDS ***
Jesterclown: folds 
TR1CKTR1CK: folds 
pudge.3096: folds 
undergr0undY: folds 
rovara: raises $1 to $1.50
I oguz han I: calls $1.50
xobit26: folds 
Millten: folds 
monkeypokerdirt: calls $1
*** FLOP *** [2s 9d 6c]
monkeypokerdirt: checks 
rovara: bets $2.48
I oguz han I: folds 
monkeypokerdirt: folds 
Uncalled bet ($2.48) returned to rovara
rovara collected $4.51 from pot
*** SUMMARY ***
Total pot $4.75 | Rake $0.24 
Board [2s 9d 6c]
Seat 1: I oguz han I folded on the Flop
Seat 2: xobit26 (button) folded before Flop (didn't bet)
Seat 3: Millten (small blind) folded before Flop
Seat 4: monkeypokerdirt (big blind) folded on the Flop
Seat 5: Jesterclown folded before Flop (didn't bet)
Seat 6: TR1CKTR1CK folded before Flop (didn't bet)
Seat 7: pudge.3096 folded before Flop (didn't bet)
Seat 8: undergr0undY folded before Flop (didn't bet)
Seat 9: rovara collected ($4.51)



PokerStars Hand #228672847087:  Hold'em No Limit ($0.25/$0.50 USD) - 2021/07/30 0:11:22 ET
Table 'Laodamia II' 9-max Seat #3 is the button
Seat 1: I oguz han I ($46.85 in chips) 
Seat 2: xobit26 ($70.14 in chips) 
Seat 3: Millten ($51.10 in chips) 
Seat 4: monkeypokerdirt ($32.01 in chips) 
Seat 5: Jesterclown ($81.59 in chips) 
Seat 6: TR1CKTR1CK ($48.13 in chips) 
Seat 7: pudge.3096 ($127.18 in chips) 
Seat 8: undergr0undY ($55.31 in chips) 
Seat 9: rovara ($57.94 in chips) 
monkeypokerdirt: posts small blind $0.25
Jesterclown: posts big blind $0.50
*** HOLE CARDS ***
TR1CKTR1CK: folds 
pudge.3096: folds 
undergr0undY: folds 
rovara: folds 
I oguz han I: folds 
xobit26: raises $0.75 to $1.25
Millten: folds 
monkeypokerdirt: folds 
Jesterclown: folds 
Uncalled bet ($0.75) returned to xobit26
xobit26 collected $1.25 from pot
xobit26: doesn't show hand 
*** SUMMARY ***
Total pot $1.25 | Rake $0 
Seat 1: I oguz han I folded before Flop (didn't bet)
Seat 2: xobit26 collected ($1.25)
Seat 3: Millten (button) folded before Flop (didn't bet)
Seat 4: monkeypokerdirt (small blind) folded before Flop
Seat 5: Jesterclown (big blind) folded before Flop
Seat 6: TR1CKTR1CK folded before Flop (didn't bet)
Seat 7: pudge.3096 folded before Flop (didn't bet)
Seat 8: undergr0undY folded before Flop (didn't bet)
Seat 9: rovara folded before Flop (didn't bet)



PokerStars Hand #228672852055:  Hold'em No Limit ($0.25/$0.50 USD) - 2021/07/30 0:11:54 ET
Table 'Laodamia II' 9-max Seat #4 is the button
Seat 1: I oguz han I ($46.85 in chips) 
Seat 2: xobit26 ($70.89 in chips) 
Seat 3: Millten ($51.10 in chips) 
Seat 4: monkeypokerdirt ($31.76 in chips) 
Seat 5: Jesterclown ($81.09 in chips) 
Seat 6: TR1CKTR1CK ($48.13 in chips) 
Seat 7: pudge.3096 ($127.18 in chips) 
Seat 8: undergr0undY ($55.31 in chips) 
Seat 9: rovara ($57.94 in chips) 
Jesterclown: posts small blind $0.25
TR1CKTR1CK: posts big blind $0.50
*** HOLE CARDS ***
pudge.3096: raises $0.75 to $1.25
undergr0undY: folds 
rovara: folds 
I oguz han I: folds 
xobit26: folds 
Millten: folds 
monkeypokerdirt: folds 
Jesterclown: folds 
TR1CKTR1CK: folds 
Uncalled bet ($0.75) returned to pudge.3096
pudge.3096 collected $1.25 from pot
pudge.3096: doesn't show hand 
*** SUMMARY ***
Total pot $1.25 | Rake $0 
Seat 1: I oguz han I folded before Flop (didn't bet)
Seat 2: xobit26 folded before Flop (didn't bet)
Seat 3: Millten folded before Flop (didn't bet)
Seat 4: monkeypokerdirt (button) folded before Flop (didn't bet)
Seat 5: Jesterclown (small blind) folded before Flop
Seat 6: TR1CKTR1CK (big blind) folded before Flop
Seat 7: pudge.3096 collected ($1.25)
Seat 8: undergr0undY folded before Flop (didn't bet)
Seat 9: rovara folded before Flop (didn't bet)



PokerStars Hand #228672854279:  Hold'em No Limit ($0.25/$0.50 USD) - 2021/07/30 0:12:08 ET
Table 'Laodamia II' 9-max Seat #5 is the button
Seat 1: I oguz han I ($46.85 in chips) 
Seat 2: xobit26 ($70.89 in chips) 
Seat 3: Millten ($51.10 in chips) 
Seat 4: monkeypokerdirt ($31.76 in chips) 
Seat 5: Jesterclown ($80.84 in chips) 
Seat 6: TR1CKTR1CK ($47.63 in chips) 
Seat 7: pudge.3096 ($127.93 in chips) 
Seat 8: undergr0undY ($55.31 in chips) 
Seat 9: rovara ($57.94 in chips) 
TR1CKTR1CK: posts small blind $0.25
pudge.3096: posts big blind $0.50
*** HOLE CARDS ***
undergr0undY: folds 
rovara: folds 
I oguz han I: folds 
xobit26: folds 
Millten: raises $0.75 to $1.25
monkeypokerdirt: calls $1.25
Jesterclown: raises $4.75 to $6
TR1CKTR1CK: folds 
pudge.3096: folds 
Millten: folds 
monkeypokerdirt: folds 
Uncalled bet ($4.75) returned to Jesterclown
Jesterclown collected $4.50 from pot
Jesterclown: doesn't show hand 
*** SUMMARY ***
Total pot $4.50 | Rake $0 
Seat 1: I oguz han I folded before Flop (didn't bet)
Seat 2: xobit26 folded before Flop (didn't bet)
Seat 3: Millten folded before Flop
Seat 4: monkeypokerdirt folded before Flop
Seat 5: Jesterclown (button) collected ($4.50)
Seat 6: TR1CKTR1CK (small blind) folded before Flop
Seat 7: pudge.3096 (big blind) folded before Flop
Seat 8: undergr0undY folded before Flop (didn't bet)
Seat 9: rovara folded before Flop (didn't bet)



PokerStars Hand #228672860130:  Hold'em No Limit ($0.25/$0.50 USD) - 2021/07/30 0:12:44 ET
Table 'Laodamia II' 9-max Seat #6 is the button
Seat 1: I oguz han I ($46.85 in chips) 
Seat 2: xobit26 ($70.89 in chips) 
Seat 3: Millten ($50 in chips) 
Seat 4: monkeypokerdirt ($30.51 in chips) 
Seat 5: Jesterclown ($84.09 in chips) 
Seat 6: TR1CKTR1CK ($47.38 in chips) 
Seat 7: pudge.3096 ($127.43 in chips) 
Seat 8: undergr0undY ($55.31 in chips) 
Seat 9: rovara ($57.94 in chips) 
pudge.3096: posts small blind $0.25
undergr0undY: posts big blind $0.50
*** HOLE CARDS ***
rovara: folds 
I oguz han I: folds 
xobit26: folds 
Millten: folds 
monkeypokerdirt: folds 
Jesterclown: folds 
TR1CKTR1CK: folds 
pudge.3096: raises $1 to $1.50
undergr0undY: folds 
Uncalled bet ($1) returned to pudge.3096
pudge.3096 collected $1 from pot
pudge.3096: doesn't show hand 
*** SUMMARY ***
Total pot $1 | Rake $0 
Seat 1: I oguz han I folded before Flop (didn't bet)
Seat 2: xobit26 folded before Flop (didn't bet)
Seat 3: Millten folded before Flop (didn't bet)
Seat 4: monkeypokerdirt folded before Flop (didn't bet)
Seat 5: Jesterclown folded before Flop (didn't bet)
Seat 6: TR1CKTR1CK (button) folded before Flop (didn't bet)
Seat 7: pudge.3096 (small blind) collected ($1)
Seat 8: undergr0undY (big blind) folded before Flop
Seat 9: rovara folded before Flop (didn't bet)



PokerStars Hand #228672865304:  Hold'em No Limit ($0.25/$0.50 USD) - 2021/07/30 0:13:17 ET
Table 'Laodamia II' 9-max Seat #7 is the button
Seat 1: I oguz han I ($46.85 in chips) 
Seat 2: xobit26 ($70.89 in chips) 
Seat 3: Millten ($50 in chips) 
Seat 4: monkeypokerdirt ($30.51 in chips) 
Seat 5: Jesterclown ($84.09 in chips) 
Seat 6: TR1CKTR1CK ($47.38 in chips) 
Seat 7: pudge.3096 ($127.93 in chips) 
Seat 8: undergr0undY ($54.81 in chips) 
Seat 9: rovara ($57.94 in chips) 
undergr0undY: posts small blind $0.25
rovara: posts big blind $0.50
*** HOLE CARDS ***
I oguz han I: folds 
xobit26: folds 
Millten: folds 
monkeypokerdirt: folds 
Jesterclown: folds 
TR1CKTR1CK: folds 
pudge.3096: raises $0.75 to $1.25
undergr0undY: raises $4.25 to $5.50
rovara: folds 
pudge.3096: folds 
Uncalled bet ($4.25) returned to undergr0undY
undergr0undY collected $3 from pot
*** SUMMARY ***
Total pot $3 | Rake $0 
Seat 1: I oguz han I folded before Flop (didn't bet)
Seat 2: xobit26 folded before Flop (didn't bet)
Seat 3: Millten folded before Flop (didn't bet)
Seat 4: monkeypokerdirt folded before Flop (didn't bet)
Seat 5: Jesterclown folded before Flop (didn't bet)
Seat 6: TR1CKTR1CK folded before Flop (didn't bet)
Seat 7: pudge.3096 (button) folded before Flop
Seat 8: undergr0undY (small blind) collected ($3)
Seat 9: rovara (big blind) folded before Flop



PokerStars Hand #228672869108:  Hold'em No Limit ($0.25/$0.50 USD) - 2021/07/30 0:13:41 ET
Table 'Laodamia II' 9-max Seat #8 is the button
Seat 1: I oguz han I ($46.85 in chips) 
Seat 2: xobit26 ($70.89 in chips) 
Seat 3: Millten ($50 in chips) 
Seat 4: monkeypokerdirt ($30.51 in chips) 
Seat 5: Jesterclown ($84.09 in chips) 
Seat 6: TR1CKTR1CK ($47.38 in chips) 
Seat 7: pudge.3096 ($126.68 in chips) 
Seat 8: undergr0undY ($56.56 in chips) 
Seat 9: rovara ($57.44 in chips) 
rovara: posts small blind $0.25
I oguz han I: posts big blind $0.50
*** HOLE CARDS ***
xobit26: folds 
Millten: folds 
monkeypokerdirt: folds 
Jesterclown: folds 
TR1CKTR1CK: folds 
pudge.3096: raises $0.75 to $1.25
undergr0undY: folds 
rovara: calls $1
I oguz han I: calls $0.75
*** FLOP *** [5c As 7c]
rovara: checks 
I oguz han I: checks 
pudge.3096: bets $1.85
rovara: folds 
I oguz han I: folds 
Uncalled bet ($1.85) returned to pudge.3096
pudge.3096 collected $3.56 from pot
pudge.3096: doesn't show hand 
*** SUMMARY ***
Total pot $3.75 | Rake $0.19 
Board [5c As 7c]
Seat 1: I oguz han I (big blind) folded on the Flop
Seat 2: xobit26 folded before Flop (didn't bet)
Seat 3: Millten folded before Flop (didn't bet)
Seat 4: monkeypokerdirt folded before Flop (didn't bet)
Seat 5: Jesterclown folded before Flop (didn't bet)
Seat 6: TR1CKTR1CK folded before Flop (didn't bet)
Seat 7: pudge.3096 collected ($3.56)
Seat 8: undergr0undY (button) folded before Flop (didn't bet)
Seat 9: rovara (small blind) folded on the Flop



PokerStars Hand #228672875269:  Hold'em No Limit ($0.25/$0.50 USD) - 2021/07/30 0:14:21 ET
Table 'Laodamia II' 9-max Seat #9 is the button
Seat 1: I oguz han I ($45.60 in chips) 
Seat 2: xobit26 ($70.89 in chips) 
Seat 3: Millten ($50 in chips) 
Seat 4: monkeypokerdirt ($30.51 in chips) 
Seat 5: Jesterclown ($84.09 in chips) 
Seat 6: TR1CKTR1CK ($47.38 in chips) 
Seat 7: pudge.3096 ($128.99 in chips) 
Seat 8: undergr0undY ($56.56 in chips) 
Seat 9: rovara ($56.19 in chips) 
I oguz han I: posts small blind $0.25
xobit26: posts big blind $0.50
*** HOLE CARDS ***
Millten: folds 
monkeypokerdirt: folds 
Jesterclown: folds 
TR1CKTR1CK: folds 
pudge.3096: folds 
Millten leaves the table
undergr0undY: folds 
rovara: folds 
I oguz han I: folds 
Uncalled bet ($0.25) returned to xobit26
xobit26 collected $0.50 from pot
xobit26: doesn't show hand 
*** SUMMARY ***
Total pot $0.50 | Rake $0 
Seat 1: I oguz han I (small blind) folded before Flop
Seat 2: xobit26 (big blind) collected ($0.50)
Seat 3: Millten folded before Flop (didn't bet)
Seat 4: monkeypokerdirt folded before Flop (didn't bet)
Seat 5: Jesterclown folded before Flop (didn't bet)
Seat 6: TR1CKTR1CK folded before Flop (didn't bet)
Seat 7: pudge.3096 folded before Flop (didn't bet)
Seat 8: undergr0undY folded before Flop (didn't bet)
Seat 9: rovara (button) folded before Flop (didn't bet)



PokerStars Hand #228672878383:  Hold'em No Limit ($0.25/$0.50 USD) - 2021/07/30 0:14:40 ET
Table 'Laodamia II' 9-max Seat #1 is the button
Seat 1: I oguz han I ($45.35 in chips) 
Seat 2: xobit26 ($71.14 in chips) 
Seat 4: monkeypokerdirt ($30.51 in chips) 
Seat 5: Jesterclown ($84.09 in chips) 
Seat 6: TR1CKTR1CK ($47.38 in chips) 
Seat 7: pudge.3096 ($128.99 in chips) 
Seat 8: undergr0undY ($56.56 in chips) 
Seat 9: rovara ($56.19 in chips) 
xobit26: posts small blind $0.25
monkeypokerdirt: posts big blind $0.50
*** HOLE CARDS ***
Jesterclown: folds 
TR1CKTR1CK: folds 
pudge.3096: folds 
undergr0undY: folds 
rovara: folds 
I oguz han I: raises $1 to $1.50
xobit26: folds 
monkeypokerdirt: calls $1
*** FLOP *** [7h Ts 5h]
monkeypokerdirt: checks 
I oguz han I: bets $1.02
monkeypokerdirt: folds 
Uncalled bet ($1.02) returned to I oguz han I
I oguz han I collected $3.09 from pot
I oguz han I: doesn't show hand 
*** SUMMARY ***
Total pot $3.25 | Rake $0.16 
Board [7h Ts 5h]
Seat 1: I oguz han I (button) collected ($3.09)
Seat 2: xobit26 (small blind) folded before Flop
Seat 4: monkeypokerdirt (big blind) folded on the Flop
Seat 5: Jesterclown folded before Flop (didn't bet)
Seat 6: TR1CKTR1CK folded before Flop (didn't bet)
Seat 7: pudge.3096 folded before Flop (didn't bet)
Seat 8: undergr0undY folded before Flop (didn't bet)
Seat 9: rovara folded before Flop (didn't bet)



PokerStars Hand #228672884606:  Hold'em No Limit ($0.25/$0.50 USD) - 2021/07/30 0:15:19 ET
Table 'Laodamia II' 9-max Seat #2 is the button
Seat 1: I oguz han I ($46.94 in chips) 
Seat 2: xobit26 ($70.89 in chips) 
Seat 4: monkeypokerdirt ($29.01 in chips) 
Seat 5: Jesterclown ($84.09 in chips) 
Seat 6: TR1CKTR1CK ($47.38 in chips) 
Seat 7: pudge.3096 ($128.99 in chips) 
Seat 8: undergr0undY ($56.56 in chips) 
Seat 9: rovara ($56.19 in chips) 
monkeypokerdirt: posts small blind $0.25
Jesterclown: posts big blind $0.50
*** HOLE CARDS ***
TR1CKTR1CK has timed out
TR1CKTR1CK: folds 
pudge.3096: folds 
undergr0undY: folds 
rovara: folds 
I oguz han I: folds 
xobit26: folds 
F.Peters10 joins the table at seat #3 
monkeypokerdirt: folds 
Uncalled bet ($0.25) returned to Jesterclown
Jesterclown collected $0.50 from pot
Jesterclown: doesn't show hand 
*** SUMMARY ***
Total pot $0.50 | Rake $0 
Seat 1: I oguz han I folded before Flop (didn't bet)
Seat 2: xobit26 (button) folded before Flop (didn't bet)
Seat 4: monkeypokerdirt (small blind) folded before Flop
Seat 5: Jesterclown (big blind) collected ($0.50)
Seat 6: TR1CKTR1CK folded before Flop (didn't bet)
Seat 7: pudge.3096 folded before Flop (didn't bet)
Seat 8: undergr0undY folded before Flop (didn't bet)
Seat 9: rovara folded before Flop (didn't bet)



PokerStars Hand #228672888922:  Hold'em No Limit ($0.25/$0.50 USD) - 2021/07/30 0:15:47 ET
Table 'Laodamia II' 9-max Seat #4 is the button
Seat 1: I oguz han I ($46.94 in chips) 
Seat 2: xobit26 ($70.89 in chips) 
Seat 4: monkeypokerdirt ($28.76 in chips) 
Seat 5: Jesterclown ($84.34 in chips) 
Seat 6: TR1CKTR1CK ($47.38 in chips) 
Seat 7: pudge.3096 ($128.99 in chips) 
Seat 8: undergr0undY ($56.56 in chips) 
Seat 9: rovara ($56.19 in chips) 
Jesterclown: posts small blind $0.25
TR1CKTR1CK: posts big blind $0.50
F.Peters10: sits out 
*** HOLE CARDS ***
pudge.3096: folds 
undergr0undY: folds 
rovara: folds 
I oguz han I: folds 
xobit26: folds 
monkeypokerdirt: folds 
Jesterclown: raises $1 to $1.50
TR1CKTR1CK: folds 
Uncalled bet ($1) returned to Jesterclown
Jesterclown collected $1 from pot
Jesterclown: doesn't show hand 
*** SUMMARY ***
Total pot $1 | Rake $0 
Seat 1: I oguz han I folded before Flop (didn't bet)
Seat 2: xobit26 folded before Flop (didn't bet)
Seat 4: monkeypokerdirt (button) folded before Flop (didn't bet)
Seat 5: Jesterclown (small blind) collected ($1)
Seat 6: TR1CKTR1CK (big blind) folded before Flop
Seat 7: pudge.3096 folded before Flop (didn't bet)
Seat 8: undergr0undY folded before Flop (didn't bet)
Seat 9: rovara folded before Flop (didn't bet)



PokerStars Hand #228672892343:  Hold'em No Limit ($0.25/$0.50 USD) - 2021/07/30 0:16:08 ET
Table 'Laodamia II' 9-max Seat #5 is the button
Seat 1: I oguz han I ($46.94 in chips) 
Seat 2: xobit26 ($70.89 in chips) 
Seat 3: F.Peters10 ($40 in chips) 
Seat 4: monkeypokerdirt ($28.76 in chips) 
Seat 5: Jesterclown ($84.84 in chips) 
Seat 6: TR1CKTR1CK ($46.88 in chips) 
Seat 7: pudge.3096 ($128.99 in chips) 
Seat 8: undergr0undY ($56.56 in chips) 
Seat 9: rovara ($56.19 in chips) 
TR1CKTR1CK: posts small blind $0.25
pudge.3096: posts big blind $0.50
F.Peters10: posts big blind $0.50
*** HOLE CARDS ***
undergr0undY: folds 
rovara: folds 
I oguz han I: folds 
xobit26: folds 
F.Peters10: checks 
monkeypokerdirt: raises $1.75 to $2.25
Jesterclown: folds 
TR1CKTR1CK: folds 
pudge.3096: folds 
F.Peters10: folds 
Uncalled bet ($1.75) returned to monkeypokerdirt
monkeypokerdirt collected $1.75 from pot
*** SUMMARY ***
Total pot $1.75 | Rake $0 
Seat 1: I oguz han I folded before Flop (didn't bet)
Seat 2: xobit26 folded before Flop (didn't bet)
Seat 3: F.Peters10 folded before Flop (didn't bet)
Seat 4: monkeypokerdirt collected ($1.75)
Seat 5: Jesterclown (button) folded before Flop (didn't bet)
Seat 6: TR1CKTR1CK (small blind) folded before Flop
Seat 7: pudge.3096 (big blind) folded before Flop
Seat 8: undergr0undY folded before Flop (didn't bet)
Seat 9: rovara folded before Flop (didn't bet)



PokerStars Hand #228672899634:  Hold'em No Limit ($0.25/$0.50 USD) - 2021/07/30 0:16:54 ET
Table 'Laodamia II' 9-max Seat #6 is the button
Seat 1: I oguz han I ($46.94 in chips) 
Seat 2: xobit26 ($70.89 in chips) 
Seat 3: F.Peters10 ($39.50 in chips) 
Seat 4: monkeypokerdirt ($30.01 in chips) 
Seat 5: Jesterclown ($84.84 in chips) 
Seat 6: TR1CKTR1CK ($46.63 in chips) 
Seat 7: pudge.3096 ($128.49 in chips) 
Seat 9: rovara ($56.19 in chips) 
pudge.3096: posts small blind $0.25
undergr0undY: is sitting out 
rovara: posts big blind $0.50
*** HOLE CARDS ***
I oguz han I: folds 
undergr0undY leaves the table
xobit26: folds 
F.Peters10: raises $0.50 to $1
monkeypokerdirt: calls $1
Jesterclown: folds 
TR1CKTR1CK: folds 
pudge.3096: calls $0.75
rovara: folds 
*** FLOP *** [7c 2d 8c]
pudge.3096: checks 
F.Peters10: checks 
monkeypokerdirt: bets $2.50
pudge.3096: calls $2.50
F.Peters10: folds 
*** TURN *** [7c 2d 8c] [3s]
pudge.3096: checks 
monkeypokerdirt: checks 
*** RIVER *** [7c 2d 8c 3s] [As]
pudge.3096: checks 
monkeypokerdirt: bets $6
pudge.3096: calls $6
*** SHOW DOWN ***
monkeypokerdirt: shows [Qc Jh] (high card Ace)
pudge.3096: shows [5d 7d] (a pair of Sevens)
pudge.3096 collected $19.48 from pot
*** SUMMARY ***
Total pot $20.50 | Rake $1.02 
Board [7c 2d 8c 3s As]
Seat 1: I oguz han I folded before Flop (didn't bet)
Seat 2: xobit26 folded before Flop (didn't bet)
Seat 3: F.Peters10 folded on the Flop
Seat 4: monkeypokerdirt showed [Qc Jh] and lost with high card Ace
Seat 5: Jesterclown folded before Flop (didn't bet)
Seat 6: TR1CKTR1CK (button) folded before Flop (didn't bet)
Seat 7: pudge.3096 (small blind) showed [5d 7d] and won ($19.48) with a pair of Sevens
Seat 9: rovara (big blind) folded before Flop



PokerStars Hand #228672913491:  Hold'em No Limit ($0.25/$0.50 USD) - 2021/07/30 0:18:23 ET
Table 'Laodamia II' 9-max Seat #7 is the button
Seat 1: I oguz han I ($46.94 in chips) 
Seat 2: xobit26 ($70.89 in chips) 
Seat 3: F.Peters10 ($38.50 in chips) 
Seat 4: monkeypokerdirt ($20.51 in chips) 
Seat 5: Jesterclown ($84.84 in chips) 
Seat 6: TR1CKTR1CK ($46.63 in chips) 
Seat 7: pudge.3096 ($138.47 in chips) 
Seat 9: rovara ($55.69 in chips) 
rovara: posts small blind $0.25
I oguz han I: posts big blind $0.50
*** HOLE CARDS ***
xobit26: folds 
F.Peters10: folds 
monkeypokerdirt: folds 
Jesterclown: raises $1 to $1.50
TR1CKTR1CK has timed out
TR1CKTR1CK: folds 
pudge.3096: folds 
rovara: folds 
I oguz han I: folds 
Uncalled bet ($1) returned to Jesterclown
Jesterclown collected $1.25 from pot
Jesterclown: doesn't show hand 
*** SUMMARY ***
Total pot $1.25 | Rake $0 
Seat 1: I oguz han I (big blind) folded before Flop
Seat 2: xobit26 folded before Flop (didn't bet)
Seat 3: F.Peters10 folded before Flop (didn't bet)
Seat 4: monkeypokerdirt folded before Flop (didn't bet)
Seat 5: Jesterclown collected ($1.25)
Seat 6: TR1CKTR1CK folded before Flop (didn't bet)
Seat 7: pudge.3096 (button) folded before Flop (didn't bet)
Seat 9: rovara (small blind) folded before Flop



PokerStars Hand #228672919011:  Hold'em No Limit ($0.25/$0.50 USD) - 2021/07/30 0:18:58 ET
Table 'Laodamia II' 9-max Seat #9 is the button
Seat 1: I oguz han I ($46.44 in chips) 
Seat 2: xobit26 ($70.89 in chips) 
Seat 3: F.Peters10 ($38.50 in chips) 
Seat 4: monkeypokerdirt ($20.51 in chips) 
Seat 5: Jesterclown ($85.59 in chips) 
Seat 6: TR1CKTR1CK ($46.63 in chips) 
Seat 7: pudge.3096 ($138.47 in chips) 
Seat 9: rovara ($55.44 in chips) 
I oguz han I: posts small blind $0.25
xobit26: posts big blind $0.50
*** HOLE CARDS ***
F.Peters10: folds 
monkeypokerdirt: folds 
Jesterclown: folds 
Eagle88888 joins the table at seat #8 
TR1CKTR1CK: folds 
pudge.3096: folds 
rovara: folds 
I oguz han I: raises $1 to $1.50
xobit26: calls $1
*** FLOP *** [Qs 5d Tc]
I oguz han I: checks 
xobit26: checks 
*** TURN *** [Qs 5d Tc] [9h]
I oguz han I: checks 
xobit26: checks 
*** RIVER *** [Qs 5d Tc 9h] [7d]
I oguz han I: checks 
xobit26: bets $2.16
I oguz han I: folds 
Uncalled bet ($2.16) returned to xobit26
xobit26 collected $2.85 from pot
xobit26: doesn't show hand 
*** SUMMARY ***
Total pot $3 | Rake $0.15 
Board [Qs 5d Tc 9h 7d]
Seat 1: I oguz han I (small blind) folded on the River
Seat 2: xobit26 (big blind) collected ($2.85)
Seat 3: F.Peters10 folded before Flop (didn't bet)
Seat 4: monkeypokerdirt folded before Flop (didn't bet)
Seat 5: Jesterclown folded before Flop (didn't bet)
Seat 6: TR1CKTR1CK folded before Flop (didn't bet)
Seat 7: pudge.3096 folded before Flop (didn't bet)
Seat 9: rovara (button) folded before Flop (didn't bet)



PokerStars Hand #228672932450:  Hold'em No Limit ($0.25/$0.50 USD) - 2021/07/30 0:19:47 ET
Table 'Laodamia II' 9-max Seat #1 is the button
Seat 1: I oguz han I ($44.94 in chips) 
Seat 2: xobit26 ($72.24 in chips) 
Seat 3: F.Peters10 ($38.50 in chips) 
Seat 4: monkeypokerdirt ($20.51 in chips) 
Seat 5: Jesterclown ($85.59 in chips) 
Seat 6: TR1CKTR1CK ($46.63 in chips) 
Seat 7: pudge.3096 ($138.47 in chips) 
Seat 9: rovara ($55.44 in chips) 
xobit26: posts small blind $0.25
F.Peters10: posts big blind $0.50
Eagle88888: sits out 
*** HOLE CARDS ***
monkeypokerdirt: folds 
Jesterclown: folds 
TR1CKTR1CK: folds 
pudge.3096: folds 
rovara: raises $0.75 to $1.25
I oguz han I: folds 
xobit26: folds 
F.Peters10: folds 
Uncalled bet ($0.75) returned to rovara
rovara collected $1.25 from pot
*** SUMMARY ***
Total pot $1.25 | Rake $0 
Seat 1: I oguz han I (button) folded before Flop (didn't bet)
Seat 2: xobit26 (small blind) folded before Flop
Seat 3: F.Peters10 (big blind) folded before Flop
Seat 4: monkeypokerdirt folded before Flop (didn't bet)
Seat 5: Jesterclown folded before Flop (didn't bet)
Seat 6: TR1CKTR1CK folded before Flop (didn't bet)
Seat 7: pudge.3096 folded before Flop (didn't bet)
Seat 9: rovara collected ($1.25)



PokerStars Hand #228671702752:  Hold'em No Limit ($0.25/$0.50 USD) - 2021/07/30 22:31:00 ET
Table 'Laodamia II' 9-max Seat #2 is the button
Seat 1: I oguz han I ($28.21 in chips) 
Seat 2: oudine2 ($50 in chips) 
Seat 3: GastonLeFort ($50 in chips) 
Seat 4: Vierc ($29 in chips) 
Seat 6: Mindthis ($82.70 in chips) 
Seat 7: SparkYLive ($51.50 in chips) 
Seat 8: Kasselbanki ($63.91 in chips) 
Seat 9: dallas580821 ($68.12 in chips) 
GastonLeFort: posts small blind $0.25
Vierc: posts big blind $0.50
*** HOLE CARDS ***
Mindthis: folds 
SparkYLive: folds 
Kasselbanki: folds 
dallas580821: raises $1 to $1.50
I oguz han I: folds 
oudine2: folds 
GastonLeFort: folds 
Vierc: folds 
Uncalled bet ($1) returned to dallas580821
dallas580821 collected $1.25 from pot
dallas580821: doesn't show hand 
*** SUMMARY ***
Total pot $1.25 | Rake $0 
Seat 1: I oguz han I folded before Flop (didn't bet)
Seat 2: oudine2 (button) folded before Flop (didn't bet)
Seat 3: GastonLeFort (small blind) folded before Flop
Seat 4: Vierc (big blind) folded before Flop
Seat 6: Mindthis folded before Flop (didn't bet)
Seat 7: SparkYLive folded before Flop (didn't bet)
Seat 8: Kasselbanki folded before Flop (didn't bet)
Seat 9: dallas580821 collected ($1.25)



PokerStars Hand #228671709215:  Hold'em No Limit ($0.25/$0.50 USD) - 2021/07/30 22:31:31 ET
Table 'Laodamia II' 9-max Seat #3 is the button
Seat 1: I oguz han I ($28.21 in chips) 
Seat 2: oudine2 ($50 in chips) 
Seat 3: GastonLeFort ($50 in chips) 
Seat 4: Vierc ($28.50 in chips) 
Seat 6: Mindthis ($82.70 in chips) 
Seat 7: SparkYLive ($51.50 in chips) 
Seat 8: Kasselbanki ($63.91 in chips) 
Seat 9: dallas580821 ($68.87 in chips) 
Vierc: posts small blind $0.25
Mindthis: posts big blind $0.50
*** HOLE CARDS ***
SparkYLive: folds 
Jesterclown joins the table at seat #5 
Kasselbanki: folds 
dallas580821: calls $0.50
I oguz han I: raises $1.50 to $2
oudine2: folds 
GastonLeFort: folds 
Vierc: raises $5 to $7
Mindthis: folds 
dallas580821: folds 
I oguz han I: folds 
Uncalled bet ($5) returned to Vierc
Vierc collected $5 from pot
Vierc: doesn't show hand 
*** SUMMARY ***
Total pot $5 | Rake $0 
Seat 1: I oguz han I folded before Flop
Seat 2: oudine2 folded before Flop (didn't bet)
Seat 3: GastonLeFort (button) folded before Flop (didn't bet)
Seat 4: Vierc (small blind) collected ($5)
Seat 6: Mindthis (big blind) folded before Flop
Seat 7: SparkYLive folded before Flop (didn't bet)
Seat 8: Kasselbanki folded before Flop (didn't bet)
Seat 9: dallas580821 folded before Flop



PokerStars Hand #228671718031:  Hold'em No Limit ($0.25/$0.50 USD) - 2021/07/30 22:32:14 ET
Table 'Laodamia II' 9-max Seat #4 is the button
Seat 1: I oguz han I ($26.21 in chips) 
Seat 2: oudine2 ($50 in chips) 
Seat 3: GastonLeFort ($50 in chips) 
Seat 4: Vierc ($31.50 in chips) 
Seat 6: Mindthis ($82.20 in chips) 
Seat 8: Kasselbanki ($63.91 in chips) 
Seat 9: dallas580821 ($68.37 in chips) 
Mindthis: posts small blind $0.25
SparkYLive: is sitting out 
Kasselbanki: posts big blind $0.50
*** HOLE CARDS ***
SparkYLive leaves the table
dallas580821 has timed out
dallas580821: folds 
I oguz han I: folds 
oudine2: folds 
GastonLeFort: raises $1 to $1.50
Vierc: calls $1.50
Mindthis: folds 
pudge.3096 joins the table at seat #7 
dallas580821 leaves the table
Kasselbanki: folds 
*** FLOP *** [4c 8s Th]
GastonLeFort: checks 
Vierc: bets $1.78
GastonLeFort: calls $1.78
*** TURN *** [4c 8s Th] [7h]
GastonLeFort: checks 
Vierc: bets $3.47
$ilentBob81 joins the table at seat #9 
GastonLeFort: calls $3.47
*** RIVER *** [4c 8s Th 7h] [6h]
GastonLeFort: checks 
Vierc: bets $6.77
GastonLeFort: folds 
Uncalled bet ($6.77) returned to Vierc
Vierc collected $13.54 from pot
Vierc: doesn't show hand 
*** SUMMARY ***
Total pot $14.25 | Rake $0.71 
Board [4c 8s Th 7h 6h]
Seat 1: I oguz han I folded before Flop (didn't bet)
Seat 2: oudine2 folded before Flop (didn't bet)
Seat 3: GastonLeFort folded on the River
Seat 4: Vierc (button) collected ($13.54)
Seat 6: Mindthis (small blind) folded before Flop
Seat 8: Kasselbanki (big blind) folded before Flop
Seat 9: dallas580821 folded before Flop (didn't bet)



PokerStars Hand #228671751635:  Hold'em No Limit ($0.25/$0.50 USD) - 2021/07/30 22:34:56 ET
Table 'Laodamia II' 9-max Seat #6 is the button
Seat 1: I oguz han I ($26.21 in chips) 
Seat 2: oudine2 ($50 in chips) 
Seat 3: GastonLeFort ($50 in chips) 
Seat 4: Vierc ($38.29 in chips) 
Seat 6: Mindthis ($81.95 in chips) 
Seat 8: Kasselbanki ($63.41 in chips) 
Seat 9: $ilentBob81 ($50 in chips) 
Kasselbanki: posts small blind $0.25
$ilentBob81: posts big blind $0.50
Jesterclown: sits out 
*** HOLE CARDS ***
I oguz han I: folds 
oudine2: folds 
GastonLeFort: folds 
Vierc: folds 
Mindthis: folds 
Kasselbanki: folds 
Uncalled bet ($0.25) returned to $ilentBob81
$ilentBob81 collected $0.50 from pot
$ilentBob81: doesn't show hand 
*** SUMMARY ***
Total pot $0.50 | Rake $0 
Seat 1: I oguz han I folded before Flop (didn't bet)
Seat 2: oudine2 folded before Flop (didn't bet)
Seat 3: GastonLeFort folded before Flop (didn't bet)
Seat 4: Vierc folded before Flop (didn't bet)
Seat 6: Mindthis (button) folded before Flop (didn't bet)
Seat 8: Kasselbanki (small blind) folded before Flop
Seat 9: $ilentBob81 (big blind) collected ($0.50)



PokerStars Hand #228671757208:  Hold'em No Limit ($0.25/$0.50 USD) - 2021/07/30 22:35:24 ET
Table 'Laodamia II' 9-max Seat #8 is the button
Seat 1: I oguz han I ($26.21 in chips) 
Seat 2: oudine2 ($50 in chips) 
Seat 3: GastonLeFort ($50 in chips) 
Seat 4: Vierc ($38.29 in chips) 
Seat 6: Mindthis ($81.95 in chips) 
Seat 8: Kasselbanki ($63.16 in chips) 
Seat 9: $ilentBob81 ($50.25 in chips) 
$ilentBob81: posts small blind $0.25
I oguz han I: posts big blind $0.50
Jesterclown: sits out 
pudge.3096: sits out 
*** HOLE CARDS ***
oudine2: folds 
GastonLeFort: folds 
Vierc has timed out
Vierc: folds 
Mindthis: folds 
Kasselbanki: raises $1 to $1.50
$ilentBob81: folds 
I oguz han I: calls $1
*** FLOP *** [7h 5d 8h]
I oguz han I: checks 
Kasselbanki: bets $2
I oguz han I: folds 
Uncalled bet ($2) returned to Kasselbanki
Kasselbanki collected $3.05 from pot
Kasselbanki: doesn't show hand 
*** SUMMARY ***
Total pot $3.25 | Rake $0.20 
Board [7h 5d 8h]
Seat 1: I oguz han I (big blind) folded on the Flop
Seat 2: oudine2 folded before Flop (didn't bet)
Seat 3: GastonLeFort folded before Flop (didn't bet)
Seat 4: Vierc folded before Flop (didn't bet)
Seat 6: Mindthis folded before Flop (didn't bet)
Seat 8: Kasselbanki (button) collected ($3.05)
Seat 9: $ilentBob81 (small blind) folded before Flop



PokerStars Hand #228671764611:  Hold'em No Limit ($0.25/$0.50 USD) - 2021/07/30 22:36:00 ET
Table 'Laodamia II' 9-max Seat #9 is the button
Seat 1: I oguz han I ($24.71 in chips) 
Seat 2: oudine2 ($50 in chips) 
Seat 3: GastonLeFort ($50 in chips) 
Seat 4: Vierc ($38.29 in chips) 
Seat 6: Mindthis ($81.95 in chips) 
Seat 7: pudge.3096 ($50 in chips) 
Seat 8: Kasselbanki ($64.71 in chips) 
Seat 9: $ilentBob81 ($50 in chips) 
I oguz han I: posts small blind $0.25
oudine2: posts big blind $0.50
Jesterclown: sits out 
pudge.3096: posts big blind $0.50
*** HOLE CARDS ***
GastonLeFort: raises $2 to $2.50
Vierc: folds 
Mindthis: calls $2.50
pudge.3096: folds 
Kasselbanki: folds 
$ilentBob81: folds 
I oguz han I: folds 
oudine2: folds 
*** FLOP *** [Qd 5d 4c]
GastonLeFort: checks 
Vierc leaves the table
Mindthis: checks 
*** TURN *** [Qd 5d 4c] [7d]
GastonLeFort: bets $1.49
Mindthis: calls $1.49
*** RIVER *** [Qd 5d 4c 7d] [3c]
monkeypokerdirt joins the table at seat #4 
GastonLeFort: checks 
Mindthis: bets $3.95
GastonLeFort: calls $3.95
*** SHOW DOWN ***
Mindthis: shows [9s 8s] (high card Queen)
GastonLeFort: shows [Kc Qh] (a pair of Queens)
GastonLeFort collected $16.27 from pot
*** SUMMARY ***
Total pot $17.13 | Rake $0.86 
Board [Qd 5d 4c 7d 3c]
Seat 1: I oguz han I (small blind) folded before Flop
Seat 2: oudine2 (big blind) folded before Flop
Seat 3: GastonLeFort showed [Kc Qh] and won ($16.27) with a pair of Queens
Seat 4: Vierc folded before Flop (didn't bet)
Seat 6: Mindthis showed [9s 8s] and lost with high card Queen
Seat 7: pudge.3096 folded before Flop (didn't bet)
Seat 8: Kasselbanki folded before Flop (didn't bet)
Seat 9: $ilentBob81 (button) folded before Flop (didn't bet)



PokerStars Hand #228671779311:  Hold'em No Limit ($0.25/$0.50 USD) - 2021/07/30 22:37:12 ET
Table 'Laodamia II' 9-max Seat #1 is the button
Seat 1: I oguz han I ($24.46 in chips) 
Seat 2: oudine2 ($50 in chips) 
Seat 3: GastonLeFort ($58.33 in chips) 
Seat 6: Mindthis ($74.01 in chips) 
Seat 7: pudge.3096 ($50 in chips) 
Seat 8: Kasselbanki ($64.71 in chips) 
Seat 9: $ilentBob81 ($50 in chips) 
oudine2: posts small blind $0.25
GastonLeFort: posts big blind $0.50
monkeypokerdirt: sits out 
Jesterclown: sits out 
*** HOLE CARDS ***
Mindthis: raises $1 to $1.50
pudge.3096: folds 
Kasselbanki: folds 
$ilentBob81: folds 
I oguz han I: raises $2.50 to $4
oudine2: folds 
GastonLeFort: folds 
Mindthis: raises $70.01 to $74.01 and is all-in
I oguz han I: calls $20.46 and is all-in
Uncalled bet ($49.55) returned to Mindthis
*** FLOP *** [8d 6s 6d]
*** TURN *** [8d 6s 6d] [2s]
*** RIVER *** [8d 6s 6d 2s] [7s]
*** SHOW DOWN ***
Mindthis: shows [Jd Jc] (two pair, Jacks and Sixes)
I oguz han I: shows [Ac As] (two pair, Aces and Sixes)
I oguz han I collected $47.67 from pot
*** SUMMARY ***
Total pot $49.67 | Rake $2 
Board [8d 6s 6d 2s 7s]
Seat 1: I oguz han I (button) showed [Ac As] and won ($47.67) with two pair, Aces and Sixes
Seat 2: oudine2 (small blind) folded before Flop
Seat 3: GastonLeFort (big blind) folded before Flop
Seat 6: Mindthis showed [Jd Jc] and lost with two pair, Jacks and Sixes
Seat 7: pudge.3096 folded before Flop (didn't bet)
Seat 8: Kasselbanki folded before Flop (didn't bet)
Seat 9: $ilentBob81 folded before Flop (didn't bet)



PokerStars Hand #228671798043:  Hold'em No Limit ($0.25/$0.50 USD) - 2021/07/30 22:38:02 ET
Table 'Laodamia II' 9-max Seat #2 is the button
Seat 1: I oguz han I ($47.67 in chips) 
Seat 2: oudine2 ($50 in chips) 
Seat 3: GastonLeFort ($57.83 in chips) 
Seat 4: monkeypokerdirt ($40 in chips) 
Seat 6: Mindthis ($50 in chips) 
Seat 7: pudge.3096 ($50 in chips) 
Seat 8: Kasselbanki ($64.71 in chips) 
Seat 9: $ilentBob81 ($50 in chips) 
GastonLeFort: posts small blind $0.25
monkeypokerdirt: posts big blind $0.50
Jesterclown: sits out 
*** HOLE CARDS ***
Mindthis: raises $1 to $1.50
pudge.3096: folds 
Kasselbanki: folds 
$ilentBob81: folds 
I oguz han I: calls $1.50
oudine2: folds 
GastonLeFort: raises $5 to $6.50
monkeypokerdirt: folds 
Mindthis: calls $5
I oguz han I: folds 
*** FLOP *** [6d 4s 3s]
GastonLeFort: bets $3.56
Mindthis: raises $14.96 to $18.52
GastonLeFort: raises $32.81 to $51.33 and is all-in
Mindthis: calls $24.98 and is all-in
Uncalled bet ($7.83) returned to GastonLeFort
*** TURN *** [6d 4s 3s] [4h]
*** RIVER *** [6d 4s 3s 4h] [Jd]
*** SHOW DOWN ***
GastonLeFort: shows [Qd Qs] (two pair, Queens and Fours)
Mindthis: shows [Js Ks] (two pair, Jacks and Fours)
GastonLeFort cashed out the hand for $55.91 | Cash Out Fee $0.56
*** SUMMARY ***
Total pot $102 | Rake $2 
Board [6d 4s 3s 4h Jd]
Seat 1: I oguz han I folded before Flop
Seat 2: oudine2 (button) folded before Flop (didn't bet)
Seat 3: GastonLeFort (small blind) showed [Qd Qs] and won ($100) with two pair, Queens and Fours (pot not awarded as player cashed out)
Seat 4: monkeypokerdirt (big blind) folded before Flop
Seat 6: Mindthis showed [Js Ks] and lost with two pair, Jacks and Fours
Seat 7: pudge.3096 folded before Flop (didn't bet)
Seat 8: Kasselbanki folded before Flop (didn't bet)
Seat 9: $ilentBob81 folded before Flop (didn't bet)



PokerStars Hand #228671815686:  Hold'em No Limit ($0.25/$0.50 USD) - 2021/07/30 22:39:29 ET
Table 'Laodamia II' 9-max Seat #3 is the button
Seat 1: I oguz han I ($46.17 in chips) 
Seat 2: oudine2 ($50 in chips) 
Seat 3: GastonLeFort ($63.74 in chips) 
Seat 4: monkeypokerdirt ($39.50 in chips) 
Seat 5: Jesterclown ($50 in chips) 
Seat 6: Mindthis ($50 in chips) 
Seat 7: pudge.3096 ($50 in chips) 
Seat 8: Kasselbanki ($64.71 in chips) 
Seat 9: $ilentBob81 ($50 in chips) 
monkeypokerdirt: posts small blind $0.25
Jesterclown: posts big blind $0.50
*** HOLE CARDS ***
Mindthis: folds 
Mindthis leaves the table
pudge.3096: folds 
Kasselbanki: raises $0.50 to $1
artemxxl joins the table at seat #6 
$ilentBob81: calls $1
I oguz han I: folds 
oudine2: folds 
GastonLeFort: folds 
monkeypokerdirt: folds 
Jesterclown: folds 
*** FLOP *** [Tc 2h Ac]
Kasselbanki: checks 
$ilentBob81: bets $1.66
Kasselbanki: folds 
Uncalled bet ($1.66) returned to $ilentBob81
$ilentBob81 collected $2.61 from pot
$ilentBob81: doesn't show hand 
*** SUMMARY ***
Total pot $2.75 | Rake $0.14 
Board [Tc 2h Ac]
Seat 1: I oguz han I folded before Flop (didn't bet)
Seat 2: oudine2 folded before Flop (didn't bet)
Seat 3: GastonLeFort (button) folded before Flop (didn't bet)
Seat 4: monkeypokerdirt (small blind) folded before Flop
Seat 5: Jesterclown (big blind) folded before Flop
Seat 6: Mindthis folded before Flop (didn't bet)
Seat 7: pudge.3096 folded before Flop (didn't bet)
Seat 8: Kasselbanki folded on the Flop
Seat 9: $ilentBob81 collected ($2.61)



PokerStars Hand #228671824789:  Hold'em No Limit ($0.25/$0.50 USD) - 2021/07/30 22:40:14 ET
Table 'Laodamia II' 9-max Seat #4 is the button
Seat 1: I oguz han I ($46.17 in chips) 
Seat 2: oudine2 ($50 in chips) 
Seat 3: GastonLeFort ($63.74 in chips) 
Seat 4: monkeypokerdirt ($39.25 in chips) 
Seat 5: Jesterclown ($50 in chips) 
Seat 7: pudge.3096 ($50 in chips) 
Seat 8: Kasselbanki ($63.71 in chips) 
Seat 9: $ilentBob81 ($51.61 in chips) 
Jesterclown: posts small blind $0.25
pudge.3096: posts big blind $0.50
*** HOLE CARDS ***
Kasselbanki: folds 
$ilentBob81: folds 
I oguz han I: folds 
oudine2: raises $1 to $1.50
GastonLeFort: folds 
monkeypokerdirt: folds 
Jesterclown: folds 
pudge.3096: folds 
Uncalled bet ($1) returned to oudine2
oudine2 collected $1.25 from pot
oudine2: doesn't show hand 
*** SUMMARY ***
Total pot $1.25 | Rake $0 
Seat 1: I oguz han I folded before Flop (didn't bet)
Seat 2: oudine2 collected ($1.25)
Seat 3: GastonLeFort folded before Flop (didn't bet)
Seat 4: monkeypokerdirt (button) folded before Flop (didn't bet)
Seat 5: Jesterclown (small blind) folded before Flop
Seat 7: pudge.3096 (big blind) folded before Flop
Seat 8: Kasselbanki folded before Flop (didn't bet)
Seat 9: $ilentBob81 folded before Flop (didn't bet)



PokerStars Hand #228671828853:  Hold'em No Limit ($0.25/$0.50 USD) - 2021/07/30 22:40:34 ET
Table 'Laodamia II' 9-max Seat #5 is the button
Seat 1: I oguz han I ($46.17 in chips) 
Seat 2: oudine2 ($50.75 in chips) 
Seat 3: GastonLeFort ($63.74 in chips) 
Seat 4: monkeypokerdirt ($39.25 in chips) 
Seat 5: Jesterclown ($50 in chips) 
Seat 7: pudge.3096 ($50 in chips) 
Seat 8: Kasselbanki ($63.71 in chips) 
Seat 9: $ilentBob81 ($51.61 in chips) 
pudge.3096: posts small blind $0.25
Kasselbanki: posts big blind $0.50
*** HOLE CARDS ***
$ilentBob81: folds 
I oguz han I: folds 
oudine2: folds 
GastonLeFort: folds 
monkeypokerdirt: folds 
Jesterclown: raises $1 to $1.50
pudge.3096: folds 
Kasselbanki: calls $1
*** FLOP *** [5d 7d Jh]
Kasselbanki: checks 
Jesterclown: bets $1.55
Kasselbanki: folds 
Uncalled bet ($1.55) returned to Jesterclown
Jesterclown collected $3.09 from pot
Jesterclown: doesn't show hand 
*** SUMMARY ***
Total pot $3.25 | Rake $0.16 
Board [5d 7d Jh]
Seat 1: I oguz han I folded before Flop (didn't bet)
Seat 2: oudine2 folded before Flop (didn't bet)
Seat 3: GastonLeFort folded before Flop (didn't bet)
Seat 4: monkeypokerdirt folded before Flop (didn't bet)
Seat 5: Jesterclown (button) collected ($3.09)
Seat 7: pudge.3096 (small blind) folded before Flop
Seat 8: Kasselbanki (big blind) folded on the Flop
Seat 9: $ilentBob81 folded before Flop (didn't bet)



PokerStars Hand #228671838598:  Hold'em No Limit ($0.25/$0.50 USD) - 2021/07/30 22:41:22 ET
Table 'Laodamia II' 9-max Seat #7 is the button
Seat 1: I oguz han I ($46.17 in chips) 
Seat 2: oudine2 ($50.75 in chips) 
Seat 3: GastonLeFort ($63.74 in chips) 
Seat 4: monkeypokerdirt ($39.25 in chips) 
Seat 5: Jesterclown ($51.59 in chips) 
Seat 7: pudge.3096 ($50 in chips) 
Seat 8: Kasselbanki ($62.21 in chips) 
Seat 9: $ilentBob81 ($51.61 in chips) 
Kasselbanki: posts small blind $0.25
$ilentBob81: posts big blind $0.50
*** HOLE CARDS ***
I oguz han I: folds 
oudine2: folds 
GastonLeFort: folds 
monkeypokerdirt: raises $0.50 to $1
Jesterclown: folds 
pudge.3096: folds 
Kasselbanki: folds 
$ilentBob81: calls $0.50
*** FLOP *** [Ad Jd Ac]
$ilentBob81: checks 
monkeypokerdirt: bets $1.50
$ilentBob81: calls $1.50
*** TURN *** [Ad Jd Ac] [5h]
$ilentBob81: checks 
monkeypokerdirt: checks 
*** RIVER *** [Ad Jd Ac 5h] [3s]
$ilentBob81: bets $2
monkeypokerdirt: folds 
Uncalled bet ($2) returned to $ilentBob81
$ilentBob81 collected $4.99 from pot
$ilentBob81: doesn't show hand 
*** SUMMARY ***
Total pot $5.25 | Rake $0.26 
Board [Ad Jd Ac 5h 3s]
Seat 1: I oguz han I folded before Flop (didn't bet)
Seat 2: oudine2 folded before Flop (didn't bet)
Seat 3: GastonLeFort folded before Flop (didn't bet)
Seat 4: monkeypokerdirt folded on the River
Seat 5: Jesterclown folded before Flop (didn't bet)
Seat 7: pudge.3096 (button) folded before Flop (didn't bet)
Seat 8: Kasselbanki (small blind) folded before Flop
Seat 9: $ilentBob81 (big blind) collected ($4.99)



PokerStars Hand #228671847691:  Hold'em No Limit ($0.25/$0.50 USD) - 2021/07/30 22:42:07 ET
Table 'Laodamia II' 9-max Seat #8 is the button
Seat 1: I oguz han I ($46.17 in chips) 
Seat 2: oudine2 ($50.75 in chips) 
Seat 3: GastonLeFort ($63.74 in chips) 
Seat 4: monkeypokerdirt ($36.75 in chips) 
Seat 5: Jesterclown ($51.59 in chips) 
Seat 7: pudge.3096 ($50 in chips) 
Seat 8: Kasselbanki ($61.96 in chips) 
Seat 9: $ilentBob81 ($54.10 in chips) 
$ilentBob81: posts small blind $0.25
I oguz han I: posts big blind $0.50
*** HOLE CARDS ***
oudine2: folds 
GastonLeFort: folds 
monkeypokerdirt: folds 
Jesterclown: folds 
pudge.3096: folds 
Kasselbanki: raises $0.50 to $1
$ilentBob81: folds 
I oguz han I: raises $2.50 to $3.50
Kasselbanki: calls $2.50
*** FLOP *** [4c 3c 6h]
I oguz han I: bets $3
Kasselbanki: calls $3
*** TURN *** [4c 3c 6h] [2s]
I oguz han I: checks 
Kasselbanki: bets $6.30
I oguz han I: folds 
Uncalled bet ($6.30) returned to Kasselbanki
Kasselbanki collected $12.43 from pot
Kasselbanki: doesn't show hand 
*** SUMMARY ***
Total pot $13.25 | Rake $0.82 
Board [4c 3c 6h 2s]
Seat 1: I oguz han I (big blind) folded on the Turn
Seat 2: oudine2 folded before Flop (didn't bet)
Seat 3: GastonLeFort folded before Flop (didn't bet)
Seat 4: monkeypokerdirt folded before Flop (didn't bet)
Seat 5: Jesterclown folded before Flop (didn't bet)
Seat 7: pudge.3096 folded before Flop (didn't bet)
Seat 8: Kasselbanki (button) collected ($12.43)
Seat 9: $ilentBob81 (small blind) folded before Flop



PokerStars Hand #228671858997:  Hold'em No Limit ($0.25/$0.50 USD) - 2021/07/30 22:43:04 ET
Table 'Laodamia II' 9-max Seat #9 is the button
Seat 1: I oguz han I ($39.67 in chips) 
Seat 2: oudine2 ($50.75 in chips) 
Seat 3: GastonLeFort ($63.74 in chips) 
Seat 4: monkeypokerdirt ($36.75 in chips) 
Seat 5: Jesterclown ($51.59 in chips) 
Seat 7: pudge.3096 ($50 in chips) 
Seat 8: Kasselbanki ($67.89 in chips) 
Seat 9: $ilentBob81 ($53.85 in chips) 
I oguz han I: posts small blind $0.25
oudine2: posts big blind $0.50
*** HOLE CARDS ***
GastonLeFort: folds 
monkeypokerdirt: raises $1 to $1.50
Jesterclown: folds 
pudge.3096: folds 
Kasselbanki: folds 
$ilentBob81: calls $1.50
I oguz han I: folds 
oudine2: calls $1
*** FLOP *** [8h Ad 5s]
oudine2: checks 
monkeypokerdirt: bets $2.50
$ilentBob81: calls $2.50
oudine2: folds 
*** TURN *** [8h Ad 5s] [Ks]
monkeypokerdirt: bets $4.63
$ilentBob81: calls $4.63
*** RIVER *** [8h Ad 5s Ks] [9s]
monkeypokerdirt: checks 
$ilentBob81: bets $12
monkeypokerdirt: calls $12
*** SHOW DOWN ***
$ilentBob81: shows [8s Ts] (a flush, King high)
monkeypokerdirt: mucks hand 
$ilentBob81 collected $41.01 from pot
*** SUMMARY ***
Total pot $43.01 | Rake $2 
Board [8h Ad 5s Ks 9s]
Seat 1: I oguz han I (small blind) folded before Flop
Seat 2: oudine2 (big blind) folded on the Flop
Seat 3: GastonLeFort folded before Flop (didn't bet)
Seat 4: monkeypokerdirt mucked
Seat 5: Jesterclown folded before Flop (didn't bet)
Seat 7: pudge.3096 folded before Flop (didn't bet)
Seat 8: Kasselbanki folded before Flop (didn't bet)
Seat 9: $ilentBob81 (button) showed [8s Ts] and won ($41.01) with a flush, King high



PokerStars Hand #228671873972:  Hold'em No Limit ($0.25/$0.50 USD) - 2021/07/30 22:44:19 ET
Table 'Laodamia II' 9-max Seat #1 is the button
Seat 1: I oguz han I ($39.42 in chips) 
Seat 2: oudine2 ($50 in chips) 
Seat 3: GastonLeFort ($63.74 in chips) 
Seat 4: monkeypokerdirt ($16.12 in chips) 
Seat 5: Jesterclown ($51.59 in chips) 
Seat 7: pudge.3096 ($50 in chips) 
Seat 8: Kasselbanki ($67.89 in chips) 
Seat 9: $ilentBob81 ($74.23 in chips) 
oudine2: posts small blind $0.25
GastonLeFort: posts big blind $0.50
*** HOLE CARDS ***
monkeypokerdirt: folds 
Jesterclown: folds 
pudge.3096: folds 
Kasselbanki: folds 
$ilentBob81: raises $0.50 to $1
I oguz han I: folds 
oudine2: calls $0.75
GastonLeFort: calls $0.50
*** FLOP *** [Ks Qs Jd]
oudine2: checks 
GastonLeFort: checks 
$ilentBob81: checks 
*** TURN *** [Ks Qs Jd] [Td]
oudine2: checks 
GastonLeFort: checks 
$ilentBob81: bets $2.85
oudine2: folds 
GastonLeFort: raises $12.83 to $15.68
$ilentBob81: calls $12.83
*** RIVER *** [Ks Qs Jd Td] [Th]
GastonLeFort: bets $8.16
$ilentBob81: folds 
Uncalled bet ($8.16) returned to GastonLeFort
GastonLeFort collected $32.64 from pot
GastonLeFort: doesn't show hand 
*** SUMMARY ***
Total pot $34.36 | Rake $1.72 
Board [Ks Qs Jd Td Th]
Seat 1: I oguz han I (button) folded before Flop (didn't bet)
Seat 2: oudine2 (small blind) folded on the Turn
Seat 3: GastonLeFort (big blind) collected ($32.64)
Seat 4: monkeypokerdirt folded before Flop (didn't bet)
Seat 5: Jesterclown folded before Flop (didn't bet)
Seat 7: pudge.3096 folded before Flop (didn't bet)
Seat 8: Kasselbanki folded before Flop (didn't bet)
Seat 9: $ilentBob81 folded on the River



PokerStars Hand #228671891756:  Hold'em No Limit ($0.25/$0.50 USD) - 2021/07/30 22:45:50 ET
Table 'Laodamia II' 9-max Seat #2 is the button
Seat 1: I oguz han I ($39.42 in chips) 
Seat 2: oudine2 ($50 in chips) 
Seat 3: GastonLeFort ($79.70 in chips) 
Seat 4: monkeypokerdirt ($16.12 in chips) 
Seat 5: Jesterclown ($51.59 in chips) 
Seat 7: pudge.3096 ($50 in chips) 
Seat 8: Kasselbanki ($67.89 in chips) 
Seat 9: $ilentBob81 ($57.55 in chips) 
GastonLeFort: posts small blind $0.25
monkeypokerdirt: posts big blind $0.50
artemxxl: sits out 
*** HOLE CARDS ***
Jesterclown: folds 
pudge.3096: folds 
Kasselbanki: folds 
$ilentBob81: folds 
I oguz han I: raises $1 to $1.50
oudine2: folds 
GastonLeFort: folds 
monkeypokerdirt: calls $1
*** FLOP *** [Jh 7s 2c]
monkeypokerdirt: checks 
I oguz han I: bets $1.50
monkeypokerdirt: folds 
Uncalled bet ($1.50) returned to I oguz han I
I oguz han I collected $3.09 from pot
I oguz han I: doesn't show hand 
*** SUMMARY ***
Total pot $3.25 | Rake $0.16 
Board [Jh 7s 2c]
Seat 1: I oguz han I collected ($3.09)
Seat 2: oudine2 (button) folded before Flop (didn't bet)
Seat 3: GastonLeFort (small blind) folded before Flop
Seat 4: monkeypokerdirt (big blind) folded on the Flop
Seat 5: Jesterclown folded before Flop (didn't bet)
Seat 7: pudge.3096 folded before Flop (didn't bet)
Seat 8: Kasselbanki folded before Flop (didn't bet)
Seat 9: $ilentBob81 folded before Flop (didn't bet)



PokerStars Hand #228671899617:  Hold'em No Limit ($0.25/$0.50 USD) - 2021/07/30 22:46:31 ET
Table 'Laodamia II' 9-max Seat #3 is the button
Seat 1: I oguz han I ($41.01 in chips) 
Seat 2: oudine2 ($50 in chips) 
Seat 3: GastonLeFort ($79.45 in chips) 
Seat 4: monkeypokerdirt ($14.62 in chips) 
Seat 5: Jesterclown ($51.59 in chips) 
Seat 7: pudge.3096 ($50 in chips) 
Seat 8: Kasselbanki ($67.89 in chips) 
Seat 9: $ilentBob81 ($57.55 in chips) 
monkeypokerdirt: posts small blind $0.25
Jesterclown: posts big blind $0.50
artemxxl: sits out 
*** HOLE CARDS ***
pudge.3096: raises $0.75 to $1.25
Kasselbanki: folds 
$ilentBob81: folds 
I oguz han I: folds 
oudine2: folds 
GastonLeFort: folds 
monkeypokerdirt: folds 
Jesterclown: folds 
Uncalled bet ($0.75) returned to pudge.3096
pudge.3096 collected $1.25 from pot
pudge.3096: doesn't show hand 
*** SUMMARY ***
Total pot $1.25 | Rake $0 
Seat 1: I oguz han I folded before Flop (didn't bet)
Seat 2: oudine2 folded before Flop (didn't bet)
Seat 3: GastonLeFort (button) folded before Flop (didn't bet)
Seat 4: monkeypokerdirt (small blind) folded before Flop
Seat 5: Jesterclown (big blind) folded before Flop
Seat 7: pudge.3096 collected ($1.25)
Seat 8: Kasselbanki folded before Flop (didn't bet)
Seat 9: $ilentBob81 folded before Flop (didn't bet)



PokerStars Hand #228671905842:  Hold'em No Limit ($0.25/$0.50 USD) - 2021/07/30 22:47:02 ET
Table 'Laodamia II' 9-max Seat #4 is the button
Seat 1: I oguz han I ($41.01 in chips) 
Seat 2: oudine2 ($50 in chips) 
Seat 3: GastonLeFort ($79.45 in chips) 
Seat 4: monkeypokerdirt ($14.37 in chips) 
Seat 5: Jesterclown ($51.09 in chips) 
Seat 6: artemxxl ($50 in chips) 
Seat 7: pudge.3096 ($50.75 in chips) 
Seat 8: Kasselbanki ($67.89 in chips) 
Seat 9: $ilentBob81 ($57.55 in chips) 
Jesterclown: posts small blind $0.25
artemxxl: posts big blind $0.50
*** HOLE CARDS ***
pudge.3096: folds 
Kasselbanki: folds 
$ilentBob81: folds 
I oguz han I: folds 
oudine2: folds 
GastonLeFort: folds 
monkeypokerdirt: folds 
Jesterclown: folds 
Uncalled bet ($0.25) returned to artemxxl
artemxxl collected $0.50 from pot
*** SUMMARY ***
Total pot $0.50 | Rake $0 
Seat 1: I oguz han I folded before Flop (didn't bet)
Seat 2: oudine2 folded before Flop (didn't bet)
Seat 3: GastonLeFort folded before Flop (didn't bet)
Seat 4: monkeypokerdirt (button) folded before Flop (didn't bet)
Seat 5: Jesterclown (small blind) folded before Flop
Seat 6: artemxxl (big blind) collected ($0.50)
Seat 7: pudge.3096 folded before Flop (didn't bet)
Seat 8: Kasselbanki folded before Flop (didn't bet)
Seat 9: $ilentBob81 folded before Flop (didn't bet)



PokerStars Hand #228671909157:  Hold'em No Limit ($0.25/$0.50 USD) - 2021/07/30 22:47:19 ET
Table 'Laodamia II' 9-max Seat #5 is the button
Seat 1: I oguz han I ($41.01 in chips) 
Seat 2: oudine2 ($50 in chips) 
Seat 3: GastonLeFort ($79.45 in chips) 
Seat 4: monkeypokerdirt ($14.37 in chips) 
Seat 5: Jesterclown ($50.84 in chips) 
Seat 6: artemxxl ($50.25 in chips) 
Seat 7: pudge.3096 ($50.75 in chips) 
Seat 8: Kasselbanki ($67.89 in chips) 
Seat 9: $ilentBob81 ($57.55 in chips) 
artemxxl: posts small blind $0.25
pudge.3096: posts big blind $0.50
*** HOLE CARDS ***
Kasselbanki: folds 
$ilentBob81: folds 
I oguz han I: folds 
oudine2: folds 
GastonLeFort: folds 
monkeypokerdirt: raises $1 to $1.50
Jesterclown: folds 
artemxxl: raises $3.50 to $5
pudge.3096: folds 
monkeypokerdirt: raises $9.37 to $14.37 and is all-in
artemxxl: calls $9.37
*** FLOP *** [2d Td Jh]
*** TURN *** [2d Td Jh] [3d]
*** RIVER *** [2d Td Jh 3d] [6c]
*** SHOW DOWN ***
artemxxl: shows [As Ac] (a pair of Aces)
monkeypokerdirt: shows [8d Qd] (a flush, Queen high)
monkeypokerdirt collected $27.78 from pot
*** SUMMARY ***
Total pot $29.24 | Rake $1.46 
Board [2d Td Jh 3d 6c]
Seat 1: I oguz han I folded before Flop (didn't bet)
Seat 2: oudine2 folded before Flop (didn't bet)
Seat 3: GastonLeFort folded before Flop (didn't bet)
Seat 4: monkeypokerdirt showed [8d Qd] and won ($27.78) with a flush, Queen high
Seat 5: Jesterclown (button) folded before Flop (didn't bet)
Seat 6: artemxxl (small blind) showed [As Ac] and lost with a pair of Aces
Seat 7: pudge.3096 (big blind) folded before Flop
Seat 8: Kasselbanki folded before Flop (didn't bet)
Seat 9: $ilentBob81 folded before Flop (didn't bet)



PokerStars Hand #228671921169:  Hold'em No Limit ($0.25/$0.50 USD) - 2021/07/30 22:48:04 ET
Table 'Laodamia II' 9-max Seat #6 is the button
Seat 1: I oguz han I ($41.01 in chips) 
Seat 2: oudine2 ($50 in chips) 
Seat 3: GastonLeFort ($79.45 in chips) 
Seat 4: monkeypokerdirt ($27.78 in chips) 
Seat 5: Jesterclown ($50.84 in chips) 
Seat 6: artemxxl ($50 in chips) 
Seat 7: pudge.3096 ($50.25 in chips) 
Seat 8: Kasselbanki ($67.89 in chips) 
Seat 9: $ilentBob81 ($57.55 in chips) 
pudge.3096: posts small blind $0.25
Kasselbanki: posts big blind $0.50
*** HOLE CARDS ***
$ilentBob81: raises $1 to $1.50
I oguz han I: folds 
oudine2: folds 
GastonLeFort: folds 
GastonLeFort leaves the table
monkeypokerdirt: folds 
Jesterclown: folds 
artemxxl: folds 
pudge.3096: folds 
Kasselbanki: raises $2 to $3.50
$ilentBob81: calls $2
*** FLOP *** [Qc Td 5c]
Kasselbanki: bets $3.50
$ilentBob81: folds 
Uncalled bet ($3.50) returned to Kasselbanki
Kasselbanki collected $6.80 from pot
Kasselbanki: doesn't show hand 
*** SUMMARY ***
Total pot $7.25 | Rake $0.45 
Board [Qc Td 5c]
Seat 1: I oguz han I folded before Flop (didn't bet)
Seat 2: oudine2 folded before Flop (didn't bet)
Seat 3: GastonLeFort folded before Flop (didn't bet)
Seat 4: monkeypokerdirt folded before Flop (didn't bet)
Seat 5: Jesterclown folded before Flop (didn't bet)
Seat 6: artemxxl (button) folded before Flop (didn't bet)
Seat 7: pudge.3096 (small blind) folded before Flop
Seat 8: Kasselbanki (big blind) collected ($6.80)
Seat 9: $ilentBob81 folded on the Flop



PokerStars Hand #228671930193:  Hold'em No Limit ($0.25/$0.50 USD) - 2021/07/30 22:48:51 ET
Table 'Laodamia II' 9-max Seat #7 is the button
Seat 1: I oguz han I ($41.01 in chips) 
Seat 2: oudine2 ($50 in chips) 
Seat 4: monkeypokerdirt ($27.78 in chips) 
Seat 5: Jesterclown ($50.84 in chips) 
Seat 6: artemxxl ($50 in chips) 
Seat 7: pudge.3096 ($50 in chips) 
Seat 8: Kasselbanki ($71.19 in chips) 
Seat 9: $ilentBob81 ($54.05 in chips) 
Kasselbanki: posts small blind $0.25
$ilentBob81: posts big blind $0.50
*** HOLE CARDS ***
6l4ck joins the table at seat #3 
I oguz han I: folds 
oudine2: folds 
monkeypokerdirt: raises $1.25 to $1.75
Jesterclown: folds 
artemxxl: raises $4 to $5.75
pudge.3096: folds 
Kasselbanki: folds 
$ilentBob81: folds 
monkeypokerdirt: folds 
Uncalled bet ($4) returned to artemxxl
artemxxl collected $4.25 from pot
*** SUMMARY ***
Total pot $4.25 | Rake $0 
Seat 1: I oguz han I folded before Flop (didn't bet)
Seat 2: oudine2 folded before Flop (didn't bet)
Seat 4: monkeypokerdirt folded before Flop
Seat 5: Jesterclown folded before Flop (didn't bet)
Seat 6: artemxxl collected ($4.25)
Seat 7: pudge.3096 (button) folded before Flop (didn't bet)
Seat 8: Kasselbanki (small blind) folded before Flop
Seat 9: $ilentBob81 (big blind) folded before Flop



PokerStars Hand #228671936851:  Hold'em No Limit ($0.25/$0.50 USD) - 2021/07/30 22:49:25 ET
Table 'Laodamia II' 9-max Seat #8 is the button
Seat 1: I oguz han I ($41.01 in chips) 
Seat 2: oudine2 ($50 in chips) 
Seat 4: monkeypokerdirt ($26.03 in chips) 
Seat 5: Jesterclown ($50.84 in chips) 
Seat 6: artemxxl ($52.50 in chips) 
Seat 7: pudge.3096 ($50 in chips) 
Seat 8: Kasselbanki ($70.94 in chips) 
Seat 9: $ilentBob81 ($53.55 in chips) 
$ilentBob81: posts small blind $0.25
I oguz han I: posts big blind $0.50
6l4ck: sits out 
*** HOLE CARDS ***
oudine2: folds 
monkeypokerdirt: folds 
Jesterclown: raises $1 to $1.50
artemxxl: calls $1.50
pudge.3096: folds 
Kasselbanki: folds 
$ilentBob81: folds 
I oguz han I: folds 
*** FLOP *** [6c 2c 3c]
Jesterclown: checks 
artemxxl: bets $2.35
Jesterclown: raises $4.65 to $7
artemxxl: calls $4.65
*** TURN *** [6c 2c 3c] [4h]
Jesterclown: checks 
artemxxl: checks 
*** RIVER *** [6c 2c 3c 4h] [7d]
Jesterclown: checks 
artemxxl: checks 
*** SHOW DOWN ***
Jesterclown: shows [Ts 9s] (high card Ten)
artemxxl: shows [Qc Qh] (a pair of Queens)
artemxxl collected $16.86 from pot
*** SUMMARY ***
Total pot $17.75 | Rake $0.89 
Board [6c 2c 3c 4h 7d]
Seat 1: I oguz han I (big blind) folded before Flop
Seat 2: oudine2 folded before Flop (didn't bet)
Seat 4: monkeypokerdirt folded before Flop (didn't bet)
Seat 5: Jesterclown showed [Ts 9s] and lost with high card Ten
Seat 6: artemxxl showed [Qc Qh] and won ($16.86) with a pair of Queens
Seat 7: pudge.3096 folded before Flop (didn't bet)
Seat 8: Kasselbanki (button) folded before Flop (didn't bet)
Seat 9: $ilentBob81 (small blind) folded before Flop



PokerStars Hand #228671950211:  Hold'em No Limit ($0.25/$0.50 USD) - 2021/07/30 22:50:35 ET
Table 'Laodamia II' 9-max Seat #9 is the button
Seat 1: I oguz han I ($40.51 in chips) 
Seat 3: 6l4ck ($97.55 in chips) 
Seat 4: monkeypokerdirt ($26.03 in chips) 
Seat 5: Jesterclown ($50 in chips) 
Seat 6: artemxxl ($60.86 in chips) 
Seat 7: pudge.3096 ($50 in chips) 
Seat 8: Kasselbanki ($70.94 in chips) 
Seat 9: $ilentBob81 ($53.30 in chips) 
I oguz han I: posts small blind $0.25
oudine2: is sitting out 
6l4ck: posts big blind $0.50
*** HOLE CARDS ***
oudine2 leaves the table
monkeypokerdirt: folds 
Jesterclown: folds 
artemxxl: folds 
pudge.3096: folds 
Kasselbanki: folds 
$ilentBob81: raises $0.50 to $1
I oguz han I: folds 
6l4ck: calls $0.50
*** FLOP *** [Jd 6d 4d]
xobit26 joins the table at seat #2 
6l4ck: checks 
$ilentBob81: checks 
*** TURN *** [Jd 6d 4d] [7s]
6l4ck: bets $2.50
$ilentBob81: calls $2.50
*** RIVER *** [Jd 6d 4d 7s] [Jc]
6l4ck: checks 
$ilentBob81: checks 
*** SHOW DOWN ***
6l4ck: shows [8s Kd] (a pair of Jacks)
$ilentBob81: mucks hand 
6l4ck collected $6.89 from pot
*** SUMMARY ***
Total pot $7.25 | Rake $0.36 
Board [Jd 6d 4d 7s Jc]
Seat 1: I oguz han I (small blind) folded before Flop
Seat 3: 6l4ck (big blind) showed [8s Kd] and won ($6.89) with a pair of Jacks
Seat 4: monkeypokerdirt folded before Flop (didn't bet)
Seat 5: Jesterclown folded before Flop (didn't bet)
Seat 6: artemxxl folded before Flop (didn't bet)
Seat 7: pudge.3096 folded before Flop (didn't bet)
Seat 8: Kasselbanki folded before Flop (didn't bet)
Seat 9: $ilentBob81 (button) mucked



PokerStars Hand #228671969647:  Hold'em No Limit ($0.25/$0.50 USD) - 2021/07/30 22:51:39 ET
Table 'Laodamia II' 9-max Seat #1 is the button
Seat 1: I oguz han I ($40.26 in chips) 
Seat 3: 6l4ck ($100.94 in chips) 
Seat 4: monkeypokerdirt ($26.03 in chips) 
Seat 5: Jesterclown ($50 in chips) 
Seat 6: artemxxl ($60.86 in chips) 
Seat 7: pudge.3096 ($50 in chips) 
Seat 8: Kasselbanki ($70.94 in chips) 
Seat 9: $ilentBob81 ($49.80 in chips) 
6l4ck: posts small blind $0.25
monkeypokerdirt: posts big blind $0.50
*** HOLE CARDS ***
Jesterclown: folds 
artemxxl: folds 
pudge.3096: folds 
Kasselbanki: folds 
$ilentBob81: folds 
I oguz han I: folds 
6l4ck: raises $1 to $1.50
monkeypokerdirt: calls $1
*** FLOP *** [3h 8h 8d]
6l4ck: checks 
monkeypokerdirt: bets $1.50
6l4ck: calls $1.50
*** TURN *** [3h 8h 8d] [9c]
6l4ck: checks 
monkeypokerdirt: checks 
*** RIVER *** [3h 8h 8d 9c] [Js]
6l4ck: checks 
monkeypokerdirt: checks 
*** SHOW DOWN ***
6l4ck: shows [As 7d] (a pair of Eights)
monkeypokerdirt: shows [Kc 3c] (two pair, Eights and Threes)
monkeypokerdirt collected $5.70 from pot
*** SUMMARY ***
Total pot $6 | Rake $0.30 
Board [3h 8h 8d 9c Js]
Seat 1: I oguz han I (button) folded before Flop (didn't bet)
Seat 3: 6l4ck (small blind) showed [As 7d] and lost with a pair of Eights
Seat 4: monkeypokerdirt (big blind) showed [Kc 3c] and won ($5.70) with two pair, Eights and Threes
Seat 5: Jesterclown folded before Flop (didn't bet)
Seat 6: artemxxl folded before Flop (didn't bet)
Seat 7: pudge.3096 folded before Flop (didn't bet)
Seat 8: Kasselbanki folded before Flop (didn't bet)
Seat 9: $ilentBob81 folded before Flop (didn't bet)



PokerStars Hand #228671982913:  Hold'em No Limit ($0.25/$0.50 USD) - 2021/07/30 22:52:47 ET
Table 'Laodamia II' 9-max Seat #3 is the button
Seat 1: I oguz han I ($40.26 in chips) 
Seat 3: 6l4ck ($97.94 in chips) 
Seat 4: monkeypokerdirt ($28.73 in chips) 
Seat 5: Jesterclown ($50 in chips) 
Seat 6: artemxxl ($60.86 in chips) 
Seat 7: pudge.3096 ($50 in chips) 
Seat 8: Kasselbanki ($70.94 in chips) 
Seat 9: $ilentBob81 ($49.80 in chips) 
monkeypokerdirt: posts small blind $0.25
Jesterclown: posts big blind $0.50
xobit26: sits out 
*** HOLE CARDS ***
artemxxl: folds 
pudge.3096: folds 
Kasselbanki: folds 
$ilentBob81: folds 
I oguz han I: raises $1 to $1.50
6l4ck: folds 
monkeypokerdirt: folds 
Jesterclown: calls $1
*** FLOP *** [Kd 3c 5s]
Jesterclown: checks 
I oguz han I: bets $1.50
Jesterclown: folds 
Uncalled bet ($1.50) returned to I oguz han I
I oguz han I collected $3.09 from pot
I oguz han I: doesn't show hand 
*** SUMMARY ***
Total pot $3.25 | Rake $0.16 
Board [Kd 3c 5s]
Seat 1: I oguz han I collected ($3.09)
Seat 3: 6l4ck (button) folded before Flop (didn't bet)
Seat 4: monkeypokerdirt (small blind) folded before Flop
Seat 5: Jesterclown (big blind) folded on the Flop
Seat 6: artemxxl folded before Flop (didn't bet)
Seat 7: pudge.3096 folded before Flop (didn't bet)
Seat 8: Kasselbanki folded before Flop (didn't bet)
Seat 9: $ilentBob81 folded before Flop (didn't bet)



PokerStars Hand #228671988680:  Hold'em No Limit ($0.25/$0.50 USD) - 2021/07/30 22:53:16 ET
Table 'Laodamia II' 9-max Seat #4 is the button
Seat 1: I oguz han I ($41.85 in chips) 
Seat 3: 6l4ck ($97.94 in chips) 
Seat 4: monkeypokerdirt ($28.48 in chips) 
Seat 5: Jesterclown ($50 in chips) 
Seat 6: artemxxl ($60.86 in chips) 
Seat 7: pudge.3096 ($50 in chips) 
Seat 8: Kasselbanki ($70.94 in chips) 
Seat 9: $ilentBob81 ($49.80 in chips) 
Jesterclown: posts small blind $0.25
artemxxl: posts big blind $0.50
xobit26: sits out 
*** HOLE CARDS ***
pudge.3096: folds 
Kasselbanki: raises $1 to $1.50
$ilentBob81: folds 
I oguz han I: folds 
6l4ck: folds 
monkeypokerdirt: folds 
Jesterclown: folds 
artemxxl: folds 
Uncalled bet ($1) returned to Kasselbanki
Kasselbanki collected $1.25 from pot
Kasselbanki: doesn't show hand 
*** SUMMARY ***
Total pot $1.25 | Rake $0 
Seat 1: I oguz han I folded before Flop (didn't bet)
Seat 3: 6l4ck folded before Flop (didn't bet)
Seat 4: monkeypokerdirt (button) folded before Flop (didn't bet)
Seat 5: Jesterclown (small blind) folded before Flop
Seat 6: artemxxl (big blind) folded before Flop
Seat 7: pudge.3096 folded before Flop (didn't bet)
Seat 8: Kasselbanki collected ($1.25)
Seat 9: $ilentBob81 folded before Flop (didn't bet)



PokerStars Hand #228671991639:  Hold'em No Limit ($0.25/$0.50 USD) - 2021/07/30 22:53:31 ET
Table 'Laodamia II' 9-max Seat #5 is the button
Seat 1: I oguz han I ($41.85 in chips) 
Seat 3: 6l4ck ($97.94 in chips) 
Seat 4: monkeypokerdirt ($28.48 in chips) 
Seat 5: Jesterclown ($50 in chips) 
Seat 6: artemxxl ($60.36 in chips) 
Seat 7: pudge.3096 ($50 in chips) 
Seat 8: Kasselbanki ($71.69 in chips) 
Seat 9: $ilentBob81 ($49.80 in chips) 
artemxxl: posts small blind $0.25
pudge.3096: posts big blind $0.50
xobit26: sits out 
*** HOLE CARDS ***
Kasselbanki: folds 
$ilentBob81: folds 
I oguz han I: raises $1 to $1.50
6l4ck: folds 
monkeypokerdirt: folds 
Jesterclown: folds 
artemxxl: folds 
pudge.3096: folds 
Uncalled bet ($1) returned to I oguz han I
I oguz han I collected $1.25 from pot
I oguz han I: doesn't show hand 
*** SUMMARY ***
Total pot $1.25 | Rake $0 
Seat 1: I oguz han I collected ($1.25)
Seat 3: 6l4ck folded before Flop (didn't bet)
Seat 4: monkeypokerdirt folded before Flop (didn't bet)
Seat 5: Jesterclown (button) folded before Flop (didn't bet)
Seat 6: artemxxl (small blind) folded before Flop
Seat 7: pudge.3096 (big blind) folded before Flop
Seat 8: Kasselbanki folded before Flop (didn't bet)
Seat 9: $ilentBob81 folded before Flop (didn't bet)



PokerStars Hand #228671995958:  Hold'em No Limit ($0.25/$0.50 USD) - 2021/07/30 22:53:54 ET
Table 'Laodamia II' 9-max Seat #6 is the button
Seat 1: I oguz han I ($42.60 in chips) 
Seat 3: 6l4ck ($97.94 in chips) 
Seat 4: monkeypokerdirt ($28.48 in chips) 
Seat 5: Jesterclown ($50 in chips) 
Seat 6: artemxxl ($60.11 in chips) 
Seat 7: pudge.3096 ($50 in chips) 
Seat 8: Kasselbanki ($71.69 in chips) 
Seat 9: $ilentBob81 ($49.80 in chips) 
pudge.3096: posts small blind $0.25
Kasselbanki: posts big blind $0.50
xobit26: sits out 
*** HOLE CARDS ***
$ilentBob81: folds 
I oguz han I: folds 
6l4ck: raises $1 to $1.50
monkeypokerdirt: calls $1.50
Jesterclown: folds 
artemxxl: folds 
pudge.3096: folds 
Kasselbanki: folds 
*** FLOP *** [2d Ac 8c]
6l4ck: checks 
monkeypokerdirt: bets $1.78
6l4ck: folds 
Uncalled bet ($1.78) returned to monkeypokerdirt
monkeypokerdirt collected $3.56 from pot
*** SUMMARY ***
Total pot $3.75 | Rake $0.19 
Board [2d Ac 8c]
Seat 1: I oguz han I folded before Flop (didn't bet)
Seat 3: 6l4ck folded on the Flop
Seat 4: monkeypokerdirt collected ($3.56)
Seat 5: Jesterclown folded before Flop (didn't bet)
Seat 6: artemxxl (button) folded before Flop (didn't bet)
Seat 7: pudge.3096 (small blind) folded before Flop
Seat 8: Kasselbanki (big blind) folded before Flop
Seat 9: $ilentBob81 folded before Flop (didn't bet)



PokerStars Hand #228672007397:  Hold'em No Limit ($0.25/$0.50 USD) - 2021/07/30 22:54:53 ET
Table 'Laodamia II' 9-max Seat #7 is the button
Seat 1: I oguz han I ($42.60 in chips) 
Seat 3: 6l4ck ($96.44 in chips) 
Seat 4: monkeypokerdirt ($30.54 in chips) 
Seat 5: Jesterclown ($50 in chips) 
Seat 6: artemxxl ($60.11 in chips) 
Seat 7: pudge.3096 ($50 in chips) 
Seat 8: Kasselbanki ($71.19 in chips) 
Seat 9: $ilentBob81 ($49.80 in chips) 
Kasselbanki: posts small blind $0.25
$ilentBob81: posts big blind $0.50
xobit26: sits out 
*** HOLE CARDS ***
I oguz han I: folds 
6l4ck: folds 
monkeypokerdirt: calls $0.50
Jesterclown: folds 
artemxxl: folds 
pudge.3096: folds 
Kasselbanki: folds 
$ilentBob81: checks 
*** FLOP *** [Ts Tc Ks]
$ilentBob81: checks 
monkeypokerdirt: bets $0.60
$ilentBob81: folds 
Uncalled bet ($0.60) returned to monkeypokerdirt
monkeypokerdirt collected $1.19 from pot
*** SUMMARY ***
Total pot $1.25 | Rake $0.06 
Board [Ts Tc Ks]
Seat 1: I oguz han I folded before Flop (didn't bet)
Seat 3: 6l4ck folded before Flop (didn't bet)
Seat 4: monkeypokerdirt collected ($1.19)
Seat 5: Jesterclown folded before Flop (didn't bet)
Seat 6: artemxxl folded before Flop (didn't bet)
Seat 7: pudge.3096 (button) folded before Flop (didn't bet)
Seat 8: Kasselbanki (small blind) folded before Flop
Seat 9: $ilentBob81 (big blind) folded on the Flop



PokerStars Hand #228672012882:  Hold'em No Limit ($0.25/$0.50 USD) - 2021/07/30 22:55:25 ET
Table 'Laodamia II' 9-max Seat #8 is the button
Seat 1: I oguz han I ($42.60 in chips) 
Seat 2: xobit26 ($50 in chips) 
Seat 3: 6l4ck ($96.44 in chips) 
Seat 4: monkeypokerdirt ($31.23 in chips) 
Seat 5: Jesterclown ($50 in chips) 
Seat 6: artemxxl ($60.11 in chips) 
Seat 7: pudge.3096 ($50 in chips) 
Seat 8: Kasselbanki ($70.94 in chips) 
I oguz han I: posts small blind $0.25
xobit26: posts big blind $0.50
*** HOLE CARDS ***
6l4ck: folds 
monkeypokerdirt: folds 
Jesterclown: folds 
artemxxl: folds 
pudge.3096: raises $0.75 to $1.25
Kasselbanki: folds 
I oguz han I: folds 
xobit26: folds 
Uncalled bet ($0.75) returned to pudge.3096
pudge.3096 collected $1.25 from pot
pudge.3096: doesn't show hand 
*** SUMMARY ***
Total pot $1.25 | Rake $0 
Seat 1: I oguz han I (small blind) folded before Flop
Seat 2: xobit26 (big blind) folded before Flop
Seat 3: 6l4ck folded before Flop (didn't bet)
Seat 4: monkeypokerdirt folded before Flop (didn't bet)
Seat 5: Jesterclown folded before Flop (didn't bet)
Seat 6: artemxxl folded before Flop (didn't bet)
Seat 7: pudge.3096 collected ($1.25)
Seat 8: Kasselbanki (button) folded before Flop (didn't bet)



PokerStars Hand #228672016204:  Hold'em No Limit ($0.25/$0.50 USD) - 2021/07/30 22:55:46 ET
Table 'Laodamia II' 9-max Seat #1 is the button
Seat 1: I oguz han I ($42.35 in chips) 
Seat 2: xobit26 ($50 in chips) 
Seat 3: 6l4ck ($96.44 in chips) 
Seat 4: monkeypokerdirt ($31.23 in chips) 
Seat 5: Jesterclown ($50 in chips) 
Seat 6: artemxxl ($60.11 in chips) 
Seat 7: pudge.3096 ($50.75 in chips) 
Seat 8: Kasselbanki ($70.94 in chips) 
xobit26: posts small blind $0.25
6l4ck: posts big blind $0.50
*** HOLE CARDS ***
monkeypokerdirt: folds 
Jesterclown: folds 
artemxxl: folds 
pudge.3096: folds 
Kasselbanki: raises $0.50 to $1
I oguz han I: folds 
xobit26: raises $3 to $4
6l4ck: folds 
Kasselbanki: calls $3
*** FLOP *** [Qh 3h 4c]
xobit26: checks 
Kasselbanki: bets $1.50
xobit26: folds 
Uncalled bet ($1.50) returned to Kasselbanki
Kasselbanki collected $7.98 from pot
Kasselbanki: doesn't show hand 
*** SUMMARY ***
Total pot $8.50 | Rake $0.52 
Board [Qh 3h 4c]
Seat 1: I oguz han I (button) folded before Flop (didn't bet)
Seat 2: xobit26 (small blind) folded on the Flop
Seat 3: 6l4ck (big blind) folded before Flop
Seat 4: monkeypokerdirt folded before Flop (didn't bet)
Seat 5: Jesterclown folded before Flop (didn't bet)
Seat 6: artemxxl folded before Flop (didn't bet)
Seat 7: pudge.3096 folded before Flop (didn't bet)
Seat 8: Kasselbanki collected ($7.98)



PokerStars Hand #228672022578:  Hold'em No Limit ($0.25/$0.50 USD) - 2021/07/30 22:56:21 ET
Table 'Laodamia II' 9-max Seat #2 is the button
Seat 1: I oguz han I ($42.35 in chips) 
Seat 2: xobit26 ($50 in chips) 
Seat 3: 6l4ck ($95.94 in chips) 
Seat 4: monkeypokerdirt ($31.23 in chips) 
Seat 5: Jesterclown ($50 in chips) 
Seat 6: artemxxl ($60.11 in chips) 
Seat 7: pudge.3096 ($50.75 in chips) 
Seat 8: Kasselbanki ($74.92 in chips) 
6l4ck: posts small blind $0.25
monkeypokerdirt: posts big blind $0.50
*** HOLE CARDS ***
Jesterclown: folds 
artemxxl: folds 
pudge.3096: folds 
Kasselbanki: folds 
I oguz han I: folds 
xobit26: raises $0.75 to $1.25
6l4ck: folds 
monkeypokerdirt: calls $0.75
*** FLOP *** [4h Ts 9s]
monkeypokerdirt: checks 
xobit26: checks 
*** TURN *** [4h Ts 9s] [3h]
monkeypokerdirt: checks 
xobit26: checks 
*** RIVER *** [4h Ts 9s 3h] [Ad]
monkeypokerdirt: checks 
xobit26: bets $1.96
monkeypokerdirt: folds 
Uncalled bet ($1.96) returned to xobit26
xobit26 collected $2.61 from pot
xobit26: doesn't show hand 
*** SUMMARY ***
Total pot $2.75 | Rake $0.14 
Board [4h Ts 9s 3h Ad]
Seat 1: I oguz han I folded before Flop (didn't bet)
Seat 2: xobit26 (button) collected ($2.61)
Seat 3: 6l4ck (small blind) folded before Flop
Seat 4: monkeypokerdirt (big blind) folded on the River
Seat 5: Jesterclown folded before Flop (didn't bet)
Seat 6: artemxxl folded before Flop (didn't bet)
Seat 7: pudge.3096 folded before Flop (didn't bet)
Seat 8: Kasselbanki folded before Flop (didn't bet)



PokerStars Hand #228672033357:  Hold'em No Limit ($0.25/$0.50 USD) - 2021/07/30 22:57:28 ET
Table 'Laodamia II' 9-max Seat #3 is the button
Seat 1: I oguz han I ($42.35 in chips) 
Seat 2: xobit26 ($51.36 in chips) 
Seat 3: 6l4ck ($95.69 in chips) 
Seat 4: monkeypokerdirt ($29.98 in chips) 
Seat 5: Jesterclown ($50 in chips) 
Seat 6: artemxxl ($60.11 in chips) 
Seat 7: pudge.3096 ($50.75 in chips) 
Seat 8: Kasselbanki ($74.92 in chips) 
monkeypokerdirt: posts small blind $0.25
Jesterclown: posts big blind $0.50
$ilentBob81: sits out 
*** HOLE CARDS ***
artemxxl: folds 
pudge.3096: folds 
Kasselbanki: raises $0.50 to $1
I oguz han I: calls $1
xobit26: folds 
6l4ck: folds 
monkeypokerdirt: folds 
Jesterclown: folds 
*** FLOP *** [4h Kd 6s]
Kasselbanki: checks 
I oguz han I: bets $1.44
Kasselbanki: calls $1.44
*** TURN *** [4h Kd 6s] [4s]
Kasselbanki: checks 
I oguz han I: bets $2.94
Kasselbanki: calls $2.94
*** RIVER *** [4h Kd 6s 4s] [6d]
Kasselbanki: checks 
I oguz han I: checks 
*** SHOW DOWN ***
Kasselbanki: shows [Qs Ks] (two pair, Kings and Sixes)
I oguz han I: mucks hand 
Kasselbanki collected $10.79 from pot
*** SUMMARY ***
Total pot $11.51 | Rake $0.72 
Board [4h Kd 6s 4s 6d]
Seat 1: I oguz han I mucked
Seat 2: xobit26 folded before Flop (didn't bet)
Seat 3: 6l4ck (button) folded before Flop (didn't bet)
Seat 4: monkeypokerdirt (small blind) folded before Flop
Seat 5: Jesterclown (big blind) folded before Flop
Seat 6: artemxxl folded before Flop (didn't bet)
Seat 7: pudge.3096 folded before Flop (didn't bet)
Seat 8: Kasselbanki showed [Qs Ks] and won ($10.79) with two pair, Kings and Sixes



PokerStars Hand #228672051093:  Hold'em No Limit ($0.25/$0.50 USD) - 2021/07/30 22:58:29 ET
Table 'Laodamia II' 9-max Seat #4 is the button
Seat 1: I oguz han I ($36.97 in chips) 
Seat 2: xobit26 ($51.36 in chips) 
Seat 3: 6l4ck ($95.69 in chips) 
Seat 4: monkeypokerdirt ($29.73 in chips) 
Seat 5: Jesterclown ($50 in chips) 
Seat 6: artemxxl ($60.11 in chips) 
Seat 7: pudge.3096 ($50.75 in chips) 
Seat 8: Kasselbanki ($80.33 in chips) 
Jesterclown: posts small blind $0.25
artemxxl: posts big blind $0.50
$ilentBob81: sits out 
*** HOLE CARDS ***
pudge.3096: folds 
Kasselbanki: folds 
I oguz han I: folds 
xobit26: raises $0.75 to $1.25
6l4ck: folds 
monkeypokerdirt: folds 
Jesterclown: raises $3.25 to $4.50
artemxxl: folds 
xobit26: folds 
Uncalled bet ($3.25) returned to Jesterclown
Jesterclown collected $3 from pot
Jesterclown: doesn't show hand 
*** SUMMARY ***
Total pot $3 | Rake $0 
Seat 1: I oguz han I folded before Flop (didn't bet)
Seat 2: xobit26 folded before Flop
Seat 3: 6l4ck folded before Flop (didn't bet)
Seat 4: monkeypokerdirt (button) folded before Flop (didn't bet)
Seat 5: Jesterclown (small blind) collected ($3)
Seat 6: artemxxl (big blind) folded before Flop
Seat 7: pudge.3096 folded before Flop (didn't bet)
Seat 8: Kasselbanki folded before Flop (didn't bet)



PokerStars Hand #228672058144:  Hold'em No Limit ($0.25/$0.50 USD) - 2021/07/30 22:59:14 ET
Table 'Laodamia II' 9-max Seat #5 is the button
Seat 1: I oguz han I ($36.97 in chips) 
Seat 2: xobit26 ($50.11 in chips) 
Seat 3: 6l4ck ($95.69 in chips) 
Seat 4: monkeypokerdirt ($29.73 in chips) 
Seat 5: Jesterclown ($51.75 in chips) 
Seat 6: artemxxl ($59.61 in chips) 
Seat 7: pudge.3096 ($50.75 in chips) 
Seat 8: Kasselbanki ($80.33 in chips) 
artemxxl: posts small blind $0.25
pudge.3096: posts big blind $0.50
$ilentBob81: sits out 
*** HOLE CARDS ***
Kasselbanki: folds 
I oguz han I: folds 
xobit26: folds 
6l4ck: raises $1 to $1.50
monkeypokerdirt: raises $3.75 to $5.25
Jesterclown: folds 
artemxxl: folds 
pudge.3096: folds 
6l4ck: folds 
Uncalled bet ($3.75) returned to monkeypokerdirt
monkeypokerdirt collected $3.75 from pot
*** SUMMARY ***
Total pot $3.75 | Rake $0 
Seat 1: I oguz han I folded before Flop (didn't bet)
Seat 2: xobit26 folded before Flop (didn't bet)
Seat 3: 6l4ck folded before Flop
Seat 4: monkeypokerdirt collected ($3.75)
Seat 5: Jesterclown (button) folded before Flop (didn't bet)
Seat 6: artemxxl (small blind) folded before Flop
Seat 7: pudge.3096 (big blind) folded before Flop
Seat 8: Kasselbanki folded before Flop (didn't bet)



PokerStars Hand #228672062779:  Hold'em No Limit ($0.25/$0.50 USD) - 2021/07/30 22:59:43 ET
Table 'Laodamia II' 9-max Seat #6 is the button
Seat 1: I oguz han I ($36.97 in chips) 
Seat 2: xobit26 ($50.11 in chips) 
Seat 3: 6l4ck ($94.19 in chips) 
Seat 4: monkeypokerdirt ($31.98 in chips) 
Seat 5: Jesterclown ($51.75 in chips) 
Seat 6: artemxxl ($59.36 in chips) 
Seat 7: pudge.3096 ($50.25 in chips) 
Seat 8: Kasselbanki ($80.33 in chips) 
pudge.3096: posts small blind $0.25
Kasselbanki: posts big blind $0.50
$ilentBob81: sits out 
*** HOLE CARDS ***
I oguz han I: folds 
xobit26: folds 
6l4ck: raises $1 to $1.50
monkeypokerdirt: calls $1.50
Jesterclown: folds 
artemxxl: folds 
pudge.3096: folds 
Kasselbanki: calls $1
*** FLOP *** [7d 2h Jd]
Kasselbanki: checks 
6l4ck: checks 
monkeypokerdirt: bets $3.50
Kasselbanki: folds 
6l4ck: folds 
Uncalled bet ($3.50) returned to monkeypokerdirt
monkeypokerdirt collected $4.51 from pot
*** SUMMARY ***
Total pot $4.75 | Rake $0.24 
Board [7d 2h Jd]
Seat 1: I oguz han I folded before Flop (didn't bet)
Seat 2: xobit26 folded before Flop (didn't bet)
Seat 3: 6l4ck folded on the Flop
Seat 4: monkeypokerdirt collected ($4.51)
Seat 5: Jesterclown folded before Flop (didn't bet)
Seat 6: artemxxl (button) folded before Flop (didn't bet)
Seat 7: pudge.3096 (small blind) folded before Flop
Seat 8: Kasselbanki (big blind) folded on the Flop



PokerStars Hand #228672073921:  Hold'em No Limit ($0.25/$0.50 USD) - 2021/07/30 23:00:49 ET
Table 'Laodamia II' 9-max Seat #7 is the button
Seat 1: I oguz han I ($36.97 in chips) 
Seat 2: xobit26 ($50.11 in chips) 
Seat 3: 6l4ck ($92.69 in chips) 
Seat 4: monkeypokerdirt ($34.99 in chips) 
Seat 5: Jesterclown ($51.75 in chips) 
Seat 6: artemxxl ($59.36 in chips) 
Seat 7: pudge.3096 ($50 in chips) 
Seat 8: Kasselbanki ($78.83 in chips) 
Seat 9: $ilentBob81 ($49.30 in chips) 
Kasselbanki: posts small blind $0.25
$ilentBob81: posts big blind $0.50
*** HOLE CARDS ***
I oguz han I: folds 
xobit26: folds 
6l4ck: folds 
monkeypokerdirt: folds 
Jesterclown: raises $1 to $1.50
artemxxl: folds 
pudge.3096: folds 
Kasselbanki: folds 
$ilentBob81: folds 
Uncalled bet ($1) returned to Jesterclown
Jesterclown collected $1.25 from pot
Jesterclown: doesn't show hand 
*** SUMMARY ***
Total pot $1.25 | Rake $0 
Seat 1: I oguz han I folded before Flop (didn't bet)
Seat 2: xobit26 folded before Flop (didn't bet)
Seat 3: 6l4ck folded before Flop (didn't bet)
Seat 4: monkeypokerdirt folded before Flop (didn't bet)
Seat 5: Jesterclown collected ($1.25)
Seat 6: artemxxl folded before Flop (didn't bet)
Seat 7: pudge.3096 (button) folded before Flop (didn't bet)
Seat 8: Kasselbanki (small blind) folded before Flop
Seat 9: $ilentBob81 (big blind) folded before Flop



PokerStars Hand #228672463461:  Hold'em No Limit ($0.25/$0.50 USD) - 2021/07/30 23:34:25 ET
Table 'Laodamia II' 9-max Seat #8 is the button
Seat 1: I oguz han I ($53.35 in chips) 
Seat 2: xobit26 ($70.32 in chips) 
Seat 5: Jesterclown ($51.31 in chips) 
Seat 6: TR1CKTR1CK ($47.13 in chips) 
Seat 7: pudge.3096 ($98.25 in chips) 
Seat 8: undergr0undY ($50 in chips) 
Seat 9: rovara ($59.06 in chips) 
rovara: posts small blind $0.25
I oguz han I: posts big blind $0.50
*** HOLE CARDS ***
xobit26: folds 
Jesterclown: folds 
TR1CKTR1CK: folds 
pudge.3096: folds 
undergr0undY: folds 
rovara: raises $1 to $1.50
I oguz han I: calls $1
*** FLOP *** [Qs Jd 9s]
rovara: bets $2
I oguz han I: raises $2.50 to $4.50
rovara: calls $2.50
*** TURN *** [Qs Jd 9s] [Ad]
rovara: checks 
Millten joins the table at seat #3 
I oguz han I: bets $6.50
rovara: raises $16.25 to $22.75
I oguz han I: calls $16.25
*** RIVER *** [Qs Jd 9s Ad] [Kh]
rovara has timed out
rovara: checks 
I oguz han I: checks 
*** SHOW DOWN ***
rovara: shows [Qh Ah] (two pair, Aces and Queens)
I oguz han I: mucks hand 
rovara collected $55.50 from pot
*** SUMMARY ***
Total pot $57.50 | Rake $2 
Board [Qs Jd 9s Ad Kh]
Seat 1: I oguz han I (big blind) mucked
Seat 2: xobit26 folded before Flop (didn't bet)
Seat 5: Jesterclown folded before Flop (didn't bet)
Seat 6: TR1CKTR1CK folded before Flop (didn't bet)
Seat 7: pudge.3096 folded before Flop (didn't bet)
Seat 8: undergr0undY (button) folded before Flop (didn't bet)
Seat 9: rovara (small blind) showed [Qh Ah] and won ($55.50) with two pair, Aces and Queens



PokerStars Hand #228672487607:  Hold'em No Limit ($0.25/$0.50 USD) - 2021/07/30 23:36:46 ET
Table 'Laodamia II' 9-max Seat #9 is the button
Seat 1: I oguz han I ($24.60 in chips) 
Seat 2: xobit26 ($70.32 in chips) 
Seat 3: Millten ($50 in chips) 
Seat 4: monkeypokerdirt ($26.43 in chips) 
Seat 5: Jesterclown ($51.31 in chips) 
Seat 6: TR1CKTR1CK ($47.13 in chips) 
Seat 7: pudge.3096 ($98.25 in chips) 
Seat 8: undergr0undY ($50 in chips) 
Seat 9: rovara ($85.81 in chips) 
I oguz han I: posts small blind $0.25
xobit26: posts big blind $0.50
Millten: posts big blind $0.50
monkeypokerdirt: posts small & big blinds $0.75
*** HOLE CARDS ***
Millten: checks 
monkeypokerdirt: checks 
Jesterclown: folds 
TR1CKTR1CK: folds 
pudge.3096: raises $2 to $2.50
undergr0undY: folds 
rovara: folds 
I oguz han I: folds 
xobit26: folds 
Millten: folds 
monkeypokerdirt: folds 
Uncalled bet ($2) returned to pudge.3096
pudge.3096 collected $2.50 from pot
pudge.3096: doesn't show hand 
*** SUMMARY ***
Total pot $2.50 | Rake $0 
Seat 1: I oguz han I (small blind) folded before Flop
Seat 2: xobit26 (big blind) folded before Flop
Seat 3: Millten folded before Flop (didn't bet)
Seat 4: monkeypokerdirt folded before Flop (didn't bet)
Seat 5: Jesterclown folded before Flop (didn't bet)
Seat 6: TR1CKTR1CK folded before Flop (didn't bet)
Seat 7: pudge.3096 collected ($2.50)
Seat 8: undergr0undY folded before Flop (didn't bet)
Seat 9: rovara (button) folded before Flop (didn't bet)



PokerStars Hand #228672493746:  Hold'em No Limit ($0.25/$0.50 USD) - 2021/07/30 23:37:22 ET
Table 'Laodamia II' 9-max Seat #1 is the button
Seat 1: I oguz han I ($24.35 in chips) 
Seat 2: xobit26 ($69.82 in chips) 
Seat 3: Millten ($50 in chips) 
Seat 4: monkeypokerdirt ($25.68 in chips) 
Seat 5: Jesterclown ($51.31 in chips) 
Seat 6: TR1CKTR1CK ($47.13 in chips) 
Seat 7: pudge.3096 ($100.25 in chips) 
Seat 8: undergr0undY ($50 in chips) 
Seat 9: rovara ($85.81 in chips) 
xobit26: posts small blind $0.25
Millten: posts big blind $0.50
*** HOLE CARDS ***
monkeypokerdirt: folds 
Jesterclown: folds 
TR1CKTR1CK: folds 
pudge.3096: folds 
undergr0undY: folds 
rovara: folds 
I oguz han I: raises $1 to $1.50
xobit26: folds 
Millten: folds 
Uncalled bet ($1) returned to I oguz han I
I oguz han I collected $1.25 from pot
I oguz han I: doesn't show hand 
*** SUMMARY ***
Total pot $1.25 | Rake $0 
Seat 1: I oguz han I (button) collected ($1.25)
Seat 2: xobit26 (small blind) folded before Flop
Seat 3: Millten (big blind) folded before Flop
Seat 4: monkeypokerdirt folded before Flop (didn't bet)
Seat 5: Jesterclown folded before Flop (didn't bet)
Seat 6: TR1CKTR1CK folded before Flop (didn't bet)
Seat 7: pudge.3096 folded before Flop (didn't bet)
Seat 8: undergr0undY folded before Flop (didn't bet)
Seat 9: rovara folded before Flop (didn't bet)



PokerStars Hand #228672664105:  Hold'em No Limit ($0.25/$0.50 USD) - 2021/07/30 23:52:54 ET
Table 'Laodamia II' 9-max Seat #6 is the button
Seat 2: xobit26 ($67.48 in chips) 
Seat 3: Millten ($53.14 in chips) 
Seat 4: monkeypokerdirt ($40.38 in chips) 
Seat 5: Jesterclown ($83.50 in chips) 
Seat 6: TR1CKTR1CK ($45.63 in chips) 
Seat 7: pudge.3096 ($103.69 in chips) 
Seat 8: undergr0undY ($50 in chips) 
Seat 9: rovara ($76.45 in chips) 
pudge.3096: posts small blind $0.25
undergr0undY: posts big blind $0.50
*** HOLE CARDS ***
rovara: raises $0.75 to $1.25
xobit26: folds 
Millten: raises $2.75 to $4
monkeypokerdirt: folds 
Jesterclown: folds 
TR1CKTR1CK: folds 
pudge.3096: folds 
undergr0undY: folds 
rovara: folds 
Uncalled bet ($2.75) returned to Millten
Millten collected $3.25 from pot
Millten: doesn't show hand 
*** SUMMARY ***
Total pot $3.25 | Rake $0 
Seat 2: xobit26 folded before Flop (didn't bet)
Seat 3: Millten collected ($3.25)
Seat 4: monkeypokerdirt folded before Flop (didn't bet)
Seat 5: Jesterclown folded before Flop (didn't bet)
Seat 6: TR1CKTR1CK (button) folded before Flop (didn't bet)
Seat 7: pudge.3096 (small blind) folded before Flop
Seat 8: undergr0undY (big blind) folded before Flop
Seat 9: rovara folded before Flop



PokerStars Hand #228673304974:  Hold'em No Limit ($0.25/$0.50 USD) - 2021/07/30 1:01:06 ET
Table 'Laodamia II' 9-max Seat #4 is the button
Seat 1: I oguz han I ($51.69 in chips) 
Seat 3: D0d027 ($44.09 in chips) 
Seat 4: smurphy123 ($91.70 in chips) 
Seat 5: Jesterclown ($92.07 in chips) 
Seat 6: TR1CKTR1CK ($43 in chips) 
Seat 7: Squall33bdi ($50 in chips) 
Seat 8: RayyRayyT ($23.08 in chips) 
Seat 9: azlots ($64.50 in chips) 
Jesterclown: posts small blind $0.25
TR1CKTR1CK: posts big blind $0.50
RayyRayyT: posts big blind $0.50
SOLDI MOLDI: sits out 
*** HOLE CARDS ***
Squall33bdi: folds 
RayyRayyT: checks 
azlots: raises $1 to $1.50
I oguz han I: folds 
D0d027: folds 
smurphy123: folds 
Jesterclown: folds 
TR1CKTR1CK: folds 
RayyRayyT: calls $1
*** FLOP *** [6s 8h 3c]
RayyRayyT: checks 
azlots: checks 
*** TURN *** [6s 8h 3c] [Ah]
RayyRayyT: checks 
azlots: checks 
*** RIVER *** [6s 8h 3c Ah] [9h]
RayyRayyT: checks 
azlots: checks 
*** SHOW DOWN ***
RayyRayyT: shows [Ac 4h] (a pair of Aces)
azlots: mucks hand 
RayyRayyT collected $3.56 from pot
*** SUMMARY ***
Total pot $3.75 | Rake $0.19 
Board [6s 8h 3c Ah 9h]
Seat 1: I oguz han I folded before Flop (didn't bet)
Seat 3: D0d027 folded before Flop (didn't bet)
Seat 4: smurphy123 (button) folded before Flop (didn't bet)
Seat 5: Jesterclown (small blind) folded before Flop
Seat 6: TR1CKTR1CK (big blind) folded before Flop
Seat 7: Squall33bdi folded before Flop (didn't bet)
Seat 8: RayyRayyT showed [Ac 4h] and won ($3.56) with a pair of Aces
Seat 9: azlots mucked



PokerStars Hand #228672936983:  Hold'em No Limit ($0.25/$0.50 USD) - 2021/07/30 0:20:16 ET
Table 'Laodamia II' 9-max Seat #2 is the button
Seat 1: I oguz han I ($44.94 in chips) 
Seat 2: xobit26 ($71.99 in chips) 
Seat 3: F.Peters10 ($38 in chips) 
Seat 4: monkeypokerdirt ($20.51 in chips) 
Seat 5: Jesterclown ($85.59 in chips) 
Seat 6: TR1CKTR1CK ($46.63 in chips) 
Seat 7: pudge.3096 ($138.47 in chips) 
Seat 9: rovara ($56.19 in chips) 
F.Peters10: posts small blind $0.25
monkeypokerdirt: posts big blind $0.50
Eagle88888: sits out 
*** HOLE CARDS ***
Jesterclown: folds 
TR1CKTR1CK: folds 
pudge.3096: raises $0.75 to $1.25
rovara: folds 
I oguz han I: folds 
xobit26: folds 
F.Peters10: folds 
monkeypokerdirt: calls $0.75
*** FLOP *** [8d As Td]
monkeypokerdirt: checks 
pudge.3096: checks 
*** TURN *** [8d As Td] [8s]
monkeypokerdirt: checks 
pudge.3096: bets $1.70
monkeypokerdirt: calls $1.70
*** RIVER *** [8d As Td 8s] [Jd]
monkeypokerdirt: checks 
pudge.3096: checks 
*** SHOW DOWN ***
monkeypokerdirt: shows [Tc 5c] (two pair, Tens and Eights)
pudge.3096: shows [Qh Qc] (two pair, Queens and Eights)
pudge.3096 collected $5.84 from pot
*** SUMMARY ***
Total pot $6.15 | Rake $0.31 
Board [8d As Td 8s Jd]
Seat 1: I oguz han I folded before Flop (didn't bet)
Seat 2: xobit26 (button) folded before Flop (didn't bet)
Seat 3: F.Peters10 (small blind) folded before Flop
Seat 4: monkeypokerdirt (big blind) showed [Tc 5c] and lost with two pair, Tens and Eights
Seat 5: Jesterclown folded before Flop (didn't bet)
Seat 6: TR1CKTR1CK folded before Flop (didn't bet)
Seat 7: pudge.3096 showed [Qh Qc] and won ($5.84) with two pair, Queens and Eights
Seat 9: rovara folded before Flop (didn't bet)



PokerStars Hand #228672948459:  Hold'em No Limit ($0.25/$0.50 USD) - 2021/07/30 0:21:30 ET
Table 'Laodamia II' 9-max Seat #3 is the button
Seat 1: I oguz han I ($44.94 in chips) 
Seat 2: xobit26 ($71.99 in chips) 
Seat 3: F.Peters10 ($37.75 in chips) 
Seat 4: monkeypokerdirt ($17.56 in chips) 
Seat 5: Jesterclown ($85.59 in chips) 
Seat 6: TR1CKTR1CK ($46.63 in chips) 
Seat 7: pudge.3096 ($141.36 in chips) 
Seat 9: rovara ($56.19 in chips) 
monkeypokerdirt: posts small blind $0.25
Jesterclown: posts big blind $0.50
Eagle88888: sits out 
*** HOLE CARDS ***
TR1CKTR1CK: folds 
pudge.3096: folds 
rovara: raises $0.75 to $1.25
I oguz han I: raises $2.75 to $4
xobit26: folds 
F.Peters10: folds 
monkeypokerdirt: calls $3.75
Jesterclown: folds 
rovara: folds 
*** FLOP *** [2s Ts Qc]
monkeypokerdirt: checks 
I oguz han I: checks 
*** TURN *** [2s Ts Qc] [6h]
monkeypokerdirt: checks 
I oguz han I: bets $3.06
monkeypokerdirt: calls $3.06
*** RIVER *** [2s Ts Qc 6h] [Js]
monkeypokerdirt: checks 
I oguz han I: bets $11.91
monkeypokerdirt: folds 
Uncalled bet ($11.91) returned to I oguz han I
I oguz han I collected $15.08 from pot
I oguz han I: doesn't show hand 
*** SUMMARY ***
Total pot $15.87 | Rake $0.79 
Board [2s Ts Qc 6h Js]
Seat 1: I oguz han I collected ($15.08)
Seat 2: xobit26 folded before Flop (didn't bet)
Seat 3: F.Peters10 (button) folded before Flop (didn't bet)
Seat 4: monkeypokerdirt (small blind) folded on the River
Seat 5: Jesterclown (big blind) folded before Flop
Seat 6: TR1CKTR1CK folded before Flop (didn't bet)
Seat 7: pudge.3096 folded before Flop (didn't bet)
Seat 9: rovara folded before Flop



PokerStars Hand #228672961930:  Hold'em No Limit ($0.25/$0.50 USD) - 2021/07/30 0:22:58 ET
Table 'Laodamia II' 9-max Seat #4 is the button
Seat 1: I oguz han I ($52.96 in chips) 
Seat 2: xobit26 ($71.99 in chips) 
Seat 3: F.Peters10 ($37.75 in chips) 
Seat 4: monkeypokerdirt ($10.50 in chips) 
Seat 5: Jesterclown ($85.09 in chips) 
Seat 6: TR1CKTR1CK ($46.63 in chips) 
Seat 7: pudge.3096 ($141.36 in chips) 
Seat 9: rovara ($54.94 in chips) 
Jesterclown: posts small blind $0.25
TR1CKTR1CK: posts big blind $0.50
Eagle88888: sits out 
*** HOLE CARDS ***
pudge.3096: raises $0.75 to $1.25
rovara: folds 
I oguz han I: folds 
xobit26: raises $2.75 to $4
F.Peters10: folds 
monkeypokerdirt: folds 
Jesterclown: folds 
TR1CKTR1CK: folds 
pudge.3096: folds 
Uncalled bet ($2.75) returned to xobit26
xobit26 collected $3.25 from pot
xobit26: doesn't show hand 
*** SUMMARY ***
Total pot $3.25 | Rake $0 
Seat 1: I oguz han I folded before Flop (didn't bet)
Seat 2: xobit26 collected ($3.25)
Seat 3: F.Peters10 folded before Flop (didn't bet)
Seat 4: monkeypokerdirt (button) folded before Flop (didn't bet)
Seat 5: Jesterclown (small blind) folded before Flop
Seat 6: TR1CKTR1CK (big blind) folded before Flop
Seat 7: pudge.3096 folded before Flop
Seat 9: rovara folded before Flop (didn't bet)



PokerStars Hand #228672966764:  Hold'em No Limit ($0.25/$0.50 USD) - 2021/07/30 0:23:29 ET
Table 'Laodamia II' 9-max Seat #5 is the button
Seat 1: I oguz han I ($52.96 in chips) 
Seat 2: xobit26 ($73.99 in chips) 
Seat 3: F.Peters10 ($37.75 in chips) 
Seat 4: monkeypokerdirt ($10.50 in chips) 
Seat 5: Jesterclown ($84.84 in chips) 
Seat 6: TR1CKTR1CK ($46.13 in chips) 
Seat 7: pudge.3096 ($140.11 in chips) 
Seat 9: rovara ($54.94 in chips) 
TR1CKTR1CK: posts small blind $0.25
pudge.3096: posts big blind $0.50
Eagle88888: sits out 
*** HOLE CARDS ***
rovara: raises $0.75 to $1.25
I oguz han I: folds 
xobit26: folds 
F.Peters10: folds 
F.Peters10 leaves the table
monkeypokerdirt: raises $4.25 to $5.50
Jesterclown: folds 
TR1CKTR1CK: folds 
pudge.3096: folds 
rovara: raises $49.44 to $54.94 and is all-in
monkeypokerdirt: calls $5 and is all-in
Uncalled bet ($44.44) returned to rovara
*** FLOP *** [Tc 4h 9d]
*** TURN *** [Tc 4h 9d] [9s]
*** RIVER *** [Tc 4h 9d 9s] [3h]
*** SHOW DOWN ***
rovara: shows [7h 7d] (two pair, Nines and Sevens)
monkeypokerdirt: shows [Ad Qd] (a pair of Nines)
rovara collected $20.66 from pot
*** SUMMARY ***
Total pot $21.75 | Rake $1.09 
Board [Tc 4h 9d 9s 3h]
Seat 1: I oguz han I folded before Flop (didn't bet)
Seat 2: xobit26 folded before Flop (didn't bet)
Seat 3: F.Peters10 folded before Flop (didn't bet)
Seat 4: monkeypokerdirt showed [Ad Qd] and lost with a pair of Nines
Seat 5: Jesterclown (button) folded before Flop (didn't bet)
Seat 6: TR1CKTR1CK (small blind) folded before Flop
Seat 7: pudge.3096 (big blind) folded before Flop
Seat 9: rovara showed [7h 7d] and won ($20.66) with two pair, Nines and Sevens



PokerStars Hand #228672973981:  Hold'em No Limit ($0.25/$0.50 USD) - 2021/07/30 0:24:16 ET
Table 'Laodamia II' 9-max Seat #6 is the button
Seat 1: I oguz han I ($52.96 in chips) 
Seat 2: xobit26 ($73.99 in chips) 
Seat 5: Jesterclown ($84.84 in chips) 
Seat 6: TR1CKTR1CK ($45.88 in chips) 
Seat 7: pudge.3096 ($139.61 in chips) 
Seat 8: Eagle88888 ($40 in chips) 
Seat 9: rovara ($65.10 in chips) 
pudge.3096: posts small blind $0.25
Eagle88888: posts big blind $0.50
*** HOLE CARDS ***
rovara: folds 
I oguz han I: folds 
monkeypokerdirt leaves the table
D0d027 joins the table at seat #3 
xobit26: folds 
Jesterclown: folds 
TR1CKTR1CK: folds 
pudge.3096: folds 
Uncalled bet ($0.25) returned to Eagle88888
xobit26 leaves the table
Eagle88888 collected $0.50 from pot
Eagle88888: doesn't show hand 
*** SUMMARY ***
Total pot $0.50 | Rake $0 
Seat 1: I oguz han I folded before Flop (didn't bet)
Seat 2: xobit26 folded before Flop (didn't bet)
Seat 5: Jesterclown folded before Flop (didn't bet)
Seat 6: TR1CKTR1CK (button) folded before Flop (didn't bet)
Seat 7: pudge.3096 (small blind) folded before Flop
Seat 8: Eagle88888 (big blind) collected ($0.50)
Seat 9: rovara folded before Flop (didn't bet)



PokerStars Hand #228672980819:  Hold'em No Limit ($0.25/$0.50 USD) - 2021/07/30 0:25:00 ET
Table 'Laodamia II' 9-max Seat #7 is the button
Seat 1: I oguz han I ($52.96 in chips) 
Seat 5: Jesterclown ($84.84 in chips) 
Seat 6: TR1CKTR1CK ($45.88 in chips) 
Seat 7: pudge.3096 ($139.36 in chips) 
Seat 8: Eagle88888 ($40.25 in chips) 
Seat 9: rovara ($65.10 in chips) 
Eagle88888: posts small blind $0.25
rovara: posts big blind $0.50
D0d027: sits out 
*** HOLE CARDS ***
I oguz han I: folds 
Jesterclown: raises $1 to $1.50
TR1CKTR1CK: raises $3 to $4.50
pudge.3096: folds 
SIRCopenhagen joins the table at seat #2 
Eagle88888: folds 
rovara: folds 
PanicJX joins the table at seat #4 
Jesterclown: calls $3
*** FLOP *** [Js Kh Qc]
Jesterclown: checks 
TR1CKTR1CK: checks 
*** TURN *** [Js Kh Qc] [Qd]
Jesterclown: checks 
TR1CKTR1CK: checks 
*** RIVER *** [Js Kh Qc Qd] [7c]
Jesterclown: bets $4
TR1CKTR1CK: calls $4
*** SHOW DOWN ***
Jesterclown: shows [7s 7d] (a full house, Sevens full of Queens)
TR1CKTR1CK: mucks hand 
Jesterclown collected $16.86 from pot
*** SUMMARY ***
Total pot $17.75 | Rake $0.89 
Board [Js Kh Qc Qd 7c]
Seat 1: I oguz han I folded before Flop (didn't bet)
Seat 5: Jesterclown showed [7s 7d] and won ($16.86) with a full house, Sevens full of Queens
Seat 6: TR1CKTR1CK mucked
Seat 7: pudge.3096 (button) folded before Flop (didn't bet)
Seat 8: Eagle88888 (small blind) folded before Flop
Seat 9: rovara (big blind) folded before Flop



PokerStars Hand #228672993148:  Hold'em No Limit ($0.25/$0.50 USD) - 2021/07/30 0:25:57 ET
Table 'Laodamia II' 9-max Seat #8 is the button
Seat 1: I oguz han I ($52.96 in chips) 
Seat 5: Jesterclown ($93.20 in chips) 
Seat 6: TR1CKTR1CK ($37.38 in chips) 
Seat 7: pudge.3096 ($139.36 in chips) 
Seat 8: Eagle88888 ($40 in chips) 
Seat 9: rovara ($64.60 in chips) 
rovara: posts small blind $0.25
I oguz han I: posts big blind $0.50
SIRCopenhagen: sits out 
D0d027: sits out 
PanicJX: sits out 
*** HOLE CARDS ***
Jesterclown: folds 
TR1CKTR1CK: raises $1 to $1.50
pudge.3096: folds 
Eagle88888: calls $1.50
rovara: folds 
I oguz han I: folds 
*** FLOP *** [Ks Jd 6d]
TR1CKTR1CK: checks 
Eagle88888: bets $1.78
TR1CKTR1CK: calls $1.78
*** TURN *** [Ks Jd 6d] [Th]
TR1CKTR1CK: checks 
Eagle88888: checks 
*** RIVER *** [Ks Jd 6d Th] [9d]
TR1CKTR1CK: bets $1.74
Eagle88888: calls $1.74
*** SHOW DOWN ***
TR1CKTR1CK: shows [Qh Kh] (a straight, Nine to King)
Eagle88888: mucks hand 
TR1CKTR1CK collected $10.25 from pot
*** SUMMARY ***
Total pot $10.79 | Rake $0.54 
Board [Ks Jd 6d Th 9d]
Seat 1: I oguz han I (big blind) folded before Flop
Seat 5: Jesterclown folded before Flop (didn't bet)
Seat 6: TR1CKTR1CK showed [Qh Kh] and won ($10.25) with a straight, Nine to King
Seat 7: pudge.3096 folded before Flop (didn't bet)
Seat 8: Eagle88888 (button) mucked
Seat 9: rovara (small blind) folded before Flop



PokerStars Hand #228673002275:  Hold'em No Limit ($0.25/$0.50 USD) - 2021/07/30 0:26:58 ET
Table 'Laodamia II' 9-max Seat #9 is the button
Seat 1: I oguz han I ($52.46 in chips) 
Seat 2: SIRCopenhagen ($50 in chips) 
Seat 5: Jesterclown ($93.20 in chips) 
Seat 6: TR1CKTR1CK ($50 in chips) 
Seat 7: pudge.3096 ($139.36 in chips) 
Seat 8: Eagle88888 ($34.98 in chips) 
Seat 9: rovara ($64.35 in chips) 
I oguz han I: posts small blind $0.25
SIRCopenhagen: posts big blind $0.50
D0d027: sits out 
PanicJX: sits out 
*** HOLE CARDS ***
Jesterclown: folds 
TR1CKTR1CK: folds 
pudge.3096: raises $0.75 to $1.25
Eagle88888: folds 
rovara: raises $3.25 to $4.50
I oguz han I: folds 
SIRCopenhagen: folds 
pudge.3096: raises $7.50 to $12
rovara: folds 
Uncalled bet ($7.50) returned to pudge.3096
pudge.3096 collected $9.75 from pot
pudge.3096: doesn't show hand 
*** SUMMARY ***
Total pot $9.75 | Rake $0 
Seat 1: I oguz han I (small blind) folded before Flop
Seat 2: SIRCopenhagen (big blind) folded before Flop
Seat 5: Jesterclown folded before Flop (didn't bet)
Seat 6: TR1CKTR1CK folded before Flop (didn't bet)
Seat 7: pudge.3096 collected ($9.75)
Seat 8: Eagle88888 folded before Flop (didn't bet)
Seat 9: rovara (button) folded before Flop



PokerStars Hand #228673012330:  Hold'em No Limit ($0.25/$0.50 USD) - 2021/07/30 0:28:05 ET
Table 'Laodamia II' 9-max Seat #1 is the button
Seat 1: I oguz han I ($52.21 in chips) 
Seat 2: SIRCopenhagen ($49.50 in chips) 
Seat 3: D0d027 ($40 in chips) 
Seat 5: Jesterclown ($93.20 in chips) 
Seat 6: TR1CKTR1CK ($50 in chips) 
Seat 7: pudge.3096 ($144.61 in chips) 
Seat 8: Eagle88888 ($34.98 in chips) 
Seat 9: rovara ($59.85 in chips) 
SIRCopenhagen: posts small blind $0.25
D0d027: posts big blind $0.50
PanicJX: sits out 
*** HOLE CARDS ***
Jesterclown: folds 
TR1CKTR1CK: folds 
pudge.3096: folds 
Eagle88888: folds 
rovara: folds 
I oguz han I: folds 
SIRCopenhagen: calls $0.25
D0d027: checks 
*** FLOP *** [Ts 4s 5h]
SIRCopenhagen: checks 
D0d027: checks 
*** TURN *** [Ts 4s 5h] [Kh]
SIRCopenhagen: checks 
D0d027: bets $1
rovara leaves the table
SIRCopenhagen: folds 
Uncalled bet ($1) returned to D0d027
D0d027 collected $0.95 from pot
D0d027: doesn't show hand 
*** SUMMARY ***
Total pot $1 | Rake $0.05 
Board [Ts 4s 5h Kh]
Seat 1: I oguz han I (button) folded before Flop (didn't bet)
Seat 2: SIRCopenhagen (small blind) folded on the Turn
Seat 3: D0d027 (big blind) collected ($0.95)
Seat 5: Jesterclown folded before Flop (didn't bet)
Seat 6: TR1CKTR1CK folded before Flop (didn't bet)
Seat 7: pudge.3096 folded before Flop (didn't bet)
Seat 8: Eagle88888 folded before Flop (didn't bet)
Seat 9: rovara folded before Flop (didn't bet)



PokerStars Hand #228673022433:  Hold'em No Limit ($0.25/$0.50 USD) - 2021/07/30 0:29:12 ET
Table 'Laodamia II' 9-max Seat #2 is the button
Seat 1: I oguz han I ($52.21 in chips) 
Seat 2: SIRCopenhagen ($49 in chips) 
Seat 3: D0d027 ($40.45 in chips) 
Seat 4: PanicJX ($50 in chips) 
Seat 5: Jesterclown ($93.20 in chips) 
Seat 6: TR1CKTR1CK ($50 in chips) 
Seat 7: pudge.3096 ($144.61 in chips) 
Seat 8: Eagle88888 ($34.98 in chips) 
D0d027: posts small blind $0.25
PanicJX: posts big blind $0.50
*** HOLE CARDS ***
azlots joins the table at seat #9 
Jesterclown: folds 
TR1CKTR1CK has timed out
TR1CKTR1CK: folds 
pudge.3096: folds 
Eagle88888: folds 
I oguz han I: raises $1 to $1.50
SIRCopenhagen: folds 
D0d027: folds 
PanicJX: calls $1
*** FLOP *** [Ks 7d Ts]
PanicJX: checks 
I oguz han I: bets $1.50
PanicJX: folds 
Uncalled bet ($1.50) returned to I oguz han I
PanicJX leaves the table
I oguz han I collected $3.09 from pot
I oguz han I: doesn't show hand 
*** SUMMARY ***
Total pot $3.25 | Rake $0.16 
Board [Ks 7d Ts]
Seat 1: I oguz han I collected ($3.09)
Seat 2: SIRCopenhagen (button) folded before Flop (didn't bet)
Seat 3: D0d027 (small blind) folded before Flop
Seat 4: PanicJX (big blind) folded on the Flop
Seat 5: Jesterclown folded before Flop (didn't bet)
Seat 6: TR1CKTR1CK folded before Flop (didn't bet)
Seat 7: pudge.3096 folded before Flop (didn't bet)
Seat 8: Eagle88888 folded before Flop (didn't bet)



PokerStars Hand #228673029493:  Hold'em No Limit ($0.25/$0.50 USD) - 2021/07/30 0:29:58 ET
Table 'Laodamia II' 9-max Seat #3 is the button
Seat 1: I oguz han I ($53.80 in chips) 
Seat 2: SIRCopenhagen ($49 in chips) 
Seat 3: D0d027 ($40.20 in chips) 
Seat 5: Jesterclown ($93.20 in chips) 
Seat 6: TR1CKTR1CK ($50 in chips) 
Seat 7: pudge.3096 ($144.61 in chips) 
Seat 8: Eagle88888 ($34.98 in chips) 
Seat 9: azlots ($50 in chips) 
Jesterclown: posts small blind $0.25
TR1CKTR1CK: posts big blind $0.50
azlots: posts big blind $0.50
*** HOLE CARDS ***
pudge.3096: folds 
Eagle88888: folds 
azlots: checks 
I oguz han I: raises $2 to $2.50
SIRCopenhagen: folds 
D0d027: folds 
Jesterclown: folds 
TR1CKTR1CK: folds 
azlots: folds 
Uncalled bet ($2) returned to I oguz han I
I oguz han I collected $1.75 from pot
I oguz han I: doesn't show hand 
*** SUMMARY ***
Total pot $1.75 | Rake $0 
Seat 1: I oguz han I collected ($1.75)
Seat 2: SIRCopenhagen folded before Flop (didn't bet)
Seat 3: D0d027 (button) folded before Flop (didn't bet)
Seat 5: Jesterclown (small blind) folded before Flop
Seat 6: TR1CKTR1CK (big blind) folded before Flop
Seat 7: pudge.3096 folded before Flop (didn't bet)
Seat 8: Eagle88888 folded before Flop (didn't bet)
Seat 9: azlots folded before Flop (didn't bet)



PokerStars Hand #228673032834:  Hold'em No Limit ($0.25/$0.50 USD) - 2021/07/30 0:30:20 ET
Table 'Laodamia II' 9-max Seat #5 is the button
Seat 1: I oguz han I ($55.05 in chips) 
Seat 2: SIRCopenhagen ($49 in chips) 
Seat 3: D0d027 ($40.20 in chips) 
Seat 5: Jesterclown ($92.95 in chips) 
Seat 6: TR1CKTR1CK ($49.50 in chips) 
Seat 8: Eagle88888 ($34.98 in chips) 
Seat 9: azlots ($49.50 in chips) 
TR1CKTR1CK: posts small blind $0.25
pudge.3096: is sitting out 
Eagle88888: posts big blind $0.50
*** HOLE CARDS ***
pudge.3096 leaves the table
azlots: raises $1 to $1.50
I oguz han I: folds 
SIRCopenhagen: folds 
D0d027: folds 
Jesterclown: folds 
TR1CKTR1CK: folds 
Eagle88888: folds 
Uncalled bet ($1) returned to azlots
azlots collected $1.25 from pot
azlots: doesn't show hand 
*** SUMMARY ***
Total pot $1.25 | Rake $0 
Seat 1: I oguz han I folded before Flop (didn't bet)
Seat 2: SIRCopenhagen folded before Flop (didn't bet)
Seat 3: D0d027 folded before Flop (didn't bet)
Seat 5: Jesterclown (button) folded before Flop (didn't bet)
Seat 6: TR1CKTR1CK (small blind) folded before Flop
Seat 8: Eagle88888 (big blind) folded before Flop
Seat 9: azlots collected ($1.25)



PokerStars Hand #228673036678:  Hold'em No Limit ($0.25/$0.50 USD) - 2021/07/30 0:30:46 ET
Table 'Laodamia II' 9-max Seat #6 is the button
Seat 1: I oguz han I ($55.05 in chips) 
Seat 2: SIRCopenhagen ($49 in chips) 
Seat 3: D0d027 ($40.20 in chips) 
Seat 5: Jesterclown ($92.95 in chips) 
Seat 6: TR1CKTR1CK ($49.25 in chips) 
Seat 8: Eagle88888 ($34.48 in chips) 
Seat 9: azlots ($50.25 in chips) 
Eagle88888: posts small blind $0.25
azlots: posts big blind $0.50
*** HOLE CARDS ***
I oguz han I: folds 
SIRCopenhagen: calls $0.50
D0d027: calls $0.50
Jesterclown: folds 
TR1CKTR1CK: folds 
Eagle88888: calls $0.25
azlots: checks 
*** FLOP *** [4d Ad 8h]
Eagle88888: checks 
azlots: checks 
SIRCopenhagen: checks 
D0d027: bets $1
Eagle88888: calls $1
azlots: folds 
SIRCopenhagen: calls $1
*** TURN *** [4d Ad 8h] [9d]
Eagle88888: checks 
SIRCopenhagen: checks 
D0d027: bets $1.50
Eagle88888: folds 
SIRCopenhagen: calls $1.50
*** RIVER *** [4d Ad 8h 9d] [Js]
SIRCopenhagen: checks 
D0d027: checks 
*** SHOW DOWN ***
SIRCopenhagen: shows [7c 6h] (high card Ace)
D0d027: shows [Ah 9c] (two pair, Aces and Nines)
D0d027 collected $7.60 from pot
*** SUMMARY ***
Total pot $8 | Rake $0.40 
Board [4d Ad 8h 9d Js]
Seat 1: I oguz han I folded before Flop (didn't bet)
Seat 2: SIRCopenhagen showed [7c 6h] and lost with high card Ace
Seat 3: D0d027 showed [Ah 9c] and won ($7.60) with two pair, Aces and Nines
Seat 5: Jesterclown folded before Flop (didn't bet)
Seat 6: TR1CKTR1CK (button) folded before Flop (didn't bet)
Seat 8: Eagle88888 (small blind) folded on the Turn
Seat 9: azlots (big blind) folded on the Flop



PokerStars Hand #228673048466:  Hold'em No Limit ($0.25/$0.50 USD) - 2021/07/30 0:32:03 ET
Table 'Laodamia II' 9-max Seat #8 is the button
Seat 1: I oguz han I ($55.05 in chips) 
Seat 2: SIRCopenhagen ($46 in chips) 
Seat 3: D0d027 ($44.80 in chips) 
Seat 5: Jesterclown ($92.95 in chips) 
Seat 6: TR1CKTR1CK ($49.25 in chips) 
Seat 8: Eagle88888 ($32.98 in chips) 
Seat 9: azlots ($49.75 in chips) 
azlots: posts small blind $0.25
I oguz han I: posts big blind $0.50
*** HOLE CARDS ***
SIRCopenhagen: folds 
D0d027: folds 
Jesterclown: folds 
TR1CKTR1CK: raises $1 to $1.50
smurphy123 joins the table at seat #4 
Eagle88888: folds 
azlots: folds 
I oguz han I: raises $3 to $4.50
TR1CKTR1CK: folds 
Uncalled bet ($3) returned to I oguz han I
I oguz han I collected $3.25 from pot
I oguz han I: doesn't show hand 
*** SUMMARY ***
Total pot $3.25 | Rake $0 
Seat 1: I oguz han I (big blind) collected ($3.25)
Seat 2: SIRCopenhagen folded before Flop (didn't bet)
Seat 3: D0d027 folded before Flop (didn't bet)
Seat 5: Jesterclown folded before Flop (didn't bet)
Seat 6: TR1CKTR1CK folded before Flop
Seat 8: Eagle88888 (button) folded before Flop (didn't bet)
Seat 9: azlots (small blind) folded before Flop



PokerStars Hand #228673058194:  Hold'em No Limit ($0.25/$0.50 USD) - 2021/07/30 0:33:07 ET
Table 'Laodamia II' 9-max Seat #9 is the button
Seat 1: I oguz han I ($56.80 in chips) 
Seat 2: SIRCopenhagen ($46 in chips) 
Seat 3: D0d027 ($44.80 in chips) 
Seat 5: Jesterclown ($92.95 in chips) 
Seat 6: TR1CKTR1CK ($47.75 in chips) 
Seat 8: Eagle88888 ($32.98 in chips) 
Seat 9: azlots ($49.50 in chips) 
I oguz han I: posts small blind $0.25
SIRCopenhagen: posts big blind $0.50
smurphy123: sits out 
*** HOLE CARDS ***
D0d027: calls $0.50
Jesterclown: folds 
TR1CKTR1CK: folds 
Eagle88888: folds 
azlots: folds 
xobit26 joins the table at seat #7 
I oguz han I: calls $0.25
SIRCopenhagen: checks 
*** FLOP *** [3s 5h 6s]
I oguz han I: bets $1
SIRCopenhagen: calls $1
D0d027: calls $1
*** TURN *** [3s 5h 6s] [5s]
I oguz han I: checks 
SIRCopenhagen: checks 
D0d027: checks 
*** RIVER *** [3s 5h 6s 5s] [9c]
I oguz han I: bets $2
SIRCopenhagen: calls $2
D0d027: folds 
*** SHOW DOWN ***
I oguz han I: shows [8s 7h] (a straight, Five to Nine)
SIRCopenhagen: mucks hand 
I oguz han I collected $8.08 from pot
*** SUMMARY ***
Total pot $8.50 | Rake $0.42 
Board [3s 5h 6s 5s 9c]
Seat 1: I oguz han I (small blind) showed [8s 7h] and won ($8.08) with a straight, Five to Nine
Seat 2: SIRCopenhagen (big blind) mucked
Seat 3: D0d027 folded on the River
Seat 5: Jesterclown folded before Flop (didn't bet)
Seat 6: TR1CKTR1CK folded before Flop (didn't bet)
Seat 8: Eagle88888 folded before Flop (didn't bet)
Seat 9: azlots (button) folded before Flop (didn't bet)



PokerStars Hand #228673067548:  Hold'em No Limit ($0.25/$0.50 USD) - 2021/07/30 0:34:09 ET
Table 'Laodamia II' 9-max Seat #1 is the button
Seat 1: I oguz han I ($61.38 in chips) 
Seat 2: SIRCopenhagen ($42.50 in chips) 
Seat 3: D0d027 ($43.30 in chips) 
Seat 5: Jesterclown ($92.95 in chips) 
Seat 6: TR1CKTR1CK ($47.75 in chips) 
Seat 8: Eagle88888 ($32.98 in chips) 
Seat 9: azlots ($49.50 in chips) 
SIRCopenhagen: posts small blind $0.25
D0d027: posts big blind $0.50
smurphy123: sits out 
xobit26: sits out 
*** HOLE CARDS ***
Jesterclown: folds 
TR1CKTR1CK: folds 
Eagle88888: folds 
azlots: folds 
I oguz han I: raises $1 to $1.50
SIRCopenhagen: calls $1.25
D0d027: folds 
*** FLOP *** [Js 9h 5c]
SIRCopenhagen: bets $1.66
I oguz han I: calls $1.66
*** TURN *** [Js 9h 5c] [7h]
SIRCopenhagen: bets $3.24
I oguz han I: calls $3.24
*** RIVER *** [Js 9h 5c 7h] [9s]
SIRCopenhagen: checks 
I oguz han I: bets $8.50
SIRCopenhagen: folds 
Uncalled bet ($8.50) returned to I oguz han I
I oguz han I collected $12.64 from pot
I oguz han I: doesn't show hand 
*** SUMMARY ***
Total pot $13.30 | Rake $0.66 
Board [Js 9h 5c 7h 9s]
Seat 1: I oguz han I (button) collected ($12.64)
Seat 2: SIRCopenhagen (small blind) folded on the River
Seat 3: D0d027 (big blind) folded before Flop
Seat 5: Jesterclown folded before Flop (didn't bet)
Seat 6: TR1CKTR1CK folded before Flop (didn't bet)
Seat 8: Eagle88888 folded before Flop (didn't bet)
Seat 9: azlots folded before Flop (didn't bet)



PokerStars Hand #228673077677:  Hold'em No Limit ($0.25/$0.50 USD) - 2021/07/30 0:35:16 ET
Table 'Laodamia II' 9-max Seat #2 is the button
Seat 1: I oguz han I ($67.62 in chips) 
Seat 2: SIRCopenhagen ($36.10 in chips) 
Seat 3: D0d027 ($42.80 in chips) 
Seat 4: smurphy123 ($50 in chips) 
Seat 5: Jesterclown ($92.95 in chips) 
Seat 6: TR1CKTR1CK ($47.75 in chips) 
Seat 8: Eagle88888 ($32.98 in chips) 
Seat 9: azlots ($49.50 in chips) 
D0d027: posts small blind $0.25
smurphy123: posts big blind $0.50
xobit26: sits out 
*** HOLE CARDS ***
Jesterclown: folds 
TR1CKTR1CK: folds 
Eagle88888: folds 
azlots: folds 
I oguz han I: folds 
SIRCopenhagen: folds 
D0d027: folds 
Uncalled bet ($0.25) returned to smurphy123
smurphy123 collected $0.50 from pot
smurphy123: doesn't show hand 
*** SUMMARY ***
Total pot $0.50 | Rake $0 
Seat 1: I oguz han I folded before Flop (didn't bet)
Seat 2: SIRCopenhagen (button) folded before Flop (didn't bet)
Seat 3: D0d027 (small blind) folded before Flop
Seat 4: smurphy123 (big blind) collected ($0.50)
Seat 5: Jesterclown folded before Flop (didn't bet)
Seat 6: TR1CKTR1CK folded before Flop (didn't bet)
Seat 8: Eagle88888 folded before Flop (didn't bet)
Seat 9: azlots folded before Flop (didn't bet)



PokerStars Hand #228673081760:  Hold'em No Limit ($0.25/$0.50 USD) - 2021/07/30 0:35:43 ET
Table 'Laodamia II' 9-max Seat #3 is the button
Seat 1: I oguz han I ($67.62 in chips) 
Seat 2: SIRCopenhagen ($36.10 in chips) 
Seat 3: D0d027 ($42.55 in chips) 
Seat 4: smurphy123 ($50.25 in chips) 
Seat 5: Jesterclown ($92.95 in chips) 
Seat 6: TR1CKTR1CK ($47.75 in chips) 
Seat 8: Eagle88888 ($32.98 in chips) 
Seat 9: azlots ($49.50 in chips) 
smurphy123: posts small blind $0.25
Jesterclown: posts big blind $0.50
xobit26: sits out 
*** HOLE CARDS ***
TR1CKTR1CK: folds 
Eagle88888: calls $0.50
azlots: folds 
I oguz han I: raises $1.50 to $2
SIRCopenhagen: folds 
D0d027: folds 
smurphy123: folds 
Jesterclown: calls $1.50
Eagle88888 is disconnected 
Eagle88888 is connected 
Eagle88888: folds 
*** FLOP *** [Th 8s Td]
Jesterclown: checks 
I oguz han I: bets $1.50
Jesterclown: calls $1.50
*** TURN *** [Th 8s Td] [Jd]
Jesterclown: bets $3
I oguz han I: folds 
Uncalled bet ($3) returned to Jesterclown
Jesterclown collected $7.36 from pot
Jesterclown: doesn't show hand 
*** SUMMARY ***
Total pot $7.75 | Rake $0.39 
Board [Th 8s Td Jd]
Seat 1: I oguz han I folded on the Turn
Seat 2: SIRCopenhagen folded before Flop (didn't bet)
Seat 3: D0d027 (button) folded before Flop (didn't bet)
Seat 4: smurphy123 (small blind) folded before Flop
Seat 5: Jesterclown (big blind) collected ($7.36)
Seat 6: TR1CKTR1CK folded before Flop (didn't bet)
Seat 8: Eagle88888 folded before Flop
Seat 9: azlots folded before Flop (didn't bet)



PokerStars Hand #228673093502:  Hold'em No Limit ($0.25/$0.50 USD) - 2021/07/30 0:37:01 ET
Table 'Laodamia II' 9-max Seat #4 is the button
Seat 1: I oguz han I ($64.12 in chips) 
Seat 2: SIRCopenhagen ($36.10 in chips) 
Seat 3: D0d027 ($42.55 in chips) 
Seat 4: smurphy123 ($50 in chips) 
Seat 5: Jesterclown ($96.81 in chips) 
Seat 6: TR1CKTR1CK ($47.75 in chips) 
Seat 8: Eagle88888 ($32.48 in chips) 
Seat 9: azlots ($49.50 in chips) 
Jesterclown: posts small blind $0.25
TR1CKTR1CK: posts big blind $0.50
xobit26: sits out 
*** HOLE CARDS ***
Eagle88888: folds 
azlots: folds 
I oguz han I: folds 
SIRCopenhagen: folds 
D0d027: calls $0.50
smurphy123: folds 
Jesterclown: folds 
TR1CKTR1CK: checks 
*** FLOP *** [Kc 8h 2d]
TR1CKTR1CK: checks 
D0d027: bets $0.60
TR1CKTR1CK: folds 
Uncalled bet ($0.60) returned to D0d027
D0d027 collected $1.19 from pot
D0d027: doesn't show hand 
*** SUMMARY ***
Total pot $1.25 | Rake $0.06 
Board [Kc 8h 2d]
Seat 1: I oguz han I folded before Flop (didn't bet)
Seat 2: SIRCopenhagen folded before Flop (didn't bet)
Seat 3: D0d027 collected ($1.19)
Seat 4: smurphy123 (button) folded before Flop (didn't bet)
Seat 5: Jesterclown (small blind) folded before Flop
Seat 6: TR1CKTR1CK (big blind) folded on the Flop
Seat 8: Eagle88888 folded before Flop (didn't bet)
Seat 9: azlots folded before Flop (didn't bet)



PokerStars Hand #228673102294:  Hold'em No Limit ($0.25/$0.50 USD) - 2021/07/30 0:37:59 ET
Table 'Laodamia II' 9-max Seat #5 is the button
Seat 1: I oguz han I ($64.12 in chips) 
Seat 2: SIRCopenhagen ($36.10 in chips) 
Seat 3: D0d027 ($43.24 in chips) 
Seat 4: smurphy123 ($50 in chips) 
Seat 5: Jesterclown ($96.56 in chips) 
Seat 6: TR1CKTR1CK ($47.25 in chips) 
Seat 7: xobit26 ($73.99 in chips) 
Seat 8: Eagle88888 ($32.48 in chips) 
Seat 9: azlots ($49.50 in chips) 
TR1CKTR1CK: posts small blind $0.25
xobit26: posts big blind $0.50
*** HOLE CARDS ***
Eagle88888: calls $0.50
azlots: raises $0.50 to $1
I oguz han I: folds 
SIRCopenhagen: folds 
D0d027: folds 
smurphy123: folds 
Jesterclown: folds 
TR1CKTR1CK: folds 
xobit26: calls $0.50
Eagle88888: calls $0.50
*** FLOP *** [5d 6s 2s]
xobit26: checks 
Eagle88888: checks 
azlots: checks 
*** TURN *** [5d 6s 2s] [Td]
xobit26: bets $2.47
Eagle88888: calls $2.47
azlots: folds 
*** RIVER *** [5d 6s 2s Td] [9c]
xobit26: bets $6.62
Eagle88888: folds 
Uncalled bet ($6.62) returned to xobit26
xobit26 collected $7.78 from pot
xobit26: doesn't show hand 
*** SUMMARY ***
Total pot $8.19 | Rake $0.41 
Board [5d 6s 2s Td 9c]
Seat 1: I oguz han I folded before Flop (didn't bet)
Seat 2: SIRCopenhagen folded before Flop (didn't bet)
Seat 3: D0d027 folded before Flop (didn't bet)
Seat 4: smurphy123 folded before Flop (didn't bet)
Seat 5: Jesterclown (button) folded before Flop (didn't bet)
Seat 6: TR1CKTR1CK (small blind) folded before Flop
Seat 7: xobit26 (big blind) collected ($7.78)
Seat 8: Eagle88888 folded on the River
Seat 9: azlots folded on the Turn



PokerStars Hand #228673112921:  Hold'em No Limit ($0.25/$0.50 USD) - 2021/07/30 0:39:10 ET
Table 'Laodamia II' 9-max Seat #7 is the button
Seat 1: I oguz han I ($64.12 in chips) 
Seat 2: SIRCopenhagen ($50 in chips) 
Seat 3: D0d027 ($43.24 in chips) 
Seat 4: smurphy123 ($50 in chips) 
Seat 5: Jesterclown ($96.56 in chips) 
Seat 7: xobit26 ($78.30 in chips) 
Seat 8: Eagle88888 ($29.01 in chips) 
Seat 9: azlots ($48.50 in chips) 
Eagle88888: posts small blind $0.25
azlots: posts big blind $0.50
*** HOLE CARDS ***
I oguz han I: folds 
SIRCopenhagen: folds 
D0d027: raises $0.50 to $1
smurphy123: folds 
Jesterclown: folds 
xobit26: folds 
Eagle88888: folds 
azlots: calls $0.50
*** FLOP *** [Ts 5h 7c]
azlots: checks 
D0d027: bets $1.07
azlots: calls $1.07
*** TURN *** [Ts 5h 7c] [Ac]
azlots: checks 
D0d027: bets $1.50
azlots: folds 
Uncalled bet ($1.50) returned to D0d027
D0d027 collected $4.17 from pot
D0d027: doesn't show hand 
*** SUMMARY ***
Total pot $4.39 | Rake $0.22 
Board [Ts 5h 7c Ac]
Seat 1: I oguz han I folded before Flop (didn't bet)
Seat 2: SIRCopenhagen folded before Flop (didn't bet)
Seat 3: D0d027 collected ($4.17)
Seat 4: smurphy123 folded before Flop (didn't bet)
Seat 5: Jesterclown folded before Flop (didn't bet)
Seat 7: xobit26 (button) folded before Flop (didn't bet)
Seat 8: Eagle88888 (small blind) folded before Flop
Seat 9: azlots (big blind) folded on the Turn



PokerStars Hand #228673120449:  Hold'em No Limit ($0.25/$0.50 USD) - 2021/07/30 0:40:01 ET
Table 'Laodamia II' 9-max Seat #8 is the button
Seat 1: I oguz han I ($64.12 in chips) 
Seat 2: SIRCopenhagen ($50 in chips) 
Seat 3: D0d027 ($45.34 in chips) 
Seat 4: smurphy123 ($50 in chips) 
Seat 5: Jesterclown ($96.56 in chips) 
Seat 7: xobit26 ($78.30 in chips) 
Seat 8: Eagle88888 ($28.76 in chips) 
Seat 9: azlots ($46.43 in chips) 
azlots: posts small blind $0.25
I oguz han I: posts big blind $0.50
*** HOLE CARDS ***
SIRCopenhagen: raises $1 to $1.50
D0d027: folds 
smurphy123: folds 
Jesterclown: calls $1.50
xobit26: folds 
Eagle88888: folds 
azlots: calls $1.25
I oguz han I: calls $1
*** FLOP *** [Qd Qh 5s]
azlots: checks 
I oguz han I: checks 
SIRCopenhagen: checks 
Jesterclown: checks 
*** TURN *** [Qd Qh 5s] [5d]
azlots: bets $2.85
I oguz han I: folds 
SIRCopenhagen: calls $2.85
Jesterclown: folds 
*** RIVER *** [Qd Qh 5s 5d] [6h]
azlots: checks 
SIRCopenhagen: checks 
*** SHOW DOWN ***
azlots: shows [9d 9c] (two pair, Queens and Nines)
SIRCopenhagen: mucks hand 
azlots collected $11.12 from pot
*** SUMMARY ***
Total pot $11.70 | Rake $0.58 
Board [Qd Qh 5s 5d 6h]
Seat 1: I oguz han I (big blind) folded on the Turn
Seat 2: SIRCopenhagen mucked
Seat 3: D0d027 folded before Flop (didn't bet)
Seat 4: smurphy123 folded before Flop (didn't bet)
Seat 5: Jesterclown folded on the Turn
Seat 7: xobit26 folded before Flop (didn't bet)
Seat 8: Eagle88888 (button) folded before Flop (didn't bet)
Seat 9: azlots (small blind) showed [9d 9c] and won ($11.12) with two pair, Queens and Nines



PokerStars Hand #228673127086:  Hold'em No Limit ($0.25/$0.50 USD) - 2021/07/30 0:40:45 ET
Table 'Laodamia II' 9-max Seat #9 is the button
Seat 1: I oguz han I ($62.62 in chips) 
Seat 2: SIRCopenhagen ($45.65 in chips) 
Seat 3: D0d027 ($45.34 in chips) 
Seat 4: smurphy123 ($50 in chips) 
Seat 5: Jesterclown ($95.06 in chips) 
Seat 6: TR1CKTR1CK ($47 in chips) 
Seat 7: xobit26 ($78.30 in chips) 
Seat 8: Eagle88888 ($28.76 in chips) 
Seat 9: azlots ($53.20 in chips) 
I oguz han I: posts small blind $0.25
SIRCopenhagen: posts big blind $0.50
*** HOLE CARDS ***
D0d027: folds 
smurphy123: folds 
Jesterclown: folds 
TR1CKTR1CK: folds 
xobit26: folds 
Eagle88888 is disconnected 
Eagle88888 is connected 
Eagle88888 has timed out
Eagle88888: folds 
azlots: folds 
I oguz han I: raises $1 to $1.50
SIRCopenhagen: calls $1
*** FLOP *** [4h 3d 7s]
I oguz han I: bets $1.50
SIRCopenhagen: calls $1.50
*** TURN *** [4h 3d 7s] [4c]
I oguz han I: checks 
SIRCopenhagen: checks 
*** RIVER *** [4h 3d 7s 4c] [Jc]
I oguz han I: checks 
SIRCopenhagen: checks 
*** SHOW DOWN ***
I oguz han I: shows [Ah Th] (a pair of Fours)
SIRCopenhagen: mucks hand 
I oguz han I collected $5.70 from pot
*** SUMMARY ***
Total pot $6 | Rake $0.30 
Board [4h 3d 7s 4c Jc]
Seat 1: I oguz han I (small blind) showed [Ah Th] and won ($5.70) with a pair of Fours
Seat 2: SIRCopenhagen (big blind) mucked
Seat 3: D0d027 folded before Flop (didn't bet)
Seat 4: smurphy123 folded before Flop (didn't bet)
Seat 5: Jesterclown folded before Flop (didn't bet)
Seat 6: TR1CKTR1CK folded before Flop (didn't bet)
Seat 7: xobit26 folded before Flop (didn't bet)
Seat 8: Eagle88888 folded before Flop (didn't bet)
Seat 9: azlots (button) folded before Flop (didn't bet)



PokerStars Hand #228673135779:  Hold'em No Limit ($0.25/$0.50 USD) - 2021/07/30 0:41:43 ET
Table 'Laodamia II' 9-max Seat #1 is the button
Seat 1: I oguz han I ($65.32 in chips) 
Seat 2: SIRCopenhagen ($42.65 in chips) 
Seat 3: D0d027 ($45.34 in chips) 
Seat 4: smurphy123 ($50 in chips) 
Seat 5: Jesterclown ($95.06 in chips) 
Seat 6: TR1CKTR1CK ($47 in chips) 
Seat 7: xobit26 ($78.30 in chips) 
Seat 9: azlots ($53.20 in chips) 
SIRCopenhagen: posts small blind $0.25
D0d027: posts big blind $0.50
*** HOLE CARDS ***
smurphy123: folds 
Jesterclown: raises $0.75 to $1.25
TR1CKTR1CK: folds 
xobit26: folds 
azlots: folds 
I oguz han I: folds 
SIRCopenhagen: calls $1
D0d027: folds 
*** FLOP *** [6d 9d 2d]
SIRCopenhagen: checks 
Jesterclown: checks 
*** TURN *** [6d 9d 2d] [7d]
SIRCopenhagen: checks 
Jesterclown: bets $1
SIRCopenhagen: folds 
Uncalled bet ($1) returned to Jesterclown
Jesterclown collected $2.85 from pot
Jesterclown: doesn't show hand 
*** SUMMARY ***
Total pot $3 | Rake $0.15 
Board [6d 9d 2d 7d]
Seat 1: I oguz han I (button) folded before Flop (didn't bet)
Seat 2: SIRCopenhagen (small blind) folded on the Turn
Seat 3: D0d027 (big blind) folded before Flop
Seat 4: smurphy123 folded before Flop (didn't bet)
Seat 5: Jesterclown collected ($2.85)
Seat 6: TR1CKTR1CK folded before Flop (didn't bet)
Seat 7: xobit26 folded before Flop (didn't bet)
Seat 9: azlots folded before Flop (didn't bet)



PokerStars Hand #228673142164:  Hold'em No Limit ($0.25/$0.50 USD) - 2021/07/30 0:42:26 ET
Table 'Laodamia II' 9-max Seat #2 is the button
Seat 1: I oguz han I ($65.32 in chips) 
Seat 2: SIRCopenhagen ($41.40 in chips) 
Seat 3: D0d027 ($44.84 in chips) 
Seat 4: smurphy123 ($50 in chips) 
Seat 5: Jesterclown ($96.66 in chips) 
Seat 6: TR1CKTR1CK ($47 in chips) 
Seat 7: xobit26 ($78.30 in chips) 
Seat 9: azlots ($53.20 in chips) 
D0d027: posts small blind $0.25
smurphy123: posts big blind $0.50
*** HOLE CARDS ***
Jesterclown: folds 
TR1CKTR1CK: folds 
xobit26: folds 
azlots: raises $1 to $1.50
I oguz han I: raises $3 to $4.50
SIRCopenhagen: folds 
D0d027: folds 
smurphy123: folds 
azlots: calls $3
*** FLOP *** [9d 7h 7c]
azlots: checks 
I oguz han I: bets $3.50
azlots: folds 
Uncalled bet ($3.50) returned to I oguz han I
I oguz han I collected $9.26 from pot
I oguz han I: doesn't show hand 
*** SUMMARY ***
Total pot $9.75 | Rake $0.49 
Board [9d 7h 7c]
Seat 1: I oguz han I collected ($9.26)
Seat 2: SIRCopenhagen (button) folded before Flop (didn't bet)
Seat 3: D0d027 (small blind) folded before Flop
Seat 4: smurphy123 (big blind) folded before Flop
Seat 5: Jesterclown folded before Flop (didn't bet)
Seat 6: TR1CKTR1CK folded before Flop (didn't bet)
Seat 7: xobit26 folded before Flop (didn't bet)
Seat 9: azlots folded on the Flop



PokerStars Hand #228673151613:  Hold'em No Limit ($0.25/$0.50 USD) - 2021/07/30 0:43:05 ET
Table 'Laodamia II' 9-max Seat #3 is the button
Seat 1: I oguz han I ($70.08 in chips) 
Seat 2: SIRCopenhagen ($41.40 in chips) 
Seat 3: D0d027 ($44.59 in chips) 
Seat 4: smurphy123 ($49.50 in chips) 
Seat 5: Jesterclown ($96.66 in chips) 
Seat 6: TR1CKTR1CK ($47 in chips) 
Seat 7: xobit26 ($78.30 in chips) 
Seat 9: azlots ($48.70 in chips) 
smurphy123: posts small blind $0.25
Jesterclown: posts big blind $0.50
*** HOLE CARDS ***
TR1CKTR1CK has timed out
TR1CKTR1CK: folds 
xobit26: folds 
azlots: folds 
I oguz han I: folds 
SIRCopenhagen: calls $0.50
D0d027: calls $0.50
smurphy123: folds 
Jesterclown: checks 
*** FLOP *** [Ks 5d Tc]
Jesterclown: checks 
SIRCopenhagen: checks 
D0d027: checks 
*** TURN *** [Ks 5d Tc] [Qs]
Jesterclown: checks 
SIRCopenhagen: checks 
D0d027: checks 
*** RIVER *** [Ks 5d Tc Qs] [2s]
Jesterclown: checks 
SIRCopenhagen: checks 
D0d027: checks 
*** SHOW DOWN ***
Jesterclown: shows [6s Ad] (high card Ace)
SIRCopenhagen: mucks hand 
D0d027: mucks hand 
Jesterclown collected $1.66 from pot
*** SUMMARY ***
Total pot $1.75 | Rake $0.09 
Board [Ks 5d Tc Qs 2s]
Seat 1: I oguz han I folded before Flop (didn't bet)
Seat 2: SIRCopenhagen mucked
Seat 3: D0d027 (button) mucked
Seat 4: smurphy123 (small blind) folded before Flop
Seat 5: Jesterclown (big blind) showed [6s Ad] and won ($1.66) with high card Ace
Seat 6: TR1CKTR1CK folded before Flop (didn't bet)
Seat 7: xobit26 folded before Flop (didn't bet)
Seat 9: azlots folded before Flop (didn't bet)



PokerStars Hand #228673163666:  Hold'em No Limit ($0.25/$0.50 USD) - 2021/07/30 0:44:03 ET
Table 'Laodamia II' 9-max Seat #4 is the button
Seat 1: I oguz han I ($70.08 in chips) 
Seat 2: SIRCopenhagen ($40.90 in chips) 
Seat 3: D0d027 ($44.09 in chips) 
Seat 4: smurphy123 ($49.25 in chips) 
Seat 5: Jesterclown ($97.82 in chips) 
Seat 6: TR1CKTR1CK ($47 in chips) 
Seat 7: xobit26 ($78.30 in chips) 
Seat 9: azlots ($48.70 in chips) 
Jesterclown: posts small blind $0.25
TR1CKTR1CK: posts big blind $0.50
*** HOLE CARDS ***
xobit26: folds 
azlots: folds 
I oguz han I: raises $1 to $1.50
SIRCopenhagen: calls $1.50
D0d027: folds 
smurphy123: calls $1.50
Jesterclown: folds 
TR1CKTR1CK: folds 
*** FLOP *** [5c 5s Ac]
I oguz han I: checks 
SIRCopenhagen: checks 
smurphy123: checks 
*** TURN *** [5c 5s Ac] [3h]
I oguz han I: bets $2
SIRCopenhagen: folds 
smurphy123: calls $2
*** RIVER *** [5c 5s Ac 3h] [9h]
I oguz han I: bets $4.83
smurphy123: raises $9.23 to $14.06
I oguz han I: folds 
Uncalled bet ($9.23) returned to smurphy123
smurphy123 collected $17.96 from pot
smurphy123: doesn't show hand 
*** SUMMARY ***
Total pot $18.91 | Rake $0.95 
Board [5c 5s Ac 3h 9h]
Seat 1: I oguz han I folded on the River
Seat 2: SIRCopenhagen folded on the Turn
Seat 3: D0d027 folded before Flop (didn't bet)
Seat 4: smurphy123 (button) collected ($17.96)
Seat 5: Jesterclown (small blind) folded before Flop
Seat 6: TR1CKTR1CK (big blind) folded before Flop
Seat 7: xobit26 folded before Flop (didn't bet)
Seat 9: azlots folded before Flop (didn't bet)



PokerStars Hand #228673172951:  Hold'em No Limit ($0.25/$0.50 USD) - 2021/07/30 0:45:06 ET
Table 'Laodamia II' 9-max Seat #5 is the button
Seat 1: I oguz han I ($61.75 in chips) 
Seat 2: SIRCopenhagen ($39.40 in chips) 
Seat 3: D0d027 ($44.09 in chips) 
Seat 4: smurphy123 ($58.88 in chips) 
Seat 5: Jesterclown ($97.57 in chips) 
Seat 6: TR1CKTR1CK ($46.50 in chips) 
Seat 7: xobit26 ($78.30 in chips) 
Seat 9: azlots ($48.70 in chips) 
TR1CKTR1CK: posts small blind $0.25
xobit26: posts big blind $0.50
*** HOLE CARDS ***
azlots: folds 
I oguz han I: folds 
SIRCopenhagen has timed out
SIRCopenhagen: folds 
D0d027: calls $0.50
smurphy123: folds 
Jesterclown: raises $1.50 to $2
TR1CKTR1CK: folds 
xobit26: folds 
D0d027: folds 
Uncalled bet ($1.50) returned to Jesterclown
Jesterclown collected $1.75 from pot
Jesterclown: doesn't show hand 
*** SUMMARY ***
Total pot $1.75 | Rake $0 
Seat 1: I oguz han I folded before Flop (didn't bet)
Seat 2: SIRCopenhagen folded before Flop (didn't bet)
Seat 3: D0d027 folded before Flop
Seat 4: smurphy123 folded before Flop (didn't bet)
Seat 5: Jesterclown (button) collected ($1.75)
Seat 6: TR1CKTR1CK (small blind) folded before Flop
Seat 7: xobit26 (big blind) folded before Flop
Seat 9: azlots folded before Flop (didn't bet)



PokerStars Hand #228673179095:  Hold'em No Limit ($0.25/$0.50 USD) - 2021/07/30 0:45:48 ET
Table 'Laodamia II' 9-max Seat #6 is the button
Seat 1: I oguz han I ($61.75 in chips) 
Seat 2: SIRCopenhagen ($39.40 in chips) 
Seat 3: D0d027 ($43.59 in chips) 
Seat 4: smurphy123 ($58.88 in chips) 
Seat 5: Jesterclown ($98.82 in chips) 
Seat 6: TR1CKTR1CK ($46.25 in chips) 
Seat 7: xobit26 ($77.80 in chips) 
Seat 9: azlots ($48.70 in chips) 
xobit26: posts small blind $0.25
azlots: posts big blind $0.50
*** HOLE CARDS ***
I oguz han I: folds 
SIRCopenhagen: folds 
D0d027: folds 
smurphy123: folds 
Jesterclown: folds 
TR1CKTR1CK: folds 
xobit26: folds 
Uncalled bet ($0.25) returned to azlots
azlots collected $0.50 from pot
azlots: doesn't show hand 
xobit26 leaves the table
*** SUMMARY ***
Total pot $0.50 | Rake $0 
Seat 1: I oguz han I folded before Flop (didn't bet)
Seat 2: SIRCopenhagen folded before Flop (didn't bet)
Seat 3: D0d027 folded before Flop (didn't bet)
Seat 4: smurphy123 folded before Flop (didn't bet)
Seat 5: Jesterclown folded before Flop (didn't bet)
Seat 6: TR1CKTR1CK (button) folded before Flop (didn't bet)
Seat 7: xobit26 (small blind) folded before Flop
Seat 9: azlots (big blind) collected ($0.50)



PokerStars Hand #228673182429:  Hold'em No Limit ($0.25/$0.50 USD) - 2021/07/30 0:46:11 ET
Table 'Laodamia II' 9-max Seat #9 is the button
Seat 1: I oguz han I ($61.75 in chips) 
Seat 2: SIRCopenhagen ($39.40 in chips) 
Seat 3: D0d027 ($43.59 in chips) 
Seat 4: smurphy123 ($58.88 in chips) 
Seat 5: Jesterclown ($98.82 in chips) 
Seat 6: TR1CKTR1CK ($46.25 in chips) 
Seat 9: azlots ($48.95 in chips) 
I oguz han I: posts small blind $0.25
SIRCopenhagen: posts big blind $0.50
*** HOLE CARDS ***
D0d027: folds 
smurphy123: folds 
Jesterclown: folds 
Squall33bdi joins the table at seat #7 
TR1CKTR1CK: folds 
azlots: folds 
I oguz han I: raises $1 to $1.50
SIRCopenhagen: calls $1
*** FLOP *** [4h Td 9h]
I oguz han I: bets $1.50
SIRCopenhagen: folds 
Uncalled bet ($1.50) returned to I oguz han I
I oguz han I collected $2.85 from pot
I oguz han I: doesn't show hand 
*** SUMMARY ***
Total pot $3 | Rake $0.15 
Board [4h Td 9h]
Seat 1: I oguz han I (small blind) collected ($2.85)
Seat 2: SIRCopenhagen (big blind) folded on the Flop
Seat 3: D0d027 folded before Flop (didn't bet)
Seat 4: smurphy123 folded before Flop (didn't bet)
Seat 5: Jesterclown folded before Flop (didn't bet)
Seat 6: TR1CKTR1CK folded before Flop (didn't bet)
Seat 9: azlots (button) folded before Flop (didn't bet)



PokerStars Hand #228673186862:  Hold'em No Limit ($0.25/$0.50 USD) - 2021/07/30 0:46:42 ET
Table 'Laodamia II' 9-max Seat #1 is the button
Seat 1: I oguz han I ($63.10 in chips) 
Seat 2: SIRCopenhagen ($37.90 in chips) 
Seat 3: D0d027 ($43.59 in chips) 
Seat 4: smurphy123 ($58.88 in chips) 
Seat 5: Jesterclown ($98.82 in chips) 
Seat 6: TR1CKTR1CK ($46.25 in chips) 
SIRCopenhagen: posts small blind $0.25
D0d027: posts big blind $0.50
Squall33bdi: sits out 
*** HOLE CARDS ***
smurphy123: folds 
Jesterclown: folds 
TR1CKTR1CK: folds 
I oguz han I: raises $1 to $1.50
SIRCopenhagen: folds 
D0d027: folds 
Uncalled bet ($1) returned to I oguz han I
I oguz han I collected $1.25 from pot
I oguz han I: doesn't show hand 
*** SUMMARY ***
Total pot $1.25 | Rake $0 
Seat 1: I oguz han I (button) collected ($1.25)
Seat 2: SIRCopenhagen (small blind) folded before Flop
Seat 3: D0d027 (big blind) folded before Flop
Seat 4: smurphy123 folded before Flop (didn't bet)
Seat 5: Jesterclown folded before Flop (didn't bet)
Seat 6: TR1CKTR1CK folded before Flop (didn't bet)



PokerStars Hand #228673190642:  Hold'em No Limit ($0.25/$0.50 USD) - 2021/07/30 0:47:08 ET
Table 'Laodamia II' 9-max Seat #2 is the button
Seat 1: I oguz han I ($63.85 in chips) 
Seat 2: SIRCopenhagen ($37.65 in chips) 
Seat 3: D0d027 ($43.09 in chips) 
Seat 4: smurphy123 ($58.88 in chips) 
Seat 5: Jesterclown ($98.82 in chips) 
Seat 6: TR1CKTR1CK ($46.25 in chips) 
D0d027: posts small blind $0.25
smurphy123: posts big blind $0.50
Squall33bdi: sits out 
*** HOLE CARDS ***
Jesterclown: folds 
TR1CKTR1CK: folds 
I oguz han I: raises $1 to $1.50
SIRCopenhagen: folds 
D0d027: folds 
smurphy123: calls $1
*** FLOP *** [Ts 6s 7s]
smurphy123: checks 
I oguz han I: bets $1.50
smurphy123: calls $1.50
*** TURN *** [Ts 6s 7s] [8c]
smurphy123: checks 
I oguz han I: checks 
*** RIVER *** [Ts 6s 7s 8c] [4h]
smurphy123: bets $2.50
I oguz han I: calls $2.50
*** SHOW DOWN ***
smurphy123: shows [Ah Th] (a pair of Tens)
I oguz han I: mucks hand 
smurphy123 collected $10.69 from pot
*** SUMMARY ***
Total pot $11.25 | Rake $0.56 
Board [Ts 6s 7s 8c 4h]
Seat 1: I oguz han I mucked
Seat 2: SIRCopenhagen (button) folded before Flop (didn't bet)
Seat 3: D0d027 (small blind) folded before Flop
Seat 4: smurphy123 (big blind) showed [Ah Th] and won ($10.69) with a pair of Tens
Seat 5: Jesterclown folded before Flop (didn't bet)
Seat 6: TR1CKTR1CK folded before Flop (didn't bet)



PokerStars Hand #228673196587:  Hold'em No Limit ($0.25/$0.50 USD) - 2021/07/30 0:47:50 ET
Table 'Laodamia II' 9-max Seat #3 is the button
Seat 1: I oguz han I ($58.35 in chips) 
Seat 2: SIRCopenhagen ($37.65 in chips) 
Seat 3: D0d027 ($42.84 in chips) 
Seat 4: smurphy123 ($64.07 in chips) 
Seat 5: Jesterclown ($98.82 in chips) 
Seat 6: TR1CKTR1CK ($46.25 in chips) 
Seat 9: azlots ($48.95 in chips) 
smurphy123: posts small blind $0.25
Jesterclown: posts big blind $0.50
Squall33bdi: sits out 
Eagle88888 is disconnected 
Eagle88888 has timed out while disconnected
Eagle88888: is sitting out 
*** HOLE CARDS ***
TR1CKTR1CK: folds 
azlots: raises $1 to $1.50
I oguz han I: folds 
SIRCopenhagen: calls $1.50
D0d027: folds 
smurphy123: folds 
Jesterclown: calls $1
*** FLOP *** [7d 3d Jc]
Jesterclown: checks 
azlots: bets $2.26
SIRCopenhagen: calls $2.26
Jesterclown: folds 
*** TURN *** [7d 3d Jc] [Tc]
azlots: bets $5.50
SIRCopenhagen: calls $5.50
*** RIVER *** [7d 3d Jc Tc] [7c]
azlots: bets $9.63
SIRCopenhagen: folds 
Uncalled bet ($9.63) returned to azlots
azlots collected $19.26 from pot
azlots: doesn't show hand 
*** SUMMARY ***
Total pot $20.27 | Rake $1.01 
Board [7d 3d Jc Tc 7c]
Seat 1: I oguz han I folded before Flop (didn't bet)
Seat 2: SIRCopenhagen folded on the River
Seat 3: D0d027 (button) folded before Flop (didn't bet)
Seat 4: smurphy123 (small blind) folded before Flop
Seat 5: Jesterclown (big blind) folded on the Flop
Seat 6: TR1CKTR1CK folded before Flop (didn't bet)
Seat 9: azlots collected ($19.26)



PokerStars Hand #228673209451:  Hold'em No Limit ($0.25/$0.50 USD) - 2021/07/30 0:49:19 ET
Table 'Laodamia II' 9-max Seat #4 is the button
Seat 1: I oguz han I ($58.35 in chips) 
Seat 2: SIRCopenhagen ($28.39 in chips) 
Seat 3: D0d027 ($42.84 in chips) 
Seat 4: smurphy123 ($63.82 in chips) 
Seat 5: Jesterclown ($97.32 in chips) 
Seat 6: TR1CKTR1CK ($46.25 in chips) 
Seat 9: azlots ($58.95 in chips) 
Jesterclown: posts small blind $0.25
TR1CKTR1CK: posts big blind $0.50
Squall33bdi: sits out 
Eagle88888: sits out 
*** HOLE CARDS ***
azlots: folds 
I oguz han I: folds 
SIRCopenhagen: raises $1 to $1.50
D0d027: folds 
smurphy123: folds 
Jesterclown: folds 
TR1CKTR1CK: folds 
Uncalled bet ($1) returned to SIRCopenhagen
SIRCopenhagen collected $1.25 from pot
SIRCopenhagen: doesn't show hand 
*** SUMMARY ***
Total pot $1.25 | Rake $0 
Seat 1: I oguz han I folded before Flop (didn't bet)
Seat 2: SIRCopenhagen collected ($1.25)
Seat 3: D0d027 folded before Flop (didn't bet)
Seat 4: smurphy123 (button) folded before Flop (didn't bet)
Seat 5: Jesterclown (small blind) folded before Flop
Seat 6: TR1CKTR1CK (big blind) folded before Flop
Seat 9: azlots folded before Flop (didn't bet)



PokerStars Hand #228673213100:  Hold'em No Limit ($0.25/$0.50 USD) - 2021/07/30 0:49:44 ET
Table 'Laodamia II' 9-max Seat #5 is the button
Seat 1: I oguz han I ($58.35 in chips) 
Seat 2: SIRCopenhagen ($29.14 in chips) 
Seat 3: D0d027 ($42.84 in chips) 
Seat 4: smurphy123 ($63.82 in chips) 
Seat 5: Jesterclown ($97.07 in chips) 
Seat 6: TR1CKTR1CK ($45.75 in chips) 
Seat 7: Squall33bdi ($50 in chips) 
Seat 9: azlots ($58.95 in chips) 
TR1CKTR1CK: posts small blind $0.25
Squall33bdi: posts big blind $0.50
Eagle88888 has timed out
Eagle88888: is sitting out 
*** HOLE CARDS ***
Eagle88888 is disconnected 
azlots: folds 
I oguz han I: folds 
SIRCopenhagen: raises $1 to $1.50
D0d027: folds 
smurphy123: calls $1.50
Jesterclown: folds 
TR1CKTR1CK: folds 
Squall33bdi: folds 
*** FLOP *** [Qc 2s 7c]
SIRCopenhagen: bets $2
smurphy123: folds 
Uncalled bet ($2) returned to SIRCopenhagen
SIRCopenhagen collected $3.56 from pot
SIRCopenhagen: doesn't show hand 
*** SUMMARY ***
Total pot $3.75 | Rake $0.19 
Board [Qc 2s 7c]
Seat 1: I oguz han I folded before Flop (didn't bet)
Seat 2: SIRCopenhagen collected ($3.56)
Seat 3: D0d027 folded before Flop (didn't bet)
Seat 4: smurphy123 folded on the Flop
Seat 5: Jesterclown (button) folded before Flop (didn't bet)
Seat 6: TR1CKTR1CK (small blind) folded before Flop
Seat 7: Squall33bdi (big blind) folded before Flop
Seat 9: azlots folded before Flop (didn't bet)



PokerStars Hand #228673219158:  Hold'em No Limit ($0.25/$0.50 USD) - 2021/07/30 0:50:27 ET
Table 'Laodamia II' 9-max Seat #6 is the button
Seat 1: I oguz han I ($58.35 in chips) 
Seat 2: SIRCopenhagen ($31.20 in chips) 
Seat 3: D0d027 ($42.84 in chips) 
Seat 4: smurphy123 ($62.32 in chips) 
Seat 5: Jesterclown ($97.07 in chips) 
Seat 6: TR1CKTR1CK ($45.50 in chips) 
Seat 7: Squall33bdi ($50 in chips) 
Seat 9: azlots ($58.95 in chips) 
Squall33bdi: posts small blind $0.25
azlots: posts big blind $0.50
*** HOLE CARDS ***
I oguz han I: folds 
SIRCopenhagen: calls $0.50
D0d027: calls $0.50
smurphy123: folds 
Jesterclown: folds 
TR1CKTR1CK: folds 
Squall33bdi: folds 
azlots: checks 
*** FLOP *** [6s 9h 8c]
azlots: checks 
SIRCopenhagen: checks 
D0d027: checks 
*** TURN *** [6s 9h 8c] [5h]
azlots: bets $0.83
SIRCopenhagen: folds 
D0d027: calls $0.83
*** RIVER *** [6s 9h 8c 5h] [9d]
azlots: checks 
D0d027: checks 
*** SHOW DOWN ***
azlots: shows [Ah 6d] (two pair, Nines and Sixes)
D0d027: mucks hand 
azlots collected $3.24 from pot
*** SUMMARY ***
Total pot $3.41 | Rake $0.17 
Board [6s 9h 8c 5h 9d]
Seat 1: I oguz han I folded before Flop (didn't bet)
Seat 2: SIRCopenhagen folded on the Turn
Seat 3: D0d027 mucked
Seat 4: smurphy123 folded before Flop (didn't bet)
Seat 5: Jesterclown folded before Flop (didn't bet)
Seat 6: TR1CKTR1CK (button) folded before Flop (didn't bet)
Seat 7: Squall33bdi (small blind) folded before Flop
Seat 9: azlots (big blind) showed [Ah 6d] and won ($3.24) with two pair, Nines and Sixes



PokerStars Hand #228673227807:  Hold'em No Limit ($0.25/$0.50 USD) - 2021/07/30 0:51:26 ET
Table 'Laodamia II' 9-max Seat #7 is the button
Seat 1: I oguz han I ($58.35 in chips) 
Seat 2: SIRCopenhagen ($30.70 in chips) 
Seat 3: D0d027 ($41.51 in chips) 
Seat 4: smurphy123 ($62.32 in chips) 
Seat 5: Jesterclown ($97.07 in chips) 
Seat 6: TR1CKTR1CK ($45.50 in chips) 
Seat 7: Squall33bdi ($50 in chips) 
Seat 9: azlots ($60.86 in chips) 
azlots: posts small blind $0.25
I oguz han I: posts big blind $0.50
*** HOLE CARDS ***
SIRCopenhagen: calls $0.50
D0d027: folds 
smurphy123: folds 
Jesterclown: raises $1.50 to $2
TR1CKTR1CK: folds 
Squall33bdi: calls $2
azlots: folds 
I oguz han I: calls $1.50
SIRCopenhagen: calls $1.50
*** FLOP *** [6h Jh 6s]
I oguz han I: checks 
SIRCopenhagen: checks 
Jesterclown: checks 
Squall33bdi: checks 
*** TURN *** [6h Jh 6s] [8h]
I oguz han I: checks 
SIRCopenhagen: checks 
Jesterclown: checks 
Squall33bdi: checks 
*** RIVER *** [6h Jh 6s 8h] [3h]
I oguz han I: checks 
SIRCopenhagen: checks 
Jesterclown: checks 
Squall33bdi: checks 
*** SHOW DOWN ***
I oguz han I: shows [4s 8s] (two pair, Eights and Sixes)
SIRCopenhagen: shows [Ad 5h] (a flush, Jack high)
Jesterclown: mucks hand 
Squall33bdi: shows [Ac Qh] (a flush, Queen high)
Squall33bdi collected $7.84 from pot
*** SUMMARY ***
Total pot $8.25 | Rake $0.41 
Board [6h Jh 6s 8h 3h]
Seat 1: I oguz han I (big blind) showed [4s 8s] and lost with two pair, Eights and Sixes
Seat 2: SIRCopenhagen showed [Ad 5h] and lost with a flush, Jack high
Seat 3: D0d027 folded before Flop (didn't bet)
Seat 4: smurphy123 folded before Flop (didn't bet)
Seat 5: Jesterclown mucked
Seat 6: TR1CKTR1CK folded before Flop (didn't bet)
Seat 7: Squall33bdi (button) showed [Ac Qh] and won ($7.84) with a flush, Queen high
Seat 9: azlots (small blind) folded before Flop



PokerStars Hand #228673238863:  Hold'em No Limit ($0.25/$0.50 USD) - 2021/07/30 0:52:43 ET
Table 'Laodamia II' 9-max Seat #9 is the button
Seat 1: I oguz han I ($56.35 in chips) 
Seat 2: SIRCopenhagen ($28.70 in chips) 
Seat 3: D0d027 ($41.51 in chips) 
Seat 4: smurphy123 ($62.32 in chips) 
Seat 5: Jesterclown ($95.07 in chips) 
Seat 6: TR1CKTR1CK ($45.50 in chips) 
Seat 7: Squall33bdi ($55.84 in chips) 
Seat 9: azlots ($60.61 in chips) 
I oguz han I: posts small blind $0.25
SIRCopenhagen: posts big blind $0.50
*** HOLE CARDS ***
D0d027: folds 
smurphy123: folds 
Jesterclown: folds 
TR1CKTR1CK: folds 
Squall33bdi: raises $0.75 to $1.25
azlots: folds 
I oguz han I: raises $3.75 to $5
SIRCopenhagen: folds 
Squall33bdi: folds 
Uncalled bet ($3.75) returned to I oguz han I
I oguz han I collected $3 from pot
I oguz han I: doesn't show hand 
*** SUMMARY ***
Total pot $3 | Rake $0 
Seat 1: I oguz han I (small blind) collected ($3)
Seat 2: SIRCopenhagen (big blind) folded before Flop
Seat 3: D0d027 folded before Flop (didn't bet)
Seat 4: smurphy123 folded before Flop (didn't bet)
Seat 5: Jesterclown folded before Flop (didn't bet)
Seat 6: TR1CKTR1CK folded before Flop (didn't bet)
Seat 7: Squall33bdi folded before Flop
Seat 9: azlots (button) folded before Flop (didn't bet)



PokerStars Hand #228673242837:  Hold'em No Limit ($0.25/$0.50 USD) - 2021/07/30 0:53:11 ET
Table 'Laodamia II' 9-max Seat #1 is the button
Seat 1: I oguz han I ($58.10 in chips) 
Seat 2: SIRCopenhagen ($28.20 in chips) 
Seat 3: D0d027 ($41.51 in chips) 
Seat 4: smurphy123 ($62.32 in chips) 
Seat 5: Jesterclown ($95.07 in chips) 
Seat 6: TR1CKTR1CK ($45.50 in chips) 
Seat 7: Squall33bdi ($54.59 in chips) 
Seat 9: azlots ($60.61 in chips) 
SIRCopenhagen: posts small blind $0.25
D0d027: posts big blind $0.50
*** HOLE CARDS ***
smurphy123: folds 
Jesterclown: folds 
TR1CKTR1CK: folds 
Squall33bdi: folds 
azlots: raises $1 to $1.50
I oguz han I: raises $3 to $4.50
SIRCopenhagen: calls $4.25
D0d027: folds 
azlots: folds 
*** FLOP *** [3s 4c 7h]
SIRCopenhagen: bets $5.50
I oguz han I: folds 
Uncalled bet ($5.50) returned to SIRCopenhagen
SIRCopenhagen collected $10.45 from pot
SIRCopenhagen: doesn't show hand 
*** SUMMARY ***
Total pot $11 | Rake $0.55 
Board [3s 4c 7h]
Seat 1: I oguz han I (button) folded on the Flop
Seat 2: SIRCopenhagen (small blind) collected ($10.45)
Seat 3: D0d027 (big blind) folded before Flop
Seat 4: smurphy123 folded before Flop (didn't bet)
Seat 5: Jesterclown folded before Flop (didn't bet)
Seat 6: TR1CKTR1CK folded before Flop (didn't bet)
Seat 7: Squall33bdi folded before Flop (didn't bet)
Seat 9: azlots folded before Flop



PokerStars Hand #228673247488:  Hold'em No Limit ($0.25/$0.50 USD) - 2021/07/30 0:53:43 ET
Table 'Laodamia II' 9-max Seat #2 is the button
Seat 1: I oguz han I ($53.60 in chips) 
Seat 2: SIRCopenhagen ($34.15 in chips) 
Seat 3: D0d027 ($41.01 in chips) 
Seat 4: smurphy123 ($62.32 in chips) 
Seat 5: Jesterclown ($95.07 in chips) 
Seat 6: TR1CKTR1CK ($45.50 in chips) 
Seat 7: Squall33bdi ($54.59 in chips) 
Seat 9: azlots ($59.11 in chips) 
D0d027: posts small blind $0.25
smurphy123: posts big blind $0.50
*** HOLE CARDS ***
Jesterclown: folds 
TR1CKTR1CK: folds 
Squall33bdi: folds 
azlots: raises $0.50 to $1
I oguz han I: folds 
SIRCopenhagen: folds 
D0d027: calls $0.75
smurphy123: folds 
*** FLOP *** [2s 6c 2h]
D0d027: checks 
azlots: bets $1.19
D0d027: calls $1.19
*** TURN *** [2s 6c 2h] [Kc]
D0d027: checks 
azlots: bets $2.32
D0d027: folds 
Uncalled bet ($2.32) returned to azlots
azlots collected $4.64 from pot
azlots: doesn't show hand 
*** SUMMARY ***
Total pot $4.88 | Rake $0.24 
Board [2s 6c 2h Kc]
Seat 1: I oguz han I folded before Flop (didn't bet)
Seat 2: SIRCopenhagen (button) folded before Flop (didn't bet)
Seat 3: D0d027 (small blind) folded on the Turn
Seat 4: smurphy123 (big blind) folded before Flop
Seat 5: Jesterclown folded before Flop (didn't bet)
Seat 6: TR1CKTR1CK folded before Flop (didn't bet)
Seat 7: Squall33bdi folded before Flop (didn't bet)
Seat 9: azlots collected ($4.64)



PokerStars Hand #228673253872:  Hold'em No Limit ($0.25/$0.50 USD) - 2021/07/30 0:54:28 ET
Table 'Laodamia II' 9-max Seat #3 is the button
Seat 1: I oguz han I ($53.60 in chips) 
Seat 2: SIRCopenhagen ($34.15 in chips) 
Seat 3: D0d027 ($38.82 in chips) 
Seat 4: smurphy123 ($61.82 in chips) 
Seat 5: Jesterclown ($95.07 in chips) 
Seat 6: TR1CKTR1CK ($45.50 in chips) 
Seat 7: Squall33bdi ($54.59 in chips) 
Seat 9: azlots ($61.56 in chips) 
smurphy123: posts small blind $0.25
Jesterclown: posts big blind $0.50
*** HOLE CARDS ***
TR1CKTR1CK: folds 
Squall33bdi: folds 
azlots: folds 
I oguz han I: folds 
SIRCopenhagen: folds 
D0d027: raises $1.25 to $1.75
smurphy123: folds 
Jesterclown: folds 
Uncalled bet ($1.25) returned to D0d027
D0d027 collected $1.25 from pot
D0d027: doesn't show hand 
*** SUMMARY ***
Total pot $1.25 | Rake $0 
Seat 1: I oguz han I folded before Flop (didn't bet)
Seat 2: SIRCopenhagen folded before Flop (didn't bet)
Seat 3: D0d027 (button) collected ($1.25)
Seat 4: smurphy123 (small blind) folded before Flop
Seat 5: Jesterclown (big blind) folded before Flop
Seat 6: TR1CKTR1CK folded before Flop (didn't bet)
Seat 7: Squall33bdi folded before Flop (didn't bet)
Seat 9: azlots folded before Flop (didn't bet)



PokerStars Hand #228673257296:  Hold'em No Limit ($0.25/$0.50 USD) - 2021/07/30 0:54:51 ET
Table 'Laodamia II' 9-max Seat #4 is the button
Seat 1: I oguz han I ($53.60 in chips) 
Seat 2: SIRCopenhagen ($34.15 in chips) 
Seat 3: D0d027 ($39.57 in chips) 
Seat 4: smurphy123 ($61.57 in chips) 
Seat 5: Jesterclown ($94.57 in chips) 
Seat 6: TR1CKTR1CK ($45.50 in chips) 
Seat 7: Squall33bdi ($54.59 in chips) 
Seat 9: azlots ($61.56 in chips) 
Jesterclown: posts small blind $0.25
TR1CKTR1CK: posts big blind $0.50
*** HOLE CARDS ***
Squall33bdi: folds 
azlots: folds 
I oguz han I: raises $1 to $1.50
SIRCopenhagen: folds 
D0d027: folds 
smurphy123: folds 
Jesterclown: raises $4 to $5.50
TR1CKTR1CK: folds 
I oguz han I: folds 
Uncalled bet ($4) returned to Jesterclown
Jesterclown collected $3.50 from pot
Jesterclown: doesn't show hand 
*** SUMMARY ***
Total pot $3.50 | Rake $0 
Seat 1: I oguz han I folded before Flop
Seat 2: SIRCopenhagen folded before Flop (didn't bet)
Seat 3: D0d027 folded before Flop (didn't bet)
Seat 4: smurphy123 (button) folded before Flop (didn't bet)
Seat 5: Jesterclown (small blind) collected ($3.50)
Seat 6: TR1CKTR1CK (big blind) folded before Flop
Seat 7: Squall33bdi folded before Flop (didn't bet)
Seat 9: azlots folded before Flop (didn't bet)



PokerStars Hand #228673262118:  Hold'em No Limit ($0.25/$0.50 USD) - 2021/07/30 0:55:28 ET
Table 'Laodamia II' 9-max Seat #5 is the button
Seat 1: I oguz han I ($52.10 in chips) 
Seat 2: SIRCopenhagen ($34.15 in chips) 
Seat 3: D0d027 ($39.57 in chips) 
Seat 4: smurphy123 ($61.57 in chips) 
Seat 5: Jesterclown ($96.57 in chips) 
Seat 6: TR1CKTR1CK ($45 in chips) 
Seat 7: Squall33bdi ($54.59 in chips) 
Seat 9: azlots ($61.56 in chips) 
TR1CKTR1CK: posts small blind $0.25
Squall33bdi: posts big blind $0.50
*** HOLE CARDS ***
azlots: folds 
I oguz han I: folds 
SIRCopenhagen: folds 
D0d027: calls $0.50
smurphy123: folds 
Jesterclown: folds 
TR1CKTR1CK: raises $1.50 to $2
Squall33bdi: folds 
D0d027: calls $1.50
*** FLOP *** [8c Ts 4h]
TR1CKTR1CK: checks 
D0d027: bets $2.50
TR1CKTR1CK: folds 
Uncalled bet ($2.50) returned to D0d027
D0d027 collected $4.28 from pot
D0d027: doesn't show hand 
*** SUMMARY ***
Total pot $4.50 | Rake $0.22 
Board [8c Ts 4h]
Seat 1: I oguz han I folded before Flop (didn't bet)
Seat 2: SIRCopenhagen folded before Flop (didn't bet)
Seat 3: D0d027 collected ($4.28)
Seat 4: smurphy123 folded before Flop (didn't bet)
Seat 5: Jesterclown (button) folded before Flop (didn't bet)
Seat 6: TR1CKTR1CK (small blind) folded on the Flop
Seat 7: Squall33bdi (big blind) folded before Flop
Seat 9: azlots folded before Flop (didn't bet)



PokerStars Hand #228673270163:  Hold'em No Limit ($0.25/$0.50 USD) - 2021/07/30 0:56:33 ET
Table 'Laodamia II' 9-max Seat #6 is the button
Seat 1: I oguz han I ($52.10 in chips) 
Seat 2: SIRCopenhagen ($34.15 in chips) 
Seat 3: D0d027 ($41.85 in chips) 
Seat 4: smurphy123 ($61.57 in chips) 
Seat 5: Jesterclown ($96.57 in chips) 
Seat 6: TR1CKTR1CK ($43 in chips) 
Seat 7: Squall33bdi ($54.09 in chips) 
Seat 8: Eagle88888 ($28.76 in chips) 
Seat 9: azlots ($61.56 in chips) 
Squall33bdi: posts small blind $0.25
Eagle88888: posts big blind $0.50
*** HOLE CARDS ***
azlots: folds 
I oguz han I: folds 
SIRCopenhagen: calls $0.50
D0d027: folds 
smurphy123: folds 
Jesterclown: folds 
TR1CKTR1CK: folds 
Squall33bdi: folds 
Eagle88888: checks 
*** FLOP *** [3h 6s 6d]
Eagle88888: checks 
SIRCopenhagen: bets $0.50
Eagle88888: folds 
Uncalled bet ($0.50) returned to SIRCopenhagen
SIRCopenhagen collected $1.19 from pot
SIRCopenhagen: doesn't show hand 
*** SUMMARY ***
Total pot $1.25 | Rake $0.06 
Board [3h 6s 6d]
Seat 1: I oguz han I folded before Flop (didn't bet)
Seat 2: SIRCopenhagen collected ($1.19)
Seat 3: D0d027 folded before Flop (didn't bet)
Seat 4: smurphy123 folded before Flop (didn't bet)
Seat 5: Jesterclown folded before Flop (didn't bet)
Seat 6: TR1CKTR1CK (button) folded before Flop (didn't bet)
Seat 7: Squall33bdi (small blind) folded before Flop
Seat 8: Eagle88888 (big blind) folded on the Flop
Seat 9: azlots folded before Flop (didn't bet)



PokerStars Hand #228673274198:  Hold'em No Limit ($0.25/$0.50 USD) - 2021/07/30 0:57:05 ET
Table 'Laodamia II' 9-max Seat #7 is the button
Seat 1: I oguz han I ($52.10 in chips) 
Seat 2: SIRCopenhagen ($34.84 in chips) 
Seat 3: D0d027 ($41.85 in chips) 
Seat 4: smurphy123 ($61.57 in chips) 
Seat 5: Jesterclown ($96.57 in chips) 
Seat 6: TR1CKTR1CK ($43 in chips) 
Seat 7: Squall33bdi ($53.84 in chips) 
Seat 8: Eagle88888 ($28.26 in chips) 
Seat 9: azlots ($61.56 in chips) 
Eagle88888: posts small blind $0.25
azlots: posts big blind $0.50
*** HOLE CARDS ***
I oguz han I: folds 
SIRCopenhagen: folds 
D0d027: folds 
smurphy123: folds 
Jesterclown: raises $1 to $1.50
TR1CKTR1CK: folds 
Squall33bdi: folds 
Eagle88888: folds 
azlots: raises $1.50 to $3
Jesterclown: calls $1.50
*** FLOP *** [2h Qd Qs]
Eagle88888 leaves the table
azlots: bets $2.97
Jesterclown: folds 
Uncalled bet ($2.97) returned to azlots
azlots collected $5.94 from pot
azlots: doesn't show hand 
SIRCopenhagen leaves the table
*** SUMMARY ***
Total pot $6.25 | Rake $0.31 
Board [2h Qd Qs]
Seat 1: I oguz han I folded before Flop (didn't bet)
Seat 2: SIRCopenhagen folded before Flop (didn't bet)
Seat 3: D0d027 folded before Flop (didn't bet)
Seat 4: smurphy123 folded before Flop (didn't bet)
Seat 5: Jesterclown folded on the Flop
Seat 6: TR1CKTR1CK folded before Flop (didn't bet)
Seat 7: Squall33bdi (button) folded before Flop (didn't bet)
Seat 8: Eagle88888 (small blind) folded before Flop
Seat 9: azlots (big blind) collected ($5.94)



PokerStars Hand #228673280234:  Hold'em No Limit ($0.25/$0.50 USD) - 2021/07/30 0:57:54 ET
Table 'Laodamia II' 9-max Seat #9 is the button
Seat 1: I oguz han I ($52.10 in chips) 
Seat 3: D0d027 ($41.85 in chips) 
Seat 4: smurphy123 ($61.57 in chips) 
Seat 5: Jesterclown ($93.57 in chips) 
Seat 6: TR1CKTR1CK ($43 in chips) 
Seat 7: Squall33bdi ($53.84 in chips) 
Seat 9: azlots ($64.50 in chips) 
I oguz han I: posts small blind $0.25
D0d027: posts big blind $0.50
*** HOLE CARDS ***
SOLDI MOLDI joins the table at seat #2 
smurphy123: folds 
Jesterclown: folds 
TR1CKTR1CK: folds 
Squall33bdi: raises $0.75 to $1.25
azlots: folds 
I oguz han I: folds 
D0d027: raises $1.25 to $2.50
Squall33bdi: calls $1.25
*** FLOP *** [6c 2h 2c]
D0d027: bets $2.50
Squall33bdi: folds 
Uncalled bet ($2.50) returned to D0d027
D0d027 collected $4.99 from pot
D0d027: doesn't show hand 
*** SUMMARY ***
Total pot $5.25 | Rake $0.26 
Board [6c 2h 2c]
Seat 1: I oguz han I (small blind) folded before Flop
Seat 3: D0d027 (big blind) collected ($4.99)
Seat 4: smurphy123 folded before Flop (didn't bet)
Seat 5: Jesterclown folded before Flop (didn't bet)
Seat 6: TR1CKTR1CK folded before Flop (didn't bet)
Seat 7: Squall33bdi folded on the Flop
Seat 9: azlots (button) folded before Flop (didn't bet)



PokerStars Hand #228673284529:  Hold'em No Limit ($0.25/$0.50 USD) - 2021/07/30 0:58:28 ET
Table 'Laodamia II' 9-max Seat #1 is the button
Seat 1: I oguz han I ($51.85 in chips) 
Seat 3: D0d027 ($44.34 in chips) 
Seat 4: smurphy123 ($61.57 in chips) 
Seat 5: Jesterclown ($93.57 in chips) 
Seat 6: TR1CKTR1CK ($43 in chips) 
Seat 7: Squall33bdi ($51.34 in chips) 
Seat 9: azlots ($64.50 in chips) 
D0d027: posts small blind $0.25
smurphy123: posts big blind $0.50
*** HOLE CARDS ***
Jesterclown: folds 
TR1CKTR1CK: folds 
Squall33bdi: raises $1.25 to $1.75
azlots: folds 
I oguz han I: calls $1.75
D0d027: folds 
smurphy123: raises $5.50 to $7.25
Squall33bdi: calls $5.50
I oguz han I: folds 
*** FLOP *** [8h Th 3c]
smurphy123: bets $7.84
Squall33bdi: calls $7.84
*** TURN *** [8h Th 3c] [Kd]
smurphy123: checks 
Squall33bdi: checks 
*** RIVER *** [8h Th 3c Kd] [8d]
smurphy123: bets $15.29
RayyRayyT joins the table at seat #8 
Squall33bdi: calls $15.29
*** SHOW DOWN ***
smurphy123: shows [Kh Ks] (a full house, Kings full of Eights)
Squall33bdi: mucks hand 
smurphy123 collected $60.76 from pot
*** SUMMARY ***
Total pot $62.76 | Rake $2 
Board [8h Th 3c Kd 8d]
Seat 1: I oguz han I (button) folded before Flop
Seat 3: D0d027 (small blind) folded before Flop
Seat 4: smurphy123 (big blind) showed [Kh Ks] and won ($60.76) with a full house, Kings full of Eights
Seat 5: Jesterclown folded before Flop (didn't bet)
Seat 6: TR1CKTR1CK folded before Flop (didn't bet)
Seat 7: Squall33bdi mucked
Seat 9: azlots folded before Flop (didn't bet)



PokerStars Hand #228673298143:  Hold'em No Limit ($0.25/$0.50 USD) - 2021/07/30 1:00:15 ET
Table 'Laodamia II' 9-max Seat #3 is the button
Seat 1: I oguz han I ($50.10 in chips) 
Seat 3: D0d027 ($44.09 in chips) 
Seat 4: smurphy123 ($91.95 in chips) 
Seat 5: Jesterclown ($93.57 in chips) 
Seat 6: TR1CKTR1CK ($43 in chips) 
Seat 7: Squall33bdi ($50 in chips) 
Seat 9: azlots ($64.50 in chips) 
smurphy123: posts small blind $0.25
Jesterclown: posts big blind $0.50
RayyRayyT: sits out 
SOLDI MOLDI: sits out 
*** HOLE CARDS ***
TR1CKTR1CK: folds 
Squall33bdi: folds 
azlots: folds 
I oguz han I: raises $1 to $1.50
D0d027: folds 
smurphy123: folds 
Jesterclown: calls $1
*** FLOP *** [Tc 2c Qh]
Jesterclown: checks 
I oguz han I: checks 
*** TURN *** [Tc 2c Qh] [As]
Jesterclown: checks 
I oguz han I: checks 
*** RIVER *** [Tc 2c Qh As] [Th]
Jesterclown: checks 
I oguz han I: bets $2.44
Jesterclown: folds 
Uncalled bet ($2.44) returned to I oguz han I
I oguz han I collected $3.09 from pot
I oguz han I: doesn't show hand 
*** SUMMARY ***
Total pot $3.25 | Rake $0.16 
Board [Tc 2c Qh As Th]
Seat 1: I oguz han I collected ($3.09)
Seat 3: D0d027 (button) folded before Flop (didn't bet)
Seat 4: smurphy123 (small blind) folded before Flop
Seat 5: Jesterclown (big blind) folded on the River
Seat 6: TR1CKTR1CK folded before Flop (didn't bet)
Seat 7: Squall33bdi folded before Flop (didn't bet)
Seat 9: azlots folded before Flop (didn't bet)



PokerStars Hand #228673324149:  Hold'em No Limit ($0.25/$0.50 USD) - 2021/07/30 1:01:47 ET
Table 'Laodamia II' 9-max Seat #5 is the button
Seat 1: I oguz han I ($51.69 in chips) 
Seat 3: D0d027 ($44.09 in chips) 
Seat 4: smurphy123 ($91.70 in chips) 
Seat 5: Jesterclown ($91.82 in chips) 
Seat 6: TR1CKTR1CK ($42.50 in chips) 
Seat 7: Squall33bdi ($50 in chips) 
Seat 8: RayyRayyT ($25.14 in chips) 
Seat 9: azlots ($63 in chips) 
TR1CKTR1CK: posts small blind $0.25
Squall33bdi: posts big blind $0.50
SOLDI MOLDI: sits out 
*** HOLE CARDS ***
RayyRayyT: folds 
azlots: raises $1 to $1.50
I oguz han I: raises $3 to $4.50
D0d027: folds 
smurphy123: folds 
Jesterclown: folds 
TR1CKTR1CK: folds 
Squall33bdi: folds 
azlots: calls $3
*** FLOP *** [4d 9s 9h]
azlots: checks 
I oguz han I: bets $3.50
azlots: folds 
Uncalled bet ($3.50) returned to I oguz han I
I oguz han I collected $9.26 from pot
I oguz han I: doesn't show hand 
*** SUMMARY ***
Total pot $9.75 | Rake $0.49 
Board [4d 9s 9h]
Seat 1: I oguz han I collected ($9.26)
Seat 3: D0d027 folded before Flop (didn't bet)
Seat 4: smurphy123 folded before Flop (didn't bet)
Seat 5: Jesterclown (button) folded before Flop (didn't bet)
Seat 6: TR1CKTR1CK (small blind) folded before Flop
Seat 7: Squall33bdi (big blind) folded before Flop
Seat 8: RayyRayyT folded before Flop (didn't bet)
Seat 9: azlots folded on the Flop



PokerStars Hand #228673329163:  Hold'em No Limit ($0.25/$0.50 USD) - 2021/07/30 1:02:24 ET
Table 'Laodamia II' 9-max Seat #6 is the button
Seat 1: I oguz han I ($56.45 in chips) 
Seat 3: D0d027 ($44.09 in chips) 
Seat 4: smurphy123 ($91.70 in chips) 
Seat 5: Jesterclown ($91.82 in chips) 
Seat 6: TR1CKTR1CK ($42.25 in chips) 
Seat 7: Squall33bdi ($50 in chips) 
Seat 8: RayyRayyT ($25.14 in chips) 
Seat 9: azlots ($58.50 in chips) 
Squall33bdi: posts small blind $0.25
RayyRayyT: posts big blind $0.50
SOLDI MOLDI: sits out 
*** HOLE CARDS ***
azlots: folds 
I oguz han I: folds 
D0d027: folds 
smurphy123: folds 
Jesterclown: folds 
TR1CKTR1CK: folds 
Squall33bdi: folds 
Uncalled bet ($0.25) returned to RayyRayyT
RayyRayyT collected $0.50 from pot
RayyRayyT: doesn't show hand 
*** SUMMARY ***
Total pot $0.50 | Rake $0 
Seat 1: I oguz han I folded before Flop (didn't bet)
Seat 3: D0d027 folded before Flop (didn't bet)
Seat 4: smurphy123 folded before Flop (didn't bet)
Seat 5: Jesterclown folded before Flop (didn't bet)
Seat 6: TR1CKTR1CK (button) folded before Flop (didn't bet)
Seat 7: Squall33bdi (small blind) folded before Flop
Seat 8: RayyRayyT (big blind) collected ($0.50)
Seat 9: azlots folded before Flop (didn't bet)



PokerStars Hand #228673342092:  Hold'em No Limit ($0.25/$0.50 USD) - 2021/07/30 1:02:46 ET
Table 'Laodamia II' 9-max Seat #7 is the button
Seat 1: I oguz han I ($56.45 in chips) 
Seat 3: D0d027 ($44.09 in chips) 
Seat 4: smurphy123 ($91.70 in chips) 
Seat 5: Jesterclown ($91.82 in chips) 
Seat 6: TR1CKTR1CK ($42.25 in chips) 
Seat 7: Squall33bdi ($50 in chips) 
Seat 8: RayyRayyT ($25.39 in chips) 
Seat 9: azlots ($58.50 in chips) 
RayyRayyT: posts small blind $0.25
azlots: posts big blind $0.50
SOLDI MOLDI: sits out 
*** HOLE CARDS ***
I oguz han I: raises $1 to $1.50
D0d027 has timed out
D0d027: folds 
smurphy123: folds 
Jesterclown: folds 
TR1CKTR1CK: folds 
Squall33bdi: calls $1.50
RayyRayyT: calls $1.25
azlots: folds 
*** FLOP *** [7c 3s 3c]
RayyRayyT: checks 
I oguz han I: checks 
Squall33bdi: checks 
*** TURN *** [7c 3s 3c] [Jh]
RayyRayyT: checks 
I oguz han I: checks 
Squall33bdi: checks 
*** RIVER *** [7c 3s 3c Jh] [8c]
RayyRayyT: bets $2.37
I oguz han I: folds 
Squall33bdi: folds 
Uncalled bet ($2.37) returned to RayyRayyT
RayyRayyT collected $4.75 from pot
RayyRayyT: doesn't show hand 
*** SUMMARY ***
Total pot $5 | Rake $0.25 
Board [7c 3s 3c Jh 8c]
Seat 1: I oguz han I folded on the River
Seat 3: D0d027 folded before Flop (didn't bet)
Seat 4: smurphy123 folded before Flop (didn't bet)
Seat 5: Jesterclown folded before Flop (didn't bet)
Seat 6: TR1CKTR1CK folded before Flop (didn't bet)
Seat 7: Squall33bdi (button) folded on the River
Seat 8: RayyRayyT (small blind) collected ($4.75)
Seat 9: azlots (big blind) folded before Flop



PokerStars Hand #228673351775:  Hold'em No Limit ($0.25/$0.50 USD) - 2021/07/30 1:03:55 ET
Table 'Laodamia II' 9-max Seat #8 is the button
Seat 1: I oguz han I ($54.95 in chips) 
Seat 3: D0d027 ($44.09 in chips) 
Seat 4: smurphy123 ($91.70 in chips) 
Seat 5: Jesterclown ($91.82 in chips) 
Seat 6: TR1CKTR1CK ($42.25 in chips) 
Seat 7: Squall33bdi ($50 in chips) 
Seat 8: RayyRayyT ($28.64 in chips) 
Seat 9: azlots ($58 in chips) 
azlots: posts small blind $0.25
I oguz han I: posts big blind $0.50
SOLDI MOLDI: sits out 
*** HOLE CARDS ***
D0d027: calls $0.50
smurphy123: folds 
Jesterclown: folds 
TR1CKTR1CK: folds 
Squall33bdi: folds 
RayyRayyT: calls $0.50
azlots: raises $1 to $1.50
I oguz han I: folds 
D0d027: calls $1
RayyRayyT: calls $1
*** FLOP *** [Js Ks 4d]
azlots: bets $2.38
D0d027: folds 
RayyRayyT: calls $2.38
*** TURN *** [Js Ks 4d] [5d]
azlots: checks 
RayyRayyT: checks 
*** RIVER *** [Js Ks 4d 5d] [5s]
azlots: checks 
RayyRayyT: bets $4.63
azlots: folds 
Uncalled bet ($4.63) returned to RayyRayyT
RayyRayyT collected $9.27 from pot
RayyRayyT: doesn't show hand 
*** SUMMARY ***
Total pot $9.76 | Rake $0.49 
Board [Js Ks 4d 5d 5s]
Seat 1: I oguz han I (big blind) folded before Flop
Seat 3: D0d027 folded on the Flop
Seat 4: smurphy123 folded before Flop (didn't bet)
Seat 5: Jesterclown folded before Flop (didn't bet)
Seat 6: TR1CKTR1CK folded before Flop (didn't bet)
Seat 7: Squall33bdi folded before Flop (didn't bet)
Seat 8: RayyRayyT (button) collected ($9.27)
Seat 9: azlots (small blind) folded on the River



PokerStars Hand #228673358562:  Hold'em No Limit ($0.25/$0.50 USD) - 2021/07/30 1:04:43 ET
Table 'Laodamia II' 9-max Seat #9 is the button
Seat 1: I oguz han I ($54.45 in chips) 
Seat 2: SOLDI MOLDI ($50 in chips) 
Seat 3: D0d027 ($42.59 in chips) 
Seat 4: smurphy123 ($91.70 in chips) 
Seat 5: Jesterclown ($91.82 in chips) 
Seat 6: TR1CKTR1CK ($42.25 in chips) 
Seat 7: Squall33bdi ($50 in chips) 
Seat 8: RayyRayyT ($34.03 in chips) 
Seat 9: azlots ($54.12 in chips) 
I oguz han I: posts small blind $0.25
SOLDI MOLDI: posts big blind $0.50
*** HOLE CARDS ***
D0d027: calls $0.50
smurphy123: folds 
Jesterclown: folds 
TR1CKTR1CK: folds 
Squall33bdi: folds 
RayyRayyT: calls $0.50
azlots: folds 
I oguz han I: calls $0.25
SOLDI MOLDI: checks 
*** FLOP *** [5d 2d 6d]
I oguz han I: checks 
SOLDI MOLDI: checks 
D0d027: bets $1
RayyRayyT: folds 
I oguz han I: calls $1
SOLDI MOLDI: folds 
*** TURN *** [5d 2d 6d] [Js]
I oguz han I: checks 
D0d027: bets $1.50
I oguz han I: calls $1.50
*** RIVER *** [5d 2d 6d Js] [5s]
I oguz han I: checks 
D0d027: checks 
*** SHOW DOWN ***
I oguz han I: shows [Qd 8h] (a pair of Fives)
D0d027: shows [6c 4c] (two pair, Sixes and Fives)
D0d027 collected $6.65 from pot
*** SUMMARY ***
Total pot $7 | Rake $0.35 
Board [5d 2d 6d Js 5s]
Seat 1: I oguz han I (small blind) showed [Qd 8h] and lost with a pair of Fives
Seat 2: SOLDI MOLDI (big blind) folded on the Flop
Seat 3: D0d027 showed [6c 4c] and won ($6.65) with two pair, Sixes and Fives
Seat 4: smurphy123 folded before Flop (didn't bet)
Seat 5: Jesterclown folded before Flop (didn't bet)
Seat 6: TR1CKTR1CK folded before Flop (didn't bet)
Seat 7: Squall33bdi folded before Flop (didn't bet)
Seat 8: RayyRayyT folded on the Flop
Seat 9: azlots (button) folded before Flop (didn't bet)



PokerStars Hand #228673365293:  Hold'em No Limit ($0.25/$0.50 USD) - 2021/07/30 1:05:31 ET
Table 'Laodamia II' 9-max Seat #1 is the button
Seat 1: I oguz han I ($51.45 in chips) 
Seat 2: SOLDI MOLDI ($50 in chips) 
Seat 3: D0d027 ($46.24 in chips) 
Seat 4: smurphy123 ($91.70 in chips) 
Seat 5: Jesterclown ($91.82 in chips) 
Seat 6: TR1CKTR1CK ($42.25 in chips) 
Seat 7: Squall33bdi ($50 in chips) 
Seat 8: RayyRayyT ($33.53 in chips) 
Seat 9: azlots ($54.12 in chips) 
SOLDI MOLDI: posts small blind $0.25
D0d027: posts big blind $0.50
*** HOLE CARDS ***
smurphy123: folds 
Jesterclown: folds 
TR1CKTR1CK: folds 
Squall33bdi: raises $1 to $1.50
RayyRayyT: calls $1.50
azlots: calls $1.50
smurphy123 leaves the table
I oguz han I: folds 
SOLDI MOLDI: folds 
D0d027: folds 
*** FLOP *** [5c Qh 2d]
Squall33bdi: checks 
RayyRayyT: checks 
azlots: bets $2.50
rovara joins the table at seat #4 
Squall33bdi: calls $2.50
RayyRayyT: folds 
*** TURN *** [5c Qh 2d] [8d]
Squall33bdi: checks 
azlots: bets $5
Squall33bdi: calls $5
*** RIVER *** [5c Qh 2d 8d] [9c]
Squall33bdi: checks 
azlots: checks 
*** SHOW DOWN ***
Squall33bdi: shows [Td Ts] (a pair of Tens)
azlots: mucks hand 
Squall33bdi collected $19.24 from pot
*** SUMMARY ***
Total pot $20.25 | Rake $1.01 
Board [5c Qh 2d 8d 9c]
Seat 1: I oguz han I (button) folded before Flop (didn't bet)
Seat 2: SOLDI MOLDI (small blind) folded before Flop
Seat 3: D0d027 (big blind) folded before Flop
Seat 4: smurphy123 folded before Flop (didn't bet)
Seat 5: Jesterclown folded before Flop (didn't bet)
Seat 6: TR1CKTR1CK folded before Flop (didn't bet)
Seat 7: Squall33bdi showed [Td Ts] and won ($19.24) with a pair of Tens
Seat 8: RayyRayyT folded on the Flop
Seat 9: azlots mucked



PokerStars Hand #228673375060:  Hold'em No Limit ($0.25/$0.50 USD) - 2021/07/30 1:06:41 ET
Table 'Laodamia II' 9-max Seat #2 is the button
Seat 1: I oguz han I ($51.45 in chips) 
Seat 2: SOLDI MOLDI ($50 in chips) 
Seat 3: D0d027 ($45.74 in chips) 
Seat 4: rovara ($59.85 in chips) 
Seat 5: Jesterclown ($91.82 in chips) 
Seat 6: TR1CKTR1CK ($42.25 in chips) 
Seat 7: Squall33bdi ($60.24 in chips) 
Seat 8: RayyRayyT ($32.03 in chips) 
Seat 9: azlots ($45.12 in chips) 
D0d027: posts small blind $0.25
rovara: posts big blind $0.50
*** HOLE CARDS ***
Jesterclown: folds 
TR1CKTR1CK: folds 
Squall33bdi: folds 
RayyRayyT: calls $0.50
azlots: folds 
I oguz han I: folds 
SOLDI MOLDI: raises $1.50 to $2
D0d027: folds 
rovara: folds 
RayyRayyT: calls $1.50
*** FLOP *** [Kh Th Ad]
RayyRayyT: checks 
SOLDI MOLDI: bets $3
RayyRayyT: raises $3 to $6
SOLDI MOLDI: calls $3
*** TURN *** [Kh Th Ad] [Qh]
RayyRayyT: bets $24.03 and is all-in
SOLDI MOLDI: calls $24.03
*** RIVER *** [Kh Th Ad Qh] [6s]
*** SHOW DOWN ***
RayyRayyT: shows [2d Kc] (a pair of Kings)
SOLDI MOLDI: shows [Ac Js] (a straight, Ten to Ace)
SOLDI MOLDI cashed out the hand for $60.05 | Cash Out Fee $0.61
*** SUMMARY ***
Total pot $64.81 | Rake $2 
Board [Kh Th Ad Qh 6s]
Seat 1: I oguz han I folded before Flop (didn't bet)
Seat 2: SOLDI MOLDI (button) showed [Ac Js] and won ($62.81) with a straight, Ten to Ace (pot not awarded as player cashed out)
Seat 3: D0d027 (small blind) folded before Flop
Seat 4: rovara (big blind) folded before Flop
Seat 5: Jesterclown folded before Flop (didn't bet)
Seat 6: TR1CKTR1CK folded before Flop (didn't bet)
Seat 7: Squall33bdi folded before Flop (didn't bet)
Seat 8: RayyRayyT showed [2d Kc] and lost with a pair of Kings
Seat 9: azlots folded before Flop (didn't bet)



PokerStars Hand #228673383960:  Hold'em No Limit ($0.25/$0.50 USD) - 2021/07/30 1:07:45 ET
Table 'Laodamia II' 9-max Seat #3 is the button
Seat 1: I oguz han I ($51.45 in chips) 
Seat 2: SOLDI MOLDI ($78.02 in chips) 
Seat 3: D0d027 ($45.49 in chips) 
Seat 4: rovara ($59.35 in chips) 
Seat 5: Jesterclown ($91.82 in chips) 
Seat 6: TR1CKTR1CK ($42.25 in chips) 
Seat 7: Squall33bdi ($60.24 in chips) 
Seat 9: azlots ($45.12 in chips) 
rovara: posts small blind $0.25
Jesterclown: posts big blind $0.50
*** HOLE CARDS ***
TR1CKTR1CK: folds 
Squall33bdi: folds 
azlots: folds 
I oguz han I: raises $1 to $1.50
SOLDI MOLDI: folds 
D0d027: folds 
rovara: folds 
Jesterclown: folds 
Uncalled bet ($1) returned to I oguz han I
I oguz han I collected $1.25 from pot
I oguz han I: doesn't show hand 
*** SUMMARY ***
Total pot $1.25 | Rake $0 
Seat 1: I oguz han I collected ($1.25)
Seat 2: SOLDI MOLDI folded before Flop (didn't bet)
Seat 3: D0d027 (button) folded before Flop (didn't bet)
Seat 4: rovara (small blind) folded before Flop
Seat 5: Jesterclown (big blind) folded before Flop
Seat 6: TR1CKTR1CK folded before Flop (didn't bet)
Seat 7: Squall33bdi folded before Flop (didn't bet)
Seat 9: azlots folded before Flop (didn't bet)



PokerStars Hand #228673388450:  Hold'em No Limit ($0.25/$0.50 USD) - 2021/07/30 1:08:17 ET
Table 'Laodamia II' 9-max Seat #4 is the button
Seat 1: I oguz han I ($52.20 in chips) 
Seat 2: SOLDI MOLDI ($78.02 in chips) 
Seat 3: D0d027 ($45.49 in chips) 
Seat 4: rovara ($59.10 in chips) 
Seat 5: Jesterclown ($91.32 in chips) 
Seat 6: TR1CKTR1CK ($42.25 in chips) 
Seat 7: Squall33bdi ($60.24 in chips) 
Seat 9: azlots ($45.12 in chips) 
Jesterclown: posts small blind $0.25
TR1CKTR1CK: posts big blind $0.50
*** HOLE CARDS ***
Squall33bdi: folds 
azlots: raises $1 to $1.50
I oguz han I: folds 
SOLDI MOLDI: folds 
D0d027: folds 
rovara: folds 
Jesterclown: raises $4 to $5.50
TR1CKTR1CK: folds 
azlots: folds 
Uncalled bet ($4) returned to Jesterclown
Jesterclown collected $3.50 from pot
Jesterclown: doesn't show hand 
*** SUMMARY ***
Total pot $3.50 | Rake $0 
Seat 1: I oguz han I folded before Flop (didn't bet)
Seat 2: SOLDI MOLDI folded before Flop (didn't bet)
Seat 3: D0d027 folded before Flop (didn't bet)
Seat 4: rovara (button) folded before Flop (didn't bet)
Seat 5: Jesterclown (small blind) collected ($3.50)
Seat 6: TR1CKTR1CK (big blind) folded before Flop
Seat 7: Squall33bdi folded before Flop (didn't bet)
Seat 9: azlots folded before Flop



PokerStars Hand #228673395328:  Hold'em No Limit ($0.25/$0.50 USD) - 2021/07/30 1:09:05 ET
Table 'Laodamia II' 9-max Seat #5 is the button
Seat 1: I oguz han I ($52.20 in chips) 
Seat 2: SOLDI MOLDI ($78.02 in chips) 
Seat 3: D0d027 ($45.49 in chips) 
Seat 4: rovara ($59.10 in chips) 
Seat 5: Jesterclown ($93.32 in chips) 
Seat 6: TR1CKTR1CK ($41.75 in chips) 
Seat 7: Squall33bdi ($60.24 in chips) 
Seat 9: azlots ($43.62 in chips) 
TR1CKTR1CK: posts small blind $0.25
Squall33bdi: posts big blind $0.50
*** HOLE CARDS ***
azlots: raises $1 to $1.50
I oguz han I: calls $1.50
SOLDI MOLDI: folds 
D0d027: folds 
rovara: folds 
Jesterclown: folds 
TR1CKTR1CK: folds 
Squall33bdi: folds 
*** FLOP *** [7s 6h 8c]
azlots: bets $1.78
I oguz han I: calls $1.78
*** TURN *** [7s 6h 8c] [3d]
azlots: checks 
I oguz han I: bets $2.29
azlots: calls $2.29
*** RIVER *** [7s 6h 8c 3d] [7h]
azlots: checks 
I oguz han I: checks 
*** SHOW DOWN ***
azlots: shows [Ad Qc] (a pair of Sevens)
I oguz han I: shows [Qh Ah] (a pair of Sevens)
azlots collected $5.65 from pot
I oguz han I collected $5.65 from pot
*** SUMMARY ***
Total pot $11.89 | Rake $0.59 
Board [7s 6h 8c 3d 7h]
Seat 1: I oguz han I showed [Qh Ah] and won ($5.65) with a pair of Sevens
Seat 2: SOLDI MOLDI folded before Flop (didn't bet)
Seat 3: D0d027 folded before Flop (didn't bet)
Seat 4: rovara folded before Flop (didn't bet)
Seat 5: Jesterclown (button) folded before Flop (didn't bet)
Seat 6: TR1CKTR1CK (small blind) folded before Flop
Seat 7: Squall33bdi (big blind) folded before Flop
Seat 9: azlots showed [Ad Qc] and won ($5.65) with a pair of Sevens



PokerStars Hand #228673401274:  Hold'em No Limit ($0.25/$0.50 USD) - 2021/07/30 1:09:48 ET
Table 'Laodamia II' 9-max Seat #6 is the button
Seat 1: I oguz han I ($52.28 in chips) 
Seat 2: SOLDI MOLDI ($78.02 in chips) 
Seat 3: D0d027 ($45.49 in chips) 
Seat 4: rovara ($59.10 in chips) 
Seat 5: Jesterclown ($93.32 in chips) 
Seat 6: TR1CKTR1CK ($41.50 in chips) 
Seat 7: Squall33bdi ($59.74 in chips) 
Seat 8: RayyRayyT ($31.16 in chips) 
Seat 9: azlots ($43.70 in chips) 
Squall33bdi: posts small blind $0.25
RayyRayyT: posts big blind $0.50
*** HOLE CARDS ***
azlots: folds 
I oguz han I: raises $0.75 to $1.25
SOLDI MOLDI: folds 
D0d027: folds 
rovara: folds 
Jesterclown: folds 
TR1CKTR1CK: folds 
Squall33bdi: folds 
RayyRayyT: calls $0.75
*** FLOP *** [6s As 9c]
RayyRayyT: checks 
I oguz han I: bets $1.50
RayyRayyT: folds 
Uncalled bet ($1.50) returned to I oguz han I
I oguz han I collected $2.61 from pot
I oguz han I: doesn't show hand 
*** SUMMARY ***
Total pot $2.75 | Rake $0.14 
Board [6s As 9c]
Seat 1: I oguz han I collected ($2.61)
Seat 2: SOLDI MOLDI folded before Flop (didn't bet)
Seat 3: D0d027 folded before Flop (didn't bet)
Seat 4: rovara folded before Flop (didn't bet)
Seat 5: Jesterclown folded before Flop (didn't bet)
Seat 6: TR1CKTR1CK (button) folded before Flop (didn't bet)
Seat 7: Squall33bdi (small blind) folded before Flop
Seat 8: RayyRayyT (big blind) folded on the Flop
Seat 9: azlots folded before Flop (didn't bet)



PokerStars Hand #228673405183:  Hold'em No Limit ($0.25/$0.50 USD) - 2021/07/30 1:10:16 ET
Table 'Laodamia II' 9-max Seat #7 is the button
Seat 1: I oguz han I ($53.64 in chips) 
Seat 2: SOLDI MOLDI ($78.02 in chips) 
Seat 3: D0d027 ($45.49 in chips) 
Seat 4: rovara ($59.10 in chips) 
Seat 5: Jesterclown ($93.32 in chips) 
Seat 6: TR1CKTR1CK ($41.50 in chips) 
Seat 7: Squall33bdi ($59.49 in chips) 
Seat 8: RayyRayyT ($29.91 in chips) 
Seat 9: azlots ($43.70 in chips) 
RayyRayyT: posts small blind $0.25
azlots: posts big blind $0.50
*** HOLE CARDS ***
I oguz han I: raises $0.75 to $1.25
SOLDI MOLDI: folds 
D0d027: calls $1.25
rovara: folds 
Jesterclown: folds 
TR1CKTR1CK: folds 
Squall33bdi: folds 
RayyRayyT: calls $1
azlots: calls $0.75
*** FLOP *** [Ac Jh 4h]
RayyRayyT: checks 
azlots: checks 
I oguz han I: checks 
D0d027: bets $4.75
RayyRayyT: calls $4.75
azlots: folds 
I oguz han I: folds 
*** TURN *** [Ac Jh 4h] [9c]
RayyRayyT: checks 
D0d027: bets $8
RayyRayyT: raises $8 to $16
D0d027: raises $11.50 to $27.50
RayyRayyT: calls $7.91 and is all-in
Uncalled bet ($3.59) returned to D0d027
*** RIVER *** [Ac Jh 4h 9c] [8h]
*** SHOW DOWN ***
RayyRayyT: shows [Jd 4d] (two pair, Jacks and Fours)
D0d027: shows [As Ah] (three of a kind, Aces)
D0d027 collected $60.32 from pot
*** SUMMARY ***
Total pot $62.32 | Rake $2 
Board [Ac Jh 4h 9c 8h]
Seat 1: I oguz han I folded on the Flop
Seat 2: SOLDI MOLDI folded before Flop (didn't bet)
Seat 3: D0d027 showed [As Ah] and won ($60.32) with three of a kind, Aces
Seat 4: rovara folded before Flop (didn't bet)
Seat 5: Jesterclown folded before Flop (didn't bet)
Seat 6: TR1CKTR1CK folded before Flop (didn't bet)
Seat 7: Squall33bdi (button) folded before Flop (didn't bet)
Seat 8: RayyRayyT (small blind) showed [Jd 4d] and lost with two pair, Jacks and Fours
Seat 9: azlots (big blind) folded on the Flop



PokerStars Hand #228673417343:  Hold'em No Limit ($0.25/$0.50 USD) - 2021/07/30 1:11:42 ET
Table 'Laodamia II' 9-max Seat #9 is the button
Seat 1: I oguz han I ($52.39 in chips) 
Seat 2: SOLDI MOLDI ($78.02 in chips) 
Seat 3: D0d027 ($75.90 in chips) 
Seat 4: rovara ($59.10 in chips) 
Seat 5: Jesterclown ($93.32 in chips) 
Seat 6: TR1CKTR1CK ($41.50 in chips) 
Seat 7: Squall33bdi ($59.49 in chips) 
Seat 9: azlots ($42.45 in chips) 
I oguz han I: posts small blind $0.25
SOLDI MOLDI: posts big blind $0.50
*** HOLE CARDS ***
RayyRayyT is disconnected 
D0d027: folds 
rovara: folds 
Jesterclown: folds 
TR1CKTR1CK: folds 
Squall33bdi: raises $0.75 to $1.25
azlots: folds 
D0d027 leaves the table
I oguz han I: folds 
Echomk joins the table at seat #3 
SOLDI MOLDI: calls $0.75
*** FLOP *** [3s 9h Kd]
SOLDI MOLDI: checks 
Squall33bdi: checks 
*** TURN *** [3s 9h Kd] [Kc]
SOLDI MOLDI: checks 
Squall33bdi: bets $0.86
SOLDI MOLDI: folds 
Uncalled bet ($0.86) returned to Squall33bdi
Squall33bdi collected $2.61 from pot
Squall33bdi: doesn't show hand 
*** SUMMARY ***
Total pot $2.75 | Rake $0.14 
Board [3s 9h Kd Kc]
Seat 1: I oguz han I (small blind) folded before Flop
Seat 2: SOLDI MOLDI (big blind) folded on the Turn
Seat 3: D0d027 folded before Flop (didn't bet)
Seat 4: rovara folded before Flop (didn't bet)
Seat 5: Jesterclown folded before Flop (didn't bet)
Seat 6: TR1CKTR1CK folded before Flop (didn't bet)
Seat 7: Squall33bdi collected ($2.61)
Seat 9: azlots (button) folded before Flop (didn't bet)



PokerStars Hand #228673425755:  Hold'em No Limit ($0.25/$0.50 USD) - 2021/07/30 1:12:43 ET
Table 'Laodamia II' 9-max Seat #1 is the button
Seat 1: I oguz han I ($52.14 in chips) 
Seat 2: SOLDI MOLDI ($76.77 in chips) 
Seat 3: Echomk ($50 in chips) 
Seat 4: rovara ($59.10 in chips) 
Seat 5: Jesterclown ($93.32 in chips) 
Seat 6: TR1CKTR1CK ($41.50 in chips) 
Seat 7: Squall33bdi ($60.85 in chips) 
Seat 9: azlots ($42.45 in chips) 
SOLDI MOLDI: posts small blind $0.25
Echomk: posts big blind $0.50
*** HOLE CARDS ***
rovara: raises $0.75 to $1.25
Jesterclown: folds 
TR1CKTR1CK: folds 
Squall33bdi: calls $1.25
azlots: calls $1.25
I oguz han I: folds 
SOLDI MOLDI: folds 
Echomk: calls $0.75
*** FLOP *** [6d 5s 3s]
Echomk: checks 
rovara: checks 
Squall33bdi: bets $2.54
azlots: folds 
Echomk: folds 
rovara: folds 
Uncalled bet ($2.54) returned to Squall33bdi
Squall33bdi collected $4.99 from pot
Squall33bdi: doesn't show hand 
*** SUMMARY ***
Total pot $5.25 | Rake $0.26 
Board [6d 5s 3s]
Seat 1: I oguz han I (button) folded before Flop (didn't bet)
Seat 2: SOLDI MOLDI (small blind) folded before Flop
Seat 3: Echomk (big blind) folded on the Flop
Seat 4: rovara folded on the Flop
Seat 5: Jesterclown folded before Flop (didn't bet)
Seat 6: TR1CKTR1CK folded before Flop (didn't bet)
Seat 7: Squall33bdi collected ($4.99)
Seat 9: azlots folded on the Flop



PokerStars Hand #228673432355:  Hold'em No Limit ($0.25/$0.50 USD) - 2021/07/30 1:13:31 ET
Table 'Laodamia II' 9-max Seat #2 is the button
Seat 1: I oguz han I ($52.14 in chips) 
Seat 2: SOLDI MOLDI ($76.52 in chips) 
Seat 3: Echomk ($50 in chips) 
Seat 4: rovara ($57.85 in chips) 
Seat 5: Jesterclown ($93.32 in chips) 
Seat 6: TR1CKTR1CK ($41.50 in chips) 
Seat 7: Squall33bdi ($64.59 in chips) 
Seat 9: azlots ($41.20 in chips) 
Echomk: posts small blind $0.25
rovara: posts big blind $0.50
*** HOLE CARDS ***
Jesterclown: folds 
TR1CKTR1CK: folds 
Squall33bdi: raises $1 to $1.50
azlots: folds 
I oguz han I: raises $3.50 to $5
SOLDI MOLDI: folds 
Echomk: folds 
rovara: folds 
Squall33bdi: folds 
Uncalled bet ($3.50) returned to I oguz han I
I oguz han I collected $3.75 from pot
I oguz han I: doesn't show hand 
*** SUMMARY ***
Total pot $3.75 | Rake $0 
Seat 1: I oguz han I collected ($3.75)
Seat 2: SOLDI MOLDI (button) folded before Flop (didn't bet)
Seat 3: Echomk (small blind) folded before Flop
Seat 4: rovara (big blind) folded before Flop
Seat 5: Jesterclown folded before Flop (didn't bet)
Seat 6: TR1CKTR1CK folded before Flop (didn't bet)
Seat 7: Squall33bdi folded before Flop
Seat 9: azlots folded before Flop (didn't bet)



PokerStars Hand #228673436473:  Hold'em No Limit ($0.25/$0.50 USD) - 2021/07/30 1:14:00 ET
Table 'Laodamia II' 9-max Seat #3 is the button
Seat 1: I oguz han I ($54.39 in chips) 
Seat 2: SOLDI MOLDI ($76.52 in chips) 
Seat 3: Echomk ($50 in chips) 
Seat 4: rovara ($57.35 in chips) 
Seat 5: Jesterclown ($93.32 in chips) 
Seat 6: TR1CKTR1CK ($41.50 in chips) 
Seat 7: Squall33bdi ($63.09 in chips) 
Seat 9: azlots ($41.20 in chips) 
rovara: posts small blind $0.25
Jesterclown: posts big blind $0.50
*** HOLE CARDS ***
TR1CKTR1CK: folds 
Squall33bdi: folds 
azlots: folds 
I oguz han I: folds 
SOLDI MOLDI: folds 
Echomk: raises $0.75 to $1.25
rovara: folds 
Jesterclown: folds 
Uncalled bet ($0.75) returned to Echomk
Echomk collected $1.25 from pot
Echomk: doesn't show hand 
*** SUMMARY ***
Total pot $1.25 | Rake $0 
Seat 1: I oguz han I folded before Flop (didn't bet)
Seat 2: SOLDI MOLDI folded before Flop (didn't bet)
Seat 3: Echomk (button) collected ($1.25)
Seat 4: rovara (small blind) folded before Flop
Seat 5: Jesterclown (big blind) folded before Flop
Seat 6: TR1CKTR1CK folded before Flop (didn't bet)
Seat 7: Squall33bdi folded before Flop (didn't bet)
Seat 9: azlots folded before Flop (didn't bet)



PokerStars Hand #228673439908:  Hold'em No Limit ($0.25/$0.50 USD) - 2021/07/30 1:14:25 ET
Table 'Laodamia II' 9-max Seat #4 is the button
Seat 1: I oguz han I ($54.39 in chips) 
Seat 2: SOLDI MOLDI ($76.52 in chips) 
Seat 3: Echomk ($50.75 in chips) 
Seat 4: rovara ($57.10 in chips) 
Seat 5: Jesterclown ($92.82 in chips) 
Seat 6: TR1CKTR1CK ($41.50 in chips) 
Seat 7: Squall33bdi ($63.09 in chips) 
Seat 9: azlots ($41.20 in chips) 
Jesterclown: posts small blind $0.25
TR1CKTR1CK: posts big blind $0.50
*** HOLE CARDS ***
Squall33bdi: folds 
azlots: raises $1 to $1.50
I oguz han I: folds 
SOLDI MOLDI: folds 
Echomk: folds 
rovara: folds 
Jesterclown: folds 
TR1CKTR1CK: folds 
Uncalled bet ($1) returned to azlots
azlots collected $1.25 from pot
azlots: doesn't show hand 
*** SUMMARY ***
Total pot $1.25 | Rake $0 
Seat 1: I oguz han I folded before Flop (didn't bet)
Seat 2: SOLDI MOLDI folded before Flop (didn't bet)
Seat 3: Echomk folded before Flop (didn't bet)
Seat 4: rovara (button) folded before Flop (didn't bet)
Seat 5: Jesterclown (small blind) folded before Flop
Seat 6: TR1CKTR1CK (big blind) folded before Flop
Seat 7: Squall33bdi folded before Flop (didn't bet)
Seat 9: azlots collected ($1.25)



PokerStars Hand #228673445658:  Hold'em No Limit ($0.25/$0.50 USD) - 2021/07/30 1:15:07 ET
Table 'Laodamia II' 9-max Seat #5 is the button
Seat 1: I oguz han I ($54.39 in chips) 
Seat 2: SOLDI MOLDI ($76.52 in chips) 
Seat 3: Echomk ($50.75 in chips) 
Seat 4: rovara ($57.10 in chips) 
Seat 5: Jesterclown ($92.57 in chips) 
Seat 6: TR1CKTR1CK ($41 in chips) 
Seat 9: azlots ($41.95 in chips) 
TR1CKTR1CK: posts small blind $0.25
Squall33bdi: is sitting out 
Squall33bdi leaves the table
azlots: posts big blind $0.50
*** HOLE CARDS ***
I oguz han I: raises $1 to $1.50
SOLDI MOLDI: folds 
Echomk: folds 
rovara: folds 
Jesterclown: calls $1.50
TR1CKTR1CK: folds 
azlots: folds 
*** FLOP *** [3c 3s 2s]
I oguz han I: checks 
Jesterclown: checks 
*** TURN *** [3c 3s 2s] [9s]
I oguz han I: bets $1.96
Jesterclown: calls $1.96
*** RIVER *** [3c 3s 2s 9s] [6d]
I oguz han I: checks 
AvaExMachina joins the table at seat #7 
Jesterclown: bets $3
I oguz han I: folds 
Uncalled bet ($3) returned to Jesterclown
Jesterclown collected $7.29 from pot
Jesterclown: doesn't show hand 
*** SUMMARY ***
Total pot $7.67 | Rake $0.38 
Board [3c 3s 2s 9s 6d]
Seat 1: I oguz han I folded on the River
Seat 2: SOLDI MOLDI folded before Flop (didn't bet)
Seat 3: Echomk folded before Flop (didn't bet)
Seat 4: rovara folded before Flop (didn't bet)
Seat 5: Jesterclown (button) collected ($7.29)
Seat 6: TR1CKTR1CK (small blind) folded before Flop
Seat 9: azlots (big blind) folded before Flop



PokerStars Hand #228673453116:  Hold'em No Limit ($0.25/$0.50 USD) - 2021/07/30 1:16:01 ET
Table 'Laodamia II' 9-max Seat #6 is the button
Seat 1: I oguz han I ($50.93 in chips) 
Seat 2: SOLDI MOLDI ($76.52 in chips) 
Seat 3: Echomk ($50.75 in chips) 
Seat 4: rovara ($57.10 in chips) 
Seat 5: Jesterclown ($96.40 in chips) 
Seat 6: TR1CKTR1CK ($40.75 in chips) 
Seat 9: azlots ($41.45 in chips) 
azlots: posts small blind $0.25
I oguz han I: posts big blind $0.50
*** HOLE CARDS ***
SOLDI MOLDI: folds 
Echomk: folds 
rovara: folds 
Jesterclown: folds 
TR1CKTR1CK: folds 
azlots: raises $1 to $1.50
I oguz han I: calls $1
*** FLOP *** [Ac 4d 7d]
azlots: bets $1.43
I oguz han I: raises $1.88 to $3.31
azlots: calls $1.88
*** TURN *** [Ac 4d 7d] [Jc]
azlots: checks 
I oguz han I: checks 
*** RIVER *** [Ac 4d 7d Jc] [Ks]
azlots: bets $4.57
I oguz han I: folds 
Uncalled bet ($4.57) returned to azlots
azlots collected $9.14 from pot
azlots: doesn't show hand 
*** SUMMARY ***
Total pot $9.62 | Rake $0.48 
Board [Ac 4d 7d Jc Ks]
Seat 1: I oguz han I (big blind) folded on the River
Seat 2: SOLDI MOLDI folded before Flop (didn't bet)
Seat 3: Echomk folded before Flop (didn't bet)
Seat 4: rovara folded before Flop (didn't bet)
Seat 5: Jesterclown folded before Flop (didn't bet)
Seat 6: TR1CKTR1CK (button) folded before Flop (didn't bet)
Seat 9: azlots (small blind) collected ($9.14)



PokerStars Hand #228673459100:  Hold'em No Limit ($0.25/$0.50 USD) - 2021/07/30 1:16:45 ET
Table 'Laodamia II' 9-max Seat #9 is the button
Seat 1: I oguz han I ($46.12 in chips) 
Seat 2: SOLDI MOLDI ($76.52 in chips) 
Seat 3: Echomk ($50.75 in chips) 
Seat 4: rovara ($57.10 in chips) 
Seat 5: Jesterclown ($96.40 in chips) 
Seat 6: TR1CKTR1CK ($40.75 in chips) 
Seat 9: azlots ($45.78 in chips) 
I oguz han I: posts small blind $0.25
SOLDI MOLDI: posts big blind $0.50
AvaExMachina: sits out 
*** HOLE CARDS ***
Echomk: folds 
rovara: folds 
Jesterclown: raises $1 to $1.50
TR1CKTR1CK: folds 
azlots: folds 
I oguz han I: folds 
SOLDI MOLDI: folds 
Uncalled bet ($1) returned to Jesterclown
Jesterclown collected $1.25 from pot
Jesterclown: doesn't show hand 
*** SUMMARY ***
Total pot $1.25 | Rake $0 
Seat 1: I oguz han I (small blind) folded before Flop
Seat 2: SOLDI MOLDI (big blind) folded before Flop
Seat 3: Echomk folded before Flop (didn't bet)
Seat 4: rovara folded before Flop (didn't bet)
Seat 5: Jesterclown collected ($1.25)
Seat 6: TR1CKTR1CK folded before Flop (didn't bet)
Seat 9: azlots (button) folded before Flop (didn't bet)



PokerStars Hand #228673461565:  Hold'em No Limit ($0.25/$0.50 USD) - 2021/07/30 1:17:03 ET
Table 'Laodamia II' 9-max Seat #1 is the button
Seat 1: I oguz han I ($45.87 in chips) 
Seat 2: SOLDI MOLDI ($76.02 in chips) 
Seat 4: rovara ($57.10 in chips) 
Seat 5: Jesterclown ($97.15 in chips) 
Seat 6: TR1CKTR1CK ($40.75 in chips) 
SOLDI MOLDI: posts small blind $0.25
Echomk: is sitting out 
rovara: posts big blind $0.50
AvaExMachina: sits out 
*** HOLE CARDS ***
Jesterclown: folds 
Echomk leaves the table
TR1CKTR1CK: folds 
I oguz han I: raises $1 to $1.50
SOLDI MOLDI: folds 
rovara: folds 
Uncalled bet ($1) returned to I oguz han I
I oguz han I collected $1.25 from pot
I oguz han I: doesn't show hand 
*** SUMMARY ***
Total pot $1.25 | Rake $0 
Seat 1: I oguz han I (button) collected ($1.25)
Seat 2: SOLDI MOLDI (small blind) folded before Flop
Seat 4: rovara (big blind) folded before Flop
Seat 5: Jesterclown folded before Flop (didn't bet)
Seat 6: TR1CKTR1CK folded before Flop (didn't bet)



PokerStars Hand #228673463521:  Hold'em No Limit ($0.25/$0.50 USD) - 2021/07/30 1:17:17 ET
Table 'Laodamia II' 9-max Seat #2 is the button
Seat 1: I oguz han I ($46.62 in chips) 
Seat 2: SOLDI MOLDI ($75.77 in chips) 
Seat 4: rovara ($56.60 in chips) 
Seat 5: Jesterclown ($97.15 in chips) 
Seat 6: TR1CKTR1CK ($40.75 in chips) 
rovara: posts small blind $0.25
Jesterclown: posts big blind $0.50
AvaExMachina: sits out 
*** HOLE CARDS ***
TR1CKTR1CK: folds 
I oguz han I: raises $1 to $1.50
SOLDI MOLDI: folds 
rovara: folds 
Jesterclown: calls $1
*** FLOP *** [Js As 2s]
Jesterclown: checks 
I oguz han I: bets $1
Jesterclown: calls $1
*** TURN *** [Js As 2s] [3s]
Jesterclown: checks 
I oguz han I: checks 
*** RIVER *** [Js As 2s 3s] [Qh]
Jesterclown: bets $1.65
I oguz han I: folds 
Uncalled bet ($1.65) returned to Jesterclown
Jesterclown collected $4.99 from pot
Jesterclown: doesn't show hand 
*** SUMMARY ***
Total pot $5.25 | Rake $0.26 
Board [Js As 2s 3s Qh]
Seat 1: I oguz han I folded on the River
Seat 2: SOLDI MOLDI (button) folded before Flop (didn't bet)
Seat 4: rovara (small blind) folded before Flop
Seat 5: Jesterclown (big blind) collected ($4.99)
Seat 6: TR1CKTR1CK folded before Flop (didn't bet)



PokerStars Hand #228673469848:  Hold'em No Limit ($0.25/$0.50 USD) - 2021/07/30 1:18:03 ET
Table 'Laodamia II' 9-max Seat #4 is the button
Seat 1: I oguz han I ($44.12 in chips) 
Seat 2: SOLDI MOLDI ($75.77 in chips) 
Seat 4: rovara ($56.35 in chips) 
Seat 5: Jesterclown ($99.64 in chips) 
Seat 6: TR1CKTR1CK ($40.75 in chips) 
Jesterclown: posts small blind $0.25
TR1CKTR1CK: posts big blind $0.50
AvaExMachina: sits out 
*** HOLE CARDS ***
I oguz han I: folds 
I oguz han I leaves the table
SOLDI MOLDI: folds 
rovara: folds 
Jesterclown: folds 
Uncalled bet ($0.25) returned to TR1CKTR1CK
TR1CKTR1CK collected $0.50 from pot
*** SUMMARY ***
Total pot $0.50 | Rake $0 
Seat 1: I oguz han I folded before Flop (didn't bet)
Seat 2: SOLDI MOLDI folded before Flop (didn't bet)
Seat 4: rovara (button) folded before Flop (didn't bet)
Seat 5: Jesterclown (small blind) folded before Flop
Seat 6: TR1CKTR1CK (big blind) collected ($0.50)



PokerStars Hand #228673471882:  Hold'em No Limit ($0.25/$0.50 USD) - 2021/07/30 1:18:18 ET
Table 'Laodamia II' 9-max Seat #5 is the button
Seat 2: SOLDI MOLDI ($75.77 in chips) 
Seat 4: rovara ($56.35 in chips) 
Seat 5: Jesterclown ($99.39 in chips) 
Seat 6: TR1CKTR1CK ($41 in chips) 
Seat 7: AvaExMachina ($50 in chips) 
TR1CKTR1CK: posts small blind $0.25
AvaExMachina: posts big blind $0.50
*** HOLE CARDS ***
SOLDI MOLDI: folds 
rovara: folds 
Jesterclown: folds 
TR1CKTR1CK: folds 
Uncalled bet ($0.25) returned to AvaExMachina
AvaExMachina collected $0.50 from pot
AvaExMachina: doesn't show hand 
*** SUMMARY ***
Total pot $0.50 | Rake $0 
Seat 2: SOLDI MOLDI folded before Flop (didn't bet)
Seat 4: rovara folded before Flop (didn't bet)
Seat 5: Jesterclown (button) folded before Flop (didn't bet)
Seat 6: TR1CKTR1CK (small blind) folded before Flop
Seat 7: AvaExMachina (big blind) collected ($0.50)



PokerStars Hand #228673474161:  Hold'em No Limit ($0.25/$0.50 USD) - 2021/07/30 1:18:34 ET
Table 'Laodamia II' 9-max Seat #6 is the button
Seat 2: SOLDI MOLDI ($75.77 in chips) 
Seat 4: rovara ($56.35 in chips) 
Seat 5: Jesterclown ($99.39 in chips) 
Seat 6: TR1CKTR1CK ($40.75 in chips) 
Seat 7: AvaExMachina ($50.25 in chips) 
Seat 9: azlots ($45.78 in chips) 
AvaExMachina: posts small blind $0.25
azlots: posts big blind $0.50
*** HOLE CARDS ***
SOLDI MOLDI: folds 
rovara: raises $0.75 to $1.25
Jesterclown: raises $2.75 to $4
TR1CKTR1CK: folds 
AvaExMachina: folds 
azlots: folds 
rovara: folds 
Uncalled bet ($2.75) returned to Jesterclown
Jesterclown collected $3.25 from pot
Jesterclown: doesn't show hand 
*** SUMMARY ***
Total pot $3.25 | Rake $0 
Seat 2: SOLDI MOLDI folded before Flop (didn't bet)
Seat 4: rovara folded before Flop
Seat 5: Jesterclown collected ($3.25)
Seat 6: TR1CKTR1CK (button) folded before Flop (didn't bet)
Seat 7: AvaExMachina (small blind) folded before Flop
Seat 9: azlots (big blind) folded before Flop



PokerStars Hand #228673476984:  Hold'em No Limit ($0.25/$0.50 USD) - 2021/07/30 1:18:55 ET
Table 'Laodamia II' 9-max Seat #7 is the button
Seat 4: rovara ($55.10 in chips) 
Seat 5: Jesterclown ($101.39 in chips) 
Seat 6: TR1CKTR1CK ($40.75 in chips) 
Seat 7: AvaExMachina ($50 in chips) 
Seat 9: azlots ($45.28 in chips) 
azlots: posts small blind $0.25
SOLDI MOLDI: is sitting out 
rovara: posts big blind $0.50
*** HOLE CARDS ***
Jesterclown: raises $1 to $1.50
TR1CKTR1CK: folds 
AvaExMachina: folds 
azlots: folds 
rovara: folds 
Uncalled bet ($1) returned to Jesterclown
Jesterclown collected $1.25 from pot
Jesterclown: doesn't show hand 
*** SUMMARY ***
Total pot $1.25 | Rake $0 
Seat 4: rovara (big blind) folded before Flop
Seat 5: Jesterclown collected ($1.25)
Seat 6: TR1CKTR1CK folded before Flop (didn't bet)
Seat 7: AvaExMachina (button) folded before Flop (didn't bet)
Seat 9: azlots (small blind) folded before Flop



PokerStars Hand #228673478319:  Hold'em No Limit ($0.25/$0.50 USD) - 2021/07/30 1:19:05 ET
Table 'Laodamia II' 9-max Seat #9 is the button
Seat 4: rovara ($54.60 in chips) 
Seat 5: Jesterclown ($102.14 in chips) 
Seat 6: TR1CKTR1CK ($40.75 in chips) 
Seat 7: AvaExMachina ($50 in chips) 
Seat 9: azlots ($45.03 in chips) 
rovara: posts small blind $0.25
Jesterclown: posts big blind $0.50
*** HOLE CARDS ***
TR1CKTR1CK: folds 
AvaExMachina: folds 
azlots: raises $1 to $1.50
rovara: folds 
Jesterclown: folds 
Uncalled bet ($1) returned to azlots
azlots collected $1.25 from pot
azlots: doesn't show hand 
*** SUMMARY ***
Total pot $1.25 | Rake $0 
Seat 4: rovara (small blind) folded before Flop
Seat 5: Jesterclown (big blind) folded before Flop
Seat 6: TR1CKTR1CK folded before Flop (didn't bet)
Seat 7: AvaExMachina folded before Flop (didn't bet)
Seat 9: azlots (button) collected ($1.25)



PokerStars Hand #228673479726:  Hold'em No Limit ($0.25/$0.50 USD) - 2021/07/30 1:19:15 ET
Table 'Laodamia II' 9-max Seat #4 is the button
Seat 4: rovara ($54.35 in chips) 
Seat 5: Jesterclown ($101.64 in chips) 
Seat 6: TR1CKTR1CK ($40.75 in chips) 
Seat 7: AvaExMachina ($50 in chips) 
Seat 9: azlots ($45.78 in chips) 
Jesterclown: posts small blind $0.25
TR1CKTR1CK: posts big blind $0.50
*** HOLE CARDS ***
AvaExMachina: folds 
azlots: folds 
rovara: raises $0.75 to $1.25
AvaExMachina leaves the table
Jesterclown: folds 
TR1CKTR1CK: folds 
Uncalled bet ($0.75) returned to rovara
rovara collected $1.25 from pot
*** SUMMARY ***
Total pot $1.25 | Rake $0 
Seat 4: rovara (button) collected ($1.25)
Seat 5: Jesterclown (small blind) folded before Flop
Seat 6: TR1CKTR1CK (big blind) folded before Flop
Seat 7: AvaExMachina folded before Flop (didn't bet)
Seat 9: azlots folded before Flop (didn't bet)



PokerStars Hand #228673482198:  Hold'em No Limit ($0.25/$0.50 USD) - 2021/07/30 1:19:33 ET
Table 'Laodamia II' 9-max Seat #5 is the button
Seat 4: rovara ($55.10 in chips) 
Seat 5: Jesterclown ($101.39 in chips) 
Seat 6: TR1CKTR1CK ($40.25 in chips) 
Seat 9: azlots ($45.78 in chips) 
TR1CKTR1CK: posts small blind $0.25
azlots: posts big blind $0.50
*** HOLE CARDS ***
rovara: folds 
Jesterclown: raises $1 to $1.50
TR1CKTR1CK: folds 
azlots: folds 
Uncalled bet ($1) returned to Jesterclown
Jesterclown collected $1.25 from pot
Jesterclown: doesn't show hand 
*** SUMMARY ***
Total pot $1.25 | Rake $0 
Seat 4: rovara folded before Flop (didn't bet)
Seat 5: Jesterclown (button) collected ($1.25)
Seat 6: TR1CKTR1CK (small blind) folded before Flop
Seat 9: azlots (big blind) folded before Flop



PokerStars Hand #228672640909:  Hold'em No Limit ($0.25/$0.50 USD) - 2021/07/30 23:51:26 ET
Table 'Laodamia II' 9-max Seat #3 is the button
Seat 1: I oguz han I ($34 in chips) 
Seat 2: xobit26 ($67.48 in chips) 
Seat 3: Millten ($53.14 in chips) 
Seat 4: monkeypokerdirt ($38.63 in chips) 
Seat 5: Jesterclown ($50 in chips) 
Seat 6: TR1CKTR1CK ($46.38 in chips) 
Seat 7: pudge.3096 ($104.19 in chips) 
Seat 8: undergr0undY ($50.75 in chips) 
Seat 9: rovara ($76.45 in chips) 
monkeypokerdirt: posts small blind $0.25
Jesterclown: posts big blind $0.50
*** HOLE CARDS ***
TR1CKTR1CK: folds 
pudge.3096: folds 
undergr0undY: raises $0.75 to $1.25
rovara: folds 
I oguz han I: folds 
xobit26: folds 
Millten: folds 
monkeypokerdirt: raises $3.25 to $4.50
Jesterclown: folds 
undergr0undY: folds 
Uncalled bet ($3.25) returned to monkeypokerdirt
monkeypokerdirt collected $3 from pot
*** SUMMARY ***
Total pot $3 | Rake $0 
Seat 1: I oguz han I folded before Flop (didn't bet)
Seat 2: xobit26 folded before Flop (didn't bet)
Seat 3: Millten (button) folded before Flop (didn't bet)
Seat 4: monkeypokerdirt (small blind) collected ($3)
Seat 5: Jesterclown (big blind) folded before Flop
Seat 6: TR1CKTR1CK folded before Flop (didn't bet)
Seat 7: pudge.3096 folded before Flop (didn't bet)
Seat 8: undergr0undY folded before Flop
Seat 9: rovara folded before Flop (didn't bet)



PokerStars Hand #228672645324:  Hold'em No Limit ($0.25/$0.50 USD) - 2021/07/30 23:51:53 ET
Table 'Laodamia II' 9-max Seat #4 is the button
Seat 1: I oguz han I ($34 in chips) 
Seat 2: xobit26 ($67.48 in chips) 
Seat 3: Millten ($53.14 in chips) 
Seat 4: monkeypokerdirt ($40.38 in chips) 
Seat 5: Jesterclown ($50 in chips) 
Seat 6: TR1CKTR1CK ($46.38 in chips) 
Seat 7: pudge.3096 ($104.19 in chips) 
Seat 8: undergr0undY ($50 in chips) 
Seat 9: rovara ($76.45 in chips) 
Jesterclown: posts small blind $0.25
TR1CKTR1CK: posts big blind $0.50
*** HOLE CARDS ***
pudge.3096: folds 
undergr0undY: folds 
rovara: folds 
I oguz han I: raises $1 to $1.50
xobit26: folds 
Millten: folds 
monkeypokerdirt: folds 
Jesterclown: folds 
TR1CKTR1CK: folds 
Uncalled bet ($1) returned to I oguz han I
I oguz han I collected $1.25 from pot
I oguz han I: doesn't show hand 
*** SUMMARY ***
Total pot $1.25 | Rake $0 
Seat 1: I oguz han I collected ($1.25)
Seat 2: xobit26 folded before Flop (didn't bet)
Seat 3: Millten folded before Flop (didn't bet)
Seat 4: monkeypokerdirt (button) folded before Flop (didn't bet)
Seat 5: Jesterclown (small blind) folded before Flop
Seat 6: TR1CKTR1CK (big blind) folded before Flop
Seat 7: pudge.3096 folded before Flop (didn't bet)
Seat 8: undergr0undY folded before Flop (didn't bet)
Seat 9: rovara folded before Flop (didn't bet)



PokerStars Hand #228672648420:  Hold'em No Limit ($0.25/$0.50 USD) - 2021/07/30 23:52:12 ET
Table 'Laodamia II' 9-max Seat #5 is the button
Seat 1: I oguz han I ($34.75 in chips) 
Seat 2: xobit26 ($67.48 in chips) 
Seat 3: Millten ($53.14 in chips) 
Seat 4: monkeypokerdirt ($40.38 in chips) 
Seat 5: Jesterclown ($50 in chips) 
Seat 6: TR1CKTR1CK ($45.88 in chips) 
Seat 7: pudge.3096 ($104.19 in chips) 
Seat 8: undergr0undY ($50 in chips) 
Seat 9: rovara ($76.45 in chips) 
TR1CKTR1CK: posts small blind $0.25
pudge.3096: posts big blind $0.50
*** HOLE CARDS ***
undergr0undY: folds 
rovara: folds 
I oguz han I: raises $1 to $1.50
xobit26: folds 
Millten: folds 
monkeypokerdirt: folds 
Jesterclown: raises $3 to $4.50
TR1CKTR1CK: folds 
pudge.3096: folds 
I oguz han I: raises $30.25 to $34.75 and is all-in
Jesterclown: calls $30.25
*** FLOP *** [9s 7h 4d]
*** TURN *** [9s 7h 4d] [Qc]
*** RIVER *** [9s 7h 4d Qc] [3d]
*** SHOW DOWN ***
I oguz han I: shows [Kd Ac] (high card Ace)
Jesterclown: shows [Jh Js] (a pair of Jacks)
Jesterclown collected $68.25 from pot
*** SUMMARY ***
Total pot $70.25 | Rake $2 
Board [9s 7h 4d Qc 3d]
Seat 1: I oguz han I showed [Kd Ac] and lost with high card Ace
Seat 2: xobit26 folded before Flop (didn't bet)
Seat 3: Millten folded before Flop (didn't bet)
Seat 4: monkeypokerdirt folded before Flop (didn't bet)
Seat 5: Jesterclown (button) showed [Jh Js] and won ($68.25) with a pair of Jacks
Seat 6: TR1CKTR1CK (small blind) folded before Flop
Seat 7: pudge.3096 (big blind) folded before Flop
Seat 8: undergr0undY folded before Flop (didn't bet)
Seat 9: rovara folded before Flop (didn't bet)



PokerStars Hand #228672669900:  Hold'em No Limit ($0.25/$0.50 USD) - 2021/07/30 23:53:30 ET
Table 'Laodamia II' 9-max Seat #7 is the button
Seat 1: I oguz han I ($50 in chips) 
Seat 2: xobit26 ($67.48 in chips) 
Seat 3: Millten ($55.14 in chips) 
Seat 4: monkeypokerdirt ($40.38 in chips) 
Seat 5: Jesterclown ($83.50 in chips) 
Seat 6: TR1CKTR1CK ($45.63 in chips) 
Seat 7: pudge.3096 ($103.44 in chips) 
Seat 8: undergr0undY ($50 in chips) 
Seat 9: rovara ($75.20 in chips) 
undergr0undY: posts small blind $0.25
rovara: posts big blind $0.50
*** HOLE CARDS ***
I oguz han I: folds 
xobit26: folds 
Millten: folds 
monkeypokerdirt: folds 
Jesterclown: folds 
TR1CKTR1CK: folds 
pudge.3096: raises $0.75 to $1.25
undergr0undY: raises $4.25 to $5.50
rovara: folds 
pudge.3096: folds 
Uncalled bet ($4.25) returned to undergr0undY
undergr0undY collected $3 from pot
*** SUMMARY ***
Total pot $3 | Rake $0 
Seat 1: I oguz han I folded before Flop (didn't bet)
Seat 2: xobit26 folded before Flop (didn't bet)
Seat 3: Millten folded before Flop (didn't bet)
Seat 4: monkeypokerdirt folded before Flop (didn't bet)
Seat 5: Jesterclown folded before Flop (didn't bet)
Seat 6: TR1CKTR1CK folded before Flop (didn't bet)
Seat 7: pudge.3096 (button) folded before Flop
Seat 8: undergr0undY (small blind) collected ($3)
Seat 9: rovara (big blind) folded before Flop



PokerStars Hand #228672674238:  Hold'em No Limit ($0.25/$0.50 USD) - 2021/07/30 23:53:57 ET
Table 'Laodamia II' 9-max Seat #8 is the button
Seat 1: I oguz han I ($50 in chips) 
Seat 2: xobit26 ($67.48 in chips) 
Seat 3: Millten ($55.14 in chips) 
Seat 4: monkeypokerdirt ($40.38 in chips) 
Seat 5: Jesterclown ($83.50 in chips) 
Seat 6: TR1CKTR1CK ($45.63 in chips) 
Seat 7: pudge.3096 ($102.19 in chips) 
Seat 8: undergr0undY ($51.75 in chips) 
Seat 9: rovara ($74.70 in chips) 
rovara: posts small blind $0.25
I oguz han I: posts big blind $0.50
*** HOLE CARDS ***
xobit26: folds 
Millten: folds 
monkeypokerdirt: calls $0.50
Jesterclown: folds 
TR1CKTR1CK: folds 
pudge.3096: folds 
undergr0undY: folds 
rovara: raises $2 to $2.50
I oguz han I: calls $2
monkeypokerdirt: calls $2
*** FLOP *** [7d 4c 4d]
rovara: checks 
I oguz han I: checks 
monkeypokerdirt: bets $5.50
rovara: raises $13.75 to $19.25
I oguz han I: folds 
monkeypokerdirt: folds 
Uncalled bet ($13.75) returned to rovara
rovara collected $17.58 from pot
*** SUMMARY ***
Total pot $18.50 | Rake $0.92 
Board [7d 4c 4d]
Seat 1: I oguz han I (big blind) folded on the Flop
Seat 2: xobit26 folded before Flop (didn't bet)
Seat 3: Millten folded before Flop (didn't bet)
Seat 4: monkeypokerdirt folded on the Flop
Seat 5: Jesterclown folded before Flop (didn't bet)
Seat 6: TR1CKTR1CK folded before Flop (didn't bet)
Seat 7: pudge.3096 folded before Flop (didn't bet)
Seat 8: undergr0undY (button) folded before Flop (didn't bet)
Seat 9: rovara (small blind) collected ($17.58)



PokerStars Hand #228672688046:  Hold'em No Limit ($0.25/$0.50 USD) - 2021/07/30 23:55:24 ET
Table 'Laodamia II' 9-max Seat #9 is the button
Seat 1: I oguz han I ($47.50 in chips) 
Seat 2: xobit26 ($67.48 in chips) 
Seat 3: Millten ($55.14 in chips) 
Seat 4: monkeypokerdirt ($32.38 in chips) 
Seat 5: Jesterclown ($83.50 in chips) 
Seat 6: TR1CKTR1CK ($45.63 in chips) 
Seat 7: pudge.3096 ($102.19 in chips) 
Seat 8: undergr0undY ($51.75 in chips) 
Seat 9: rovara ($84.28 in chips) 
I oguz han I: posts small blind $0.25
xobit26: posts big blind $0.50
*** HOLE CARDS ***
Millten: folds 
monkeypokerdirt: calls $0.50
Jesterclown: folds 
TR1CKTR1CK has timed out
TR1CKTR1CK: folds 
pudge.3096: folds 
undergr0undY: raises $1.50 to $2
rovara: folds 
I oguz han I: folds 
xobit26: folds 
monkeypokerdirt: calls $1.50
*** FLOP *** [6d 2c 5d]
monkeypokerdirt: bets $2.50
undergr0undY: folds 
Uncalled bet ($2.50) returned to monkeypokerdirt
monkeypokerdirt collected $4.51 from pot
*** SUMMARY ***
Total pot $4.75 | Rake $0.24 
Board [6d 2c 5d]
Seat 1: I oguz han I (small blind) folded before Flop
Seat 2: xobit26 (big blind) folded before Flop
Seat 3: Millten folded before Flop (didn't bet)
Seat 4: monkeypokerdirt collected ($4.51)
Seat 5: Jesterclown folded before Flop (didn't bet)
Seat 6: TR1CKTR1CK folded before Flop (didn't bet)
Seat 7: pudge.3096 folded before Flop (didn't bet)
Seat 8: undergr0undY folded on the Flop
Seat 9: rovara (button) folded before Flop (didn't bet)



PokerStars Hand #228672703878:  Hold'em No Limit ($0.25/$0.50 USD) - 2021/07/30 23:56:35 ET
Table 'Laodamia II' 9-max Seat #1 is the button
Seat 1: I oguz han I ($47.25 in chips) 
Seat 2: xobit26 ($66.98 in chips) 
Seat 3: Millten ($55.14 in chips) 
Seat 4: monkeypokerdirt ($34.89 in chips) 
Seat 5: Jesterclown ($83.50 in chips) 
Seat 6: TR1CKTR1CK ($45.63 in chips) 
Seat 7: pudge.3096 ($102.19 in chips) 
Seat 8: undergr0undY ($50 in chips) 
Seat 9: rovara ($84.28 in chips) 
xobit26: posts small blind $0.25
Millten: posts big blind $0.50
*** HOLE CARDS ***
monkeypokerdirt: calls $0.50
Jesterclown: folds 
TR1CKTR1CK: folds 
pudge.3096: raises $2 to $2.50
undergr0undY: folds 
rovara: raises $5 to $7.50
I oguz han I: folds 
xobit26: folds 
Millten: folds 
monkeypokerdirt: folds 
pudge.3096: calls $5
*** FLOP *** [Ah 3s Ac]
pudge.3096: checks 
rovara: bets $5.10
pudge.3096: calls $5.10
*** TURN *** [Ah 3s Ac] [Jc]
pudge.3096: checks 
rovara: bets $15
pudge.3096: raises $17.50 to $32.50
rovara: folds 
Uncalled bet ($17.50) returned to pudge.3096
pudge.3096 collected $54.45 from pot
pudge.3096: doesn't show hand 
*** SUMMARY ***
Total pot $56.45 | Rake $2 
Board [Ah 3s Ac Jc]
Seat 1: I oguz han I (button) folded before Flop (didn't bet)
Seat 2: xobit26 (small blind) folded before Flop
Seat 3: Millten (big blind) folded before Flop
Seat 4: monkeypokerdirt folded before Flop
Seat 5: Jesterclown folded before Flop (didn't bet)
Seat 6: TR1CKTR1CK folded before Flop (didn't bet)
Seat 7: pudge.3096 collected ($54.45)
Seat 8: undergr0undY folded before Flop (didn't bet)
Seat 9: rovara folded on the Turn



PokerStars Hand #228672723633:  Hold'em No Limit ($0.25/$0.50 USD) - 2021/07/30 23:58:42 ET
Table 'Laodamia II' 9-max Seat #2 is the button
Seat 1: I oguz han I ($47.25 in chips) 
Seat 2: xobit26 ($66.73 in chips) 
Seat 3: Millten ($54.64 in chips) 
Seat 4: monkeypokerdirt ($34.39 in chips) 
Seat 5: Jesterclown ($83.50 in chips) 
Seat 6: TR1CKTR1CK ($45.63 in chips) 
Seat 7: pudge.3096 ($129.04 in chips) 
Seat 8: undergr0undY ($50 in chips) 
Seat 9: rovara ($56.68 in chips) 
Millten: posts small blind $0.25
monkeypokerdirt: posts big blind $0.50
*** HOLE CARDS ***
Jesterclown: folds 
TR1CKTR1CK: folds 
pudge.3096: folds 
undergr0undY: folds 
rovara: folds 
I oguz han I: folds 
xobit26: folds 
Millten: raises $0.90 to $1.40
monkeypokerdirt: calls $0.90
*** FLOP *** [7h 5h 9h]
Millten: bets $1.36
monkeypokerdirt: calls $1.36
*** TURN *** [7h 5h 9h] [6h]
Millten: checks 
monkeypokerdirt: bets $5.24
Millten: calls $5.24
*** RIVER *** [7h 5h 9h 6h] [3d]
Millten: checks 
monkeypokerdirt: bets $26.39 and is all-in
Millten: folds 
Uncalled bet ($26.39) returned to monkeypokerdirt
monkeypokerdirt collected $15.20 from pot
*** SUMMARY ***
Total pot $16 | Rake $0.80 
Board [7h 5h 9h 6h 3d]
Seat 1: I oguz han I folded before Flop (didn't bet)
Seat 2: xobit26 (button) folded before Flop (didn't bet)
Seat 3: Millten (small blind) folded on the River
Seat 4: monkeypokerdirt (big blind) collected ($15.20)
Seat 5: Jesterclown folded before Flop (didn't bet)
Seat 6: TR1CKTR1CK folded before Flop (didn't bet)
Seat 7: pudge.3096 folded before Flop (didn't bet)
Seat 8: undergr0undY folded before Flop (didn't bet)
Seat 9: rovara folded before Flop (didn't bet)



PokerStars Hand #228673484046:  Hold'em No Limit ($0.25/$0.50 USD) - 2021/07/30 1:19:46 ET
Table 'Laodamia II' 9-max Seat #6 is the button
Seat 4: rovara ($55.10 in chips) 
Seat 5: Jesterclown ($102.14 in chips) 
Seat 6: TR1CKTR1CK ($40 in chips) 
Seat 9: azlots ($45.28 in chips) 
azlots: posts small blind $0.25
rovara: posts big blind $0.50
*** HOLE CARDS ***
Jesterclown: folds 
TR1CKTR1CK: raises $1 to $1.50
azlots: calls $1.25
rovara: calls $1
*** FLOP *** [5h Js 2h]
azlots: checks 
rovara: bets $2.35
TR1CKTR1CK: raises $5.65 to $8
azlots: folds 
dexeosRankX joins the table at seat #1 
rovara: raises $45.60 to $53.60 and is all-in
TR1CKTR1CK: calls $30.50 and is all-in
Uncalled bet ($15.10) returned to rovara
*** TURN *** [5h Js 2h] [Qh]
*** RIVER *** [5h Js 2h Qh] [8c]
*** SHOW DOWN ***
rovara: shows [5d 5s] (three of a kind, Fives)
TR1CKTR1CK: shows [Jc Jh] (three of a kind, Jacks)
TR1CKTR1CK collected $80.75 from pot
*** SUMMARY ***
Total pot $81.50 | Rake $0.75 
Board [5h Js 2h Qh 8c]
Seat 4: rovara (big blind) showed [5d 5s] and lost with three of a kind, Fives
Seat 5: Jesterclown folded before Flop (didn't bet)
Seat 6: TR1CKTR1CK (button) showed [Jc Jh] and won ($80.75) with three of a kind, Jacks
Seat 9: azlots (small blind) folded on the Flop



PokerStars Hand #228673496546:  Hold'em No Limit ($0.25/$0.50 USD) - 2021/07/30 1:21:17 ET
Table 'Laodamia II' 9-max Seat #9 is the button
Seat 4: rovara ($50 in chips) 
Seat 5: Jesterclown ($102.14 in chips) 
Seat 6: TR1CKTR1CK ($80.75 in chips) 
Seat 9: azlots ($43.78 in chips) 
rovara: posts small blind $0.25
Jesterclown: posts big blind $0.50
*** HOLE CARDS ***
SOLDI MOLDI leaves the table
TR1CKTR1CK: folds 
azlots: folds 
rovara: raises $1 to $1.50
RayyRayyT was removed from the table for failing to post
RayyRayyT leaves the table
Jesterclown: calls $1
*** FLOP *** [5s 8d 6h]
rovara: bets $1.57
Jesterclown: calls $1.57
*** TURN *** [5s 8d 6h] [6c]
rovara: bets $4.43
Jesterclown: folds 
Uncalled bet ($4.43) returned to rovara
rovara collected $5.83 from pot
*** SUMMARY ***
Total pot $6.14 | Rake $0.31 
Board [5s 8d 6h 6c]
Seat 4: rovara (small blind) collected ($5.83)
Seat 5: Jesterclown (big blind) folded on the Turn
Seat 6: TR1CKTR1CK folded before Flop (didn't bet)
Seat 9: azlots (button) folded before Flop (didn't bet)



PokerStars Hand #228673506494:  Hold'em No Limit ($0.25/$0.50 USD) - 2021/07/30 1:22:29 ET
Table 'Laodamia II' 9-max Seat #4 is the button
Seat 4: rovara ($52.76 in chips) 
Seat 5: Jesterclown ($99.07 in chips) 
Seat 6: TR1CKTR1CK ($80.75 in chips) 
Seat 9: azlots ($43.78 in chips) 
Jesterclown: posts small blind $0.25
TR1CKTR1CK: posts big blind $0.50
dexeosRankX: sits out 
*** HOLE CARDS ***
azlots: raises $1 to $1.50
rovara: folds 
Jesterclown: folds 
TR1CKTR1CK: raises $4.50 to $6
azlots: folds 
Uncalled bet ($4.50) returned to TR1CKTR1CK
TR1CKTR1CK collected $3.25 from pot
*** SUMMARY ***
Total pot $3.25 | Rake $0 
Seat 4: rovara (button) folded before Flop (didn't bet)
Seat 5: Jesterclown (small blind) folded before Flop
Seat 6: TR1CKTR1CK (big blind) collected ($3.25)
Seat 9: azlots folded before Flop



PokerStars Hand #228673513122:  Hold'em No Limit ($0.25/$0.50 USD) - 2021/07/30 1:22:55 ET
Table 'Laodamia II' 9-max Seat #5 is the button
Seat 1: dexeosRankX ($50 in chips) 
Seat 4: rovara ($52.76 in chips) 
Seat 5: Jesterclown ($98.82 in chips) 
Seat 6: TR1CKTR1CK ($82.50 in chips) 
TR1CKTR1CK: posts small blind $0.25
azlots: is sitting out 
dexeosRankX: posts big blind $0.50
*** HOLE CARDS ***
azlots leaves the table
rovara: folds 
Jesterclown: raises $1 to $1.50
TR1CKTR1CK: folds 
dexeosRankX: folds 
Uncalled bet ($1) returned to Jesterclown
Jesterclown collected $1.25 from pot
Jesterclown: doesn't show hand 
*** SUMMARY ***
Total pot $1.25 | Rake $0 
Seat 1: dexeosRankX (big blind) folded before Flop
Seat 4: rovara folded before Flop (didn't bet)
Seat 5: Jesterclown (button) collected ($1.25)
Seat 6: TR1CKTR1CK (small blind) folded before Flop



PokerStars Hand #228673517427:  Hold'em No Limit ($0.25/$0.50 USD) - 2021/07/30 1:23:26 ET
Table 'Laodamia II' 9-max Seat #6 is the button
Seat 1: dexeosRankX ($50 in chips) 
Seat 4: rovara ($52.76 in chips) 
Seat 5: Jesterclown ($99.57 in chips) 
Seat 6: TR1CKTR1CK ($82.25 in chips) 
dexeosRankX: posts small blind $0.25
rovara: posts big blind $0.50
*** HOLE CARDS ***
Jesterclown: raises $1 to $1.50
TR1CKTR1CK: folds 
dexeosRankX: raises $3.75 to $5.25
rovara: folds 
Jesterclown: folds 
Uncalled bet ($3.75) returned to dexeosRankX
dexeosRankX collected $3.50 from pot
dexeosRankX: doesn't show hand 
*** SUMMARY ***
Total pot $3.50 | Rake $0 
Seat 1: dexeosRankX (small blind) collected ($3.50)
Seat 4: rovara (big blind) folded before Flop
Seat 5: Jesterclown folded before Flop
Seat 6: TR1CKTR1CK (button) folded before Flop (didn't bet)



PokerStars Hand #228673522147:  Hold'em No Limit ($0.25/$0.50 USD) - 2021/07/30 1:24:00 ET
Table 'Laodamia II' 9-max Seat #1 is the button
Seat 1: dexeosRankX ($52 in chips) 
Seat 5: Jesterclown ($98.07 in chips) 
Seat 6: TR1CKTR1CK ($82.25 in chips) 
Jesterclown: posts small blind $0.25
TR1CKTR1CK: posts big blind $0.50
*** HOLE CARDS ***
dexeosRankX: raises $0.65 to $1.15
Jesterclown: folds 
TR1CKTR1CK: folds 
Uncalled bet ($0.65) returned to dexeosRankX
dexeosRankX collected $1.25 from pot
dexeosRankX: doesn't show hand 
*** SUMMARY ***
Total pot $1.25 | Rake $0 
Seat 1: dexeosRankX (button) collected ($1.25)
Seat 5: Jesterclown (small blind) folded before Flop
Seat 6: TR1CKTR1CK (big blind) folded before Flop



PokerStars Hand #228673523927:  Hold'em No Limit ($0.25/$0.50 USD) - 2021/07/30 1:24:13 ET
Table 'Laodamia II' 9-max Seat #5 is the button
Seat 1: dexeosRankX ($52.75 in chips) 
Seat 5: Jesterclown ($97.82 in chips) 
Seat 6: TR1CKTR1CK ($81.75 in chips) 
TR1CKTR1CK: posts small blind $0.25
dexeosRankX: posts big blind $0.50
*** HOLE CARDS ***
Jesterclown: folds 
TR1CKTR1CK: raises $0.75 to $1.25
dexeosRankX: calls $0.75
*** FLOP *** [2h Qd 4h]
TR1CKTR1CK: checks 
dexeosRankX: checks 
*** TURN *** [2h Qd 4h] [Ts]
TR1CKTR1CK: checks 
dexeosRankX: checks 
*** RIVER *** [2h Qd 4h Ts] [9h]
TR1CKTR1CK: checks 
dexeosRankX: checks 
*** SHOW DOWN ***
TR1CKTR1CK: shows [Qh 8c] (a pair of Queens)
dexeosRankX: mucks hand 
TR1CKTR1CK collected $2.38 from pot
*** SUMMARY ***
Total pot $2.50 | Rake $0.12 
Board [2h Qd 4h Ts 9h]
Seat 1: dexeosRankX (big blind) mucked
Seat 5: Jesterclown (button) folded before Flop (didn't bet)
Seat 6: TR1CKTR1CK (small blind) showed [Qh 8c] and won ($2.38) with a pair of Queens



PokerStars Hand #228673528884:  Hold'em No Limit ($0.25/$0.50 USD) - 2021/07/30 1:24:49 ET
Table 'Laodamia II' 9-max Seat #6 is the button
Seat 1: dexeosRankX ($51.50 in chips) 
Seat 5: Jesterclown ($97.82 in chips) 
Seat 6: TR1CKTR1CK ($82.88 in chips) 
dexeosRankX: posts small blind $0.25
Jesterclown: posts big blind $0.50
*** HOLE CARDS ***
TR1CKTR1CK: folds 
dexeosRankX: folds 
Uncalled bet ($0.25) returned to Jesterclown
Jesterclown collected $0.50 from pot
Jesterclown: doesn't show hand 
*** SUMMARY ***
Total pot $0.50 | Rake $0 
Seat 1: dexeosRankX (small blind) folded before Flop
Seat 5: Jesterclown (big blind) collected ($0.50)
Seat 6: TR1CKTR1CK (button) folded before Flop (didn't bet)



PokerStars Hand #228673529670:  Hold'em No Limit ($0.25/$0.50 USD) - 2021/07/30 1:24:55 ET
Table 'Laodamia II' 9-max Seat #1 is the button
Seat 1: dexeosRankX ($51.25 in chips) 
Seat 5: Jesterclown ($98.07 in chips) 
Seat 6: TR1CKTR1CK ($82.88 in chips) 
Jesterclown: posts small blind $0.25
TR1CKTR1CK: posts big blind $0.50
*** HOLE CARDS ***
dexeosRankX: folds 
dexeosRankX leaves the table
Jesterclown: folds 
Uncalled bet ($0.25) returned to TR1CKTR1CK
TR1CKTR1CK collected $0.50 from pot
*** SUMMARY ***
Total pot $0.50 | Rake $0 
Seat 1: dexeosRankX (button) folded before Flop (didn't bet)
Seat 5: Jesterclown (small blind) folded before Flop
Seat 6: TR1CKTR1CK (big blind) collected ($0.50)



PokerStars Hand #228673531530:  Hold'em No Limit ($0.25/$0.50 USD) - 2021/07/30 1:25:08 ET
Table 'Laodamia II' 9-max Seat #6 is the button
Seat 5: Jesterclown ($97.82 in chips) 
Seat 6: TR1CKTR1CK ($83.13 in chips) 
TR1CKTR1CK: posts small blind $0.25
Jesterclown: posts big blind $0.50
*** HOLE CARDS ***
TR1CKTR1CK: raises $0.75 to $1.25
Jesterclown: folds 
Uncalled bet ($0.75) returned to TR1CKTR1CK
TR1CKTR1CK collected $1 from pot
*** SUMMARY ***
Total pot $1 | Rake $0 
Seat 5: Jesterclown (big blind) folded before Flop
Seat 6: TR1CKTR1CK (button) (small blind) collected ($1)



PokerStars Hand #228673533430:  Hold'em No Limit ($0.25/$0.50 USD) - 2021/07/30 1:25:22 ET
Table 'Laodamia II' 9-max Seat #5 is the button
Seat 5: Jesterclown ($97.32 in chips) 
Seat 6: TR1CKTR1CK ($83.63 in chips) 
Jesterclown: posts small blind $0.25
TR1CKTR1CK: posts big blind $0.50
*** HOLE CARDS ***
Jesterclown: folds 
Uncalled bet ($0.25) returned to TR1CKTR1CK
TR1CKTR1CK collected $0.50 from pot
*** SUMMARY ***
Total pot $0.50 | Rake $0 
Seat 5: Jesterclown (button) (small blind) folded before Flop
Seat 6: TR1CKTR1CK (big blind) collected ($0.50)



PokerStars Hand #228672315923:  Hold'em No Limit ($0.25/$0.50 USD) - 2021/07/30 23:21:03 ET
Table 'Laodamia II' 9-max Seat #3 is the button
Seat 1: I oguz han I ($56.10 in chips) 
Seat 2: xobit26 ($66.32 in chips) 
Seat 3: 6l4ck ($79.37 in chips) 
Seat 4: monkeypokerdirt ($38.19 in chips) 
Seat 5: Jesterclown ($51 in chips) 
Seat 6: artemxxl ($98 in chips) 
Seat 7: pudge.3096 ($50 in chips) 
Seat 8: Kasselbanki ($60.26 in chips) 
Seat 9: $ilentBob81 ($97.74 in chips) 
monkeypokerdirt: posts small blind $0.25
Jesterclown: posts big blind $0.50
*** HOLE CARDS ***
artemxxl: folds 
pudge.3096: folds 
Kasselbanki: raises $1.50 to $2
$ilentBob81: folds 
I oguz han I: folds 
xobit26: folds 
6l4ck: calls $2
monkeypokerdirt: calls $1.75
Jesterclown: folds 
*** FLOP *** [9c 3h Th]
artemxxl leaves the table
monkeypokerdirt: checks 
Kasselbanki: bets $1.50
TR1CKTR1CK joins the table at seat #6 
6l4ck: raises $4.59 to $6.09
monkeypokerdirt: folds 
Kasselbanki: folds 
Uncalled bet ($4.59) returned to 6l4ck
6l4ck collected $9.02 from pot
6l4ck: doesn't show hand 
*** SUMMARY ***
Total pot $9.50 | Rake $0.48 
Board [9c 3h Th]
Seat 1: I oguz han I folded before Flop (didn't bet)
Seat 2: xobit26 folded before Flop (didn't bet)
Seat 3: 6l4ck (button) collected ($9.02)
Seat 4: monkeypokerdirt (small blind) folded on the Flop
Seat 5: Jesterclown (big blind) folded before Flop
Seat 6: artemxxl folded before Flop (didn't bet)
Seat 7: pudge.3096 folded before Flop (didn't bet)
Seat 8: Kasselbanki folded on the Flop
Seat 9: $ilentBob81 folded before Flop (didn't bet)



PokerStars Hand #228672328682:  Hold'em No Limit ($0.25/$0.50 USD) - 2021/07/30 23:22:15 ET
Table 'Laodamia II' 9-max Seat #4 is the button
Seat 2: xobit26 ($66.32 in chips) 
Seat 3: 6l4ck ($84.89 in chips) 
Seat 4: monkeypokerdirt ($36.19 in chips) 
Seat 5: Jesterclown ($50.50 in chips) 
Seat 6: TR1CKTR1CK ($50 in chips) 
Seat 7: pudge.3096 ($50 in chips) 
Seat 8: Kasselbanki ($56.76 in chips) 
Seat 9: $ilentBob81 ($97.74 in chips) 
Jesterclown: posts small blind $0.25
TR1CKTR1CK: posts big blind $0.50
*** HOLE CARDS ***
pudge.3096: raises $0.75 to $1.25
Kasselbanki: folds 
$ilentBob81: folds 
xobit26: folds 
6l4ck: folds 
monkeypokerdirt: folds 
Jesterclown: folds 
TR1CKTR1CK: folds 
Uncalled bet ($0.75) returned to pudge.3096
pudge.3096 collected $1.25 from pot
pudge.3096: doesn't show hand 
*** SUMMARY ***
Total pot $1.25 | Rake $0 
Seat 2: xobit26 folded before Flop (didn't bet)
Seat 3: 6l4ck folded before Flop (didn't bet)
Seat 4: monkeypokerdirt (button) folded before Flop (didn't bet)
Seat 5: Jesterclown (small blind) folded before Flop
Seat 6: TR1CKTR1CK (big blind) folded before Flop
Seat 7: pudge.3096 collected ($1.25)
Seat 8: Kasselbanki folded before Flop (didn't bet)
Seat 9: $ilentBob81 folded before Flop (didn't bet)



PokerStars Hand #228672333104:  Hold'em No Limit ($0.25/$0.50 USD) - 2021/07/30 23:22:40 ET
Table 'Laodamia II' 9-max Seat #5 is the button
Seat 2: xobit26 ($66.32 in chips) 
Seat 3: 6l4ck ($84.89 in chips) 
Seat 4: monkeypokerdirt ($36.19 in chips) 
Seat 5: Jesterclown ($50.25 in chips) 
Seat 6: TR1CKTR1CK ($49.50 in chips) 
Seat 7: pudge.3096 ($50.75 in chips) 
Seat 8: Kasselbanki ($56.76 in chips) 
Seat 9: $ilentBob81 ($97.74 in chips) 
TR1CKTR1CK: posts small blind $0.25
pudge.3096: posts big blind $0.50
*** HOLE CARDS ***
Kasselbanki: raises $1 to $1.50
$ilentBob81 has timed out
$ilentBob81: folds 
xobit26: folds 
6l4ck: folds 
monkeypokerdirt: calls $1.50
Jesterclown: folds 
TR1CKTR1CK: folds 
$ilentBob81 leaves the table
pudge.3096: folds 
*** FLOP *** [9c Qc 2c]
Kasselbanki: checks 
monkeypokerdirt: checks 
*** TURN *** [9c Qc 2c] [Qd]
Kasselbanki: bets $2
monkeypokerdirt: folds 
Uncalled bet ($2) returned to Kasselbanki
Kasselbanki collected $3.51 from pot
Kasselbanki: doesn't show hand 
rovara joins the table at seat #9 
*** SUMMARY ***
Total pot $3.75 | Rake $0.24 
Board [9c Qc 2c Qd]
Seat 2: xobit26 folded before Flop (didn't bet)
Seat 3: 6l4ck folded before Flop (didn't bet)
Seat 4: monkeypokerdirt folded on the Turn
Seat 5: Jesterclown (button) folded before Flop (didn't bet)
Seat 6: TR1CKTR1CK (small blind) folded before Flop
Seat 7: pudge.3096 (big blind) folded before Flop
Seat 8: Kasselbanki collected ($3.51)
Seat 9: $ilentBob81 folded before Flop (didn't bet)



PokerStars Hand #228672342649:  Hold'em No Limit ($0.25/$0.50 USD) - 2021/07/30 23:23:34 ET
Table 'Laodamia II' 9-max Seat #6 is the button
Seat 2: xobit26 ($66.32 in chips) 
Seat 3: 6l4ck ($84.89 in chips) 
Seat 4: monkeypokerdirt ($34.69 in chips) 
Seat 5: Jesterclown ($50.25 in chips) 
Seat 6: TR1CKTR1CK ($49.25 in chips) 
Seat 7: pudge.3096 ($50.25 in chips) 
Seat 8: Kasselbanki ($58.77 in chips) 
pudge.3096: posts small blind $0.25
Kasselbanki: posts big blind $0.50
rovara: sits out 
*** HOLE CARDS ***
xobit26: folds 
6l4ck: folds 
monkeypokerdirt: folds 
Jesterclown: folds 
TR1CKTR1CK: folds 
pudge.3096: raises $1 to $1.50
Kasselbanki: folds 
Uncalled bet ($1) returned to pudge.3096
pudge.3096 collected $1 from pot
pudge.3096: doesn't show hand 
*** SUMMARY ***
Total pot $1 | Rake $0 
Seat 2: xobit26 folded before Flop (didn't bet)
Seat 3: 6l4ck folded before Flop (didn't bet)
Seat 4: monkeypokerdirt folded before Flop (didn't bet)
Seat 5: Jesterclown folded before Flop (didn't bet)
Seat 6: TR1CKTR1CK (button) folded before Flop (didn't bet)
Seat 7: pudge.3096 (small blind) collected ($1)
Seat 8: Kasselbanki (big blind) folded before Flop



PokerStars Hand #228672347552:  Hold'em No Limit ($0.25/$0.50 USD) - 2021/07/30 23:24:01 ET
Table 'Laodamia II' 9-max Seat #7 is the button
Seat 2: xobit26 ($66.32 in chips) 
Seat 3: 6l4ck ($84.89 in chips) 
Seat 4: monkeypokerdirt ($34.69 in chips) 
Seat 5: Jesterclown ($50.25 in chips) 
Seat 6: TR1CKTR1CK ($49.25 in chips) 
Seat 7: pudge.3096 ($50.75 in chips) 
Seat 8: Kasselbanki ($58.27 in chips) 
Seat 9: rovara ($61.56 in chips) 
Kasselbanki: posts small blind $0.25
rovara: posts big blind $0.50
*** HOLE CARDS ***
xobit26: folds 
6l4ck: folds 
monkeypokerdirt: calls $0.50
Jesterclown: folds 
TR1CKTR1CK: folds 
pudge.3096: folds 
Kasselbanki: folds 
rovara: raises $2 to $2.50
monkeypokerdirt: calls $2
*** FLOP *** [3s 3c 6c]
rovara: checks 
monkeypokerdirt: checks 
*** TURN *** [3s 3c 6c] [5h]
rovara: checks 
monkeypokerdirt: bets $3.50
rovara: folds 
Uncalled bet ($3.50) returned to monkeypokerdirt
monkeypokerdirt collected $4.99 from pot
*** SUMMARY ***
Total pot $5.25 | Rake $0.26 
Board [3s 3c 6c 5h]
Seat 2: xobit26 folded before Flop (didn't bet)
Seat 3: 6l4ck folded before Flop (didn't bet)
Seat 4: monkeypokerdirt collected ($4.99)
Seat 5: Jesterclown folded before Flop (didn't bet)
Seat 6: TR1CKTR1CK folded before Flop (didn't bet)
Seat 7: pudge.3096 (button) folded before Flop (didn't bet)
Seat 8: Kasselbanki (small blind) folded before Flop
Seat 9: rovara (big blind) folded on the Turn



PokerStars Hand #228672356883:  Hold'em No Limit ($0.25/$0.50 USD) - 2021/07/30 23:24:54 ET
Table 'Laodamia II' 9-max Seat #8 is the button
Seat 2: xobit26 ($66.32 in chips) 
Seat 3: 6l4ck ($84.89 in chips) 
Seat 4: monkeypokerdirt ($37.18 in chips) 
Seat 5: Jesterclown ($50.25 in chips) 
Seat 6: TR1CKTR1CK ($49.25 in chips) 
Seat 7: pudge.3096 ($50.75 in chips) 
Seat 8: Kasselbanki ($58.02 in chips) 
Seat 9: rovara ($59.06 in chips) 
rovara: posts small blind $0.25
xobit26: posts big blind $0.50
*** HOLE CARDS ***
6l4ck has timed out
6l4ck: folds 
monkeypokerdirt: folds 
Jesterclown: raises $1 to $1.50
TR1CKTR1CK: folds 
pudge.3096: folds 
Kasselbanki: calls $1.50
rovara: folds 
xobit26: folds 
*** FLOP *** [3s Jh 5s]
Jesterclown: bets $2
Kasselbanki: folds 
Uncalled bet ($2) returned to Jesterclown
Jesterclown collected $3.56 from pot
Jesterclown: doesn't show hand 
*** SUMMARY ***
Total pot $3.75 | Rake $0.19 
Board [3s Jh 5s]
Seat 2: xobit26 (big blind) folded before Flop
Seat 3: 6l4ck folded before Flop (didn't bet)
Seat 4: monkeypokerdirt folded before Flop (didn't bet)
Seat 5: Jesterclown collected ($3.56)
Seat 6: TR1CKTR1CK folded before Flop (didn't bet)
Seat 7: pudge.3096 folded before Flop (didn't bet)
Seat 8: Kasselbanki (button) folded on the Flop
Seat 9: rovara (small blind) folded before Flop



PokerStars Hand #228672366153:  Hold'em No Limit ($0.25/$0.50 USD) - 2021/07/30 23:25:47 ET
Table 'Laodamia II' 9-max Seat #9 is the button
Seat 2: xobit26 ($65.82 in chips) 
Seat 3: 6l4ck ($84.89 in chips) 
Seat 4: monkeypokerdirt ($37.18 in chips) 
Seat 5: Jesterclown ($52.31 in chips) 
Seat 6: TR1CKTR1CK ($49.25 in chips) 
Seat 7: pudge.3096 ($50.75 in chips) 
Seat 8: Kasselbanki ($56.52 in chips) 
Seat 9: rovara ($58.81 in chips) 
xobit26: posts small blind $0.25
6l4ck: posts big blind $0.50
*** HOLE CARDS ***
monkeypokerdirt: calls $0.50
Jesterclown: folds 
TR1CKTR1CK: folds 
pudge.3096: folds 
Kasselbanki: folds 
rovara: folds 
xobit26: calls $0.25
6l4ck: checks 
*** FLOP *** [7c 6s 8h]
xobit26: checks 
6l4ck: bets $1.25
monkeypokerdirt: calls $1.25
xobit26: folds 
*** TURN *** [7c 6s 8h] [Qc]
6l4ck: bets $2.50
monkeypokerdirt: calls $2.50
*** RIVER *** [7c 6s 8h Qc] [7s]
6l4ck: checks 
monkeypokerdirt: bets $6
6l4ck: calls $6
*** SHOW DOWN ***
monkeypokerdirt: shows [5h 2h] (a pair of Sevens)
6l4ck: shows [8s Ad] (two pair, Eights and Sevens)
6l4ck collected $19.95 from pot
*** SUMMARY ***
Total pot $21 | Rake $1.05 
Board [7c 6s 8h Qc 7s]
Seat 2: xobit26 (small blind) folded on the Flop
Seat 3: 6l4ck (big blind) showed [8s Ad] and won ($19.95) with two pair, Eights and Sevens
Seat 4: monkeypokerdirt showed [5h 2h] and lost with a pair of Sevens
Seat 5: Jesterclown folded before Flop (didn't bet)
Seat 6: TR1CKTR1CK folded before Flop (didn't bet)
Seat 7: pudge.3096 folded before Flop (didn't bet)
Seat 8: Kasselbanki folded before Flop (didn't bet)
Seat 9: rovara (button) folded before Flop (didn't bet)



PokerStars Hand #228672383515:  Hold'em No Limit ($0.25/$0.50 USD) - 2021/07/30 23:27:27 ET
Table 'Laodamia II' 9-max Seat #2 is the button
Seat 2: xobit26 ($65.32 in chips) 
Seat 3: 6l4ck ($94.59 in chips) 
Seat 4: monkeypokerdirt ($26.93 in chips) 
Seat 5: Jesterclown ($52.31 in chips) 
Seat 6: TR1CKTR1CK ($49.25 in chips) 
Seat 7: pudge.3096 ($50.75 in chips) 
Seat 8: Kasselbanki ($56.52 in chips) 
Seat 9: rovara ($58.81 in chips) 
6l4ck: posts small blind $0.25
monkeypokerdirt: posts big blind $0.50
I oguz han I: sits out 
*** HOLE CARDS ***
Jesterclown: folds 
TR1CKTR1CK: folds 
pudge.3096: raises $0.75 to $1.25
Kasselbanki: raises $1.75 to $3
rovara: folds 
xobit26: folds 
6l4ck: folds 
monkeypokerdirt: folds 
pudge.3096: raises $6 to $9
Kasselbanki: calls $6
*** FLOP *** [6c 5d 2h]
pudge.3096: bets $5.70
Kasselbanki: calls $5.70
*** TURN *** [6c 5d 2h] [Qs]
pudge.3096: checks 
Kasselbanki: bets $0.50
pudge.3096: raises $18.50 to $19
Kasselbanki: calls $18.50
*** RIVER *** [6c 5d 2h Qs] [5h]
pudge.3096: bets $17.05 and is all-in
Kasselbanki: calls $17.05
I oguz han I leaves the table
*** SHOW DOWN ***
pudge.3096: shows [As Ah] (two pair, Aces and Fives)
Kasselbanki: shows [Jc Jd] (two pair, Jacks and Fives)
pudge.3096 collected $100.25 from pot
*** SUMMARY ***
Total pot $102.25 | Rake $2 
Board [6c 5d 2h Qs 5h]
Seat 2: xobit26 (button) folded before Flop (didn't bet)
Seat 3: 6l4ck (small blind) folded before Flop
Seat 4: monkeypokerdirt (big blind) folded before Flop
Seat 5: Jesterclown folded before Flop (didn't bet)
Seat 6: TR1CKTR1CK folded before Flop (didn't bet)
Seat 7: pudge.3096 showed [As Ah] and won ($100.25) with two pair, Aces and Fives
Seat 8: Kasselbanki showed [Jc Jd] and lost with two pair, Jacks and Fives
Seat 9: rovara folded before Flop (didn't bet)



PokerStars Hand #228672409522:  Hold'em No Limit ($0.25/$0.50 USD) - 2021/07/30 23:29:16 ET
Table 'Laodamia II' 9-max Seat #3 is the button
Seat 2: xobit26 ($65.32 in chips) 
Seat 3: 6l4ck ($94.34 in chips) 
Seat 5: Jesterclown ($52.31 in chips) 
Seat 6: TR1CKTR1CK ($49.25 in chips) 
Seat 7: pudge.3096 ($100.25 in chips) 
Seat 8: Kasselbanki ($5.77 in chips) 
Seat 9: rovara ($58.81 in chips) 
Jesterclown: posts small blind $0.25
TR1CKTR1CK: posts big blind $0.50
*** HOLE CARDS ***
pudge.3096: folds 
Kasselbanki: folds 
Kasselbanki leaves the table
rovara: folds 
xobit26: folds 
6l4ck: raises $0.75 to $1.25
rovara is disconnected 
Jesterclown: folds 
TR1CKTR1CK: calls $0.75
*** FLOP *** [Td 4d 2c]
TR1CKTR1CK: checks 
6l4ck: bets $1.50
TR1CKTR1CK: calls $1.50
*** TURN *** [Td 4d 2c] [Kh]
TR1CKTR1CK: checks 
6l4ck: bets $4.10
I oguz han I joins the table at seat #1 
TR1CKTR1CK: folds 
Uncalled bet ($4.10) returned to 6l4ck
6l4ck collected $5.46 from pot
6l4ck: doesn't show hand 
*** SUMMARY ***
Total pot $5.75 | Rake $0.29 
Board [Td 4d 2c Kh]
Seat 2: xobit26 folded before Flop (didn't bet)
Seat 3: 6l4ck (button) collected ($5.46)
Seat 5: Jesterclown (small blind) folded before Flop
Seat 6: TR1CKTR1CK (big blind) folded on the Turn
Seat 7: pudge.3096 folded before Flop (didn't bet)
Seat 8: Kasselbanki folded before Flop (didn't bet)
Seat 9: rovara folded before Flop (didn't bet)



PokerStars Hand #228672420599:  Hold'em No Limit ($0.25/$0.50 USD) - 2021/07/30 23:30:19 ET
Table 'Laodamia II' 9-max Seat #5 is the button
Seat 1: I oguz han I ($56.10 in chips) 
Seat 2: xobit26 ($65.32 in chips) 
Seat 3: 6l4ck ($97.05 in chips) 
Seat 5: Jesterclown ($52.06 in chips) 
Seat 6: TR1CKTR1CK ($46.50 in chips) 
Seat 7: pudge.3096 ($100.25 in chips) 
Seat 9: rovara ($58.81 in chips) 
TR1CKTR1CK: posts small blind $0.25
pudge.3096: posts big blind $0.50
I oguz han I: posts big blind $0.50
*** HOLE CARDS ***
rovara: folds 
I oguz han I: checks 
xobit26: folds 
6l4ck: folds 
Jesterclown: folds 
TR1CKTR1CK: calls $0.25
pudge.3096: checks 
*** FLOP *** [8d Ad 4c]
TR1CKTR1CK: bets $0.50
pudge.3096: calls $0.50
I oguz han I: folds 
*** TURN *** [8d Ad 4c] [3d]
TR1CKTR1CK: bets $0.79
pudge.3096: folds 
Uncalled bet ($0.79) returned to TR1CKTR1CK
TR1CKTR1CK collected $2.38 from pot
*** SUMMARY ***
Total pot $2.50 | Rake $0.12 
Board [8d Ad 4c 3d]
Seat 1: I oguz han I folded on the Flop (didn't bet)
Seat 2: xobit26 folded before Flop (didn't bet)
Seat 3: 6l4ck folded before Flop (didn't bet)
Seat 5: Jesterclown (button) folded before Flop (didn't bet)
Seat 6: TR1CKTR1CK (small blind) collected ($2.38)
Seat 7: pudge.3096 (big blind) folded on the Turn
Seat 9: rovara folded before Flop (didn't bet)



PokerStars Hand #228672427322:  Hold'em No Limit ($0.25/$0.50 USD) - 2021/07/30 23:30:57 ET
Table 'Laodamia II' 9-max Seat #6 is the button
Seat 1: I oguz han I ($55.60 in chips) 
Seat 2: xobit26 ($65.32 in chips) 
Seat 3: 6l4ck ($97.05 in chips) 
Seat 5: Jesterclown ($52.06 in chips) 
Seat 6: TR1CKTR1CK ($47.88 in chips) 
Seat 7: pudge.3096 ($99.25 in chips) 
Seat 9: rovara ($58.81 in chips) 
pudge.3096: posts small blind $0.25
rovara: posts big blind $0.50
*** HOLE CARDS ***
I oguz han I: folds 
undergr0undY joins the table at seat #8 
xobit26: raises $1 to $1.50
6l4ck: folds 
Jesterclown: folds 
TR1CKTR1CK: folds 
pudge.3096: folds 
rovara: folds 
Uncalled bet ($1) returned to xobit26
xobit26 collected $1.25 from pot
xobit26: doesn't show hand 
*** SUMMARY ***
Total pot $1.25 | Rake $0 
Seat 1: I oguz han I folded before Flop (didn't bet)
Seat 2: xobit26 collected ($1.25)
Seat 3: 6l4ck folded before Flop (didn't bet)
Seat 5: Jesterclown folded before Flop (didn't bet)
Seat 6: TR1CKTR1CK (button) folded before Flop (didn't bet)
Seat 7: pudge.3096 (small blind) folded before Flop
Seat 9: rovara (big blind) folded before Flop



PokerStars Hand #228672429829:  Hold'em No Limit ($0.25/$0.50 USD) - 2021/07/30 23:31:12 ET
Table 'Laodamia II' 9-max Seat #7 is the button
Seat 1: I oguz han I ($55.60 in chips) 
Seat 2: xobit26 ($66.07 in chips) 
Seat 3: 6l4ck ($97.05 in chips) 
Seat 5: Jesterclown ($52.06 in chips) 
Seat 6: TR1CKTR1CK ($47.88 in chips) 
Seat 7: pudge.3096 ($99 in chips) 
Seat 9: rovara ($58.31 in chips) 
rovara: posts small blind $0.25
I oguz han I: posts big blind $0.50
*** HOLE CARDS ***
xobit26: folds 
6l4ck: folds 
Jesterclown: folds 
TR1CKTR1CK: folds 
pudge.3096: folds 
rovara: folds 
Uncalled bet ($0.25) returned to I oguz han I
I oguz han I collected $0.50 from pot
I oguz han I: doesn't show hand 
*** SUMMARY ***
Total pot $0.50 | Rake $0 
Seat 1: I oguz han I (big blind) collected ($0.50)
Seat 2: xobit26 folded before Flop (didn't bet)
Seat 3: 6l4ck folded before Flop (didn't bet)
Seat 5: Jesterclown folded before Flop (didn't bet)
Seat 6: TR1CKTR1CK folded before Flop (didn't bet)
Seat 7: pudge.3096 (button) folded before Flop (didn't bet)
Seat 9: rovara (small blind) folded before Flop



PokerStars Hand #228672434240:  Hold'em No Limit ($0.25/$0.50 USD) - 2021/07/30 23:31:37 ET
Table 'Laodamia II' 9-max Seat #9 is the button
Seat 1: I oguz han I ($55.85 in chips) 
Seat 2: xobit26 ($66.07 in chips) 
Seat 3: 6l4ck ($97.05 in chips) 
Seat 5: Jesterclown ($52.06 in chips) 
Seat 6: TR1CKTR1CK ($47.88 in chips) 
Seat 7: pudge.3096 ($99 in chips) 
Seat 9: rovara ($58.06 in chips) 
I oguz han I: posts small blind $0.25
xobit26: posts big blind $0.50
undergr0undY: sits out 
*** HOLE CARDS ***
6l4ck: folds 
Jesterclown: folds 
TR1CKTR1CK: folds 
pudge.3096: folds 
rovara: folds 
I oguz han I: raises $1 to $1.50
xobit26: calls $1
*** FLOP *** [Jc 4c Tc]
I oguz han I: bets $1
xobit26: raises $3.64 to $4.64
I oguz han I: folds 
Uncalled bet ($3.64) returned to xobit26
xobit26 collected $4.75 from pot
xobit26: doesn't show hand 
*** SUMMARY ***
Total pot $5 | Rake $0.25 
Board [Jc 4c Tc]
Seat 1: I oguz han I (small blind) folded on the Flop
Seat 2: xobit26 (big blind) collected ($4.75)
Seat 3: 6l4ck folded before Flop (didn't bet)
Seat 5: Jesterclown folded before Flop (didn't bet)
Seat 6: TR1CKTR1CK folded before Flop (didn't bet)
Seat 7: pudge.3096 folded before Flop (didn't bet)
Seat 9: rovara (button) folded before Flop (didn't bet)



PokerStars Hand #228672442275:  Hold'em No Limit ($0.25/$0.50 USD) - 2021/07/30 23:32:23 ET
Table 'Laodamia II' 9-max Seat #1 is the button
Seat 1: I oguz han I ($53.35 in chips) 
Seat 2: xobit26 ($68.32 in chips) 
Seat 5: Jesterclown ($52.06 in chips) 
Seat 6: TR1CKTR1CK ($47.88 in chips) 
Seat 7: pudge.3096 ($99 in chips) 
Seat 9: rovara ($58.06 in chips) 
xobit26: posts small blind $0.25
6l4ck: is sitting out 
Jesterclown: posts big blind $0.50
undergr0undY: sits out 
*** HOLE CARDS ***
6l4ck leaves the table
TR1CKTR1CK: folds 
pudge.3096: folds 
rovara: folds 
I oguz han I: raises $1 to $1.50
xobit26: raises $3.50 to $5
Jesterclown: folds 
I oguz han I: folds 
Uncalled bet ($3.50) returned to xobit26
xobit26 collected $3.50 from pot
xobit26: doesn't show hand 
*** SUMMARY ***
Total pot $3.50 | Rake $0 
Seat 1: I oguz han I (button) folded before Flop
Seat 2: xobit26 (small blind) collected ($3.50)
Seat 5: Jesterclown (big blind) folded before Flop
Seat 6: TR1CKTR1CK folded before Flop (didn't bet)
Seat 7: pudge.3096 folded before Flop (didn't bet)
Seat 9: rovara folded before Flop (didn't bet)



PokerStars Hand #228672446693:  Hold'em No Limit ($0.25/$0.50 USD) - 2021/07/30 23:32:48 ET
Table 'Laodamia II' 9-max Seat #2 is the button
Seat 1: I oguz han I ($51.85 in chips) 
Seat 2: xobit26 ($70.32 in chips) 
Seat 5: Jesterclown ($51.56 in chips) 
Seat 6: TR1CKTR1CK ($47.88 in chips) 
Seat 7: pudge.3096 ($99 in chips) 
Seat 9: rovara ($58.06 in chips) 
Jesterclown: posts small blind $0.25
TR1CKTR1CK: posts big blind $0.50
undergr0undY: sits out 
*** HOLE CARDS ***
pudge.3096: folds 
rovara: raises $1 to $1.50
I oguz han I: folds 
xobit26: folds 
Jesterclown: folds 
TR1CKTR1CK: folds 
Uncalled bet ($1) returned to rovara
rovara collected $1.25 from pot
*** SUMMARY ***
Total pot $1.25 | Rake $0 
Seat 1: I oguz han I folded before Flop (didn't bet)
Seat 2: xobit26 (button) folded before Flop (didn't bet)
Seat 5: Jesterclown (small blind) folded before Flop
Seat 6: TR1CKTR1CK (big blind) folded before Flop
Seat 7: pudge.3096 folded before Flop (didn't bet)
Seat 9: rovara collected ($1.25)



PokerStars Hand #228672450030:  Hold'em No Limit ($0.25/$0.50 USD) - 2021/07/30 23:33:07 ET
Table 'Laodamia II' 9-max Seat #5 is the button
Seat 1: I oguz han I ($51.85 in chips) 
Seat 2: xobit26 ($70.32 in chips) 
Seat 5: Jesterclown ($51.31 in chips) 
Seat 6: TR1CKTR1CK ($47.38 in chips) 
Seat 7: pudge.3096 ($99 in chips) 
Seat 9: rovara ($58.81 in chips) 
TR1CKTR1CK: posts small blind $0.25
pudge.3096: posts big blind $0.50
undergr0undY: sits out 
*** HOLE CARDS ***
rovara: folds 
I oguz han I: raises $1 to $1.50
xobit26: folds 
Jesterclown: folds 
TR1CKTR1CK: folds 
pudge.3096: folds 
Uncalled bet ($1) returned to I oguz han I
I oguz han I collected $1.25 from pot
I oguz han I: doesn't show hand 
*** SUMMARY ***
Total pot $1.25 | Rake $0 
Seat 1: I oguz han I collected ($1.25)
Seat 2: xobit26 folded before Flop (didn't bet)
Seat 5: Jesterclown (button) folded before Flop (didn't bet)
Seat 6: TR1CKTR1CK (small blind) folded before Flop
Seat 7: pudge.3096 (big blind) folded before Flop
Seat 9: rovara folded before Flop (didn't bet)



PokerStars Hand #228672454651:  Hold'em No Limit ($0.25/$0.50 USD) - 2021/07/30 23:33:34 ET
Table 'Laodamia II' 9-max Seat #6 is the button
Seat 1: I oguz han I ($52.60 in chips) 
Seat 2: xobit26 ($70.32 in chips) 
Seat 5: Jesterclown ($51.31 in chips) 
Seat 6: TR1CKTR1CK ($47.13 in chips) 
Seat 7: pudge.3096 ($98.50 in chips) 
Seat 8: undergr0undY ($50 in chips) 
Seat 9: rovara ($58.81 in chips) 
pudge.3096: posts small blind $0.25
undergr0undY: posts big blind $0.50
*** HOLE CARDS ***
rovara: folds 
I oguz han I: raises $1 to $1.50
xobit26: folds 
Jesterclown: folds 
TR1CKTR1CK: folds 
pudge.3096: folds 
undergr0undY: folds 
Uncalled bet ($1) returned to I oguz han I
I oguz han I collected $1.25 from pot
I oguz han I: doesn't show hand 
*** SUMMARY ***
Total pot $1.25 | Rake $0 
Seat 1: I oguz han I collected ($1.25)
Seat 2: xobit26 folded before Flop (didn't bet)
Seat 5: Jesterclown folded before Flop (didn't bet)
Seat 6: TR1CKTR1CK (button) folded before Flop (didn't bet)
Seat 7: pudge.3096 (small blind) folded before Flop
Seat 8: undergr0undY (big blind) folded before Flop
Seat 9: rovara folded before Flop (didn't bet)



PokerStars Hand #228672459157:  Hold'em No Limit ($0.25/$0.50 USD) - 2021/07/30 23:34:00 ET
Table 'Laodamia II' 9-max Seat #7 is the button
Seat 1: I oguz han I ($53.35 in chips) 
Seat 2: xobit26 ($70.32 in chips) 
Seat 5: Jesterclown ($51.31 in chips) 
Seat 6: TR1CKTR1CK ($47.13 in chips) 
Seat 7: pudge.3096 ($98.25 in chips) 
Seat 8: undergr0undY ($50 in chips) 
Seat 9: rovara ($58.81 in chips) 
undergr0undY: posts small blind $0.25
rovara: posts big blind $0.50
*** HOLE CARDS ***
I oguz han I: folds 
xobit26: folds 
Jesterclown: folds 
TR1CKTR1CK: folds 
pudge.3096: folds 
undergr0undY: folds 
Uncalled bet ($0.25) returned to rovara
rovara collected $0.50 from pot
*** SUMMARY ***
Total pot $0.50 | Rake $0 
Seat 1: I oguz han I folded before Flop (didn't bet)
Seat 2: xobit26 folded before Flop (didn't bet)
Seat 5: Jesterclown folded before Flop (didn't bet)
Seat 6: TR1CKTR1CK folded before Flop (didn't bet)
Seat 7: pudge.3096 (button) folded before Flop (didn't bet)
Seat 8: undergr0undY (small blind) folded before Flop
Seat 9: rovara (big blind) collected ($0.50)



PokerStars Hand #228672498068:  Hold'em No Limit ($0.25/$0.50 USD) - 2021/07/30 23:37:47 ET
Table 'Laodamia II' 9-max Seat #2 is the button
Seat 1: I oguz han I ($25.10 in chips) 
Seat 2: xobit26 ($69.57 in chips) 
Seat 3: Millten ($50 in chips) 
Seat 4: monkeypokerdirt ($25.68 in chips) 
Seat 5: Jesterclown ($51.31 in chips) 
Seat 6: TR1CKTR1CK ($47.13 in chips) 
Seat 7: pudge.3096 ($100.25 in chips) 
Seat 8: undergr0undY ($50 in chips) 
Seat 9: rovara ($85.81 in chips) 
Millten: posts small blind $0.25
monkeypokerdirt: posts big blind $0.50
*** HOLE CARDS ***
Jesterclown: folds 
TR1CKTR1CK: folds 
pudge.3096: folds 
undergr0undY: folds 
rovara: folds 
I oguz han I: raises $1 to $1.50
xobit26: raises $3 to $4.50
Millten: folds 
monkeypokerdirt: folds 
I oguz han I: raises $20.60 to $25.10 and is all-in
xobit26: folds 
Uncalled bet ($20.60) returned to I oguz han I
I oguz han I collected $9.75 from pot
I oguz han I: doesn't show hand 
*** SUMMARY ***
Total pot $9.75 | Rake $0 
Seat 1: I oguz han I collected ($9.75)
Seat 2: xobit26 (button) folded before Flop
Seat 3: Millten (small blind) folded before Flop
Seat 4: monkeypokerdirt (big blind) folded before Flop
Seat 5: Jesterclown folded before Flop (didn't bet)
Seat 6: TR1CKTR1CK folded before Flop (didn't bet)
Seat 7: pudge.3096 folded before Flop (didn't bet)
Seat 8: undergr0undY folded before Flop (didn't bet)
Seat 9: rovara folded before Flop (didn't bet)



PokerStars Hand #228672506185:  Hold'em No Limit ($0.25/$0.50 USD) - 2021/07/30 23:38:35 ET
Table 'Laodamia II' 9-max Seat #3 is the button
Seat 1: I oguz han I ($30.35 in chips) 
Seat 2: xobit26 ($65.07 in chips) 
Seat 3: Millten ($50 in chips) 
Seat 4: monkeypokerdirt ($25.18 in chips) 
Seat 5: Jesterclown ($51.31 in chips) 
Seat 6: TR1CKTR1CK ($47.13 in chips) 
Seat 7: pudge.3096 ($100.25 in chips) 
Seat 8: undergr0undY ($50 in chips) 
Seat 9: rovara ($85.81 in chips) 
monkeypokerdirt: posts small blind $0.25
Jesterclown: posts big blind $0.50
*** HOLE CARDS ***
TR1CKTR1CK has timed out
TR1CKTR1CK: folds 
pudge.3096: raises $0.75 to $1.25
undergr0undY: folds 
rovara: folds 
I oguz han I: calls $1.25
xobit26: folds 
Millten: folds 
monkeypokerdirt: calls $1
Jesterclown: folds 
*** FLOP *** [Kc Kh Qd]
monkeypokerdirt: checks 
pudge.3096: bets $1.29
I oguz han I: folds 
monkeypokerdirt: raises $2.21 to $3.50
pudge.3096: calls $2.21
*** TURN *** [Kc Kh Qd] [7d]
monkeypokerdirt: checks 
pudge.3096: bets $6.95
monkeypokerdirt: folds 
Uncalled bet ($6.95) returned to pudge.3096
pudge.3096 collected $10.69 from pot
pudge.3096: doesn't show hand 
*** SUMMARY ***
Total pot $11.25 | Rake $0.56 
Board [Kc Kh Qd 7d]
Seat 1: I oguz han I folded on the Flop
Seat 2: xobit26 folded before Flop (didn't bet)
Seat 3: Millten (button) folded before Flop (didn't bet)
Seat 4: monkeypokerdirt (small blind) folded on the Turn
Seat 5: Jesterclown (big blind) folded before Flop
Seat 6: TR1CKTR1CK folded before Flop (didn't bet)
Seat 7: pudge.3096 collected ($10.69)
Seat 8: undergr0undY folded before Flop (didn't bet)
Seat 9: rovara folded before Flop (didn't bet)



PokerStars Hand #228672520955:  Hold'em No Limit ($0.25/$0.50 USD) - 2021/07/30 23:40:02 ET
Table 'Laodamia II' 9-max Seat #4 is the button
Seat 1: I oguz han I ($29.10 in chips) 
Seat 2: xobit26 ($65.07 in chips) 
Seat 3: Millten ($50 in chips) 
Seat 4: monkeypokerdirt ($20.43 in chips) 
Seat 5: Jesterclown ($50.81 in chips) 
Seat 6: TR1CKTR1CK ($47.13 in chips) 
Seat 7: pudge.3096 ($106.19 in chips) 
Seat 8: undergr0undY ($50 in chips) 
Seat 9: rovara ($85.81 in chips) 
Jesterclown: posts small blind $0.25
TR1CKTR1CK: posts big blind $0.50
*** HOLE CARDS ***
pudge.3096: folds 
undergr0undY: folds 
rovara: folds 
I oguz han I: folds 
xobit26: folds 
Millten: folds 
monkeypokerdirt: folds 
Jesterclown: raises $1 to $1.50
TR1CKTR1CK: folds 
Uncalled bet ($1) returned to Jesterclown
Jesterclown collected $1 from pot
Jesterclown: doesn't show hand 
*** SUMMARY ***
Total pot $1 | Rake $0 
Seat 1: I oguz han I folded before Flop (didn't bet)
Seat 2: xobit26 folded before Flop (didn't bet)
Seat 3: Millten folded before Flop (didn't bet)
Seat 4: monkeypokerdirt (button) folded before Flop (didn't bet)
Seat 5: Jesterclown (small blind) collected ($1)
Seat 6: TR1CKTR1CK (big blind) folded before Flop
Seat 7: pudge.3096 folded before Flop (didn't bet)
Seat 8: undergr0undY folded before Flop (didn't bet)
Seat 9: rovara folded before Flop (didn't bet)



PokerStars Hand #228672526079:  Hold'em No Limit ($0.25/$0.50 USD) - 2021/07/30 23:40:31 ET
Table 'Laodamia II' 9-max Seat #5 is the button
Seat 1: I oguz han I ($29.10 in chips) 
Seat 2: xobit26 ($65.07 in chips) 
Seat 3: Millten ($50 in chips) 
Seat 4: monkeypokerdirt ($20.43 in chips) 
Seat 5: Jesterclown ($51.31 in chips) 
Seat 6: TR1CKTR1CK ($46.63 in chips) 
Seat 7: pudge.3096 ($106.19 in chips) 
Seat 8: undergr0undY ($50 in chips) 
Seat 9: rovara ($85.81 in chips) 
TR1CKTR1CK: posts small blind $0.25
pudge.3096: posts big blind $0.50
*** HOLE CARDS ***
undergr0undY: folds 
rovara: folds 
I oguz han I: folds 
xobit26: folds 
Millten: folds 
monkeypokerdirt: folds 
Jesterclown: folds 
TR1CKTR1CK: folds 
Uncalled bet ($0.25) returned to pudge.3096
pudge.3096 collected $0.50 from pot
pudge.3096: doesn't show hand 
*** SUMMARY ***
Total pot $0.50 | Rake $0 
Seat 1: I oguz han I folded before Flop (didn't bet)
Seat 2: xobit26 folded before Flop (didn't bet)
Seat 3: Millten folded before Flop (didn't bet)
Seat 4: monkeypokerdirt folded before Flop (didn't bet)
Seat 5: Jesterclown (button) folded before Flop (didn't bet)
Seat 6: TR1CKTR1CK (small blind) folded before Flop
Seat 7: pudge.3096 (big blind) collected ($0.50)
Seat 8: undergr0undY folded before Flop (didn't bet)
Seat 9: rovara folded before Flop (didn't bet)



PokerStars Hand #228672528548:  Hold'em No Limit ($0.25/$0.50 USD) - 2021/07/30 23:40:46 ET
Table 'Laodamia II' 9-max Seat #6 is the button
Seat 1: I oguz han I ($29.10 in chips) 
Seat 2: xobit26 ($65.07 in chips) 
Seat 3: Millten ($50 in chips) 
Seat 4: monkeypokerdirt ($20.43 in chips) 
Seat 5: Jesterclown ($51.31 in chips) 
Seat 6: TR1CKTR1CK ($46.38 in chips) 
Seat 7: pudge.3096 ($106.44 in chips) 
Seat 8: undergr0undY ($50 in chips) 
Seat 9: rovara ($85.81 in chips) 
pudge.3096: posts small blind $0.25
undergr0undY: posts big blind $0.50
*** HOLE CARDS ***
rovara: folds 
I oguz han I: folds 
xobit26: folds 
Millten: folds 
monkeypokerdirt: folds 
Jesterclown: folds 
TR1CKTR1CK: folds 
pudge.3096: folds 
Uncalled bet ($0.25) returned to undergr0undY
undergr0undY collected $0.50 from pot
*** SUMMARY ***
Total pot $0.50 | Rake $0 
Seat 1: I oguz han I folded before Flop (didn't bet)
Seat 2: xobit26 folded before Flop (didn't bet)
Seat 3: Millten folded before Flop (didn't bet)
Seat 4: monkeypokerdirt folded before Flop (didn't bet)
Seat 5: Jesterclown folded before Flop (didn't bet)
Seat 6: TR1CKTR1CK (button) folded before Flop (didn't bet)
Seat 7: pudge.3096 (small blind) folded before Flop
Seat 8: undergr0undY (big blind) collected ($0.50)
Seat 9: rovara folded before Flop (didn't bet)



PokerStars Hand #228672533856:  Hold'em No Limit ($0.25/$0.50 USD) - 2021/07/30 23:41:17 ET
Table 'Laodamia II' 9-max Seat #7 is the button
Seat 1: I oguz han I ($29.10 in chips) 
Seat 2: xobit26 ($65.07 in chips) 
Seat 3: Millten ($50 in chips) 
Seat 4: monkeypokerdirt ($20.43 in chips) 
Seat 5: Jesterclown ($51.31 in chips) 
Seat 6: TR1CKTR1CK ($46.38 in chips) 
Seat 7: pudge.3096 ($106.19 in chips) 
Seat 8: undergr0undY ($50.25 in chips) 
Seat 9: rovara ($85.81 in chips) 
undergr0undY: posts small blind $0.25
rovara: posts big blind $0.50
*** HOLE CARDS ***
I oguz han I: folds 
xobit26: raises $1 to $1.50
Millten: folds 
monkeypokerdirt: folds 
Jesterclown: folds 
TR1CKTR1CK: folds 
pudge.3096: folds 
undergr0undY: folds 
rovara: calls $1
*** FLOP *** [Kc 8h 2h]
rovara: checks 
xobit26: bets $0.93
rovara: folds 
Uncalled bet ($0.93) returned to xobit26
xobit26 collected $3.09 from pot
xobit26: doesn't show hand 
*** SUMMARY ***
Total pot $3.25 | Rake $0.16 
Board [Kc 8h 2h]
Seat 1: I oguz han I folded before Flop (didn't bet)
Seat 2: xobit26 collected ($3.09)
Seat 3: Millten folded before Flop (didn't bet)
Seat 4: monkeypokerdirt folded before Flop (didn't bet)
Seat 5: Jesterclown folded before Flop (didn't bet)
Seat 6: TR1CKTR1CK folded before Flop (didn't bet)
Seat 7: pudge.3096 (button) folded before Flop (didn't bet)
Seat 8: undergr0undY (small blind) folded before Flop
Seat 9: rovara (big blind) folded on the Flop



PokerStars Hand #228672541165:  Hold'em No Limit ($0.25/$0.50 USD) - 2021/07/30 23:42:00 ET
Table 'Laodamia II' 9-max Seat #8 is the button
Seat 1: I oguz han I ($29.10 in chips) 
Seat 2: xobit26 ($66.66 in chips) 
Seat 3: Millten ($50 in chips) 
Seat 4: monkeypokerdirt ($20.43 in chips) 
Seat 5: Jesterclown ($51.31 in chips) 
Seat 6: TR1CKTR1CK ($46.38 in chips) 
Seat 7: pudge.3096 ($106.19 in chips) 
Seat 8: undergr0undY ($50 in chips) 
Seat 9: rovara ($84.31 in chips) 
rovara: posts small blind $0.25
I oguz han I: posts big blind $0.50
*** HOLE CARDS ***
xobit26: folds 
Millten: folds 
monkeypokerdirt: folds 
Jesterclown: folds 
TR1CKTR1CK: folds 
pudge.3096: folds 
undergr0undY: folds 
rovara: raises $1 to $1.50
I oguz han I: raises $3 to $4.50
rovara: calls $3
*** FLOP *** [4d 5d Jc]
rovara: checks 
I oguz han I: bets $3.50
rovara: folds 
Uncalled bet ($3.50) returned to I oguz han I
I oguz han I collected $8.55 from pot
I oguz han I: doesn't show hand 
*** SUMMARY ***
Total pot $9 | Rake $0.45 
Board [4d 5d Jc]
Seat 1: I oguz han I (big blind) collected ($8.55)
Seat 2: xobit26 folded before Flop (didn't bet)
Seat 3: Millten folded before Flop (didn't bet)
Seat 4: monkeypokerdirt folded before Flop (didn't bet)
Seat 5: Jesterclown folded before Flop (didn't bet)
Seat 6: TR1CKTR1CK folded before Flop (didn't bet)
Seat 7: pudge.3096 folded before Flop (didn't bet)
Seat 8: undergr0undY (button) folded before Flop (didn't bet)
Seat 9: rovara (small blind) folded on the Flop



PokerStars Hand #228672550230:  Hold'em No Limit ($0.25/$0.50 USD) - 2021/07/30 23:42:54 ET
Table 'Laodamia II' 9-max Seat #9 is the button
Seat 1: I oguz han I ($33.15 in chips) 
Seat 2: xobit26 ($66.66 in chips) 
Seat 3: Millten ($50 in chips) 
Seat 4: monkeypokerdirt ($20.43 in chips) 
Seat 5: Jesterclown ($51.31 in chips) 
Seat 6: TR1CKTR1CK ($46.38 in chips) 
Seat 7: pudge.3096 ($106.19 in chips) 
Seat 8: undergr0undY ($50 in chips) 
Seat 9: rovara ($79.81 in chips) 
I oguz han I: posts small blind $0.25
xobit26: posts big blind $0.50
*** HOLE CARDS ***
Millten: folds 
monkeypokerdirt: folds 
Jesterclown: folds 
TR1CKTR1CK: folds 
pudge.3096: raises $0.75 to $1.25
undergr0undY: folds 
rovara: folds 
I oguz han I: raises $2.75 to $4
xobit26: folds 
pudge.3096: folds 
Uncalled bet ($2.75) returned to I oguz han I
I oguz han I collected $3 from pot
I oguz han I: doesn't show hand 
*** SUMMARY ***
Total pot $3 | Rake $0 
Seat 1: I oguz han I (small blind) collected ($3)
Seat 2: xobit26 (big blind) folded before Flop
Seat 3: Millten folded before Flop (didn't bet)
Seat 4: monkeypokerdirt folded before Flop (didn't bet)
Seat 5: Jesterclown folded before Flop (didn't bet)
Seat 6: TR1CKTR1CK folded before Flop (didn't bet)
Seat 7: pudge.3096 folded before Flop
Seat 8: undergr0undY folded before Flop (didn't bet)
Seat 9: rovara (button) folded before Flop (didn't bet)



PokerStars Hand #228672555299:  Hold'em No Limit ($0.25/$0.50 USD) - 2021/07/30 23:43:24 ET
Table 'Laodamia II' 9-max Seat #1 is the button
Seat 1: I oguz han I ($34.90 in chips) 
Seat 2: xobit26 ($66.16 in chips) 
Seat 3: Millten ($50 in chips) 
Seat 4: monkeypokerdirt ($20.43 in chips) 
Seat 5: Jesterclown ($51.31 in chips) 
Seat 6: TR1CKTR1CK ($46.38 in chips) 
Seat 7: pudge.3096 ($104.94 in chips) 
Seat 8: undergr0undY ($50 in chips) 
Seat 9: rovara ($79.81 in chips) 
xobit26: posts small blind $0.25
Millten: posts big blind $0.50
*** HOLE CARDS ***
monkeypokerdirt: folds 
Jesterclown: folds 
TR1CKTR1CK: folds 
pudge.3096: folds 
undergr0undY: raises $0.75 to $1.25
rovara: folds 
I oguz han I: folds 
xobit26: folds 
Millten: folds 
Uncalled bet ($0.75) returned to undergr0undY
undergr0undY collected $1.25 from pot
*** SUMMARY ***
Total pot $1.25 | Rake $0 
Seat 1: I oguz han I (button) folded before Flop (didn't bet)
Seat 2: xobit26 (small blind) folded before Flop
Seat 3: Millten (big blind) folded before Flop
Seat 4: monkeypokerdirt folded before Flop (didn't bet)
Seat 5: Jesterclown folded before Flop (didn't bet)
Seat 6: TR1CKTR1CK folded before Flop (didn't bet)
Seat 7: pudge.3096 folded before Flop (didn't bet)
Seat 8: undergr0undY collected ($1.25)
Seat 9: rovara folded before Flop (didn't bet)



PokerStars Hand #228672564733:  Hold'em No Limit ($0.25/$0.50 USD) - 2021/07/30 23:43:53 ET
Table 'Laodamia II' 9-max Seat #2 is the button
Seat 1: I oguz han I ($34.90 in chips) 
Seat 2: xobit26 ($65.91 in chips) 
Seat 3: Millten ($50 in chips) 
Seat 4: monkeypokerdirt ($20.43 in chips) 
Seat 5: Jesterclown ($51.31 in chips) 
Seat 6: TR1CKTR1CK ($46.38 in chips) 
Seat 7: pudge.3096 ($104.94 in chips) 
Seat 8: undergr0undY ($50.75 in chips) 
Seat 9: rovara ($79.81 in chips) 
Millten: posts small blind $0.25
monkeypokerdirt: posts big blind $0.50
*** HOLE CARDS ***
Jesterclown: folds 
TR1CKTR1CK has timed out
TR1CKTR1CK: folds 
pudge.3096: folds 
undergr0undY: folds 
rovara: folds 
I oguz han I: folds 
xobit26: folds 
Millten: raises $0.90 to $1.40
monkeypokerdirt: folds 
Uncalled bet ($0.90) returned to Millten
Millten collected $1 from pot
Millten: doesn't show hand 
*** SUMMARY ***
Total pot $1 | Rake $0 
Seat 1: I oguz han I folded before Flop (didn't bet)
Seat 2: xobit26 (button) folded before Flop (didn't bet)
Seat 3: Millten (small blind) collected ($1)
Seat 4: monkeypokerdirt (big blind) folded before Flop
Seat 5: Jesterclown folded before Flop (didn't bet)
Seat 6: TR1CKTR1CK folded before Flop (didn't bet)
Seat 7: pudge.3096 folded before Flop (didn't bet)
Seat 8: undergr0undY folded before Flop (didn't bet)
Seat 9: rovara folded before Flop (didn't bet)



PokerStars Hand #228672573125:  Hold'em No Limit ($0.25/$0.50 USD) - 2021/07/30 23:44:43 ET
Table 'Laodamia II' 9-max Seat #3 is the button
Seat 1: I oguz han I ($34.90 in chips) 
Seat 2: xobit26 ($65.91 in chips) 
Seat 3: Millten ($50.50 in chips) 
Seat 4: monkeypokerdirt ($19.93 in chips) 
Seat 5: Jesterclown ($51.31 in chips) 
Seat 6: TR1CKTR1CK ($46.38 in chips) 
Seat 7: pudge.3096 ($104.94 in chips) 
Seat 8: undergr0undY ($50.75 in chips) 
Seat 9: rovara ($79.81 in chips) 
monkeypokerdirt: posts small blind $0.25
Jesterclown: posts big blind $0.50
*** HOLE CARDS ***
TR1CKTR1CK: folds 
pudge.3096: folds 
undergr0undY: folds 
rovara: folds 
I oguz han I: raises $1 to $1.50
xobit26: folds 
Millten: folds 
monkeypokerdirt: folds 
Jesterclown: folds 
Uncalled bet ($1) returned to I oguz han I
I oguz han I collected $1.25 from pot
I oguz han I: doesn't show hand 
*** SUMMARY ***
Total pot $1.25 | Rake $0 
Seat 1: I oguz han I collected ($1.25)
Seat 2: xobit26 folded before Flop (didn't bet)
Seat 3: Millten (button) folded before Flop (didn't bet)
Seat 4: monkeypokerdirt (small blind) folded before Flop
Seat 5: Jesterclown (big blind) folded before Flop
Seat 6: TR1CKTR1CK folded before Flop (didn't bet)
Seat 7: pudge.3096 folded before Flop (didn't bet)
Seat 8: undergr0undY folded before Flop (didn't bet)
Seat 9: rovara folded before Flop (didn't bet)



PokerStars Hand #228672577139:  Hold'em No Limit ($0.25/$0.50 USD) - 2021/07/30 23:45:07 ET
Table 'Laodamia II' 9-max Seat #4 is the button
Seat 1: I oguz han I ($35.65 in chips) 
Seat 2: xobit26 ($65.91 in chips) 
Seat 3: Millten ($50.50 in chips) 
Seat 4: monkeypokerdirt ($19.68 in chips) 
Seat 5: Jesterclown ($50.81 in chips) 
Seat 6: TR1CKTR1CK ($46.38 in chips) 
Seat 7: pudge.3096 ($104.94 in chips) 
Seat 8: undergr0undY ($50.75 in chips) 
Seat 9: rovara ($79.81 in chips) 
Jesterclown: posts small blind $0.25
TR1CKTR1CK: posts big blind $0.50
*** HOLE CARDS ***
pudge.3096: folds 
undergr0undY: raises $0.75 to $1.25
rovara: folds 
I oguz han I: folds 
xobit26: folds 
Millten: folds 
monkeypokerdirt: folds 
Jesterclown: folds 
TR1CKTR1CK: folds 
Uncalled bet ($0.75) returned to undergr0undY
undergr0undY collected $1.25 from pot
*** SUMMARY ***
Total pot $1.25 | Rake $0 
Seat 1: I oguz han I folded before Flop (didn't bet)
Seat 2: xobit26 folded before Flop (didn't bet)
Seat 3: Millten folded before Flop (didn't bet)
Seat 4: monkeypokerdirt (button) folded before Flop (didn't bet)
Seat 5: Jesterclown (small blind) folded before Flop
Seat 6: TR1CKTR1CK (big blind) folded before Flop
Seat 7: pudge.3096 folded before Flop (didn't bet)
Seat 8: undergr0undY collected ($1.25)
Seat 9: rovara folded before Flop (didn't bet)



PokerStars Hand #228672581948:  Hold'em No Limit ($0.25/$0.50 USD) - 2021/07/30 23:45:35 ET
Table 'Laodamia II' 9-max Seat #5 is the button
Seat 1: I oguz han I ($35.65 in chips) 
Seat 2: xobit26 ($65.91 in chips) 
Seat 3: Millten ($50.50 in chips) 
Seat 4: monkeypokerdirt ($19.68 in chips) 
Seat 5: Jesterclown ($50.56 in chips) 
Seat 6: TR1CKTR1CK ($45.88 in chips) 
Seat 7: pudge.3096 ($104.94 in chips) 
Seat 8: undergr0undY ($51.50 in chips) 
Seat 9: rovara ($79.81 in chips) 
TR1CKTR1CK: posts small blind $0.25
pudge.3096: posts big blind $0.50
*** HOLE CARDS ***
undergr0undY: folds 
rovara: raises $0.75 to $1.25
I oguz han I: folds 
xobit26: folds 
Millten: folds 
monkeypokerdirt: raises $3.25 to $4.50
Jesterclown: raises $4.50 to $9
TR1CKTR1CK: folds 
pudge.3096: folds 
rovara: folds 
monkeypokerdirt: raises $10.68 to $19.68 and is all-in
Jesterclown: calls $10.68
*** FLOP *** [4d 8c 5s]
*** TURN *** [4d 8c 5s] [4c]
*** RIVER *** [4d 8c 5s 4c] [3c]
*** SHOW DOWN ***
monkeypokerdirt: shows [As Ac] (two pair, Aces and Fours)
Jesterclown: shows [Qd Qc] (two pair, Queens and Fours)
monkeypokerdirt collected $39.36 from pot
*** SUMMARY ***
Total pot $41.36 | Rake $2 
Board [4d 8c 5s 4c 3c]
Seat 1: I oguz han I folded before Flop (didn't bet)
Seat 2: xobit26 folded before Flop (didn't bet)
Seat 3: Millten folded before Flop (didn't bet)
Seat 4: monkeypokerdirt showed [As Ac] and won ($39.36) with two pair, Aces and Fours
Seat 5: Jesterclown (button) showed [Qd Qc] and lost with two pair, Queens and Fours
Seat 6: TR1CKTR1CK (small blind) folded before Flop
Seat 7: pudge.3096 (big blind) folded before Flop
Seat 8: undergr0undY folded before Flop (didn't bet)
Seat 9: rovara folded before Flop



PokerStars Hand #228672593911:  Hold'em No Limit ($0.25/$0.50 USD) - 2021/07/30 23:46:47 ET
Table 'Laodamia II' 9-max Seat #6 is the button
Seat 1: I oguz han I ($35.65 in chips) 
Seat 2: xobit26 ($65.91 in chips) 
Seat 3: Millten ($50.50 in chips) 
Seat 4: monkeypokerdirt ($39.36 in chips) 
Seat 5: Jesterclown ($50 in chips) 
Seat 6: TR1CKTR1CK ($45.63 in chips) 
Seat 7: pudge.3096 ($104.44 in chips) 
Seat 8: undergr0undY ($51.50 in chips) 
Seat 9: rovara ($78.56 in chips) 
pudge.3096: posts small blind $0.25
undergr0undY: posts big blind $0.50
*** HOLE CARDS ***
rovara: folds 
I oguz han I: folds 
xobit26: folds 
Millten: folds 
monkeypokerdirt: folds 
Jesterclown: folds 
TR1CKTR1CK: raises $1 to $1.50
pudge.3096: folds 
undergr0undY: folds 
Uncalled bet ($1) returned to TR1CKTR1CK
TR1CKTR1CK collected $1.25 from pot
*** SUMMARY ***
Total pot $1.25 | Rake $0 
Seat 1: I oguz han I folded before Flop (didn't bet)
Seat 2: xobit26 folded before Flop (didn't bet)
Seat 3: Millten folded before Flop (didn't bet)
Seat 4: monkeypokerdirt folded before Flop (didn't bet)
Seat 5: Jesterclown folded before Flop (didn't bet)
Seat 6: TR1CKTR1CK (button) collected ($1.25)
Seat 7: pudge.3096 (small blind) folded before Flop
Seat 8: undergr0undY (big blind) folded before Flop
Seat 9: rovara folded before Flop (didn't bet)



PokerStars Hand #228672597946:  Hold'em No Limit ($0.25/$0.50 USD) - 2021/07/30 23:47:11 ET
Table 'Laodamia II' 9-max Seat #7 is the button
Seat 1: I oguz han I ($35.65 in chips) 
Seat 2: xobit26 ($65.91 in chips) 
Seat 3: Millten ($50.50 in chips) 
Seat 4: monkeypokerdirt ($39.36 in chips) 
Seat 5: Jesterclown ($50 in chips) 
Seat 6: TR1CKTR1CK ($46.38 in chips) 
Seat 7: pudge.3096 ($104.19 in chips) 
Seat 8: undergr0undY ($51 in chips) 
Seat 9: rovara ($78.56 in chips) 
undergr0undY: posts small blind $0.25
rovara: posts big blind $0.50
*** HOLE CARDS ***
I oguz han I: folds 
xobit26: folds 
Millten: raises $0.90 to $1.40
monkeypokerdirt: folds 
Jesterclown: folds 
TR1CKTR1CK: folds 
pudge.3096: folds 
undergr0undY: folds 
rovara: folds 
Uncalled bet ($0.90) returned to Millten
Millten collected $1.25 from pot
Millten: doesn't show hand 
*** SUMMARY ***
Total pot $1.25 | Rake $0 
Seat 1: I oguz han I folded before Flop (didn't bet)
Seat 2: xobit26 folded before Flop (didn't bet)
Seat 3: Millten collected ($1.25)
Seat 4: monkeypokerdirt folded before Flop (didn't bet)
Seat 5: Jesterclown folded before Flop (didn't bet)
Seat 6: TR1CKTR1CK folded before Flop (didn't bet)
Seat 7: pudge.3096 (button) folded before Flop (didn't bet)
Seat 8: undergr0undY (small blind) folded before Flop
Seat 9: rovara (big blind) folded before Flop



PokerStars Hand #228672603035:  Hold'em No Limit ($0.25/$0.50 USD) - 2021/07/30 23:47:41 ET
Table 'Laodamia II' 9-max Seat #8 is the button
Seat 1: I oguz han I ($35.65 in chips) 
Seat 2: xobit26 ($65.91 in chips) 
Seat 3: Millten ($51.25 in chips) 
Seat 4: monkeypokerdirt ($39.36 in chips) 
Seat 5: Jesterclown ($50 in chips) 
Seat 6: TR1CKTR1CK ($46.38 in chips) 
Seat 7: pudge.3096 ($104.19 in chips) 
Seat 8: undergr0undY ($50.75 in chips) 
Seat 9: rovara ($78.06 in chips) 
rovara: posts small blind $0.25
I oguz han I: posts big blind $0.50
*** HOLE CARDS ***
xobit26: folds 
Millten: folds 
monkeypokerdirt: calls $0.50
Jesterclown: folds 
TR1CKTR1CK: folds 
pudge.3096: folds 
undergr0undY: folds 
rovara: folds 
I oguz han I: checks 
*** FLOP *** [9h 2s 5s]
I oguz han I: bets $0.65
monkeypokerdirt: calls $0.65
*** TURN *** [9h 2s 5s] [Kd]
I oguz han I: checks 
monkeypokerdirt: bets $1.50
I oguz han I: folds 
Uncalled bet ($1.50) returned to monkeypokerdirt
monkeypokerdirt collected $2.42 from pot
*** SUMMARY ***
Total pot $2.55 | Rake $0.13 
Board [9h 2s 5s Kd]
Seat 1: I oguz han I (big blind) folded on the Turn
Seat 2: xobit26 folded before Flop (didn't bet)
Seat 3: Millten folded before Flop (didn't bet)
Seat 4: monkeypokerdirt collected ($2.42)
Seat 5: Jesterclown folded before Flop (didn't bet)
Seat 6: TR1CKTR1CK folded before Flop (didn't bet)
Seat 7: pudge.3096 folded before Flop (didn't bet)
Seat 8: undergr0undY (button) folded before Flop (didn't bet)
Seat 9: rovara (small blind) folded before Flop



PokerStars Hand #228672613112:  Hold'em No Limit ($0.25/$0.50 USD) - 2021/07/30 23:48:40 ET
Table 'Laodamia II' 9-max Seat #9 is the button
Seat 1: I oguz han I ($34.50 in chips) 
Seat 2: xobit26 ($65.91 in chips) 
Seat 3: Millten ($51.25 in chips) 
Seat 4: monkeypokerdirt ($40.63 in chips) 
Seat 5: Jesterclown ($50 in chips) 
Seat 6: TR1CKTR1CK ($46.38 in chips) 
Seat 7: pudge.3096 ($104.19 in chips) 
Seat 8: undergr0undY ($50.75 in chips) 
Seat 9: rovara ($77.81 in chips) 
I oguz han I: posts small blind $0.25
xobit26: posts big blind $0.50
*** HOLE CARDS ***
Millten: folds 
monkeypokerdirt: calls $0.50
Jesterclown: folds 
TR1CKTR1CK: folds 
pudge.3096: folds 
undergr0undY: folds 
rovara: folds 
I oguz han I: calls $0.25
xobit26: checks 
*** FLOP *** [Ks 6h 4d]
I oguz han I: checks 
xobit26: checks 
monkeypokerdirt: bets $1
I oguz han I: folds 
xobit26: calls $1
*** TURN *** [Ks 6h 4d] [5s]
xobit26: checks 
monkeypokerdirt: checks 
*** RIVER *** [Ks 6h 4d 5s] [5h]
xobit26: checks 
monkeypokerdirt: checks 
*** SHOW DOWN ***
xobit26: shows [2d 6c] (two pair, Sixes and Fives)
monkeypokerdirt: mucks hand 
xobit26 collected $3.32 from pot
*** SUMMARY ***
Total pot $3.50 | Rake $0.18 
Board [Ks 6h 4d 5s 5h]
Seat 1: I oguz han I (small blind) folded on the Flop
Seat 2: xobit26 (big blind) showed [2d 6c] and won ($3.32) with two pair, Sixes and Fives
Seat 3: Millten folded before Flop (didn't bet)
Seat 4: monkeypokerdirt mucked
Seat 5: Jesterclown folded before Flop (didn't bet)
Seat 6: TR1CKTR1CK folded before Flop (didn't bet)
Seat 7: pudge.3096 folded before Flop (didn't bet)
Seat 8: undergr0undY folded before Flop (didn't bet)
Seat 9: rovara (button) folded before Flop (didn't bet)



PokerStars Hand #228672626353:  Hold'em No Limit ($0.25/$0.50 USD) - 2021/07/30 23:49:59 ET
Table 'Laodamia II' 9-max Seat #1 is the button
Seat 1: I oguz han I ($34 in chips) 
Seat 2: xobit26 ($67.73 in chips) 
Seat 3: Millten ($51.25 in chips) 
Seat 4: monkeypokerdirt ($39.13 in chips) 
Seat 5: Jesterclown ($50 in chips) 
Seat 6: TR1CKTR1CK ($46.38 in chips) 
Seat 7: pudge.3096 ($104.19 in chips) 
Seat 8: undergr0undY ($50.75 in chips) 
Seat 9: rovara ($77.81 in chips) 
xobit26: posts small blind $0.25
Millten: posts big blind $0.50
*** HOLE CARDS ***
monkeypokerdirt: folds 
Jesterclown: folds 
TR1CKTR1CK: folds 
pudge.3096: folds 
undergr0undY: folds 
rovara: raises $0.75 to $1.25
I oguz han I: folds 
xobit26: folds 
Millten: calls $0.75
*** FLOP *** [4d 8c Kd]
Millten: checks 
rovara: bets $0.86
Millten: calls $0.86
*** TURN *** [4d 8c Kd] [9s]
Millten: bets $2.76
rovara: folds 
Uncalled bet ($2.76) returned to Millten
Millten collected $4.25 from pot
Millten: doesn't show hand 
*** SUMMARY ***
Total pot $4.47 | Rake $0.22 
Board [4d 8c Kd 9s]
Seat 1: I oguz han I (button) folded before Flop (didn't bet)
Seat 2: xobit26 (small blind) folded before Flop
Seat 3: Millten (big blind) collected ($4.25)
Seat 4: monkeypokerdirt folded before Flop (didn't bet)
Seat 5: Jesterclown folded before Flop (didn't bet)
Seat 6: TR1CKTR1CK folded before Flop (didn't bet)
Seat 7: pudge.3096 folded before Flop (didn't bet)
Seat 8: undergr0undY folded before Flop (didn't bet)
Seat 9: rovara folded on the Turn



PokerStars Hand #228672636595:  Hold'em No Limit ($0.25/$0.50 USD) - 2021/07/30 23:51:01 ET
Table 'Laodamia II' 9-max Seat #2 is the button
Seat 1: I oguz han I ($34 in chips) 
Seat 2: xobit26 ($67.48 in chips) 
Seat 3: Millten ($53.39 in chips) 
Seat 4: monkeypokerdirt ($39.13 in chips) 
Seat 5: Jesterclown ($50 in chips) 
Seat 6: TR1CKTR1CK ($46.38 in chips) 
Seat 7: pudge.3096 ($104.19 in chips) 
Seat 8: undergr0undY ($50.75 in chips) 
Seat 9: rovara ($75.70 in chips) 
Millten: posts small blind $0.25
monkeypokerdirt: posts big blind $0.50
*** HOLE CARDS ***
Jesterclown: folds 
TR1CKTR1CK: folds 
pudge.3096: folds 
undergr0undY: folds 
rovara: raises $1 to $1.50
I oguz han I: folds 
xobit26: folds 
Millten: folds 
monkeypokerdirt: folds 
Uncalled bet ($1) returned to rovara
rovara collected $1.25 from pot
*** SUMMARY ***
Total pot $1.25 | Rake $0 
Seat 1: I oguz han I folded before Flop (didn't bet)
Seat 2: xobit26 (button) folded before Flop (didn't bet)
Seat 3: Millten (small blind) folded before Flop
Seat 4: monkeypokerdirt (big blind) folded before Flop
Seat 5: Jesterclown folded before Flop (didn't bet)
Seat 6: TR1CKTR1CK folded before Flop (didn't bet)
Seat 7: pudge.3096 folded before Flop (didn't bet)
Seat 8: undergr0undY folded before Flop (didn't bet)
Seat 9: rovara collected ($1.25)



