PokerStars Hand #228684644308:  Hold'em No Limit ($0.25/$0.50 USD) - 2021/07/30 14:04:15 ET
Table 'Galilea III' 9-max Seat #7 is the button
Seat 1: DOA1980 ($58.29 in chips) 
Seat 2: dstrola ($50 in chips) 
Seat 3: SpeeLy ($56.93 in chips) 
Seat 5: dikanmax ($58.84 in chips) 
Seat 6: PleBeY95 ($60.57 in chips) 
Seat 7: Pachebrash ($50 in chips) 
DOA1980: posts small blind $0.25
dstrola: posts big blind $0.50
akiobenj: sits out 
*** HOLE CARDS ***
SpeeLy: folds 
dikanmax: folds 
PleBeY95: raises $1 to $1.50
Pachebrash: folds 
DOA1980: folds 
dstrola: folds 
Uncalled bet ($1) returned to PleBeY95
PleBeY95 collected $1.25 from pot
*** SUMMARY ***
Total pot $1.25 | Rake $0 
Seat 1: DOA1980 (small blind) folded before Flop
Seat 2: dstrola (big blind) folded before Flop
Seat 3: SpeeLy folded before Flop (didn't bet)
Seat 5: dikanmax folded before Flop (didn't bet)
Seat 6: PleBeY95 collected ($1.25)
Seat 7: Pachebrash (button) folded before Flop (didn't bet)



PokerStars Hand #228683866758:  Hold'em No Limit ($0.25/$0.50 USD) - 2021/07/30 13:32:16 ET
Table 'Galilea III' 9-max Seat #3 is the button
Seat 1: DOA1980 ($50 in chips) 
Seat 2: se13giuum ($39.13 in chips) 
Seat 3: Volk_Vetra ($50.50 in chips) 
Seat 4: butch2102 ($50.25 in chips) 
Seat 5: Hunt133 ($50 in chips) 
butch2102: posts small blind $0.25
Hunt133: posts big blind $0.50
PleBeY95: sits out 
lonely fire: sits out 
RikaSunPay: sits out 
*** HOLE CARDS ***
DOA1980: folds 
se13giuum: folds 
Volk_Vetra: folds 
butch2102: folds 
Uncalled bet ($0.25) returned to Hunt133
Hunt133 collected $0.50 from pot
Hunt133: doesn't show hand 
*** SUMMARY ***
Total pot $0.50 | Rake $0 
Seat 1: DOA1980 folded before Flop (didn't bet)
Seat 2: se13giuum folded before Flop (didn't bet)
Seat 3: Volk_Vetra (button) folded before Flop (didn't bet)
Seat 4: butch2102 (small blind) folded before Flop
Seat 5: Hunt133 (big blind) collected ($0.50)



PokerStars Hand #228683873573:  Hold'em No Limit ($0.25/$0.50 USD) - 2021/07/30 13:32:32 ET
Table 'Galilea III' 9-max Seat #4 is the button
Seat 1: DOA1980 ($50 in chips) 
Seat 2: se13giuum ($39.13 in chips) 
Seat 3: Volk_Vetra ($50.50 in chips) 
Seat 4: butch2102 ($50 in chips) 
Seat 5: Hunt133 ($50.25 in chips) 
Seat 6: PleBeY95 ($50 in chips) 
Hunt133: posts small blind $0.25
PleBeY95: posts big blind $0.50
lonely fire: sits out 
RikaSunPay: sits out 
*** HOLE CARDS ***
DOA1980: folds 
se13giuum: folds 
Volk_Vetra: raises $1 to $1.50
butch2102: calls $1.50
Hunt133: folds 
PleBeY95: folds 
*** FLOP *** [Jd 6d 4h]
Volk_Vetra: checks 
butch2102: bets $3.56
Volk_Vetra: folds 
Uncalled bet ($3.56) returned to butch2102
butch2102 collected $3.56 from pot
butch2102: doesn't show hand 
*** SUMMARY ***
Total pot $3.75 | Rake $0.19 
Board [Jd 6d 4h]
Seat 1: DOA1980 folded before Flop (didn't bet)
Seat 2: se13giuum folded before Flop (didn't bet)
Seat 3: Volk_Vetra folded on the Flop
Seat 4: butch2102 (button) collected ($3.56)
Seat 5: Hunt133 (small blind) folded before Flop
Seat 6: PleBeY95 (big blind) folded before Flop



PokerStars Hand #228683884769:  Hold'em No Limit ($0.25/$0.50 USD) - 2021/07/30 13:32:59 ET
Table 'Galilea III' 9-max Seat #5 is the button
Seat 1: DOA1980 ($50 in chips) 
Seat 2: se13giuum ($39.13 in chips) 
Seat 3: Volk_Vetra ($50 in chips) 
Seat 4: butch2102 ($52.06 in chips) 
Seat 5: Hunt133 ($50 in chips) 
Seat 6: PleBeY95 ($50 in chips) 
Seat 8: lonely fire ($50 in chips) 
PleBeY95: posts small blind $0.25
lonely fire: posts big blind $0.50
RikaSunPay: sits out 
*** HOLE CARDS ***
DOA1980: folds 
se13giuum: folds 
Volk_Vetra: folds 
butch2102: raises $0.50 to $1
Hunt133: folds 
PleBeY95: calls $0.75
lonely fire: calls $0.50
*** FLOP *** [Tc Th 2d]
PleBeY95: checks 
lonely fire: checks 
butch2102: checks 
*** TURN *** [Tc Th 2d] [7s]
PleBeY95: bets $2.14
lonely fire: folds 
butch2102: calls $2.14
*** RIVER *** [Tc Th 2d 7s] [4c]
PleBeY95: bets $5.19
butch2102: calls $5.19
*** SHOW DOWN ***
PleBeY95: shows [8s 9s] (a pair of Tens)
butch2102: shows [As 7c] (two pair, Tens and Sevens)
butch2102 collected $16.78 from pot
*** SUMMARY ***
Total pot $17.66 | Rake $0.88 
Board [Tc Th 2d 7s 4c]
Seat 1: DOA1980 folded before Flop (didn't bet)
Seat 2: se13giuum folded before Flop (didn't bet)
Seat 3: Volk_Vetra folded before Flop (didn't bet)
Seat 4: butch2102 showed [As 7c] and won ($16.78) with two pair, Tens and Sevens
Seat 5: Hunt133 (button) folded before Flop (didn't bet)
Seat 6: PleBeY95 (small blind) showed [8s 9s] and lost with a pair of Tens
Seat 8: lonely fire (big blind) folded on the Turn



PokerStars Hand #228683905246:  Hold'em No Limit ($0.25/$0.50 USD) - 2021/07/30 13:33:48 ET
Table 'Galilea III' 9-max Seat #6 is the button
Seat 1: DOA1980 ($50 in chips) 
Seat 2: se13giuum ($39.13 in chips) 
Seat 3: Volk_Vetra ($50 in chips) 
Seat 4: butch2102 ($60.51 in chips) 
Seat 5: Hunt133 ($50 in chips) 
Seat 6: PleBeY95 ($50 in chips) 
Seat 8: lonely fire ($50 in chips) 
Seat 9: RikaSunPay ($50 in chips) 
lonely fire: posts small blind $0.25
RikaSunPay: posts big blind $0.50
*** HOLE CARDS ***
DOA1980: raises $0.75 to $1.25
se13giuum: folds 
Volk_Vetra: raises $3.25 to $4.50
butch2102: folds 
Hunt133: folds 
PleBeY95: folds 
lonely fire: folds 
RikaSunPay: folds 
DOA1980: calls $3.25
*** FLOP *** [2c 3h 2d]
DOA1980: checks 
Volk_Vetra: bets $3.50
Hunt133 is disconnected 
DOA1980: raises $7 to $10.50
Volk_Vetra: calls $7
*** TURN *** [2c 3h 2d] [7c]
DOA1980: bets $35 and is all-in
Volk_Vetra: calls $35 and is all-in
*** RIVER *** [2c 3h 2d 7c] [5s]
*** SHOW DOWN ***
DOA1980: shows [Qs Qc] (two pair, Queens and Deuces)
Volk_Vetra: shows [Ks Kd] (two pair, Kings and Deuces)
Volk_Vetra collected $98.75 from pot
*** SUMMARY ***
Total pot $100.75 | Rake $2 
Board [2c 3h 2d 7c 5s]
Seat 1: DOA1980 showed [Qs Qc] and lost with two pair, Queens and Deuces
Seat 2: se13giuum folded before Flop (didn't bet)
Seat 3: Volk_Vetra showed [Ks Kd] and won ($98.75) with two pair, Kings and Deuces
Seat 4: butch2102 folded before Flop (didn't bet)
Seat 5: Hunt133 folded before Flop (didn't bet)
Seat 6: PleBeY95 (button) folded before Flop (didn't bet)
Seat 8: lonely fire (small blind) folded before Flop
Seat 9: RikaSunPay (big blind) folded before Flop



PokerStars Hand #228683946639:  Hold'em No Limit ($0.25/$0.50 USD) - 2021/07/30 13:35:12 ET
Table 'Galilea III' 9-max Seat #8 is the button
Seat 1: DOA1980 ($50 in chips) 
Seat 2: se13giuum ($39.13 in chips) 
Seat 3: Volk_Vetra ($98.75 in chips) 
Seat 4: butch2102 ($60.51 in chips) 
Seat 5: Hunt133 ($50 in chips) 
Seat 6: PleBeY95 ($50 in chips) 
Seat 8: lonely fire ($50 in chips) 
Seat 9: RikaSunPay ($50 in chips) 
RikaSunPay: posts small blind $0.25
DOA1980: posts big blind $0.50
Dragonclawss: sits out 
*** HOLE CARDS ***
se13giuum: folds 
Volk_Vetra: folds 
butch2102: calls $0.50
Hunt133 has timed out while disconnected
Hunt133: folds 
PleBeY95: folds 
lonely fire: folds 
RikaSunPay: raises $2 to $2.50
DOA1980: folds 
butch2102: calls $2
*** FLOP *** [8c 5s 4c]
se13giuum is disconnected 
RikaSunPay: bets $3.45
butch2102: calls $3.45
*** TURN *** [8c 5s 4c] [Kh]
RikaSunPay: checks 
butch2102: checks 
*** RIVER *** [8c 5s 4c Kh] [6s]
RikaSunPay: checks 
butch2102: checks 
*** SHOW DOWN ***
RikaSunPay: shows [Qd Qs] (a pair of Queens)
butch2102: mucks hand 
RikaSunPay collected $11.78 from pot
*** SUMMARY ***
Total pot $12.40 | Rake $0.62 
Board [8c 5s 4c Kh 6s]
Seat 1: DOA1980 (big blind) folded before Flop
Seat 2: se13giuum folded before Flop (didn't bet)
Seat 3: Volk_Vetra folded before Flop (didn't bet)
Seat 4: butch2102 mucked
Seat 5: Hunt133 folded before Flop (didn't bet)
Seat 6: PleBeY95 folded before Flop (didn't bet)
Seat 8: lonely fire (button) folded before Flop (didn't bet)
Seat 9: RikaSunPay (small blind) showed [Qd Qs] and won ($11.78) with a pair of Queens



PokerStars Hand #228683988013:  Hold'em No Limit ($0.25/$0.50 USD) - 2021/07/30 13:36:50 ET
Table 'Galilea III' 9-max Seat #9 is the button
Seat 1: DOA1980 ($50 in chips) 
Seat 4: butch2102 ($54.56 in chips) 
Seat 5: Hunt133 ($50 in chips) 
Seat 6: PleBeY95 ($50 in chips) 
Seat 8: lonely fire ($50 in chips) 
Seat 9: RikaSunPay ($55.83 in chips) 
DOA1980: posts small blind $0.25
Volk_Vetra: is sitting out 
butch2102: posts big blind $0.50
Dragonclawss: sits out 
*** HOLE CARDS ***
Hunt133: folds 
PleBeY95: folds 
lonely fire: folds 
Volk_Vetra leaves the table
RikaSunPay: raises $1.13 to $1.63
DOA1980: folds 
butch2102: calls $1.13
*** FLOP *** [Qd Ac 9s]
butch2102: checks 
RikaSunPay: checks 
*** TURN *** [Qd Ac 9s] [2c]
butch2102: bets $3.33
RikaSunPay: folds 
Uncalled bet ($3.33) returned to butch2102
butch2102 collected $3.33 from pot
butch2102: doesn't show hand 
*** SUMMARY ***
Total pot $3.51 | Rake $0.18 
Board [Qd Ac 9s 2c]
Seat 1: DOA1980 (small blind) folded before Flop
Seat 4: butch2102 (big blind) collected ($3.33)
Seat 5: Hunt133 folded before Flop (didn't bet)
Seat 6: PleBeY95 folded before Flop (didn't bet)
Seat 8: lonely fire folded before Flop (didn't bet)
Seat 9: RikaSunPay (button) folded on the Turn



PokerStars Hand #228684006676:  Hold'em No Limit ($0.25/$0.50 USD) - 2021/07/30 13:37:34 ET
Table 'Galilea III' 9-max Seat #1 is the button
Seat 1: DOA1980 ($50 in chips) 
Seat 4: butch2102 ($56.26 in chips) 
Seat 5: Hunt133 ($50 in chips) 
Seat 6: PleBeY95 ($50 in chips) 
Seat 8: lonely fire ($50 in chips) 
Seat 9: RikaSunPay ($54.20 in chips) 
butch2102: posts small blind $0.25
Hunt133: posts big blind $0.50
Dragonclawss: sits out 
*** HOLE CARDS ***
PleBeY95: folds 
lonely fire: folds 
RikaSunPay: raises $1.13 to $1.63
DOA1980: folds 
butch2102: folds 
Hunt133: folds 
Uncalled bet ($1.13) returned to RikaSunPay
RikaSunPay collected $1.25 from pot
RikaSunPay: doesn't show hand 
*** SUMMARY ***
Total pot $1.25 | Rake $0 
Seat 1: DOA1980 (button) folded before Flop (didn't bet)
Seat 4: butch2102 (small blind) folded before Flop
Seat 5: Hunt133 (big blind) folded before Flop
Seat 6: PleBeY95 folded before Flop (didn't bet)
Seat 8: lonely fire folded before Flop (didn't bet)
Seat 9: RikaSunPay collected ($1.25)



PokerStars Hand #228684015221:  Hold'em No Limit ($0.25/$0.50 USD) - 2021/07/30 13:37:55 ET
Table 'Galilea III' 9-max Seat #4 is the button
Seat 1: DOA1980 ($50 in chips) 
Seat 4: butch2102 ($56.01 in chips) 
Seat 5: Hunt133 ($49.50 in chips) 
Seat 6: PleBeY95 ($50 in chips) 
Seat 8: lonely fire ($50 in chips) 
Seat 9: RikaSunPay ($54.95 in chips) 
Hunt133: posts small blind $0.25
PleBeY95: posts big blind $0.50
Dragonclawss: sits out 
*** HOLE CARDS ***
lonely fire: folds 
RikaSunPay: folds 
DOA1980: folds 
butch2102: raises $1.25 to $1.75
Hunt133: folds 
PleBeY95: calls $1.25
*** FLOP *** [7c Ac 3h]
PleBeY95: checks 
butch2102: bets $3.56
PleBeY95: folds 
Uncalled bet ($3.56) returned to butch2102
butch2102 collected $3.56 from pot
butch2102: doesn't show hand 
*** SUMMARY ***
Total pot $3.75 | Rake $0.19 
Board [7c Ac 3h]
Seat 1: DOA1980 folded before Flop (didn't bet)
Seat 4: butch2102 (button) collected ($3.56)
Seat 5: Hunt133 (small blind) folded before Flop
Seat 6: PleBeY95 (big blind) folded on the Flop
Seat 8: lonely fire folded before Flop (didn't bet)
Seat 9: RikaSunPay folded before Flop (didn't bet)



PokerStars Hand #228684026730:  Hold'em No Limit ($0.25/$0.50 USD) - 2021/07/30 13:38:22 ET
Table 'Galilea III' 9-max Seat #5 is the button
Seat 1: DOA1980 ($50 in chips) 
Seat 4: butch2102 ($57.82 in chips) 
Seat 5: Hunt133 ($50 in chips) 
Seat 6: PleBeY95 ($50 in chips) 
Seat 7: Dragonclawss ($50 in chips) 
Seat 8: lonely fire ($50 in chips) 
Seat 9: RikaSunPay ($54.95 in chips) 
PleBeY95: posts small blind $0.25
Dragonclawss: posts big blind $0.50
*** HOLE CARDS ***
lonely fire: raises $1 to $1.50
RikaSunPay: folds 
DOA1980: folds 
butch2102: calls $1.50
Hunt133: folds 
PleBeY95: folds 
Dragonclawss: folds 
*** FLOP *** [8h 3s Jh]
lonely fire: checks 
butch2102: bets $3.56
lonely fire: calls $3.56
*** TURN *** [8h 3s Jh] [2c]
lonely fire: checks 
SpeeLy joins the table at seat #3 
butch2102: checks 
*** RIVER *** [8h 3s Jh 2c] [Qc]
lonely fire: checks 
butch2102: checks 
*** SHOW DOWN ***
lonely fire: shows [Tc Jc] (a pair of Jacks)
butch2102: mucks hand 
lonely fire collected $10.33 from pot
*** SUMMARY ***
Total pot $10.87 | Rake $0.54 
Board [8h 3s Jh 2c Qc]
Seat 1: DOA1980 folded before Flop (didn't bet)
Seat 4: butch2102 mucked
Seat 5: Hunt133 (button) folded before Flop (didn't bet)
Seat 6: PleBeY95 (small blind) folded before Flop
Seat 7: Dragonclawss (big blind) folded before Flop
Seat 8: lonely fire showed [Tc Jc] and won ($10.33) with a pair of Jacks
Seat 9: RikaSunPay folded before Flop (didn't bet)



PokerStars Hand #228684045775:  Hold'em No Limit ($0.25/$0.50 USD) - 2021/07/30 13:39:07 ET
Table 'Galilea III' 9-max Seat #6 is the button
Seat 1: DOA1980 ($50 in chips) 
Seat 4: butch2102 ($52.76 in chips) 
Seat 5: Hunt133 ($50 in chips) 
Seat 6: PleBeY95 ($50 in chips) 
Seat 7: Dragonclawss ($50 in chips) 
Seat 8: lonely fire ($55.27 in chips) 
Seat 9: RikaSunPay ($54.95 in chips) 
Dragonclawss: posts small blind $0.25
lonely fire: posts big blind $0.50
SpeeLy: sits out 
*** HOLE CARDS ***
RikaSunPay: folds 
DOA1980: folds 
butch2102: folds 
Hunt133: folds 
PleBeY95: folds 
Dragonclawss: folds 
Uncalled bet ($0.25) returned to lonely fire
lonely fire collected $0.50 from pot
lonely fire: doesn't show hand 
*** SUMMARY ***
Total pot $0.50 | Rake $0 
Seat 1: DOA1980 folded before Flop (didn't bet)
Seat 4: butch2102 folded before Flop (didn't bet)
Seat 5: Hunt133 folded before Flop (didn't bet)
Seat 6: PleBeY95 (button) folded before Flop (didn't bet)
Seat 7: Dragonclawss (small blind) folded before Flop
Seat 8: lonely fire (big blind) collected ($0.50)
Seat 9: RikaSunPay folded before Flop (didn't bet)



PokerStars Hand #228684050829:  Hold'em No Limit ($0.25/$0.50 USD) - 2021/07/30 13:39:19 ET
Table 'Galilea III' 9-max Seat #7 is the button
Seat 1: DOA1980 ($50 in chips) 
Seat 4: butch2102 ($52.76 in chips) 
Seat 5: Hunt133 ($50 in chips) 
Seat 6: PleBeY95 ($50 in chips) 
Seat 7: Dragonclawss ($50 in chips) 
Seat 8: lonely fire ($55.52 in chips) 
Seat 9: RikaSunPay ($54.95 in chips) 
lonely fire: posts small blind $0.25
RikaSunPay: posts big blind $0.50
SpeeLy: sits out 
*** HOLE CARDS ***
DOA1980: folds 
butch2102: folds 
Hunt133: folds 
PleBeY95: folds 
Dragonclawss: raises $0.75 to $1.25
lonely fire: folds 
RikaSunPay: calls $0.75
*** FLOP *** [Jh 5d 9d]
RikaSunPay: checks 
Dragonclawss: checks 
*** TURN *** [Jh 5d 9d] [4d]
RikaSunPay: bets $1.75
Dragonclawss: folds 
Uncalled bet ($1.75) returned to RikaSunPay
RikaSunPay collected $2.61 from pot
RikaSunPay: doesn't show hand 
*** SUMMARY ***
Total pot $2.75 | Rake $0.14 
Board [Jh 5d 9d 4d]
Seat 1: DOA1980 folded before Flop (didn't bet)
Seat 4: butch2102 folded before Flop (didn't bet)
Seat 5: Hunt133 folded before Flop (didn't bet)
Seat 6: PleBeY95 folded before Flop (didn't bet)
Seat 7: Dragonclawss (button) folded on the Turn
Seat 8: lonely fire (small blind) folded before Flop
Seat 9: RikaSunPay (big blind) collected ($2.61)



PokerStars Hand #228684077448:  Hold'em No Limit ($0.25/$0.50 USD) - 2021/07/30 13:40:23 ET
Table 'Galilea III' 9-max Seat #8 is the button
Seat 1: DOA1980 ($50 in chips) 
Seat 4: butch2102 ($52.76 in chips) 
Seat 5: Hunt133 ($50 in chips) 
Seat 6: PleBeY95 ($50 in chips) 
Seat 7: Dragonclawss ($50 in chips) 
Seat 8: lonely fire ($55.27 in chips) 
Seat 9: RikaSunPay ($56.31 in chips) 
RikaSunPay: posts small blind $0.25
DOA1980: posts big blind $0.50
SpeeLy: sits out 
*** HOLE CARDS ***
butch2102: folds 
Hunt133: folds 
PleBeY95: folds 
Dragonclawss: folds 
lonely fire: raises $0.75 to $1.25
RikaSunPay: folds 
DOA1980: folds 
Uncalled bet ($0.75) returned to lonely fire
lonely fire collected $1.25 from pot
lonely fire: doesn't show hand 
*** SUMMARY ***
Total pot $1.25 | Rake $0 
Seat 1: DOA1980 (big blind) folded before Flop
Seat 4: butch2102 folded before Flop (didn't bet)
Seat 5: Hunt133 folded before Flop (didn't bet)
Seat 6: PleBeY95 folded before Flop (didn't bet)
Seat 7: Dragonclawss folded before Flop (didn't bet)
Seat 8: lonely fire (button) collected ($1.25)
Seat 9: RikaSunPay (small blind) folded before Flop



PokerStars Hand #228684084864:  Hold'em No Limit ($0.25/$0.50 USD) - 2021/07/30 13:40:40 ET
Table 'Galilea III' 9-max Seat #9 is the button
Seat 1: DOA1980 ($50 in chips) 
Seat 3: SpeeLy ($50 in chips) 
Seat 4: butch2102 ($52.76 in chips) 
Seat 5: Hunt133 ($50 in chips) 
Seat 6: PleBeY95 ($50 in chips) 
Seat 7: Dragonclawss ($50 in chips) 
Seat 8: lonely fire ($56.02 in chips) 
Seat 9: RikaSunPay ($56.06 in chips) 
DOA1980: posts small blind $0.25
SpeeLy: posts big blind $0.50
*** HOLE CARDS ***
butch2102: raises $0.50 to $1
Hunt133: folds 
PleBeY95: folds 
Dragonclawss: folds 
lonely fire: raises $3.50 to $4.50
RikaSunPay: folds 
DOA1980: folds 
SpeeLy: folds 
butch2102: calls $3.50
*** FLOP *** [2c Kd 8c]
butch2102: checks 
lonely fire: checks 
*** TURN *** [2c Kd 8c] [Ac]
butch2102: checks 
lonely fire: checks 
*** RIVER *** [2c Kd 8c Ac] [6d]
butch2102: checks 
lonely fire: checks 
*** SHOW DOWN ***
butch2102: shows [3c 3h] (a pair of Threes)
lonely fire: shows [Jc Jd] (a pair of Jacks)
lonely fire collected $9.26 from pot
*** SUMMARY ***
Total pot $9.75 | Rake $0.49 
Board [2c Kd 8c Ac 6d]
Seat 1: DOA1980 (small blind) folded before Flop
Seat 3: SpeeLy (big blind) folded before Flop
Seat 4: butch2102 showed [3c 3h] and lost with a pair of Threes
Seat 5: Hunt133 folded before Flop (didn't bet)
Seat 6: PleBeY95 folded before Flop (didn't bet)
Seat 7: Dragonclawss folded before Flop (didn't bet)
Seat 8: lonely fire showed [Jc Jd] and won ($9.26) with a pair of Jacks
Seat 9: RikaSunPay (button) folded before Flop (didn't bet)



PokerStars Hand #228684109057:  Hold'em No Limit ($0.25/$0.50 USD) - 2021/07/30 13:41:38 ET
Table 'Galilea III' 9-max Seat #1 is the button
Seat 1: DOA1980 ($50 in chips) 
Seat 3: SpeeLy ($50 in chips) 
Seat 4: butch2102 ($48.26 in chips) 
Seat 5: Hunt133 ($50 in chips) 
Seat 6: PleBeY95 ($50 in chips) 
Seat 7: Dragonclawss ($50 in chips) 
Seat 8: lonely fire ($60.78 in chips) 
Seat 9: RikaSunPay ($56.06 in chips) 
SpeeLy: posts small blind $0.25
butch2102: posts big blind $0.50
*** HOLE CARDS ***
Hunt133: folds 
PleBeY95: raises $1 to $1.50
Dragonclawss: calls $1.50
lonely fire: folds 
RikaSunPay: folds 
DOA1980: folds 
SpeeLy: calls $1.25
butch2102: folds 
*** FLOP *** [9h Qs 3s]
SpeeLy: checks 
PleBeY95: bets $1.57
Dragonclawss: raises $7.89 to $9.46
SpeeLy: folds 
PleBeY95: folds 
Uncalled bet ($7.89) returned to Dragonclawss
Dragonclawss collected $7.73 from pot
Dragonclawss: doesn't show hand 
*** SUMMARY ***
Total pot $8.14 | Rake $0.41 
Board [9h Qs 3s]
Seat 1: DOA1980 (button) folded before Flop (didn't bet)
Seat 3: SpeeLy (small blind) folded on the Flop
Seat 4: butch2102 (big blind) folded before Flop
Seat 5: Hunt133 folded before Flop (didn't bet)
Seat 6: PleBeY95 folded on the Flop
Seat 7: Dragonclawss collected ($7.73)
Seat 8: lonely fire folded before Flop (didn't bet)
Seat 9: RikaSunPay folded before Flop (didn't bet)



PokerStars Hand #228684131152:  Hold'em No Limit ($0.25/$0.50 USD) - 2021/07/30 13:42:30 ET
Table 'Galilea III' 9-max Seat #3 is the button
Seat 1: DOA1980 ($50 in chips) 
Seat 3: SpeeLy ($50 in chips) 
Seat 4: butch2102 ($47.76 in chips) 
Seat 5: Hunt133 ($50 in chips) 
Seat 6: PleBeY95 ($50 in chips) 
Seat 7: Dragonclawss ($54.66 in chips) 
Seat 8: lonely fire ($60.78 in chips) 
Seat 9: RikaSunPay ($56.06 in chips) 
butch2102: posts small blind $0.25
Hunt133: posts big blind $0.50
*** HOLE CARDS ***
PleBeY95: raises $1 to $1.50
Dragonclawss: folds 
lonely fire: folds 
RikaSunPay: folds 
DOA1980: folds 
SpeeLy: folds 
butch2102: folds 
Hunt133: folds 
Uncalled bet ($1) returned to PleBeY95
PleBeY95 collected $1.25 from pot
*** SUMMARY ***
Total pot $1.25 | Rake $0 
Seat 1: DOA1980 folded before Flop (didn't bet)
Seat 3: SpeeLy (button) folded before Flop (didn't bet)
Seat 4: butch2102 (small blind) folded before Flop
Seat 5: Hunt133 (big blind) folded before Flop
Seat 6: PleBeY95 collected ($1.25)
Seat 7: Dragonclawss folded before Flop (didn't bet)
Seat 8: lonely fire folded before Flop (didn't bet)
Seat 9: RikaSunPay folded before Flop (didn't bet)



PokerStars Hand #228684137666:  Hold'em No Limit ($0.25/$0.50 USD) - 2021/07/30 13:42:46 ET
Table 'Galilea III' 9-max Seat #4 is the button
Seat 1: DOA1980 ($50 in chips) 
Seat 3: SpeeLy ($50 in chips) 
Seat 4: butch2102 ($47.51 in chips) 
Seat 5: Hunt133 ($49.50 in chips) 
Seat 6: PleBeY95 ($50.75 in chips) 
Seat 7: Dragonclawss ($54.66 in chips) 
Seat 8: lonely fire ($60.78 in chips) 
Seat 9: RikaSunPay ($56.06 in chips) 
Hunt133: posts small blind $0.25
PleBeY95: posts big blind $0.50
*** HOLE CARDS ***
Dragonclawss: folds 
lonely fire: folds 
RikaSunPay: folds 
DOA1980: folds 
SpeeLy: folds 
butch2102: calls $0.50
Hunt133: folds 
PleBeY95: checks 
*** FLOP *** [Kc 9h 4s]
PleBeY95: checks 
butch2102: bets $1.19
PleBeY95: folds 
Uncalled bet ($1.19) returned to butch2102
butch2102 collected $1.19 from pot
butch2102: doesn't show hand 
*** SUMMARY ***
Total pot $1.25 | Rake $0.06 
Board [Kc 9h 4s]
Seat 1: DOA1980 folded before Flop (didn't bet)
Seat 3: SpeeLy folded before Flop (didn't bet)
Seat 4: butch2102 (button) collected ($1.19)
Seat 5: Hunt133 (small blind) folded before Flop
Seat 6: PleBeY95 (big blind) folded on the Flop
Seat 7: Dragonclawss folded before Flop (didn't bet)
Seat 8: lonely fire folded before Flop (didn't bet)
Seat 9: RikaSunPay folded before Flop (didn't bet)



PokerStars Hand #228684145533:  Hold'em No Limit ($0.25/$0.50 USD) - 2021/07/30 13:43:04 ET
Table 'Galilea III' 9-max Seat #5 is the button
Seat 1: DOA1980 ($50 in chips) 
Seat 3: SpeeLy ($50 in chips) 
Seat 4: butch2102 ($48.20 in chips) 
Seat 5: Hunt133 ($50 in chips) 
Seat 6: PleBeY95 ($50.25 in chips) 
Seat 7: Dragonclawss ($54.66 in chips) 
Seat 8: lonely fire ($60.78 in chips) 
Seat 9: RikaSunPay ($56.06 in chips) 
PleBeY95: posts small blind $0.25
Dragonclawss: posts big blind $0.50
*** HOLE CARDS ***
lonely fire: raises $1 to $1.50
RikaSunPay: raises $2.75 to $4.25
DOA1980: folds 
SpeeLy: folds 
butch2102: raises $2.75 to $7
Hunt133: folds 
PleBeY95: folds 
Dragonclawss: folds 
lonely fire: folds 
RikaSunPay: raises $49.06 to $56.06 and is all-in
butch2102: calls $41.20 and is all-in
Uncalled bet ($7.86) returned to RikaSunPay
*** FLOP *** [Ts 3s Jd]
*** TURN *** [Ts 3s Jd] [Jh]
*** RIVER *** [Ts 3s Jd Jh] [Js]
*** SHOW DOWN ***
RikaSunPay: shows [As Kh] (three of a kind, Jacks)
butch2102: shows [7d 7s] (a full house, Jacks full of Sevens)
butch2102 collected $96.65 from pot
*** SUMMARY ***
Total pot $98.65 | Rake $2 
Board [Ts 3s Jd Jh Js]
Seat 1: DOA1980 folded before Flop (didn't bet)
Seat 3: SpeeLy folded before Flop (didn't bet)
Seat 4: butch2102 showed [7d 7s] and won ($96.65) with a full house, Jacks full of Sevens
Seat 5: Hunt133 (button) folded before Flop (didn't bet)
Seat 6: PleBeY95 (small blind) folded before Flop
Seat 7: Dragonclawss (big blind) folded before Flop
Seat 8: lonely fire folded before Flop
Seat 9: RikaSunPay showed [As Kh] and lost with three of a kind, Jacks



PokerStars Hand #228684162118:  Hold'em No Limit ($0.25/$0.50 USD) - 2021/07/30 13:43:43 ET
Table 'Galilea III' 9-max Seat #6 is the button
Seat 1: DOA1980 ($50 in chips) 
Seat 3: SpeeLy ($50 in chips) 
Seat 4: butch2102 ($96.65 in chips) 
Seat 5: Hunt133 ($50 in chips) 
Seat 6: PleBeY95 ($50 in chips) 
Seat 7: Dragonclawss ($54.16 in chips) 
Seat 8: lonely fire ($59.28 in chips) 
Seat 9: RikaSunPay ($50 in chips) 
Dragonclawss: posts small blind $0.25
lonely fire: posts big blind $0.50
*** HOLE CARDS ***
RikaSunPay: folds 
DOA1980: folds 
SpeeLy: folds 
butch2102: folds 
Hunt133: raises $0.75 to $1.25
PleBeY95: folds 
Dragonclawss: folds 
lonely fire: calls $0.75
*** FLOP *** [2d 5h 6h]
lonely fire: checks 
Hunt133: checks 
*** TURN *** [2d 5h 6h] [9c]
lonely fire: checks 
Hunt133: bets $1.74
lonely fire: folds 
Uncalled bet ($1.74) returned to Hunt133
Hunt133 collected $2.61 from pot
*** SUMMARY ***
Total pot $2.75 | Rake $0.14 
Board [2d 5h 6h 9c]
Seat 1: DOA1980 folded before Flop (didn't bet)
Seat 3: SpeeLy folded before Flop (didn't bet)
Seat 4: butch2102 folded before Flop (didn't bet)
Seat 5: Hunt133 collected ($2.61)
Seat 6: PleBeY95 (button) folded before Flop (didn't bet)
Seat 7: Dragonclawss (small blind) folded before Flop
Seat 8: lonely fire (big blind) folded on the Turn
Seat 9: RikaSunPay folded before Flop (didn't bet)



PokerStars Hand #228684173236:  Hold'em No Limit ($0.25/$0.50 USD) - 2021/07/30 13:44:10 ET
Table 'Galilea III' 9-max Seat #7 is the button
Seat 1: DOA1980 ($50 in chips) 
Seat 3: SpeeLy ($50 in chips) 
Seat 4: butch2102 ($96.65 in chips) 
Seat 5: Hunt133 ($51.36 in chips) 
Seat 6: PleBeY95 ($50 in chips) 
Seat 7: Dragonclawss ($53.91 in chips) 
Seat 8: lonely fire ($58.03 in chips) 
Seat 9: RikaSunPay ($50 in chips) 
lonely fire: posts small blind $0.25
RikaSunPay: posts big blind $0.50
*** HOLE CARDS ***
DOA1980: folds 
SpeeLy: folds 
butch2102: folds 
Hunt133: folds 
PleBeY95: folds 
Dragonclawss: raises $0.75 to $1.25
lonely fire: folds 
RikaSunPay: calls $0.75
*** FLOP *** [3h 5c 2d]
RikaSunPay: checks 
Dragonclawss: bets $2
RikaSunPay: calls $2
*** TURN *** [3h 5c 2d] [Ks]
RikaSunPay: checks 
Dragonclawss: bets $3.21
RikaSunPay: raises $5.29 to $8.50
Dragonclawss: raises $42.16 to $50.66 and is all-in
RikaSunPay: folds 
Uncalled bet ($42.16) returned to Dragonclawss
Dragonclawss collected $22.56 from pot
Dragonclawss: doesn't show hand 
*** SUMMARY ***
Total pot $23.75 | Rake $1.19 
Board [3h 5c 2d Ks]
Seat 1: DOA1980 folded before Flop (didn't bet)
Seat 3: SpeeLy folded before Flop (didn't bet)
Seat 4: butch2102 folded before Flop (didn't bet)
Seat 5: Hunt133 folded before Flop (didn't bet)
Seat 6: PleBeY95 folded before Flop (didn't bet)
Seat 7: Dragonclawss (button) collected ($22.56)
Seat 8: lonely fire (small blind) folded before Flop
Seat 9: RikaSunPay (big blind) folded on the Turn



PokerStars Hand #228684215920:  Hold'em No Limit ($0.25/$0.50 USD) - 2021/07/30 13:45:51 ET
Table 'Galilea III' 9-max Seat #8 is the button
Seat 1: DOA1980 ($50 in chips) 
Seat 3: SpeeLy ($50 in chips) 
Seat 4: butch2102 ($96.65 in chips) 
Seat 5: Hunt133 ($51.36 in chips) 
Seat 6: PleBeY95 ($50 in chips) 
Seat 7: Dragonclawss ($64.72 in chips) 
Seat 8: lonely fire ($57.78 in chips) 
Seat 9: RikaSunPay ($50 in chips) 
RikaSunPay: posts small blind $0.25
DOA1980: posts big blind $0.50
*** HOLE CARDS ***
SpeeLy: folds 
butch2102: folds 
Hunt133: folds 
PleBeY95: folds 
Dragonclawss: folds 
lonely fire: folds 
RikaSunPay: folds 
Uncalled bet ($0.25) returned to DOA1980
DOA1980 collected $0.50 from pot
DOA1980: doesn't show hand 
*** SUMMARY ***
Total pot $0.50 | Rake $0 
Seat 1: DOA1980 (big blind) collected ($0.50)
Seat 3: SpeeLy folded before Flop (didn't bet)
Seat 4: butch2102 folded before Flop (didn't bet)
Seat 5: Hunt133 folded before Flop (didn't bet)
Seat 6: PleBeY95 folded before Flop (didn't bet)
Seat 7: Dragonclawss folded before Flop (didn't bet)
Seat 8: lonely fire (button) folded before Flop (didn't bet)
Seat 9: RikaSunPay (small blind) folded before Flop



PokerStars Hand #228684219850:  Hold'em No Limit ($0.25/$0.50 USD) - 2021/07/30 13:46:00 ET
Table 'Galilea III' 9-max Seat #9 is the button
Seat 1: DOA1980 ($50.25 in chips) 
Seat 3: SpeeLy ($50 in chips) 
Seat 4: butch2102 ($96.65 in chips) 
Seat 5: Hunt133 ($51.36 in chips) 
Seat 6: PleBeY95 ($50 in chips) 
Seat 7: Dragonclawss ($64.72 in chips) 
Seat 8: lonely fire ($57.78 in chips) 
Seat 9: RikaSunPay ($50 in chips) 
DOA1980: posts small blind $0.25
SpeeLy: posts big blind $0.50
*** HOLE CARDS ***
butch2102: folds 
Hunt133: folds 
PleBeY95: folds 
Dragonclawss: folds 
lonely fire: folds 
RikaSunPay: folds 
se13giuum was removed from the table for failing to post
se13giuum leaves the table
DOA1980: folds 
Uncalled bet ($0.25) returned to SpeeLy
SpeeLy collected $0.50 from pot
SpeeLy: doesn't show hand 
*** SUMMARY ***
Total pot $0.50 | Rake $0 
Seat 1: DOA1980 (small blind) folded before Flop
Seat 3: SpeeLy (big blind) collected ($0.50)
Seat 4: butch2102 folded before Flop (didn't bet)
Seat 5: Hunt133 folded before Flop (didn't bet)
Seat 6: PleBeY95 folded before Flop (didn't bet)
Seat 7: Dragonclawss folded before Flop (didn't bet)
Seat 8: lonely fire folded before Flop (didn't bet)
Seat 9: RikaSunPay (button) folded before Flop (didn't bet)



PokerStars Hand #228684227851:  Hold'em No Limit ($0.25/$0.50 USD) - 2021/07/30 13:46:19 ET
Table 'Galilea III' 9-max Seat #1 is the button
Seat 1: DOA1980 ($50 in chips) 
Seat 3: SpeeLy ($50.25 in chips) 
Seat 4: butch2102 ($96.65 in chips) 
Seat 5: Hunt133 ($51.36 in chips) 
Seat 6: PleBeY95 ($50 in chips) 
Seat 7: Dragonclawss ($64.72 in chips) 
Seat 8: lonely fire ($57.78 in chips) 
Seat 9: RikaSunPay ($50 in chips) 
SpeeLy: posts small blind $0.25
butch2102: posts big blind $0.50
*** HOLE CARDS ***
Hunt133: folds 
PleBeY95: raises $1 to $1.50
Dragonclawss: folds 
lonely fire: folds 
RikaSunPay: folds 
DOA1980: calls $1.50
SpeeLy: folds 
butch2102: folds 
*** FLOP *** [Tc 2c Jh]
PleBeY95: checks 
DOA1980: bets $2.25
dstrola joins the table at seat #2 
PleBeY95: calls $2.25
*** TURN *** [Tc 2c Jh] [8d]
PleBeY95: checks 
DOA1980: checks 
*** RIVER *** [Tc 2c Jh 8d] [8h]
PleBeY95: checks 
DOA1980: checks 
*** SHOW DOWN ***
PleBeY95: shows [Kc Js] (two pair, Jacks and Eights)
DOA1980: mucks hand 
PleBeY95 collected $7.84 from pot
*** SUMMARY ***
Total pot $8.25 | Rake $0.41 
Board [Tc 2c Jh 8d 8h]
Seat 1: DOA1980 (button) mucked
Seat 3: SpeeLy (small blind) folded before Flop
Seat 4: butch2102 (big blind) folded before Flop
Seat 5: Hunt133 folded before Flop (didn't bet)
Seat 6: PleBeY95 showed [Kc Js] and won ($7.84) with two pair, Jacks and Eights
Seat 7: Dragonclawss folded before Flop (didn't bet)
Seat 8: lonely fire folded before Flop (didn't bet)
Seat 9: RikaSunPay folded before Flop (didn't bet)



PokerStars Hand #228684251666:  Hold'em No Limit ($0.25/$0.50 USD) - 2021/07/30 13:47:16 ET
Table 'Galilea III' 9-max Seat #3 is the button
Seat 1: DOA1980 ($50 in chips) 
Seat 2: dstrola ($50 in chips) 
Seat 3: SpeeLy ($50 in chips) 
Seat 4: butch2102 ($96.15 in chips) 
Seat 5: Hunt133 ($51.36 in chips) 
Seat 6: PleBeY95 ($54.09 in chips) 
Seat 7: Dragonclawss ($64.72 in chips) 
Seat 8: lonely fire ($57.78 in chips) 
Seat 9: RikaSunPay ($50 in chips) 
butch2102: posts small blind $0.25
Hunt133: posts big blind $0.50
dstrola: posts big blind $0.50
*** HOLE CARDS ***
PleBeY95: folds 
Dragonclawss: folds 
lonely fire: folds 
RikaSunPay: folds 
DOA1980: folds 
dstrola: checks 
SpeeLy: folds 
butch2102: calls $0.25
Hunt133: checks 
*** FLOP *** [6h 5d 8c]
butch2102: checks 
Hunt133: checks 
dstrola: checks 
*** TURN *** [6h 5d 8c] [Jd]
butch2102: bets $1.42
Hunt133 is disconnected 
Hunt133 has timed out while disconnected
Hunt133: folds 
dstrola: folds 
Uncalled bet ($1.42) returned to butch2102
butch2102 collected $1.42 from pot
butch2102: doesn't show hand 
*** SUMMARY ***
Total pot $1.50 | Rake $0.08 
Board [6h 5d 8c Jd]
Seat 1: DOA1980 folded before Flop (didn't bet)
Seat 2: dstrola folded on the Turn (didn't bet)
Seat 3: SpeeLy (button) folded before Flop (didn't bet)
Seat 4: butch2102 (small blind) collected ($1.42)
Seat 5: Hunt133 (big blind) folded on the Turn
Seat 6: PleBeY95 folded before Flop (didn't bet)
Seat 7: Dragonclawss folded before Flop (didn't bet)
Seat 8: lonely fire folded before Flop (didn't bet)
Seat 9: RikaSunPay folded before Flop (didn't bet)



PokerStars Hand #228684278292:  Hold'em No Limit ($0.25/$0.50 USD) - 2021/07/30 13:48:20 ET
Table 'Galilea III' 9-max Seat #4 is the button
Seat 1: DOA1980 ($50 in chips) 
Seat 2: dstrola ($50 in chips) 
Seat 3: SpeeLy ($50 in chips) 
Seat 4: butch2102 ($97.07 in chips) 
Seat 6: PleBeY95 ($54.09 in chips) 
Seat 7: Dragonclawss ($64.72 in chips) 
Seat 8: lonely fire ($57.78 in chips) 
Seat 9: RikaSunPay ($50 in chips) 
PleBeY95: posts small blind $0.25
Dragonclawss: posts big blind $0.50
*** HOLE CARDS ***
lonely fire: folds 
RikaSunPay: folds 
DOA1980: folds 
dstrola: folds 
SpeeLy: folds 
butch2102: raises $0.50 to $1
PleBeY95: raises $3.50 to $4.50
Dragonclawss: folds 
butch2102: calls $3.50
*** FLOP *** [8h Kc 3s]
PleBeY95: bets $2.98
butch2102: folds 
Uncalled bet ($2.98) returned to PleBeY95
PleBeY95 collected $9.02 from pot
*** SUMMARY ***
Total pot $9.50 | Rake $0.48 
Board [8h Kc 3s]
Seat 1: DOA1980 folded before Flop (didn't bet)
Seat 2: dstrola folded before Flop (didn't bet)
Seat 3: SpeeLy folded before Flop (didn't bet)
Seat 4: butch2102 (button) folded on the Flop
Seat 6: PleBeY95 (small blind) collected ($9.02)
Seat 7: Dragonclawss (big blind) folded before Flop
Seat 8: lonely fire folded before Flop (didn't bet)
Seat 9: RikaSunPay folded before Flop (didn't bet)



PokerStars Hand #228684291216:  Hold'em No Limit ($0.25/$0.50 USD) - 2021/07/30 13:48:51 ET
Table 'Galilea III' 9-max Seat #6 is the button
Seat 1: DOA1980 ($50 in chips) 
Seat 2: dstrola ($50 in chips) 
Seat 3: SpeeLy ($50 in chips) 
Seat 4: butch2102 ($92.57 in chips) 
Seat 6: PleBeY95 ($58.61 in chips) 
Seat 7: Dragonclawss ($64.22 in chips) 
Seat 8: lonely fire ($57.78 in chips) 
Seat 9: RikaSunPay ($50 in chips) 
Dragonclawss: posts small blind $0.25
lonely fire: posts big blind $0.50
*** HOLE CARDS ***
RikaSunPay: folds 
DOA1980: folds 
dstrola: folds 
SpeeLy: folds 
butch2102: calls $0.50
PleBeY95: folds 
Dragonclawss: calls $0.25
lonely fire: checks 
*** FLOP *** [3c 8s Qc]
Dragonclawss: checks 
lonely fire: checks 
butch2102: bets $1.42
Dragonclawss: calls $1.42
lonely fire: folds 
*** TURN *** [3c 8s Qc] [Jd]
Dragonclawss: checks 
butch2102: checks 
*** RIVER *** [3c 8s Qc Jd] [8c]
Dragonclawss: checks 
butch2102: bets $4.12
Dragonclawss: calls $4.12
*** SHOW DOWN ***
butch2102: shows [Qh 7h] (two pair, Queens and Eights)
Dragonclawss: shows [2c Ac] (a flush, Ace high)
Dragonclawss collected $11.95 from pot
*** SUMMARY ***
Total pot $12.58 | Rake $0.63 
Board [3c 8s Qc Jd 8c]
Seat 1: DOA1980 folded before Flop (didn't bet)
Seat 2: dstrola folded before Flop (didn't bet)
Seat 3: SpeeLy folded before Flop (didn't bet)
Seat 4: butch2102 showed [Qh 7h] and lost with two pair, Queens and Eights
Seat 6: PleBeY95 (button) folded before Flop (didn't bet)
Seat 7: Dragonclawss (small blind) showed [2c Ac] and won ($11.95) with a flush, Ace high
Seat 8: lonely fire (big blind) folded on the Flop
Seat 9: RikaSunPay folded before Flop (didn't bet)



PokerStars Hand #228684323353:  Hold'em No Limit ($0.25/$0.50 USD) - 2021/07/30 13:49:47 ET
Table 'Galilea III' 9-max Seat #7 is the button
Seat 1: DOA1980 ($50 in chips) 
Seat 2: dstrola ($50 in chips) 
Seat 3: SpeeLy ($50 in chips) 
Seat 4: butch2102 ($86.53 in chips) 
Seat 6: PleBeY95 ($58.61 in chips) 
Seat 7: Dragonclawss ($70.13 in chips) 
Seat 8: lonely fire ($57.28 in chips) 
Seat 9: RikaSunPay ($50 in chips) 
lonely fire: posts small blind $0.25
RikaSunPay: posts big blind $0.50
*** HOLE CARDS ***
DOA1980: folds 
dstrola: folds 
SpeeLy: folds 
butch2102: folds 
PleBeY95: folds 
Dragonclawss: folds 
lonely fire: folds 
Uncalled bet ($0.25) returned to RikaSunPay
RikaSunPay collected $0.50 from pot
RikaSunPay: doesn't show hand 
*** SUMMARY ***
Total pot $0.50 | Rake $0 
Seat 1: DOA1980 folded before Flop (didn't bet)
Seat 2: dstrola folded before Flop (didn't bet)
Seat 3: SpeeLy folded before Flop (didn't bet)
Seat 4: butch2102 folded before Flop (didn't bet)
Seat 6: PleBeY95 folded before Flop (didn't bet)
Seat 7: Dragonclawss (button) folded before Flop (didn't bet)
Seat 8: lonely fire (small blind) folded before Flop
Seat 9: RikaSunPay (big blind) collected ($0.50)



PokerStars Hand #228684338696:  Hold'em No Limit ($0.25/$0.50 USD) - 2021/07/30 13:50:24 ET
Table 'Galilea III' 9-max Seat #8 is the button
Seat 1: DOA1980 ($50 in chips) 
Seat 2: dstrola ($50 in chips) 
Seat 3: SpeeLy ($50 in chips) 
Seat 4: butch2102 ($86.53 in chips) 
Seat 6: PleBeY95 ($58.61 in chips) 
Seat 7: Dragonclawss ($70.13 in chips) 
Seat 8: lonely fire ($57.03 in chips) 
Seat 9: RikaSunPay ($50.25 in chips) 
RikaSunPay: posts small blind $0.25
DOA1980: posts big blind $0.50
*** HOLE CARDS ***
dstrola: folds 
SpeeLy: folds 
butch2102: raises $1.25 to $1.75
PleBeY95: raises $3.25 to $5
Dragonclawss: folds 
lonely fire: folds 
RikaSunPay: folds 
DOA1980: folds 
butch2102: calls $3.25
*** FLOP *** [6d 4s Kh]
butch2102: checks 
PleBeY95: bets $3.37
butch2102: folds 
Uncalled bet ($3.37) returned to PleBeY95
PleBeY95 collected $10.21 from pot
*** SUMMARY ***
Total pot $10.75 | Rake $0.54 
Board [6d 4s Kh]
Seat 1: DOA1980 (big blind) folded before Flop
Seat 2: dstrola folded before Flop (didn't bet)
Seat 3: SpeeLy folded before Flop (didn't bet)
Seat 4: butch2102 folded on the Flop
Seat 6: PleBeY95 collected ($10.21)
Seat 7: Dragonclawss folded before Flop (didn't bet)
Seat 8: lonely fire (button) folded before Flop (didn't bet)
Seat 9: RikaSunPay (small blind) folded before Flop



PokerStars Hand #228684355261:  Hold'em No Limit ($0.25/$0.50 USD) - 2021/07/30 13:51:04 ET
Table 'Galilea III' 9-max Seat #9 is the button
Seat 1: DOA1980 ($50 in chips) 
Seat 2: dstrola ($50 in chips) 
Seat 3: SpeeLy ($50 in chips) 
Seat 4: butch2102 ($81.53 in chips) 
Seat 6: PleBeY95 ($63.82 in chips) 
Seat 7: Dragonclawss ($70.13 in chips) 
Seat 8: lonely fire ($57.03 in chips) 
Seat 9: RikaSunPay ($50 in chips) 
DOA1980: posts small blind $0.25
dstrola: posts big blind $0.50
*** HOLE CARDS ***
SpeeLy: folds 
butch2102: calls $0.50
PleBeY95: folds 
Dragonclawss: folds 
lonely fire: raises $1.50 to $2
RikaSunPay: folds 
DOA1980: folds 
dstrola: folds 
butch2102: calls $1.50
*** FLOP *** [8s 9h 9s]
butch2102: bets $4.51
lonely fire: folds 
Uncalled bet ($4.51) returned to butch2102
butch2102 collected $4.51 from pot
butch2102: doesn't show hand 
*** SUMMARY ***
Total pot $4.75 | Rake $0.24 
Board [8s 9h 9s]
Seat 1: DOA1980 (small blind) folded before Flop
Seat 2: dstrola (big blind) folded before Flop
Seat 3: SpeeLy folded before Flop (didn't bet)
Seat 4: butch2102 collected ($4.51)
Seat 6: PleBeY95 folded before Flop (didn't bet)
Seat 7: Dragonclawss folded before Flop (didn't bet)
Seat 8: lonely fire folded on the Flop
Seat 9: RikaSunPay (button) folded before Flop (didn't bet)



PokerStars Hand #228684371580:  Hold'em No Limit ($0.25/$0.50 USD) - 2021/07/30 13:51:43 ET
Table 'Galilea III' 9-max Seat #1 is the button
Seat 1: DOA1980 ($50 in chips) 
Seat 2: dstrola ($50 in chips) 
Seat 3: SpeeLy ($50 in chips) 
Seat 4: butch2102 ($84.04 in chips) 
Seat 6: PleBeY95 ($63.82 in chips) 
Seat 7: Dragonclawss ($70.13 in chips) 
Seat 8: lonely fire ($55.03 in chips) 
Seat 9: RikaSunPay ($50 in chips) 
dstrola: posts small blind $0.25
SpeeLy: posts big blind $0.50
*** HOLE CARDS ***
butch2102: folds 
PleBeY95: folds 
Dragonclawss: folds 
lonely fire: folds 
RikaSunPay: folds 
DOA1980: folds 
dstrola: folds 
Uncalled bet ($0.25) returned to SpeeLy
SpeeLy collected $0.50 from pot
SpeeLy: doesn't show hand 
*** SUMMARY ***
Total pot $0.50 | Rake $0 
Seat 1: DOA1980 (button) folded before Flop (didn't bet)
Seat 2: dstrola (small blind) folded before Flop
Seat 3: SpeeLy (big blind) collected ($0.50)
Seat 4: butch2102 folded before Flop (didn't bet)
Seat 6: PleBeY95 folded before Flop (didn't bet)
Seat 7: Dragonclawss folded before Flop (didn't bet)
Seat 8: lonely fire folded before Flop (didn't bet)
Seat 9: RikaSunPay folded before Flop (didn't bet)



PokerStars Hand #228684379439:  Hold'em No Limit ($0.25/$0.50 USD) - 2021/07/30 13:52:02 ET
Table 'Galilea III' 9-max Seat #2 is the button
Seat 1: DOA1980 ($50 in chips) 
Seat 2: dstrola ($50 in chips) 
Seat 3: SpeeLy ($50.25 in chips) 
Seat 4: butch2102 ($84.04 in chips) 
Seat 6: PleBeY95 ($63.82 in chips) 
Seat 7: Dragonclawss ($70.13 in chips) 
Seat 8: lonely fire ($55.03 in chips) 
Seat 9: RikaSunPay ($50 in chips) 
SpeeLy: posts small blind $0.25
butch2102: posts big blind $0.50
*** HOLE CARDS ***
PleBeY95: folds 
Dragonclawss: folds 
lonely fire: folds 
RikaSunPay: raises $1.13 to $1.63
DOA1980: calls $1.63
dstrola: folds 
SpeeLy: folds 
butch2102: folds 
*** FLOP *** [5h Js Th]
RikaSunPay: bets $2.51
DOA1980: calls $2.51
*** TURN *** [5h Js Th] [Ad]
RikaSunPay: checks 
DOA1980: bets $4.25
RikaSunPay: raises $6.25 to $10.50
DOA1980: raises $35.36 to $45.86 and is all-in
RikaSunPay has timed out
RikaSunPay: folds 
Uncalled bet ($35.36) returned to DOA1980
DOA1980 collected $28.53 from pot
DOA1980: doesn't show hand 
*** SUMMARY ***
Total pot $30.03 | Rake $1.50 
Board [5h Js Th Ad]
Seat 1: DOA1980 collected ($28.53)
Seat 2: dstrola (button) folded before Flop (didn't bet)
Seat 3: SpeeLy (small blind) folded before Flop
Seat 4: butch2102 (big blind) folded before Flop
Seat 6: PleBeY95 folded before Flop (didn't bet)
Seat 7: Dragonclawss folded before Flop (didn't bet)
Seat 8: lonely fire folded before Flop (didn't bet)
Seat 9: RikaSunPay folded on the Turn



PokerStars Hand #228684433688:  Hold'em No Limit ($0.25/$0.50 USD) - 2021/07/30 13:54:13 ET
Table 'Galilea III' 9-max Seat #3 is the button
Seat 1: DOA1980 ($63.89 in chips) 
Seat 2: dstrola ($50 in chips) 
Seat 3: SpeeLy ($50 in chips) 
Seat 4: butch2102 ($83.54 in chips) 
Seat 6: PleBeY95 ($63.82 in chips) 
Seat 7: Dragonclawss ($70.13 in chips) 
Seat 8: lonely fire ($55.03 in chips) 
Seat 9: RikaSunPay ($50 in chips) 
butch2102: posts small blind $0.25
PleBeY95: posts big blind $0.50
*** HOLE CARDS ***
Dragonclawss: folds 
lonely fire: folds 
RikaSunPay: folds 
DOA1980: folds 
Dragonclawss leaves the table
dstrola: raises $1 to $1.50
SpeeLy: folds 
butch2102: folds 
PleBeY95: folds 
Uncalled bet ($1) returned to dstrola
dstrola collected $1.25 from pot
*** SUMMARY ***
Total pot $1.25 | Rake $0 
Seat 1: DOA1980 folded before Flop (didn't bet)
Seat 2: dstrola collected ($1.25)
Seat 3: SpeeLy (button) folded before Flop (didn't bet)
Seat 4: butch2102 (small blind) folded before Flop
Seat 6: PleBeY95 (big blind) folded before Flop
Seat 7: Dragonclawss folded before Flop (didn't bet)
Seat 8: lonely fire folded before Flop (didn't bet)
Seat 9: RikaSunPay folded before Flop (didn't bet)



PokerStars Hand #228684437335:  Hold'em No Limit ($0.25/$0.50 USD) - 2021/07/30 13:54:22 ET
Table 'Galilea III' 9-max Seat #4 is the button
Seat 1: DOA1980 ($63.89 in chips) 
Seat 2: dstrola ($50.75 in chips) 
Seat 3: SpeeLy ($50 in chips) 
Seat 4: butch2102 ($83.29 in chips) 
Seat 6: PleBeY95 ($63.32 in chips) 
Seat 8: lonely fire ($55.03 in chips) 
Seat 9: RikaSunPay ($50 in chips) 
PleBeY95: posts small blind $0.25
lonely fire: posts big blind $0.50
*** HOLE CARDS ***
RikaSunPay: folds 
DOA1980: folds 
dstrola: folds 
SpeeLy: folds 
butch2102: folds 
PleBeY95: folds 
Uncalled bet ($0.25) returned to lonely fire
lonely fire collected $0.50 from pot
lonely fire: doesn't show hand 
*** SUMMARY ***
Total pot $0.50 | Rake $0 
Seat 1: DOA1980 folded before Flop (didn't bet)
Seat 2: dstrola folded before Flop (didn't bet)
Seat 3: SpeeLy folded before Flop (didn't bet)
Seat 4: butch2102 (button) folded before Flop (didn't bet)
Seat 6: PleBeY95 (small blind) folded before Flop
Seat 8: lonely fire (big blind) collected ($0.50)
Seat 9: RikaSunPay folded before Flop (didn't bet)



PokerStars Hand #228684440331:  Hold'em No Limit ($0.25/$0.50 USD) - 2021/07/30 13:54:29 ET
Table 'Galilea III' 9-max Seat #6 is the button
Seat 1: DOA1980 ($63.89 in chips) 
Seat 2: dstrola ($50.75 in chips) 
Seat 3: SpeeLy ($50 in chips) 
Seat 4: butch2102 ($83.29 in chips) 
Seat 6: PleBeY95 ($63.07 in chips) 
Seat 8: lonely fire ($55.28 in chips) 
Seat 9: RikaSunPay ($50 in chips) 
lonely fire: posts small blind $0.25
RikaSunPay: posts big blind $0.50
*** HOLE CARDS ***
DOA1980: folds 
dstrola: folds 
SpeeLy: folds 
butch2102: folds 
PleBeY95: folds 
Pachebrash joins the table at seat #7 
lonely fire: raises $0.75 to $1.25
RikaSunPay: calls $0.75
*** FLOP *** [Kh Ac 3c]
lonely fire: bets $1.50
RikaSunPay: folds 
Uncalled bet ($1.50) returned to lonely fire
lonely fire collected $2.38 from pot
lonely fire: doesn't show hand 
*** SUMMARY ***
Total pot $2.50 | Rake $0.12 
Board [Kh Ac 3c]
Seat 1: DOA1980 folded before Flop (didn't bet)
Seat 2: dstrola folded before Flop (didn't bet)
Seat 3: SpeeLy folded before Flop (didn't bet)
Seat 4: butch2102 folded before Flop (didn't bet)
Seat 6: PleBeY95 (button) folded before Flop (didn't bet)
Seat 8: lonely fire (small blind) collected ($2.38)
Seat 9: RikaSunPay (big blind) folded on the Flop



PokerStars Hand #228684452232:  Hold'em No Limit ($0.25/$0.50 USD) - 2021/07/30 13:54:58 ET
Table 'Galilea III' 9-max Seat #8 is the button
Seat 1: DOA1980 ($63.89 in chips) 
Seat 2: dstrola ($50.75 in chips) 
Seat 3: SpeeLy ($50 in chips) 
Seat 4: butch2102 ($83.29 in chips) 
Seat 6: PleBeY95 ($63.07 in chips) 
Seat 8: lonely fire ($56.41 in chips) 
Seat 9: RikaSunPay ($50 in chips) 
RikaSunPay: posts small blind $0.25
DOA1980: posts big blind $0.50
Pachebrash: sits out 
*** HOLE CARDS ***
dstrola: folds 
SpeeLy: folds 
butch2102: raises $0.50 to $1
PleBeY95: folds 
lonely fire: folds 
RikaSunPay: raises $4.25 to $5.25
DOA1980: folds 
butch2102: raises $6.25 to $11.50
RikaSunPay: raises $38.50 to $50 and is all-in
butch2102: calls $38.50
*** FLOP *** [5s 4d Ah]
*** TURN *** [5s 4d Ah] [Jh]
*** RIVER *** [5s 4d Ah Jh] [Ts]
*** SHOW DOWN ***
RikaSunPay: shows [Jd Jc] (three of a kind, Jacks)
butch2102: shows [Tc Td] (three of a kind, Tens)
RikaSunPay collected $98.50 from pot
*** SUMMARY ***
Total pot $100.50 | Rake $2 
Board [5s 4d Ah Jh Ts]
Seat 1: DOA1980 (big blind) folded before Flop
Seat 2: dstrola folded before Flop (didn't bet)
Seat 3: SpeeLy folded before Flop (didn't bet)
Seat 4: butch2102 showed [Tc Td] and lost with three of a kind, Tens
Seat 6: PleBeY95 folded before Flop (didn't bet)
Seat 8: lonely fire (button) folded before Flop (didn't bet)
Seat 9: RikaSunPay (small blind) showed [Jd Jc] and won ($98.50) with three of a kind, Jacks



PokerStars Hand #228684466449:  Hold'em No Limit ($0.25/$0.50 USD) - 2021/07/30 13:55:42 ET
Table 'Galilea III' 9-max Seat #9 is the button
Seat 1: DOA1980 ($63.39 in chips) 
Seat 2: dstrola ($50.75 in chips) 
Seat 3: SpeeLy ($50 in chips) 
Seat 4: butch2102 ($33.29 in chips) 
Seat 6: PleBeY95 ($63.07 in chips) 
Seat 8: lonely fire ($56.41 in chips) 
Seat 9: RikaSunPay ($98.50 in chips) 
DOA1980: posts small blind $0.25
dstrola: posts big blind $0.50
Pachebrash: sits out 
*** HOLE CARDS ***
SpeeLy: folds 
butch2102: folds 
PleBeY95: folds 
lonely fire: folds 
RikaSunPay: folds 
DOA1980: raises $1 to $1.50
dstrola: folds 
Uncalled bet ($1) returned to DOA1980
DOA1980 collected $1 from pot
DOA1980: doesn't show hand 
*** SUMMARY ***
Total pot $1 | Rake $0 
Seat 1: DOA1980 (small blind) collected ($1)
Seat 2: dstrola (big blind) folded before Flop
Seat 3: SpeeLy folded before Flop (didn't bet)
Seat 4: butch2102 folded before Flop (didn't bet)
Seat 6: PleBeY95 folded before Flop (didn't bet)
Seat 8: lonely fire folded before Flop (didn't bet)
Seat 9: RikaSunPay (button) folded before Flop (didn't bet)



PokerStars Hand #228684470076:  Hold'em No Limit ($0.25/$0.50 USD) - 2021/07/30 13:55:54 ET
Table 'Galilea III' 9-max Seat #1 is the button
Seat 1: DOA1980 ($63.89 in chips) 
Seat 2: dstrola ($50.25 in chips) 
Seat 3: SpeeLy ($50 in chips) 
Seat 4: butch2102 ($33.29 in chips) 
Seat 6: PleBeY95 ($63.07 in chips) 
Seat 8: lonely fire ($56.41 in chips) 
Seat 9: RikaSunPay ($98.50 in chips) 
dstrola: posts small blind $0.25
SpeeLy: posts big blind $0.50
Pachebrash: sits out 
*** HOLE CARDS ***
butch2102: folds 
PleBeY95: folds 
lonely fire: raises $1 to $1.50
RikaSunPay: folds 
DOA1980: folds 
dstrola: folds 
SpeeLy: calls $1
*** FLOP *** [3c Ad 8d]
SpeeLy: checks 
lonely fire: bets $1.02
SpeeLy: folds 
Uncalled bet ($1.02) returned to lonely fire
lonely fire collected $3.09 from pot
lonely fire: doesn't show hand 
*** SUMMARY ***
Total pot $3.25 | Rake $0.16 
Board [3c Ad 8d]
Seat 1: DOA1980 (button) folded before Flop (didn't bet)
Seat 2: dstrola (small blind) folded before Flop
Seat 3: SpeeLy (big blind) folded on the Flop
Seat 4: butch2102 folded before Flop (didn't bet)
Seat 6: PleBeY95 folded before Flop (didn't bet)
Seat 8: lonely fire collected ($3.09)
Seat 9: RikaSunPay folded before Flop (didn't bet)



PokerStars Hand #228684477319:  Hold'em No Limit ($0.25/$0.50 USD) - 2021/07/30 13:56:19 ET
Table 'Galilea III' 9-max Seat #2 is the button
Seat 1: DOA1980 ($63.89 in chips) 
Seat 2: dstrola ($50 in chips) 
Seat 3: SpeeLy ($50 in chips) 
Seat 4: butch2102 ($33.29 in chips) 
Seat 6: PleBeY95 ($63.07 in chips) 
Seat 8: lonely fire ($58 in chips) 
Seat 9: RikaSunPay ($98.50 in chips) 
SpeeLy: posts small blind $0.25
butch2102: posts big blind $0.50
Pachebrash: sits out 
*** HOLE CARDS ***
PleBeY95: folds 
lonely fire: folds 
RikaSunPay: folds 
DOA1980: folds 
dstrola: folds 
SpeeLy: folds 
Uncalled bet ($0.25) returned to butch2102
butch2102 collected $0.50 from pot
butch2102: doesn't show hand 
*** SUMMARY ***
Total pot $0.50 | Rake $0 
Seat 1: DOA1980 folded before Flop (didn't bet)
Seat 2: dstrola (button) folded before Flop (didn't bet)
Seat 3: SpeeLy (small blind) folded before Flop
Seat 4: butch2102 (big blind) collected ($0.50)
Seat 6: PleBeY95 folded before Flop (didn't bet)
Seat 8: lonely fire folded before Flop (didn't bet)
Seat 9: RikaSunPay folded before Flop (didn't bet)



PokerStars Hand #228684484619:  Hold'em No Limit ($0.25/$0.50 USD) - 2021/07/30 13:56:43 ET
Table 'Galilea III' 9-max Seat #3 is the button
Seat 1: DOA1980 ($63.89 in chips) 
Seat 2: dstrola ($50 in chips) 
Seat 3: SpeeLy ($50 in chips) 
Seat 4: butch2102 ($33.54 in chips) 
Seat 6: PleBeY95 ($63.07 in chips) 
Seat 8: lonely fire ($58 in chips) 
Seat 9: RikaSunPay ($98.50 in chips) 
butch2102: posts small blind $0.25
PleBeY95: posts big blind $0.50
Pachebrash: sits out 
*** HOLE CARDS ***
lonely fire: raises $1 to $1.50
RikaSunPay: folds 
DOA1980: calls $1.50
dstrola: folds 
SpeeLy: folds 
butch2102: folds 
PleBeY95: folds 
*** FLOP *** [4h 9h 9c]
lonely fire: checks 
DOA1980: checks 
*** TURN *** [4h 9h 9c] [8s]
lonely fire: bets $2.25
DOA1980: calls $2.25
*** RIVER *** [4h 9h 9c 8s] [9d]
lonely fire: bets $5
DOA1980: folds 
Uncalled bet ($5) returned to lonely fire
lonely fire collected $7.84 from pot
lonely fire: doesn't show hand 
*** SUMMARY ***
Total pot $8.25 | Rake $0.41 
Board [4h 9h 9c 8s 9d]
Seat 1: DOA1980 folded on the River
Seat 2: dstrola folded before Flop (didn't bet)
Seat 3: SpeeLy (button) folded before Flop (didn't bet)
Seat 4: butch2102 (small blind) folded before Flop
Seat 6: PleBeY95 (big blind) folded before Flop
Seat 8: lonely fire collected ($7.84)
Seat 9: RikaSunPay folded before Flop (didn't bet)



PokerStars Hand #228684500531:  Hold'em No Limit ($0.25/$0.50 USD) - 2021/07/30 13:57:37 ET
Table 'Galilea III' 9-max Seat #4 is the button
Seat 1: DOA1980 ($60.14 in chips) 
Seat 2: dstrola ($50 in chips) 
Seat 3: SpeeLy ($50 in chips) 
Seat 4: butch2102 ($33.29 in chips) 
Seat 6: PleBeY95 ($62.57 in chips) 
Seat 7: Pachebrash ($50 in chips) 
Seat 8: lonely fire ($62.09 in chips) 
Seat 9: RikaSunPay ($98.50 in chips) 
PleBeY95: posts small blind $0.25
Pachebrash: posts big blind $0.50
*** HOLE CARDS ***
lonely fire: folds 
RikaSunPay: folds 
DOA1980: folds 
dstrola: folds 
SpeeLy: folds 
butch2102: folds 
PleBeY95: folds 
Uncalled bet ($0.25) returned to Pachebrash
Pachebrash collected $0.50 from pot
Pachebrash: doesn't show hand 
*** SUMMARY ***
Total pot $0.50 | Rake $0 
Seat 1: DOA1980 folded before Flop (didn't bet)
Seat 2: dstrola folded before Flop (didn't bet)
Seat 3: SpeeLy folded before Flop (didn't bet)
Seat 4: butch2102 (button) folded before Flop (didn't bet)
Seat 6: PleBeY95 (small blind) folded before Flop
Seat 7: Pachebrash (big blind) collected ($0.50)
Seat 8: lonely fire folded before Flop (didn't bet)
Seat 9: RikaSunPay folded before Flop (didn't bet)



PokerStars Hand #228684505852:  Hold'em No Limit ($0.25/$0.50 USD) - 2021/07/30 13:57:55 ET
Table 'Galilea III' 9-max Seat #6 is the button
Seat 1: DOA1980 ($60.14 in chips) 
Seat 2: dstrola ($50 in chips) 
Seat 3: SpeeLy ($50 in chips) 
Seat 4: butch2102 ($33.29 in chips) 
Seat 6: PleBeY95 ($62.32 in chips) 
Seat 7: Pachebrash ($50.25 in chips) 
Seat 8: lonely fire ($62.09 in chips) 
Seat 9: RikaSunPay ($98.50 in chips) 
Pachebrash: posts small blind $0.25
lonely fire: posts big blind $0.50
*** HOLE CARDS ***
RikaSunPay: folds 
DOA1980: raises $0.75 to $1.25
dstrola: folds 
SpeeLy: folds 
butch2102: folds 
PleBeY95: folds 
Pachebrash: folds 
lonely fire: folds 
Uncalled bet ($0.75) returned to DOA1980
DOA1980 collected $1.25 from pot
DOA1980: doesn't show hand 
*** SUMMARY ***
Total pot $1.25 | Rake $0 
Seat 1: DOA1980 collected ($1.25)
Seat 2: dstrola folded before Flop (didn't bet)
Seat 3: SpeeLy folded before Flop (didn't bet)
Seat 4: butch2102 folded before Flop (didn't bet)
Seat 6: PleBeY95 (button) folded before Flop (didn't bet)
Seat 7: Pachebrash (small blind) folded before Flop
Seat 8: lonely fire (big blind) folded before Flop
Seat 9: RikaSunPay folded before Flop (didn't bet)



PokerStars Hand #228684509401:  Hold'em No Limit ($0.25/$0.50 USD) - 2021/07/30 13:58:07 ET
Table 'Galilea III' 9-max Seat #7 is the button
Seat 1: DOA1980 ($60.89 in chips) 
Seat 2: dstrola ($50 in chips) 
Seat 3: SpeeLy ($50 in chips) 
Seat 4: butch2102 ($33.29 in chips) 
Seat 6: PleBeY95 ($62.32 in chips) 
Seat 7: Pachebrash ($50 in chips) 
Seat 8: lonely fire ($61.59 in chips) 
Seat 9: RikaSunPay ($98.50 in chips) 
lonely fire: posts small blind $0.25
RikaSunPay: posts big blind $0.50
*** HOLE CARDS ***
DOA1980: raises $0.75 to $1.25
dstrola: folds 
SpeeLy: folds 
butch2102: calls $1.25
PleBeY95: folds 
Pachebrash: folds 
lonely fire: calls $1
Hunt133 was removed from the table for failing to post
Hunt133 leaves the table
RikaSunPay: calls $0.75
*** FLOP *** [Js 2h Ks]
lonely fire: checks 
RikaSunPay: checks 
DOA1980: bets $1.50
butch2102: calls $1.50
lonely fire: calls $1.50
RikaSunPay: folds 
*** TURN *** [Js 2h Ks] [5c]
lonely fire: checks 
DOA1980: bets $9
dikanmax joins the table at seat #5 
butch2102: raises $9 to $18
lonely fire: folds 
DOA1980: folds 
Uncalled bet ($9) returned to butch2102
butch2102 collected $26.12 from pot
butch2102: doesn't show hand 
*** SUMMARY ***
Total pot $27.50 | Rake $1.38 
Board [Js 2h Ks 5c]
Seat 1: DOA1980 folded on the Turn
Seat 2: dstrola folded before Flop (didn't bet)
Seat 3: SpeeLy folded before Flop (didn't bet)
Seat 4: butch2102 collected ($26.12)
Seat 6: PleBeY95 folded before Flop (didn't bet)
Seat 7: Pachebrash (button) folded before Flop (didn't bet)
Seat 8: lonely fire (small blind) folded on the Turn
Seat 9: RikaSunPay (big blind) folded on the Flop



PokerStars Hand #228684529643:  Hold'em No Limit ($0.25/$0.50 USD) - 2021/07/30 13:59:14 ET
Table 'Galilea III' 9-max Seat #8 is the button
Seat 1: DOA1980 ($50 in chips) 
Seat 2: dstrola ($50 in chips) 
Seat 3: SpeeLy ($50 in chips) 
Seat 4: butch2102 ($47.66 in chips) 
Seat 6: PleBeY95 ($62.32 in chips) 
Seat 7: Pachebrash ($50 in chips) 
Seat 8: lonely fire ($58.84 in chips) 
Seat 9: RikaSunPay ($97.25 in chips) 
RikaSunPay: posts small blind $0.25
DOA1980: posts big blind $0.50
dikanmax: sits out 
*** HOLE CARDS ***
dstrola: raises $1 to $1.50
SpeeLy: folds 
butch2102: folds 
PleBeY95: folds 
Pachebrash: folds 
lonely fire: folds 
RikaSunPay: folds 
DOA1980: folds 
Uncalled bet ($1) returned to dstrola
dstrola collected $1.25 from pot
*** SUMMARY ***
Total pot $1.25 | Rake $0 
Seat 1: DOA1980 (big blind) folded before Flop
Seat 2: dstrola collected ($1.25)
Seat 3: SpeeLy folded before Flop (didn't bet)
Seat 4: butch2102 folded before Flop (didn't bet)
Seat 6: PleBeY95 folded before Flop (didn't bet)
Seat 7: Pachebrash folded before Flop (didn't bet)
Seat 8: lonely fire (button) folded before Flop (didn't bet)
Seat 9: RikaSunPay (small blind) folded before Flop



PokerStars Hand #228684533603:  Hold'em No Limit ($0.25/$0.50 USD) - 2021/07/30 13:59:27 ET
Table 'Galilea III' 9-max Seat #9 is the button
Seat 1: DOA1980 ($50 in chips) 
Seat 2: dstrola ($50.75 in chips) 
Seat 3: SpeeLy ($50 in chips) 
Seat 4: butch2102 ($47.66 in chips) 
Seat 6: PleBeY95 ($62.32 in chips) 
Seat 7: Pachebrash ($50 in chips) 
Seat 8: lonely fire ($58.84 in chips) 
Seat 9: RikaSunPay ($97 in chips) 
DOA1980: posts small blind $0.25
dstrola: posts big blind $0.50
dikanmax: sits out 
*** HOLE CARDS ***
SpeeLy: folds 
butch2102: calls $0.50
PleBeY95: folds 
Pachebrash: folds 
lonely fire: folds 
RikaSunPay: folds 
DOA1980: raises $2 to $2.50
dstrola: folds 
butch2102: calls $2
*** FLOP *** [9d 7d Js]
DOA1980: checks 
butch2102: bets $5.22
DOA1980: raises $9.78 to $15
butch2102: folds 
Uncalled bet ($9.78) returned to DOA1980
DOA1980 collected $15.14 from pot
DOA1980: doesn't show hand 
*** SUMMARY ***
Total pot $15.94 | Rake $0.80 
Board [9d 7d Js]
Seat 1: DOA1980 (small blind) collected ($15.14)
Seat 2: dstrola (big blind) folded before Flop
Seat 3: SpeeLy folded before Flop (didn't bet)
Seat 4: butch2102 folded on the Flop
Seat 6: PleBeY95 folded before Flop (didn't bet)
Seat 7: Pachebrash folded before Flop (didn't bet)
Seat 8: lonely fire folded before Flop (didn't bet)
Seat 9: RikaSunPay (button) folded before Flop (didn't bet)



PokerStars Hand #228684556930:  Hold'em No Limit ($0.25/$0.50 USD) - 2021/07/30 14:00:37 ET
Table 'Galilea III' 9-max Seat #1 is the button
Seat 1: DOA1980 ($57.42 in chips) 
Seat 2: dstrola ($50.25 in chips) 
Seat 3: SpeeLy ($50 in chips) 
Seat 4: butch2102 ($39.94 in chips) 
Seat 6: PleBeY95 ($62.32 in chips) 
Seat 7: Pachebrash ($50 in chips) 
Seat 8: lonely fire ($58.84 in chips) 
Seat 9: RikaSunPay ($97 in chips) 
dstrola: posts small blind $0.25
SpeeLy: posts big blind $0.50
dikanmax: sits out 
*** HOLE CARDS ***
butch2102: calls $0.50
PleBeY95: folds 
Pachebrash: folds 
lonely fire: folds 
RikaSunPay: folds 
DOA1980: folds 
dstrola: folds 
SpeeLy: checks 
*** FLOP *** [4c As 6d]
SpeeLy: checks 
butch2102: bets $1.19
SpeeLy: calls $1.19
*** TURN *** [4c As 6d] [8h]
SpeeLy: checks 
butch2102: checks 
*** RIVER *** [4c As 6d 8h] [3d]
SpeeLy: bets $1.76
butch2102: raises $4.26 to $6.02
SpeeLy: calls $4.26
*** SHOW DOWN ***
butch2102: shows [3s Ac] (two pair, Aces and Threes)
SpeeLy: shows [Ah 8c] (two pair, Aces and Eights)
SpeeLy collected $14.89 from pot
*** SUMMARY ***
Total pot $15.67 | Rake $0.78 
Board [4c As 6d 8h 3d]
Seat 1: DOA1980 (button) folded before Flop (didn't bet)
Seat 2: dstrola (small blind) folded before Flop
Seat 3: SpeeLy (big blind) showed [Ah 8c] and won ($14.89) with two pair, Aces and Eights
Seat 4: butch2102 showed [3s Ac] and lost with two pair, Aces and Threes
Seat 6: PleBeY95 folded before Flop (didn't bet)
Seat 7: Pachebrash folded before Flop (didn't bet)
Seat 8: lonely fire folded before Flop (didn't bet)
Seat 9: RikaSunPay folded before Flop (didn't bet)



PokerStars Hand #228684569626:  Hold'em No Limit ($0.25/$0.50 USD) - 2021/07/30 14:01:13 ET
Table 'Galilea III' 9-max Seat #2 is the button
Seat 1: DOA1980 ($57.42 in chips) 
Seat 2: dstrola ($50 in chips) 
Seat 3: SpeeLy ($57.18 in chips) 
Seat 4: butch2102 ($32.23 in chips) 
Seat 6: PleBeY95 ($62.32 in chips) 
Seat 7: Pachebrash ($50 in chips) 
Seat 8: lonely fire ($58.84 in chips) 
Seat 9: RikaSunPay ($97 in chips) 
SpeeLy: posts small blind $0.25
butch2102: posts big blind $0.50
dikanmax: sits out 
*** HOLE CARDS ***
PleBeY95: folds 
Pachebrash: folds 
lonely fire: folds 
RikaSunPay: folds 
DOA1980: raises $0.75 to $1.25
dstrola: folds 
SpeeLy: folds 
butch2102: raises $4.75 to $6
DOA1980: raises $51.42 to $57.42 and is all-in
butch2102: calls $26.23 and is all-in
Uncalled bet ($25.19) returned to DOA1980
*** FLOP *** [5c 3c 7s]
*** TURN *** [5c 3c 7s] [Qd]
*** RIVER *** [5c 3c 7s Qd] [8c]
*** SHOW DOWN ***
butch2102: shows [Kd Ah] (high card Ace)
DOA1980: shows [Ad Ks] (high card Ace)
butch2102 collected $31.36 from pot
DOA1980 collected $31.35 from pot
*** SUMMARY ***
Total pot $64.71 | Rake $2 
Board [5c 3c 7s Qd 8c]
Seat 1: DOA1980 showed [Ad Ks] and won ($31.35) with high card Ace
Seat 2: dstrola (button) folded before Flop (didn't bet)
Seat 3: SpeeLy (small blind) folded before Flop
Seat 4: butch2102 (big blind) showed [Kd Ah] and won ($31.36) with high card Ace
Seat 6: PleBeY95 folded before Flop (didn't bet)
Seat 7: Pachebrash folded before Flop (didn't bet)
Seat 8: lonely fire folded before Flop (didn't bet)
Seat 9: RikaSunPay folded before Flop (didn't bet)



PokerStars Hand #228684582205:  Hold'em No Limit ($0.25/$0.50 USD) - 2021/07/30 14:01:46 ET
Table 'Galilea III' 9-max Seat #3 is the button
Seat 1: DOA1980 ($56.54 in chips) 
Seat 2: dstrola ($50 in chips) 
Seat 3: SpeeLy ($56.93 in chips) 
Seat 4: butch2102 ($31.36 in chips) 
Seat 5: dikanmax ($50 in chips) 
Seat 6: PleBeY95 ($62.32 in chips) 
Seat 7: Pachebrash ($50 in chips) 
Seat 8: lonely fire ($58.84 in chips) 
Seat 9: RikaSunPay ($97 in chips) 
butch2102: posts small blind $0.25
dikanmax: posts big blind $0.50
*** HOLE CARDS ***
PleBeY95: raises $1 to $1.50
Pachebrash: folds 
lonely fire: folds 
RikaSunPay: raises $2.75 to $4.25
DOA1980: folds 
dstrola: folds 
SpeeLy: folds 
butch2102: calls $4
dikanmax: folds 
PleBeY95: folds 
*** FLOP *** [8s Td 3c]
butch2102: bets $27.11 and is all-in
RikaSunPay: calls $27.11
*** TURN *** [8s Td 3c] [Qs]
*** RIVER *** [8s Td 3c Qs] [3s]
*** SHOW DOWN ***
butch2102: shows [5d 5c] (two pair, Fives and Threes)
RikaSunPay: shows [Ac Ah] (two pair, Aces and Threes)
RikaSunPay collected $62.72 from pot
*** SUMMARY ***
Total pot $64.72 | Rake $2 
Board [8s Td 3c Qs 3s]
Seat 1: DOA1980 folded before Flop (didn't bet)
Seat 2: dstrola folded before Flop (didn't bet)
Seat 3: SpeeLy (button) folded before Flop (didn't bet)
Seat 4: butch2102 (small blind) showed [5d 5c] and lost with two pair, Fives and Threes
Seat 5: dikanmax (big blind) folded before Flop
Seat 6: PleBeY95 folded before Flop
Seat 7: Pachebrash folded before Flop (didn't bet)
Seat 8: lonely fire folded before Flop (didn't bet)
Seat 9: RikaSunPay showed [Ac Ah] and won ($62.72) with two pair, Aces and Threes



PokerStars Hand #228684602159:  Hold'em No Limit ($0.25/$0.50 USD) - 2021/07/30 14:02:35 ET
Table 'Galilea III' 9-max Seat #5 is the button
Seat 1: DOA1980 ($56.54 in chips) 
Seat 2: dstrola ($50 in chips) 
Seat 3: SpeeLy ($56.93 in chips) 
Seat 5: dikanmax ($50 in chips) 
Seat 6: PleBeY95 ($60.82 in chips) 
Seat 7: Pachebrash ($50 in chips) 
Seat 8: lonely fire ($58.84 in chips) 
Seat 9: RikaSunPay ($128.36 in chips) 
PleBeY95: posts small blind $0.25
Pachebrash: posts big blind $0.50
*** HOLE CARDS ***
lonely fire: folds 
RikaSunPay: folds 
butch2102 leaves the table
DOA1980: folds 
dstrola: raises $1 to $1.50
SpeeLy: folds 
dikanmax: raises $3 to $4.50
PleBeY95: folds 
Pachebrash: folds 
dstrola: calls $3
*** FLOP *** [5c 5s 3s]
dstrola: checks 
dikanmax: bets $6.20
dstrola: calls $6.20
*** TURN *** [5c 5s 3s] [9h]
dstrola: checks 
akiobenj joins the table at seat #4 
dikanmax: bets $39.30 and is all-in
dstrola: folds 
Uncalled bet ($39.30) returned to dikanmax
dikanmax collected $21.04 from pot
dikanmax: doesn't show hand 
*** SUMMARY ***
Total pot $22.15 | Rake $1.11 
Board [5c 5s 3s 9h]
Seat 1: DOA1980 folded before Flop (didn't bet)
Seat 2: dstrola folded on the Turn
Seat 3: SpeeLy folded before Flop (didn't bet)
Seat 5: dikanmax (button) collected ($21.04)
Seat 6: PleBeY95 (small blind) folded before Flop
Seat 7: Pachebrash (big blind) folded before Flop
Seat 8: lonely fire folded before Flop (didn't bet)
Seat 9: RikaSunPay folded before Flop (didn't bet)



PokerStars Hand #228684631986:  Hold'em No Limit ($0.25/$0.50 USD) - 2021/07/30 14:03:45 ET
Table 'Galilea III' 9-max Seat #6 is the button
Seat 1: DOA1980 ($56.54 in chips) 
Seat 2: dstrola ($50 in chips) 
Seat 3: SpeeLy ($56.93 in chips) 
Seat 5: dikanmax ($60.34 in chips) 
Seat 6: PleBeY95 ($60.57 in chips) 
Seat 7: Pachebrash ($50 in chips) 
Pachebrash: posts small blind $0.25
lonely fire: is sitting out 
RikaSunPay: is sitting out 
DOA1980: posts big blind $0.50
akiobenj: sits out 
*** HOLE CARDS ***
dstrola: folds 
SpeeLy: folds 
dikanmax: raises $1 to $1.50
PleBeY95: folds 
Pachebrash: folds 
RikaSunPay leaves the table
DOA1980: raises $3.75 to $5.25
dikanmax: folds 
Uncalled bet ($3.75) returned to DOA1980
DOA1980 collected $3.25 from pot
DOA1980: doesn't show hand 
*** SUMMARY ***
Total pot $3.25 | Rake $0 
Seat 1: DOA1980 (big blind) collected ($3.25)
Seat 2: dstrola folded before Flop (didn't bet)
Seat 3: SpeeLy folded before Flop (didn't bet)
Seat 5: dikanmax folded before Flop
Seat 6: PleBeY95 (button) folded before Flop (didn't bet)
Seat 7: Pachebrash (small blind) folded before Flop



PokerStars Hand #228684651471:  Hold'em No Limit ($0.25/$0.50 USD) - 2021/07/30 14:04:31 ET
Table 'Galilea III' 9-max Seat #1 is the button
Seat 1: DOA1980 ($58.04 in chips) 
Seat 2: dstrola ($50 in chips) 
Seat 3: SpeeLy ($56.93 in chips) 
Seat 5: dikanmax ($58.84 in chips) 
Seat 6: PleBeY95 ($61.32 in chips) 
Seat 7: Pachebrash ($50 in chips) 
Seat 8: lonely fire ($58.84 in chips) 
dstrola: posts small blind $0.25
SpeeLy: posts big blind $0.50
akiobenj: sits out 
lonely fire: posts small & big blinds $0.75
*** HOLE CARDS ***
Nestle170 joins the table at seat #9 
dikanmax: folds 
PleBeY95: folds 
Pachebrash: folds 
lonely fire: checks 
DOA1980: raises $1.25 to $1.75
dstrola: folds 
SpeeLy: folds 
lonely fire: folds 
Uncalled bet ($1.25) returned to DOA1980
DOA1980 collected $2 from pot
DOA1980: doesn't show hand 
*** SUMMARY ***
Total pot $2 | Rake $0 
Seat 1: DOA1980 (button) collected ($2)
Seat 2: dstrola (small blind) folded before Flop
Seat 3: SpeeLy (big blind) folded before Flop
Seat 5: dikanmax folded before Flop (didn't bet)
Seat 6: PleBeY95 folded before Flop (didn't bet)
Seat 7: Pachebrash folded before Flop (didn't bet)
Seat 8: lonely fire folded before Flop (didn't bet)



PokerStars Hand #228684661965:  Hold'em No Limit ($0.25/$0.50 USD) - 2021/07/30 14:04:56 ET
Table 'Galilea III' 9-max Seat #2 is the button
Seat 1: DOA1980 ($59.54 in chips) 
Seat 2: dstrola ($50 in chips) 
Seat 3: SpeeLy ($56.43 in chips) 
Seat 4: akiobenj ($33.79 in chips) 
Seat 5: dikanmax ($58.84 in chips) 
Seat 6: PleBeY95 ($61.32 in chips) 
Seat 7: Pachebrash ($50 in chips) 
Seat 8: lonely fire ($58.09 in chips) 
SpeeLy: posts small blind $0.25
akiobenj: posts big blind $0.50
Nestle170: sits out 
*** HOLE CARDS ***
dikanmax: folds 
PleBeY95: folds 
Pachebrash: raises $1 to $1.50
lonely fire: folds 
DOA1980: folds 
dstrola: folds 
SpeeLy: folds 
akiobenj: calls $1
*** FLOP *** [Js 3c Tc]
akiobenj: checks 
Pachebrash: checks 
*** TURN *** [Js 3c Tc] [6h]
akiobenj: bets $3.09
Pachebrash: calls $3.09
*** RIVER *** [Js 3c Tc 6h] [8h]
akiobenj: bets $8.96
Pachebrash: calls $8.96
*** SHOW DOWN ***
akiobenj: shows [Kd Jh] (a pair of Jacks)
Pachebrash: mucks hand 
akiobenj collected $25.98 from pot
*** SUMMARY ***
Total pot $27.35 | Rake $1.37 
Board [Js 3c Tc 6h 8h]
Seat 1: DOA1980 folded before Flop (didn't bet)
Seat 2: dstrola (button) folded before Flop (didn't bet)
Seat 3: SpeeLy (small blind) folded before Flop
Seat 4: akiobenj (big blind) showed [Kd Jh] and won ($25.98) with a pair of Jacks
Seat 5: dikanmax folded before Flop (didn't bet)
Seat 6: PleBeY95 folded before Flop (didn't bet)
Seat 7: Pachebrash mucked
Seat 8: lonely fire folded before Flop (didn't bet)



PokerStars Hand #228684683776:  Hold'em No Limit ($0.25/$0.50 USD) - 2021/07/30 14:05:47 ET
Table 'Galilea III' 9-max Seat #3 is the button
Seat 1: DOA1980 ($59.54 in chips) 
Seat 2: dstrola ($50 in chips) 
Seat 3: SpeeLy ($56.18 in chips) 
Seat 4: akiobenj ($46.22 in chips) 
Seat 5: dikanmax ($58.84 in chips) 
Seat 6: PleBeY95 ($61.32 in chips) 
Seat 7: Pachebrash ($50 in chips) 
Seat 8: lonely fire ($58.09 in chips) 
akiobenj: posts small blind $0.25
dikanmax: posts big blind $0.50
Nestle170: sits out 
*** HOLE CARDS ***
PleBeY95: folds 
Pachebrash: raises $1 to $1.50
lonely fire: folds 
DOA1980: raises $3 to $4.50
dstrola: folds 
SpeeLy: folds 
akiobenj: folds 
dikanmax: folds 
Pachebrash: calls $3
*** FLOP *** [Qh Th 6c]
Pachebrash: checks 
DOA1980: bets $3
Pachebrash: calls $3
*** TURN *** [Qh Th 6c] [3s]
Pachebrash: checks 
DOA1980: bets $11.52
Pachebrash: folds 
Uncalled bet ($11.52) returned to DOA1980
DOA1980 collected $14.96 from pot
DOA1980: doesn't show hand 
*** SUMMARY ***
Total pot $15.75 | Rake $0.79 
Board [Qh Th 6c 3s]
Seat 1: DOA1980 collected ($14.96)
Seat 2: dstrola folded before Flop (didn't bet)
Seat 3: SpeeLy (button) folded before Flop (didn't bet)
Seat 4: akiobenj (small blind) folded before Flop
Seat 5: dikanmax (big blind) folded before Flop
Seat 6: PleBeY95 folded before Flop (didn't bet)
Seat 7: Pachebrash folded on the Turn
Seat 8: lonely fire folded before Flop (didn't bet)



PokerStars Hand #228684705852:  Hold'em No Limit ($0.25/$0.50 USD) - 2021/07/30 14:06:39 ET
Table 'Galilea III' 9-max Seat #4 is the button
Seat 1: DOA1980 ($67 in chips) 
Seat 2: dstrola ($50 in chips) 
Seat 3: SpeeLy ($56.18 in chips) 
Seat 4: akiobenj ($45.97 in chips) 
Seat 5: dikanmax ($58.34 in chips) 
Seat 6: PleBeY95 ($61.32 in chips) 
Seat 7: Pachebrash ($50 in chips) 
Seat 8: lonely fire ($58.09 in chips) 
dikanmax: posts small blind $0.25
PleBeY95: posts big blind $0.50
Nestle170: sits out 
*** HOLE CARDS ***
Pachebrash: folds 
lonely fire: folds 
DOA1980: folds 
dstrola: folds 
SpeeLy: raises $0.75 to $1.25
akiobenj: folds 
dikanmax: folds 
PleBeY95: folds 
Uncalled bet ($0.75) returned to SpeeLy
SpeeLy collected $1.25 from pot
SpeeLy: doesn't show hand 
*** SUMMARY ***
Total pot $1.25 | Rake $0 
Seat 1: DOA1980 folded before Flop (didn't bet)
Seat 2: dstrola folded before Flop (didn't bet)
Seat 3: SpeeLy collected ($1.25)
Seat 4: akiobenj (button) folded before Flop (didn't bet)
Seat 5: dikanmax (small blind) folded before Flop
Seat 6: PleBeY95 (big blind) folded before Flop
Seat 7: Pachebrash folded before Flop (didn't bet)
Seat 8: lonely fire folded before Flop (didn't bet)



PokerStars Hand #228684714059:  Hold'em No Limit ($0.25/$0.50 USD) - 2021/07/30 14:06:58 ET
Table 'Galilea III' 9-max Seat #5 is the button
Seat 1: DOA1980 ($67 in chips) 
Seat 2: dstrola ($50 in chips) 
Seat 3: SpeeLy ($56.93 in chips) 
Seat 4: akiobenj ($45.97 in chips) 
Seat 5: dikanmax ($58.09 in chips) 
Seat 6: PleBeY95 ($60.82 in chips) 
Seat 7: Pachebrash ($50 in chips) 
Seat 8: lonely fire ($58.09 in chips) 
PleBeY95: posts small blind $0.25
Pachebrash: posts big blind $0.50
Nestle170: sits out 
*** HOLE CARDS ***
lonely fire: folds 
DOA1980: raises $0.75 to $1.25
dstrola: folds 
SpeeLy: folds 
akiobenj: folds 
dikanmax: folds 
PleBeY95: folds 
Pachebrash: folds 
Uncalled bet ($0.75) returned to DOA1980
DOA1980 collected $1.25 from pot
DOA1980: doesn't show hand 
*** SUMMARY ***
Total pot $1.25 | Rake $0 
Seat 1: DOA1980 collected ($1.25)
Seat 2: dstrola folded before Flop (didn't bet)
Seat 3: SpeeLy folded before Flop (didn't bet)
Seat 4: akiobenj folded before Flop (didn't bet)
Seat 5: dikanmax (button) folded before Flop (didn't bet)
Seat 6: PleBeY95 (small blind) folded before Flop
Seat 7: Pachebrash (big blind) folded before Flop
Seat 8: lonely fire folded before Flop (didn't bet)



PokerStars Hand #228684720482:  Hold'em No Limit ($0.25/$0.50 USD) - 2021/07/30 14:07:13 ET
Table 'Galilea III' 9-max Seat #6 is the button
Seat 1: DOA1980 ($67.75 in chips) 
Seat 2: dstrola ($50 in chips) 
Seat 3: SpeeLy ($56.93 in chips) 
Seat 4: akiobenj ($45.97 in chips) 
Seat 5: dikanmax ($58.09 in chips) 
Seat 6: PleBeY95 ($60.57 in chips) 
Seat 7: Pachebrash ($50 in chips) 
Seat 8: lonely fire ($58.09 in chips) 
Pachebrash: posts small blind $0.25
lonely fire: posts big blind $0.50
Nestle170: sits out 
*** HOLE CARDS ***
DOA1980: folds 
dstrola: folds 
SpeeLy: folds 
akiobenj has timed out
akiobenj: folds 
dikanmax: folds 
PleBeY95: raises $0.75 to $1.25
Pachebrash: folds 
lonely fire: calls $0.75
*** FLOP *** [5h Jh Js]
lonely fire: checks 
PleBeY95: bets $0.86
lonely fire: raises $1.89 to $2.75
SpeeLy leaves the table
PleBeY95: folds 
Uncalled bet ($1.89) returned to lonely fire
lonely fire collected $4.25 from pot
lonely fire: doesn't show hand 
*** SUMMARY ***
Total pot $4.47 | Rake $0.22 
Board [5h Jh Js]
Seat 1: DOA1980 folded before Flop (didn't bet)
Seat 2: dstrola folded before Flop (didn't bet)
Seat 3: SpeeLy folded before Flop (didn't bet)
Seat 4: akiobenj folded before Flop (didn't bet)
Seat 5: dikanmax folded before Flop (didn't bet)
Seat 6: PleBeY95 (button) folded on the Flop
Seat 7: Pachebrash (small blind) folded before Flop
Seat 8: lonely fire (big blind) collected ($4.25)



PokerStars Hand #228684752161:  Hold'em No Limit ($0.25/$0.50 USD) - 2021/07/30 14:08:27 ET
Table 'Galilea III' 9-max Seat #7 is the button
Seat 1: DOA1980 ($67.75 in chips) 
Seat 2: dstrola ($50 in chips) 
Seat 4: akiobenj ($45.97 in chips) 
Seat 5: dikanmax ($58.09 in chips) 
Seat 6: PleBeY95 ($58.46 in chips) 
Seat 7: Pachebrash ($50 in chips) 
Seat 8: lonely fire ($60.23 in chips) 
Seat 9: Nestle170 ($50 in chips) 
lonely fire: posts small blind $0.25
Nestle170: posts big blind $0.50
*** HOLE CARDS ***
DOA1980: folds 
dstrola: folds 
akiobenj: folds 
dikanmax: folds 
PleBeY95: raises $1 to $1.50
Pachebrash: folds 
lonely fire: folds 
Nestle170: calls $1
*** FLOP *** [Ks 3s Qd]
Nestle170: checks 
PleBeY95: bets $1.02
se13giuum joins the table at seat #3 
Nestle170: calls $1.02
*** TURN *** [Ks 3s Qd] [Qs]
Nestle170: checks 
PleBeY95: checks 
*** RIVER *** [Ks 3s Qd Qs] [6h]
Nestle170: bets $1.66
PleBeY95: folds 
Uncalled bet ($1.66) returned to Nestle170
Nestle170 collected $5.03 from pot
Nestle170: doesn't show hand 
*** SUMMARY ***
Total pot $5.29 | Rake $0.26 
Board [Ks 3s Qd Qs 6h]
Seat 1: DOA1980 folded before Flop (didn't bet)
Seat 2: dstrola folded before Flop (didn't bet)
Seat 4: akiobenj folded before Flop (didn't bet)
Seat 5: dikanmax folded before Flop (didn't bet)
Seat 6: PleBeY95 folded on the River
Seat 7: Pachebrash (button) folded before Flop (didn't bet)
Seat 8: lonely fire (small blind) folded before Flop
Seat 9: Nestle170 (big blind) collected ($5.03)



PokerStars Hand #228684785543:  Hold'em No Limit ($0.25/$0.50 USD) - 2021/07/30 14:09:37 ET
Table 'Galilea III' 9-max Seat #8 is the button
Seat 1: DOA1980 ($67.75 in chips) 
Seat 2: dstrola ($50 in chips) 
Seat 4: akiobenj ($45.97 in chips) 
Seat 5: dikanmax ($58.09 in chips) 
Seat 6: PleBeY95 ($55.94 in chips) 
Seat 7: Pachebrash ($50 in chips) 
Seat 8: lonely fire ($59.98 in chips) 
Seat 9: Nestle170 ($52.51 in chips) 
Nestle170: posts small blind $0.25
DOA1980: posts big blind $0.50
se13giuum: sits out 
*** HOLE CARDS ***
dstrola: folds 
akiobenj: folds 
dikanmax: folds 
PleBeY95: folds 
Pachebrash: folds 
lonely fire: folds 
Nestle170: folds 
Uncalled bet ($0.25) returned to DOA1980
DOA1980 collected $0.50 from pot
DOA1980: doesn't show hand 
*** SUMMARY ***
Total pot $0.50 | Rake $0 
Seat 1: DOA1980 (big blind) collected ($0.50)
Seat 2: dstrola folded before Flop (didn't bet)
Seat 4: akiobenj folded before Flop (didn't bet)
Seat 5: dikanmax folded before Flop (didn't bet)
Seat 6: PleBeY95 folded before Flop (didn't bet)
Seat 7: Pachebrash folded before Flop (didn't bet)
Seat 8: lonely fire (button) folded before Flop (didn't bet)
Seat 9: Nestle170 (small blind) folded before Flop



PokerStars Hand #228684792817:  Hold'em No Limit ($0.25/$0.50 USD) - 2021/07/30 14:09:55 ET
Table 'Galilea III' 9-max Seat #9 is the button
Seat 1: DOA1980 ($68 in chips) 
Seat 2: dstrola ($50 in chips) 
Seat 4: akiobenj ($45.97 in chips) 
Seat 5: dikanmax ($58.09 in chips) 
Seat 6: PleBeY95 ($55.94 in chips) 
Seat 7: Pachebrash ($50 in chips) 
Seat 8: lonely fire ($59.98 in chips) 
Seat 9: Nestle170 ($52.26 in chips) 
DOA1980: posts small blind $0.25
dstrola: posts big blind $0.50
se13giuum: sits out 
*** HOLE CARDS ***
akiobenj: folds 
dikanmax: folds 
PleBeY95: folds 
Pachebrash: folds 
lonely fire: raises $1 to $1.50
Nestle170: folds 
DOA1980: folds 
dstrola: folds 
Uncalled bet ($1) returned to lonely fire
lonely fire collected $1.25 from pot
lonely fire: doesn't show hand 
*** SUMMARY ***
Total pot $1.25 | Rake $0 
Seat 1: DOA1980 (small blind) folded before Flop
Seat 2: dstrola (big blind) folded before Flop
Seat 4: akiobenj folded before Flop (didn't bet)
Seat 5: dikanmax folded before Flop (didn't bet)
Seat 6: PleBeY95 folded before Flop (didn't bet)
Seat 7: Pachebrash folded before Flop (didn't bet)
Seat 8: lonely fire collected ($1.25)
Seat 9: Nestle170 (button) folded before Flop (didn't bet)



PokerStars Hand #228684801122:  Hold'em No Limit ($0.25/$0.50 USD) - 2021/07/30 14:10:14 ET
Table 'Galilea III' 9-max Seat #1 is the button
Seat 1: DOA1980 ($67.75 in chips) 
Seat 2: dstrola ($50 in chips) 
Seat 3: se13giuum ($43.56 in chips) 
Seat 4: akiobenj ($45.97 in chips) 
Seat 5: dikanmax ($58.09 in chips) 
Seat 6: PleBeY95 ($55.94 in chips) 
Seat 7: Pachebrash ($50 in chips) 
Seat 8: lonely fire ($60.73 in chips) 
Seat 9: Nestle170 ($52.26 in chips) 
dstrola: posts small blind $0.25
se13giuum: posts big blind $0.50
*** HOLE CARDS ***
akiobenj: calls $0.50
dikanmax: folds 
PleBeY95: folds 
Pachebrash: folds 
lonely fire: folds 
Nestle170: raises $1.50 to $2
DOA1980: folds 
dstrola: folds 
se13giuum: folds 
akiobenj: calls $1.50
*** FLOP *** [8h 5c 4c]
akiobenj: bets $2.25
Nestle170: raises $4.50 to $6.75
akiobenj: calls $4.50
*** TURN *** [8h 5c 4c] [Ks]
akiobenj: checks 
Nestle170: checks 
*** RIVER *** [8h 5c 4c Ks] [2d]
akiobenj: bets $8.67
Nestle170: folds 
Uncalled bet ($8.67) returned to akiobenj
akiobenj collected $17.34 from pot
akiobenj: doesn't show hand 
*** SUMMARY ***
Total pot $18.25 | Rake $0.91 
Board [8h 5c 4c Ks 2d]
Seat 1: DOA1980 (button) folded before Flop (didn't bet)
Seat 2: dstrola (small blind) folded before Flop
Seat 3: se13giuum (big blind) folded before Flop
Seat 4: akiobenj collected ($17.34)
Seat 5: dikanmax folded before Flop (didn't bet)
Seat 6: PleBeY95 folded before Flop (didn't bet)
Seat 7: Pachebrash folded before Flop (didn't bet)
Seat 8: lonely fire folded before Flop (didn't bet)
Seat 9: Nestle170 folded on the River



PokerStars Hand #228684832705:  Hold'em No Limit ($0.25/$0.50 USD) - 2021/07/30 14:11:27 ET
Table 'Galilea III' 9-max Seat #3 is the button
Seat 1: DOA1980 ($67.75 in chips) 
Seat 3: se13giuum ($43.06 in chips) 
Seat 4: akiobenj ($54.56 in chips) 
Seat 5: dikanmax ($58.09 in chips) 
Seat 6: PleBeY95 ($55.94 in chips) 
Seat 7: Pachebrash ($50 in chips) 
Seat 8: lonely fire ($60.73 in chips) 
Seat 9: Nestle170 ($50 in chips) 
akiobenj: posts small blind $0.25
dikanmax: posts big blind $0.50
*** HOLE CARDS ***
PleBeY95: folds 
Pachebrash: folds 
lonely fire: folds 
Nestle170: folds 
DOA1980: raises $0.75 to $1.25
se13giuum: calls $1.25
akiobenj: folds 
dikanmax: folds 
*** FLOP *** [Ad 3h 3s]
DOA1980: checks 
se13giuum: bets $1.54
DOA1980: folds 
Uncalled bet ($1.54) returned to se13giuum
se13giuum collected $3.09 from pot
se13giuum: doesn't show hand 
*** SUMMARY ***
Total pot $3.25 | Rake $0.16 
Board [Ad 3h 3s]
Seat 1: DOA1980 folded on the Flop
Seat 3: se13giuum (button) collected ($3.09)
Seat 4: akiobenj (small blind) folded before Flop
Seat 5: dikanmax (big blind) folded before Flop
Seat 6: PleBeY95 folded before Flop (didn't bet)
Seat 7: Pachebrash folded before Flop (didn't bet)
Seat 8: lonely fire folded before Flop (didn't bet)
Seat 9: Nestle170 folded before Flop (didn't bet)



PokerStars Hand #228684850389:  Hold'em No Limit ($0.25/$0.50 USD) - 2021/07/30 14:12:09 ET
Table 'Galilea III' 9-max Seat #4 is the button
Seat 1: DOA1980 ($66.50 in chips) 
Seat 3: se13giuum ($44.90 in chips) 
Seat 4: akiobenj ($54.31 in chips) 
Seat 5: dikanmax ($57.59 in chips) 
Seat 6: PleBeY95 ($55.94 in chips) 
Seat 7: Pachebrash ($50 in chips) 
Seat 8: lonely fire ($60.73 in chips) 
Seat 9: Nestle170 ($50 in chips) 
dikanmax: posts small blind $0.25
PleBeY95: posts big blind $0.50
*** HOLE CARDS ***
Pachebrash: folds 
lonely fire: folds 
Nestle170: folds 
DOA1980: folds 
se13giuum: folds 
akiobenj: calls $0.50
dikanmax: calls $0.25
PleBeY95: checks 
*** FLOP *** [2h 4d 3d]
dikanmax: bets $0.50
PleBeY95: calls $0.50
akiobenj: calls $0.50
*** TURN *** [2h 4d 3d] [2d]
dikanmax: checks 
PleBeY95: bets $2.14
akiobenj: folds 
dikanmax: calls $2.14
*** RIVER *** [2h 4d 3d 2d] [Js]
dikanmax: checks 
PleBeY95: bets $5.19
dikanmax: folds 
Uncalled bet ($5.19) returned to PleBeY95
PleBeY95 collected $6.92 from pot
*** SUMMARY ***
Total pot $7.28 | Rake $0.36 
Board [2h 4d 3d 2d Js]
Seat 1: DOA1980 folded before Flop (didn't bet)
Seat 3: se13giuum folded before Flop (didn't bet)
Seat 4: akiobenj (button) folded on the Turn
Seat 5: dikanmax (small blind) folded on the River
Seat 6: PleBeY95 (big blind) collected ($6.92)
Seat 7: Pachebrash folded before Flop (didn't bet)
Seat 8: lonely fire folded before Flop (didn't bet)
Seat 9: Nestle170 folded before Flop (didn't bet)



PokerStars Hand #228684874945:  Hold'em No Limit ($0.25/$0.50 USD) - 2021/07/30 14:13:07 ET
Table 'Galilea III' 9-max Seat #5 is the button
Seat 1: DOA1980 ($66.50 in chips) 
Seat 3: se13giuum ($44.90 in chips) 
Seat 4: akiobenj ($53.31 in chips) 
Seat 5: dikanmax ($54.45 in chips) 
Seat 6: PleBeY95 ($59.72 in chips) 
Seat 7: Pachebrash ($50 in chips) 
Seat 8: lonely fire ($60.73 in chips) 
Seat 9: Nestle170 ($50 in chips) 
PleBeY95: posts small blind $0.25
Pachebrash: posts big blind $0.50
*** HOLE CARDS ***
lonely fire: folds 
lonely fire leaves the table
Nestle170: folds 
190K joins the table at seat #8 
DOA1980: folds 
se13giuum: folds 
akiobenj: calls $0.50
dikanmax: raises $1.75 to $2.25
PleBeY95: folds 
Pachebrash: folds 
akiobenj: folds 
Uncalled bet ($1.75) returned to dikanmax
dikanmax collected $1.75 from pot
dikanmax: doesn't show hand 
*** SUMMARY ***
Total pot $1.75 | Rake $0 
Seat 1: DOA1980 folded before Flop (didn't bet)
Seat 3: se13giuum folded before Flop (didn't bet)
Seat 4: akiobenj folded before Flop
Seat 5: dikanmax (button) collected ($1.75)
Seat 6: PleBeY95 (small blind) folded before Flop
Seat 7: Pachebrash (big blind) folded before Flop
Seat 8: lonely fire folded before Flop (didn't bet)
Seat 9: Nestle170 folded before Flop (didn't bet)



PokerStars Hand #228684895343:  Hold'em No Limit ($0.25/$0.50 USD) - 2021/07/30 14:13:34 ET
Table 'Galilea III' 9-max Seat #6 is the button
Seat 1: DOA1980 ($66.50 in chips) 
Seat 3: se13giuum ($44.90 in chips) 
Seat 4: akiobenj ($52.81 in chips) 
Seat 5: dikanmax ($55.70 in chips) 
Seat 6: PleBeY95 ($59.47 in chips) 
Seat 7: Pachebrash ($50 in chips) 
Seat 8: 190K ($50 in chips) 
Seat 9: Nestle170 ($50 in chips) 
Pachebrash: posts small blind $0.25
190K: posts big blind $0.50
*** HOLE CARDS ***
Nestle170: folds 
DOA1980: folds 
se13giuum: folds 
akiobenj: folds 
dikanmax: raises $1 to $1.50
PleBeY95: folds 
Pachebrash: folds 
DOA1980 leaves the table
190K: folds 
Uncalled bet ($1) returned to dikanmax
dikanmax collected $1.25 from pot
dikanmax: doesn't show hand 
*** SUMMARY ***
Total pot $1.25 | Rake $0 
Seat 1: DOA1980 folded before Flop (didn't bet)
Seat 3: se13giuum folded before Flop (didn't bet)
Seat 4: akiobenj folded before Flop (didn't bet)
Seat 5: dikanmax collected ($1.25)
Seat 6: PleBeY95 (button) folded before Flop (didn't bet)
Seat 7: Pachebrash (small blind) folded before Flop
Seat 8: 190K (big blind) folded before Flop
Seat 9: Nestle170 folded before Flop (didn't bet)



PokerStars Hand #228684906709:  Hold'em No Limit ($0.25/$0.50 USD) - 2021/07/30 14:14:01 ET
Table 'Galilea III' 9-max Seat #7 is the button
Seat 3: se13giuum ($44.90 in chips) 
Seat 4: akiobenj ($52.81 in chips) 
Seat 5: dikanmax ($56.45 in chips) 
Seat 6: PleBeY95 ($59.47 in chips) 
Seat 7: Pachebrash ($50 in chips) 
Seat 8: 190K ($50 in chips) 
Seat 9: Nestle170 ($50 in chips) 
190K: posts small blind $0.25
Nestle170: posts big blind $0.50
*** HOLE CARDS ***
StudentRB joins the table at seat #1 
se13giuum: raises $1 to $1.50
akiobenj: folds 
dikanmax: folds 
PleBeY95: folds 
Pachebrash: folds 
190K: calls $1.25
Nestle170: folds 
*** FLOP *** [3s 8s Ad]
190K: checks 
se13giuum: bets $1.66
190K: folds 
Uncalled bet ($1.66) returned to se13giuum
se13giuum collected $3.32 from pot
se13giuum: doesn't show hand 
*** SUMMARY ***
Total pot $3.50 | Rake $0.18 
Board [3s 8s Ad]
Seat 3: se13giuum collected ($3.32)
Seat 4: akiobenj folded before Flop (didn't bet)
Seat 5: dikanmax folded before Flop (didn't bet)
Seat 6: PleBeY95 folded before Flop (didn't bet)
Seat 7: Pachebrash (button) folded before Flop (didn't bet)
Seat 8: 190K (small blind) folded on the Flop
Seat 9: Nestle170 (big blind) folded before Flop



PokerStars Hand #228684919469:  Hold'em No Limit ($0.25/$0.50 USD) - 2021/07/30 14:14:31 ET
Table 'Galilea III' 9-max Seat #8 is the button
Seat 1: StudentRB ($50 in chips) 
Seat 3: se13giuum ($46.72 in chips) 
Seat 4: akiobenj ($52.81 in chips) 
Seat 5: dikanmax ($56.45 in chips) 
Seat 6: PleBeY95 ($59.47 in chips) 
Seat 7: Pachebrash ($50 in chips) 
Seat 8: 190K ($50 in chips) 
Seat 9: Nestle170 ($50 in chips) 
Nestle170: posts small blind $0.25
StudentRB: posts big blind $0.50
*** HOLE CARDS ***
se13giuum: folds 
akiobenj: folds 
dikanmax: folds 
PleBeY95: folds 
Pachebrash: folds 
190K: raises $0.75 to $1.25
Nestle170: folds 
StudentRB: folds 
Uncalled bet ($0.75) returned to 190K
190K collected $1.25 from pot
190K: doesn't show hand 
*** SUMMARY ***
Total pot $1.25 | Rake $0 
Seat 1: StudentRB (big blind) folded before Flop
Seat 3: se13giuum folded before Flop (didn't bet)
Seat 4: akiobenj folded before Flop (didn't bet)
Seat 5: dikanmax folded before Flop (didn't bet)
Seat 6: PleBeY95 folded before Flop (didn't bet)
Seat 7: Pachebrash folded before Flop (didn't bet)
Seat 8: 190K (button) collected ($1.25)
Seat 9: Nestle170 (small blind) folded before Flop



PokerStars Hand #228684926168:  Hold'em No Limit ($0.25/$0.50 USD) - 2021/07/30 14:14:47 ET
Table 'Galilea III' 9-max Seat #9 is the button
Seat 1: StudentRB ($50 in chips) 
Seat 3: se13giuum ($46.72 in chips) 
Seat 4: akiobenj ($52.81 in chips) 
Seat 5: dikanmax ($56.45 in chips) 
Seat 6: PleBeY95 ($59.47 in chips) 
Seat 7: Pachebrash ($50 in chips) 
Seat 8: 190K ($50.75 in chips) 
Seat 9: Nestle170 ($50 in chips) 
StudentRB: posts small blind $0.25
se13giuum: posts big blind $0.50
*** HOLE CARDS ***
akiobenj: calls $0.50
dikanmax: folds 
PleBeY95: raises $1.50 to $2
Pachebrash: folds 
190K: folds 
Nestle170: folds 
StudentRB: folds 
se13giuum: folds 
akiobenj: calls $1.50
*** FLOP *** [9c Td 9h]
akiobenj: checks 
PleBeY95: bets $1.49
akiobenj: calls $1.49
*** TURN *** [9c Td 9h] [Jc]
akiobenj: checks 
PleBeY95: checks 
*** RIVER *** [9c Td 9h Jc] [2d]
akiobenj: bets $3.67
PleBeY95: raises $9.83 to $13.50
akiobenj: folds 
Uncalled bet ($9.83) returned to PleBeY95
PleBeY95 collected $14.32 from pot
*** SUMMARY ***
Total pot $15.07 | Rake $0.75 
Board [9c Td 9h Jc 2d]
Seat 1: StudentRB (small blind) folded before Flop
Seat 3: se13giuum (big blind) folded before Flop
Seat 4: akiobenj folded on the River
Seat 5: dikanmax folded before Flop (didn't bet)
Seat 6: PleBeY95 collected ($14.32)
Seat 7: Pachebrash folded before Flop (didn't bet)
Seat 8: 190K folded before Flop (didn't bet)
Seat 9: Nestle170 (button) folded before Flop (didn't bet)



PokerStars Hand #228684951216:  Hold'em No Limit ($0.25/$0.50 USD) - 2021/07/30 14:15:45 ET
Table 'Galilea III' 9-max Seat #1 is the button
Seat 1: StudentRB ($50 in chips) 
Seat 3: se13giuum ($46.22 in chips) 
Seat 4: akiobenj ($45.65 in chips) 
Seat 5: dikanmax ($56.45 in chips) 
Seat 6: PleBeY95 ($66.63 in chips) 
Seat 7: Pachebrash ($50 in chips) 
Seat 8: 190K ($50.75 in chips) 
Seat 9: Nestle170 ($50 in chips) 
se13giuum: posts small blind $0.25
akiobenj: posts big blind $0.50
*** HOLE CARDS ***
dikanmax: folds 
PleBeY95: folds 
Pachebrash: folds 
190K: folds 
Nestle170: raises $0.75 to $1.25
StudentRB: folds 
se13giuum: raises $0.75 to $2
akiobenj: folds 
Nestle170: calls $0.75
*** FLOP *** [7c 8s Ts]
se13giuum: checks 
Nestle170: checks 
*** TURN *** [7c 8s Ts] [7h]
se13giuum: bets $2.14
Nestle170: calls $2.14
*** RIVER *** [7c 8s Ts 7h] [5s]
se13giuum has timed out
se13giuum: checks 
Nestle170: checks 
*** SHOW DOWN ***
se13giuum: shows [Qs Kd] (a pair of Sevens)
Nestle170: shows [Ad Jd] (a pair of Sevens - Ace kicker)
Nestle170 collected $8.34 from pot
*** SUMMARY ***
Total pot $8.78 | Rake $0.44 
Board [7c 8s Ts 7h 5s]
Seat 1: StudentRB (button) folded before Flop (didn't bet)
Seat 3: se13giuum (small blind) showed [Qs Kd] and lost with a pair of Sevens
Seat 4: akiobenj (big blind) folded before Flop
Seat 5: dikanmax folded before Flop (didn't bet)
Seat 6: PleBeY95 folded before Flop (didn't bet)
Seat 7: Pachebrash folded before Flop (didn't bet)
Seat 8: 190K folded before Flop (didn't bet)
Seat 9: Nestle170 showed [Ad Jd] and won ($8.34) with a pair of Sevens



PokerStars Hand #228684984842:  Hold'em No Limit ($0.25/$0.50 USD) - 2021/07/30 14:17:05 ET
Table 'Galilea III' 9-max Seat #3 is the button
Seat 1: StudentRB ($50 in chips) 
Seat 3: se13giuum ($42.08 in chips) 
Seat 4: akiobenj ($45.15 in chips) 
Seat 5: dikanmax ($56.45 in chips) 
Seat 6: PleBeY95 ($66.63 in chips) 
Seat 7: Pachebrash ($50 in chips) 
Seat 8: 190K ($50.75 in chips) 
Seat 9: Nestle170 ($54.20 in chips) 
akiobenj: posts small blind $0.25
dikanmax: posts big blind $0.50
*** HOLE CARDS ***
PleBeY95: folds 
Pachebrash: folds 
190K: raises $1 to $1.50
Nestle170: folds 
StudentRB: folds 
se13giuum: folds 
akiobenj: calls $1.25
dikanmax: folds 
*** FLOP *** [4s 4d 9s]
akiobenj: bets $3.32
190K: folds 
Uncalled bet ($3.32) returned to akiobenj
akiobenj collected $3.32 from pot
akiobenj: doesn't show hand 
*** SUMMARY ***
Total pot $3.50 | Rake $0.18 
Board [4s 4d 9s]
Seat 1: StudentRB folded before Flop (didn't bet)
Seat 3: se13giuum (button) folded before Flop (didn't bet)
Seat 4: akiobenj (small blind) collected ($3.32)
Seat 5: dikanmax (big blind) folded before Flop
Seat 6: PleBeY95 folded before Flop (didn't bet)
Seat 7: Pachebrash folded before Flop (didn't bet)
Seat 8: 190K folded on the Flop
Seat 9: Nestle170 folded before Flop (didn't bet)



PokerStars Hand #228684997977:  Hold'em No Limit ($0.25/$0.50 USD) - 2021/07/30 14:17:36 ET
Table 'Galilea III' 9-max Seat #4 is the button
Seat 1: StudentRB ($50 in chips) 
Seat 3: se13giuum ($42.08 in chips) 
Seat 4: akiobenj ($46.97 in chips) 
Seat 5: dikanmax ($55.95 in chips) 
Seat 6: PleBeY95 ($66.63 in chips) 
Seat 7: Pachebrash ($50 in chips) 
Seat 8: 190K ($50 in chips) 
Seat 9: Nestle170 ($54.20 in chips) 
dikanmax: posts small blind $0.25
PleBeY95: posts big blind $0.50
*** HOLE CARDS ***
Pachebrash: raises $1 to $1.50
190K: folds 
Nestle170: folds 
StudentRB: folds 
se13giuum: folds 
akiobenj: calls $1.50
dikanmax: calls $1.25
PleBeY95: folds 
*** FLOP *** [4c Ad Ah]
dikanmax: checks 
Pachebrash: bets $1.75
akiobenj: calls $1.75
dikanmax: calls $1.75
*** TURN *** [4c Ad Ah] [7d]
dikanmax: checks 
Pachebrash: bets $6.43
akiobenj: calls $6.43
dikanmax: folds 
*** RIVER *** [4c Ad Ah 7d] [Ts]
Pachebrash: bets $12.25
akiobenj: folds 
Uncalled bet ($12.25) returned to Pachebrash
Pachebrash collected $21.95 from pot
Pachebrash: doesn't show hand 
*** SUMMARY ***
Total pot $23.11 | Rake $1.16 
Board [4c Ad Ah 7d Ts]
Seat 1: StudentRB folded before Flop (didn't bet)
Seat 3: se13giuum folded before Flop (didn't bet)
Seat 4: akiobenj (button) folded on the River
Seat 5: dikanmax (small blind) folded on the Turn
Seat 6: PleBeY95 (big blind) folded before Flop
Seat 7: Pachebrash collected ($21.95)
Seat 8: 190K folded before Flop (didn't bet)
Seat 9: Nestle170 folded before Flop (didn't bet)



PokerStars Hand #228685025566:  Hold'em No Limit ($0.25/$0.50 USD) - 2021/07/30 14:18:41 ET
Table 'Galilea III' 9-max Seat #5 is the button
Seat 1: StudentRB ($50 in chips) 
Seat 3: se13giuum ($42.08 in chips) 
Seat 4: akiobenj ($37.29 in chips) 
Seat 5: dikanmax ($52.70 in chips) 
Seat 6: PleBeY95 ($66.13 in chips) 
Seat 7: Pachebrash ($62.27 in chips) 
Seat 8: 190K ($50 in chips) 
Seat 9: Nestle170 ($54.20 in chips) 
PleBeY95: posts small blind $0.25
Pachebrash: posts big blind $0.50
*** HOLE CARDS ***
190K: folds 
190K leaves the table
Nestle170: folds 
StudentRB: folds 
se13giuum: raises $1 to $1.50
akiobenj: folds 
dikanmax: folds 
PleBeY95: folds 
Pachebrash: folds 
Uncalled bet ($1) returned to se13giuum
se13giuum collected $1.25 from pot
se13giuum: doesn't show hand 
*** SUMMARY ***
Total pot $1.25 | Rake $0 
Seat 1: StudentRB folded before Flop (didn't bet)
Seat 3: se13giuum collected ($1.25)
Seat 4: akiobenj folded before Flop (didn't bet)
Seat 5: dikanmax (button) folded before Flop (didn't bet)
Seat 6: PleBeY95 (small blind) folded before Flop
Seat 7: Pachebrash (big blind) folded before Flop
Seat 8: 190K folded before Flop (didn't bet)
Seat 9: Nestle170 folded before Flop (didn't bet)



PokerStars Hand #228685031117:  Hold'em No Limit ($0.25/$0.50 USD) - 2021/07/30 14:18:54 ET
Table 'Galilea III' 9-max Seat #6 is the button
Seat 1: StudentRB ($50 in chips) 
Seat 3: se13giuum ($42.83 in chips) 
Seat 4: akiobenj ($37.29 in chips) 
Seat 5: dikanmax ($52.70 in chips) 
Seat 6: PleBeY95 ($65.88 in chips) 
Seat 7: Pachebrash ($61.77 in chips) 
Seat 9: Nestle170 ($54.20 in chips) 
Pachebrash: posts small blind $0.25
Nestle170: posts big blind $0.50
*** HOLE CARDS ***
StudentRB: folds 
se13giuum: folds 
akiobenj: calls $0.50
tomekpe joins the table at seat #8 
dikanmax: calls $0.50
PleBeY95: folds 
Pachebrash: folds 
Nestle170: checks 
*** FLOP *** [4d Ad 9h]
Nestle170: checks 
akiobenj: checks 
dikanmax: checks 
*** TURN *** [4d Ad 9h] [9d]
Nestle170: checks 
akiobenj: bets $1.66
dikanmax: folds 
Nestle170: folds 
Uncalled bet ($1.66) returned to akiobenj
akiobenj collected $1.66 from pot
akiobenj: doesn't show hand 
*** SUMMARY ***
Total pot $1.75 | Rake $0.09 
Board [4d Ad 9h 9d]
Seat 1: StudentRB folded before Flop (didn't bet)
Seat 3: se13giuum folded before Flop (didn't bet)
Seat 4: akiobenj collected ($1.66)
Seat 5: dikanmax folded on the Turn
Seat 6: PleBeY95 (button) folded before Flop (didn't bet)
Seat 7: Pachebrash (small blind) folded before Flop
Seat 9: Nestle170 (big blind) folded on the Turn



PokerStars Hand #228685054948:  Hold'em No Limit ($0.25/$0.50 USD) - 2021/07/30 14:19:50 ET
Table 'Galilea III' 9-max Seat #7 is the button
Seat 1: StudentRB ($50 in chips) 
Seat 3: se13giuum ($42.83 in chips) 
Seat 4: akiobenj ($38.45 in chips) 
Seat 5: dikanmax ($52.20 in chips) 
Seat 6: PleBeY95 ($65.88 in chips) 
Seat 7: Pachebrash ($61.52 in chips) 
Seat 9: Nestle170 ($53.70 in chips) 
Nestle170: posts small blind $0.25
StudentRB: posts big blind $0.50
*** HOLE CARDS ***
se13giuum has timed out
se13giuum: folds 
akiobenj: calls $0.50
dikanmax: folds 
PleBeY95: raises $1.50 to $2
Pachebrash: folds 
Nestle170: folds 
StudentRB: folds 
akiobenj: calls $1.50
*** FLOP *** [9h 2h 6d]
akiobenj: checks 
PleBeY95: bets $1.49
akiobenj: calls $1.49
*** TURN *** [9h 2h 6d] [7s]
akiobenj: bets $3.67
PleBeY95: folds 
Uncalled bet ($3.67) returned to akiobenj
akiobenj collected $7.34 from pot
akiobenj: doesn't show hand 
*** SUMMARY ***
Total pot $7.73 | Rake $0.39 
Board [9h 2h 6d 7s]
Seat 1: StudentRB (big blind) folded before Flop
Seat 3: se13giuum folded before Flop (didn't bet)
Seat 4: akiobenj collected ($7.34)
Seat 5: dikanmax folded before Flop (didn't bet)
Seat 6: PleBeY95 folded on the Turn
Seat 7: Pachebrash (button) folded before Flop (didn't bet)
Seat 9: Nestle170 (small blind) folded before Flop



PokerStars Hand #228685077196:  Hold'em No Limit ($0.25/$0.50 USD) - 2021/07/30 14:20:43 ET
Table 'Galilea III' 9-max Seat #9 is the button
Seat 1: StudentRB ($50 in chips) 
Seat 3: se13giuum ($42.83 in chips) 
Seat 4: akiobenj ($42.30 in chips) 
Seat 5: dikanmax ($52.20 in chips) 
Seat 6: PleBeY95 ($62.39 in chips) 
Seat 7: Pachebrash ($61.52 in chips) 
Seat 9: Nestle170 ($53.45 in chips) 
StudentRB: posts small blind $0.25
se13giuum: posts big blind $0.50
tomekpe: sits out 
*** HOLE CARDS ***
akiobenj: folds 
dikanmax: folds 
PleBeY95: folds 
Pachebrash: folds 
Nestle170: raises $0.60 to $1.10
StudentRB: folds 
se13giuum: folds 
Uncalled bet ($0.60) returned to Nestle170
Nestle170 collected $1.25 from pot
Nestle170: doesn't show hand 
*** SUMMARY ***
Total pot $1.25 | Rake $0 
Seat 1: StudentRB (small blind) folded before Flop
Seat 3: se13giuum (big blind) folded before Flop
Seat 4: akiobenj folded before Flop (didn't bet)
Seat 5: dikanmax folded before Flop (didn't bet)
Seat 6: PleBeY95 folded before Flop (didn't bet)
Seat 7: Pachebrash folded before Flop (didn't bet)
Seat 9: Nestle170 (button) collected ($1.25)



PokerStars Hand #228685087764:  Hold'em No Limit ($0.25/$0.50 USD) - 2021/07/30 14:21:08 ET
Table 'Galilea III' 9-max Seat #1 is the button
Seat 1: StudentRB ($50 in chips) 
Seat 3: se13giuum ($42.33 in chips) 
Seat 4: akiobenj ($42.30 in chips) 
Seat 5: dikanmax ($52.20 in chips) 
Seat 6: PleBeY95 ($62.39 in chips) 
Seat 7: Pachebrash ($61.52 in chips) 
Seat 9: Nestle170 ($54.20 in chips) 
se13giuum: posts small blind $0.25
akiobenj: posts big blind $0.50
tomekpe: sits out 
*** HOLE CARDS ***
dikanmax: raises $1 to $1.50
PleBeY95: folds 
Pachebrash: folds 
Nestle170: folds 
StudentRB: folds 
se13giuum: folds 
akiobenj: calls $1
*** FLOP *** [7s 8s Qc]
akiobenj: checks 
dikanmax: bets $2.25
akiobenj: calls $2.25
*** TURN *** [7s 8s Qc] [5c]
akiobenj: checks 
dikanmax: bets $7.36
akiobenj: folds 
Uncalled bet ($7.36) returned to dikanmax
dikanmax collected $7.36 from pot
dikanmax: doesn't show hand 
*** SUMMARY ***
Total pot $7.75 | Rake $0.39 
Board [7s 8s Qc 5c]
Seat 1: StudentRB (button) folded before Flop (didn't bet)
Seat 3: se13giuum (small blind) folded before Flop
Seat 4: akiobenj (big blind) folded on the Turn
Seat 5: dikanmax collected ($7.36)
Seat 6: PleBeY95 folded before Flop (didn't bet)
Seat 7: Pachebrash folded before Flop (didn't bet)
Seat 9: Nestle170 folded before Flop (didn't bet)



PokerStars Hand #228685104811:  Hold'em No Limit ($0.25/$0.50 USD) - 2021/07/30 14:21:48 ET
Table 'Galilea III' 9-max Seat #3 is the button
Seat 1: StudentRB ($50 in chips) 
Seat 2: dstrola ($50 in chips) 
Seat 3: se13giuum ($42.08 in chips) 
Seat 4: akiobenj ($38.55 in chips) 
Seat 5: dikanmax ($55.81 in chips) 
Seat 6: PleBeY95 ($62.39 in chips) 
Seat 7: Pachebrash ($61.52 in chips) 
Seat 9: Nestle170 ($54.20 in chips) 
akiobenj: posts small blind $0.25
dikanmax: posts big blind $0.50
tomekpe: sits out 
dstrola: posts small & big blinds $0.75
*** HOLE CARDS ***
PleBeY95: folds 
Pachebrash: folds 
Nestle170: folds 
StudentRB: folds 
dstrola: raises $1 to $1.50
se13giuum has timed out
se13giuum: folds 
akiobenj: calls $1.25
dikanmax: folds 
*** FLOP *** [Th Kh Js]
akiobenj: bets $1.78
dstrola: folds 
Uncalled bet ($1.78) returned to akiobenj
akiobenj collected $3.56 from pot
akiobenj: doesn't show hand 
*** SUMMARY ***
Total pot $3.75 | Rake $0.19 
Board [Th Kh Js]
Seat 1: StudentRB folded before Flop (didn't bet)
Seat 2: dstrola folded on the Flop
Seat 3: se13giuum (button) folded before Flop (didn't bet)
Seat 4: akiobenj (small blind) collected ($3.56)
Seat 5: dikanmax (big blind) folded before Flop
Seat 6: PleBeY95 folded before Flop (didn't bet)
Seat 7: Pachebrash folded before Flop (didn't bet)
Seat 9: Nestle170 folded before Flop (didn't bet)



PokerStars Hand #228685122526:  Hold'em No Limit ($0.25/$0.50 USD) - 2021/07/30 14:22:30 ET
Table 'Galilea III' 9-max Seat #4 is the button
Seat 1: StudentRB ($50 in chips) 
Seat 2: dstrola ($50 in chips) 
Seat 3: se13giuum ($42.08 in chips) 
Seat 4: akiobenj ($40.61 in chips) 
Seat 5: dikanmax ($55.31 in chips) 
Seat 6: PleBeY95 ($62.39 in chips) 
Seat 7: Pachebrash ($61.52 in chips) 
Seat 9: Nestle170 ($54.20 in chips) 
dikanmax: posts small blind $0.25
PleBeY95: posts big blind $0.50
tomekpe: sits out 
*** HOLE CARDS ***
Pachebrash: folds 
Nestle170: folds 
StudentRB: raises $0.75 to $1.25
dstrola: folds 
se13giuum: folds 
akiobenj: calls $1.25
dikanmax: folds 
PleBeY95: folds 
*** FLOP *** [Kc Qd 8c]
StudentRB: bets $2
akiobenj: calls $2
*** TURN *** [Kc Qd 8c] [2h]
StudentRB: checks 
akiobenj: bets $3.44
StudentRB: raises $8.56 to $12
akiobenj: calls $8.56
*** RIVER *** [Kc Qd 8c 2h] [2c]
StudentRB: checks 
akiobenj: bets $25.36 and is all-in
StudentRB: calls $25.36
*** SHOW DOWN ***
akiobenj: shows [Th Ac] (a pair of Deuces)
StudentRB: shows [Qc Kd] (two pair, Kings and Queens)
StudentRB collected $79.97 from pot
*** SUMMARY ***
Total pot $81.97 | Rake $2 
Board [Kc Qd 8c 2h 2c]
Seat 1: StudentRB showed [Qc Kd] and won ($79.97) with two pair, Kings and Queens
Seat 2: dstrola folded before Flop (didn't bet)
Seat 3: se13giuum folded before Flop (didn't bet)
Seat 4: akiobenj (button) showed [Th Ac] and lost with a pair of Deuces
Seat 5: dikanmax (small blind) folded before Flop
Seat 6: PleBeY95 (big blind) folded before Flop
Seat 7: Pachebrash folded before Flop (didn't bet)
Seat 9: Nestle170 folded before Flop (didn't bet)



PokerStars Hand #228685157463:  Hold'em No Limit ($0.25/$0.50 USD) - 2021/07/30 14:23:53 ET
Table 'Galilea III' 9-max Seat #5 is the button
Seat 1: StudentRB ($89.36 in chips) 
Seat 2: dstrola ($50 in chips) 
Seat 3: se13giuum ($42.08 in chips) 
Seat 5: dikanmax ($55.06 in chips) 
Seat 6: PleBeY95 ($61.89 in chips) 
Seat 7: Pachebrash ($61.52 in chips) 
Seat 9: Nestle170 ($54.20 in chips) 
PleBeY95: posts small blind $0.25
Pachebrash: posts big blind $0.50
tomekpe: sits out 
*** HOLE CARDS ***
Nestle170: folds 
akiobenj leaves the table
StudentRB: folds 
dstrola: raises $1 to $1.50
se13giuum: folds 
saschaWITT joins the table at seat #4 
dikanmax: raises $3 to $4.50
PleBeY95: folds 
Pachebrash: folds 
dstrola: calls $3
*** FLOP *** [Ad 2d Th]
dstrola: checks 
dikanmax: bets $2.78
dstrola: calls $2.78
*** TURN *** [Ad 2d Th] [3h]
dstrola: checks 
dikanmax: bets $9.75
dstrola: folds 
Uncalled bet ($9.75) returned to dikanmax
dikanmax collected $14.54 from pot
dikanmax: doesn't show hand 
*** SUMMARY ***
Total pot $15.31 | Rake $0.77 
Board [Ad 2d Th 3h]
Seat 1: StudentRB folded before Flop (didn't bet)
Seat 2: dstrola folded on the Turn
Seat 3: se13giuum folded before Flop (didn't bet)
Seat 5: dikanmax (button) collected ($14.54)
Seat 6: PleBeY95 (small blind) folded before Flop
Seat 7: Pachebrash (big blind) folded before Flop
Seat 9: Nestle170 folded before Flop (didn't bet)



PokerStars Hand #228685178237:  Hold'em No Limit ($0.25/$0.50 USD) - 2021/07/30 14:24:43 ET
Table 'Galilea III' 9-max Seat #6 is the button
Seat 1: StudentRB ($89.36 in chips) 
Seat 2: dstrola ($50 in chips) 
Seat 3: se13giuum ($42.08 in chips) 
Seat 4: saschaWITT ($22.87 in chips) 
Seat 5: dikanmax ($62.32 in chips) 
Seat 6: PleBeY95 ($61.64 in chips) 
Seat 7: Pachebrash ($61.02 in chips) 
Seat 8: tomekpe ($50 in chips) 
Seat 9: Nestle170 ($54.20 in chips) 
Pachebrash: posts small blind $0.25
tomekpe: posts big blind $0.50
saschaWITT: posts big blind $0.50
*** HOLE CARDS ***
Nestle170: folds 
StudentRB: raises $1.50 to $2
dstrola: folds 
se13giuum: folds 
saschaWITT: folds 
dikanmax: folds 
PleBeY95: folds 
Pachebrash: folds 
tomekpe: folds 
Uncalled bet ($1.50) returned to StudentRB
StudentRB collected $1.75 from pot
StudentRB: doesn't show hand 
*** SUMMARY ***
Total pot $1.75 | Rake $0 
Seat 1: StudentRB collected ($1.75)
Seat 2: dstrola folded before Flop (didn't bet)
Seat 3: se13giuum folded before Flop (didn't bet)
Seat 4: saschaWITT folded before Flop (didn't bet)
Seat 5: dikanmax folded before Flop (didn't bet)
Seat 6: PleBeY95 (button) folded before Flop (didn't bet)
Seat 7: Pachebrash (small blind) folded before Flop
Seat 8: tomekpe (big blind) folded before Flop
Seat 9: Nestle170 folded before Flop (didn't bet)



PokerStars Hand #228685194001:  Hold'em No Limit ($0.25/$0.50 USD) - 2021/07/30 14:25:20 ET
Table 'Galilea III' 9-max Seat #7 is the button
Seat 1: StudentRB ($90.61 in chips) 
Seat 2: dstrola ($50 in chips) 
Seat 3: se13giuum ($42.08 in chips) 
Seat 4: saschaWITT ($22.37 in chips) 
Seat 5: dikanmax ($62.32 in chips) 
Seat 6: PleBeY95 ($61.64 in chips) 
Seat 7: Pachebrash ($60.77 in chips) 
Seat 8: tomekpe ($50 in chips) 
Seat 9: Nestle170 ($54.20 in chips) 
tomekpe: posts small blind $0.25
Nestle170: posts big blind $0.50
*** HOLE CARDS ***
StudentRB: folds 
dstrola: folds 
se13giuum: raises $1 to $1.50
saschaWITT: folds 
dikanmax: folds 
PleBeY95: folds 
Pachebrash: folds 
tomekpe: folds 
Nestle170: folds 
Uncalled bet ($1) returned to se13giuum
se13giuum collected $1.25 from pot
se13giuum: doesn't show hand 
*** SUMMARY ***
Total pot $1.25 | Rake $0 
Seat 1: StudentRB folded before Flop (didn't bet)
Seat 2: dstrola folded before Flop (didn't bet)
Seat 3: se13giuum collected ($1.25)
Seat 4: saschaWITT folded before Flop (didn't bet)
Seat 5: dikanmax folded before Flop (didn't bet)
Seat 6: PleBeY95 folded before Flop (didn't bet)
Seat 7: Pachebrash (button) folded before Flop (didn't bet)
Seat 8: tomekpe (small blind) folded before Flop
Seat 9: Nestle170 (big blind) folded before Flop



PokerStars Hand #228685203014:  Hold'em No Limit ($0.25/$0.50 USD) - 2021/07/30 14:25:41 ET
Table 'Galilea III' 9-max Seat #8 is the button
Seat 2: dstrola ($50 in chips) 
Seat 3: se13giuum ($42.83 in chips) 
Seat 4: saschaWITT ($22.37 in chips) 
Seat 5: dikanmax ($62.32 in chips) 
Seat 6: PleBeY95 ($61.64 in chips) 
Seat 7: Pachebrash ($60.77 in chips) 
Seat 8: tomekpe ($50 in chips) 
Seat 9: Nestle170 ($53.70 in chips) 
Nestle170: posts small blind $0.25
StudentRB: is sitting out 
dstrola: posts big blind $0.50
*** HOLE CARDS ***
StudentRB leaves the table
se13giuum: calls $0.50
saschaWITT: folds 
dikanmax: folds 
PleBeY95: folds 
Pachebrash: folds 
tomekpe: raises $1.57 to $2.07
Nestle170: folds 
dstrola: calls $1.57
Dihabet joins the table at seat #1 
se13giuum: calls $1.57
*** FLOP *** [Js 3c Qd]
dstrola: checks 
se13giuum: checks 
tomekpe: checks 
*** TURN *** [Js 3c Qd] [3h]
dstrola: bets $1.84
se13giuum has timed out
se13giuum: folds 
tomekpe: folds 
Uncalled bet ($1.84) returned to dstrola
dstrola collected $6.14 from pot
*** SUMMARY ***
Total pot $6.46 | Rake $0.32 
Board [Js 3c Qd 3h]
Seat 2: dstrola (big blind) collected ($6.14)
Seat 3: se13giuum folded on the Turn
Seat 4: saschaWITT folded before Flop (didn't bet)
Seat 5: dikanmax folded before Flop (didn't bet)
Seat 6: PleBeY95 folded before Flop (didn't bet)
Seat 7: Pachebrash folded before Flop (didn't bet)
Seat 8: tomekpe (button) folded on the Turn
Seat 9: Nestle170 (small blind) folded before Flop



PokerStars Hand #228685245415:  Hold'em No Limit ($0.25/$0.50 USD) - 2021/07/30 14:27:22 ET
Table 'Galilea III' 9-max Seat #9 is the button
Seat 2: dstrola ($54.07 in chips) 
Seat 4: saschaWITT ($22.37 in chips) 
Seat 5: dikanmax ($62.32 in chips) 
Seat 6: PleBeY95 ($61.64 in chips) 
Seat 7: Pachebrash ($60.77 in chips) 
Seat 8: tomekpe ($50 in chips) 
Seat 9: Nestle170 ($53.45 in chips) 
dstrola: posts small blind $0.25
saschaWITT: posts big blind $0.50
*** HOLE CARDS ***
dikanmax: folds 
PleBeY95: folds 
Pachebrash: folds 
tomekpe: folds 
Nestle170: folds 
dstrola: folds 
Uncalled bet ($0.25) returned to saschaWITT
saschaWITT collected $0.50 from pot
saschaWITT: doesn't show hand 
*** SUMMARY ***
Total pot $0.50 | Rake $0 
Seat 2: dstrola (small blind) folded before Flop
Seat 4: saschaWITT (big blind) collected ($0.50)
Seat 5: dikanmax folded before Flop (didn't bet)
Seat 6: PleBeY95 folded before Flop (didn't bet)
Seat 7: Pachebrash folded before Flop (didn't bet)
Seat 8: tomekpe folded before Flop (didn't bet)
Seat 9: Nestle170 (button) folded before Flop (didn't bet)



PokerStars Hand #228685256772:  Hold'em No Limit ($0.25/$0.50 USD) - 2021/07/30 14:27:40 ET
Table 'Galilea III' 9-max Seat #2 is the button
Seat 2: dstrola ($53.82 in chips) 
Seat 4: saschaWITT ($22.62 in chips) 
Seat 6: PleBeY95 ($61.64 in chips) 
Seat 7: Pachebrash ($60.77 in chips) 
Seat 8: tomekpe ($50 in chips) 
Seat 9: Nestle170 ($53.45 in chips) 
saschaWITT: posts small blind $0.25
dikanmax: is sitting out 
PleBeY95: posts big blind $0.50
Dihabet: sits out 
*** HOLE CARDS ***
Pachebrash: folds 
tomekpe: raises $0.69 to $1.19
Nestle170: folds 
dstrola: folds 
saschaWITT: calls $0.94
PleBeY95: folds 
*** FLOP *** [Kh Ts 4d]
saschaWITT: checks 
tomekpe: bets $1.51
saschaWITT: calls $1.51
*** TURN *** [Kh Ts 4d] [7h]
saschaWITT: checks 
tomekpe: bets $3.98
saschaWITT: folds 
Uncalled bet ($3.98) returned to tomekpe
tomekpe collected $5.60 from pot
tomekpe: doesn't show hand 
*** SUMMARY ***
Total pot $5.90 | Rake $0.30 
Board [Kh Ts 4d 7h]
Seat 2: dstrola (button) folded before Flop (didn't bet)
Seat 4: saschaWITT (small blind) folded on the Turn
Seat 6: PleBeY95 (big blind) folded before Flop
Seat 7: Pachebrash folded before Flop (didn't bet)
Seat 8: tomekpe collected ($5.60)
Seat 9: Nestle170 folded before Flop (didn't bet)



PokerStars Hand #228685267790:  Hold'em No Limit ($0.25/$0.50 USD) - 2021/07/30 14:28:05 ET
Table 'Galilea III' 9-max Seat #4 is the button
Seat 2: dstrola ($53.82 in chips) 
Seat 3: se13giuum ($40.76 in chips) 
Seat 4: saschaWITT ($19.92 in chips) 
Seat 6: PleBeY95 ($61.14 in chips) 
Seat 9: Nestle170 ($53.45 in chips) 
PleBeY95: posts small blind $0.25
Pachebrash: is sitting out 
tomekpe: is sitting out 
Nestle170: posts big blind $0.50
Dihabet: sits out 
tomekpe leaves the table
se13giuum: posts small & big blinds $0.75
*** HOLE CARDS ***
dstrola: folds 
se13giuum: raises $1 to $1.50
saschaWITT: folds 
MarsMiland joins the table at seat #8 
PleBeY95: folds 
Nestle170: folds 
Uncalled bet ($1) returned to se13giuum
se13giuum collected $1.50 from pot
se13giuum: doesn't show hand 
*** SUMMARY ***
Total pot $1.50 | Rake $0 
Seat 2: dstrola folded before Flop (didn't bet)
Seat 3: se13giuum collected ($1.50)
Seat 4: saschaWITT (button) folded before Flop (didn't bet)
Seat 6: PleBeY95 (small blind) folded before Flop
Seat 9: Nestle170 (big blind) folded before Flop



PokerStars Hand #228685463336:  Hold'em No Limit ($0.25/$0.50 USD) - 2021/07/30 14:35:46 ET
Table 'Galilea III' 9-max Seat #2 is the button
Seat 1: Dihabet ($50 in chips) 
Seat 2: Zargmen ($23.02 in chips) 
Seat 4: saschaWITT ($6.85 in chips) 
Seat 5: dikanmax ($62.32 in chips) 
Seat 6: Nestle170 ($59.35 in chips) 
Seat 7: Xamil666 ($50 in chips) 
Seat 8: MarsMiland ($52 in chips) 
Seat 9: Mmago24 ($53.14 in chips) 
se13giuum has timed out
se13giuum: is sitting out 
saschaWITT: posts small blind $0.25
dikanmax: posts big blind $0.50
*** HOLE CARDS ***
Nestle170: folds 
Xamil666: folds 
MarsMiland: raises $0.80 to $1.30
se13giuum is disconnected 
Mmago24: folds 
Dihabet: calls $1.30
Zargmen: folds 
saschaWITT: folds 
dikanmax: folds 
*** FLOP *** [4h 8h 8d]
MarsMiland: checks 
Dihabet: checks 
*** TURN *** [4h 8h 8d] [Ts]
MarsMiland: bets $2
Dihabet: calls $2
*** RIVER *** [4h 8h 8d Ts] [8s]
MarsMiland: bets $2.30
Dihabet: raises $5.70 to $8
MarsMiland: calls $5.70
*** SHOW DOWN ***
Dihabet: shows [Kh Qd] (three of a kind, Eights)
MarsMiland: shows [Jh Js] (a full house, Eights full of Jacks)
MarsMiland collected $22.18 from pot
*** SUMMARY ***
Total pot $23.35 | Rake $1.17 
Board [4h 8h 8d Ts 8s]
Seat 1: Dihabet showed [Kh Qd] and lost with three of a kind, Eights
Seat 2: Zargmen (button) folded before Flop (didn't bet)
Seat 4: saschaWITT (small blind) folded before Flop
Seat 5: dikanmax (big blind) folded before Flop
Seat 6: Nestle170 folded before Flop (didn't bet)
Seat 7: Xamil666 folded before Flop (didn't bet)
Seat 8: MarsMiland showed [Jh Js] and won ($22.18) with a full house, Eights full of Jacks
Seat 9: Mmago24 folded before Flop (didn't bet)



PokerStars Hand #228685533649:  Hold'em No Limit ($0.25/$0.50 USD) - 2021/07/30 14:38:32 ET
Table 'Galilea III' 9-max Seat #6 is the button
Seat 1: Dihabet ($51.45 in chips) 
Seat 2: Zargmen ($23.02 in chips) 
Seat 4: saschaWITT ($6.60 in chips) 
Seat 5: dikanmax ($61.57 in chips) 
Seat 6: Nestle170 ($65.94 in chips) 
Seat 7: Xamil666 ($50 in chips) 
Seat 8: MarsMiland ($62.88 in chips) 
Seat 9: Mmago24 ($50 in chips) 
Xamil666: posts small blind $0.25
MarsMiland: posts big blind $0.50
*** HOLE CARDS ***
Mmago24: folds 
Dihabet: folds 
Zargmen has timed out
Zargmen: folds 
saschaWITT: folds 
dikanmax: folds 
Nestle170: folds 
Xamil666: raises $1 to $1.50
MarsMiland: folds 
Uncalled bet ($1) returned to Xamil666
Xamil666 collected $1 from pot
*** SUMMARY ***
Total pot $1 | Rake $0 
Seat 1: Dihabet folded before Flop (didn't bet)
Seat 2: Zargmen folded before Flop (didn't bet)
Seat 4: saschaWITT folded before Flop (didn't bet)
Seat 5: dikanmax folded before Flop (didn't bet)
Seat 6: Nestle170 (button) folded before Flop (didn't bet)
Seat 7: Xamil666 (small blind) collected ($1)
Seat 8: MarsMiland (big blind) folded before Flop
Seat 9: Mmago24 folded before Flop (didn't bet)



PokerStars Hand #228685546391:  Hold'em No Limit ($0.25/$0.50 USD) - 2021/07/30 14:39:01 ET
Table 'Galilea III' 9-max Seat #7 is the button
Seat 1: Dihabet ($51.45 in chips) 
Seat 2: Zargmen ($23.02 in chips) 
Seat 4: saschaWITT ($6.60 in chips) 
Seat 5: dikanmax ($61.57 in chips) 
Seat 6: Nestle170 ($65.94 in chips) 
Seat 7: Xamil666 ($50.50 in chips) 
Seat 8: MarsMiland ($62.38 in chips) 
Seat 9: Mmago24 ($50 in chips) 
MarsMiland: posts small blind $0.25
Mmago24: posts big blind $0.50
*** HOLE CARDS ***
Dihabet: folds 
Zargmen: folds 
saschaWITT: folds 
dikanmax: folds 
Nestle170: folds 
Xamil666: folds 
MarsMiland: folds 
Uncalled bet ($0.25) returned to Mmago24
Mmago24 collected $0.50 from pot
Mmago24: doesn't show hand 
*** SUMMARY ***
Total pot $0.50 | Rake $0 
Seat 1: Dihabet folded before Flop (didn't bet)
Seat 2: Zargmen folded before Flop (didn't bet)
Seat 4: saschaWITT folded before Flop (didn't bet)
Seat 5: dikanmax folded before Flop (didn't bet)
Seat 6: Nestle170 folded before Flop (didn't bet)
Seat 7: Xamil666 (button) folded before Flop (didn't bet)
Seat 8: MarsMiland (small blind) folded before Flop
Seat 9: Mmago24 (big blind) collected ($0.50)



PokerStars Hand #228685551830:  Hold'em No Limit ($0.25/$0.50 USD) - 2021/07/30 14:39:14 ET
Table 'Galilea III' 9-max Seat #8 is the button
Seat 1: Dihabet ($51.45 in chips) 
Seat 2: Zargmen ($23.02 in chips) 
Seat 4: saschaWITT ($6.60 in chips) 
Seat 5: dikanmax ($61.57 in chips) 
Seat 6: Nestle170 ($65.94 in chips) 
Seat 7: Xamil666 ($50.50 in chips) 
Seat 8: MarsMiland ($62.13 in chips) 
Seat 9: Mmago24 ($50.25 in chips) 
Mmago24: posts small blind $0.25
Dihabet: posts big blind $0.50
*** HOLE CARDS ***
Zargmen: folds 
saschaWITT: folds 
dikanmax: folds 
Nestle170: folds 
Xamil666: folds 
MarsMiland: folds 
Mmago24: folds 
Uncalled bet ($0.25) returned to Dihabet
Dihabet collected $0.50 from pot
Dihabet: doesn't show hand 
*** SUMMARY ***
Total pot $0.50 | Rake $0 
Seat 1: Dihabet (big blind) collected ($0.50)
Seat 2: Zargmen folded before Flop (didn't bet)
Seat 4: saschaWITT folded before Flop (didn't bet)
Seat 5: dikanmax folded before Flop (didn't bet)
Seat 6: Nestle170 folded before Flop (didn't bet)
Seat 7: Xamil666 folded before Flop (didn't bet)
Seat 8: MarsMiland (button) folded before Flop (didn't bet)
Seat 9: Mmago24 (small blind) folded before Flop



PokerStars Hand #228685556133:  Hold'em No Limit ($0.25/$0.50 USD) - 2021/07/30 14:39:24 ET
Table 'Galilea III' 9-max Seat #9 is the button
Seat 1: Dihabet ($51.70 in chips) 
Seat 2: Zargmen ($23.02 in chips) 
Seat 4: saschaWITT ($6.60 in chips) 
Seat 5: dikanmax ($61.57 in chips) 
Seat 6: Nestle170 ($65.94 in chips) 
Seat 7: Xamil666 ($50.50 in chips) 
Seat 8: MarsMiland ($62.13 in chips) 
Seat 9: Mmago24 ($50 in chips) 
Dihabet: posts small blind $0.25
Zargmen: posts big blind $0.50
*** HOLE CARDS ***
saschaWITT: folds 
dikanmax: raises $1 to $1.50
Nestle170: folds 
Xamil666: folds 
MarsMiland: folds 
Mmago24: folds 
Dihabet: folds 
Zargmen: folds 
Uncalled bet ($1) returned to dikanmax
dikanmax collected $1.25 from pot
dikanmax: doesn't show hand 
*** SUMMARY ***
Total pot $1.25 | Rake $0 
Seat 1: Dihabet (small blind) folded before Flop
Seat 2: Zargmen (big blind) folded before Flop
Seat 4: saschaWITT folded before Flop (didn't bet)
Seat 5: dikanmax collected ($1.25)
Seat 6: Nestle170 folded before Flop (didn't bet)
Seat 7: Xamil666 folded before Flop (didn't bet)
Seat 8: MarsMiland folded before Flop (didn't bet)
Seat 9: Mmago24 (button) folded before Flop (didn't bet)



PokerStars Hand #228685562887:  Hold'em No Limit ($0.25/$0.50 USD) - 2021/07/30 14:39:40 ET
Table 'Galilea III' 9-max Seat #1 is the button
Seat 1: Dihabet ($51.45 in chips) 
Seat 2: Zargmen ($22.52 in chips) 
Seat 4: saschaWITT ($6.60 in chips) 
Seat 5: dikanmax ($62.32 in chips) 
Seat 6: Nestle170 ($65.94 in chips) 
Seat 7: Xamil666 ($50.50 in chips) 
Seat 8: MarsMiland ($62.13 in chips) 
Seat 9: Mmago24 ($50 in chips) 
Zargmen: posts small blind $0.25
saschaWITT: posts big blind $0.50
*** HOLE CARDS ***
dikanmax: folds 
Nestle170: folds 
Xamil666: raises $1 to $1.50
MarsMiland: folds 
Mmago24: calls $1.50
Dihabet: folds 
Zargmen: folds 
saschaWITT: calls $1
*** FLOP *** [5d 6h 7c]
saschaWITT: checks 
Xamil666: checks 
Mmago24: bets $2.39
saschaWITT: folds 
Xamil666: folds 
Uncalled bet ($2.39) returned to Mmago24
Mmago24 collected $4.51 from pot
Mmago24: doesn't show hand 
*** SUMMARY ***
Total pot $4.75 | Rake $0.24 
Board [5d 6h 7c]
Seat 1: Dihabet (button) folded before Flop (didn't bet)
Seat 2: Zargmen (small blind) folded before Flop
Seat 4: saschaWITT (big blind) folded on the Flop
Seat 5: dikanmax folded before Flop (didn't bet)
Seat 6: Nestle170 folded before Flop (didn't bet)
Seat 7: Xamil666 folded on the Flop
Seat 8: MarsMiland folded before Flop (didn't bet)
Seat 9: Mmago24 collected ($4.51)



PokerStars Hand #228685579958:  Hold'em No Limit ($0.25/$0.50 USD) - 2021/07/30 14:40:19 ET
Table 'Galilea III' 9-max Seat #2 is the button
Seat 1: Dihabet ($51.45 in chips) 
Seat 2: Zargmen ($22.27 in chips) 
Seat 4: saschaWITT ($5.10 in chips) 
Seat 5: dikanmax ($62.32 in chips) 
Seat 6: Nestle170 ($65.94 in chips) 
Seat 7: Xamil666 ($50 in chips) 
Seat 8: MarsMiland ($62.13 in chips) 
Seat 9: Mmago24 ($53.01 in chips) 
saschaWITT: posts small blind $0.25
dikanmax: posts big blind $0.50
*** HOLE CARDS ***
Nestle170: folds 
Xamil666: folds 
MarsMiland: raises $0.80 to $1.30
Mmago24: folds 
Dihabet: folds 
Zargmen: folds 
saschaWITT: folds 
dikanmax: folds 
Uncalled bet ($0.80) returned to MarsMiland
MarsMiland collected $1.25 from pot
MarsMiland: doesn't show hand 
*** SUMMARY ***
Total pot $1.25 | Rake $0 
Seat 1: Dihabet folded before Flop (didn't bet)
Seat 2: Zargmen (button) folded before Flop (didn't bet)
Seat 4: saschaWITT (small blind) folded before Flop
Seat 5: dikanmax (big blind) folded before Flop
Seat 6: Nestle170 folded before Flop (didn't bet)
Seat 7: Xamil666 folded before Flop (didn't bet)
Seat 8: MarsMiland collected ($1.25)
Seat 9: Mmago24 folded before Flop (didn't bet)



PokerStars Hand #228685591870:  Hold'em No Limit ($0.25/$0.50 USD) - 2021/07/30 14:40:48 ET
Table 'Galilea III' 9-max Seat #4 is the button
Seat 1: Dihabet ($51.45 in chips) 
Seat 2: Zargmen ($22.27 in chips) 
Seat 4: saschaWITT ($4.85 in chips) 
Seat 5: dikanmax ($61.82 in chips) 
Seat 6: Nestle170 ($65.94 in chips) 
Seat 7: Xamil666 ($50 in chips) 
Seat 8: MarsMiland ($62.88 in chips) 
Seat 9: Mmago24 ($53.01 in chips) 
dikanmax: posts small blind $0.25
Nestle170: posts big blind $0.50
*** HOLE CARDS ***
Xamil666: folds 
MarsMiland: folds 
Mmago24: folds 
Dihabet: folds 
Zargmen: folds 
saschaWITT: folds 
dikanmax: calls $0.25
Nestle170: checks 
*** FLOP *** [8s Ah 3s]
dikanmax: bets $0.50
Nestle170: calls $0.50
*** TURN *** [8s Ah 3s] [9c]
dikanmax: checks 
Nestle170: checks 
*** RIVER *** [8s Ah 3s 9c] [5h]
dikanmax: checks 
Nestle170: checks 
*** SHOW DOWN ***
dikanmax: shows [5s 7d] (a pair of Fives)
Nestle170: mucks hand 
dikanmax collected $1.90 from pot
*** SUMMARY ***
Total pot $2 | Rake $0.10 
Board [8s Ah 3s 9c 5h]
Seat 1: Dihabet folded before Flop (didn't bet)
Seat 2: Zargmen folded before Flop (didn't bet)
Seat 4: saschaWITT (button) folded before Flop (didn't bet)
Seat 5: dikanmax (small blind) showed [5s 7d] and won ($1.90) with a pair of Fives
Seat 6: Nestle170 (big blind) mucked
Seat 7: Xamil666 folded before Flop (didn't bet)
Seat 8: MarsMiland folded before Flop (didn't bet)
Seat 9: Mmago24 folded before Flop (didn't bet)



PokerStars Hand #228685614900:  Hold'em No Limit ($0.25/$0.50 USD) - 2021/07/30 14:41:41 ET
Table 'Galilea III' 9-max Seat #5 is the button
Seat 1: Dihabet ($51.45 in chips) 
Seat 2: Zargmen ($22.27 in chips) 
Seat 3: se13giuum ($41.26 in chips) 
Seat 4: saschaWITT ($4.85 in chips) 
Seat 5: dikanmax ($62.72 in chips) 
Seat 6: Nestle170 ($64.94 in chips) 
Seat 7: Xamil666 ($50 in chips) 
Seat 8: MarsMiland ($62.88 in chips) 
Seat 9: Mmago24 ($53.01 in chips) 
Nestle170: posts small blind $0.25
Xamil666: posts big blind $0.50
se13giuum: posts small & big blinds $0.75
*** HOLE CARDS ***
MarsMiland: folds 
Mmago24: folds 
Dihabet: folds 
Zargmen: folds 
se13giuum: checks 
saschaWITT: folds 
dikanmax: raises $1.50 to $2
Nestle170: folds 
Xamil666: folds 
se13giuum: calls $1.50
*** FLOP *** [Ah 4d 8d]
se13giuum: checks 
dikanmax: bets $2.38
se13giuum: folds 
Uncalled bet ($2.38) returned to dikanmax
dikanmax collected $4.75 from pot
dikanmax: doesn't show hand 
*** SUMMARY ***
Total pot $5 | Rake $0.25 
Board [Ah 4d 8d]
Seat 1: Dihabet folded before Flop (didn't bet)
Seat 2: Zargmen folded before Flop (didn't bet)
Seat 3: se13giuum folded on the Flop
Seat 4: saschaWITT folded before Flop (didn't bet)
Seat 5: dikanmax (button) collected ($4.75)
Seat 6: Nestle170 (small blind) folded before Flop
Seat 7: Xamil666 (big blind) folded before Flop
Seat 8: MarsMiland folded before Flop (didn't bet)
Seat 9: Mmago24 folded before Flop (didn't bet)



PokerStars Hand #228685629522:  Hold'em No Limit ($0.25/$0.50 USD) - 2021/07/30 14:42:16 ET
Table 'Galilea III' 9-max Seat #6 is the button
Seat 1: Dihabet ($51.45 in chips) 
Seat 2: Zargmen ($22.27 in chips) 
Seat 3: se13giuum ($39.01 in chips) 
Seat 4: saschaWITT ($4.85 in chips) 
Seat 5: dikanmax ($65.47 in chips) 
Seat 6: Nestle170 ($64.69 in chips) 
Seat 7: Xamil666 ($50 in chips) 
Seat 8: MarsMiland ($62.88 in chips) 
Seat 9: Mmago24 ($53.01 in chips) 
Xamil666: posts small blind $0.25
MarsMiland: posts big blind $0.50
*** HOLE CARDS ***
Mmago24: folds 
Dihabet: folds 
Zargmen: folds 
se13giuum: folds 
saschaWITT: folds 
dikanmax: folds 
Nestle170: folds 
Xamil666: folds 
Uncalled bet ($0.25) returned to MarsMiland
MarsMiland collected $0.50 from pot
MarsMiland: doesn't show hand 
*** SUMMARY ***
Total pot $0.50 | Rake $0 
Seat 1: Dihabet folded before Flop (didn't bet)
Seat 2: Zargmen folded before Flop (didn't bet)
Seat 3: se13giuum folded before Flop (didn't bet)
Seat 4: saschaWITT folded before Flop (didn't bet)
Seat 5: dikanmax folded before Flop (didn't bet)
Seat 6: Nestle170 (button) folded before Flop (didn't bet)
Seat 7: Xamil666 (small blind) folded before Flop
Seat 8: MarsMiland (big blind) collected ($0.50)
Seat 9: Mmago24 folded before Flop (didn't bet)



PokerStars Hand #228685636267:  Hold'em No Limit ($0.25/$0.50 USD) - 2021/07/30 14:42:32 ET
Table 'Galilea III' 9-max Seat #7 is the button
Seat 1: Dihabet ($51.45 in chips) 
Seat 2: Zargmen ($22.27 in chips) 
Seat 3: se13giuum ($39.01 in chips) 
Seat 4: saschaWITT ($4.85 in chips) 
Seat 5: dikanmax ($65.47 in chips) 
Seat 6: Nestle170 ($64.69 in chips) 
Seat 7: Xamil666 ($50 in chips) 
Seat 8: MarsMiland ($63.13 in chips) 
Seat 9: Mmago24 ($53.01 in chips) 
MarsMiland: posts small blind $0.25
Mmago24: posts big blind $0.50
*** HOLE CARDS ***
Dihabet: folds 
Zargmen: folds 
se13giuum: raises $1 to $1.50
saschaWITT: raises $3.35 to $4.85 and is all-in
dikanmax: folds 
Nestle170: folds 
Xamil666: folds 
MarsMiland: folds 
Mmago24: folds 
se13giuum: calls $3.35
saschaWITT:  
se13giuum:  
*** FLOP *** [Ks Kd 9s]
*** TURN *** [Ks Kd 9s] [Ac]
*** RIVER *** [Ks Kd 9s Ac] [2h]
*** SHOW DOWN ***
se13giuum: shows [Jh Jc] (two pair, Kings and Jacks)
saschaWITT: shows [8d 8c] (two pair, Kings and Eights)
se13giuum collected $9.93 from pot
*** SUMMARY ***
Total pot $10.45 | Rake $0.52 
Board [Ks Kd 9s Ac 2h]
Seat 1: Dihabet folded before Flop (didn't bet)
Seat 2: Zargmen folded before Flop (didn't bet)
Seat 3: se13giuum showed [Jh Jc] and won ($9.93) with two pair, Kings and Jacks
Seat 4: saschaWITT showed [8d 8c] and lost with two pair, Kings and Eights
Seat 5: dikanmax folded before Flop (didn't bet)
Seat 6: Nestle170 folded before Flop (didn't bet)
Seat 7: Xamil666 (button) folded before Flop (didn't bet)
Seat 8: MarsMiland (small blind) folded before Flop
Seat 9: Mmago24 (big blind) folded before Flop



PokerStars Hand #228685653204:  Hold'em No Limit ($0.25/$0.50 USD) - 2021/07/30 14:43:11 ET
Table 'Galilea III' 9-max Seat #8 is the button
Seat 1: Dihabet ($51.45 in chips) 
Seat 2: Zargmen ($22.27 in chips) 
Seat 3: se13giuum ($44.09 in chips) 
Seat 5: dikanmax ($65.47 in chips) 
Seat 6: Nestle170 ($64.69 in chips) 
Seat 7: Xamil666 ($50 in chips) 
Seat 8: MarsMiland ($62.88 in chips) 
Seat 9: Mmago24 ($52.51 in chips) 
Mmago24: posts small blind $0.25
Dihabet: posts big blind $0.50
*** HOLE CARDS ***
Zargmen: folds 
se13giuum: folds 
dikanmax: folds 
Nestle170: folds 
Xamil666: folds 
MarsMiland: folds 
saschaWITT leaves the table
Mmago24: raises $1 to $1.50
Dihabet: folds 
Uncalled bet ($1) returned to Mmago24
Mmago24 collected $1 from pot
Mmago24: doesn't show hand 
*** SUMMARY ***
Total pot $1 | Rake $0 
Seat 1: Dihabet (big blind) folded before Flop
Seat 2: Zargmen folded before Flop (didn't bet)
Seat 3: se13giuum folded before Flop (didn't bet)
Seat 5: dikanmax folded before Flop (didn't bet)
Seat 6: Nestle170 folded before Flop (didn't bet)
Seat 7: Xamil666 folded before Flop (didn't bet)
Seat 8: MarsMiland (button) folded before Flop (didn't bet)
Seat 9: Mmago24 (small blind) collected ($1)



PokerStars Hand #228685660381:  Hold'em No Limit ($0.25/$0.50 USD) - 2021/07/30 14:43:27 ET
Table 'Galilea III' 9-max Seat #9 is the button
Seat 1: Dihabet ($50.95 in chips) 
Seat 2: Zargmen ($22.27 in chips) 
Seat 3: se13giuum ($44.09 in chips) 
Seat 5: dikanmax ($65.47 in chips) 
Seat 6: Nestle170 ($64.69 in chips) 
Seat 7: Xamil666 ($50 in chips) 
Seat 8: MarsMiland ($62.88 in chips) 
Seat 9: Mmago24 ($53.01 in chips) 
Dihabet: posts small blind $0.25
Zargmen: posts big blind $0.50
*** HOLE CARDS ***
LeXuSSS201 joins the table at seat #4 
se13giuum: folds 
dikanmax: folds 
Nestle170: folds 
Xamil666: folds 
MarsMiland: folds 
Mmago24: raises $0.72 to $1.22
Dihabet: folds 
Zargmen: folds 
Uncalled bet ($0.72) returned to Mmago24
Mmago24 collected $1.25 from pot
Mmago24: doesn't show hand 
*** SUMMARY ***
Total pot $1.25 | Rake $0 
Seat 1: Dihabet (small blind) folded before Flop
Seat 2: Zargmen (big blind) folded before Flop
Seat 3: se13giuum folded before Flop (didn't bet)
Seat 5: dikanmax folded before Flop (didn't bet)
Seat 6: Nestle170 folded before Flop (didn't bet)
Seat 7: Xamil666 folded before Flop (didn't bet)
Seat 8: MarsMiland folded before Flop (didn't bet)
Seat 9: Mmago24 (button) collected ($1.25)



PokerStars Hand #228685669816:  Hold'em No Limit ($0.25/$0.50 USD) - 2021/07/30 14:43:49 ET
Table 'Galilea III' 9-max Seat #1 is the button
Seat 1: Dihabet ($50.70 in chips) 
Seat 2: Zargmen ($21.77 in chips) 
Seat 3: se13giuum ($44.09 in chips) 
Seat 5: dikanmax ($65.47 in chips) 
Seat 6: Nestle170 ($64.69 in chips) 
Seat 7: Xamil666 ($50 in chips) 
Seat 8: MarsMiland ($62.88 in chips) 
Seat 9: Mmago24 ($53.76 in chips) 
Zargmen: posts small blind $0.25
se13giuum: posts big blind $0.50
*** HOLE CARDS ***
dikanmax: folds 
Nestle170: folds 
Xamil666: folds 
MarsMiland: folds 
Mmago24: folds 
Dihabet: folds 
Zargmen: raises $1 to $1.50
se13giuum: folds 
Uncalled bet ($1) returned to Zargmen
Zargmen collected $1 from pot
Zargmen: doesn't show hand 
*** SUMMARY ***
Total pot $1 | Rake $0 
Seat 1: Dihabet (button) folded before Flop (didn't bet)
Seat 2: Zargmen (small blind) collected ($1)
Seat 3: se13giuum (big blind) folded before Flop
Seat 5: dikanmax folded before Flop (didn't bet)
Seat 6: Nestle170 folded before Flop (didn't bet)
Seat 7: Xamil666 folded before Flop (didn't bet)
Seat 8: MarsMiland folded before Flop (didn't bet)
Seat 9: Mmago24 folded before Flop (didn't bet)



PokerStars Hand #228685677355:  Hold'em No Limit ($0.25/$0.50 USD) - 2021/07/30 14:44:06 ET
Table 'Galilea III' 9-max Seat #2 is the button
Seat 1: Dihabet ($50.70 in chips) 
Seat 2: Zargmen ($22.27 in chips) 
Seat 3: se13giuum ($43.59 in chips) 
Seat 5: dikanmax ($65.47 in chips) 
Seat 6: Nestle170 ($64.69 in chips) 
Seat 7: Xamil666 ($50 in chips) 
Seat 8: MarsMiland ($62.88 in chips) 
Seat 9: Mmago24 ($53.76 in chips) 
se13giuum: posts small blind $0.25
dikanmax: posts big blind $0.50
*** HOLE CARDS ***
Nestle170: folds 
Xamil666: folds 
MarsMiland: folds 
Mmago24: folds 
Dihabet: raises $0.85 to $1.35
Zargmen: folds 
se13giuum: folds 
dikanmax: calls $0.85
*** FLOP *** [3h Jh 6s]
dikanmax: checks 
Dihabet: bets $1.40
dikanmax: folds 
Uncalled bet ($1.40) returned to Dihabet
Dihabet collected $2.80 from pot
Dihabet: doesn't show hand 
*** SUMMARY ***
Total pot $2.95 | Rake $0.15 
Board [3h Jh 6s]
Seat 1: Dihabet collected ($2.80)
Seat 2: Zargmen (button) folded before Flop (didn't bet)
Seat 3: se13giuum (small blind) folded before Flop
Seat 5: dikanmax (big blind) folded on the Flop
Seat 6: Nestle170 folded before Flop (didn't bet)
Seat 7: Xamil666 folded before Flop (didn't bet)
Seat 8: MarsMiland folded before Flop (didn't bet)
Seat 9: Mmago24 folded before Flop (didn't bet)



PokerStars Hand #228685691367:  Hold'em No Limit ($0.25/$0.50 USD) - 2021/07/30 14:44:39 ET
Table 'Galilea III' 9-max Seat #3 is the button
Seat 1: Dihabet ($52.15 in chips) 
Seat 2: Zargmen ($22.27 in chips) 
Seat 3: se13giuum ($43.34 in chips) 
Seat 5: dikanmax ($64.12 in chips) 
Seat 6: Nestle170 ($64.69 in chips) 
Seat 7: Xamil666 ($50 in chips) 
Seat 8: MarsMiland ($62.88 in chips) 
Seat 9: Mmago24 ($53.76 in chips) 
dikanmax: posts small blind $0.25
Nestle170: posts big blind $0.50
*** HOLE CARDS ***
Xamil666: folds 
MarsMiland: folds 
Mmago24: folds 
Dihabet: folds 
Zargmen: folds 
Xamil666 leaves the table
se13giuum: calls $0.50
dikanmax: folds 
Nestle170: checks 
*** FLOP *** [Kc 5c 8c]
Nestle170: checks 
se13giuum: checks 
*** TURN *** [Kc 5c 8c] [Ac]
Nestle170: checks 
LeXuSSS201 is disconnected 
se13giuum: bets $0.59
Nestle170: folds 
Uncalled bet ($0.59) returned to se13giuum
se13giuum collected $1.19 from pot
se13giuum: doesn't show hand 
*** SUMMARY ***
Total pot $1.25 | Rake $0.06 
Board [Kc 5c 8c Ac]
Seat 1: Dihabet folded before Flop (didn't bet)
Seat 2: Zargmen folded before Flop (didn't bet)
Seat 3: se13giuum (button) collected ($1.19)
Seat 5: dikanmax (small blind) folded before Flop
Seat 6: Nestle170 (big blind) folded on the Turn
Seat 7: Xamil666 folded before Flop (didn't bet)
Seat 8: MarsMiland folded before Flop (didn't bet)
Seat 9: Mmago24 folded before Flop (didn't bet)



PokerStars Hand #228685713587:  Hold'em No Limit ($0.25/$0.50 USD) - 2021/07/30 14:45:15 ET
Table 'Galilea III' 9-max Seat #5 is the button
Seat 1: Dihabet ($52.15 in chips) 
Seat 2: Zargmen ($22.27 in chips) 
Seat 3: se13giuum ($44.03 in chips) 
Seat 5: dikanmax ($63.87 in chips) 
Seat 6: Nestle170 ($64.19 in chips) 
Seat 9: Mmago24 ($53.76 in chips) 
Nestle170: posts small blind $0.25
MarsMiland: is sitting out 
Mmago24: posts big blind $0.50
*** HOLE CARDS ***
Dihabet: folds 
Zargmen: calls $0.50
se13giuum: raises $1 to $1.50
dikanmax: folds 
Nestle170: folds 
MarsMiland leaves the table
Mmago24: folds 
Zargmen: folds 
Uncalled bet ($1) returned to se13giuum
se13giuum collected $1.75 from pot
se13giuum: doesn't show hand 
CocoAlexMix joins the table at seat #7 
*** SUMMARY ***
Total pot $1.75 | Rake $0 
Seat 1: Dihabet folded before Flop (didn't bet)
Seat 2: Zargmen folded before Flop
Seat 3: se13giuum collected ($1.75)
Seat 5: dikanmax (button) folded before Flop (didn't bet)
Seat 6: Nestle170 (small blind) folded before Flop
Seat 9: Mmago24 (big blind) folded before Flop



PokerStars Hand #228685722752:  Hold'em No Limit ($0.25/$0.50 USD) - 2021/07/30 14:45:37 ET
Table 'Galilea III' 9-max Seat #6 is the button
Seat 1: Dihabet ($52.15 in chips) 
Seat 2: Zargmen ($21.77 in chips) 
Seat 3: se13giuum ($45.28 in chips) 
Seat 5: dikanmax ($63.87 in chips) 
Seat 6: Nestle170 ($63.94 in chips) 
Seat 9: Mmago24 ($53.26 in chips) 
Mmago24: posts small blind $0.25
Dihabet: posts big blind $0.50
*** HOLE CARDS ***
Zargmen: folds 
se13giuum: raises $1 to $1.50
balaskas199 joins the table at seat #8 
dikanmax: raises $3 to $4.50
Nestle170: folds 
balaskas199 leaves the table
Mmago24: folds 
Dihabet: folds 
se13giuum: calls $3
*** FLOP *** [Th 5h 3c]
se13giuum: bets $4.63
dikanmax: raises $7.37 to $12
se13giuum: calls $7.37
*** TURN *** [Th 5h 3c] [2c]
se13giuum: bets $28.78 and is all-in
dikanmax: folds 
Uncalled bet ($28.78) returned to se13giuum
se13giuum collected $32.06 from pot
se13giuum: doesn't show hand 
*** SUMMARY ***
Total pot $33.75 | Rake $1.69 
Board [Th 5h 3c 2c]
Seat 1: Dihabet (big blind) folded before Flop
Seat 2: Zargmen folded before Flop (didn't bet)
Seat 3: se13giuum collected ($32.06)
Seat 5: dikanmax folded on the Turn
Seat 6: Nestle170 (button) folded before Flop (didn't bet)
Seat 9: Mmago24 (small blind) folded before Flop



PokerStars Hand #228685745178:  Hold'em No Limit ($0.25/$0.50 USD) - 2021/07/30 14:46:29 ET
Table 'Galilea III' 9-max Seat #9 is the button
Seat 1: Dihabet ($51.65 in chips) 
Seat 2: Zargmen ($21.77 in chips) 
Seat 3: se13giuum ($60.84 in chips) 
Seat 5: dikanmax ($50 in chips) 
Seat 6: Nestle170 ($63.94 in chips) 
Seat 9: Mmago24 ($53.01 in chips) 
Dihabet: posts small blind $0.25
Zargmen: posts big blind $0.50
LeXuSSS201: sits out 
CocoAlexMix: sits out 
*** HOLE CARDS ***
se13giuum: folds 
dikanmax: folds 
Nestle170: folds 
m11k1989 joins the table at seat #8 
Mmago24: folds 
Dihabet: folds 
Uncalled bet ($0.25) returned to Zargmen
Zargmen collected $0.50 from pot
Zargmen: doesn't show hand 
*** SUMMARY ***
Total pot $0.50 | Rake $0 
Seat 1: Dihabet (small blind) folded before Flop
Seat 2: Zargmen (big blind) collected ($0.50)
Seat 3: se13giuum folded before Flop (didn't bet)
Seat 5: dikanmax folded before Flop (didn't bet)
Seat 6: Nestle170 folded before Flop (didn't bet)
Seat 9: Mmago24 (button) folded before Flop (didn't bet)



PokerStars Hand #228685752000:  Hold'em No Limit ($0.25/$0.50 USD) - 2021/07/30 14:46:45 ET
Table 'Galilea III' 9-max Seat #1 is the button
Seat 1: Dihabet ($51.40 in chips) 
Seat 3: se13giuum ($60.84 in chips) 
Seat 4: LeXuSSS201 ($50 in chips) 
Seat 5: dikanmax ($50 in chips) 
Seat 6: Nestle170 ($63.94 in chips) 
Seat 9: Mmago24 ($53.01 in chips) 
se13giuum: posts small blind $0.25
LeXuSSS201: posts big blind $0.50
CocoAlexMix: sits out 
m11k1989: sits out 
*** HOLE CARDS ***
dikanmax: raises $1 to $1.50
Nestle170: folds 
Zargmen leaves the table
Mmago24: folds 
Dihabet: folds 
v.sting joins the table at seat #2 
se13giuum: calls $1.25
LeXuSSS201: folds 
*** FLOP *** [3c 9s 9d]
se13giuum: checks 
dikanmax: bets $2.25
se13giuum: folds 
Uncalled bet ($2.25) returned to dikanmax
dikanmax collected $3.32 from pot
dikanmax: doesn't show hand 
*** SUMMARY ***
Total pot $3.50 | Rake $0.18 
Board [3c 9s 9d]
Seat 1: Dihabet (button) folded before Flop (didn't bet)
Seat 3: se13giuum (small blind) folded on the Flop
Seat 4: LeXuSSS201 (big blind) folded before Flop
Seat 5: dikanmax collected ($3.32)
Seat 6: Nestle170 folded before Flop (didn't bet)
Seat 9: Mmago24 folded before Flop (didn't bet)



PokerStars Hand #228685784654:  Hold'em No Limit ($0.25/$0.50 USD) - 2021/07/30 14:48:00 ET
Table 'Galilea III' 9-max Seat #3 is the button
Seat 1: Dihabet ($51.40 in chips) 
Seat 3: se13giuum ($59.34 in chips) 
Seat 4: LeXuSSS201 ($50 in chips) 
Seat 6: Nestle170 ($63.94 in chips) 
Seat 8: m11k1989 ($29.64 in chips) 
Seat 9: Mmago24 ($53.01 in chips) 
LeXuSSS201: posts small blind $0.25
Nestle170: posts big blind $0.50
CocoAlexMix: sits out 
m11k1989: posts big blind $0.50
v.sting: sits out 
*** HOLE CARDS ***
m11k1989: checks 
Mmago24: folds 
Dihabet: folds 
WarllocK1982 joins the table at seat #5 
se13giuum is disconnected 
se13giuum has timed out while disconnected
se13giuum: folds 
m11k1989 is disconnected 
LeXuSSS201: raises $1.25 to $1.75
Nestle170: folds 
m11k1989 is connected 
m11k1989 has timed out
m11k1989: folds 
Uncalled bet ($1.25) returned to LeXuSSS201
LeXuSSS201 collected $1.50 from pot
LeXuSSS201: doesn't show hand 
*** SUMMARY ***
Total pot $1.50 | Rake $0 
Seat 1: Dihabet folded before Flop (didn't bet)
Seat 3: se13giuum (button) folded before Flop (didn't bet)
Seat 4: LeXuSSS201 (small blind) collected ($1.50)
Seat 6: Nestle170 (big blind) folded before Flop
Seat 8: m11k1989 folded before Flop (didn't bet)
Seat 9: Mmago24 folded before Flop (didn't bet)



PokerStars Hand #228685809645:  Hold'em No Limit ($0.25/$0.50 USD) - 2021/07/30 14:48:58 ET
Table 'Galilea III' 9-max Seat #4 is the button
Seat 1: Dihabet ($51.40 in chips) 
Seat 4: LeXuSSS201 ($51 in chips) 
Seat 6: Nestle170 ($63.44 in chips) 
Seat 8: m11k1989 ($29.14 in chips) 
Seat 9: Mmago24 ($53.01 in chips) 
Nestle170: posts small blind $0.25
LeXuSSS201 is disconnected 
m11k1989: posts big blind $0.50
v.sting: sits out 
*** HOLE CARDS ***
Mmago24: folds 
Dihabet: folds 
LeXuSSS201 has timed out while disconnected
LeXuSSS201: folds 
Nestle170: raises $1 to $1.50
m11k1989: folds 
Uncalled bet ($1) returned to Nestle170
Nestle170 collected $1 from pot
*** SUMMARY ***
Total pot $1 | Rake $0 
Seat 1: Dihabet folded before Flop (didn't bet)
Seat 4: LeXuSSS201 (button) folded before Flop (didn't bet)
Seat 6: Nestle170 (small blind) collected ($1)
Seat 8: m11k1989 (big blind) folded before Flop
Seat 9: Mmago24 folded before Flop (didn't bet)



PokerStars Hand #228685818444:  Hold'em No Limit ($0.25/$0.50 USD) - 2021/07/30 14:49:18 ET
Table 'Galilea III' 9-max Seat #6 is the button
Seat 1: Dihabet ($51.40 in chips) 
Seat 6: Nestle170 ($63.94 in chips) 
Seat 8: m11k1989 ($28.64 in chips) 
m11k1989: posts small blind $0.25
Mmago24: is sitting out 
Dihabet: posts big blind $0.50
m11k1989 is disconnected 
v.sting: sits out 
WarllocK1982: sits out 
*** HOLE CARDS ***
CocoAlexMix leaves the table
Nestle170: raises $0.60 to $1.10
m11k1989 is connected 
m11k1989: folds 
Dihabet: raises $3.90 to $5
fool_rabbit joins the table at seat #7 
Nestle170: folds 
Uncalled bet ($3.90) returned to Dihabet
Dihabet collected $2.45 from pot
Dihabet: doesn't show hand 
*** SUMMARY ***
Total pot $2.45 | Rake $0 
Seat 1: Dihabet (big blind) collected ($2.45)
Seat 6: Nestle170 (button) folded before Flop
Seat 8: m11k1989 (small blind) folded before Flop



PokerStars Hand #228685831531:  Hold'em No Limit ($0.25/$0.50 USD) - 2021/07/30 14:49:49 ET
Table 'Galilea III' 9-max Seat #8 is the button
Seat 1: Dihabet ($52.75 in chips) 
Seat 2: v.sting ($50 in chips) 
Seat 4: LeXuSSS201 ($51 in chips) 
Seat 6: Nestle170 ($62.84 in chips) 
Seat 7: fool_rabbit ($50 in chips) 
Seat 8: m11k1989 ($28.39 in chips) 
Dihabet: posts small blind $0.25
v.sting: posts big blind $0.50
WarllocK1982: sits out 
fool_rabbit: posts big blind $0.50
*** HOLE CARDS ***
LeXuSSS201: folds 
Nestle170: folds 
fool_rabbit: checks 
m11k1989: folds 
Dihabet: folds 
v.sting: checks 
*** FLOP *** [Qd 7d Qc]
v.sting: checks 
fool_rabbit: checks 
*** TURN *** [Qd 7d Qc] [6c]
v.sting: checks 
fool_rabbit: checks 
*** RIVER *** [Qd 7d Qc 6c] [6d]
v.sting: checks 
fool_rabbit: bets $1.25
v.sting: calls $1.25
*** SHOW DOWN ***
fool_rabbit: shows [8c 4s] (two pair, Queens and Sixes)
v.sting: mucks hand 
fool_rabbit collected $3.56 from pot
*** SUMMARY ***
Total pot $3.75 | Rake $0.19 
Board [Qd 7d Qc 6c 6d]
Seat 1: Dihabet (small blind) folded before Flop
Seat 2: v.sting (big blind) mucked
Seat 4: LeXuSSS201 folded before Flop (didn't bet)
Seat 6: Nestle170 folded before Flop (didn't bet)
Seat 7: fool_rabbit showed [8c 4s] and won ($3.56) with two pair, Queens and Sixes
Seat 8: m11k1989 (button) folded before Flop (didn't bet)



PokerStars Hand #228685853656:  Hold'em No Limit ($0.25/$0.50 USD) - 2021/07/30 14:50:40 ET
Table 'Galilea III' 9-max Seat #1 is the button
Seat 1: Dihabet ($52.50 in chips) 
Seat 2: v.sting ($50 in chips) 
Seat 5: WarllocK1982 ($50 in chips) 
Seat 6: Nestle170 ($62.84 in chips) 
Seat 7: fool_rabbit ($51.81 in chips) 
Seat 8: m11k1989 ($28.39 in chips) 
v.sting: posts small blind $0.25
LeXuSSS201: is sitting out 
WarllocK1982: posts big blind $0.50
Mmago24: sits out 
*** HOLE CARDS ***
Nestle170: raises $1 to $1.50
fool_rabbit: raises $3 to $4.50
m11k1989: folds 
Dihabet: folds 
v.sting: folds 
WarllocK1982: folds 
Nestle170: folds 
Uncalled bet ($3) returned to fool_rabbit
fool_rabbit collected $3.75 from pot
fool_rabbit: doesn't show hand 
*** SUMMARY ***
Total pot $3.75 | Rake $0 
Seat 1: Dihabet (button) folded before Flop (didn't bet)
Seat 2: v.sting (small blind) folded before Flop
Seat 5: WarllocK1982 (big blind) folded before Flop
Seat 6: Nestle170 folded before Flop
Seat 7: fool_rabbit collected ($3.75)
Seat 8: m11k1989 folded before Flop (didn't bet)



PokerStars Hand #228685870513:  Hold'em No Limit ($0.25/$0.50 USD) - 2021/07/30 14:51:19 ET
Table 'Galilea III' 9-max Seat #2 is the button
Seat 1: Dihabet ($52.50 in chips) 
Seat 2: v.sting ($50 in chips) 
Seat 5: WarllocK1982 ($50 in chips) 
Seat 6: Nestle170 ($61.34 in chips) 
Seat 7: fool_rabbit ($54.06 in chips) 
Seat 8: m11k1989 ($28.39 in chips) 
WarllocK1982: posts small blind $0.25
Nestle170: posts big blind $0.50
Mmago24: sits out 
*** HOLE CARDS ***
fool_rabbit: folds 
m11k1989: calls $0.50
Dihabet: folds 
v.sting: folds 
WarllocK1982: folds 
Nestle170: checks 
*** FLOP *** [Kd 8d 7c]
Nestle170: bets $0.65
m11k1989: raises $1.15 to $1.80
Nestle170: calls $1.15
*** TURN *** [Kd 8d 7c] [Ts]
Nestle170: checks 
m11k1989: bets $4.61
Nestle170: calls $4.61
*** RIVER *** [Kd 8d 7c Ts] [Ah]
Nestle170: checks 
m11k1989: bets $5.50
Nestle170: calls $5.50
*** SHOW DOWN ***
m11k1989: shows [Ac Qs] (a pair of Aces)
Nestle170: mucks hand 
m11k1989 collected $23.82 from pot
*** SUMMARY ***
Total pot $25.07 | Rake $1.25 
Board [Kd 8d 7c Ts Ah]
Seat 1: Dihabet folded before Flop (didn't bet)
Seat 2: v.sting (button) folded before Flop (didn't bet)
Seat 5: WarllocK1982 (small blind) folded before Flop
Seat 6: Nestle170 (big blind) mucked
Seat 7: fool_rabbit folded before Flop (didn't bet)
Seat 8: m11k1989 showed [Ac Qs] and won ($23.82) with a pair of Aces



PokerStars Hand #228685894689:  Hold'em No Limit ($0.25/$0.50 USD) - 2021/07/30 14:52:15 ET
Table 'Galilea III' 9-max Seat #5 is the button
Seat 1: Dihabet ($52.50 in chips) 
Seat 2: v.sting ($50 in chips) 
Seat 5: WarllocK1982 ($50 in chips) 
Seat 6: Nestle170 ($50 in chips) 
Seat 7: fool_rabbit ($54.06 in chips) 
Seat 8: m11k1989 ($39.80 in chips) 
Nestle170: posts small blind $0.25
fool_rabbit: posts big blind $0.50
Mmago24: sits out 
*** HOLE CARDS ***
m11k1989: folds 
Dihabet: folds 
v.sting: folds 
WarllocK1982: folds 
Nestle170: raises $1 to $1.50
fool_rabbit: calls $1
*** FLOP *** [Js Kh Qs]
Nestle170: checks 
fool_rabbit: checks 
*** TURN *** [Js Kh Qs] [7h]
Nestle170: checks 
LeXuSSS201 leaves the table
fool_rabbit: checks 
*** RIVER *** [Js Kh Qs 7h] [As]
Nestle170: checks 
fool_rabbit: checks 
*** SHOW DOWN ***
Nestle170: shows [8s Ac] (a pair of Aces)
fool_rabbit: mucks hand 
Nestle170 collected $2.85 from pot
*** SUMMARY ***
Total pot $3 | Rake $0.15 
Board [Js Kh Qs 7h As]
Seat 1: Dihabet folded before Flop (didn't bet)
Seat 2: v.sting folded before Flop (didn't bet)
Seat 5: WarllocK1982 (button) folded before Flop (didn't bet)
Seat 6: Nestle170 (small blind) showed [8s Ac] and won ($2.85) with a pair of Aces
Seat 7: fool_rabbit (big blind) mucked
Seat 8: m11k1989 folded before Flop (didn't bet)



PokerStars Hand #228685917628:  Hold'em No Limit ($0.25/$0.50 USD) - 2021/07/30 14:53:08 ET
Table 'Galilea III' 9-max Seat #6 is the button
Seat 1: Dihabet ($52.50 in chips) 
Seat 2: v.sting ($50 in chips) 
Seat 5: WarllocK1982 ($50 in chips) 
Seat 6: Nestle170 ($51.35 in chips) 
Seat 7: fool_rabbit ($52.56 in chips) 
Seat 8: m11k1989 ($39.80 in chips) 
fool_rabbit: posts small blind $0.25
m11k1989: posts big blind $0.50
Mmago24: sits out 
*** HOLE CARDS ***
Dihabet: raises $0.85 to $1.35
v.sting: folds 
WarllocK1982: folds 
Nestle170: folds 
fool_rabbit: folds 
$lavik88 joins the table at seat #4 
m11k1989: calls $0.85
*** FLOP *** [Kh 9d 2h]
m11k1989: checks 
Dihabet: bets $1.40
m11k1989: folds 
Uncalled bet ($1.40) returned to Dihabet
Dihabet collected $2.80 from pot
Dihabet: doesn't show hand 
*** SUMMARY ***
Total pot $2.95 | Rake $0.15 
Board [Kh 9d 2h]
Seat 1: Dihabet collected ($2.80)
Seat 2: v.sting folded before Flop (didn't bet)
Seat 5: WarllocK1982 folded before Flop (didn't bet)
Seat 6: Nestle170 (button) folded before Flop (didn't bet)
Seat 7: fool_rabbit (small blind) folded before Flop
Seat 8: m11k1989 (big blind) folded on the Flop



PokerStars Hand #228685932792:  Hold'em No Limit ($0.25/$0.50 USD) - 2021/07/30 14:53:44 ET
Table 'Galilea III' 9-max Seat #7 is the button
Seat 1: Dihabet ($53.95 in chips) 
Seat 2: v.sting ($50 in chips) 
Seat 5: WarllocK1982 ($50 in chips) 
Seat 6: Nestle170 ($51.35 in chips) 
Seat 7: fool_rabbit ($52.31 in chips) 
Seat 8: m11k1989 ($38.45 in chips) 
Seat 9: Mmago24 ($53.01 in chips) 
m11k1989: posts small blind $0.25
Mmago24: posts big blind $0.50
$lavik88: sits out 
*** HOLE CARDS ***
Dihabet: folds 
v.sting: folds 
WarllocK1982: folds 
Nestle170: folds 
fool_rabbit: raises $1 to $1.50
m11k1989: folds 
Mmago24: folds 
Uncalled bet ($1) returned to fool_rabbit
fool_rabbit collected $1.25 from pot
fool_rabbit: doesn't show hand 
*** SUMMARY ***
Total pot $1.25 | Rake $0 
Seat 1: Dihabet folded before Flop (didn't bet)
Seat 2: v.sting folded before Flop (didn't bet)
Seat 5: WarllocK1982 folded before Flop (didn't bet)
Seat 6: Nestle170 folded before Flop (didn't bet)
Seat 7: fool_rabbit (button) collected ($1.25)
Seat 8: m11k1989 (small blind) folded before Flop
Seat 9: Mmago24 (big blind) folded before Flop



PokerStars Hand #228685940673:  Hold'em No Limit ($0.25/$0.50 USD) - 2021/07/30 14:54:02 ET
Table 'Galilea III' 9-max Seat #8 is the button
Seat 1: Dihabet ($53.95 in chips) 
Seat 2: v.sting ($50 in chips) 
Seat 5: WarllocK1982 ($50 in chips) 
Seat 6: Nestle170 ($51.35 in chips) 
Seat 7: fool_rabbit ($53.06 in chips) 
Seat 8: m11k1989 ($38.20 in chips) 
Seat 9: Mmago24 ($52.51 in chips) 
Mmago24: posts small blind $0.25
Dihabet: posts big blind $0.50
$lavik88: sits out 
*** HOLE CARDS ***
v.sting: folds 
WarllocK1982: folds 
Nestle170: folds 
fool_rabbit: folds 
m11k1989: folds 
Mmago24: folds 
Uncalled bet ($0.25) returned to Dihabet
Dihabet collected $0.50 from pot
Dihabet: doesn't show hand 
*** SUMMARY ***
Total pot $0.50 | Rake $0 
Seat 1: Dihabet (big blind) collected ($0.50)
Seat 2: v.sting folded before Flop (didn't bet)
Seat 5: WarllocK1982 folded before Flop (didn't bet)
Seat 6: Nestle170 folded before Flop (didn't bet)
Seat 7: fool_rabbit folded before Flop (didn't bet)
Seat 8: m11k1989 (button) folded before Flop (didn't bet)
Seat 9: Mmago24 (small blind) folded before Flop



PokerStars Hand #228685945453:  Hold'em No Limit ($0.25/$0.50 USD) - 2021/07/30 14:54:13 ET
Table 'Galilea III' 9-max Seat #9 is the button
Seat 1: Dihabet ($54.20 in chips) 
Seat 2: v.sting ($50 in chips) 
Seat 5: WarllocK1982 ($50 in chips) 
Seat 6: Nestle170 ($51.35 in chips) 
Seat 7: fool_rabbit ($53.06 in chips) 
Seat 8: m11k1989 ($38.20 in chips) 
Seat 9: Mmago24 ($52.26 in chips) 
Dihabet: posts small blind $0.25
v.sting: posts big blind $0.50
$lavik88: sits out 
*** HOLE CARDS ***
WarllocK1982: folds 
Nestle170: folds 
fool_rabbit has timed out
fool_rabbit: folds 
m11k1989: calls $0.50
Mmago24: raises $1.50 to $2
Dihabet: folds 
v.sting: folds 
m11k1989: raises $4.75 to $6.75
Mmago24: folds 
Uncalled bet ($4.75) returned to m11k1989
m11k1989 collected $4.75 from pot
m11k1989: doesn't show hand 
*** SUMMARY ***
Total pot $4.75 | Rake $0 
Seat 1: Dihabet (small blind) folded before Flop
Seat 2: v.sting (big blind) folded before Flop
Seat 5: WarllocK1982 folded before Flop (didn't bet)
Seat 6: Nestle170 folded before Flop (didn't bet)
Seat 7: fool_rabbit folded before Flop (didn't bet)
Seat 8: m11k1989 collected ($4.75)
Seat 9: Mmago24 (button) folded before Flop



PokerStars Hand #228685960097:  Hold'em No Limit ($0.25/$0.50 USD) - 2021/07/30 14:54:48 ET
Table 'Galilea III' 9-max Seat #1 is the button
Seat 1: Dihabet ($53.95 in chips) 
Seat 2: v.sting ($50 in chips) 
Seat 4: $lavik88 ($50 in chips) 
Seat 5: WarllocK1982 ($50 in chips) 
Seat 6: Nestle170 ($51.35 in chips) 
Seat 7: fool_rabbit ($53.06 in chips) 
Seat 8: m11k1989 ($40.95 in chips) 
Seat 9: Mmago24 ($50.26 in chips) 
v.sting: posts small blind $0.25
$lavik88: posts big blind $0.50
*** HOLE CARDS ***
WarllocK1982: folds 
Nestle170: raises $1 to $1.50
fool_rabbit: folds 
m11k1989: calls $1.50
Mmago24: calls $1.50
Dihabet: folds 
v.sting: folds 
$lavik88: calls $1
*** FLOP *** [Tc 8d 5h]
$lavik88: checks 
Nestle170: checks 
m11k1989: bets $3.97
Mmago24: calls $3.97
$lavik88: calls $3.97
Nestle170: folds 
*** TURN *** [Tc 8d 5h] [8c]
$lavik88: checks 
m11k1989: bets $8.62
Mmago24: folds 
$lavik88: folds 
Uncalled bet ($8.62) returned to m11k1989
m11k1989 collected $17.25 from pot
m11k1989: doesn't show hand 
*** SUMMARY ***
Total pot $18.16 | Rake $0.91 
Board [Tc 8d 5h 8c]
Seat 1: Dihabet (button) folded before Flop (didn't bet)
Seat 2: v.sting (small blind) folded before Flop
Seat 4: $lavik88 (big blind) folded on the Turn
Seat 5: WarllocK1982 folded before Flop (didn't bet)
Seat 6: Nestle170 folded on the Flop
Seat 7: fool_rabbit folded before Flop (didn't bet)
Seat 8: m11k1989 collected ($17.25)
Seat 9: Mmago24 folded on the Turn



PokerStars Hand #228685978459:  Hold'em No Limit ($0.25/$0.50 USD) - 2021/07/30 14:55:37 ET
Table 'Galilea III' 9-max Seat #2 is the button
Seat 1: Dihabet ($53.95 in chips) 
Seat 2: v.sting ($50 in chips) 
Seat 4: $lavik88 ($50 in chips) 
Seat 5: WarllocK1982 ($50 in chips) 
Seat 6: Nestle170 ($50 in chips) 
Seat 7: fool_rabbit ($53.06 in chips) 
Seat 8: m11k1989 ($52.73 in chips) 
Seat 9: Mmago24 ($50 in chips) 
$lavik88: posts small blind $0.25
WarllocK1982: posts big blind $0.50
*** HOLE CARDS ***
Nestle170: folds 
fool_rabbit: raises $1 to $1.50
m11k1989: folds 
Mmago24: folds 
Dihabet: calls $1.50
v.sting: folds 
$lavik88: folds 
WarllocK1982: folds 
*** FLOP *** [8h Kc Js]
fool_rabbit: checks 
Dihabet: checks 
*** TURN *** [8h Kc Js] [Qs]
m11k1989 is disconnected 
fool_rabbit: checks 
Dihabet: checks 
*** RIVER *** [8h Kc Js Qs] [Tc]
fool_rabbit: checks 
Dihabet: checks 
*** SHOW DOWN ***
fool_rabbit: shows [7c 7s] (a pair of Sevens)
Dihabet: mucks hand 
fool_rabbit collected $3.56 from pot
*** SUMMARY ***
Total pot $3.75 | Rake $0.19 
Board [8h Kc Js Qs Tc]
Seat 1: Dihabet mucked
Seat 2: v.sting (button) folded before Flop (didn't bet)
Seat 4: $lavik88 (small blind) folded before Flop
Seat 5: WarllocK1982 (big blind) folded before Flop
Seat 6: Nestle170 folded before Flop (didn't bet)
Seat 7: fool_rabbit showed [7c 7s] and won ($3.56) with a pair of Sevens
Seat 8: m11k1989 folded before Flop (didn't bet)
Seat 9: Mmago24 folded before Flop (didn't bet)



PokerStars Hand #228685991426:  Hold'em No Limit ($0.25/$0.50 USD) - 2021/07/30 14:56:18 ET
Table 'Galilea III' 9-max Seat #4 is the button
Seat 1: Dihabet ($52.45 in chips) 
Seat 2: v.sting ($50 in chips) 
Seat 4: $lavik88 ($50 in chips) 
Seat 5: WarllocK1982 ($50 in chips) 
Seat 6: Nestle170 ($50 in chips) 
Seat 7: fool_rabbit ($55.12 in chips) 
Seat 9: Mmago24 ($50 in chips) 
WarllocK1982: posts small blind $0.25
Nestle170: posts big blind $0.50
*** HOLE CARDS ***
fool_rabbit: folds 
Mmago24: folds 
Dihabet: folds 
v.sting: folds 
$lavik88: raises $0.70 to $1.20
WarllocK1982: folds 
Nestle170: folds 
Uncalled bet ($0.70) returned to $lavik88
$lavik88 collected $1.25 from pot
$lavik88: doesn't show hand 
*** SUMMARY ***
Total pot $1.25 | Rake $0 
Seat 1: Dihabet folded before Flop (didn't bet)
Seat 2: v.sting folded before Flop (didn't bet)
Seat 4: $lavik88 (button) collected ($1.25)
Seat 5: WarllocK1982 (small blind) folded before Flop
Seat 6: Nestle170 (big blind) folded before Flop
Seat 7: fool_rabbit folded before Flop (didn't bet)
Seat 9: Mmago24 folded before Flop (didn't bet)



PokerStars Hand #228686005809:  Hold'em No Limit ($0.25/$0.50 USD) - 2021/07/30 14:57:04 ET
Table 'Galilea III' 9-max Seat #5 is the button
Seat 1: Dihabet ($52.45 in chips) 
Seat 2: v.sting ($50 in chips) 
Seat 4: $lavik88 ($50.75 in chips) 
Seat 5: WarllocK1982 ($50 in chips) 
Seat 6: Nestle170 ($50 in chips) 
Seat 7: fool_rabbit ($55.12 in chips) 
Seat 9: Mmago24 ($50 in chips) 
Nestle170: posts small blind $0.25
fool_rabbit: posts big blind $0.50
*** HOLE CARDS ***
Mmago24: folds 
Dihabet: raises $0.85 to $1.35
v.sting: folds 
$lavik88: folds 
WarllocK1982: folds 
Nestle170: folds 
fool_rabbit: folds 
Uncalled bet ($0.85) returned to Dihabet
Dihabet collected $1.25 from pot
Dihabet: doesn't show hand 
*** SUMMARY ***
Total pot $1.25 | Rake $0 
Seat 1: Dihabet collected ($1.25)
Seat 2: v.sting folded before Flop (didn't bet)
Seat 4: $lavik88 folded before Flop (didn't bet)
Seat 5: WarllocK1982 (button) folded before Flop (didn't bet)
Seat 6: Nestle170 (small blind) folded before Flop
Seat 7: fool_rabbit (big blind) folded before Flop
Seat 9: Mmago24 folded before Flop (didn't bet)



PokerStars Hand #228686018123:  Hold'em No Limit ($0.25/$0.50 USD) - 2021/07/30 14:57:43 ET
Table 'Galilea III' 9-max Seat #6 is the button
Seat 1: Dihabet ($53.20 in chips) 
Seat 2: v.sting ($50 in chips) 
Seat 4: $lavik88 ($50.75 in chips) 
Seat 5: WarllocK1982 ($50 in chips) 
Seat 6: Nestle170 ($50 in chips) 
Seat 7: fool_rabbit ($54.62 in chips) 
Seat 9: Mmago24 ($50 in chips) 
fool_rabbit: posts small blind $0.25
Mmago24: posts big blind $0.50
*** HOLE CARDS ***
Dihabet: folds 
v.sting: folds 
$lavik88: folds 
WarllocK1982: folds 
Nestle170: folds 
fool_rabbit: raises $1 to $1.50
Mmago24: folds 
Uncalled bet ($1) returned to fool_rabbit
fool_rabbit collected $1 from pot
fool_rabbit: doesn't show hand 
*** SUMMARY ***
Total pot $1 | Rake $0 
Seat 1: Dihabet folded before Flop (didn't bet)
Seat 2: v.sting folded before Flop (didn't bet)
Seat 4: $lavik88 folded before Flop (didn't bet)
Seat 5: WarllocK1982 folded before Flop (didn't bet)
Seat 6: Nestle170 (button) folded before Flop (didn't bet)
Seat 7: fool_rabbit (small blind) collected ($1)
Seat 9: Mmago24 (big blind) folded before Flop



PokerStars Hand #228686026497:  Hold'em No Limit ($0.25/$0.50 USD) - 2021/07/30 14:58:09 ET
Table 'Galilea III' 9-max Seat #7 is the button
Seat 1: Dihabet ($53.20 in chips) 
Seat 2: v.sting ($50 in chips) 
Seat 4: $lavik88 ($50.75 in chips) 
Seat 5: WarllocK1982 ($50 in chips) 
Seat 6: Nestle170 ($50 in chips) 
Seat 7: fool_rabbit ($55.12 in chips) 
Seat 9: Mmago24 ($50 in chips) 
Mmago24: posts small blind $0.25
Dihabet: posts big blind $0.50
*** HOLE CARDS ***
v.sting: folds 
$lavik88: folds 
WarllocK1982: folds 
Nestle170: folds 
fool_rabbit: folds 
Mmago24: folds 
Uncalled bet ($0.25) returned to Dihabet
Dihabet collected $0.50 from pot
Dihabet: doesn't show hand 
*** SUMMARY ***
Total pot $0.50 | Rake $0 
Seat 1: Dihabet (big blind) collected ($0.50)
Seat 2: v.sting folded before Flop (didn't bet)
Seat 4: $lavik88 folded before Flop (didn't bet)
Seat 5: WarllocK1982 folded before Flop (didn't bet)
Seat 6: Nestle170 folded before Flop (didn't bet)
Seat 7: fool_rabbit (button) folded before Flop (didn't bet)
Seat 9: Mmago24 (small blind) folded before Flop



PokerStars Hand #228686029515:  Hold'em No Limit ($0.25/$0.50 USD) - 2021/07/30 14:58:18 ET
Table 'Galilea III' 9-max Seat #9 is the button
Seat 1: Dihabet ($53.45 in chips) 
Seat 2: v.sting ($50 in chips) 
Seat 4: $lavik88 ($50.75 in chips) 
Seat 5: WarllocK1982 ($50 in chips) 
Seat 6: Nestle170 ($50 in chips) 
Seat 7: fool_rabbit ($55.12 in chips) 
Seat 9: Mmago24 ($50 in chips) 
Dihabet: posts small blind $0.25
v.sting: posts big blind $0.50
*** HOLE CARDS ***
se13giuum was removed from the table for failing to post
se13giuum leaves the table
$lavik88: folds 
WarllocK1982: raises $0.75 to $1.25
Nestle170: folds 
fool_rabbit: folds 
Mmago24: folds 
Dihabet: folds 
akbloger joins the table at seat #3 
v.sting: calls $0.75
*** FLOP *** [Kd Jd 6h]
v.sting: checks 
WarllocK1982: checks 
*** TURN *** [Kd Jd 6h] [Ac]
v.sting: bets $0.86
WarllocK1982: calls $0.86
*** RIVER *** [Kd Jd 6h Ac] [Ah]
v.sting: bets $3
WarllocK1982: raises $5 to $8
v.sting: calls $5
*** SHOW DOWN ***
WarllocK1982: shows [6s As] (a full house, Aces full of Sixes)
v.sting: mucks hand 
WarllocK1982 collected $19.45 from pot
*** SUMMARY ***
Total pot $20.47 | Rake $1.02 
Board [Kd Jd 6h Ac Ah]
Seat 1: Dihabet (small blind) folded before Flop
Seat 2: v.sting (big blind) mucked
Seat 4: $lavik88 folded before Flop (didn't bet)
Seat 5: WarllocK1982 showed [6s As] and won ($19.45) with a full house, Aces full of Sixes
Seat 6: Nestle170 folded before Flop (didn't bet)
Seat 7: fool_rabbit folded before Flop (didn't bet)
Seat 9: Mmago24 (button) folded before Flop (didn't bet)



PokerStars Hand #228686048155:  Hold'em No Limit ($0.25/$0.50 USD) - 2021/07/30 14:59:16 ET
Table 'Galilea III' 9-max Seat #1 is the button
Seat 1: Dihabet ($53.20 in chips) 
Seat 2: v.sting ($50 in chips) 
Seat 3: akbloger ($50 in chips) 
Seat 4: $lavik88 ($50.75 in chips) 
Seat 5: WarllocK1982 ($59.34 in chips) 
Seat 6: Nestle170 ($50 in chips) 
Seat 7: fool_rabbit ($55.12 in chips) 
Seat 8: m11k1989 ($52.73 in chips) 
Seat 9: Mmago24 ($50 in chips) 
v.sting: posts small blind $0.25
akbloger: posts big blind $0.50
m11k1989: posts small & big blinds $0.75
*** HOLE CARDS ***
$lavik88: raises $2 to $2.50
WarllocK1982: folds 
Nestle170: folds 
fool_rabbit: folds 
m11k1989: folds 
Mmago24: folds 
Dihabet: folds 
v.sting: folds 
akbloger: folds 
Uncalled bet ($2) returned to $lavik88
$lavik88 collected $2 from pot
$lavik88: doesn't show hand 
*** SUMMARY ***
Total pot $2 | Rake $0 
Seat 1: Dihabet (button) folded before Flop (didn't bet)
Seat 2: v.sting (small blind) folded before Flop
Seat 3: akbloger (big blind) folded before Flop
Seat 4: $lavik88 collected ($2)
Seat 5: WarllocK1982 folded before Flop (didn't bet)
Seat 6: Nestle170 folded before Flop (didn't bet)
Seat 7: fool_rabbit folded before Flop (didn't bet)
Seat 8: m11k1989 folded before Flop (didn't bet)
Seat 9: Mmago24 folded before Flop (didn't bet)



PokerStars Hand #228686061341:  Hold'em No Limit ($0.25/$0.50 USD) - 2021/07/30 14:59:57 ET
Table 'Galilea III' 9-max Seat #2 is the button
Seat 1: Dihabet ($53.20 in chips) 
Seat 2: v.sting ($50 in chips) 
Seat 3: akbloger ($50 in chips) 
Seat 4: $lavik88 ($52.25 in chips) 
Seat 5: WarllocK1982 ($59.34 in chips) 
Seat 6: Nestle170 ($50 in chips) 
Seat 7: fool_rabbit ($55.12 in chips) 
Seat 8: m11k1989 ($51.98 in chips) 
Seat 9: Mmago24 ($50 in chips) 
akbloger: posts small blind $0.25
$lavik88: posts big blind $0.50
*** HOLE CARDS ***
WarllocK1982: folds 
Nestle170: folds 
fool_rabbit: folds 
m11k1989: calls $0.50
Mmago24: raises $1.25 to $1.75
Dihabet: folds 
v.sting: folds 
akbloger: folds 
$lavik88: folds 
m11k1989: calls $1.25
*** FLOP *** [Kh Kd 5s]
m11k1989: bets $0.50
Mmago24: calls $0.50
*** TURN *** [Kh Kd 5s] [2c]
m11k1989: bets $1.50
Mmago24: folds 
Uncalled bet ($1.50) returned to m11k1989
m11k1989 collected $4.99 from pot
m11k1989: doesn't show hand 
*** SUMMARY ***
Total pot $5.25 | Rake $0.26 
Board [Kh Kd 5s 2c]
Seat 1: Dihabet folded before Flop (didn't bet)
Seat 2: v.sting (button) folded before Flop (didn't bet)
Seat 3: akbloger (small blind) folded before Flop
Seat 4: $lavik88 (big blind) folded before Flop
Seat 5: WarllocK1982 folded before Flop (didn't bet)
Seat 6: Nestle170 folded before Flop (didn't bet)
Seat 7: fool_rabbit folded before Flop (didn't bet)
Seat 8: m11k1989 collected ($4.99)
Seat 9: Mmago24 folded on the Turn



PokerStars Hand #228686077837:  Hold'em No Limit ($0.25/$0.50 USD) - 2021/07/30 15:00:46 ET
Table 'Galilea III' 9-max Seat #3 is the button
Seat 1: Dihabet ($53.20 in chips) 
Seat 2: v.sting ($50 in chips) 
Seat 3: akbloger ($50 in chips) 
Seat 4: $lavik88 ($51.75 in chips) 
Seat 5: WarllocK1982 ($59.34 in chips) 
Seat 6: Nestle170 ($50 in chips) 
Seat 7: fool_rabbit ($55.12 in chips) 
Seat 8: m11k1989 ($54.72 in chips) 
Seat 9: Mmago24 ($50 in chips) 
$lavik88: posts small blind $0.25
WarllocK1982: posts big blind $0.50
*** HOLE CARDS ***
Nestle170: folds 
fool_rabbit: folds 
m11k1989: folds 
Mmago24: folds 
Dihabet: folds 
v.sting: raises $0.75 to $1.25
akbloger: folds 
$lavik88: raises $3.75 to $5
WarllocK1982: folds 
v.sting: calls $3.75
*** FLOP *** [Th 9h Kh]
$lavik88: bets $2.99
v.sting: raises $9.01 to $12
$lavik88: raises $34.75 to $46.75 and is all-in
v.sting: calls $33 and is all-in
Uncalled bet ($1.75) returned to $lavik88
v.sting:  
$lavik88:  
*** TURN *** [Th 9h Kh] [4h]
*** RIVER *** [Th 9h Kh 4h] [6c]
*** SHOW DOWN ***
$lavik88: shows [9d 9c] (three of a kind, Nines)
v.sting: shows [Tc Td] (three of a kind, Tens)
v.sting collected $98.50 from pot
*** SUMMARY ***
Total pot $100.50 | Rake $2 
Board [Th 9h Kh 4h 6c]
Seat 1: Dihabet folded before Flop (didn't bet)
Seat 2: v.sting showed [Tc Td] and won ($98.50) with three of a kind, Tens
Seat 3: akbloger (button) folded before Flop (didn't bet)
Seat 4: $lavik88 (small blind) showed [9d 9c] and lost with three of a kind, Nines
Seat 5: WarllocK1982 (big blind) folded before Flop
Seat 6: Nestle170 folded before Flop (didn't bet)
Seat 7: fool_rabbit folded before Flop (didn't bet)
Seat 8: m11k1989 folded before Flop (didn't bet)
Seat 9: Mmago24 folded before Flop (didn't bet)



PokerStars Hand #228686112026:  Hold'em No Limit ($0.25/$0.50 USD) - 2021/07/30 15:02:07 ET
Table 'Galilea III' 9-max Seat #4 is the button
Seat 1: Dihabet ($53.20 in chips) 
Seat 2: v.sting ($98.50 in chips) 
Seat 3: akbloger ($50 in chips) 
Seat 4: $lavik88 ($50 in chips) 
Seat 5: WarllocK1982 ($58.84 in chips) 
Seat 6: Nestle170 ($50 in chips) 
Seat 7: fool_rabbit ($55.12 in chips) 
Seat 8: m11k1989 ($54.72 in chips) 
Seat 9: Mmago24 ($50 in chips) 
WarllocK1982: posts small blind $0.25
Nestle170: posts big blind $0.50
*** HOLE CARDS ***
fool_rabbit: raises $1 to $1.50
m11k1989: calls $1.50
Mmago24: folds 
Dihabet: folds 
v.sting: folds 
akbloger: folds 
$lavik88: folds 
WarllocK1982: folds 
Nestle170: folds 
*** FLOP *** [7c 6d Jh]
fool_rabbit: bets $1.78
m11k1989: folds 
Uncalled bet ($1.78) returned to fool_rabbit
fool_rabbit collected $3.56 from pot
fool_rabbit: doesn't show hand 
*** SUMMARY ***
Total pot $3.75 | Rake $0.19 
Board [7c 6d Jh]
Seat 1: Dihabet folded before Flop (didn't bet)
Seat 2: v.sting folded before Flop (didn't bet)
Seat 3: akbloger folded before Flop (didn't bet)
Seat 4: $lavik88 (button) folded before Flop (didn't bet)
Seat 5: WarllocK1982 (small blind) folded before Flop
Seat 6: Nestle170 (big blind) folded before Flop
Seat 7: fool_rabbit collected ($3.56)
Seat 8: m11k1989 folded on the Flop
Seat 9: Mmago24 folded before Flop (didn't bet)



PokerStars Hand #228686122125:  Hold'em No Limit ($0.25/$0.50 USD) - 2021/07/30 15:02:32 ET
Table 'Galilea III' 9-max Seat #5 is the button
Seat 1: Dihabet ($53.20 in chips) 
Seat 2: v.sting ($98.50 in chips) 
Seat 3: akbloger ($50 in chips) 
Seat 4: $lavik88 ($50 in chips) 
Seat 5: WarllocK1982 ($58.59 in chips) 
Seat 6: Nestle170 ($50 in chips) 
Seat 7: fool_rabbit ($57.18 in chips) 
Seat 8: m11k1989 ($53.22 in chips) 
Seat 9: Mmago24 ($50 in chips) 
Nestle170: posts small blind $0.25
fool_rabbit: posts big blind $0.50
*** HOLE CARDS ***
m11k1989: calls $0.50
Mmago24: folds 
Dihabet: folds 
v.sting: folds 
akbloger: folds 
$lavik88: folds 
WarllocK1982: folds 
Nestle170: folds 
fool_rabbit: raises $2 to $2.50
m11k1989: calls $2
*** FLOP *** [Ah Qc As]
fool_rabbit: checks 
m11k1989: bets $1.50
fool_rabbit: calls $1.50
*** TURN *** [Ah Qc As] [8d]
fool_rabbit: checks 
m11k1989: checks 
*** RIVER *** [Ah Qc As 8d] [3h]
fool_rabbit: checks 
m11k1989: checks 
*** SHOW DOWN ***
fool_rabbit: shows [Qd Ac] (a full house, Aces full of Queens)
m11k1989: mucks hand 
fool_rabbit collected $7.84 from pot
*** SUMMARY ***
Total pot $8.25 | Rake $0.41 
Board [Ah Qc As 8d 3h]
Seat 1: Dihabet folded before Flop (didn't bet)
Seat 2: v.sting folded before Flop (didn't bet)
Seat 3: akbloger folded before Flop (didn't bet)
Seat 4: $lavik88 folded before Flop (didn't bet)
Seat 5: WarllocK1982 (button) folded before Flop (didn't bet)
Seat 6: Nestle170 (small blind) folded before Flop
Seat 7: fool_rabbit (big blind) showed [Qd Ac] and won ($7.84) with a full house, Aces full of Queens
Seat 8: m11k1989 mucked
Seat 9: Mmago24 folded before Flop (didn't bet)



PokerStars Hand #228685273260:  Hold'em No Limit ($0.25/$0.50 USD) - 2021/07/30 14:28:18 ET
Table 'Galilea III' 9-max Seat #6 is the button
Seat 1: Dihabet ($50 in chips) 
Seat 2: dstrola ($53.82 in chips) 
Seat 3: se13giuum ($41.51 in chips) 
Seat 4: saschaWITT ($19.92 in chips) 
Seat 6: PleBeY95 ($60.89 in chips) 
Seat 9: Nestle170 ($52.95 in chips) 
Nestle170: posts small blind $0.25
Dihabet: posts big blind $0.50
*** HOLE CARDS ***
dstrola has timed out
dstrola: folds 
se13giuum: raises $1 to $1.50
saschaWITT: folds 
dstrola leaves the table
PleBeY95: folds 
Nestle170: folds 
Dihabet: folds 
Uncalled bet ($1) returned to se13giuum
se13giuum collected $1.25 from pot
se13giuum: doesn't show hand 
*** SUMMARY ***
Total pot $1.25 | Rake $0 
Seat 1: Dihabet (big blind) folded before Flop
Seat 2: dstrola folded before Flop (didn't bet)
Seat 3: se13giuum collected ($1.25)
Seat 4: saschaWITT folded before Flop (didn't bet)
Seat 6: PleBeY95 (button) folded before Flop (didn't bet)
Seat 9: Nestle170 (small blind) folded before Flop



PokerStars Hand #228685282108:  Hold'em No Limit ($0.25/$0.50 USD) - 2021/07/30 14:28:40 ET
Table 'Galilea III' 9-max Seat #9 is the button
Seat 1: Dihabet ($50 in chips) 
Seat 3: se13giuum ($42.26 in chips) 
Seat 4: saschaWITT ($19.92 in chips) 
Seat 6: PleBeY95 ($60.89 in chips) 
Seat 9: Nestle170 ($52.70 in chips) 
Dihabet: posts small blind $0.25
se13giuum: posts big blind $0.50
MarsMiland: sits out 
*** HOLE CARDS ***
saschaWITT: folds 
PleBeY95: folds 
Nestle170: folds 
Dihabet: folds 
Uncalled bet ($0.25) returned to se13giuum
se13giuum collected $0.50 from pot
se13giuum: doesn't show hand 
*** SUMMARY ***
Total pot $0.50 | Rake $0 
Seat 1: Dihabet (small blind) folded before Flop
Seat 3: se13giuum (big blind) collected ($0.50)
Seat 4: saschaWITT folded before Flop (didn't bet)
Seat 6: PleBeY95 folded before Flop (didn't bet)
Seat 9: Nestle170 (button) folded before Flop (didn't bet)



PokerStars Hand #228685284618:  Hold'em No Limit ($0.25/$0.50 USD) - 2021/07/30 14:28:45 ET
Table 'Galilea III' 9-max Seat #1 is the button
Seat 1: Dihabet ($50 in chips) 
Seat 3: se13giuum ($42.51 in chips) 
Seat 4: saschaWITT ($19.92 in chips) 
Seat 6: PleBeY95 ($60.89 in chips) 
Seat 9: Nestle170 ($52.70 in chips) 
se13giuum: posts small blind $0.25
saschaWITT: posts big blind $0.50
MarsMiland: sits out 
*** HOLE CARDS ***
PleBeY95: folds 
Nestle170: folds 
Pachebrash leaves the table
Dihabet: folds 
Xamil666 joins the table at seat #7 
PleBeY95 leaves the table
se13giuum: folds 
Uncalled bet ($0.25) returned to saschaWITT
saschaWITT collected $0.50 from pot
saschaWITT: doesn't show hand 
Nestle170 leaves the table
*** SUMMARY ***
Total pot $0.50 | Rake $0 
Seat 1: Dihabet (button) folded before Flop (didn't bet)
Seat 3: se13giuum (small blind) folded before Flop
Seat 4: saschaWITT (big blind) collected ($0.50)
Seat 6: PleBeY95 folded before Flop (didn't bet)
Seat 9: Nestle170 folded before Flop (didn't bet)



PokerStars Hand #228685294439:  Hold'em No Limit ($0.25/$0.50 USD) - 2021/07/30 14:29:09 ET
Table 'Galilea III' 9-max Seat #3 is the button
Seat 1: Dihabet ($50 in chips) 
Seat 3: se13giuum ($42.26 in chips) 
Seat 4: saschaWITT ($20.17 in chips) 
Seat 7: Xamil666 ($50 in chips) 
saschaWITT: posts small blind $0.25
Xamil666: posts big blind $0.50
MarsMiland: sits out 
*** HOLE CARDS ***
Dihabet: folds 
Nestle170 joins the table at seat #6 
se13giuum: folds 
saschaWITT: folds 
Uncalled bet ($0.25) returned to Xamil666
Xamil666 collected $0.50 from pot
*** SUMMARY ***
Total pot $0.50 | Rake $0 
Seat 1: Dihabet folded before Flop (didn't bet)
Seat 3: se13giuum (button) folded before Flop (didn't bet)
Seat 4: saschaWITT (small blind) folded before Flop
Seat 7: Xamil666 (big blind) collected ($0.50)



PokerStars Hand #228685300073:  Hold'em No Limit ($0.25/$0.50 USD) - 2021/07/30 14:29:22 ET
Table 'Galilea III' 9-max Seat #4 is the button
Seat 1: Dihabet ($50 in chips) 
Seat 3: se13giuum ($42.26 in chips) 
Seat 4: saschaWITT ($19.92 in chips) 
Seat 7: Xamil666 ($50.25 in chips) 
Seat 8: MarsMiland ($50 in chips) 
Xamil666: posts small blind $0.25
MarsMiland: posts big blind $0.50
*** HOLE CARDS ***
Dihabet: raises $0.85 to $1.35
se13giuum: folds 
saschaWITT: calls $1.35
Xamil666: folds 
MarsMiland: folds 
*** FLOP *** [8c As Qd]
Dihabet: checks 
saschaWITT: checks 
*** TURN *** [8c As Qd] [Tc]
Dihabet: checks 
saschaWITT: bets $0.50
Mmago24 joins the table at seat #9 
Dihabet: calls $0.50
*** RIVER *** [8c As Qd Tc] [Qc]
Dihabet: bets $4.23
saschaWITT: folds 
Uncalled bet ($4.23) returned to Dihabet
Dihabet collected $4.23 from pot
Dihabet: doesn't show hand 
*** SUMMARY ***
Total pot $4.45 | Rake $0.22 
Board [8c As Qd Tc Qc]
Seat 1: Dihabet collected ($4.23)
Seat 3: se13giuum folded before Flop (didn't bet)
Seat 4: saschaWITT (button) folded on the River
Seat 7: Xamil666 (small blind) folded before Flop
Seat 8: MarsMiland (big blind) folded before Flop



PokerStars Hand #228685319611:  Hold'em No Limit ($0.25/$0.50 USD) - 2021/07/30 14:30:08 ET
Table 'Galilea III' 9-max Seat #7 is the button
Seat 1: Dihabet ($52.38 in chips) 
Seat 3: se13giuum ($42.26 in chips) 
Seat 4: saschaWITT ($18.07 in chips) 
Seat 7: Xamil666 ($50 in chips) 
Seat 8: MarsMiland ($50 in chips) 
Seat 9: Mmago24 ($50 in chips) 
MarsMiland: posts small blind $0.25
Mmago24: posts big blind $0.50
Nestle170: sits out 
*** HOLE CARDS ***
Dihabet: folds 
se13giuum: folds 
saschaWITT: folds 
Xamil666: folds 
MarsMiland: raises $0.75 to $1.25
Mmago24: folds 
Uncalled bet ($0.75) returned to MarsMiland
MarsMiland collected $1 from pot
MarsMiland: doesn't show hand 
*** SUMMARY ***
Total pot $1 | Rake $0 
Seat 1: Dihabet folded before Flop (didn't bet)
Seat 3: se13giuum folded before Flop (didn't bet)
Seat 4: saschaWITT folded before Flop (didn't bet)
Seat 7: Xamil666 (button) folded before Flop (didn't bet)
Seat 8: MarsMiland (small blind) collected ($1)
Seat 9: Mmago24 (big blind) folded before Flop



PokerStars Hand #228685325980:  Hold'em No Limit ($0.25/$0.50 USD) - 2021/07/30 14:30:23 ET
Table 'Galilea III' 9-max Seat #8 is the button
Seat 1: Dihabet ($52.38 in chips) 
Seat 3: se13giuum ($42.26 in chips) 
Seat 4: saschaWITT ($18.07 in chips) 
Seat 7: Xamil666 ($50 in chips) 
Seat 8: MarsMiland ($50.50 in chips) 
Seat 9: Mmago24 ($50 in chips) 
Mmago24: posts small blind $0.25
Dihabet: posts big blind $0.50
Nestle170: sits out 
*** HOLE CARDS ***
se13giuum: calls $0.50
saschaWITT: folds 
Xamil666: folds 
MarsMiland: folds 
Mmago24: raises $2 to $2.50
Dihabet: folds 
se13giuum: folds 
Uncalled bet ($2) returned to Mmago24
Mmago24 collected $1.50 from pot
Mmago24: doesn't show hand 
*** SUMMARY ***
Total pot $1.50 | Rake $0 
Seat 1: Dihabet (big blind) folded before Flop
Seat 3: se13giuum folded before Flop
Seat 4: saschaWITT folded before Flop (didn't bet)
Seat 7: Xamil666 folded before Flop (didn't bet)
Seat 8: MarsMiland (button) folded before Flop (didn't bet)
Seat 9: Mmago24 (small blind) collected ($1.50)



PokerStars Hand #228685332385:  Hold'em No Limit ($0.25/$0.50 USD) - 2021/07/30 14:30:38 ET
Table 'Galilea III' 9-max Seat #9 is the button
Seat 1: Dihabet ($51.88 in chips) 
Seat 3: se13giuum ($41.76 in chips) 
Seat 4: saschaWITT ($18.07 in chips) 
Seat 7: Xamil666 ($50 in chips) 
Seat 8: MarsMiland ($50.50 in chips) 
Seat 9: Mmago24 ($51 in chips) 
Dihabet: posts small blind $0.25
se13giuum: posts big blind $0.50
Nestle170: sits out 
*** HOLE CARDS ***
saschaWITT: folds 
Xamil666: folds 
MarsMiland: folds 
Mmago24: folds 
Dihabet: folds 
Uncalled bet ($0.25) returned to se13giuum
se13giuum collected $0.50 from pot
se13giuum: doesn't show hand 
*** SUMMARY ***
Total pot $0.50 | Rake $0 
Seat 1: Dihabet (small blind) folded before Flop
Seat 3: se13giuum (big blind) collected ($0.50)
Seat 4: saschaWITT folded before Flop (didn't bet)
Seat 7: Xamil666 folded before Flop (didn't bet)
Seat 8: MarsMiland folded before Flop (didn't bet)
Seat 9: Mmago24 (button) folded before Flop (didn't bet)



PokerStars Hand #228685336768:  Hold'em No Limit ($0.25/$0.50 USD) - 2021/07/30 14:30:49 ET
Table 'Galilea III' 9-max Seat #1 is the button
Seat 1: Dihabet ($51.63 in chips) 
Seat 3: se13giuum ($42.01 in chips) 
Seat 4: saschaWITT ($18.07 in chips) 
Seat 7: Xamil666 ($50 in chips) 
Seat 8: MarsMiland ($50.50 in chips) 
Seat 9: Mmago24 ($51 in chips) 
se13giuum: posts small blind $0.25
saschaWITT: posts big blind $0.50
Nestle170: sits out 
*** HOLE CARDS ***
Xamil666: folds 
MarsMiland: raises $0.80 to $1.30
Mmago24: folds 
Dihabet: folds 
se13giuum: folds 
saschaWITT: folds 
Uncalled bet ($0.80) returned to MarsMiland
MarsMiland collected $1.25 from pot
MarsMiland: doesn't show hand 
*** SUMMARY ***
Total pot $1.25 | Rake $0 
Seat 1: Dihabet (button) folded before Flop (didn't bet)
Seat 3: se13giuum (small blind) folded before Flop
Seat 4: saschaWITT (big blind) folded before Flop
Seat 7: Xamil666 folded before Flop (didn't bet)
Seat 8: MarsMiland collected ($1.25)
Seat 9: Mmago24 folded before Flop (didn't bet)



PokerStars Hand #228685343894:  Hold'em No Limit ($0.25/$0.50 USD) - 2021/07/30 14:31:05 ET
Table 'Galilea III' 9-max Seat #3 is the button
Seat 1: Dihabet ($51.63 in chips) 
Seat 3: se13giuum ($41.76 in chips) 
Seat 4: saschaWITT ($17.57 in chips) 
Seat 6: Nestle170 ($52.70 in chips) 
Seat 7: Xamil666 ($50 in chips) 
Seat 8: MarsMiland ($51.25 in chips) 
Seat 9: Mmago24 ($51 in chips) 
saschaWITT: posts small blind $0.25
Nestle170: posts big blind $0.50
*** HOLE CARDS ***
Xamil666: folds 
MarsMiland: folds 
Mmago24: folds 
Dihabet: folds 
se13giuum: folds 
saschaWITT: folds 
Uncalled bet ($0.25) returned to Nestle170
Nestle170 collected $0.50 from pot
Nestle170: doesn't show hand 
*** SUMMARY ***
Total pot $0.50 | Rake $0 
Seat 1: Dihabet folded before Flop (didn't bet)
Seat 3: se13giuum (button) folded before Flop (didn't bet)
Seat 4: saschaWITT (small blind) folded before Flop
Seat 6: Nestle170 (big blind) collected ($0.50)
Seat 7: Xamil666 folded before Flop (didn't bet)
Seat 8: MarsMiland folded before Flop (didn't bet)
Seat 9: Mmago24 folded before Flop (didn't bet)



PokerStars Hand #228685349048:  Hold'em No Limit ($0.25/$0.50 USD) - 2021/07/30 14:31:17 ET
Table 'Galilea III' 9-max Seat #4 is the button
Seat 1: Dihabet ($51.63 in chips) 
Seat 3: se13giuum ($41.76 in chips) 
Seat 4: saschaWITT ($17.32 in chips) 
Seat 6: Nestle170 ($52.95 in chips) 
Seat 7: Xamil666 ($50 in chips) 
Seat 8: MarsMiland ($51.25 in chips) 
Seat 9: Mmago24 ($51 in chips) 
Nestle170: posts small blind $0.25
Xamil666: posts big blind $0.50
*** HOLE CARDS ***
MarsMiland: folds 
Mmago24: folds 
Dihabet: raises $0.85 to $1.35
se13giuum: folds 
saschaWITT: calls $1.35
Nestle170: folds 
Xamil666: folds 
*** FLOP *** [2c 5h 6h]
Dihabet: bets $2.13
saschaWITT: raises $2.13 to $4.26
Dihabet: raises $7.67 to $11.93
saschaWITT: raises $4.04 to $15.97 and is all-in
Dihabet: calls $4.04
*** FIRST TURN *** [2c 5h 6h] [5s]
*** FIRST RIVER *** [2c 5h 6h 5s] [Js]
*** SECOND TURN *** [2c 5h 6h] [Tc]
*** SECOND RIVER *** [2c 5h 6h Tc] [7d]
*** FIRST SHOW DOWN ***
Dihabet: shows [Kh Kd] (two pair, Kings and Fives)
saschaWITT: shows [7h 6d] (two pair, Sixes and Fives)
Dihabet collected $16.81 from pot
*** SECOND SHOW DOWN ***
Dihabet: shows [Kh Kd] (a pair of Kings)
saschaWITT: shows [7h 6d] (two pair, Sevens and Sixes)
saschaWITT collected $16.59 from pot
*** SUMMARY ***
Total pot $35.39 | Rake $1.99 
Hand was run twice
FIRST Board [2c 5h 6h 5s Js]
SECOND Board [2c 5h 6h Tc 7d]
Seat 1: Dihabet showed [Kh Kd] and won ($16.81) with two pair, Kings and Fives, and lost with a pair of Kings
Seat 3: se13giuum folded before Flop (didn't bet)
Seat 4: saschaWITT (button) showed [7h 6d] and lost with two pair, Sixes and Fives, and won ($16.59) with two pair, Sevens and Sixes
Seat 6: Nestle170 (small blind) folded before Flop
Seat 7: Xamil666 (big blind) folded before Flop
Seat 8: MarsMiland folded before Flop (didn't bet)
Seat 9: Mmago24 folded before Flop (didn't bet)



PokerStars Hand #228685361055:  Hold'em No Limit ($0.25/$0.50 USD) - 2021/07/30 14:31:45 ET
Table 'Galilea III' 9-max Seat #6 is the button
Seat 1: Dihabet ($51.12 in chips) 
Seat 3: se13giuum ($41.76 in chips) 
Seat 4: saschaWITT ($16.59 in chips) 
Seat 6: Nestle170 ($52.70 in chips) 
Seat 7: Xamil666 ($50 in chips) 
Seat 8: MarsMiland ($51.25 in chips) 
Seat 9: Mmago24 ($51 in chips) 
Xamil666: posts small blind $0.25
MarsMiland: posts big blind $0.50
*** HOLE CARDS ***
Mmago24: folds 
Dihabet: folds 
se13giuum: folds 
saschaWITT: folds 
Nestle170: folds 
Xamil666: folds 
Uncalled bet ($0.25) returned to MarsMiland
MarsMiland collected $0.50 from pot
MarsMiland: doesn't show hand 
*** SUMMARY ***
Total pot $0.50 | Rake $0 
Seat 1: Dihabet folded before Flop (didn't bet)
Seat 3: se13giuum folded before Flop (didn't bet)
Seat 4: saschaWITT folded before Flop (didn't bet)
Seat 6: Nestle170 (button) folded before Flop (didn't bet)
Seat 7: Xamil666 (small blind) folded before Flop
Seat 8: MarsMiland (big blind) collected ($0.50)
Seat 9: Mmago24 folded before Flop (didn't bet)



PokerStars Hand #228685371784:  Hold'em No Limit ($0.25/$0.50 USD) - 2021/07/30 14:32:11 ET
Table 'Galilea III' 9-max Seat #7 is the button
Seat 1: Dihabet ($51.12 in chips) 
Seat 3: se13giuum ($41.76 in chips) 
Seat 4: saschaWITT ($16.59 in chips) 
Seat 6: Nestle170 ($52.70 in chips) 
Seat 7: Xamil666 ($50 in chips) 
Seat 8: MarsMiland ($51.50 in chips) 
Seat 9: Mmago24 ($51 in chips) 
MarsMiland: posts small blind $0.25
Mmago24: posts big blind $0.50
*** HOLE CARDS ***
Dihabet: folds 
se13giuum: folds 
saschaWITT: folds 
Nestle170: folds 
Xamil666: folds 
MarsMiland: raises $1 to $1.50
Mmago24: folds 
Uncalled bet ($1) returned to MarsMiland
MarsMiland collected $1 from pot
MarsMiland: doesn't show hand 
*** SUMMARY ***
Total pot $1 | Rake $0 
Seat 1: Dihabet folded before Flop (didn't bet)
Seat 3: se13giuum folded before Flop (didn't bet)
Seat 4: saschaWITT folded before Flop (didn't bet)
Seat 6: Nestle170 folded before Flop (didn't bet)
Seat 7: Xamil666 (button) folded before Flop (didn't bet)
Seat 8: MarsMiland (small blind) collected ($1)
Seat 9: Mmago24 (big blind) folded before Flop



PokerStars Hand #228685381851:  Hold'em No Limit ($0.25/$0.50 USD) - 2021/07/30 14:32:34 ET
Table 'Galilea III' 9-max Seat #8 is the button
Seat 1: Dihabet ($51.12 in chips) 
Seat 3: se13giuum ($41.76 in chips) 
Seat 4: saschaWITT ($16.59 in chips) 
Seat 6: Nestle170 ($52.70 in chips) 
Seat 7: Xamil666 ($50 in chips) 
Seat 8: MarsMiland ($52 in chips) 
Seat 9: Mmago24 ($50.50 in chips) 
Mmago24: posts small blind $0.25
Dihabet: posts big blind $0.50
*** HOLE CARDS ***
se13giuum has timed out
se13giuum: folds 
saschaWITT: folds 
Nestle170: folds 
Xamil666: folds 
MarsMiland: folds 
Zargmen joins the table at seat #2 
Mmago24: raises $1 to $1.50
Dihabet: calls $1
*** FLOP *** [3d 9s 8s]
Mmago24: checks 
Dihabet: bets $1.43
Mmago24: calls $1.43
*** TURN *** [3d 9s 8s] [7c]
Mmago24: checks 
Dihabet: checks 
*** RIVER *** [3d 9s 8s 7c] [9h]
Mmago24: checks 
Dihabet: checks 
*** SHOW DOWN ***
Mmago24: shows [Ts Ad] (a pair of Nines)
Dihabet: mucks hand 
Mmago24 collected $5.57 from pot
*** SUMMARY ***
Total pot $5.86 | Rake $0.29 
Board [3d 9s 8s 7c 9h]
Seat 1: Dihabet (big blind) mucked
Seat 3: se13giuum folded before Flop (didn't bet)
Seat 4: saschaWITT folded before Flop (didn't bet)
Seat 6: Nestle170 folded before Flop (didn't bet)
Seat 7: Xamil666 folded before Flop (didn't bet)
Seat 8: MarsMiland (button) folded before Flop (didn't bet)
Seat 9: Mmago24 (small blind) showed [Ts Ad] and won ($5.57) with a pair of Nines



PokerStars Hand #228685407299:  Hold'em No Limit ($0.25/$0.50 USD) - 2021/07/30 14:33:34 ET
Table 'Galilea III' 9-max Seat #9 is the button
Seat 1: Dihabet ($50 in chips) 
Seat 2: Zargmen ($20.21 in chips) 
Seat 3: se13giuum ($41.76 in chips) 
Seat 4: saschaWITT ($16.59 in chips) 
Seat 6: Nestle170 ($52.70 in chips) 
Seat 7: Xamil666 ($50 in chips) 
Seat 8: MarsMiland ($52 in chips) 
Seat 9: Mmago24 ($53.14 in chips) 
Dihabet: posts small blind $0.25
Zargmen: posts big blind $0.50
*** HOLE CARDS ***
se13giuum has timed out
se13giuum: folds 
saschaWITT: raises $0.50 to $1
Nestle170: folds 
Xamil666: folds 
MarsMiland: folds 
Mmago24: folds 
Dihabet: folds 
Zargmen: calls $0.50
*** FLOP *** [Ad Qd 8c]
Zargmen: checks 
saschaWITT: checks 
*** TURN *** [Ad Qd 8c] [3h]
Zargmen: checks 
saschaWITT: checks 
*** RIVER *** [Ad Qd 8c 3h] [7d]
Zargmen: checks 
saschaWITT: bets $2.14
saschaWITT is disconnected 
Zargmen: raises $3.86 to $6
saschaWITT is connected 
saschaWITT: folds 
Uncalled bet ($3.86) returned to Zargmen
Zargmen collected $6.20 from pot
Zargmen: doesn't show hand 
*** SUMMARY ***
Total pot $6.53 | Rake $0.33 
Board [Ad Qd 8c 3h 7d]
Seat 1: Dihabet (small blind) folded before Flop
Seat 2: Zargmen (big blind) collected ($6.20)
Seat 3: se13giuum folded before Flop (didn't bet)
Seat 4: saschaWITT folded on the River
Seat 6: Nestle170 folded before Flop (didn't bet)
Seat 7: Xamil666 folded before Flop (didn't bet)
Seat 8: MarsMiland folded before Flop (didn't bet)
Seat 9: Mmago24 (button) folded before Flop (didn't bet)



PokerStars Hand #228685441273:  Hold'em No Limit ($0.25/$0.50 USD) - 2021/07/30 14:34:55 ET
Table 'Galilea III' 9-max Seat #1 is the button
Seat 1: Dihabet ($50 in chips) 
Seat 2: Zargmen ($23.27 in chips) 
Seat 3: se13giuum ($41.76 in chips) 
Seat 4: saschaWITT ($13.45 in chips) 
Seat 6: Nestle170 ($52.70 in chips) 
Seat 7: Xamil666 ($50 in chips) 
Seat 8: MarsMiland ($52 in chips) 
Seat 9: Mmago24 ($53.14 in chips) 
Zargmen: posts small blind $0.25
se13giuum: posts big blind $0.50
*** HOLE CARDS ***
saschaWITT: calls $0.50
Nestle170: raises $1.50 to $2
Xamil666: folds 
MarsMiland: folds 
Mmago24: folds 
Dihabet: folds 
Zargmen: folds 
se13giuum: folds 
saschaWITT: calls $1.50
*** FLOP *** [Ah Qh 9s]
saschaWITT: checks 
Nestle170: checks 
*** TURN *** [Ah Qh 9s] [6d]
saschaWITT: bets $0.50
Nestle170: calls $0.50
*** RIVER *** [Ah Qh 9s 6d] [Jd]
saschaWITT: checks 
Nestle170: bets $4.10
saschaWITT: calls $4.10
*** SHOW DOWN ***
Nestle170: shows [Ks Ts] (a straight, Ten to Ace)
saschaWITT: mucks hand 
Nestle170 collected $13.25 from pot
*** SUMMARY ***
Total pot $13.95 | Rake $0.70 
Board [Ah Qh 9s 6d Jd]
Seat 1: Dihabet (button) folded before Flop (didn't bet)
Seat 2: Zargmen (small blind) folded before Flop
Seat 3: se13giuum (big blind) folded before Flop
Seat 4: saschaWITT mucked
Seat 6: Nestle170 showed [Ks Ts] and won ($13.25) with a straight, Ten to Ace
Seat 7: Xamil666 folded before Flop (didn't bet)
Seat 8: MarsMiland folded before Flop (didn't bet)
Seat 9: Mmago24 folded before Flop (didn't bet)



PokerStars Hand #228685488119:  Hold'em No Limit ($0.25/$0.50 USD) - 2021/07/30 14:36:46 ET
Table 'Galilea III' 9-max Seat #4 is the button
Seat 1: Dihabet ($50 in chips) 
Seat 2: Zargmen ($23.02 in chips) 
Seat 4: saschaWITT ($6.60 in chips) 
Seat 5: dikanmax ($61.82 in chips) 
Seat 6: Nestle170 ($59.35 in chips) 
Seat 7: Xamil666 ($50 in chips) 
Seat 8: MarsMiland ($62.88 in chips) 
Seat 9: Mmago24 ($53.14 in chips) 
dikanmax: posts small blind $0.25
Nestle170: posts big blind $0.50
*** HOLE CARDS ***
Xamil666: folds 
MarsMiland: folds 
Mmago24: folds 
Dihabet: raises $0.85 to $1.35
Zargmen: folds 
saschaWITT: folds 
dikanmax: folds 
Nestle170: calls $0.85
*** FLOP *** [6c 7d 4s]
Nestle170: checks 
Dihabet: checks 
*** TURN *** [6c 7d 4s] [2c]
Nestle170: checks 
Dihabet: checks 
*** RIVER *** [6c 7d 4s 2c] [8c]
Nestle170: checks 
Dihabet: checks 
*** SHOW DOWN ***
Nestle170: shows [Jc Kd] (high card King)
Dihabet: shows [3c 3h] (a pair of Threes)
Dihabet collected $2.80 from pot
*** SUMMARY ***
Total pot $2.95 | Rake $0.15 
Board [6c 7d 4s 2c 8c]
Seat 1: Dihabet showed [3c 3h] and won ($2.80) with a pair of Threes
Seat 2: Zargmen folded before Flop (didn't bet)
Seat 4: saschaWITT (button) folded before Flop (didn't bet)
Seat 5: dikanmax (small blind) folded before Flop
Seat 6: Nestle170 (big blind) showed [Jc Kd] and lost with high card King
Seat 7: Xamil666 folded before Flop (didn't bet)
Seat 8: MarsMiland folded before Flop (didn't bet)
Seat 9: Mmago24 folded before Flop (didn't bet)



PokerStars Hand #228685506666:  Hold'em No Limit ($0.25/$0.50 USD) - 2021/07/30 14:37:29 ET
Table 'Galilea III' 9-max Seat #5 is the button
Seat 1: Dihabet ($51.45 in chips) 
Seat 2: Zargmen ($23.02 in chips) 
Seat 4: saschaWITT ($6.60 in chips) 
Seat 5: dikanmax ($61.57 in chips) 
Seat 6: Nestle170 ($58 in chips) 
Seat 7: Xamil666 ($50 in chips) 
Seat 8: MarsMiland ($62.88 in chips) 
Seat 9: Mmago24 ($53.14 in chips) 
Nestle170: posts small blind $0.25
Xamil666: posts big blind $0.50
*** HOLE CARDS ***
MarsMiland: folds 
Mmago24: raises $0.72 to $1.22
Dihabet: folds 
Zargmen: folds 
saschaWITT: folds 
dikanmax: folds 
Nestle170: raises $3.78 to $5
Xamil666: folds 
Mmago24: calls $3.78
*** FLOP *** [Ac 5s Td]
Nestle170: checks 
Mmago24: checks 
*** TURN *** [Ac 5s Td] [5d]
Nestle170: checks 
Mmago24: checks 
*** RIVER *** [Ac 5s Td 5d] [Ah]
Nestle170: bets $3.29
Mmago24: calls $3.29
*** SHOW DOWN ***
Nestle170: shows [Qh Qd] (two pair, Aces and Queens)
Mmago24: mucks hand 
Nestle170 collected $16.23 from pot
*** SUMMARY ***
Total pot $17.08 | Rake $0.85 
Board [Ac 5s Td 5d Ah]
Seat 1: Dihabet folded before Flop (didn't bet)
Seat 2: Zargmen folded before Flop (didn't bet)
Seat 4: saschaWITT folded before Flop (didn't bet)
Seat 5: dikanmax (button) folded before Flop (didn't bet)
Seat 6: Nestle170 (small blind) showed [Qh Qd] and won ($16.23) with two pair, Aces and Queens
Seat 7: Xamil666 (big blind) folded before Flop
Seat 8: MarsMiland folded before Flop (didn't bet)
Seat 9: Mmago24 mucked



PokerStars Hand #228686150506:  Hold'em No Limit ($0.25/$0.50 USD) - 2021/07/30 15:03:37 ET
Table 'Galilea III' 9-max Seat #6 is the button
Seat 1: Dihabet ($53.20 in chips) 
Seat 2: v.sting ($98.50 in chips) 
Seat 3: akbloger ($50 in chips) 
Seat 4: $lavik88 ($50 in chips) 
Seat 5: WarllocK1982 ($58.59 in chips) 
Seat 6: Nestle170 ($50 in chips) 
Seat 7: fool_rabbit ($61.02 in chips) 
Seat 8: m11k1989 ($49.22 in chips) 
Seat 9: Mmago24 ($50 in chips) 
fool_rabbit: posts small blind $0.25
m11k1989: posts big blind $0.50
*** HOLE CARDS ***
Mmago24: raises $0.72 to $1.22
Dihabet: folds 
v.sting: folds 
akbloger: folds 
$lavik88: folds 
WarllocK1982: folds 
Nestle170: folds 
fool_rabbit: folds 
m11k1989: calls $0.72
*** FLOP *** [6s 7c Kh]
m11k1989: checks 
Mmago24: bets $0.84
m11k1989: calls $0.84
*** TURN *** [6s 7c Kh] [Ac]
m11k1989: bets $0.50
Mmago24: raises $2 to $2.50
m11k1989: folds 
Uncalled bet ($2) returned to Mmago24
Mmago24 collected $5.10 from pot
Mmago24: doesn't show hand 
*** SUMMARY ***
Total pot $5.37 | Rake $0.27 
Board [6s 7c Kh Ac]
Seat 1: Dihabet folded before Flop (didn't bet)
Seat 2: v.sting folded before Flop (didn't bet)
Seat 3: akbloger folded before Flop (didn't bet)
Seat 4: $lavik88 folded before Flop (didn't bet)
Seat 5: WarllocK1982 folded before Flop (didn't bet)
Seat 6: Nestle170 (button) folded before Flop (didn't bet)
Seat 7: fool_rabbit (small blind) folded before Flop
Seat 8: m11k1989 (big blind) folded on the Turn
Seat 9: Mmago24 collected ($5.10)



PokerStars Hand #228686174258:  Hold'em No Limit ($0.25/$0.50 USD) - 2021/07/30 15:04:30 ET
Table 'Galilea III' 9-max Seat #7 is the button
Seat 1: Dihabet ($53.20 in chips) 
Seat 2: v.sting ($98.50 in chips) 
Seat 3: akbloger ($50 in chips) 
Seat 4: $lavik88 ($50 in chips) 
Seat 5: WarllocK1982 ($58.59 in chips) 
Seat 6: Nestle170 ($50 in chips) 
Seat 7: fool_rabbit ($60.77 in chips) 
Seat 8: m11k1989 ($46.66 in chips) 
m11k1989: posts small blind $0.25
Mmago24: is sitting out 
Dihabet: posts big blind $0.50
*** HOLE CARDS ***
v.sting: folds 
akbloger: folds 
$lavik88: folds 
WarllocK1982: folds 
Nestle170: raises $0.75 to $1.25
fool_rabbit: folds 
m11k1989: folds 
Dihabet: folds 
Uncalled bet ($0.75) returned to Nestle170
Nestle170 collected $1.25 from pot
Nestle170: doesn't show hand 
*** SUMMARY ***
Total pot $1.25 | Rake $0 
Seat 1: Dihabet (big blind) folded before Flop
Seat 2: v.sting folded before Flop (didn't bet)
Seat 3: akbloger folded before Flop (didn't bet)
Seat 4: $lavik88 folded before Flop (didn't bet)
Seat 5: WarllocK1982 folded before Flop (didn't bet)
Seat 6: Nestle170 collected ($1.25)
Seat 7: fool_rabbit (button) folded before Flop (didn't bet)
Seat 8: m11k1989 (small blind) folded before Flop



PokerStars Hand #228686186924:  Hold'em No Limit ($0.25/$0.50 USD) - 2021/07/30 15:04:59 ET
Table 'Galilea III' 9-max Seat #8 is the button
Seat 1: Dihabet ($52.70 in chips) 
Seat 2: v.sting ($98.50 in chips) 
Seat 3: akbloger ($50 in chips) 
Seat 4: $lavik88 ($50 in chips) 
Seat 5: WarllocK1982 ($58.59 in chips) 
Seat 6: Nestle170 ($50.75 in chips) 
Seat 7: fool_rabbit ($60.77 in chips) 
Seat 8: m11k1989 ($46.41 in chips) 
Dihabet: posts small blind $0.25
v.sting: posts big blind $0.50
*** HOLE CARDS ***
akbloger: raises $1 to $1.50
$lavik88: folds 
WarllocK1982: folds 
Nestle170: folds 
fool_rabbit: folds 
m11k1989: calls $1.50
Dihabet: folds 
v.sting: folds 
*** FLOP *** [6c 8c 2s]
akbloger: bets $2.67
m11k1989: calls $2.67
*** TURN *** [6c 8c 2s] [7s]
akbloger: checks 
m11k1989: bets $2
akbloger: calls $2
*** RIVER *** [6c 8c 2s 7s] [4h]
akbloger: checks 
m11k1989: bets $12.44
akbloger: folds 
Uncalled bet ($12.44) returned to m11k1989
m11k1989 collected $12.44 from pot
m11k1989: doesn't show hand 
*** SUMMARY ***
Total pot $13.09 | Rake $0.65 
Board [6c 8c 2s 7s 4h]
Seat 1: Dihabet (small blind) folded before Flop
Seat 2: v.sting (big blind) folded before Flop
Seat 3: akbloger folded on the River
Seat 4: $lavik88 folded before Flop (didn't bet)
Seat 5: WarllocK1982 folded before Flop (didn't bet)
Seat 6: Nestle170 folded before Flop (didn't bet)
Seat 7: fool_rabbit folded before Flop (didn't bet)
Seat 8: m11k1989 (button) collected ($12.44)



PokerStars Hand #228686215753:  Hold'em No Limit ($0.25/$0.50 USD) - 2021/07/30 15:05:52 ET
Table 'Galilea III' 9-max Seat #1 is the button
Seat 1: Dihabet ($52.45 in chips) 
Seat 2: v.sting ($98 in chips) 
Seat 3: akbloger ($50 in chips) 
Seat 4: $lavik88 ($50 in chips) 
Seat 5: WarllocK1982 ($58.59 in chips) 
Seat 6: Nestle170 ($50.75 in chips) 
Seat 7: fool_rabbit ($60.77 in chips) 
Seat 8: m11k1989 ($52.68 in chips) 
v.sting: posts small blind $0.25
akbloger: posts big blind $0.50
*** HOLE CARDS ***
$lavik88: folds 
WarllocK1982: folds 
Nestle170: folds 
fool_rabbit: folds 
m11k1989: calls $0.50
Dihabet: folds 
v.sting: raises $2.50 to $3
akbloger: folds 
m11k1989: folds 
Uncalled bet ($2.50) returned to v.sting
v.sting collected $1.50 from pot
v.sting: doesn't show hand 
*** SUMMARY ***
Total pot $1.50 | Rake $0 
Seat 1: Dihabet (button) folded before Flop (didn't bet)
Seat 2: v.sting (small blind) collected ($1.50)
Seat 3: akbloger (big blind) folded before Flop
Seat 4: $lavik88 folded before Flop (didn't bet)
Seat 5: WarllocK1982 folded before Flop (didn't bet)
Seat 6: Nestle170 folded before Flop (didn't bet)
Seat 7: fool_rabbit folded before Flop (didn't bet)
Seat 8: m11k1989 folded before Flop



PokerStars Hand #228686226623:  Hold'em No Limit ($0.25/$0.50 USD) - 2021/07/30 15:06:16 ET
Table 'Galilea III' 9-max Seat #2 is the button
Seat 1: Dihabet ($52.45 in chips) 
Seat 2: v.sting ($99 in chips) 
Seat 3: akbloger ($50 in chips) 
Seat 4: $lavik88 ($50 in chips) 
Seat 5: WarllocK1982 ($58.59 in chips) 
Seat 6: Nestle170 ($50.75 in chips) 
Seat 7: fool_rabbit ($60.77 in chips) 
Seat 8: m11k1989 ($52.18 in chips) 
akbloger: posts small blind $0.25
$lavik88: posts big blind $0.50
Mmago24: sits out 
*** HOLE CARDS ***
WarllocK1982: folds 
Nestle170: folds 
fool_rabbit: folds 
m11k1989: folds 
Dihabet: folds 
v.sting: folds 
akbloger: folds 
Uncalled bet ($0.25) returned to $lavik88
$lavik88 collected $0.50 from pot
$lavik88: doesn't show hand 
*** SUMMARY ***
Total pot $0.50 | Rake $0 
Seat 1: Dihabet folded before Flop (didn't bet)
Seat 2: v.sting (button) folded before Flop (didn't bet)
Seat 3: akbloger (small blind) folded before Flop
Seat 4: $lavik88 (big blind) collected ($0.50)
Seat 5: WarllocK1982 folded before Flop (didn't bet)
Seat 6: Nestle170 folded before Flop (didn't bet)
Seat 7: fool_rabbit folded before Flop (didn't bet)
Seat 8: m11k1989 folded before Flop (didn't bet)



PokerStars Hand #228686236744:  Hold'em No Limit ($0.25/$0.50 USD) - 2021/07/30 15:06:38 ET
Table 'Galilea III' 9-max Seat #3 is the button
Seat 1: Dihabet ($52.45 in chips) 
Seat 2: v.sting ($99 in chips) 
Seat 3: akbloger ($50 in chips) 
Seat 4: $lavik88 ($50.25 in chips) 
Seat 5: WarllocK1982 ($58.59 in chips) 
Seat 6: Nestle170 ($50.75 in chips) 
Seat 7: fool_rabbit ($60.77 in chips) 
Seat 8: m11k1989 ($52.18 in chips) 
$lavik88: posts small blind $0.25
WarllocK1982: posts big blind $0.50
Mmago24: sits out 
*** HOLE CARDS ***
Nestle170: folds 
fool_rabbit: raises $1 to $1.50
m11k1989: calls $1.50
Dihabet: folds 
v.sting: folds 
akbloger: calls $1.50
$lavik88: folds 
WarllocK1982: folds 
*** FLOP *** [8d Td 7h]
fool_rabbit: checks 
m11k1989: checks 
akbloger: bets $1.65
fool_rabbit: calls $1.65
m11k1989: folds 
*** TURN *** [8d Td 7h] [Th]
fool_rabbit: checks 
akbloger: checks 
*** RIVER *** [8d Td 7h Th] [9s]
fool_rabbit: bets $5
akbloger: folds 
Uncalled bet ($5) returned to fool_rabbit
fool_rabbit collected $8.12 from pot
fool_rabbit: doesn't show hand 
*** SUMMARY ***
Total pot $8.55 | Rake $0.43 
Board [8d Td 7h Th 9s]
Seat 1: Dihabet folded before Flop (didn't bet)
Seat 2: v.sting folded before Flop (didn't bet)
Seat 3: akbloger (button) folded on the River
Seat 4: $lavik88 (small blind) folded before Flop
Seat 5: WarllocK1982 (big blind) folded before Flop
Seat 6: Nestle170 folded before Flop (didn't bet)
Seat 7: fool_rabbit collected ($8.12)
Seat 8: m11k1989 folded on the Flop



PokerStars Hand #228686277910:  Hold'em No Limit ($0.25/$0.50 USD) - 2021/07/30 15:08:08 ET
Table 'Galilea III' 9-max Seat #4 is the button
Seat 1: Dihabet ($52.45 in chips) 
Seat 2: v.sting ($99 in chips) 
Seat 3: akbloger ($50 in chips) 
Seat 4: $lavik88 ($50 in chips) 
Seat 5: WarllocK1982 ($58.09 in chips) 
Seat 6: Nestle170 ($50.75 in chips) 
Seat 7: fool_rabbit ($65.74 in chips) 
Seat 8: m11k1989 ($50.68 in chips) 
WarllocK1982: posts small blind $0.25
Nestle170: posts big blind $0.50
Mmago24: sits out 
*** HOLE CARDS ***
fool_rabbit: folds 
m11k1989: calls $0.50
Dihabet: folds 
v.sting: folds 
akbloger: folds 
$lavik88: raises $1.50 to $2
WarllocK1982: folds 
Nestle170: folds 
m11k1989: calls $1.50
*** FLOP *** [5d 8s Qh]
m11k1989: bets $0.50
$lavik88: raises $2 to $2.50
m11k1989: folds 
Uncalled bet ($2) returned to $lavik88
$lavik88 collected $5.46 from pot
$lavik88: doesn't show hand 
*** SUMMARY ***
Total pot $5.75 | Rake $0.29 
Board [5d 8s Qh]
Seat 1: Dihabet folded before Flop (didn't bet)
Seat 2: v.sting folded before Flop (didn't bet)
Seat 3: akbloger folded before Flop (didn't bet)
Seat 4: $lavik88 (button) collected ($5.46)
Seat 5: WarllocK1982 (small blind) folded before Flop
Seat 6: Nestle170 (big blind) folded before Flop
Seat 7: fool_rabbit folded before Flop (didn't bet)
Seat 8: m11k1989 folded on the Flop



PokerStars Hand #228686296794:  Hold'em No Limit ($0.25/$0.50 USD) - 2021/07/30 15:08:49 ET
Table 'Galilea III' 9-max Seat #5 is the button
Seat 1: Dihabet ($52.45 in chips) 
Seat 2: v.sting ($99 in chips) 
Seat 3: akbloger ($50 in chips) 
Seat 4: $lavik88 ($52.96 in chips) 
Seat 5: WarllocK1982 ($57.84 in chips) 
Seat 6: Nestle170 ($50.25 in chips) 
Seat 8: m11k1989 ($48.18 in chips) 
Nestle170: posts small blind $0.25
fool_rabbit: is sitting out 
m11k1989: posts big blind $0.50
Mmago24: sits out 
*** HOLE CARDS ***
Dihabet: folds 
v.sting: folds 
akbloger: raises $0.75 to $1.25
$lavik88: folds 
WarllocK1982: folds 
Nestle170: folds 
m11k1989: folds 
Uncalled bet ($0.75) returned to akbloger
akbloger collected $1.25 from pot
akbloger: doesn't show hand 
*** SUMMARY ***
Total pot $1.25 | Rake $0 
Seat 1: Dihabet folded before Flop (didn't bet)
Seat 2: v.sting folded before Flop (didn't bet)
Seat 3: akbloger collected ($1.25)
Seat 4: $lavik88 folded before Flop (didn't bet)
Seat 5: WarllocK1982 (button) folded before Flop (didn't bet)
Seat 6: Nestle170 (small blind) folded before Flop
Seat 8: m11k1989 (big blind) folded before Flop



PokerStars Hand #228686304992:  Hold'em No Limit ($0.25/$0.50 USD) - 2021/07/30 15:09:07 ET
Table 'Galilea III' 9-max Seat #6 is the button
Seat 1: Dihabet ($52.45 in chips) 
Seat 2: v.sting ($99 in chips) 
Seat 3: akbloger ($50.75 in chips) 
Seat 4: $lavik88 ($52.96 in chips) 
Seat 5: WarllocK1982 ($57.84 in chips) 
Seat 6: Nestle170 ($50 in chips) 
Seat 8: m11k1989 ($47.68 in chips) 
Seat 9: Mmago24 ($52.54 in chips) 
m11k1989: posts small blind $0.25
Mmago24: posts big blind $0.50
*** HOLE CARDS ***
Dihabet: folds 
v.sting: folds 
akbloger: folds 
fool_rabbit leaves the table
$lavik88: folds 
WarllocK1982: raises $0.75 to $1.25
Nestle170: raises $3.25 to $4.50
m11k1989: folds 
Mmago24: folds 
WarllocK1982: folds 
Uncalled bet ($3.25) returned to Nestle170
Nestle170 collected $3.25 from pot
Nestle170: doesn't show hand 
*** SUMMARY ***
Total pot $3.25 | Rake $0 
Seat 1: Dihabet folded before Flop (didn't bet)
Seat 2: v.sting folded before Flop (didn't bet)
Seat 3: akbloger folded before Flop (didn't bet)
Seat 4: $lavik88 folded before Flop (didn't bet)
Seat 5: WarllocK1982 folded before Flop
Seat 6: Nestle170 (button) collected ($3.25)
Seat 8: m11k1989 (small blind) folded before Flop
Seat 9: Mmago24 (big blind) folded before Flop



PokerStars Hand #228686317139:  Hold'em No Limit ($0.25/$0.50 USD) - 2021/07/30 15:09:33 ET
Table 'Galilea III' 9-max Seat #8 is the button
Seat 1: Dihabet ($52.45 in chips) 
Seat 2: v.sting ($99 in chips) 
Seat 3: akbloger ($50.75 in chips) 
Seat 4: $lavik88 ($52.96 in chips) 
Seat 5: WarllocK1982 ($56.59 in chips) 
Seat 6: Nestle170 ($52 in chips) 
Seat 8: m11k1989 ($47.43 in chips) 
Seat 9: Mmago24 ($52.04 in chips) 
Mmago24: posts small blind $0.25
Dihabet: posts big blind $0.50
*** HOLE CARDS ***
danthaur joins the table at seat #7 
v.sting: folds 
akbloger: raises $1 to $1.50
$lavik88: folds 
WarllocK1982: folds 
Nestle170: folds 
m11k1989: folds 
Mmago24: folds 
Dihabet: folds 
Uncalled bet ($1) returned to akbloger
akbloger collected $1.25 from pot
akbloger: doesn't show hand 
*** SUMMARY ***
Total pot $1.25 | Rake $0 
Seat 1: Dihabet (big blind) folded before Flop
Seat 2: v.sting folded before Flop (didn't bet)
Seat 3: akbloger collected ($1.25)
Seat 4: $lavik88 folded before Flop (didn't bet)
Seat 5: WarllocK1982 folded before Flop (didn't bet)
Seat 6: Nestle170 folded before Flop (didn't bet)
Seat 8: m11k1989 (button) folded before Flop (didn't bet)
Seat 9: Mmago24 (small blind) folded before Flop



PokerStars Hand #228686346045:  Hold'em No Limit ($0.25/$0.50 USD) - 2021/07/30 15:10:36 ET
Table 'Galilea III' 9-max Seat #9 is the button
Seat 1: Dihabet ($51.95 in chips) 
Seat 2: v.sting ($99 in chips) 
Seat 3: akbloger ($51.50 in chips) 
Seat 4: $lavik88 ($52.96 in chips) 
Seat 5: WarllocK1982 ($56.59 in chips) 
Seat 6: Nestle170 ($52 in chips) 
Seat 8: m11k1989 ($47.43 in chips) 
Seat 9: Mmago24 ($51.79 in chips) 
Dihabet: posts small blind $0.25
v.sting: posts big blind $0.50
danthaur: sits out 
*** HOLE CARDS ***
akbloger: folds 
$lavik88: folds 
WarllocK1982: folds 
Nestle170: folds 
m11k1989: calls $0.50
Mmago24: folds 
Dihabet: raises $1.50 to $2
v.sting: calls $1.50
m11k1989: calls $1.50
*** FLOP *** [4c Ah Ks]
Dihabet: bets $1.71
v.sting: calls $1.71
m11k1989: folds 
*** TURN *** [4c Ah Ks] [Qc]
Dihabet: bets $4
v.sting: calls $4
*** RIVER *** [4c Ah Ks Qc] [3s]
Dihabet: bets $7.50
v.sting: folds 
Uncalled bet ($7.50) returned to Dihabet
Dihabet collected $16.55 from pot
Dihabet: doesn't show hand 
*** SUMMARY ***
Total pot $17.42 | Rake $0.87 
Board [4c Ah Ks Qc 3s]
Seat 1: Dihabet (small blind) collected ($16.55)
Seat 2: v.sting (big blind) folded on the River
Seat 3: akbloger folded before Flop (didn't bet)
Seat 4: $lavik88 folded before Flop (didn't bet)
Seat 5: WarllocK1982 folded before Flop (didn't bet)
Seat 6: Nestle170 folded before Flop (didn't bet)
Seat 8: m11k1989 folded on the Flop
Seat 9: Mmago24 (button) folded before Flop (didn't bet)



PokerStars Hand #228686395191:  Hold'em No Limit ($0.25/$0.50 USD) - 2021/07/30 15:12:22 ET
Table 'Galilea III' 9-max Seat #1 is the button
Seat 1: Dihabet ($60.79 in chips) 
Seat 2: v.sting ($91.29 in chips) 
Seat 3: akbloger ($51.50 in chips) 
Seat 4: $lavik88 ($52.96 in chips) 
Seat 5: WarllocK1982 ($56.59 in chips) 
Seat 6: Nestle170 ($52 in chips) 
Seat 8: m11k1989 ($45.43 in chips) 
Seat 9: Mmago24 ($51.79 in chips) 
v.sting: posts small blind $0.25
akbloger: posts big blind $0.50
danthaur: sits out 
*** HOLE CARDS ***
$lavik88: raises $1 to $1.50
WarllocK1982: folds 
Nestle170: folds 
m11k1989: folds 
Mmago24: folds 
Dihabet: folds 
v.sting: folds 
akbloger: folds 
Uncalled bet ($1) returned to $lavik88
$lavik88 collected $1.25 from pot
$lavik88: doesn't show hand 
*** SUMMARY ***
Total pot $1.25 | Rake $0 
Seat 1: Dihabet (button) folded before Flop (didn't bet)
Seat 2: v.sting (small blind) folded before Flop
Seat 3: akbloger (big blind) folded before Flop
Seat 4: $lavik88 collected ($1.25)
Seat 5: WarllocK1982 folded before Flop (didn't bet)
Seat 6: Nestle170 folded before Flop (didn't bet)
Seat 8: m11k1989 folded before Flop (didn't bet)
Seat 9: Mmago24 folded before Flop (didn't bet)



PokerStars Hand #228686405920:  Hold'em No Limit ($0.25/$0.50 USD) - 2021/07/30 15:12:45 ET
Table 'Galilea III' 9-max Seat #2 is the button
Seat 1: Dihabet ($60.79 in chips) 
Seat 2: v.sting ($91.04 in chips) 
Seat 3: akbloger ($51 in chips) 
Seat 4: $lavik88 ($53.71 in chips) 
Seat 5: WarllocK1982 ($56.59 in chips) 
Seat 6: Nestle170 ($52 in chips) 
Seat 8: m11k1989 ($45.43 in chips) 
Seat 9: Mmago24 ($51.79 in chips) 
akbloger: posts small blind $0.25
$lavik88: posts big blind $0.50
danthaur: sits out 
*** HOLE CARDS ***
WarllocK1982: folds 
Nestle170: folds 
m11k1989: folds 
Mmago24: folds 
Dihabet: folds 
v.sting: folds 
akbloger: raises $1 to $1.50
$lavik88: calls $1
*** FLOP *** [6d Tc Kd]
akbloger: bets $0.94
$lavik88: calls $0.94
*** TURN *** [6d Tc Kd] [Qc]
akbloger: bets $3.48
$lavik88: calls $3.48
*** RIVER *** [6d Tc Kd Qc] [Jh]
akbloger: bets $8.44
$lavik88: folds 
Uncalled bet ($8.44) returned to akbloger
akbloger collected $11.25 from pot
akbloger: doesn't show hand 
*** SUMMARY ***
Total pot $11.84 | Rake $0.59 
Board [6d Tc Kd Qc Jh]
Seat 1: Dihabet folded before Flop (didn't bet)
Seat 2: v.sting (button) folded before Flop (didn't bet)
Seat 3: akbloger (small blind) collected ($11.25)
Seat 4: $lavik88 (big blind) folded on the River
Seat 5: WarllocK1982 folded before Flop (didn't bet)
Seat 6: Nestle170 folded before Flop (didn't bet)
Seat 8: m11k1989 folded before Flop (didn't bet)
Seat 9: Mmago24 folded before Flop (didn't bet)



PokerStars Hand #228686451718:  Hold'em No Limit ($0.25/$0.50 USD) - 2021/07/30 15:14:07 ET
Table 'Galilea III' 9-max Seat #3 is the button
Seat 1: Dihabet ($60.79 in chips) 
Seat 2: v.sting ($91.04 in chips) 
Seat 3: akbloger ($56.33 in chips) 
Seat 4: $lavik88 ($50 in chips) 
Seat 5: WarllocK1982 ($56.59 in chips) 
Seat 6: Nestle170 ($52 in chips) 
Seat 8: m11k1989 ($45.43 in chips) 
Seat 9: Mmago24 ($51.79 in chips) 
$lavik88: posts small blind $0.25
WarllocK1982: posts big blind $0.50
danthaur: sits out 
*** HOLE CARDS ***
Nestle170: folds 
m11k1989: calls $0.50
Mmago24: raises $1.75 to $2.25
Dihabet: folds 
v.sting has timed out
v.sting: folds 
akbloger: folds 
$lavik88: folds 
WarllocK1982: folds 
m11k1989: calls $1.75
*** FLOP *** [3s Ad 5h]
m11k1989: checks 
Mmago24: checks 
*** TURN *** [3s Ad 5h] [8c]
m11k1989: bets $2.50
Mmago24: calls $2.50
*** RIVER *** [3s Ad 5h 8c] [Ah]
m11k1989: bets $4.50
Mmago24: calls $4.50
*** SHOW DOWN ***
m11k1989: shows [4h 6s] (a pair of Aces)
Mmago24: shows [9h 9s] (two pair, Aces and Nines)
Mmago24 collected $18.29 from pot
*** SUMMARY ***
Total pot $19.25 | Rake $0.96 
Board [3s Ad 5h 8c Ah]
Seat 1: Dihabet folded before Flop (didn't bet)
Seat 2: v.sting folded before Flop (didn't bet)
Seat 3: akbloger (button) folded before Flop (didn't bet)
Seat 4: $lavik88 (small blind) folded before Flop
Seat 5: WarllocK1982 (big blind) folded before Flop
Seat 6: Nestle170 folded before Flop (didn't bet)
Seat 8: m11k1989 showed [4h 6s] and lost with a pair of Aces
Seat 9: Mmago24 showed [9h 9s] and won ($18.29) with two pair, Aces and Nines



PokerStars Hand #228686487415:  Hold'em No Limit ($0.25/$0.50 USD) - 2021/07/30 15:15:24 ET
Table 'Galilea III' 9-max Seat #4 is the button
Seat 1: Dihabet ($60.79 in chips) 
Seat 2: v.sting ($91.04 in chips) 
Seat 3: akbloger ($56.33 in chips) 
Seat 4: $lavik88 ($50 in chips) 
Seat 5: WarllocK1982 ($56.09 in chips) 
Seat 6: Nestle170 ($52 in chips) 
Seat 8: m11k1989 ($36.18 in chips) 
Seat 9: Mmago24 ($60.83 in chips) 
WarllocK1982: posts small blind $0.25
Nestle170: posts big blind $0.50
danthaur: sits out 
*** HOLE CARDS ***
m11k1989: calls $0.50
Mmago24: folds 
Dihabet: folds 
v.sting: raises $2 to $2.50
akbloger: folds 
$lavik88: folds 
WarllocK1982: folds 
Nestle170: folds 
m11k1989: folds 
Uncalled bet ($2) returned to v.sting
v.sting collected $1.75 from pot
v.sting: doesn't show hand 
*** SUMMARY ***
Total pot $1.75 | Rake $0 
Seat 1: Dihabet folded before Flop (didn't bet)
Seat 2: v.sting collected ($1.75)
Seat 3: akbloger folded before Flop (didn't bet)
Seat 4: $lavik88 (button) folded before Flop (didn't bet)
Seat 5: WarllocK1982 (small blind) folded before Flop
Seat 6: Nestle170 (big blind) folded before Flop
Seat 8: m11k1989 folded before Flop
Seat 9: Mmago24 folded before Flop (didn't bet)



PokerStars Hand #228686499735:  Hold'em No Limit ($0.25/$0.50 USD) - 2021/07/30 15:15:50 ET
Table 'Galilea III' 9-max Seat #5 is the button
Seat 1: Dihabet ($60.79 in chips) 
Seat 2: v.sting ($92.29 in chips) 
Seat 3: akbloger ($56.33 in chips) 
Seat 4: $lavik88 ($50 in chips) 
Seat 5: WarllocK1982 ($55.84 in chips) 
Seat 6: Nestle170 ($51.50 in chips) 
Seat 7: danthaur ($50 in chips) 
Seat 8: m11k1989 ($35.68 in chips) 
Seat 9: Mmago24 ($60.83 in chips) 
Nestle170: posts small blind $0.25
danthaur: posts big blind $0.50
*** HOLE CARDS ***
m11k1989: raises $0.50 to $1
Mmago24: raises $2.50 to $3.50
Dihabet: folds 
v.sting: folds 
akbloger: folds 
$lavik88: folds 
WarllocK1982: folds 
Nestle170: folds 
danthaur: folds 
m11k1989: folds 
Uncalled bet ($2.50) returned to Mmago24
Mmago24 collected $2.75 from pot
Mmago24: doesn't show hand 
*** SUMMARY ***
Total pot $2.75 | Rake $0 
Seat 1: Dihabet folded before Flop (didn't bet)
Seat 2: v.sting folded before Flop (didn't bet)
Seat 3: akbloger folded before Flop (didn't bet)
Seat 4: $lavik88 folded before Flop (didn't bet)
Seat 5: WarllocK1982 (button) folded before Flop (didn't bet)
Seat 6: Nestle170 (small blind) folded before Flop
Seat 7: danthaur (big blind) folded before Flop
Seat 8: m11k1989 folded before Flop
Seat 9: Mmago24 collected ($2.75)



PokerStars Hand #228686517473:  Hold'em No Limit ($0.25/$0.50 USD) - 2021/07/30 15:16:28 ET
Table 'Galilea III' 9-max Seat #6 is the button
Seat 1: Dihabet ($60.79 in chips) 
Seat 2: v.sting ($92.29 in chips) 
Seat 3: akbloger ($56.33 in chips) 
Seat 4: $lavik88 ($50 in chips) 
Seat 5: WarllocK1982 ($55.84 in chips) 
Seat 6: Nestle170 ($51.25 in chips) 
Seat 7: danthaur ($50 in chips) 
Seat 8: m11k1989 ($34.68 in chips) 
Seat 9: Mmago24 ($62.58 in chips) 
danthaur: posts small blind $0.25
m11k1989: posts big blind $0.50
*** HOLE CARDS ***
Mmago24: folds 
Dihabet: folds 
v.sting has timed out
v.sting: folds 
akbloger: raises $0.75 to $1.25
$lavik88: folds 
WarllocK1982: folds 
Nestle170: folds 
danthaur: calls $1
m11k1989: calls $0.75
*** FLOP *** [3s 9c 2c]
danthaur: checks 
m11k1989: bets $3
akbloger: folds 
danthaur: folds 
Uncalled bet ($3) returned to m11k1989
m11k1989 collected $3.56 from pot
m11k1989: doesn't show hand 
*** SUMMARY ***
Total pot $3.75 | Rake $0.19 
Board [3s 9c 2c]
Seat 1: Dihabet folded before Flop (didn't bet)
Seat 2: v.sting folded before Flop (didn't bet)
Seat 3: akbloger folded on the Flop
Seat 4: $lavik88 folded before Flop (didn't bet)
Seat 5: WarllocK1982 folded before Flop (didn't bet)
Seat 6: Nestle170 (button) folded before Flop (didn't bet)
Seat 7: danthaur (small blind) folded on the Flop
Seat 8: m11k1989 (big blind) collected ($3.56)
Seat 9: Mmago24 folded before Flop (didn't bet)



PokerStars Hand #228686545072:  Hold'em No Limit ($0.25/$0.50 USD) - 2021/07/30 15:17:28 ET
Table 'Galilea III' 9-max Seat #7 is the button
Seat 1: Dihabet ($60.79 in chips) 
Seat 2: v.sting ($92.29 in chips) 
Seat 3: akbloger ($55.08 in chips) 
Seat 4: $lavik88 ($50 in chips) 
Seat 5: WarllocK1982 ($55.84 in chips) 
Seat 6: Nestle170 ($51.25 in chips) 
Seat 7: danthaur ($50 in chips) 
Seat 8: m11k1989 ($36.99 in chips) 
Seat 9: Mmago24 ($62.58 in chips) 
m11k1989: posts small blind $0.25
Mmago24: posts big blind $0.50
*** HOLE CARDS ***
Dihabet: folds 
v.sting has timed out
v.sting: folds 
akbloger: folds 
$lavik88: raises $1 to $1.50
WarllocK1982: folds 
Nestle170: folds 
danthaur: folds 
m11k1989: calls $1.25
Mmago24: folds 
*** FLOP *** [Ac Qs 8c]
m11k1989: bets $0.50
$lavik88: raises $1 to $1.50
m11k1989: calls $1
*** TURN *** [Ac Qs 8c] [9h]
m11k1989: checks 
$lavik88: bets $9
m11k1989: folds 
Uncalled bet ($9) returned to $lavik88
$lavik88 collected $6.18 from pot
$lavik88: doesn't show hand 
*** SUMMARY ***
Total pot $6.50 | Rake $0.32 
Board [Ac Qs 8c 9h]
Seat 1: Dihabet folded before Flop (didn't bet)
Seat 2: v.sting folded before Flop (didn't bet)
Seat 3: akbloger folded before Flop (didn't bet)
Seat 4: $lavik88 collected ($6.18)
Seat 5: WarllocK1982 folded before Flop (didn't bet)
Seat 6: Nestle170 folded before Flop (didn't bet)
Seat 7: danthaur (button) folded before Flop (didn't bet)
Seat 8: m11k1989 (small blind) folded on the Turn
Seat 9: Mmago24 (big blind) folded before Flop



PokerStars Hand #228686583793:  Hold'em No Limit ($0.25/$0.50 USD) - 2021/07/30 15:18:30 ET
Table 'Galilea III' 9-max Seat #8 is the button
Seat 1: Dihabet ($60.79 in chips) 
Seat 2: v.sting ($92.29 in chips) 
Seat 3: akbloger ($55.08 in chips) 
Seat 4: $lavik88 ($53.18 in chips) 
Seat 5: WarllocK1982 ($55.84 in chips) 
Seat 6: Nestle170 ($51.25 in chips) 
Seat 7: danthaur ($50 in chips) 
Seat 8: m11k1989 ($33.99 in chips) 
Seat 9: Mmago24 ($62.08 in chips) 
Mmago24: posts small blind $0.25
Dihabet: posts big blind $0.50
*** HOLE CARDS ***
v.sting: folds 
akbloger: folds 
$lavik88: folds 
WarllocK1982: raises $0.75 to $1.25
Nestle170: folds 
danthaur: folds 
m11k1989: calls $1.25
Mmago24: folds 
Dihabet: folds 
*** FLOP *** [4h Ts As]
WarllocK1982: bets $2.04
m11k1989: folds 
Uncalled bet ($2.04) returned to WarllocK1982
WarllocK1982 collected $3.09 from pot
*** SUMMARY ***
Total pot $3.25 | Rake $0.16 
Board [4h Ts As]
Seat 1: Dihabet (big blind) folded before Flop
Seat 2: v.sting folded before Flop (didn't bet)
Seat 3: akbloger folded before Flop (didn't bet)
Seat 4: $lavik88 folded before Flop (didn't bet)
Seat 5: WarllocK1982 collected ($3.09)
Seat 6: Nestle170 folded before Flop (didn't bet)
Seat 7: danthaur folded before Flop (didn't bet)
Seat 8: m11k1989 (button) folded on the Flop
Seat 9: Mmago24 (small blind) folded before Flop



PokerStars Hand #228686601524:  Hold'em No Limit ($0.25/$0.50 USD) - 2021/07/30 15:19:08 ET
Table 'Galilea III' 9-max Seat #9 is the button
Seat 1: Dihabet ($60.29 in chips) 
Seat 2: v.sting ($92.29 in chips) 
Seat 3: akbloger ($55.08 in chips) 
Seat 4: $lavik88 ($53.18 in chips) 
Seat 5: WarllocK1982 ($57.68 in chips) 
Seat 6: Nestle170 ($51.25 in chips) 
Seat 7: danthaur ($50 in chips) 
Seat 8: m11k1989 ($32.74 in chips) 
Seat 9: Mmago24 ($61.83 in chips) 
Dihabet: posts small blind $0.25
v.sting: posts big blind $0.50
*** HOLE CARDS ***
akbloger: folds 
$lavik88: folds 
WarllocK1982: folds 
Nestle170: folds 
danthaur: folds 
m11k1989: calls $0.50
Mmago24: folds 
Dihabet: folds 
v.sting has timed out
v.sting: checks 
*** FLOP *** [Ad Kc 7c]
v.sting: checks 
m11k1989: bets $0.50
v.sting: calls $0.50
*** TURN *** [Ad Kc 7c] [7d]
v.sting: checks 
m11k1989: bets $1.50
v.sting: calls $1.50
*** RIVER *** [Ad Kc 7c 7d] [6c]
v.sting: checks 
m11k1989: checks 
*** SHOW DOWN ***
v.sting: shows [Jh Ac] (two pair, Aces and Sevens)
m11k1989: mucks hand 
v.sting collected $4.99 from pot
*** SUMMARY ***
Total pot $5.25 | Rake $0.26 
Board [Ad Kc 7c 7d 6c]
Seat 1: Dihabet (small blind) folded before Flop
Seat 2: v.sting (big blind) showed [Jh Ac] and won ($4.99) with two pair, Aces and Sevens
Seat 3: akbloger folded before Flop (didn't bet)
Seat 4: $lavik88 folded before Flop (didn't bet)
Seat 5: WarllocK1982 folded before Flop (didn't bet)
Seat 6: Nestle170 folded before Flop (didn't bet)
Seat 7: danthaur folded before Flop (didn't bet)
Seat 8: m11k1989 mucked
Seat 9: Mmago24 (button) folded before Flop (didn't bet)



PokerStars Hand #228686641996:  Hold'em No Limit ($0.25/$0.50 USD) - 2021/07/30 15:20:34 ET
Table 'Galilea III' 9-max Seat #1 is the button
Seat 1: Dihabet ($60.04 in chips) 
Seat 2: v.sting ($94.78 in chips) 
Seat 3: akbloger ($55.08 in chips) 
Seat 4: $lavik88 ($53.18 in chips) 
Seat 5: WarllocK1982 ($57.68 in chips) 
Seat 6: Nestle170 ($51.25 in chips) 
Seat 7: danthaur ($50 in chips) 
Seat 8: m11k1989 ($30.24 in chips) 
Seat 9: Mmago24 ($61.83 in chips) 
v.sting: posts small blind $0.25
akbloger: posts big blind $0.50
*** HOLE CARDS ***
$lavik88: folds 
WarllocK1982: folds 
Nestle170: folds 
danthaur: folds 
m11k1989: folds 
Mmago24: folds 
Dihabet: folds 
v.sting: raises $1 to $1.50
akbloger: raises $3 to $4.50
v.sting: folds 
Uncalled bet ($3) returned to akbloger
akbloger collected $3 from pot
akbloger: doesn't show hand 
*** SUMMARY ***
Total pot $3 | Rake $0 
Seat 1: Dihabet (button) folded before Flop (didn't bet)
Seat 2: v.sting (small blind) folded before Flop
Seat 3: akbloger (big blind) collected ($3)
Seat 4: $lavik88 folded before Flop (didn't bet)
Seat 5: WarllocK1982 folded before Flop (didn't bet)
Seat 6: Nestle170 folded before Flop (didn't bet)
Seat 7: danthaur folded before Flop (didn't bet)
Seat 8: m11k1989 folded before Flop (didn't bet)
Seat 9: Mmago24 folded before Flop (didn't bet)



PokerStars Hand #228686654956:  Hold'em No Limit ($0.25/$0.50 USD) - 2021/07/30 15:21:01 ET
Table 'Galilea III' 9-max Seat #2 is the button
Seat 1: Dihabet ($60.04 in chips) 
Seat 2: v.sting ($93.28 in chips) 
Seat 3: akbloger ($56.58 in chips) 
Seat 4: $lavik88 ($53.18 in chips) 
Seat 5: WarllocK1982 ($57.68 in chips) 
Seat 6: Nestle170 ($51.25 in chips) 
Seat 7: danthaur ($50 in chips) 
Seat 8: m11k1989 ($30.24 in chips) 
Seat 9: Mmago24 ($61.83 in chips) 
akbloger: posts small blind $0.25
$lavik88: posts big blind $0.50
*** HOLE CARDS ***
WarllocK1982: folds 
Nestle170: raises $1 to $1.50
danthaur: folds 
m11k1989: folds 
Mmago24: folds 
Dihabet: folds 
v.sting: folds 
akbloger: folds 
$lavik88: folds 
Uncalled bet ($1) returned to Nestle170
Nestle170 collected $1.25 from pot
Nestle170: doesn't show hand 
*** SUMMARY ***
Total pot $1.25 | Rake $0 
Seat 1: Dihabet folded before Flop (didn't bet)
Seat 2: v.sting (button) folded before Flop (didn't bet)
Seat 3: akbloger (small blind) folded before Flop
Seat 4: $lavik88 (big blind) folded before Flop
Seat 5: WarllocK1982 folded before Flop (didn't bet)
Seat 6: Nestle170 collected ($1.25)
Seat 7: danthaur folded before Flop (didn't bet)
Seat 8: m11k1989 folded before Flop (didn't bet)
Seat 9: Mmago24 folded before Flop (didn't bet)



PokerStars Hand #228686664370:  Hold'em No Limit ($0.25/$0.50 USD) - 2021/07/30 15:21:22 ET
Table 'Galilea III' 9-max Seat #3 is the button
Seat 1: Dihabet ($60.04 in chips) 
Seat 2: v.sting ($93.28 in chips) 
Seat 3: akbloger ($56.33 in chips) 
Seat 4: $lavik88 ($52.68 in chips) 
Seat 5: WarllocK1982 ($57.68 in chips) 
Seat 6: Nestle170 ($52 in chips) 
Seat 7: danthaur ($50 in chips) 
Seat 8: m11k1989 ($30.24 in chips) 
Seat 9: Mmago24 ($61.83 in chips) 
$lavik88: posts small blind $0.25
WarllocK1982: posts big blind $0.50
*** HOLE CARDS ***
Nestle170: folds 
danthaur: folds 
m11k1989: calls $0.50
Mmago24: raises $1.75 to $2.25
Dihabet: folds 
v.sting: folds 
akbloger: folds 
$lavik88: raises $4.75 to $7
WarllocK1982: folds 
m11k1989: folds 
Mmago24: calls $4.75
*** FLOP *** [7d 9h 2h]
$lavik88: bets $4.28
Mmago24: raises $8.22 to $12.50
$lavik88: raises $33.18 to $45.68 and is all-in
Mmago24: calls $33.18
*** TURN *** [7d 9h 2h] [6s]
*** RIVER *** [7d 9h 2h 6s] [9s]
*** SHOW DOWN ***
$lavik88: shows [Qh Qs] (two pair, Queens and Nines)
Mmago24: shows [Js Jc] (two pair, Jacks and Nines)
$lavik88 collected $104.36 from pot
*** SUMMARY ***
Total pot $106.36 | Rake $2 
Board [7d 9h 2h 6s 9s]
Seat 1: Dihabet folded before Flop (didn't bet)
Seat 2: v.sting folded before Flop (didn't bet)
Seat 3: akbloger (button) folded before Flop (didn't bet)
Seat 4: $lavik88 (small blind) showed [Qh Qs] and won ($104.36) with two pair, Queens and Nines
Seat 5: WarllocK1982 (big blind) folded before Flop
Seat 6: Nestle170 folded before Flop (didn't bet)
Seat 7: danthaur folded before Flop (didn't bet)
Seat 8: m11k1989 folded before Flop
Seat 9: Mmago24 showed [Js Jc] and lost with two pair, Jacks and Nines



PokerStars Hand #228686712891:  Hold'em No Limit ($0.25/$0.50 USD) - 2021/07/30 15:23:06 ET
Table 'Galilea III' 9-max Seat #4 is the button
Seat 1: Dihabet ($60.04 in chips) 
Seat 2: v.sting ($93.28 in chips) 
Seat 3: akbloger ($56.33 in chips) 
Seat 4: $lavik88 ($104.36 in chips) 
Seat 5: WarllocK1982 ($57.18 in chips) 
Seat 6: Nestle170 ($52 in chips) 
Seat 7: danthaur ($50 in chips) 
Seat 8: m11k1989 ($29.74 in chips) 
Seat 9: Mmago24 ($50 in chips) 
WarllocK1982: posts small blind $0.25
Nestle170: posts big blind $0.50
*** HOLE CARDS ***
danthaur: folds 
m11k1989: calls $0.50
Mmago24: folds 
Dihabet: folds 
v.sting: raises $2 to $2.50
akbloger: folds 
$lavik88: folds 
WarllocK1982: folds 
Nestle170: folds 
m11k1989: calls $2
*** FLOP *** [8s 8h 7h]
m11k1989: bets $2.50
v.sting has timed out
v.sting: folds 
Uncalled bet ($2.50) returned to m11k1989
m11k1989 collected $5.46 from pot
m11k1989: doesn't show hand 
*** SUMMARY ***
Total pot $5.75 | Rake $0.29 
Board [8s 8h 7h]
Seat 1: Dihabet folded before Flop (didn't bet)
Seat 2: v.sting folded on the Flop
Seat 3: akbloger folded before Flop (didn't bet)
Seat 4: $lavik88 (button) folded before Flop (didn't bet)
Seat 5: WarllocK1982 (small blind) folded before Flop
Seat 6: Nestle170 (big blind) folded before Flop
Seat 7: danthaur folded before Flop (didn't bet)
Seat 8: m11k1989 collected ($5.46)
Seat 9: Mmago24 folded before Flop (didn't bet)



PokerStars Hand #228686739791:  Hold'em No Limit ($0.25/$0.50 USD) - 2021/07/30 15:24:04 ET
Table 'Galilea III' 9-max Seat #5 is the button
Seat 1: Dihabet ($60.04 in chips) 
Seat 2: v.sting ($90.78 in chips) 
Seat 3: akbloger ($56.33 in chips) 
Seat 4: $lavik88 ($104.36 in chips) 
Seat 5: WarllocK1982 ($56.93 in chips) 
Seat 6: Nestle170 ($51.50 in chips) 
Seat 7: danthaur ($50 in chips) 
Seat 8: m11k1989 ($32.70 in chips) 
Seat 9: Mmago24 ($50 in chips) 
Nestle170: posts small blind $0.25
danthaur: posts big blind $0.50
*** HOLE CARDS ***
m11k1989: calls $0.50
Mmago24: folds 
Dihabet: folds 
v.sting: folds 
akbloger: folds 
$lavik88: raises $1.50 to $2
WarllocK1982: folds 
Nestle170: folds 
danthaur: folds 
m11k1989: calls $1.50
*** FLOP *** [7c Th 6d]
m11k1989: bets $0.50
$lavik88: raises $3.03 to $3.53
m11k1989: folds 
Uncalled bet ($3.03) returned to $lavik88
$lavik88 collected $5.46 from pot
$lavik88: doesn't show hand 
*** SUMMARY ***
Total pot $5.75 | Rake $0.29 
Board [7c Th 6d]
Seat 1: Dihabet folded before Flop (didn't bet)
Seat 2: v.sting folded before Flop (didn't bet)
Seat 3: akbloger folded before Flop (didn't bet)
Seat 4: $lavik88 collected ($5.46)
Seat 5: WarllocK1982 (button) folded before Flop (didn't bet)
Seat 6: Nestle170 (small blind) folded before Flop
Seat 7: danthaur (big blind) folded before Flop
Seat 8: m11k1989 folded on the Flop
Seat 9: Mmago24 folded before Flop (didn't bet)



PokerStars Hand #228686756568:  Hold'em No Limit ($0.25/$0.50 USD) - 2021/07/30 15:24:41 ET
Table 'Galilea III' 9-max Seat #6 is the button
Seat 1: Dihabet ($60.04 in chips) 
Seat 2: v.sting ($90.78 in chips) 
Seat 3: akbloger ($56.33 in chips) 
Seat 4: $lavik88 ($107.32 in chips) 
Seat 5: WarllocK1982 ($56.93 in chips) 
Seat 6: Nestle170 ($51.25 in chips) 
Seat 7: danthaur ($50 in chips) 
Seat 8: m11k1989 ($30.20 in chips) 
Seat 9: Mmago24 ($50 in chips) 
danthaur: posts small blind $0.25
m11k1989: posts big blind $0.50
*** HOLE CARDS ***
Mmago24: folds 
Dihabet: folds 
v.sting: folds 
akbloger: folds 
$lavik88: folds 
WarllocK1982: folds 
Nestle170: folds 
danthaur: folds 
Uncalled bet ($0.25) returned to m11k1989
m11k1989 collected $0.50 from pot
m11k1989: doesn't show hand 
*** SUMMARY ***
Total pot $0.50 | Rake $0 
Seat 1: Dihabet folded before Flop (didn't bet)
Seat 2: v.sting folded before Flop (didn't bet)
Seat 3: akbloger folded before Flop (didn't bet)
Seat 4: $lavik88 folded before Flop (didn't bet)
Seat 5: WarllocK1982 folded before Flop (didn't bet)
Seat 6: Nestle170 (button) folded before Flop (didn't bet)
Seat 7: danthaur (small blind) folded before Flop
Seat 8: m11k1989 (big blind) collected ($0.50)
Seat 9: Mmago24 folded before Flop (didn't bet)



PokerStars Hand #228686766463:  Hold'em No Limit ($0.25/$0.50 USD) - 2021/07/30 15:25:02 ET
Table 'Galilea III' 9-max Seat #7 is the button
Seat 1: Dihabet ($60.04 in chips) 
Seat 2: v.sting ($90.78 in chips) 
Seat 3: akbloger ($56.33 in chips) 
Seat 4: $lavik88 ($107.32 in chips) 
Seat 5: WarllocK1982 ($56.93 in chips) 
Seat 6: Nestle170 ($51.25 in chips) 
Seat 7: danthaur ($50 in chips) 
Seat 8: m11k1989 ($30.45 in chips) 
Seat 9: Mmago24 ($50 in chips) 
m11k1989: posts small blind $0.25
Mmago24: posts big blind $0.50
*** HOLE CARDS ***
Dihabet: folds 
v.sting: folds 
akbloger: folds 
$lavik88: folds 
WarllocK1982: folds 
Nestle170: folds 
danthaur: raises $0.75 to $1.25
m11k1989: folds 
Mmago24: calls $0.75
*** FLOP *** [8c 7d 2s]
Mmago24: checks 
danthaur: checks 
*** TURN *** [8c 7d 2s] [Tc]
Mmago24: bets $1.38
danthaur: calls $1.38
*** RIVER *** [8c 7d 2s Tc] [6s]
Mmago24: bets $3.49
danthaur: calls $3.49
*** SHOW DOWN ***
Mmago24: shows [9h Kc] (a straight, Six to Ten)
danthaur: mucks hand 
Mmago24 collected $11.87 from pot
*** SUMMARY ***
Total pot $12.49 | Rake $0.62 
Board [8c 7d 2s Tc 6s]
Seat 1: Dihabet folded before Flop (didn't bet)
Seat 2: v.sting folded before Flop (didn't bet)
Seat 3: akbloger folded before Flop (didn't bet)
Seat 4: $lavik88 folded before Flop (didn't bet)
Seat 5: WarllocK1982 folded before Flop (didn't bet)
Seat 6: Nestle170 folded before Flop (didn't bet)
Seat 7: danthaur (button) mucked
Seat 8: m11k1989 (small blind) folded before Flop
Seat 9: Mmago24 (big blind) showed [9h Kc] and won ($11.87) with a straight, Six to Ten



PokerStars Hand #228686801580:  Hold'em No Limit ($0.25/$0.50 USD) - 2021/07/30 15:26:18 ET
Table 'Galilea III' 9-max Seat #8 is the button
Seat 1: Dihabet ($60.04 in chips) 
Seat 2: v.sting ($90.78 in chips) 
Seat 3: akbloger ($56.33 in chips) 
Seat 4: $lavik88 ($107.32 in chips) 
Seat 5: WarllocK1982 ($56.93 in chips) 
Seat 6: Nestle170 ($51.25 in chips) 
Seat 7: danthaur ($50 in chips) 
Seat 8: m11k1989 ($30.20 in chips) 
Seat 9: Mmago24 ($55.75 in chips) 
Mmago24: posts small blind $0.25
Dihabet: posts big blind $0.50
*** HOLE CARDS ***
v.sting: folds 
akbloger: folds 
$lavik88: folds 
WarllocK1982: raises $0.75 to $1.25
Nestle170: raises $3.13 to $4.38
danthaur: folds 
m11k1989: calls $4.38
Mmago24: folds 
Dihabet: folds 
WarllocK1982: calls $3.13
*** FLOP *** [Jh 2h 7d]
WarllocK1982: checks 
Nestle170: checks 
m11k1989: checks 
*** TURN *** [Jh 2h 7d] [Qs]
WarllocK1982: checks 
Nestle170: checks 
m11k1989: bets $6.60
WarllocK1982: calls $6.60
Nestle170: folds 
*** RIVER *** [Jh 2h 7d Qs] [Ks]
WarllocK1982: checks 
m11k1989: bets $19.22 and is all-in
WarllocK1982: calls $19.22
*** SHOW DOWN ***
m11k1989: shows [Kh Qd] (two pair, Kings and Queens)
WarllocK1982: shows [Ah Kd] (a pair of Kings)
m11k1989 collected $63.53 from pot
*** SUMMARY ***
Total pot $65.53 | Rake $2 
Board [Jh 2h 7d Qs Ks]
Seat 1: Dihabet (big blind) folded before Flop
Seat 2: v.sting folded before Flop (didn't bet)
Seat 3: akbloger folded before Flop (didn't bet)
Seat 4: $lavik88 folded before Flop (didn't bet)
Seat 5: WarllocK1982 showed [Ah Kd] and lost with a pair of Kings
Seat 6: Nestle170 folded on the Turn
Seat 7: danthaur folded before Flop (didn't bet)
Seat 8: m11k1989 (button) showed [Kh Qd] and won ($63.53) with two pair, Kings and Queens
Seat 9: Mmago24 (small blind) folded before Flop



PokerStars Hand #228687736731:  Hold'em No Limit ($0.25/$0.50 USD) - 2021/07/30 16:01:06 ET
Table 'Galilea III' 9-max Seat #4 is the button
Seat 1: Xamil666 ($102.34 in chips) 
Seat 3: akbloger ($53.16 in chips) 
Seat 4: $lavik88 ($79.35 in chips) 
Seat 5: WarllocK1982 ($50 in chips) 
Seat 6: Nestle170 ($50 in chips) 
Seat 7: danthaur ($50 in chips) 
Seat 8: m11k1989 ($44.94 in chips) 
Seat 9: Mmago24 ($66.01 in chips) 
WarllocK1982: posts small blind $0.25
Nestle170: posts big blind $0.50
v.sting: sits out 
*** HOLE CARDS ***
danthaur: folds 
m11k1989: calls $0.50
Mmago24: folds 
Xamil666: folds 
akbloger: folds 
$lavik88: folds 
WarllocK1982: calls $0.25
Nestle170: checks 
*** FLOP *** [5s 3c 4s]
WarllocK1982: bets $1.07
Nestle170: raises $2.93 to $4
m11k1989: folds 
WarllocK1982: calls $2.93
*** TURN *** [5s 3c 4s] [Jd]
WarllocK1982: checks 
Nestle170: bets $6.77
WarllocK1982: calls $6.77
*** RIVER *** [5s 3c 4s Jd] [Kc]
WarllocK1982: checks 
Nestle170: checks 
*** SHOW DOWN ***
WarllocK1982: shows [5c 5h] (three of a kind, Fives)
Nestle170: mucks hand 
WarllocK1982 collected $21.89 from pot
*** SUMMARY ***
Total pot $23.04 | Rake $1.15 
Board [5s 3c 4s Jd Kc]
Seat 1: Xamil666 folded before Flop (didn't bet)
Seat 3: akbloger folded before Flop (didn't bet)
Seat 4: $lavik88 (button) folded before Flop (didn't bet)
Seat 5: WarllocK1982 (small blind) showed [5c 5h] and won ($21.89) with three of a kind, Fives
Seat 6: Nestle170 (big blind) mucked
Seat 7: danthaur folded before Flop (didn't bet)
Seat 8: m11k1989 folded on the Flop
Seat 9: Mmago24 folded before Flop (didn't bet)



PokerStars Hand #228686844089:  Hold'em No Limit ($0.25/$0.50 USD) - 2021/07/30 15:27:50 ET
Table 'Galilea III' 9-max Seat #9 is the button
Seat 1: Dihabet ($59.54 in chips) 
Seat 2: v.sting ($90.78 in chips) 
Seat 3: akbloger ($56.33 in chips) 
Seat 4: $lavik88 ($107.32 in chips) 
Seat 5: WarllocK1982 ($50 in chips) 
Seat 6: Nestle170 ($50 in chips) 
Seat 7: danthaur ($50 in chips) 
Seat 8: m11k1989 ($63.53 in chips) 
Seat 9: Mmago24 ($55.50 in chips) 
Dihabet: posts small blind $0.25
v.sting: posts big blind $0.50
*** HOLE CARDS ***
akbloger: folds 
$lavik88: folds 
WarllocK1982: folds 
Nestle170: folds 
danthaur: folds 
m11k1989: calls $0.50
Mmago24: folds 
Dihabet: folds 
v.sting: raises $2.50 to $3
m11k1989: folds 
Uncalled bet ($2.50) returned to v.sting
v.sting collected $1.25 from pot
v.sting: doesn't show hand 
*** SUMMARY ***
Total pot $1.25 | Rake $0 
Seat 1: Dihabet (small blind) folded before Flop
Seat 2: v.sting (big blind) collected ($1.25)
Seat 3: akbloger folded before Flop (didn't bet)
Seat 4: $lavik88 folded before Flop (didn't bet)
Seat 5: WarllocK1982 folded before Flop (didn't bet)
Seat 6: Nestle170 folded before Flop (didn't bet)
Seat 7: danthaur folded before Flop (didn't bet)
Seat 8: m11k1989 folded before Flop
Seat 9: Mmago24 (button) folded before Flop (didn't bet)



PokerStars Hand #228686860983:  Hold'em No Limit ($0.25/$0.50 USD) - 2021/07/30 15:28:27 ET
Table 'Galilea III' 9-max Seat #1 is the button
Seat 1: Dihabet ($59.29 in chips) 
Seat 2: v.sting ($91.53 in chips) 
Seat 3: akbloger ($56.33 in chips) 
Seat 4: $lavik88 ($107.32 in chips) 
Seat 5: WarllocK1982 ($50 in chips) 
Seat 6: Nestle170 ($50 in chips) 
Seat 7: danthaur ($50 in chips) 
Seat 8: m11k1989 ($63.03 in chips) 
Seat 9: Mmago24 ($55.50 in chips) 
v.sting: posts small blind $0.25
akbloger: posts big blind $0.50
*** HOLE CARDS ***
$lavik88: folds 
WarllocK1982: folds 
Nestle170: folds 
danthaur: folds 
m11k1989: folds 
Mmago24: folds 
Dihabet: folds 
v.sting: raises $1 to $1.50
akbloger: calls $1
*** FLOP *** [Ad 7d 2c]
v.sting: checks 
akbloger: checks 
*** TURN *** [Ad 7d 2c] [Ah]
v.sting has timed out
v.sting: checks 
akbloger: checks 
*** RIVER *** [Ad 7d 2c Ah] [Ac]
v.sting: checks 
akbloger: checks 
*** SHOW DOWN ***
v.sting: shows [Kh Qh] (three of a kind, Aces)
akbloger: mucks hand 
v.sting collected $2.85 from pot
*** SUMMARY ***
Total pot $3 | Rake $0.15 
Board [Ad 7d 2c Ah Ac]
Seat 1: Dihabet (button) folded before Flop (didn't bet)
Seat 2: v.sting (small blind) showed [Kh Qh] and won ($2.85) with three of a kind, Aces
Seat 3: akbloger (big blind) mucked
Seat 4: $lavik88 folded before Flop (didn't bet)
Seat 5: WarllocK1982 folded before Flop (didn't bet)
Seat 6: Nestle170 folded before Flop (didn't bet)
Seat 7: danthaur folded before Flop (didn't bet)
Seat 8: m11k1989 folded before Flop (didn't bet)
Seat 9: Mmago24 folded before Flop (didn't bet)



PokerStars Hand #228686888545:  Hold'em No Limit ($0.25/$0.50 USD) - 2021/07/30 15:29:27 ET
Table 'Galilea III' 9-max Seat #2 is the button
Seat 1: Dihabet ($59.29 in chips) 
Seat 2: v.sting ($92.88 in chips) 
Seat 3: akbloger ($54.83 in chips) 
Seat 4: $lavik88 ($107.32 in chips) 
Seat 5: WarllocK1982 ($50 in chips) 
Seat 6: Nestle170 ($50 in chips) 
Seat 7: danthaur ($50 in chips) 
Seat 8: m11k1989 ($63.03 in chips) 
Seat 9: Mmago24 ($55.50 in chips) 
akbloger: posts small blind $0.25
$lavik88: posts big blind $0.50
*** HOLE CARDS ***
WarllocK1982: folds 
Nestle170: folds 
danthaur: folds 
m11k1989: calls $0.50
Mmago24: folds 
Dihabet: folds 
v.sting: folds 
akbloger: folds 
$lavik88: checks 
*** FLOP *** [5s 7s 8c]
$lavik88: checks 
m11k1989: checks 
*** TURN *** [5s 7s 8c] [9c]
$lavik88: checks 
m11k1989: bets $0.50
$lavik88: folds 
Uncalled bet ($0.50) returned to m11k1989
m11k1989 collected $1.19 from pot
m11k1989: doesn't show hand 
*** SUMMARY ***
Total pot $1.25 | Rake $0.06 
Board [5s 7s 8c 9c]
Seat 1: Dihabet folded before Flop (didn't bet)
Seat 2: v.sting (button) folded before Flop (didn't bet)
Seat 3: akbloger (small blind) folded before Flop
Seat 4: $lavik88 (big blind) folded on the Turn
Seat 5: WarllocK1982 folded before Flop (didn't bet)
Seat 6: Nestle170 folded before Flop (didn't bet)
Seat 7: danthaur folded before Flop (didn't bet)
Seat 8: m11k1989 collected ($1.19)
Seat 9: Mmago24 folded before Flop (didn't bet)



PokerStars Hand #228686910719:  Hold'em No Limit ($0.25/$0.50 USD) - 2021/07/30 15:30:15 ET
Table 'Galilea III' 9-max Seat #3 is the button
Seat 1: Dihabet ($59.29 in chips) 
Seat 2: v.sting ($92.88 in chips) 
Seat 3: akbloger ($54.58 in chips) 
Seat 4: $lavik88 ($106.82 in chips) 
Seat 5: WarllocK1982 ($50 in chips) 
Seat 6: Nestle170 ($50 in chips) 
Seat 7: danthaur ($50 in chips) 
Seat 8: m11k1989 ($63.72 in chips) 
Seat 9: Mmago24 ($55.50 in chips) 
$lavik88: posts small blind $0.25
WarllocK1982: posts big blind $0.50
*** HOLE CARDS ***
Nestle170: folds 
danthaur: folds 
m11k1989: calls $0.50
Mmago24: folds 
Dihabet: raises $1.50 to $2
v.sting: folds 
akbloger: folds 
$lavik88: folds 
WarllocK1982: folds 
m11k1989: calls $1.50
*** FLOP *** [2h 3c 7s]
m11k1989: bets $0.50
Dihabet: calls $0.50
*** TURN *** [2h 3c 7s] [Qd]
m11k1989: bets $1.50
Dihabet: calls $1.50
*** RIVER *** [2h 3c 7s Qd] [9d]
m11k1989: bets $0.50
Dihabet: raises $4.50 to $5
m11k1989: folds 
Uncalled bet ($4.50) returned to Dihabet
Dihabet collected $9.26 from pot
Dihabet: doesn't show hand 
*** SUMMARY ***
Total pot $9.75 | Rake $0.49 
Board [2h 3c 7s Qd 9d]
Seat 1: Dihabet collected ($9.26)
Seat 2: v.sting folded before Flop (didn't bet)
Seat 3: akbloger (button) folded before Flop (didn't bet)
Seat 4: $lavik88 (small blind) folded before Flop
Seat 5: WarllocK1982 (big blind) folded before Flop
Seat 6: Nestle170 folded before Flop (didn't bet)
Seat 7: danthaur folded before Flop (didn't bet)
Seat 8: m11k1989 folded on the River
Seat 9: Mmago24 folded before Flop (didn't bet)



PokerStars Hand #228686936055:  Hold'em No Limit ($0.25/$0.50 USD) - 2021/07/30 15:31:10 ET
Table 'Galilea III' 9-max Seat #4 is the button
Seat 1: Dihabet ($64.05 in chips) 
Seat 2: v.sting ($92.88 in chips) 
Seat 3: akbloger ($54.58 in chips) 
Seat 4: $lavik88 ($106.57 in chips) 
Seat 5: WarllocK1982 ($50 in chips) 
Seat 6: Nestle170 ($50 in chips) 
Seat 7: danthaur ($50 in chips) 
Seat 8: m11k1989 ($59.22 in chips) 
Seat 9: Mmago24 ($55.50 in chips) 
WarllocK1982: posts small blind $0.25
Nestle170: posts big blind $0.50
*** HOLE CARDS ***
danthaur has timed out
danthaur: folds 
m11k1989: folds 
Mmago24: folds 
Dihabet: folds 
v.sting: folds 
akbloger: folds 
$lavik88: folds 
WarllocK1982: raises $1 to $1.50
Nestle170: folds 
Uncalled bet ($1) returned to WarllocK1982
WarllocK1982 collected $1 from pot
*** SUMMARY ***
Total pot $1 | Rake $0 
Seat 1: Dihabet folded before Flop (didn't bet)
Seat 2: v.sting folded before Flop (didn't bet)
Seat 3: akbloger folded before Flop (didn't bet)
Seat 4: $lavik88 (button) folded before Flop (didn't bet)
Seat 5: WarllocK1982 (small blind) collected ($1)
Seat 6: Nestle170 (big blind) folded before Flop
Seat 7: danthaur folded before Flop (didn't bet)
Seat 8: m11k1989 folded before Flop (didn't bet)
Seat 9: Mmago24 folded before Flop (didn't bet)



PokerStars Hand #228686947058:  Hold'em No Limit ($0.25/$0.50 USD) - 2021/07/30 15:31:34 ET
Table 'Galilea III' 9-max Seat #5 is the button
Seat 1: Dihabet ($64.05 in chips) 
Seat 2: v.sting ($92.88 in chips) 
Seat 3: akbloger ($54.58 in chips) 
Seat 4: $lavik88 ($106.57 in chips) 
Seat 5: WarllocK1982 ($50.50 in chips) 
Seat 6: Nestle170 ($50 in chips) 
Seat 7: danthaur ($50 in chips) 
Seat 8: m11k1989 ($59.22 in chips) 
Seat 9: Mmago24 ($55.50 in chips) 
Nestle170: posts small blind $0.25
danthaur: posts big blind $0.50
*** HOLE CARDS ***
m11k1989 has timed out
m11k1989: folds 
Mmago24: folds 
Dihabet: folds 
v.sting: raises $1 to $1.50
akbloger: folds 
$lavik88: folds 
WarllocK1982: folds 
Nestle170: folds 
danthaur: folds 
Uncalled bet ($1) returned to v.sting
v.sting collected $1.25 from pot
v.sting: doesn't show hand 
*** SUMMARY ***
Total pot $1.25 | Rake $0 
Seat 1: Dihabet folded before Flop (didn't bet)
Seat 2: v.sting collected ($1.25)
Seat 3: akbloger folded before Flop (didn't bet)
Seat 4: $lavik88 folded before Flop (didn't bet)
Seat 5: WarllocK1982 (button) folded before Flop (didn't bet)
Seat 6: Nestle170 (small blind) folded before Flop
Seat 7: danthaur (big blind) folded before Flop
Seat 8: m11k1989 folded before Flop (didn't bet)
Seat 9: Mmago24 folded before Flop (didn't bet)



PokerStars Hand #228686962193:  Hold'em No Limit ($0.25/$0.50 USD) - 2021/07/30 15:32:06 ET
Table 'Galilea III' 9-max Seat #6 is the button
Seat 1: Dihabet ($64.05 in chips) 
Seat 2: v.sting ($93.63 in chips) 
Seat 3: akbloger ($54.58 in chips) 
Seat 4: $lavik88 ($106.57 in chips) 
Seat 5: WarllocK1982 ($50.50 in chips) 
Seat 6: Nestle170 ($50 in chips) 
Seat 7: danthaur ($50 in chips) 
Seat 8: m11k1989 ($59.22 in chips) 
Seat 9: Mmago24 ($55.50 in chips) 
danthaur: posts small blind $0.25
m11k1989: posts big blind $0.50
*** HOLE CARDS ***
Mmago24: folds 
Dihabet: raises $0.85 to $1.35
v.sting: folds 
akbloger: folds 
$lavik88: folds 
WarllocK1982: folds 
Nestle170: folds 
danthaur: folds 
m11k1989: calls $0.85
*** FLOP *** [Ah 8c 7d]
m11k1989: checks 
Dihabet: bets $1.40
m11k1989: folds 
Uncalled bet ($1.40) returned to Dihabet
Dihabet collected $2.80 from pot
Dihabet: doesn't show hand 
*** SUMMARY ***
Total pot $2.95 | Rake $0.15 
Board [Ah 8c 7d]
Seat 1: Dihabet collected ($2.80)
Seat 2: v.sting folded before Flop (didn't bet)
Seat 3: akbloger folded before Flop (didn't bet)
Seat 4: $lavik88 folded before Flop (didn't bet)
Seat 5: WarllocK1982 folded before Flop (didn't bet)
Seat 6: Nestle170 (button) folded before Flop (didn't bet)
Seat 7: danthaur (small blind) folded before Flop
Seat 8: m11k1989 (big blind) folded on the Flop
Seat 9: Mmago24 folded before Flop (didn't bet)



PokerStars Hand #228686982212:  Hold'em No Limit ($0.25/$0.50 USD) - 2021/07/30 15:32:49 ET
Table 'Galilea III' 9-max Seat #7 is the button
Seat 1: Dihabet ($65.50 in chips) 
Seat 2: v.sting ($93.63 in chips) 
Seat 3: akbloger ($54.58 in chips) 
Seat 4: $lavik88 ($106.57 in chips) 
Seat 5: WarllocK1982 ($50.50 in chips) 
Seat 6: Nestle170 ($50 in chips) 
Seat 7: danthaur ($50 in chips) 
Seat 8: m11k1989 ($57.87 in chips) 
Seat 9: Mmago24 ($55.50 in chips) 
m11k1989: posts small blind $0.25
Mmago24: posts big blind $0.50
*** HOLE CARDS ***
Dihabet: folds 
v.sting: folds 
akbloger: folds 
$lavik88: raises $1 to $1.50
WarllocK1982: folds 
Nestle170: folds 
danthaur: folds 
m11k1989 is disconnected 
m11k1989 is connected 
m11k1989: calls $1.25
Mmago24: calls $1
*** FLOP *** [4h Jh 6d]
m11k1989: checks 
Mmago24: bets $1.50
$lavik88: folds 
m11k1989: folds 
Uncalled bet ($1.50) returned to Mmago24
Mmago24 collected $4.28 from pot
Mmago24: doesn't show hand 
*** SUMMARY ***
Total pot $4.50 | Rake $0.22 
Board [4h Jh 6d]
Seat 1: Dihabet folded before Flop (didn't bet)
Seat 2: v.sting folded before Flop (didn't bet)
Seat 3: akbloger folded before Flop (didn't bet)
Seat 4: $lavik88 folded on the Flop
Seat 5: WarllocK1982 folded before Flop (didn't bet)
Seat 6: Nestle170 folded before Flop (didn't bet)
Seat 7: danthaur (button) folded before Flop (didn't bet)
Seat 8: m11k1989 (small blind) folded on the Flop
Seat 9: Mmago24 (big blind) collected ($4.28)



PokerStars Hand #228687007814:  Hold'em No Limit ($0.25/$0.50 USD) - 2021/07/30 15:33:44 ET
Table 'Galilea III' 9-max Seat #8 is the button
Seat 1: Dihabet ($65.50 in chips) 
Seat 2: v.sting ($93.63 in chips) 
Seat 3: akbloger ($54.58 in chips) 
Seat 4: $lavik88 ($105.07 in chips) 
Seat 5: WarllocK1982 ($50.50 in chips) 
Seat 6: Nestle170 ($50 in chips) 
Seat 7: danthaur ($50 in chips) 
Seat 8: m11k1989 ($56.37 in chips) 
Seat 9: Mmago24 ($58.28 in chips) 
Mmago24: posts small blind $0.25
Dihabet: posts big blind $0.50
*** HOLE CARDS ***
v.sting: folds 
akbloger: folds 
$lavik88: folds 
WarllocK1982: folds 
Nestle170: folds 
danthaur: folds 
m11k1989: calls $0.50
Mmago24: raises $1.75 to $2.25
Dihabet: folds 
m11k1989: calls $1.75
*** FLOP *** [7d 4h 3c]
Mmago24: bets $1.57
m11k1989: calls $1.57
*** TURN *** [7d 4h 3c] [Ts]
Mmago24: bets $5.15
m11k1989: calls $5.15
*** RIVER *** [7d 4h 3c Ts] [8s]
Mmago24: checks 
Dihabet leaves the table
m11k1989: checks 
*** SHOW DOWN ***
Mmago24: shows [Qs Td] (a pair of Tens)
m11k1989: mucks hand 
Mmago24 collected $17.52 from pot
*** SUMMARY ***
Total pot $18.44 | Rake $0.92 
Board [7d 4h 3c Ts 8s]
Seat 1: Dihabet (big blind) folded before Flop
Seat 2: v.sting folded before Flop (didn't bet)
Seat 3: akbloger folded before Flop (didn't bet)
Seat 4: $lavik88 folded before Flop (didn't bet)
Seat 5: WarllocK1982 folded before Flop (didn't bet)
Seat 6: Nestle170 folded before Flop (didn't bet)
Seat 7: danthaur folded before Flop (didn't bet)
Seat 8: m11k1989 (button) mucked
Seat 9: Mmago24 (small blind) showed [Qs Td] and won ($17.52) with a pair of Tens



PokerStars Hand #228687033096:  Hold'em No Limit ($0.25/$0.50 USD) - 2021/07/30 15:34:38 ET
Table 'Galilea III' 9-max Seat #9 is the button
Seat 2: v.sting ($93.63 in chips) 
Seat 3: akbloger ($54.58 in chips) 
Seat 4: $lavik88 ($105.07 in chips) 
Seat 5: WarllocK1982 ($50.50 in chips) 
Seat 6: Nestle170 ($50 in chips) 
Seat 7: danthaur ($50 in chips) 
Seat 8: m11k1989 ($47.40 in chips) 
Seat 9: Mmago24 ($66.83 in chips) 
v.sting: posts small blind $0.25
akbloger: posts big blind $0.50
*** HOLE CARDS ***
$lavik88: folds 
WarllocK1982: folds 
Nestle170: folds 
danthaur: folds 
m11k1989: raises $1 to $1.50
Mmago24: folds 
v.sting: folds 
akbloger: folds 
Uncalled bet ($1) returned to m11k1989
m11k1989 collected $1.25 from pot
m11k1989: doesn't show hand 
*** SUMMARY ***
Total pot $1.25 | Rake $0 
Seat 2: v.sting (small blind) folded before Flop
Seat 3: akbloger (big blind) folded before Flop
Seat 4: $lavik88 folded before Flop (didn't bet)
Seat 5: WarllocK1982 folded before Flop (didn't bet)
Seat 6: Nestle170 folded before Flop (didn't bet)
Seat 7: danthaur folded before Flop (didn't bet)
Seat 8: m11k1989 collected ($1.25)
Seat 9: Mmago24 (button) folded before Flop (didn't bet)



PokerStars Hand #228687046563:  Hold'em No Limit ($0.25/$0.50 USD) - 2021/07/30 15:35:07 ET
Table 'Galilea III' 9-max Seat #2 is the button
Seat 2: v.sting ($93.38 in chips) 
Seat 3: akbloger ($54.08 in chips) 
Seat 4: $lavik88 ($105.07 in chips) 
Seat 5: WarllocK1982 ($50.50 in chips) 
Seat 6: Nestle170 ($50 in chips) 
Seat 7: danthaur ($50 in chips) 
Seat 8: m11k1989 ($48.15 in chips) 
Seat 9: Mmago24 ($66.83 in chips) 
akbloger: posts small blind $0.25
$lavik88: posts big blind $0.50
*** HOLE CARDS ***
WarllocK1982: folds 
Nestle170: folds 
danthaur: folds 
m11k1989: raises $0.50 to $1
Mmago24: raises $2 to $3
v.sting: folds 
akbloger: folds 
$lavik88: folds 
Xamil666 joins the table at seat #1 
m11k1989: calls $2
*** FLOP *** [Tc 9c Jc]
m11k1989: checks 
Mmago24: checks 
*** TURN *** [Tc 9c Jc] [3c]
m11k1989: bets $3.20
Mmago24: folds 
Uncalled bet ($3.20) returned to m11k1989
m11k1989 collected $6.41 from pot
m11k1989: doesn't show hand 
*** SUMMARY ***
Total pot $6.75 | Rake $0.34 
Board [Tc 9c Jc 3c]
Seat 2: v.sting (button) folded before Flop (didn't bet)
Seat 3: akbloger (small blind) folded before Flop
Seat 4: $lavik88 (big blind) folded before Flop
Seat 5: WarllocK1982 folded before Flop (didn't bet)
Seat 6: Nestle170 folded before Flop (didn't bet)
Seat 7: danthaur folded before Flop (didn't bet)
Seat 8: m11k1989 collected ($6.41)
Seat 9: Mmago24 folded on the Turn



PokerStars Hand #228687068578:  Hold'em No Limit ($0.25/$0.50 USD) - 2021/07/30 15:35:54 ET
Table 'Galilea III' 9-max Seat #3 is the button
Seat 2: v.sting ($93.38 in chips) 
Seat 3: akbloger ($53.83 in chips) 
Seat 4: $lavik88 ($104.57 in chips) 
Seat 5: WarllocK1982 ($50.50 in chips) 
Seat 6: Nestle170 ($50 in chips) 
Seat 7: danthaur ($50 in chips) 
Seat 8: m11k1989 ($51.56 in chips) 
Seat 9: Mmago24 ($63.83 in chips) 
$lavik88: posts small blind $0.25
WarllocK1982: posts big blind $0.50
Xamil666: sits out 
*** HOLE CARDS ***
Nestle170: folds 
danthaur: folds 
m11k1989: folds 
Mmago24: raises $0.72 to $1.22
v.sting: folds 
akbloger: folds 
$lavik88: folds 
WarllocK1982: folds 
Uncalled bet ($0.72) returned to Mmago24
Mmago24 collected $1.25 from pot
Mmago24: doesn't show hand 
*** SUMMARY ***
Total pot $1.25 | Rake $0 
Seat 2: v.sting folded before Flop (didn't bet)
Seat 3: akbloger (button) folded before Flop (didn't bet)
Seat 4: $lavik88 (small blind) folded before Flop
Seat 5: WarllocK1982 (big blind) folded before Flop
Seat 6: Nestle170 folded before Flop (didn't bet)
Seat 7: danthaur folded before Flop (didn't bet)
Seat 8: m11k1989 folded before Flop (didn't bet)
Seat 9: Mmago24 collected ($1.25)



PokerStars Hand #228687076830:  Hold'em No Limit ($0.25/$0.50 USD) - 2021/07/30 15:36:12 ET
Table 'Galilea III' 9-max Seat #4 is the button
Seat 2: v.sting ($93.38 in chips) 
Seat 3: akbloger ($53.83 in chips) 
Seat 4: $lavik88 ($104.32 in chips) 
Seat 5: WarllocK1982 ($50 in chips) 
Seat 6: Nestle170 ($50 in chips) 
Seat 7: danthaur ($50 in chips) 
Seat 8: m11k1989 ($51.56 in chips) 
Seat 9: Mmago24 ($64.58 in chips) 
WarllocK1982: posts small blind $0.25
Nestle170: posts big blind $0.50
Xamil666: sits out 
*** HOLE CARDS ***
danthaur: folds 
m11k1989: calls $0.50
Mmago24: folds 
v.sting: folds 
akbloger: folds 
$lavik88: folds 
WarllocK1982: folds 
Nestle170: checks 
*** FLOP *** [8d 2c 9c]
Nestle170: checks 
m11k1989: bets $0.50
Nestle170: folds 
Uncalled bet ($0.50) returned to m11k1989
m11k1989 collected $1.19 from pot
m11k1989: doesn't show hand 
*** SUMMARY ***
Total pot $1.25 | Rake $0.06 
Board [8d 2c 9c]
Seat 2: v.sting folded before Flop (didn't bet)
Seat 3: akbloger folded before Flop (didn't bet)
Seat 4: $lavik88 (button) folded before Flop (didn't bet)
Seat 5: WarllocK1982 (small blind) folded before Flop
Seat 6: Nestle170 (big blind) folded on the Flop
Seat 7: danthaur folded before Flop (didn't bet)
Seat 8: m11k1989 collected ($1.19)
Seat 9: Mmago24 folded before Flop (didn't bet)



PokerStars Hand #228687085994:  Hold'em No Limit ($0.25/$0.50 USD) - 2021/07/30 15:36:31 ET
Table 'Galilea III' 9-max Seat #5 is the button
Seat 2: v.sting ($93.38 in chips) 
Seat 3: akbloger ($53.83 in chips) 
Seat 4: $lavik88 ($104.32 in chips) 
Seat 5: WarllocK1982 ($50 in chips) 
Seat 6: Nestle170 ($50 in chips) 
Seat 7: danthaur ($50 in chips) 
Seat 8: m11k1989 ($52.25 in chips) 
Seat 9: Mmago24 ($64.58 in chips) 
Nestle170: posts small blind $0.25
danthaur: posts big blind $0.50
Xamil666: sits out 
*** HOLE CARDS ***
m11k1989: calls $0.50
Mmago24: folds 
v.sting: folds 
akbloger: folds 
$lavik88: folds 
WarllocK1982: folds 
Nestle170: folds 
danthaur: checks 
*** FLOP *** [7h Kc Kd]
danthaur: checks 
m11k1989: bets $1
danthaur: folds 
Uncalled bet ($1) returned to m11k1989
m11k1989 collected $1.19 from pot
m11k1989: doesn't show hand 
*** SUMMARY ***
Total pot $1.25 | Rake $0.06 
Board [7h Kc Kd]
Seat 2: v.sting folded before Flop (didn't bet)
Seat 3: akbloger folded before Flop (didn't bet)
Seat 4: $lavik88 folded before Flop (didn't bet)
Seat 5: WarllocK1982 (button) folded before Flop (didn't bet)
Seat 6: Nestle170 (small blind) folded before Flop
Seat 7: danthaur (big blind) folded on the Flop
Seat 8: m11k1989 collected ($1.19)
Seat 9: Mmago24 folded before Flop (didn't bet)



PokerStars Hand #228687109803:  Hold'em No Limit ($0.25/$0.50 USD) - 2021/07/30 15:37:22 ET
Table 'Galilea III' 9-max Seat #6 is the button
Seat 2: v.sting ($93.38 in chips) 
Seat 3: akbloger ($53.83 in chips) 
Seat 4: $lavik88 ($104.32 in chips) 
Seat 5: WarllocK1982 ($50 in chips) 
Seat 6: Nestle170 ($50 in chips) 
Seat 7: danthaur ($50 in chips) 
Seat 8: m11k1989 ($52.94 in chips) 
Seat 9: Mmago24 ($64.58 in chips) 
danthaur: posts small blind $0.25
m11k1989: posts big blind $0.50
Xamil666: sits out 
*** HOLE CARDS ***
Mmago24: folds 
v.sting: raises $1 to $1.50
akbloger: folds 
$lavik88: folds 
WarllocK1982: folds 
Nestle170: folds 
danthaur: folds 
m11k1989: folds 
Uncalled bet ($1) returned to v.sting
v.sting collected $1.25 from pot
v.sting: doesn't show hand 
*** SUMMARY ***
Total pot $1.25 | Rake $0 
Seat 2: v.sting collected ($1.25)
Seat 3: akbloger folded before Flop (didn't bet)
Seat 4: $lavik88 folded before Flop (didn't bet)
Seat 5: WarllocK1982 folded before Flop (didn't bet)
Seat 6: Nestle170 (button) folded before Flop (didn't bet)
Seat 7: danthaur (small blind) folded before Flop
Seat 8: m11k1989 (big blind) folded before Flop
Seat 9: Mmago24 folded before Flop (didn't bet)



PokerStars Hand #228687121126:  Hold'em No Limit ($0.25/$0.50 USD) - 2021/07/30 15:37:47 ET
Table 'Galilea III' 9-max Seat #7 is the button
Seat 2: v.sting ($94.13 in chips) 
Seat 3: akbloger ($53.83 in chips) 
Seat 4: $lavik88 ($104.32 in chips) 
Seat 5: WarllocK1982 ($50 in chips) 
Seat 6: Nestle170 ($50 in chips) 
Seat 7: danthaur ($50 in chips) 
Seat 8: m11k1989 ($52.44 in chips) 
Seat 9: Mmago24 ($64.58 in chips) 
m11k1989: posts small blind $0.25
Mmago24: posts big blind $0.50
Xamil666: sits out 
*** HOLE CARDS ***
v.sting: folds 
akbloger: folds 
$lavik88: folds 
WarllocK1982: folds 
Nestle170: folds 
danthaur: raises $0.75 to $1.25
m11k1989: folds 
Mmago24: folds 
Uncalled bet ($0.75) returned to danthaur
danthaur collected $1.25 from pot
danthaur: doesn't show hand 
*** SUMMARY ***
Total pot $1.25 | Rake $0 
Seat 2: v.sting folded before Flop (didn't bet)
Seat 3: akbloger folded before Flop (didn't bet)
Seat 4: $lavik88 folded before Flop (didn't bet)
Seat 5: WarllocK1982 folded before Flop (didn't bet)
Seat 6: Nestle170 folded before Flop (didn't bet)
Seat 7: danthaur (button) collected ($1.25)
Seat 8: m11k1989 (small blind) folded before Flop
Seat 9: Mmago24 (big blind) folded before Flop



PokerStars Hand #228687128353:  Hold'em No Limit ($0.25/$0.50 USD) - 2021/07/30 15:38:03 ET
Table 'Galilea III' 9-max Seat #8 is the button
Seat 1: Xamil666 ($50 in chips) 
Seat 2: v.sting ($94.13 in chips) 
Seat 3: akbloger ($53.83 in chips) 
Seat 4: $lavik88 ($104.32 in chips) 
Seat 5: WarllocK1982 ($50 in chips) 
Seat 6: Nestle170 ($50 in chips) 
Seat 7: danthaur ($50.75 in chips) 
Seat 8: m11k1989 ($52.19 in chips) 
Seat 9: Mmago24 ($64.08 in chips) 
Mmago24: posts small blind $0.25
Xamil666: posts big blind $0.50
*** HOLE CARDS ***
v.sting: folds 
akbloger: folds 
$lavik88: folds 
WarllocK1982: folds 
Nestle170: folds 
danthaur: raises $0.75 to $1.25
m11k1989: folds 
Mmago24: folds 
Xamil666: folds 
Uncalled bet ($0.75) returned to danthaur
danthaur collected $1.25 from pot
danthaur: doesn't show hand 
*** SUMMARY ***
Total pot $1.25 | Rake $0 
Seat 1: Xamil666 (big blind) folded before Flop
Seat 2: v.sting folded before Flop (didn't bet)
Seat 3: akbloger folded before Flop (didn't bet)
Seat 4: $lavik88 folded before Flop (didn't bet)
Seat 5: WarllocK1982 folded before Flop (didn't bet)
Seat 6: Nestle170 folded before Flop (didn't bet)
Seat 7: danthaur collected ($1.25)
Seat 8: m11k1989 (button) folded before Flop (didn't bet)
Seat 9: Mmago24 (small blind) folded before Flop



PokerStars Hand #228687139739:  Hold'em No Limit ($0.25/$0.50 USD) - 2021/07/30 15:38:27 ET
Table 'Galilea III' 9-max Seat #9 is the button
Seat 1: Xamil666 ($50 in chips) 
Seat 2: v.sting ($94.13 in chips) 
Seat 3: akbloger ($53.83 in chips) 
Seat 4: $lavik88 ($104.32 in chips) 
Seat 5: WarllocK1982 ($50 in chips) 
Seat 6: Nestle170 ($50 in chips) 
Seat 7: danthaur ($51.50 in chips) 
Seat 8: m11k1989 ($52.19 in chips) 
Seat 9: Mmago24 ($63.83 in chips) 
Xamil666: posts small blind $0.25
v.sting: posts big blind $0.50
*** HOLE CARDS ***
akbloger: folds 
$lavik88: folds 
WarllocK1982: raises $0.75 to $1.25
Nestle170: folds 
danthaur: folds 
m11k1989: calls $1.25
Mmago24: folds 
Xamil666: folds 
v.sting: folds 
*** FLOP *** [6s 2c 8h]
WarllocK1982: checks 
m11k1989: bets $1
WarllocK1982: calls $1
*** TURN *** [6s 2c 8h] [8s]
WarllocK1982: checks 
m11k1989: bets $3
WarllocK1982: calls $3
*** RIVER *** [6s 2c 8h 8s] [2h]
WarllocK1982: checks 
m11k1989: checks 
*** SHOW DOWN ***
WarllocK1982: shows [Js Ks] (two pair, Eights and Deuces)
m11k1989: mucks hand 
WarllocK1982 collected $10.69 from pot
*** SUMMARY ***
Total pot $11.25 | Rake $0.56 
Board [6s 2c 8h 8s 2h]
Seat 1: Xamil666 (small blind) folded before Flop
Seat 2: v.sting (big blind) folded before Flop
Seat 3: akbloger folded before Flop (didn't bet)
Seat 4: $lavik88 folded before Flop (didn't bet)
Seat 5: WarllocK1982 showed [Js Ks] and won ($10.69) with two pair, Eights and Deuces
Seat 6: Nestle170 folded before Flop (didn't bet)
Seat 7: danthaur folded before Flop (didn't bet)
Seat 8: m11k1989 mucked
Seat 9: Mmago24 (button) folded before Flop (didn't bet)



PokerStars Hand #228687164735:  Hold'em No Limit ($0.25/$0.50 USD) - 2021/07/30 15:39:20 ET
Table 'Galilea III' 9-max Seat #1 is the button
Seat 1: Xamil666 ($50 in chips) 
Seat 2: v.sting ($93.63 in chips) 
Seat 3: akbloger ($53.83 in chips) 
Seat 4: $lavik88 ($104.32 in chips) 
Seat 5: WarllocK1982 ($55.44 in chips) 
Seat 6: Nestle170 ($50 in chips) 
Seat 7: danthaur ($51.50 in chips) 
Seat 8: m11k1989 ($46.94 in chips) 
Seat 9: Mmago24 ($63.83 in chips) 
v.sting: posts small blind $0.25
akbloger: posts big blind $0.50
*** HOLE CARDS ***
$lavik88: folds 
WarllocK1982: folds 
Nestle170: folds 
danthaur: folds 
m11k1989: raises $0.50 to $1
Mmago24: folds 
Xamil666: folds 
v.sting: folds 
akbloger: folds 
Uncalled bet ($0.50) returned to m11k1989
m11k1989 collected $1.25 from pot
m11k1989: doesn't show hand 
*** SUMMARY ***
Total pot $1.25 | Rake $0 
Seat 1: Xamil666 (button) folded before Flop (didn't bet)
Seat 2: v.sting (small blind) folded before Flop
Seat 3: akbloger (big blind) folded before Flop
Seat 4: $lavik88 folded before Flop (didn't bet)
Seat 5: WarllocK1982 folded before Flop (didn't bet)
Seat 6: Nestle170 folded before Flop (didn't bet)
Seat 7: danthaur folded before Flop (didn't bet)
Seat 8: m11k1989 collected ($1.25)
Seat 9: Mmago24 folded before Flop (didn't bet)



PokerStars Hand #228687175877:  Hold'em No Limit ($0.25/$0.50 USD) - 2021/07/30 15:39:44 ET
Table 'Galilea III' 9-max Seat #2 is the button
Seat 1: Xamil666 ($50 in chips) 
Seat 2: v.sting ($93.38 in chips) 
Seat 3: akbloger ($53.33 in chips) 
Seat 4: $lavik88 ($104.32 in chips) 
Seat 5: WarllocK1982 ($55.44 in chips) 
Seat 6: Nestle170 ($50 in chips) 
Seat 7: danthaur ($51.50 in chips) 
Seat 8: m11k1989 ($47.69 in chips) 
Seat 9: Mmago24 ($63.83 in chips) 
akbloger: posts small blind $0.25
$lavik88: posts big blind $0.50
*** HOLE CARDS ***
WarllocK1982: folds 
Nestle170: folds 
danthaur: folds 
m11k1989: folds 
Mmago24: folds 
Xamil666: folds 
v.sting: folds 
akbloger: raises $1 to $1.50
$lavik88: calls $1
*** FLOP *** [8d 4c Qd]
akbloger: bets $0.94
$lavik88: calls $0.94
*** TURN *** [8d 4c Qd] [7d]
akbloger: bets $3.48
$lavik88: calls $3.48
*** RIVER *** [8d 4c Qd 7d] [As]
akbloger: bets $8.44
$lavik88: folds 
Uncalled bet ($8.44) returned to akbloger
akbloger collected $11.25 from pot
akbloger: doesn't show hand 
*** SUMMARY ***
Total pot $11.84 | Rake $0.59 
Board [8d 4c Qd 7d As]
Seat 1: Xamil666 folded before Flop (didn't bet)
Seat 2: v.sting (button) folded before Flop (didn't bet)
Seat 3: akbloger (small blind) collected ($11.25)
Seat 4: $lavik88 (big blind) folded on the River
Seat 5: WarllocK1982 folded before Flop (didn't bet)
Seat 6: Nestle170 folded before Flop (didn't bet)
Seat 7: danthaur folded before Flop (didn't bet)
Seat 8: m11k1989 folded before Flop (didn't bet)
Seat 9: Mmago24 folded before Flop (didn't bet)



PokerStars Hand #228687216863:  Hold'em No Limit ($0.25/$0.50 USD) - 2021/07/30 15:40:52 ET
Table 'Galilea III' 9-max Seat #3 is the button
Seat 1: Xamil666 ($50 in chips) 
Seat 2: v.sting ($93.38 in chips) 
Seat 3: akbloger ($58.66 in chips) 
Seat 4: $lavik88 ($98.40 in chips) 
Seat 5: WarllocK1982 ($55.44 in chips) 
Seat 6: Nestle170 ($50 in chips) 
Seat 7: danthaur ($51.50 in chips) 
Seat 8: m11k1989 ($47.69 in chips) 
Seat 9: Mmago24 ($63.83 in chips) 
$lavik88: posts small blind $0.25
WarllocK1982: posts big blind $0.50
*** HOLE CARDS ***
Nestle170: folds 
danthaur: folds 
m11k1989: calls $0.50
Mmago24: raises $1.75 to $2.25
Xamil666: folds 
v.sting: folds 
akbloger: folds 
$lavik88: folds 
WarllocK1982: folds 
m11k1989: folds 
Uncalled bet ($1.75) returned to Mmago24
Mmago24 collected $1.75 from pot
Mmago24: doesn't show hand 
*** SUMMARY ***
Total pot $1.75 | Rake $0 
Seat 1: Xamil666 folded before Flop (didn't bet)
Seat 2: v.sting folded before Flop (didn't bet)
Seat 3: akbloger (button) folded before Flop (didn't bet)
Seat 4: $lavik88 (small blind) folded before Flop
Seat 5: WarllocK1982 (big blind) folded before Flop
Seat 6: Nestle170 folded before Flop (didn't bet)
Seat 7: danthaur folded before Flop (didn't bet)
Seat 8: m11k1989 folded before Flop
Seat 9: Mmago24 collected ($1.75)



PokerStars Hand #228687235425:  Hold'em No Limit ($0.25/$0.50 USD) - 2021/07/30 15:41:33 ET
Table 'Galilea III' 9-max Seat #4 is the button
Seat 1: Xamil666 ($50 in chips) 
Seat 2: v.sting ($93.38 in chips) 
Seat 3: akbloger ($58.66 in chips) 
Seat 4: $lavik88 ($98.15 in chips) 
Seat 5: WarllocK1982 ($54.94 in chips) 
Seat 6: Nestle170 ($50 in chips) 
Seat 7: danthaur ($51.50 in chips) 
Seat 8: m11k1989 ($47.19 in chips) 
Seat 9: Mmago24 ($65.08 in chips) 
WarllocK1982: posts small blind $0.25
Nestle170: posts big blind $0.50
*** HOLE CARDS ***
danthaur: folds 
m11k1989: calls $0.50
Mmago24: folds 
Xamil666: folds 
v.sting: folds 
akbloger: folds 
$lavik88: raises $1.50 to $2
WarllocK1982: folds 
Nestle170: folds 
m11k1989: calls $1.50
*** FLOP *** [8h Jd 8d]
m11k1989: bets $0.50
$lavik88: raises $1.65 to $2.15
m11k1989: raises $3.15 to $5.30
$lavik88: calls $3.15
*** TURN *** [8h Jd 8d] [Tc]
m11k1989: bets $4.50
$lavik88: calls $4.50
*** RIVER *** [8h Jd 8d Tc] [9d]
m11k1989: bets $4
$lavik88: calls $4
*** SHOW DOWN ***
m11k1989: shows [7c 3d] (a straight, Seven to Jack)
$lavik88: mucks hand 
m11k1989 collected $30.73 from pot
*** SUMMARY ***
Total pot $32.35 | Rake $1.62 
Board [8h Jd 8d Tc 9d]
Seat 1: Xamil666 folded before Flop (didn't bet)
Seat 2: v.sting folded before Flop (didn't bet)
Seat 3: akbloger folded before Flop (didn't bet)
Seat 4: $lavik88 (button) mucked
Seat 5: WarllocK1982 (small blind) folded before Flop
Seat 6: Nestle170 (big blind) folded before Flop
Seat 7: danthaur folded before Flop (didn't bet)
Seat 8: m11k1989 showed [7c 3d] and won ($30.73) with a straight, Seven to Jack
Seat 9: Mmago24 folded before Flop (didn't bet)



PokerStars Hand #228687270253:  Hold'em No Limit ($0.25/$0.50 USD) - 2021/07/30 15:42:48 ET
Table 'Galilea III' 9-max Seat #5 is the button
Seat 1: Xamil666 ($50 in chips) 
Seat 2: v.sting ($93.38 in chips) 
Seat 3: akbloger ($58.66 in chips) 
Seat 4: $lavik88 ($82.35 in chips) 
Seat 5: WarllocK1982 ($54.69 in chips) 
Seat 6: Nestle170 ($50 in chips) 
Seat 7: danthaur ($51.50 in chips) 
Seat 8: m11k1989 ($62.12 in chips) 
Seat 9: Mmago24 ($65.08 in chips) 
Nestle170: posts small blind $0.25
danthaur: posts big blind $0.50
*** HOLE CARDS ***
m11k1989: calls $0.50
Mmago24: raises $1.50 to $2
Xamil666: folds 
v.sting has timed out
v.sting: folds 
akbloger: folds 
$lavik88: folds 
WarllocK1982: folds 
Nestle170: folds 
danthaur: folds 
m11k1989: calls $1.50
*** FLOP *** [2s Kh Jc]
m11k1989: bets $0.50
Mmago24: raises $2 to $2.50
m11k1989: folds 
Uncalled bet ($2) returned to Mmago24
Mmago24 collected $5.46 from pot
Mmago24: doesn't show hand 
*** SUMMARY ***
Total pot $5.75 | Rake $0.29 
Board [2s Kh Jc]
Seat 1: Xamil666 folded before Flop (didn't bet)
Seat 2: v.sting folded before Flop (didn't bet)
Seat 3: akbloger folded before Flop (didn't bet)
Seat 4: $lavik88 folded before Flop (didn't bet)
Seat 5: WarllocK1982 (button) folded before Flop (didn't bet)
Seat 6: Nestle170 (small blind) folded before Flop
Seat 7: danthaur (big blind) folded before Flop
Seat 8: m11k1989 folded on the Flop
Seat 9: Mmago24 collected ($5.46)



PokerStars Hand #228687301258:  Hold'em No Limit ($0.25/$0.50 USD) - 2021/07/30 15:43:56 ET
Table 'Galilea III' 9-max Seat #6 is the button
Seat 1: Xamil666 ($50 in chips) 
Seat 2: v.sting ($93.38 in chips) 
Seat 3: akbloger ($58.66 in chips) 
Seat 4: $lavik88 ($82.35 in chips) 
Seat 5: WarllocK1982 ($54.69 in chips) 
Seat 6: Nestle170 ($50 in chips) 
Seat 7: danthaur ($51 in chips) 
Seat 8: m11k1989 ($59.62 in chips) 
Seat 9: Mmago24 ($68.04 in chips) 
danthaur: posts small blind $0.25
m11k1989: posts big blind $0.50
*** HOLE CARDS ***
Mmago24: folds 
Xamil666: folds 
v.sting: folds 
akbloger: folds 
$lavik88: folds 
WarllocK1982: folds 
Nestle170: folds 
danthaur: folds 
Uncalled bet ($0.25) returned to m11k1989
m11k1989 collected $0.50 from pot
m11k1989: doesn't show hand 
*** SUMMARY ***
Total pot $0.50 | Rake $0 
Seat 1: Xamil666 folded before Flop (didn't bet)
Seat 2: v.sting folded before Flop (didn't bet)
Seat 3: akbloger folded before Flop (didn't bet)
Seat 4: $lavik88 folded before Flop (didn't bet)
Seat 5: WarllocK1982 folded before Flop (didn't bet)
Seat 6: Nestle170 (button) folded before Flop (didn't bet)
Seat 7: danthaur (small blind) folded before Flop
Seat 8: m11k1989 (big blind) collected ($0.50)
Seat 9: Mmago24 folded before Flop (didn't bet)



PokerStars Hand #228687309073:  Hold'em No Limit ($0.25/$0.50 USD) - 2021/07/30 15:44:13 ET
Table 'Galilea III' 9-max Seat #7 is the button
Seat 1: Xamil666 ($50 in chips) 
Seat 2: v.sting ($93.38 in chips) 
Seat 3: akbloger ($58.66 in chips) 
Seat 4: $lavik88 ($82.35 in chips) 
Seat 5: WarllocK1982 ($54.69 in chips) 
Seat 6: Nestle170 ($50 in chips) 
Seat 7: danthaur ($50.75 in chips) 
Seat 8: m11k1989 ($59.87 in chips) 
Seat 9: Mmago24 ($68.04 in chips) 
m11k1989: posts small blind $0.25
Mmago24: posts big blind $0.50
*** HOLE CARDS ***
Xamil666: folds 
v.sting: folds 
akbloger: folds 
$lavik88: folds 
WarllocK1982: folds 
Nestle170: folds 
danthaur: folds 
m11k1989: calls $0.25
Mmago24: checks 
*** FLOP *** [8d 4d 3d]
m11k1989: bets $1
Mmago24: calls $1
*** TURN *** [8d 4d 3d] [3s]
m11k1989: bets $1
Mmago24: calls $1
*** RIVER *** [8d 4d 3d 3s] [Jc]
m11k1989: checks 
Mmago24: checks 
*** SHOW DOWN ***
m11k1989: shows [5d 5h] (two pair, Fives and Threes)
Mmago24: shows [8s 5c] (two pair, Eights and Threes)
Mmago24 collected $4.75 from pot
*** SUMMARY ***
Total pot $5 | Rake $0.25 
Board [8d 4d 3d 3s Jc]
Seat 1: Xamil666 folded before Flop (didn't bet)
Seat 2: v.sting folded before Flop (didn't bet)
Seat 3: akbloger folded before Flop (didn't bet)
Seat 4: $lavik88 folded before Flop (didn't bet)
Seat 5: WarllocK1982 folded before Flop (didn't bet)
Seat 6: Nestle170 folded before Flop (didn't bet)
Seat 7: danthaur (button) folded before Flop (didn't bet)
Seat 8: m11k1989 (small blind) showed [5d 5h] and lost with two pair, Fives and Threes
Seat 9: Mmago24 (big blind) showed [8s 5c] and won ($4.75) with two pair, Eights and Threes



PokerStars Hand #228687328844:  Hold'em No Limit ($0.25/$0.50 USD) - 2021/07/30 15:44:56 ET
Table 'Galilea III' 9-max Seat #8 is the button
Seat 1: Xamil666 ($50 in chips) 
Seat 2: v.sting ($93.38 in chips) 
Seat 3: akbloger ($58.66 in chips) 
Seat 4: $lavik88 ($82.35 in chips) 
Seat 5: WarllocK1982 ($54.69 in chips) 
Seat 6: Nestle170 ($50 in chips) 
Seat 7: danthaur ($50.75 in chips) 
Seat 8: m11k1989 ($57.37 in chips) 
Seat 9: Mmago24 ($70.29 in chips) 
Mmago24: posts small blind $0.25
Xamil666: posts big blind $0.50
*** HOLE CARDS ***
v.sting has timed out
v.sting: folds 
akbloger: folds 
$lavik88: folds 
WarllocK1982: folds 
Nestle170: folds 
danthaur: folds 
m11k1989: calls $0.50
Mmago24: folds 
Xamil666: checks 
*** FLOP *** [Jd 9d Ks]
Xamil666: checks 
m11k1989: bets $0.50
Xamil666: folds 
Uncalled bet ($0.50) returned to m11k1989
m11k1989 collected $1.19 from pot
m11k1989: doesn't show hand 
*** SUMMARY ***
Total pot $1.25 | Rake $0.06 
Board [Jd 9d Ks]
Seat 1: Xamil666 (big blind) folded on the Flop
Seat 2: v.sting folded before Flop (didn't bet)
Seat 3: akbloger folded before Flop (didn't bet)
Seat 4: $lavik88 folded before Flop (didn't bet)
Seat 5: WarllocK1982 folded before Flop (didn't bet)
Seat 6: Nestle170 folded before Flop (didn't bet)
Seat 7: danthaur folded before Flop (didn't bet)
Seat 8: m11k1989 (button) collected ($1.19)
Seat 9: Mmago24 (small blind) folded before Flop



PokerStars Hand #228687344873:  Hold'em No Limit ($0.25/$0.50 USD) - 2021/07/30 15:45:31 ET
Table 'Galilea III' 9-max Seat #9 is the button
Seat 1: Xamil666 ($50 in chips) 
Seat 2: v.sting ($93.38 in chips) 
Seat 3: akbloger ($58.66 in chips) 
Seat 4: $lavik88 ($82.35 in chips) 
Seat 5: WarllocK1982 ($54.69 in chips) 
Seat 6: Nestle170 ($50 in chips) 
Seat 7: danthaur ($50.75 in chips) 
Seat 8: m11k1989 ($58.06 in chips) 
Seat 9: Mmago24 ($70.04 in chips) 
Xamil666: posts small blind $0.25
v.sting: posts big blind $0.50
*** HOLE CARDS ***
akbloger: raises $1 to $1.50
$lavik88: folds 
WarllocK1982: folds 
Nestle170: folds 
danthaur: folds 
m11k1989: folds 
Mmago24: folds 
Xamil666: folds 
v.sting has timed out
v.sting: folds 
Uncalled bet ($1) returned to akbloger
akbloger collected $1.25 from pot
akbloger: doesn't show hand 
*** SUMMARY ***
Total pot $1.25 | Rake $0 
Seat 1: Xamil666 (small blind) folded before Flop
Seat 2: v.sting (big blind) folded before Flop
Seat 3: akbloger collected ($1.25)
Seat 4: $lavik88 folded before Flop (didn't bet)
Seat 5: WarllocK1982 folded before Flop (didn't bet)
Seat 6: Nestle170 folded before Flop (didn't bet)
Seat 7: danthaur folded before Flop (didn't bet)
Seat 8: m11k1989 folded before Flop (didn't bet)
Seat 9: Mmago24 (button) folded before Flop (didn't bet)



PokerStars Hand #228687371313:  Hold'em No Limit ($0.25/$0.50 USD) - 2021/07/30 15:46:15 ET
Table 'Galilea III' 9-max Seat #1 is the button
Seat 1: Xamil666 ($50 in chips) 
Seat 2: v.sting ($92.88 in chips) 
Seat 3: akbloger ($59.41 in chips) 
Seat 4: $lavik88 ($82.35 in chips) 
Seat 5: WarllocK1982 ($54.69 in chips) 
Seat 6: Nestle170 ($50 in chips) 
Seat 7: danthaur ($50.75 in chips) 
Seat 8: m11k1989 ($58.06 in chips) 
Seat 9: Mmago24 ($70.04 in chips) 
v.sting: posts small blind $0.25
akbloger: posts big blind $0.50
*** HOLE CARDS ***
$lavik88: folds 
WarllocK1982: folds 
Nestle170: folds 
danthaur: folds 
m11k1989: calls $0.50
Mmago24: folds 
Xamil666: folds 
v.sting has timed out
v.sting: folds 
akbloger: checks 
*** FLOP *** [4h 7c 6d]
akbloger: checks 
m11k1989: bets $1
akbloger: folds 
Uncalled bet ($1) returned to m11k1989
m11k1989 collected $1.19 from pot
m11k1989: doesn't show hand 
*** SUMMARY ***
Total pot $1.25 | Rake $0.06 
Board [4h 7c 6d]
Seat 1: Xamil666 (button) folded before Flop (didn't bet)
Seat 2: v.sting (small blind) folded before Flop
Seat 3: akbloger (big blind) folded on the Flop
Seat 4: $lavik88 folded before Flop (didn't bet)
Seat 5: WarllocK1982 folded before Flop (didn't bet)
Seat 6: Nestle170 folded before Flop (didn't bet)
Seat 7: danthaur folded before Flop (didn't bet)
Seat 8: m11k1989 collected ($1.19)
Seat 9: Mmago24 folded before Flop (didn't bet)



PokerStars Hand #228687386972:  Hold'em No Limit ($0.25/$0.50 USD) - 2021/07/30 15:46:49 ET
Table 'Galilea III' 9-max Seat #3 is the button
Seat 1: Xamil666 ($50 in chips) 
Seat 3: akbloger ($58.91 in chips) 
Seat 4: $lavik88 ($82.35 in chips) 
Seat 5: WarllocK1982 ($54.69 in chips) 
Seat 6: Nestle170 ($50 in chips) 
Seat 7: danthaur ($50.75 in chips) 
Seat 8: m11k1989 ($58.75 in chips) 
Seat 9: Mmago24 ($70.04 in chips) 
$lavik88: posts small blind $0.25
WarllocK1982: posts big blind $0.50
*** HOLE CARDS ***
Nestle170: folds 
danthaur: folds 
m11k1989: raises $0.50 to $1
Mmago24: calls $1
Xamil666: folds 
akbloger: folds 
$lavik88: folds 
WarllocK1982: calls $0.50
*** FLOP *** [6c 4h 3s]
WarllocK1982: checks 
m11k1989: checks 
Mmago24: checks 
*** TURN *** [6c 4h 3s] [Ts]
WarllocK1982: checks 
m11k1989: bets $0.50
Mmago24: calls $0.50
WarllocK1982: folds 
*** RIVER *** [6c 4h 3s Ts] [6d]
m11k1989: checks 
Mmago24: checks 
*** SHOW DOWN ***
m11k1989: shows [Qd Ks] (a pair of Sixes)
Mmago24: shows [5d 5c] (two pair, Sixes and Fives)
Mmago24 collected $4.04 from pot
*** SUMMARY ***
Total pot $4.25 | Rake $0.21 
Board [6c 4h 3s Ts 6d]
Seat 1: Xamil666 folded before Flop (didn't bet)
Seat 3: akbloger (button) folded before Flop (didn't bet)
Seat 4: $lavik88 (small blind) folded before Flop
Seat 5: WarllocK1982 (big blind) folded on the Turn
Seat 6: Nestle170 folded before Flop (didn't bet)
Seat 7: danthaur folded before Flop (didn't bet)
Seat 8: m11k1989 showed [Qd Ks] and lost with a pair of Sixes
Seat 9: Mmago24 showed [5d 5c] and won ($4.04) with two pair, Sixes and Fives



PokerStars Hand #228687414916:  Hold'em No Limit ($0.25/$0.50 USD) - 2021/07/30 15:47:50 ET
Table 'Galilea III' 9-max Seat #4 is the button
Seat 1: Xamil666 ($50 in chips) 
Seat 3: akbloger ($58.91 in chips) 
Seat 4: $lavik88 ($82.10 in chips) 
Seat 5: WarllocK1982 ($53.69 in chips) 
Seat 6: Nestle170 ($50 in chips) 
Seat 7: danthaur ($50.75 in chips) 
Seat 8: m11k1989 ($57.25 in chips) 
Seat 9: Mmago24 ($72.58 in chips) 
WarllocK1982: posts small blind $0.25
Nestle170: posts big blind $0.50
*** HOLE CARDS ***
danthaur: folds 
m11k1989: folds 
Mmago24: folds 
Xamil666: folds 
akbloger: folds 
$lavik88: raises $0.70 to $1.20
WarllocK1982: folds 
Nestle170: folds 
Uncalled bet ($0.70) returned to $lavik88
$lavik88 collected $1.25 from pot
$lavik88: doesn't show hand 
*** SUMMARY ***
Total pot $1.25 | Rake $0 
Seat 1: Xamil666 folded before Flop (didn't bet)
Seat 3: akbloger folded before Flop (didn't bet)
Seat 4: $lavik88 (button) collected ($1.25)
Seat 5: WarllocK1982 (small blind) folded before Flop
Seat 6: Nestle170 (big blind) folded before Flop
Seat 7: danthaur folded before Flop (didn't bet)
Seat 8: m11k1989 folded before Flop (didn't bet)
Seat 9: Mmago24 folded before Flop (didn't bet)



PokerStars Hand #228687427875:  Hold'em No Limit ($0.25/$0.50 USD) - 2021/07/30 15:48:18 ET
Table 'Galilea III' 9-max Seat #5 is the button
Seat 1: Xamil666 ($50 in chips) 
Seat 3: akbloger ($58.91 in chips) 
Seat 4: $lavik88 ($82.85 in chips) 
Seat 5: WarllocK1982 ($53.44 in chips) 
Seat 6: Nestle170 ($50 in chips) 
Seat 7: danthaur ($50.75 in chips) 
Seat 8: m11k1989 ($57.25 in chips) 
Seat 9: Mmago24 ($72.58 in chips) 
Nestle170: posts small blind $0.25
danthaur: posts big blind $0.50
*** HOLE CARDS ***
m11k1989: calls $0.50
Mmago24: folds 
Xamil666: folds 
akbloger: folds 
$lavik88: folds 
WarllocK1982: folds 
Nestle170: folds 
danthaur: checks 
*** FLOP *** [Jd 8c 3h]
danthaur: bets $0.65
m11k1989: calls $0.65
*** TURN *** [Jd 8c 3h] [9d]
danthaur: bets $0.80
m11k1989: raises $1.80 to $2.60
danthaur: calls $1.80
*** RIVER *** [Jd 8c 3h 9d] [As]
danthaur: checks 
m11k1989: checks 
*** SHOW DOWN ***
danthaur: shows [Tc 9h] (a pair of Nines)
m11k1989: mucks hand 
danthaur collected $7.36 from pot
*** SUMMARY ***
Total pot $7.75 | Rake $0.39 
Board [Jd 8c 3h 9d As]
Seat 1: Xamil666 folded before Flop (didn't bet)
Seat 3: akbloger folded before Flop (didn't bet)
Seat 4: $lavik88 folded before Flop (didn't bet)
Seat 5: WarllocK1982 (button) folded before Flop (didn't bet)
Seat 6: Nestle170 (small blind) folded before Flop
Seat 7: danthaur (big blind) showed [Tc 9h] and won ($7.36) with a pair of Nines
Seat 8: m11k1989 mucked
Seat 9: Mmago24 folded before Flop (didn't bet)



PokerStars Hand #228687455665:  Hold'em No Limit ($0.25/$0.50 USD) - 2021/07/30 15:49:18 ET
Table 'Galilea III' 9-max Seat #6 is the button
Seat 1: Xamil666 ($50 in chips) 
Seat 3: akbloger ($58.91 in chips) 
Seat 4: $lavik88 ($82.85 in chips) 
Seat 5: WarllocK1982 ($53.44 in chips) 
Seat 6: Nestle170 ($50 in chips) 
Seat 7: danthaur ($54.36 in chips) 
Seat 8: m11k1989 ($53.50 in chips) 
Seat 9: Mmago24 ($72.58 in chips) 
danthaur: posts small blind $0.25
m11k1989: posts big blind $0.50
*** HOLE CARDS ***
Mmago24: folds 
Xamil666: folds 
akbloger: folds 
$lavik88: raises $1 to $1.50
WarllocK1982: folds 
Nestle170: folds 
danthaur: folds 
m11k1989: calls $1
*** FLOP *** [2d 5s 4c]
m11k1989: bets $0.50
$lavik88: calls $0.50
*** TURN *** [2d 5s 4c] [6d]
m11k1989: bets $1.50
$lavik88: folds 
Uncalled bet ($1.50) returned to m11k1989
m11k1989 collected $4.04 from pot
m11k1989: doesn't show hand 
*** SUMMARY ***
Total pot $4.25 | Rake $0.21 
Board [2d 5s 4c 6d]
Seat 1: Xamil666 folded before Flop (didn't bet)
Seat 3: akbloger folded before Flop (didn't bet)
Seat 4: $lavik88 folded on the Turn
Seat 5: WarllocK1982 folded before Flop (didn't bet)
Seat 6: Nestle170 (button) folded before Flop (didn't bet)
Seat 7: danthaur (small blind) folded before Flop
Seat 8: m11k1989 (big blind) collected ($4.04)
Seat 9: Mmago24 folded before Flop (didn't bet)



PokerStars Hand #228687476792:  Hold'em No Limit ($0.25/$0.50 USD) - 2021/07/30 15:50:04 ET
Table 'Galilea III' 9-max Seat #7 is the button
Seat 1: Xamil666 ($50 in chips) 
Seat 3: akbloger ($58.91 in chips) 
Seat 4: $lavik88 ($80.85 in chips) 
Seat 5: WarllocK1982 ($53.44 in chips) 
Seat 6: Nestle170 ($50 in chips) 
Seat 7: danthaur ($54.11 in chips) 
Seat 8: m11k1989 ($55.54 in chips) 
Seat 9: Mmago24 ($72.58 in chips) 
m11k1989: posts small blind $0.25
Mmago24: posts big blind $0.50
*** HOLE CARDS ***
Xamil666: raises $1 to $1.50
akbloger: folds 
$lavik88: folds 
WarllocK1982: folds 
Nestle170: folds 
danthaur: folds 
m11k1989: calls $1.25
Mmago24: calls $1
*** FLOP *** [5s 6d Qd]
m11k1989: checks 
Mmago24: checks 
Xamil666: bets $3.21
m11k1989: calls $3.21
Mmago24: folds 
*** TURN *** [5s 6d Qd] [4c]
m11k1989: bets $1.50
Xamil666: raises $5.50 to $7
m11k1989: folds 
Uncalled bet ($5.50) returned to Xamil666
Xamil666 collected $13.22 from pot
*** SUMMARY ***
Total pot $13.92 | Rake $0.70 
Board [5s 6d Qd 4c]
Seat 1: Xamil666 collected ($13.22)
Seat 3: akbloger folded before Flop (didn't bet)
Seat 4: $lavik88 folded before Flop (didn't bet)
Seat 5: WarllocK1982 folded before Flop (didn't bet)
Seat 6: Nestle170 folded before Flop (didn't bet)
Seat 7: danthaur (button) folded before Flop (didn't bet)
Seat 8: m11k1989 (small blind) folded on the Turn
Seat 9: Mmago24 (big blind) folded on the Flop



PokerStars Hand #228687512796:  Hold'em No Limit ($0.25/$0.50 USD) - 2021/07/30 15:51:23 ET
Table 'Galilea III' 9-max Seat #8 is the button
Seat 1: Xamil666 ($57.01 in chips) 
Seat 3: akbloger ($58.91 in chips) 
Seat 4: $lavik88 ($80.85 in chips) 
Seat 5: WarllocK1982 ($53.44 in chips) 
Seat 6: Nestle170 ($50 in chips) 
Seat 7: danthaur ($54.11 in chips) 
Seat 8: m11k1989 ($49.33 in chips) 
Seat 9: Mmago24 ($71.08 in chips) 
Mmago24: posts small blind $0.25
Xamil666: posts big blind $0.50
*** HOLE CARDS ***
akbloger: folds 
$lavik88: folds 
WarllocK1982: folds 
Nestle170: folds 
danthaur: folds 
m11k1989: calls $0.50
Mmago24: folds 
Xamil666: checks 
*** FLOP *** [Js Tc 9d]
Xamil666: checks 
m11k1989: bets $2
Xamil666: folds 
Uncalled bet ($2) returned to m11k1989
m11k1989 collected $1.19 from pot
m11k1989: doesn't show hand 
*** SUMMARY ***
Total pot $1.25 | Rake $0.06 
Board [Js Tc 9d]
Seat 1: Xamil666 (big blind) folded on the Flop
Seat 3: akbloger folded before Flop (didn't bet)
Seat 4: $lavik88 folded before Flop (didn't bet)
Seat 5: WarllocK1982 folded before Flop (didn't bet)
Seat 6: Nestle170 folded before Flop (didn't bet)
Seat 7: danthaur folded before Flop (didn't bet)
Seat 8: m11k1989 (button) collected ($1.19)
Seat 9: Mmago24 (small blind) folded before Flop



PokerStars Hand #228687527997:  Hold'em No Limit ($0.25/$0.50 USD) - 2021/07/30 15:51:56 ET
Table 'Galilea III' 9-max Seat #9 is the button
Seat 1: Xamil666 ($56.51 in chips) 
Seat 3: akbloger ($58.91 in chips) 
Seat 4: $lavik88 ($80.85 in chips) 
Seat 5: WarllocK1982 ($53.44 in chips) 
Seat 6: Nestle170 ($50 in chips) 
Seat 7: danthaur ($54.11 in chips) 
Seat 8: m11k1989 ($50.02 in chips) 
Seat 9: Mmago24 ($70.83 in chips) 
Xamil666: posts small blind $0.25
akbloger: posts big blind $0.50
*** HOLE CARDS ***
$lavik88: folds 
WarllocK1982 has timed out
WarllocK1982: folds 
Nestle170: folds 
danthaur: raises $1 to $1.50
m11k1989: calls $1.50
Mmago24: calls $1.50
Xamil666: raises $6 to $7.50
akbloger: folds 
danthaur: folds 
m11k1989: folds 
Mmago24: calls $6
*** FLOP *** [Ks 3s 6s]
Xamil666: bets $5.80
Mmago24: calls $5.80
*** TURN *** [Ks 3s 6s] [3h]
Xamil666: bets $9.44
Mmago24: folds 
Uncalled bet ($9.44) returned to Xamil666
Xamil666 collected $28.60 from pot
*** SUMMARY ***
Total pot $30.10 | Rake $1.50 
Board [Ks 3s 6s 3h]
Seat 1: Xamil666 (small blind) collected ($28.60)
Seat 3: akbloger (big blind) folded before Flop
Seat 4: $lavik88 folded before Flop (didn't bet)
Seat 5: WarllocK1982 folded before Flop (didn't bet)
Seat 6: Nestle170 folded before Flop (didn't bet)
Seat 7: danthaur folded before Flop
Seat 8: m11k1989 folded before Flop
Seat 9: Mmago24 (button) folded on the Turn



PokerStars Hand #228687573967:  Hold'em No Limit ($0.25/$0.50 USD) - 2021/07/30 15:53:37 ET
Table 'Galilea III' 9-max Seat #1 is the button
Seat 1: Xamil666 ($71.81 in chips) 
Seat 3: akbloger ($58.41 in chips) 
Seat 4: $lavik88 ($80.85 in chips) 
Seat 5: WarllocK1982 ($53.44 in chips) 
Seat 6: Nestle170 ($50 in chips) 
Seat 7: danthaur ($52.61 in chips) 
Seat 8: m11k1989 ($48.52 in chips) 
Seat 9: Mmago24 ($57.53 in chips) 
akbloger: posts small blind $0.25
$lavik88: posts big blind $0.50
*** HOLE CARDS ***
WarllocK1982: folds 
Nestle170: folds 
danthaur: folds 
m11k1989: folds 
Mmago24: folds 
Xamil666: raises $0.60 to $1.10
akbloger: folds 
$lavik88: folds 
Uncalled bet ($0.60) returned to Xamil666
Xamil666 collected $1.25 from pot
*** SUMMARY ***
Total pot $1.25 | Rake $0 
Seat 1: Xamil666 (button) collected ($1.25)
Seat 3: akbloger (small blind) folded before Flop
Seat 4: $lavik88 (big blind) folded before Flop
Seat 5: WarllocK1982 folded before Flop (didn't bet)
Seat 6: Nestle170 folded before Flop (didn't bet)
Seat 7: danthaur folded before Flop (didn't bet)
Seat 8: m11k1989 folded before Flop (didn't bet)
Seat 9: Mmago24 folded before Flop (didn't bet)



PokerStars Hand #228687590634:  Hold'em No Limit ($0.25/$0.50 USD) - 2021/07/30 15:54:14 ET
Table 'Galilea III' 9-max Seat #3 is the button
Seat 1: Xamil666 ($72.56 in chips) 
Seat 3: akbloger ($58.16 in chips) 
Seat 4: $lavik88 ($80.35 in chips) 
Seat 5: WarllocK1982 ($53.44 in chips) 
Seat 6: Nestle170 ($50 in chips) 
Seat 7: danthaur ($52.61 in chips) 
Seat 8: m11k1989 ($48.52 in chips) 
Seat 9: Mmago24 ($57.53 in chips) 
$lavik88: posts small blind $0.25
WarllocK1982: posts big blind $0.50
v.sting: sits out 
*** HOLE CARDS ***
Nestle170: folds 
danthaur: folds 
m11k1989: calls $0.50
Mmago24: folds 
Xamil666: folds 
akbloger: folds 
$lavik88: folds 
WarllocK1982: checks 
*** FLOP *** [Kc Qh 9d]
WarllocK1982: checks 
m11k1989: bets $1
WarllocK1982: folds 
Uncalled bet ($1) returned to m11k1989
m11k1989 collected $1.19 from pot
m11k1989: doesn't show hand 
*** SUMMARY ***
Total pot $1.25 | Rake $0.06 
Board [Kc Qh 9d]
Seat 1: Xamil666 folded before Flop (didn't bet)
Seat 3: akbloger (button) folded before Flop (didn't bet)
Seat 4: $lavik88 (small blind) folded before Flop
Seat 5: WarllocK1982 (big blind) folded on the Flop
Seat 6: Nestle170 folded before Flop (didn't bet)
Seat 7: danthaur folded before Flop (didn't bet)
Seat 8: m11k1989 collected ($1.19)
Seat 9: Mmago24 folded before Flop (didn't bet)



PokerStars Hand #228687603555:  Hold'em No Limit ($0.25/$0.50 USD) - 2021/07/30 15:54:43 ET
Table 'Galilea III' 9-max Seat #4 is the button
Seat 1: Xamil666 ($72.56 in chips) 
Seat 3: akbloger ($58.16 in chips) 
Seat 4: $lavik88 ($80.10 in chips) 
Seat 5: WarllocK1982 ($52.94 in chips) 
Seat 6: Nestle170 ($50 in chips) 
Seat 7: danthaur ($52.61 in chips) 
Seat 8: m11k1989 ($49.21 in chips) 
Seat 9: Mmago24 ($57.53 in chips) 
WarllocK1982: posts small blind $0.25
Nestle170: posts big blind $0.50
v.sting: sits out 
*** HOLE CARDS ***
danthaur: folds 
m11k1989: folds 
Mmago24: folds 
Xamil666: folds 
akbloger: folds 
$lavik88: folds 
WarllocK1982: folds 
Uncalled bet ($0.25) returned to Nestle170
Nestle170 collected $0.50 from pot
Nestle170: doesn't show hand 
*** SUMMARY ***
Total pot $0.50 | Rake $0 
Seat 1: Xamil666 folded before Flop (didn't bet)
Seat 3: akbloger folded before Flop (didn't bet)
Seat 4: $lavik88 (button) folded before Flop (didn't bet)
Seat 5: WarllocK1982 (small blind) folded before Flop
Seat 6: Nestle170 (big blind) collected ($0.50)
Seat 7: danthaur folded before Flop (didn't bet)
Seat 8: m11k1989 folded before Flop (didn't bet)
Seat 9: Mmago24 folded before Flop (didn't bet)



PokerStars Hand #228687609069:  Hold'em No Limit ($0.25/$0.50 USD) - 2021/07/30 15:54:55 ET
Table 'Galilea III' 9-max Seat #5 is the button
Seat 1: Xamil666 ($72.56 in chips) 
Seat 3: akbloger ($58.16 in chips) 
Seat 4: $lavik88 ($80.10 in chips) 
Seat 5: WarllocK1982 ($52.69 in chips) 
Seat 6: Nestle170 ($50.25 in chips) 
Seat 7: danthaur ($52.61 in chips) 
Seat 8: m11k1989 ($49.21 in chips) 
Seat 9: Mmago24 ($57.53 in chips) 
Nestle170: posts small blind $0.25
danthaur: posts big blind $0.50
v.sting: sits out 
*** HOLE CARDS ***
m11k1989: raises $0.50 to $1
Mmago24: raises $2.50 to $3.50
Xamil666: folds 
akbloger: folds 
$lavik88: folds 
WarllocK1982: folds 
Nestle170: folds 
danthaur: folds 
m11k1989: calls $2.50
*** FLOP *** [Jd 2c Th]
m11k1989: checks 
Mmago24: bets $3
m11k1989: calls $3
*** TURN *** [Jd 2c Th] [5d]
m11k1989: checks 
Mmago24: bets $8.71
m11k1989: calls $8.71
*** RIVER *** [Jd 2c Th 5d] [6s]
m11k1989: checks 
Mmago24: checks 
*** SHOW DOWN ***
m11k1989: shows [Kd Ad] (high card Ace)
Mmago24: shows [Jh Ac] (a pair of Jacks)
Mmago24 collected $29.61 from pot
*** SUMMARY ***
Total pot $31.17 | Rake $1.56 
Board [Jd 2c Th 5d 6s]
Seat 1: Xamil666 folded before Flop (didn't bet)
Seat 3: akbloger folded before Flop (didn't bet)
Seat 4: $lavik88 folded before Flop (didn't bet)
Seat 5: WarllocK1982 (button) folded before Flop (didn't bet)
Seat 6: Nestle170 (small blind) folded before Flop
Seat 7: danthaur (big blind) folded before Flop
Seat 8: m11k1989 showed [Kd Ad] and lost with high card Ace
Seat 9: Mmago24 showed [Jh Ac] and won ($29.61) with a pair of Jacks



PokerStars Hand #228687630078:  Hold'em No Limit ($0.25/$0.50 USD) - 2021/07/30 15:55:53 ET
Table 'Galilea III' 9-max Seat #6 is the button
Seat 1: Xamil666 ($72.56 in chips) 
Seat 3: akbloger ($58.16 in chips) 
Seat 4: $lavik88 ($80.10 in chips) 
Seat 5: WarllocK1982 ($52.69 in chips) 
Seat 6: Nestle170 ($50 in chips) 
Seat 7: danthaur ($52.11 in chips) 
Seat 8: m11k1989 ($34 in chips) 
Seat 9: Mmago24 ($71.93 in chips) 
danthaur: posts small blind $0.25
m11k1989: posts big blind $0.50
v.sting: sits out 
*** HOLE CARDS ***
Mmago24: raises $0.72 to $1.22
Xamil666: calls $1.22
akbloger: folds 
$lavik88: folds 
WarllocK1982: folds 
Nestle170: calls $1.22
danthaur: folds 
m11k1989: calls $0.72
*** FLOP *** [5h 8d 5s]
m11k1989: checks 
Mmago24: checks 
Xamil666: checks 
Nestle170: bets $1.95
m11k1989: folds 
Mmago24: calls $1.95
Xamil666: calls $1.95
*** TURN *** [5h 8d 5s] [Ah]
Mmago24: checks 
Xamil666: checks 
Nestle170: checks 
*** RIVER *** [5h 8d 5s Ah] [7d]
Mmago24: bets $6.50
Xamil666: raises $11.72 to $18.22
Nestle170: calls $18.22
Mmago24: folds 
*** SHOW DOWN ***
Xamil666: shows [8c 8h] (a full house, Eights full of Fives)
Nestle170: mucks hand 
Xamil666 collected $51.92 from pot
*** SUMMARY ***
Total pot $53.92 | Rake $2 
Board [5h 8d 5s Ah 7d]
Seat 1: Xamil666 showed [8c 8h] and won ($51.92) with a full house, Eights full of Fives
Seat 3: akbloger folded before Flop (didn't bet)
Seat 4: $lavik88 folded before Flop (didn't bet)
Seat 5: WarllocK1982 folded before Flop (didn't bet)
Seat 6: Nestle170 (button) mucked
Seat 7: danthaur (small blind) folded before Flop
Seat 8: m11k1989 (big blind) folded on the Flop
Seat 9: Mmago24 folded on the River



PokerStars Hand #228687665018:  Hold'em No Limit ($0.25/$0.50 USD) - 2021/07/30 15:57:39 ET
Table 'Galilea III' 9-max Seat #7 is the button
Seat 1: Xamil666 ($103.09 in chips) 
Seat 3: akbloger ($58.16 in chips) 
Seat 4: $lavik88 ($80.10 in chips) 
Seat 5: WarllocK1982 ($52.69 in chips) 
Seat 6: Nestle170 ($50 in chips) 
Seat 7: danthaur ($51.86 in chips) 
Seat 8: m11k1989 ($32.78 in chips) 
Seat 9: Mmago24 ($62.26 in chips) 
m11k1989: posts small blind $0.25
Mmago24: posts big blind $0.50
v.sting: sits out 
*** HOLE CARDS ***
Xamil666: folds 
akbloger: folds 
$lavik88: folds 
WarllocK1982: raises $0.75 to $1.25
Nestle170: folds 
danthaur: folds 
m11k1989: calls $1
Mmago24: folds 
*** FLOP *** [Jc 6c 9c]
m11k1989: checks 
WarllocK1982: bets $1.88
m11k1989: calls $1.88
*** TURN *** [Jc 6c 9c] [3d]
m11k1989: checks 
WarllocK1982: bets $4.24
m11k1989: calls $4.24
*** RIVER *** [Jc 6c 9c 3d] [4s]
m11k1989: checks 
WarllocK1982: checks 
*** SHOW DOWN ***
m11k1989: shows [9h Js] (two pair, Jacks and Nines)
WarllocK1982: mucks hand 
m11k1989 collected $14.48 from pot
*** SUMMARY ***
Total pot $15.24 | Rake $0.76 
Board [Jc 6c 9c 3d 4s]
Seat 1: Xamil666 folded before Flop (didn't bet)
Seat 3: akbloger folded before Flop (didn't bet)
Seat 4: $lavik88 folded before Flop (didn't bet)
Seat 5: WarllocK1982 mucked
Seat 6: Nestle170 folded before Flop (didn't bet)
Seat 7: danthaur (button) folded before Flop (didn't bet)
Seat 8: m11k1989 (small blind) showed [9h Js] and won ($14.48) with two pair, Jacks and Nines
Seat 9: Mmago24 (big blind) folded before Flop



PokerStars Hand #228687684079:  Hold'em No Limit ($0.25/$0.50 USD) - 2021/07/30 15:58:37 ET
Table 'Galilea III' 9-max Seat #8 is the button
Seat 1: Xamil666 ($103.09 in chips) 
Seat 3: akbloger ($58.16 in chips) 
Seat 4: $lavik88 ($80.10 in chips) 
Seat 5: WarllocK1982 ($50 in chips) 
Seat 6: Nestle170 ($50 in chips) 
Seat 7: danthaur ($51.86 in chips) 
Seat 8: m11k1989 ($39.89 in chips) 
Seat 9: Mmago24 ($61.76 in chips) 
Mmago24: posts small blind $0.25
Xamil666: posts big blind $0.50
v.sting: sits out 
*** HOLE CARDS ***
akbloger: folds 
$lavik88: folds 
WarllocK1982: folds 
Nestle170: folds 
danthaur: raises $0.75 to $1.25
m11k1989: calls $1.25
Mmago24: folds 
Xamil666: folds 
*** FLOP *** [Kd 4h 9s]
danthaur: bets $1.02
m11k1989: raises $1.02 to $2.04
danthaur: folds 
Uncalled bet ($1.02) returned to m11k1989
m11k1989 collected $5.03 from pot
m11k1989: doesn't show hand 
*** SUMMARY ***
Total pot $5.29 | Rake $0.26 
Board [Kd 4h 9s]
Seat 1: Xamil666 (big blind) folded before Flop
Seat 3: akbloger folded before Flop (didn't bet)
Seat 4: $lavik88 folded before Flop (didn't bet)
Seat 5: WarllocK1982 folded before Flop (didn't bet)
Seat 6: Nestle170 folded before Flop (didn't bet)
Seat 7: danthaur folded on the Flop
Seat 8: m11k1989 (button) collected ($5.03)
Seat 9: Mmago24 (small blind) folded before Flop



PokerStars Hand #228687699330:  Hold'em No Limit ($0.25/$0.50 USD) - 2021/07/30 15:59:22 ET
Table 'Galilea III' 9-max Seat #9 is the button
Seat 1: Xamil666 ($102.59 in chips) 
Seat 2: v.sting ($92.63 in chips) 
Seat 3: akbloger ($58.16 in chips) 
Seat 4: $lavik88 ($80.10 in chips) 
Seat 5: WarllocK1982 ($50 in chips) 
Seat 6: Nestle170 ($50 in chips) 
Seat 7: danthaur ($50 in chips) 
Seat 8: m11k1989 ($42.65 in chips) 
Seat 9: Mmago24 ($61.51 in chips) 
Xamil666: posts small blind $0.25
v.sting: posts big blind $0.50
*** HOLE CARDS ***
akbloger: folds 
$lavik88: folds 
WarllocK1982: folds 
Nestle170: folds 
danthaur: folds 
m11k1989: folds 
Mmago24: raises $0.72 to $1.22
Xamil666: folds 
v.sting has timed out
v.sting: folds 
Uncalled bet ($0.72) returned to Mmago24
Mmago24 collected $1.25 from pot
Mmago24: doesn't show hand 
*** SUMMARY ***
Total pot $1.25 | Rake $0 
Seat 1: Xamil666 (small blind) folded before Flop
Seat 2: v.sting (big blind) folded before Flop
Seat 3: akbloger folded before Flop (didn't bet)
Seat 4: $lavik88 folded before Flop (didn't bet)
Seat 5: WarllocK1982 folded before Flop (didn't bet)
Seat 6: Nestle170 folded before Flop (didn't bet)
Seat 7: danthaur folded before Flop (didn't bet)
Seat 8: m11k1989 folded before Flop (didn't bet)
Seat 9: Mmago24 (button) collected ($1.25)



PokerStars Hand #228687708785:  Hold'em No Limit ($0.25/$0.50 USD) - 2021/07/30 15:59:51 ET
Table 'Galilea III' 9-max Seat #1 is the button
Seat 1: Xamil666 ($102.34 in chips) 
Seat 3: akbloger ($58.16 in chips) 
Seat 4: $lavik88 ($80.10 in chips) 
Seat 5: WarllocK1982 ($50 in chips) 
Seat 6: Nestle170 ($50 in chips) 
Seat 7: danthaur ($50 in chips) 
Seat 8: m11k1989 ($42.65 in chips) 
Seat 9: Mmago24 ($62.26 in chips) 
akbloger: posts small blind $0.25
$lavik88: posts big blind $0.50
*** HOLE CARDS ***
WarllocK1982: folds 
Nestle170: folds 
danthaur: folds 
m11k1989: folds 
Mmago24: raises $0.72 to $1.22
Xamil666: folds 
akbloger: raises $3.78 to $5
$lavik88: folds 
Mmago24: raises $7.50 to $12.50
akbloger: folds 
Uncalled bet ($7.50) returned to Mmago24
Mmago24 collected $10.50 from pot
Mmago24: doesn't show hand 
*** SUMMARY ***
Total pot $10.50 | Rake $0 
Seat 1: Xamil666 (button) folded before Flop (didn't bet)
Seat 3: akbloger (small blind) folded before Flop
Seat 4: $lavik88 (big blind) folded before Flop
Seat 5: WarllocK1982 folded before Flop (didn't bet)
Seat 6: Nestle170 folded before Flop (didn't bet)
Seat 7: danthaur folded before Flop (didn't bet)
Seat 8: m11k1989 folded before Flop (didn't bet)
Seat 9: Mmago24 collected ($10.50)



PokerStars Hand #228687722862:  Hold'em No Limit ($0.25/$0.50 USD) - 2021/07/30 16:00:30 ET
Table 'Galilea III' 9-max Seat #3 is the button
Seat 1: Xamil666 ($102.34 in chips) 
Seat 3: akbloger ($53.16 in chips) 
Seat 4: $lavik88 ($79.60 in chips) 
Seat 5: WarllocK1982 ($50 in chips) 
Seat 6: Nestle170 ($50 in chips) 
Seat 7: danthaur ($50 in chips) 
Seat 8: m11k1989 ($42.65 in chips) 
Seat 9: Mmago24 ($67.76 in chips) 
$lavik88: posts small blind $0.25
WarllocK1982: posts big blind $0.50
v.sting: sits out 
*** HOLE CARDS ***
Nestle170: folds 
danthaur: folds 
m11k1989: calls $0.50
Mmago24: raises $1.25 to $1.75
Xamil666: folds 
akbloger: folds 
$lavik88: folds 
WarllocK1982: folds 
m11k1989: calls $1.25
*** FLOP *** [6s Jc Ac]
m11k1989: bets $3
Mmago24: folds 
Uncalled bet ($3) returned to m11k1989
m11k1989 collected $4.04 from pot
m11k1989: doesn't show hand 
*** SUMMARY ***
Total pot $4.25 | Rake $0.21 
Board [6s Jc Ac]
Seat 1: Xamil666 folded before Flop (didn't bet)
Seat 3: akbloger (button) folded before Flop (didn't bet)
Seat 4: $lavik88 (small blind) folded before Flop
Seat 5: WarllocK1982 (big blind) folded before Flop
Seat 6: Nestle170 folded before Flop (didn't bet)
Seat 7: danthaur folded before Flop (didn't bet)
Seat 8: m11k1989 collected ($4.04)
Seat 9: Mmago24 folded on the Flop



PokerStars Hand #228687768531:  Hold'em No Limit ($0.25/$0.50 USD) - 2021/07/30 16:02:19 ET
Table 'Galilea III' 9-max Seat #5 is the button
Seat 1: Xamil666 ($102.34 in chips) 
Seat 3: akbloger ($53.16 in chips) 
Seat 4: $lavik88 ($79.35 in chips) 
Seat 5: WarllocK1982 ($60.62 in chips) 
Seat 6: Nestle170 ($50 in chips) 
Seat 7: danthaur ($50 in chips) 
Seat 8: m11k1989 ($44.44 in chips) 
Seat 9: Mmago24 ($66.01 in chips) 
Nestle170: posts small blind $0.25
danthaur: posts big blind $0.50
v.sting: sits out 
*** HOLE CARDS ***
m11k1989: raises $0.50 to $1
Mmago24: folds 
Xamil666: folds 
akbloger: folds 
$lavik88: folds 
WarllocK1982: raises $3 to $4
Nestle170: folds 
danthaur: folds 
m11k1989: calls $3
*** FLOP *** [2s 7d Qh]
m11k1989: checks 
WarllocK1982: bets $2.74
m11k1989: calls $2.74
*** TURN *** [2s 7d Qh] [9h]
m11k1989: bets $3
WarllocK1982: raises $7.50 to $10.50
m11k1989: calls $7.50
*** RIVER *** [2s 7d Qh 9h] [Th]
m11k1989: checks 
WarllocK1982: bets $27.50
m11k1989: calls $27.20 and is all-in
Uncalled bet ($0.30) returned to WarllocK1982
*** SHOW DOWN ***
WarllocK1982: shows [Qs Qd] (three of a kind, Queens)
m11k1989: shows [6s 8s] (a straight, Six to Ten)
m11k1989 collected $87.63 from pot
*** SUMMARY ***
Total pot $89.63 | Rake $2 
Board [2s 7d Qh 9h Th]
Seat 1: Xamil666 folded before Flop (didn't bet)
Seat 3: akbloger folded before Flop (didn't bet)
Seat 4: $lavik88 folded before Flop (didn't bet)
Seat 5: WarllocK1982 (button) showed [Qs Qd] and lost with three of a kind, Queens
Seat 6: Nestle170 (small blind) folded before Flop
Seat 7: danthaur (big blind) folded before Flop
Seat 8: m11k1989 showed [6s 8s] and won ($87.63) with a straight, Six to Ten
Seat 9: Mmago24 folded before Flop (didn't bet)



PokerStars Hand #228687807860:  Hold'em No Limit ($0.25/$0.50 USD) - 2021/07/30 16:03:45 ET
Table 'Galilea III' 9-max Seat #6 is the button
Seat 1: Xamil666 ($102.34 in chips) 
Seat 3: akbloger ($53.16 in chips) 
Seat 4: $lavik88 ($79.35 in chips) 
Seat 5: WarllocK1982 ($50 in chips) 
Seat 6: Nestle170 ($50 in chips) 
Seat 7: danthaur ($50 in chips) 
Seat 8: m11k1989 ($87.63 in chips) 
Seat 9: Mmago24 ($66.01 in chips) 
danthaur: posts small blind $0.25
m11k1989: posts big blind $0.50
v.sting: sits out 
*** HOLE CARDS ***
Mmago24: folds 
Xamil666: folds 
akbloger: raises $0.75 to $1.25
$lavik88: folds 
WarllocK1982: folds 
Nestle170: folds 
danthaur: folds 
m11k1989: calls $0.75
*** FLOP *** [8d As 7h]
m11k1989: checks 
akbloger: checks 
*** TURN *** [8d As 7h] [2d]
m11k1989: bets $0.50
akbloger: calls $0.50
*** RIVER *** [8d As 7h 2d] [3h]
m11k1989: bets $0.50
akbloger: calls $0.50
*** SHOW DOWN ***
m11k1989: shows [Qs Qh] (a pair of Queens)
akbloger: mucks hand 
m11k1989 collected $4.51 from pot
*** SUMMARY ***
Total pot $4.75 | Rake $0.24 
Board [8d As 7h 2d 3h]
Seat 1: Xamil666 folded before Flop (didn't bet)
Seat 3: akbloger mucked
Seat 4: $lavik88 folded before Flop (didn't bet)
Seat 5: WarllocK1982 folded before Flop (didn't bet)
Seat 6: Nestle170 (button) folded before Flop (didn't bet)
Seat 7: danthaur (small blind) folded before Flop
Seat 8: m11k1989 (big blind) showed [Qs Qh] and won ($4.51) with a pair of Queens
Seat 9: Mmago24 folded before Flop (didn't bet)



PokerStars Hand #228687819829:  Hold'em No Limit ($0.25/$0.50 USD) - 2021/07/30 16:04:11 ET
Table 'Galilea III' 9-max Seat #7 is the button
Seat 1: Xamil666 ($102.34 in chips) 
Seat 3: akbloger ($50.91 in chips) 
Seat 4: $lavik88 ($79.35 in chips) 
Seat 5: WarllocK1982 ($50 in chips) 
Seat 6: Nestle170 ($50 in chips) 
Seat 7: danthaur ($50 in chips) 
Seat 8: m11k1989 ($89.89 in chips) 
m11k1989: posts small blind $0.25
Mmago24: is sitting out 
Xamil666: posts big blind $0.50
v.sting: sits out 
*** HOLE CARDS ***
akbloger: folds 
$lavik88: folds 
WarllocK1982: folds 
Nestle170: folds 
danthaur: folds 
m11k1989: calls $0.25
Xamil666: checks 
*** FLOP *** [6d 4h As]
m11k1989: checks 
Xamil666: checks 
*** TURN *** [6d 4h As] [2h]
m11k1989: checks 
Xamil666: checks 
*** RIVER *** [6d 4h As 2h] [Kh]
m11k1989: checks 
Xamil666: checks 
*** SHOW DOWN ***
m11k1989: shows [9c Qs] (high card Ace)
Xamil666: mucks hand 
m11k1989 collected $0.95 from pot
*** SUMMARY ***
Total pot $1 | Rake $0.05 
Board [6d 4h As 2h Kh]
Seat 1: Xamil666 (big blind) mucked
Seat 3: akbloger folded before Flop (didn't bet)
Seat 4: $lavik88 folded before Flop (didn't bet)
Seat 5: WarllocK1982 folded before Flop (didn't bet)
Seat 6: Nestle170 folded before Flop (didn't bet)
Seat 7: danthaur (button) folded before Flop (didn't bet)
Seat 8: m11k1989 (small blind) showed [9c Qs] and won ($0.95) with high card Ace



PokerStars Hand #228687839030:  Hold'em No Limit ($0.25/$0.50 USD) - 2021/07/30 16:04:53 ET
Table 'Galilea III' 9-max Seat #8 is the button
Seat 1: Xamil666 ($101.84 in chips) 
Seat 2: v.sting ($92.13 in chips) 
Seat 3: akbloger ($50.91 in chips) 
Seat 4: $lavik88 ($79.35 in chips) 
Seat 5: WarllocK1982 ($50 in chips) 
Seat 6: Nestle170 ($50 in chips) 
Seat 7: danthaur ($50 in chips) 
Seat 8: m11k1989 ($90.34 in chips) 
Xamil666: posts small blind $0.25
v.sting: posts big blind $0.50
*** HOLE CARDS ***
akbloger: folds 
$lavik88: folds 
WarllocK1982: folds 
Nestle170: folds 
danthaur: raises $0.75 to $1.25
m11k1989: folds 
Xamil666: folds 
v.sting: calls $0.75
*** FLOP *** [Qh 2s 9d]
v.sting: checks 
danthaur: checks 
*** TURN *** [Qh 2s 9d] [Ad]
v.sting: bets $0.86
danthaur: folds 
Uncalled bet ($0.86) returned to v.sting
v.sting collected $2.61 from pot
v.sting: doesn't show hand 
*** SUMMARY ***
Total pot $2.75 | Rake $0.14 
Board [Qh 2s 9d Ad]
Seat 1: Xamil666 (small blind) folded before Flop
Seat 2: v.sting (big blind) collected ($2.61)
Seat 3: akbloger folded before Flop (didn't bet)
Seat 4: $lavik88 folded before Flop (didn't bet)
Seat 5: WarllocK1982 folded before Flop (didn't bet)
Seat 6: Nestle170 folded before Flop (didn't bet)
Seat 7: danthaur folded on the Turn
Seat 8: m11k1989 (button) folded before Flop (didn't bet)



PokerStars Hand #228687866139:  Hold'em No Limit ($0.25/$0.50 USD) - 2021/07/30 16:05:51 ET
Table 'Galilea III' 9-max Seat #1 is the button
Seat 1: Xamil666 ($101.59 in chips) 
Seat 2: v.sting ($93.49 in chips) 
Seat 3: akbloger ($50.91 in chips) 
Seat 4: $lavik88 ($79.35 in chips) 
Seat 5: WarllocK1982 ($50 in chips) 
Seat 6: Nestle170 ($50 in chips) 
Seat 7: danthaur ($50 in chips) 
Seat 8: m11k1989 ($90.34 in chips) 
v.sting: posts small blind $0.25
akbloger: posts big blind $0.50
*** HOLE CARDS ***
$lavik88: folds 
WarllocK1982: folds 
Nestle170: folds 
danthaur: folds 
m11k1989: calls $0.50
Xamil666: folds 
v.sting: folds 
akbloger: raises $1.50 to $2
m11k1989: calls $1.50
*** FLOP *** [3s Th 2d]
akbloger: checks 
m11k1989: bets $0.50
akbloger: calls $0.50
*** TURN *** [3s Th 2d] [5s]
akbloger: checks 
m11k1989: bets $1.50
akbloger: folds 
Uncalled bet ($1.50) returned to m11k1989
m11k1989 collected $4.99 from pot
m11k1989: doesn't show hand 
*** SUMMARY ***
Total pot $5.25 | Rake $0.26 
Board [3s Th 2d 5s]
Seat 1: Xamil666 (button) folded before Flop (didn't bet)
Seat 2: v.sting (small blind) folded before Flop
Seat 3: akbloger (big blind) folded on the Turn
Seat 4: $lavik88 folded before Flop (didn't bet)
Seat 5: WarllocK1982 folded before Flop (didn't bet)
Seat 6: Nestle170 folded before Flop (didn't bet)
Seat 7: danthaur folded before Flop (didn't bet)
Seat 8: m11k1989 collected ($4.99)



PokerStars Hand #228687886796:  Hold'em No Limit ($0.25/$0.50 USD) - 2021/07/30 16:06:35 ET
Table 'Galilea III' 9-max Seat #2 is the button
Seat 1: Xamil666 ($101.59 in chips) 
Seat 2: v.sting ($93.24 in chips) 
Seat 3: akbloger ($50 in chips) 
Seat 4: $lavik88 ($79.35 in chips) 
Seat 5: WarllocK1982 ($50 in chips) 
Seat 6: Nestle170 ($50 in chips) 
Seat 7: danthaur ($50 in chips) 
Seat 8: m11k1989 ($92.83 in chips) 
akbloger: posts small blind $0.25
$lavik88: posts big blind $0.50
*** HOLE CARDS ***
WarllocK1982: folds 
Nestle170: folds 
danthaur: raises $1 to $1.50
m11k1989: folds 
Xamil666: folds 
v.sting: raises $3 to $4.50
akbloger: folds 
$lavik88: folds 
danthaur: calls $3
*** FLOP *** [9h Jd Ad]
danthaur: checks 
v.sting: bets $3.06
danthaur: calls $3.06
*** TURN *** [9h Jd Ad] [Td]
danthaur: checks 
v.sting: checks 
*** RIVER *** [9h Jd Ad Td] [6c]
danthaur: bets $11.31
v.sting: folds 
Uncalled bet ($11.31) returned to danthaur
danthaur collected $15.08 from pot
danthaur: doesn't show hand 
*** SUMMARY ***
Total pot $15.87 | Rake $0.79 
Board [9h Jd Ad Td 6c]
Seat 1: Xamil666 folded before Flop (didn't bet)
Seat 2: v.sting (button) folded on the River
Seat 3: akbloger (small blind) folded before Flop
Seat 4: $lavik88 (big blind) folded before Flop
Seat 5: WarllocK1982 folded before Flop (didn't bet)
Seat 6: Nestle170 folded before Flop (didn't bet)
Seat 7: danthaur collected ($15.08)
Seat 8: m11k1989 folded before Flop (didn't bet)



PokerStars Hand #228687943682:  Hold'em No Limit ($0.25/$0.50 USD) - 2021/07/30 16:08:20 ET
Table 'Galilea III' 9-max Seat #3 is the button
Seat 1: Xamil666 ($101.59 in chips) 
Seat 2: v.sting ($85.68 in chips) 
Seat 3: akbloger ($50 in chips) 
Seat 4: $lavik88 ($78.85 in chips) 
Seat 6: Nestle170 ($50 in chips) 
Seat 7: danthaur ($57.52 in chips) 
Seat 8: m11k1989 ($92.83 in chips) 
$lavik88: posts small blind $0.25
WarllocK1982: is sitting out 
WarllocK1982 leaves the table
Nestle170: posts big blind $0.50
*** HOLE CARDS ***
danthaur: folds 
m11k1989: calls $0.50
190K joins the table at seat #5 
Xamil666: folds 
v.sting: raises $2 to $2.50
akbloger: folds 
$lavik88: folds 
Nestle170: folds 
m11k1989: folds 
Uncalled bet ($2) returned to v.sting
v.sting collected $1.75 from pot
v.sting: doesn't show hand 
*** SUMMARY ***
Total pot $1.75 | Rake $0 
Seat 1: Xamil666 folded before Flop (didn't bet)
Seat 2: v.sting collected ($1.75)
Seat 3: akbloger (button) folded before Flop (didn't bet)
Seat 4: $lavik88 (small blind) folded before Flop
Seat 6: Nestle170 (big blind) folded before Flop
Seat 7: danthaur folded before Flop (didn't bet)
Seat 8: m11k1989 folded before Flop



PokerStars Hand #228687953041:  Hold'em No Limit ($0.25/$0.50 USD) - 2021/07/30 16:08:40 ET
Table 'Galilea III' 9-max Seat #4 is the button
Seat 1: Xamil666 ($101.59 in chips) 
Seat 2: v.sting ($86.93 in chips) 
Seat 3: akbloger ($50 in chips) 
Seat 4: $lavik88 ($78.60 in chips) 
Seat 6: Nestle170 ($50 in chips) 
Seat 7: danthaur ($57.52 in chips) 
Seat 8: m11k1989 ($92.33 in chips) 
Nestle170: posts small blind $0.25
danthaur: posts big blind $0.50
*** HOLE CARDS ***
m11k1989: raises $0.50 to $1
Xamil666: folds 
v.sting: folds 
akbloger: raises $3 to $4
$lavik88: folds 
Nestle170: folds 
danthaur: folds 
m11k1989: calls $3
*** FLOP *** [Ks 2h Th]
m11k1989: checks 
akbloger: bets $4.14
m11k1989: calls $4.14
*** TURN *** [Ks 2h Th] [9c]
m11k1989: bets $1.50
akbloger: raises $14.05 to $15.55
m11k1989: folds 
Uncalled bet ($14.05) returned to akbloger
akbloger collected $19.03 from pot
akbloger: doesn't show hand 
*** SUMMARY ***
Total pot $20.03 | Rake $1 
Board [Ks 2h Th 9c]
Seat 1: Xamil666 folded before Flop (didn't bet)
Seat 2: v.sting folded before Flop (didn't bet)
Seat 3: akbloger collected ($19.03)
Seat 4: $lavik88 (button) folded before Flop (didn't bet)
Seat 6: Nestle170 (small blind) folded before Flop
Seat 7: danthaur (big blind) folded before Flop
Seat 8: m11k1989 folded on the Turn



PokerStars Hand #228687986234:  Hold'em No Limit ($0.25/$0.50 USD) - 2021/07/30 16:09:51 ET
Table 'Galilea III' 9-max Seat #6 is the button
Seat 1: Xamil666 ($101.59 in chips) 
Seat 2: v.sting ($86.93 in chips) 
Seat 3: akbloger ($59.39 in chips) 
Seat 4: $lavik88 ($78.60 in chips) 
Seat 6: Nestle170 ($50 in chips) 
Seat 7: danthaur ($57.02 in chips) 
Seat 8: m11k1989 ($82.69 in chips) 
danthaur: posts small blind $0.25
m11k1989: posts big blind $0.50
Mmago24: sits out 
190K: sits out 
*** HOLE CARDS ***
Xamil666: folds 
v.sting: folds 
akbloger: folds 
$lavik88 has timed out
$lavik88: folds 
Nestle170: raises $0.60 to $1.10
danthaur: folds 
m11k1989: calls $0.60
*** FLOP *** [Ac 5c 4h]
m11k1989: bets $0.50
Nestle170: raises $1.75 to $2.25
m11k1989: folds 
Uncalled bet ($1.75) returned to Nestle170
Nestle170 collected $3.28 from pot
Nestle170: doesn't show hand 
*** SUMMARY ***
Total pot $3.45 | Rake $0.17 
Board [Ac 5c 4h]
Seat 1: Xamil666 folded before Flop (didn't bet)
Seat 2: v.sting folded before Flop (didn't bet)
Seat 3: akbloger folded before Flop (didn't bet)
Seat 4: $lavik88 folded before Flop (didn't bet)
Seat 6: Nestle170 (button) collected ($3.28)
Seat 7: danthaur (small blind) folded before Flop
Seat 8: m11k1989 (big blind) folded on the Flop



PokerStars Hand #228688011195:  Hold'em No Limit ($0.25/$0.50 USD) - 2021/07/30 16:10:43 ET
Table 'Galilea III' 9-max Seat #7 is the button
Seat 1: Xamil666 ($101.59 in chips) 
Seat 2: v.sting ($86.93 in chips) 
Seat 3: akbloger ($59.39 in chips) 
Seat 4: $lavik88 ($78.60 in chips) 
Seat 6: Nestle170 ($51.68 in chips) 
Seat 7: danthaur ($56.77 in chips) 
Seat 8: m11k1989 ($81.09 in chips) 
Seat 9: Mmago24 ($66.01 in chips) 
m11k1989: posts small blind $0.25
Mmago24: posts big blind $0.50
190K: sits out 
*** HOLE CARDS ***
Xamil666: folds 
v.sting: folds 
akbloger: folds 
$lavik88: folds 
Nestle170: folds 
danthaur: folds 
m11k1989: calls $0.25
Mmago24: checks 
*** FLOP *** [Jh 2d 3h]
m11k1989: checks 
Mmago24: checks 
*** TURN *** [Jh 2d 3h] [Kc]
m11k1989: bets $0.95
Mmago24: folds 
Uncalled bet ($0.95) returned to m11k1989
m11k1989 collected $0.95 from pot
m11k1989: doesn't show hand 
*** SUMMARY ***
Total pot $1 | Rake $0.05 
Board [Jh 2d 3h Kc]
Seat 1: Xamil666 folded before Flop (didn't bet)
Seat 2: v.sting folded before Flop (didn't bet)
Seat 3: akbloger folded before Flop (didn't bet)
Seat 4: $lavik88 folded before Flop (didn't bet)
Seat 6: Nestle170 folded before Flop (didn't bet)
Seat 7: danthaur (button) folded before Flop (didn't bet)
Seat 8: m11k1989 (small blind) collected ($0.95)
Seat 9: Mmago24 (big blind) folded on the Turn



PokerStars Hand #228688027545:  Hold'em No Limit ($0.25/$0.50 USD) - 2021/07/30 16:11:18 ET
Table 'Galilea III' 9-max Seat #8 is the button
Seat 1: Xamil666 ($101.59 in chips) 
Seat 2: v.sting ($86.93 in chips) 
Seat 3: akbloger ($59.39 in chips) 
Seat 4: $lavik88 ($78.60 in chips) 
Seat 6: Nestle170 ($51.68 in chips) 
Seat 7: danthaur ($56.77 in chips) 
Seat 8: m11k1989 ($81.54 in chips) 
Seat 9: Mmago24 ($65.51 in chips) 
Mmago24: posts small blind $0.25
Xamil666: posts big blind $0.50
190K: sits out 
*** HOLE CARDS ***
v.sting: folds 
akbloger: folds 
$lavik88: folds 
Nestle170: raises $1.50 to $2
danthaur: folds 
m11k1989: folds 
Mmago24: folds 
Xamil666: folds 
Uncalled bet ($1.50) returned to Nestle170
Nestle170 collected $1.25 from pot
Nestle170: doesn't show hand 
*** SUMMARY ***
Total pot $1.25 | Rake $0 
Seat 1: Xamil666 (big blind) folded before Flop
Seat 2: v.sting folded before Flop (didn't bet)
Seat 3: akbloger folded before Flop (didn't bet)
Seat 4: $lavik88 folded before Flop (didn't bet)
Seat 6: Nestle170 collected ($1.25)
Seat 7: danthaur folded before Flop (didn't bet)
Seat 8: m11k1989 (button) folded before Flop (didn't bet)
Seat 9: Mmago24 (small blind) folded before Flop



PokerStars Hand #228688043833:  Hold'em No Limit ($0.25/$0.50 USD) - 2021/07/30 16:11:53 ET
Table 'Galilea III' 9-max Seat #9 is the button
Seat 1: Xamil666 ($101.09 in chips) 
Seat 2: v.sting ($86.93 in chips) 
Seat 3: akbloger ($59.39 in chips) 
Seat 4: $lavik88 ($78.60 in chips) 
Seat 6: Nestle170 ($52.43 in chips) 
Seat 7: danthaur ($56.77 in chips) 
Seat 8: m11k1989 ($81.54 in chips) 
Seat 9: Mmago24 ($65.26 in chips) 
Xamil666: posts small blind $0.25
v.sting: posts big blind $0.50
190K: sits out 
*** HOLE CARDS ***
akbloger: folds 
$lavik88: folds 
Nestle170: folds 
danthaur: folds 
m11k1989: calls $0.50
Mmago24: folds 
Xamil666: folds 
v.sting: raises $2.50 to $3
m11k1989: folds 
Uncalled bet ($2.50) returned to v.sting
v.sting collected $1.25 from pot
v.sting: doesn't show hand 
*** SUMMARY ***
Total pot $1.25 | Rake $0 
Seat 1: Xamil666 (small blind) folded before Flop
Seat 2: v.sting (big blind) collected ($1.25)
Seat 3: akbloger folded before Flop (didn't bet)
Seat 4: $lavik88 folded before Flop (didn't bet)
Seat 6: Nestle170 folded before Flop (didn't bet)
Seat 7: danthaur folded before Flop (didn't bet)
Seat 8: m11k1989 folded before Flop
Seat 9: Mmago24 (button) folded before Flop (didn't bet)



PokerStars Hand #228688057750:  Hold'em No Limit ($0.25/$0.50 USD) - 2021/07/30 16:12:23 ET
Table 'Galilea III' 9-max Seat #1 is the button
Seat 1: Xamil666 ($100.84 in chips) 
Seat 2: v.sting ($87.68 in chips) 
Seat 3: akbloger ($59.39 in chips) 
Seat 4: $lavik88 ($78.60 in chips) 
Seat 6: Nestle170 ($52.43 in chips) 
Seat 7: danthaur ($56.77 in chips) 
Seat 8: m11k1989 ($81.04 in chips) 
Seat 9: Mmago24 ($65.26 in chips) 
v.sting: posts small blind $0.25
akbloger: posts big blind $0.50
190K: sits out 
*** HOLE CARDS ***
$lavik88: folds 
Nestle170: folds 
danthaur: raises $1 to $1.50
m11k1989: folds 
Mmago24: folds 
Xamil666: folds 
v.sting: folds 
akbloger: folds 
Uncalled bet ($1) returned to danthaur
danthaur collected $1.25 from pot
danthaur: doesn't show hand 
*** SUMMARY ***
Total pot $1.25 | Rake $0 
Seat 1: Xamil666 (button) folded before Flop (didn't bet)
Seat 2: v.sting (small blind) folded before Flop
Seat 3: akbloger (big blind) folded before Flop
Seat 4: $lavik88 folded before Flop (didn't bet)
Seat 6: Nestle170 folded before Flop (didn't bet)
Seat 7: danthaur collected ($1.25)
Seat 8: m11k1989 folded before Flop (didn't bet)
Seat 9: Mmago24 folded before Flop (didn't bet)



PokerStars Hand #228688070066:  Hold'em No Limit ($0.25/$0.50 USD) - 2021/07/30 16:12:50 ET
Table 'Galilea III' 9-max Seat #2 is the button
Seat 1: Xamil666 ($100.84 in chips) 
Seat 2: v.sting ($87.43 in chips) 
Seat 3: akbloger ($58.89 in chips) 
Seat 4: $lavik88 ($78.60 in chips) 
Seat 6: Nestle170 ($52.43 in chips) 
Seat 7: danthaur ($57.52 in chips) 
Seat 8: m11k1989 ($81.04 in chips) 
Seat 9: Mmago24 ($65.26 in chips) 
akbloger: posts small blind $0.25
$lavik88: posts big blind $0.50
190K: sits out 
*** HOLE CARDS ***
Nestle170: raises $1 to $1.50
danthaur: folds 
m11k1989: calls $1.50
Mmago24: folds 
Xamil666: folds 
v.sting: folds 
akbloger: folds 
$lavik88: folds 
*** FLOP *** [Js 5s Ah]
Nestle170: bets $1.25
m11k1989: calls $1.25
*** TURN *** [Js 5s Ah] [9d]
Nestle170: checks 
m11k1989: bets $4
Nestle170: raises $7.67 to $11.67
m11k1989: folds 
Uncalled bet ($7.67) returned to Nestle170
Nestle170 collected $13.54 from pot
Nestle170: doesn't show hand 
*** SUMMARY ***
Total pot $14.25 | Rake $0.71 
Board [Js 5s Ah 9d]
Seat 1: Xamil666 folded before Flop (didn't bet)
Seat 2: v.sting (button) folded before Flop (didn't bet)
Seat 3: akbloger (small blind) folded before Flop
Seat 4: $lavik88 (big blind) folded before Flop
Seat 6: Nestle170 collected ($13.54)
Seat 7: danthaur folded before Flop (didn't bet)
Seat 8: m11k1989 folded on the Turn
Seat 9: Mmago24 folded before Flop (didn't bet)



PokerStars Hand #228688093977:  Hold'em No Limit ($0.25/$0.50 USD) - 2021/07/30 16:13:41 ET
Table 'Galilea III' 9-max Seat #3 is the button
Seat 1: Xamil666 ($100.84 in chips) 
Seat 2: v.sting ($87.43 in chips) 
Seat 3: akbloger ($58.64 in chips) 
Seat 4: $lavik88 ($78.10 in chips) 
Seat 5: 190K ($50 in chips) 
Seat 6: Nestle170 ($59.22 in chips) 
Seat 7: danthaur ($57.52 in chips) 
Seat 8: m11k1989 ($74.29 in chips) 
Seat 9: Mmago24 ($65.26 in chips) 
$lavik88: posts small blind $0.25
190K: posts big blind $0.50
*** HOLE CARDS ***
Nestle170: raises $1 to $1.50
danthaur: folds 
m11k1989: folds 
Mmago24: folds 
Xamil666: folds 
v.sting: folds 
akbloger: folds 
$lavik88: folds 
190K: calls $1
*** FLOP *** [As 5s Kd]
190K: checks 
Nestle170: checks 
*** TURN *** [As 5s Kd] [9h]
190K: checks 
Nestle170: checks 
*** RIVER *** [As 5s Kd 9h] [Qh]
190K: checks 
Nestle170: bets $2.32
190K: folds 
Uncalled bet ($2.32) returned to Nestle170
Nestle170 collected $3.09 from pot
Nestle170: doesn't show hand 
*** SUMMARY ***
Total pot $3.25 | Rake $0.16 
Board [As 5s Kd 9h Qh]
Seat 1: Xamil666 folded before Flop (didn't bet)
Seat 2: v.sting folded before Flop (didn't bet)
Seat 3: akbloger (button) folded before Flop (didn't bet)
Seat 4: $lavik88 (small blind) folded before Flop
Seat 5: 190K (big blind) folded on the River
Seat 6: Nestle170 collected ($3.09)
Seat 7: danthaur folded before Flop (didn't bet)
Seat 8: m11k1989 folded before Flop (didn't bet)
Seat 9: Mmago24 folded before Flop (didn't bet)



PokerStars Hand #228688127644:  Hold'em No Limit ($0.25/$0.50 USD) - 2021/07/30 16:14:54 ET
Table 'Galilea III' 9-max Seat #4 is the button
Seat 1: Xamil666 ($100.84 in chips) 
Seat 2: v.sting ($87.43 in chips) 
Seat 3: akbloger ($58.64 in chips) 
Seat 4: $lavik88 ($77.85 in chips) 
Seat 5: 190K ($50 in chips) 
Seat 6: Nestle170 ($60.81 in chips) 
Seat 7: danthaur ($57.52 in chips) 
Seat 8: m11k1989 ($74.29 in chips) 
Seat 9: Mmago24 ($65.26 in chips) 
190K: posts small blind $0.25
Nestle170: posts big blind $0.50
*** HOLE CARDS ***
danthaur: folds 
m11k1989: folds 
Mmago24: raises $0.72 to $1.22
Xamil666: folds 
v.sting: raises $2.78 to $4
akbloger: folds 
$lavik88: folds 
190K: folds 
Nestle170: folds 
Mmago24: calls $2.78
*** FLOP *** [Kc 8h 4c]
Mmago24: checks 
v.sting: bets $2.74
Mmago24: folds 
Uncalled bet ($2.74) returned to v.sting
v.sting collected $8.31 from pot
v.sting: doesn't show hand 
*** SUMMARY ***
Total pot $8.75 | Rake $0.44 
Board [Kc 8h 4c]
Seat 1: Xamil666 folded before Flop (didn't bet)
Seat 2: v.sting collected ($8.31)
Seat 3: akbloger folded before Flop (didn't bet)
Seat 4: $lavik88 (button) folded before Flop (didn't bet)
Seat 5: 190K (small blind) folded before Flop
Seat 6: Nestle170 (big blind) folded before Flop
Seat 7: danthaur folded before Flop (didn't bet)
Seat 8: m11k1989 folded before Flop (didn't bet)
Seat 9: Mmago24 folded on the Flop



PokerStars Hand #228688161248:  Hold'em No Limit ($0.25/$0.50 USD) - 2021/07/30 16:15:53 ET
Table 'Galilea III' 9-max Seat #5 is the button
Seat 1: Xamil666 ($100.84 in chips) 
Seat 2: v.sting ($91.74 in chips) 
Seat 3: akbloger ($58.64 in chips) 
Seat 4: $lavik88 ($77.85 in chips) 
Seat 5: 190K ($50 in chips) 
Seat 6: Nestle170 ($60.31 in chips) 
Seat 7: danthaur ($57.52 in chips) 
Seat 8: m11k1989 ($74.29 in chips) 
Seat 9: Mmago24 ($61.26 in chips) 
Nestle170: posts small blind $0.25
danthaur: posts big blind $0.50
*** HOLE CARDS ***
m11k1989: raises $0.50 to $1
Mmago24: folds 
Xamil666: folds 
v.sting: folds 
akbloger: raises $3 to $4
$lavik88: folds 
190K: folds 
Nestle170: folds 
danthaur: folds 
m11k1989: calls $3
*** FLOP *** [Kc 2h 5d]
m11k1989: checks 
akbloger: checks 
*** TURN *** [Kc 2h 5d] [7d]
m11k1989: bets $5
akbloger: folds 
Uncalled bet ($5) returned to m11k1989
m11k1989 collected $8.31 from pot
m11k1989: doesn't show hand 
*** SUMMARY ***
Total pot $8.75 | Rake $0.44 
Board [Kc 2h 5d 7d]
Seat 1: Xamil666 folded before Flop (didn't bet)
Seat 2: v.sting folded before Flop (didn't bet)
Seat 3: akbloger folded on the Turn
Seat 4: $lavik88 folded before Flop (didn't bet)
Seat 5: 190K (button) folded before Flop (didn't bet)
Seat 6: Nestle170 (small blind) folded before Flop
Seat 7: danthaur (big blind) folded before Flop
Seat 8: m11k1989 collected ($8.31)
Seat 9: Mmago24 folded before Flop (didn't bet)



PokerStars Hand #228688189664:  Hold'em No Limit ($0.25/$0.50 USD) - 2021/07/30 16:16:52 ET
Table 'Galilea III' 9-max Seat #6 is the button
Seat 1: Xamil666 ($100.84 in chips) 
Seat 2: v.sting ($91.74 in chips) 
Seat 3: akbloger ($54.64 in chips) 
Seat 4: $lavik88 ($77.85 in chips) 
Seat 5: 190K ($50 in chips) 
Seat 6: Nestle170 ($60.06 in chips) 
Seat 7: danthaur ($57.02 in chips) 
Seat 8: m11k1989 ($78.60 in chips) 
Seat 9: Mmago24 ($61.26 in chips) 
danthaur: posts small blind $0.25
m11k1989: posts big blind $0.50
*** HOLE CARDS ***
Mmago24: folds 
Xamil666: raises $1 to $1.50
v.sting: folds 
akbloger: folds 
$lavik88: folds 
190K: raises $3 to $4.50
Nestle170: folds 
danthaur: folds 
m11k1989: folds 
Mmago24 leaves the table
Xamil666: folds 
Uncalled bet ($3) returned to 190K
190K collected $3.75 from pot
190K: doesn't show hand 
*** SUMMARY ***
Total pot $3.75 | Rake $0 
Seat 1: Xamil666 folded before Flop
Seat 2: v.sting folded before Flop (didn't bet)
Seat 3: akbloger folded before Flop (didn't bet)
Seat 4: $lavik88 folded before Flop (didn't bet)
Seat 5: 190K collected ($3.75)
Seat 6: Nestle170 (button) folded before Flop (didn't bet)
Seat 7: danthaur (small blind) folded before Flop
Seat 8: m11k1989 (big blind) folded before Flop
Seat 9: Mmago24 folded before Flop (didn't bet)



PokerStars Hand #228688209779:  Hold'em No Limit ($0.25/$0.50 USD) - 2021/07/30 16:17:33 ET
Table 'Galilea III' 9-max Seat #7 is the button
Seat 1: Xamil666 ($99.34 in chips) 
Seat 2: v.sting ($91.74 in chips) 
Seat 3: akbloger ($54.64 in chips) 
Seat 4: $lavik88 ($77.85 in chips) 
Seat 5: 190K ($52.25 in chips) 
Seat 6: Nestle170 ($60.06 in chips) 
Seat 7: danthaur ($56.77 in chips) 
Seat 8: m11k1989 ($78.10 in chips) 
m11k1989: posts small blind $0.25
Xamil666: posts big blind $0.50
*** HOLE CARDS ***
v.sting: folds 
akbloger: folds 
$lavik88: folds 
190K: raises $1 to $1.50
Nestle170: folds 
danthaur: folds 
m11k1989: calls $1.25
Xamil666: folds 
*** FLOP *** [Ts 9c Js]
m11k1989: bets $0.50
190K: calls $0.50
*** TURN *** [Ts 9c Js] [9h]
m11k1989: checks 
190K: checks 
*** RIVER *** [Ts 9c Js 9h] [Tc]
m11k1989: bets $4.28
holdemamn joins the table at seat #9 
190K: folds 
Uncalled bet ($4.28) returned to m11k1989
m11k1989 collected $4.28 from pot
m11k1989: doesn't show hand 
*** SUMMARY ***
Total pot $4.50 | Rake $0.22 
Board [Ts 9c Js 9h Tc]
Seat 1: Xamil666 (big blind) folded before Flop
Seat 2: v.sting folded before Flop (didn't bet)
Seat 3: akbloger folded before Flop (didn't bet)
Seat 4: $lavik88 folded before Flop (didn't bet)
Seat 5: 190K folded on the River
Seat 6: Nestle170 folded before Flop (didn't bet)
Seat 7: danthaur (button) folded before Flop (didn't bet)
Seat 8: m11k1989 (small blind) collected ($4.28)



PokerStars Hand #228688232216:  Hold'em No Limit ($0.25/$0.50 USD) - 2021/07/30 16:18:19 ET
Table 'Galilea III' 9-max Seat #8 is the button
Seat 1: Xamil666 ($98.84 in chips) 
Seat 2: v.sting ($91.74 in chips) 
Seat 3: akbloger ($54.64 in chips) 
Seat 4: $lavik88 ($77.85 in chips) 
Seat 5: 190K ($50.25 in chips) 
Seat 6: Nestle170 ($60.06 in chips) 
Seat 7: danthaur ($56.77 in chips) 
Seat 8: m11k1989 ($80.38 in chips) 
Xamil666: posts small blind $0.25
v.sting: posts big blind $0.50
*** HOLE CARDS ***
akbloger: folds 
$lavik88: folds 
190K: folds 
Nestle170: folds 
danthaur: folds 
m11k1989: folds 
Xamil666: folds 
Uncalled bet ($0.25) returned to v.sting
v.sting collected $0.50 from pot
v.sting: doesn't show hand 
*** SUMMARY ***
Total pot $0.50 | Rake $0 
Seat 1: Xamil666 (small blind) folded before Flop
Seat 2: v.sting (big blind) collected ($0.50)
Seat 3: akbloger folded before Flop (didn't bet)
Seat 4: $lavik88 folded before Flop (didn't bet)
Seat 5: 190K folded before Flop (didn't bet)
Seat 6: Nestle170 folded before Flop (didn't bet)
Seat 7: danthaur folded before Flop (didn't bet)
Seat 8: m11k1989 (button) folded before Flop (didn't bet)



PokerStars Hand #228688241085:  Hold'em No Limit ($0.25/$0.50 USD) - 2021/07/30 16:18:37 ET
Table 'Galilea III' 9-max Seat #1 is the button
Seat 1: Xamil666 ($98.59 in chips) 
Seat 2: v.sting ($91.99 in chips) 
Seat 3: akbloger ($54.64 in chips) 
Seat 4: $lavik88 ($77.85 in chips) 
Seat 5: 190K ($50.25 in chips) 
Seat 6: Nestle170 ($60.06 in chips) 
Seat 7: danthaur ($56.77 in chips) 
Seat 8: m11k1989 ($80.38 in chips) 
v.sting: posts small blind $0.25
akbloger: posts big blind $0.50
holdemamn: sits out 
*** HOLE CARDS ***
$lavik88: folds 
190K: folds 
Nestle170: raises $1 to $1.50
danthaur: folds 
m11k1989: folds 
Xamil666: folds 
v.sting: folds 
akbloger: folds 
Uncalled bet ($1) returned to Nestle170
Nestle170 collected $1.25 from pot
Nestle170: doesn't show hand 
*** SUMMARY ***
Total pot $1.25 | Rake $0 
Seat 1: Xamil666 (button) folded before Flop (didn't bet)
Seat 2: v.sting (small blind) folded before Flop
Seat 3: akbloger (big blind) folded before Flop
Seat 4: $lavik88 folded before Flop (didn't bet)
Seat 5: 190K folded before Flop (didn't bet)
Seat 6: Nestle170 collected ($1.25)
Seat 7: danthaur folded before Flop (didn't bet)
Seat 8: m11k1989 folded before Flop (didn't bet)



PokerStars Hand #228688251602:  Hold'em No Limit ($0.25/$0.50 USD) - 2021/07/30 16:18:59 ET
Table 'Galilea III' 9-max Seat #2 is the button
Seat 1: Xamil666 ($98.59 in chips) 
Seat 2: v.sting ($91.74 in chips) 
Seat 3: akbloger ($54.14 in chips) 
Seat 4: $lavik88 ($77.85 in chips) 
Seat 5: 190K ($50.25 in chips) 
Seat 6: Nestle170 ($60.81 in chips) 
Seat 7: danthaur ($56.77 in chips) 
Seat 8: m11k1989 ($80.38 in chips) 
akbloger: posts small blind $0.25
$lavik88: posts big blind $0.50
holdemamn: sits out 
*** HOLE CARDS ***
190K: folds 
Nestle170: raises $1 to $1.50
danthaur: folds 
m11k1989: folds 
Xamil666: folds 
v.sting: folds 
akbloger: folds 
$lavik88: raises $4 to $5.50
Nestle170: folds 
Uncalled bet ($4) returned to $lavik88
$lavik88 collected $3.25 from pot
$lavik88: doesn't show hand 
*** SUMMARY ***
Total pot $3.25 | Rake $0 
Seat 1: Xamil666 folded before Flop (didn't bet)
Seat 2: v.sting (button) folded before Flop (didn't bet)
Seat 3: akbloger (small blind) folded before Flop
Seat 4: $lavik88 (big blind) collected ($3.25)
Seat 5: 190K folded before Flop (didn't bet)
Seat 6: Nestle170 folded before Flop
Seat 7: danthaur folded before Flop (didn't bet)
Seat 8: m11k1989 folded before Flop (didn't bet)



PokerStars Hand #228688272985:  Hold'em No Limit ($0.25/$0.50 USD) - 2021/07/30 16:19:43 ET
Table 'Galilea III' 9-max Seat #3 is the button
Seat 1: Xamil666 ($98.59 in chips) 
Seat 2: v.sting ($91.74 in chips) 
Seat 3: akbloger ($53.89 in chips) 
Seat 4: $lavik88 ($79.60 in chips) 
Seat 5: 190K ($50.25 in chips) 
Seat 6: Nestle170 ($59.31 in chips) 
Seat 7: danthaur ($56.77 in chips) 
Seat 8: m11k1989 ($80.38 in chips) 
$lavik88: posts small blind $0.25
190K: posts big blind $0.50
holdemamn: sits out 
*** HOLE CARDS ***
Nestle170: folds 
danthaur: folds 
m11k1989: calls $0.50
Xamil666: folds 
v.sting: folds 
akbloger: raises $1.50 to $2
$lavik88: folds 
190K: folds 
m11k1989: calls $1.50
*** FLOP *** [Kd 7d Kc]
m11k1989: checks 
akbloger: checks 
*** TURN *** [Kd 7d Kc] [4d]
m11k1989: bets $2.50
akbloger: calls $2.50
*** RIVER *** [Kd 7d Kc 4d] [6s]
m11k1989: bets $3.50
akbloger: calls $3.50
*** SHOW DOWN ***
m11k1989: shows [2s Qs] (a pair of Kings)
akbloger: shows [Ah Ac] (two pair, Aces and Kings)
akbloger collected $15.91 from pot
*** SUMMARY ***
Total pot $16.75 | Rake $0.84 
Board [Kd 7d Kc 4d 6s]
Seat 1: Xamil666 folded before Flop (didn't bet)
Seat 2: v.sting folded before Flop (didn't bet)
Seat 3: akbloger (button) showed [Ah Ac] and won ($15.91) with two pair, Aces and Kings
Seat 4: $lavik88 (small blind) folded before Flop
Seat 5: 190K (big blind) folded before Flop
Seat 6: Nestle170 folded before Flop (didn't bet)
Seat 7: danthaur folded before Flop (didn't bet)
Seat 8: m11k1989 showed [2s Qs] and lost with a pair of Kings



PokerStars Hand #228688293032:  Hold'em No Limit ($0.25/$0.50 USD) - 2021/07/30 16:20:24 ET
Table 'Galilea III' 9-max Seat #4 is the button
Seat 1: Xamil666 ($98.59 in chips) 
Seat 2: v.sting ($91.74 in chips) 
Seat 3: akbloger ($61.80 in chips) 
Seat 4: $lavik88 ($79.35 in chips) 
Seat 5: 190K ($50 in chips) 
Seat 6: Nestle170 ($59.31 in chips) 
Seat 7: danthaur ($56.77 in chips) 
Seat 8: m11k1989 ($72.38 in chips) 
190K: posts small blind $0.25
Nestle170: posts big blind $0.50
holdemamn: sits out 
*** HOLE CARDS ***
danthaur: folds 
m11k1989: raises $1 to $1.50
Xamil666: folds 
v.sting: folds 
akbloger: folds 
$lavik88: folds 
190K: folds 
Nestle170: folds 
Uncalled bet ($1) returned to m11k1989
m11k1989 collected $1.25 from pot
m11k1989: doesn't show hand 
*** SUMMARY ***
Total pot $1.25 | Rake $0 
Seat 1: Xamil666 folded before Flop (didn't bet)
Seat 2: v.sting folded before Flop (didn't bet)
Seat 3: akbloger folded before Flop (didn't bet)
Seat 4: $lavik88 (button) folded before Flop (didn't bet)
Seat 5: 190K (small blind) folded before Flop
Seat 6: Nestle170 (big blind) folded before Flop
Seat 7: danthaur folded before Flop (didn't bet)
Seat 8: m11k1989 collected ($1.25)



PokerStars Hand #228688300367:  Hold'em No Limit ($0.25/$0.50 USD) - 2021/07/30 16:20:39 ET
Table 'Galilea III' 9-max Seat #5 is the button
Seat 1: Xamil666 ($98.59 in chips) 
Seat 2: v.sting ($91.74 in chips) 
Seat 3: akbloger ($61.80 in chips) 
Seat 4: $lavik88 ($79.35 in chips) 
Seat 5: 190K ($50 in chips) 
Seat 6: Nestle170 ($58.81 in chips) 
Seat 7: danthaur ($56.77 in chips) 
Seat 8: m11k1989 ($73.13 in chips) 
Nestle170: posts small blind $0.25
danthaur: posts big blind $0.50
holdemamn: sits out 
*** HOLE CARDS ***
m11k1989: folds 
Xamil666: folds 
v.sting: folds 
akbloger: folds 
$lavik88: folds 
190K: raises $0.75 to $1.25
Nestle170: folds 
danthaur: raises $3.25 to $4.50
190K: calls $3.25
*** FLOP *** [2s 8s 6c]
danthaur: checks 
190K: bets $2.90
danthaur: folds 
Uncalled bet ($2.90) returned to 190K
190K collected $8.79 from pot
190K: doesn't show hand 
*** SUMMARY ***
Total pot $9.25 | Rake $0.46 
Board [2s 8s 6c]
Seat 1: Xamil666 folded before Flop (didn't bet)
Seat 2: v.sting folded before Flop (didn't bet)
Seat 3: akbloger folded before Flop (didn't bet)
Seat 4: $lavik88 folded before Flop (didn't bet)
Seat 5: 190K (button) collected ($8.79)
Seat 6: Nestle170 (small blind) folded before Flop
Seat 7: danthaur (big blind) folded on the Flop
Seat 8: m11k1989 folded before Flop (didn't bet)



PokerStars Hand #228688330288:  Hold'em No Limit ($0.25/$0.50 USD) - 2021/07/30 16:21:40 ET
Table 'Galilea III' 9-max Seat #6 is the button
Seat 1: Xamil666 ($98.59 in chips) 
Seat 2: v.sting ($91.74 in chips) 
Seat 3: akbloger ($61.80 in chips) 
Seat 4: $lavik88 ($79.35 in chips) 
Seat 5: 190K ($54.29 in chips) 
Seat 6: Nestle170 ($58.56 in chips) 
Seat 7: danthaur ($52.27 in chips) 
Seat 8: m11k1989 ($73.13 in chips) 
danthaur: posts small blind $0.25
m11k1989: posts big blind $0.50
holdemamn: sits out 
*** HOLE CARDS ***
Xamil666: raises $1 to $1.50
v.sting: folds 
akbloger: folds 
$lavik88: folds 
190K: folds 
Nestle170: raises $3 to $4.50
danthaur: folds 
m11k1989: folds 
Xamil666: folds 
Uncalled bet ($3) returned to Nestle170
Nestle170 collected $3.75 from pot
Nestle170: doesn't show hand 
*** SUMMARY ***
Total pot $3.75 | Rake $0 
Seat 1: Xamil666 folded before Flop
Seat 2: v.sting folded before Flop (didn't bet)
Seat 3: akbloger folded before Flop (didn't bet)
Seat 4: $lavik88 folded before Flop (didn't bet)
Seat 5: 190K folded before Flop (didn't bet)
Seat 6: Nestle170 (button) collected ($3.75)
Seat 7: danthaur (small blind) folded before Flop
Seat 8: m11k1989 (big blind) folded before Flop



PokerStars Hand #228688341908:  Hold'em No Limit ($0.25/$0.50 USD) - 2021/07/30 16:22:04 ET
Table 'Galilea III' 9-max Seat #7 is the button
Seat 1: Xamil666 ($97.09 in chips) 
Seat 2: v.sting ($91.74 in chips) 
Seat 3: akbloger ($61.80 in chips) 
Seat 4: $lavik88 ($79.35 in chips) 
Seat 5: 190K ($54.29 in chips) 
Seat 6: Nestle170 ($60.81 in chips) 
Seat 7: danthaur ($52.02 in chips) 
Seat 8: m11k1989 ($72.63 in chips) 
Seat 9: holdemamn ($50 in chips) 
m11k1989: posts small blind $0.25
holdemamn: posts big blind $0.50
*** HOLE CARDS ***
Xamil666: folds 
v.sting: raises $1 to $1.50
akbloger: folds 
$lavik88: folds 
190K: folds 
Nestle170: folds 
danthaur: folds 
m11k1989: calls $1.25
holdemamn: folds 
*** FLOP *** [7h Jh 5c]
m11k1989: bets $0.50
v.sting: raises $1.43 to $1.93
m11k1989: calls $1.43
*** TURN *** [7h Jh 5c] [4c]
m11k1989: bets $1
v.sting: calls $1
*** RIVER *** [7h Jh 5c 4c] [2c]
m11k1989: bets $10.50
v.sting: raises $14.50 to $25
m11k1989: folds 
Uncalled bet ($14.50) returned to v.sting
v.sting collected $28.84 from pot
v.sting: doesn't show hand 
*** SUMMARY ***
Total pot $30.36 | Rake $1.52 
Board [7h Jh 5c 4c 2c]
Seat 1: Xamil666 folded before Flop (didn't bet)
Seat 2: v.sting collected ($28.84)
Seat 3: akbloger folded before Flop (didn't bet)
Seat 4: $lavik88 folded before Flop (didn't bet)
Seat 5: 190K folded before Flop (didn't bet)
Seat 6: Nestle170 folded before Flop (didn't bet)
Seat 7: danthaur (button) folded before Flop (didn't bet)
Seat 8: m11k1989 (small blind) folded on the River
Seat 9: holdemamn (big blind) folded before Flop



PokerStars Hand #228688398159:  Hold'em No Limit ($0.25/$0.50 USD) - 2021/07/30 16:23:59 ET
Table 'Galilea III' 9-max Seat #8 is the button
Seat 1: Xamil666 ($97.09 in chips) 
Seat 2: v.sting ($105.65 in chips) 
Seat 3: akbloger ($61.80 in chips) 
Seat 4: $lavik88 ($79.35 in chips) 
Seat 5: 190K ($54.29 in chips) 
Seat 6: Nestle170 ($60.81 in chips) 
Seat 7: danthaur ($52.02 in chips) 
Seat 8: m11k1989 ($57.70 in chips) 
Seat 9: holdemamn ($50 in chips) 
holdemamn: posts small blind $0.25
Xamil666: posts big blind $0.50
*** HOLE CARDS ***
v.sting: folds 
akbloger: folds 
$lavik88: folds 
190K: folds 
Nestle170: raises $1 to $1.50
danthaur: folds 
m11k1989: calls $1.50
holdemamn: folds 
Xamil666: folds 
*** FLOP *** [4d 9d Ac]
Nestle170: checks 
m11k1989: checks 
*** TURN *** [4d 9d Ac] [5d]
Nestle170: bets $2.67
m11k1989: raises $2.67 to $5.34
Nestle170: raises $7.83 to $13.17
m11k1989: raises $43.03 to $56.20 and is all-in
Nestle170: folds 
Uncalled bet ($43.03) returned to m11k1989
m11k1989 collected $28.59 from pot
m11k1989: doesn't show hand 
*** SUMMARY ***
Total pot $30.09 | Rake $1.50 
Board [4d 9d Ac 5d]
Seat 1: Xamil666 (big blind) folded before Flop
Seat 2: v.sting folded before Flop (didn't bet)
Seat 3: akbloger folded before Flop (didn't bet)
Seat 4: $lavik88 folded before Flop (didn't bet)
Seat 5: 190K folded before Flop (didn't bet)
Seat 6: Nestle170 folded on the Turn
Seat 7: danthaur folded before Flop (didn't bet)
Seat 8: m11k1989 (button) collected ($28.59)
Seat 9: holdemamn (small blind) folded before Flop



PokerStars Hand #228688427672:  Hold'em No Limit ($0.25/$0.50 USD) - 2021/07/30 16:25:00 ET
Table 'Galilea III' 9-max Seat #9 is the button
Seat 1: Xamil666 ($96.59 in chips) 
Seat 2: v.sting ($105.65 in chips) 
Seat 3: akbloger ($61.80 in chips) 
Seat 4: $lavik88 ($79.35 in chips) 
Seat 5: 190K ($54.29 in chips) 
Seat 6: Nestle170 ($50 in chips) 
Seat 7: danthaur ($52.02 in chips) 
Seat 8: m11k1989 ($71.62 in chips) 
Seat 9: holdemamn ($50 in chips) 
Xamil666: posts small blind $0.25
v.sting: posts big blind $0.50
*** HOLE CARDS ***
akbloger: raises $1 to $1.50
$lavik88: folds 
190K: folds 
Nestle170: folds 
danthaur: folds 
m11k1989: calls $1.50
holdemamn: raises $5.50 to $7
Xamil666: folds 
v.sting: folds 
akbloger: folds 
m11k1989: folds 
Uncalled bet ($5.50) returned to holdemamn
holdemamn collected $5.25 from pot
holdemamn: doesn't show hand 
*** SUMMARY ***
Total pot $5.25 | Rake $0 
Seat 1: Xamil666 (small blind) folded before Flop
Seat 2: v.sting (big blind) folded before Flop
Seat 3: akbloger folded before Flop
Seat 4: $lavik88 folded before Flop (didn't bet)
Seat 5: 190K folded before Flop (didn't bet)
Seat 6: Nestle170 folded before Flop (didn't bet)
Seat 7: danthaur folded before Flop (didn't bet)
Seat 8: m11k1989 folded before Flop
Seat 9: holdemamn (button) collected ($5.25)



PokerStars Hand #228688441134:  Hold'em No Limit ($0.25/$0.50 USD) - 2021/07/30 16:25:28 ET
Table 'Galilea III' 9-max Seat #1 is the button
Seat 1: Xamil666 ($96.34 in chips) 
Seat 2: v.sting ($105.15 in chips) 
Seat 3: akbloger ($60.30 in chips) 
Seat 4: $lavik88 ($79.35 in chips) 
Seat 5: 190K ($54.29 in chips) 
Seat 6: Nestle170 ($50 in chips) 
Seat 7: danthaur ($52.02 in chips) 
Seat 8: m11k1989 ($70.12 in chips) 
Seat 9: holdemamn ($53.75 in chips) 
v.sting: posts small blind $0.25
akbloger: posts big blind $0.50
*** HOLE CARDS ***
$lavik88: folds 
190K: folds 
Nestle170: folds 
danthaur: raises $1 to $1.50
m11k1989: calls $1.50
holdemamn: folds 
Xamil666: folds 
v.sting: folds 
akbloger: folds 
*** FLOP *** [7s 8s Ac]
danthaur: checks 
m11k1989: bets $1.50
danthaur: folds 
Uncalled bet ($1.50) returned to m11k1989
m11k1989 collected $3.56 from pot
m11k1989: doesn't show hand 
*** SUMMARY ***
Total pot $3.75 | Rake $0.19 
Board [7s 8s Ac]
Seat 1: Xamil666 (button) folded before Flop (didn't bet)
Seat 2: v.sting (small blind) folded before Flop
Seat 3: akbloger (big blind) folded before Flop
Seat 4: $lavik88 folded before Flop (didn't bet)
Seat 5: 190K folded before Flop (didn't bet)
Seat 6: Nestle170 folded before Flop (didn't bet)
Seat 7: danthaur folded on the Flop
Seat 8: m11k1989 collected ($3.56)
Seat 9: holdemamn folded before Flop (didn't bet)



PokerStars Hand #228688455067:  Hold'em No Limit ($0.25/$0.50 USD) - 2021/07/30 16:25:57 ET
Table 'Galilea III' 9-max Seat #2 is the button
Seat 1: Xamil666 ($96.34 in chips) 
Seat 2: v.sting ($104.90 in chips) 
Seat 3: akbloger ($59.80 in chips) 
Seat 4: $lavik88 ($79.35 in chips) 
Seat 5: 190K ($54.29 in chips) 
Seat 6: Nestle170 ($50 in chips) 
Seat 7: danthaur ($50.52 in chips) 
Seat 8: m11k1989 ($72.18 in chips) 
Seat 9: holdemamn ($53.75 in chips) 
akbloger: posts small blind $0.25
$lavik88: posts big blind $0.50
*** HOLE CARDS ***
190K: raises $1 to $1.50
Nestle170: folds 
danthaur: folds 
m11k1989: folds 
holdemamn: folds 
Xamil666: folds 
v.sting: folds 
akbloger: folds 
$lavik88: folds 
Uncalled bet ($1) returned to 190K
190K collected $1.25 from pot
190K: doesn't show hand 
*** SUMMARY ***
Total pot $1.25 | Rake $0 
Seat 1: Xamil666 folded before Flop (didn't bet)
Seat 2: v.sting (button) folded before Flop (didn't bet)
Seat 3: akbloger (small blind) folded before Flop
Seat 4: $lavik88 (big blind) folded before Flop
Seat 5: 190K collected ($1.25)
Seat 6: Nestle170 folded before Flop (didn't bet)
Seat 7: danthaur folded before Flop (didn't bet)
Seat 8: m11k1989 folded before Flop (didn't bet)
Seat 9: holdemamn folded before Flop (didn't bet)



PokerStars Hand #228688470323:  Hold'em No Limit ($0.25/$0.50 USD) - 2021/07/30 16:26:28 ET
Table 'Galilea III' 9-max Seat #3 is the button
Seat 1: Xamil666 ($96.34 in chips) 
Seat 2: v.sting ($104.90 in chips) 
Seat 3: akbloger ($59.55 in chips) 
Seat 4: $lavik88 ($78.85 in chips) 
Seat 6: Nestle170 ($50 in chips) 
Seat 7: danthaur ($50.52 in chips) 
Seat 8: m11k1989 ($72.18 in chips) 
Seat 9: holdemamn ($53.75 in chips) 
$lavik88: posts small blind $0.25
190K: is sitting out 
Nestle170: posts big blind $0.50
*** HOLE CARDS ***
190K leaves the table
danthaur: folds 
m11k1989 has timed out
m11k1989: folds 
holdemamn: folds 
Xamil666: folds 
v.sting: folds 
akbloger: folds 
$lavik88: folds 
Uncalled bet ($0.25) returned to Nestle170
Nestle170 collected $0.50 from pot
Nestle170: doesn't show hand 
PleBeY95 joins the table at seat #5 
*** SUMMARY ***
Total pot $0.50 | Rake $0 
Seat 1: Xamil666 folded before Flop (didn't bet)
Seat 2: v.sting folded before Flop (didn't bet)
Seat 3: akbloger (button) folded before Flop (didn't bet)
Seat 4: $lavik88 (small blind) folded before Flop
Seat 6: Nestle170 (big blind) collected ($0.50)
Seat 7: danthaur folded before Flop (didn't bet)
Seat 8: m11k1989 folded before Flop (didn't bet)
Seat 9: holdemamn folded before Flop (didn't bet)



PokerStars Hand #228688480517:  Hold'em No Limit ($0.25/$0.50 USD) - 2021/07/30 16:26:49 ET
Table 'Galilea III' 9-max Seat #4 is the button
Seat 1: Xamil666 ($96.34 in chips) 
Seat 2: v.sting ($104.90 in chips) 
Seat 3: akbloger ($59.55 in chips) 
Seat 4: $lavik88 ($78.60 in chips) 
Seat 6: Nestle170 ($50.25 in chips) 
Seat 7: danthaur ($50.52 in chips) 
Seat 8: m11k1989 ($72.18 in chips) 
Seat 9: holdemamn ($53.75 in chips) 
Nestle170: posts small blind $0.25
danthaur: posts big blind $0.50
*** HOLE CARDS ***
m11k1989: calls $0.50
holdemamn: folds 
Xamil666: folds 
v.sting: folds 
akbloger: folds 
$lavik88: folds 
Nestle170: folds 
danthaur: checks 
*** FLOP *** [5s 3c Jc]
danthaur: checks 
m11k1989: checks 
*** TURN *** [5s 3c Jc] [4s]
danthaur: bets $0.65
m11k1989: folds 
Uncalled bet ($0.65) returned to danthaur
danthaur collected $1.19 from pot
danthaur: doesn't show hand 
*** SUMMARY ***
Total pot $1.25 | Rake $0.06 
Board [5s 3c Jc 4s]
Seat 1: Xamil666 folded before Flop (didn't bet)
Seat 2: v.sting folded before Flop (didn't bet)
Seat 3: akbloger folded before Flop (didn't bet)
Seat 4: $lavik88 (button) folded before Flop (didn't bet)
Seat 6: Nestle170 (small blind) folded before Flop
Seat 7: danthaur (big blind) collected ($1.19)
Seat 8: m11k1989 folded on the Turn
Seat 9: holdemamn folded before Flop (didn't bet)



PokerStars Hand #228688506089:  Hold'em No Limit ($0.25/$0.50 USD) - 2021/07/30 16:27:43 ET
Table 'Galilea III' 9-max Seat #6 is the button
Seat 1: Xamil666 ($96.34 in chips) 
Seat 2: v.sting ($104.90 in chips) 
Seat 3: akbloger ($59.55 in chips) 
Seat 4: $lavik88 ($78.60 in chips) 
Seat 6: Nestle170 ($50 in chips) 
Seat 7: danthaur ($51.21 in chips) 
Seat 8: m11k1989 ($71.68 in chips) 
Seat 9: holdemamn ($53.75 in chips) 
danthaur: posts small blind $0.25
m11k1989: posts big blind $0.50
PleBeY95: sits out 
*** HOLE CARDS ***
holdemamn: folds 
Xamil666: folds 
v.sting: folds 
akbloger: folds 
$lavik88: folds 
Nestle170: raises $0.75 to $1.25
danthaur: folds 
m11k1989: folds 
Uncalled bet ($0.75) returned to Nestle170
Nestle170 collected $1.25 from pot
Nestle170: doesn't show hand 
*** SUMMARY ***
Total pot $1.25 | Rake $0 
Seat 1: Xamil666 folded before Flop (didn't bet)
Seat 2: v.sting folded before Flop (didn't bet)
Seat 3: akbloger folded before Flop (didn't bet)
Seat 4: $lavik88 folded before Flop (didn't bet)
Seat 6: Nestle170 (button) collected ($1.25)
Seat 7: danthaur (small blind) folded before Flop
Seat 8: m11k1989 (big blind) folded before Flop
Seat 9: holdemamn folded before Flop (didn't bet)



PokerStars Hand #228688520492:  Hold'em No Limit ($0.25/$0.50 USD) - 2021/07/30 16:28:13 ET
Table 'Galilea III' 9-max Seat #7 is the button
Seat 1: Xamil666 ($96.34 in chips) 
Seat 2: v.sting ($104.90 in chips) 
Seat 3: akbloger ($59.55 in chips) 
Seat 4: $lavik88 ($78.60 in chips) 
Seat 6: Nestle170 ($50.75 in chips) 
Seat 7: danthaur ($50.96 in chips) 
Seat 8: m11k1989 ($71.18 in chips) 
Seat 9: holdemamn ($53.75 in chips) 
m11k1989: posts small blind $0.25
holdemamn: posts big blind $0.50
PleBeY95: sits out 
*** HOLE CARDS ***
Xamil666: folds 
v.sting: folds 
akbloger: folds 
$lavik88: raises $1 to $1.50
Nestle170: raises $3 to $4.50
danthaur: folds 
m11k1989: folds 
holdemamn: folds 
$lavik88: raises $7 to $11.50
Nestle170: folds 
Uncalled bet ($7) returned to $lavik88
$lavik88 collected $9.75 from pot
$lavik88: doesn't show hand 
*** SUMMARY ***
Total pot $9.75 | Rake $0 
Seat 1: Xamil666 folded before Flop (didn't bet)
Seat 2: v.sting folded before Flop (didn't bet)
Seat 3: akbloger folded before Flop (didn't bet)
Seat 4: $lavik88 collected ($9.75)
Seat 6: Nestle170 folded before Flop
Seat 7: danthaur (button) folded before Flop (didn't bet)
Seat 8: m11k1989 (small blind) folded before Flop
Seat 9: holdemamn (big blind) folded before Flop



PokerStars Hand #228688547983:  Hold'em No Limit ($0.25/$0.50 USD) - 2021/07/30 16:29:10 ET
Table 'Galilea III' 9-max Seat #8 is the button
Seat 1: Xamil666 ($96.34 in chips) 
Seat 2: v.sting ($104.90 in chips) 
Seat 3: akbloger ($59.55 in chips) 
Seat 4: $lavik88 ($83.85 in chips) 
Seat 6: Nestle170 ($50 in chips) 
Seat 7: danthaur ($50.96 in chips) 
Seat 8: m11k1989 ($70.93 in chips) 
Seat 9: holdemamn ($53.25 in chips) 
holdemamn: posts small blind $0.25
Xamil666: posts big blind $0.50
PleBeY95: sits out 
*** HOLE CARDS ***
v.sting: folds 
akbloger: folds 
$lavik88: folds 
Nestle170: folds 
danthaur: raises $0.75 to $1.25
m11k1989 has timed out
m11k1989: folds 
holdemamn: folds 
Xamil666: folds 
Uncalled bet ($0.75) returned to danthaur
danthaur collected $1.25 from pot
danthaur: doesn't show hand 
*** SUMMARY ***
Total pot $1.25 | Rake $0 
Seat 1: Xamil666 (big blind) folded before Flop
Seat 2: v.sting folded before Flop (didn't bet)
Seat 3: akbloger folded before Flop (didn't bet)
Seat 4: $lavik88 folded before Flop (didn't bet)
Seat 6: Nestle170 folded before Flop (didn't bet)
Seat 7: danthaur collected ($1.25)
Seat 8: m11k1989 (button) folded before Flop (didn't bet)
Seat 9: holdemamn (small blind) folded before Flop



PokerStars Hand #228688706242:  Hold'em No Limit ($0.25/$0.50 USD) - 2021/07/30 16:34:33 ET
Table 'Galilea III' 9-max Seat #8 is the button
Seat 2: v.sting ($108.90 in chips) 
Seat 3: akbloger ($58.80 in chips) 
Seat 4: $lavik88 ($83.85 in chips) 
Seat 5: PleBeY95 ($60.14 in chips) 
Seat 6: Nestle170 ($50 in chips) 
Seat 7: danthaur ($50 in chips) 
Seat 8: m11k1989 ($74.87 in chips) 
Seat 9: holdemamn ($51.81 in chips) 
holdemamn: posts small blind $0.25
v.sting: posts big blind $0.50
*** HOLE CARDS ***
An1an1 joins the table at seat #1 
akbloger: folds 
$lavik88: folds 
PleBeY95: folds 
Nestle170: folds 
danthaur: raises $0.75 to $1.25
m11k1989: calls $1.25
holdemamn: folds 
v.sting: folds 
*** FLOP *** [6d 4c Ks]
danthaur: bets $0.75
m11k1989: calls $0.75
*** TURN *** [6d 4c Ks] [Td]
danthaur: checks 
m11k1989: bets $1.50
danthaur: calls $1.50
*** RIVER *** [6d 4c Ks Td] [2h]
danthaur: checks 
m11k1989: checks 
*** SHOW DOWN ***
danthaur: shows [7d 7s] (a pair of Sevens)
m11k1989: mucks hand 
danthaur collected $7.36 from pot
*** SUMMARY ***
Total pot $7.75 | Rake $0.39 
Board [6d 4c Ks Td 2h]
Seat 2: v.sting (big blind) folded before Flop
Seat 3: akbloger folded before Flop (didn't bet)
Seat 4: $lavik88 folded before Flop (didn't bet)
Seat 5: PleBeY95 folded before Flop (didn't bet)
Seat 6: Nestle170 folded before Flop (didn't bet)
Seat 7: danthaur showed [7d 7s] and won ($7.36) with a pair of Sevens
Seat 8: m11k1989 (button) mucked
Seat 9: holdemamn (small blind) folded before Flop



PokerStars Hand #228688739746:  Hold'em No Limit ($0.25/$0.50 USD) - 2021/07/30 16:35:43 ET
Table 'Galilea III' 9-max Seat #9 is the button
Seat 2: v.sting ($108.40 in chips) 
Seat 3: akbloger ($58.80 in chips) 
Seat 4: $lavik88 ($83.85 in chips) 
Seat 5: PleBeY95 ($60.14 in chips) 
Seat 6: Nestle170 ($50 in chips) 
Seat 7: danthaur ($53.86 in chips) 
Seat 8: m11k1989 ($71.37 in chips) 
Seat 9: holdemamn ($51.56 in chips) 
v.sting: posts small blind $0.25
akbloger: posts big blind $0.50
*** HOLE CARDS ***
$lavik88: raises $1 to $1.50
PleBeY95: folds 
Nestle170: folds 
danthaur: folds 
m11k1989: calls $1.50
holdemamn: folds 
v.sting: folds 
akbloger: folds 
*** FLOP *** [5d 3d 7s]
$lavik88: bets $2
m11k1989: folds 
Uncalled bet ($2) returned to $lavik88
$lavik88 collected $3.56 from pot
$lavik88: doesn't show hand 
*** SUMMARY ***
Total pot $3.75 | Rake $0.19 
Board [5d 3d 7s]
Seat 2: v.sting (small blind) folded before Flop
Seat 3: akbloger (big blind) folded before Flop
Seat 4: $lavik88 collected ($3.56)
Seat 5: PleBeY95 folded before Flop (didn't bet)
Seat 6: Nestle170 folded before Flop (didn't bet)
Seat 7: danthaur folded before Flop (didn't bet)
Seat 8: m11k1989 folded on the Flop
Seat 9: holdemamn (button) folded before Flop (didn't bet)



PokerStars Hand #228688767239:  Hold'em No Limit ($0.25/$0.50 USD) - 2021/07/30 16:36:41 ET
Table 'Galilea III' 9-max Seat #2 is the button
Seat 2: v.sting ($108.15 in chips) 
Seat 3: akbloger ($58.30 in chips) 
Seat 4: $lavik88 ($85.91 in chips) 
Seat 5: PleBeY95 ($60.14 in chips) 
Seat 6: Nestle170 ($50 in chips) 
Seat 7: danthaur ($53.86 in chips) 
Seat 8: m11k1989 ($69.87 in chips) 
Seat 9: holdemamn ($51.56 in chips) 
akbloger: posts small blind $0.25
$lavik88: posts big blind $0.50
An1an1: sits out 
*** HOLE CARDS ***
PleBeY95: folds 
Nestle170: raises $1 to $1.50
danthaur: folds 
m11k1989: calls $1.50
holdemamn: folds 
v.sting: folds 
akbloger: folds 
$lavik88: folds 
*** FLOP *** [7s 2h 5s]
Nestle170: checks 
m11k1989: bets $1.50
Nestle170: folds 
Uncalled bet ($1.50) returned to m11k1989
m11k1989 collected $3.56 from pot
*** SUMMARY ***
Total pot $3.75 | Rake $0.19 
Board [7s 2h 5s]
Seat 2: v.sting (button) folded before Flop (didn't bet)
Seat 3: akbloger (small blind) folded before Flop
Seat 4: $lavik88 (big blind) folded before Flop
Seat 5: PleBeY95 folded before Flop (didn't bet)
Seat 6: Nestle170 folded on the Flop
Seat 7: danthaur folded before Flop (didn't bet)
Seat 8: m11k1989 collected ($3.56)
Seat 9: holdemamn folded before Flop (didn't bet)



PokerStars Hand #228688793274:  Hold'em No Limit ($0.25/$0.50 USD) - 2021/07/30 16:37:36 ET
Table 'Galilea III' 9-max Seat #3 is the button
Seat 2: v.sting ($108.15 in chips) 
Seat 3: akbloger ($58.05 in chips) 
Seat 4: $lavik88 ($85.41 in chips) 
Seat 5: PleBeY95 ($60.14 in chips) 
Seat 6: Nestle170 ($50 in chips) 
Seat 7: danthaur ($53.86 in chips) 
Seat 8: m11k1989 ($71.93 in chips) 
Seat 9: holdemamn ($51.56 in chips) 
$lavik88: posts small blind $0.25
PleBeY95: posts big blind $0.50
An1an1: sits out 
*** HOLE CARDS ***
Nestle170: folds 
danthaur: folds 
m11k1989: calls $0.50
holdemamn: folds 
v.sting: folds 
akbloger: folds 
$lavik88: calls $0.25
PleBeY95: checks 
*** FLOP *** [6s 9c 8d]
$lavik88: checks 
PleBeY95: checks 
m11k1989: bets $1.50
$lavik88: folds 
PleBeY95: folds 
Uncalled bet ($1.50) returned to m11k1989
m11k1989 collected $1.42 from pot
*** SUMMARY ***
Total pot $1.50 | Rake $0.08 
Board [6s 9c 8d]
Seat 2: v.sting folded before Flop (didn't bet)
Seat 3: akbloger (button) folded before Flop (didn't bet)
Seat 4: $lavik88 (small blind) folded on the Flop
Seat 5: PleBeY95 (big blind) folded on the Flop
Seat 6: Nestle170 folded before Flop (didn't bet)
Seat 7: danthaur folded before Flop (didn't bet)
Seat 8: m11k1989 collected ($1.42)
Seat 9: holdemamn folded before Flop (didn't bet)



PokerStars Hand #228688812281:  Hold'em No Limit ($0.25/$0.50 USD) - 2021/07/30 16:38:15 ET
Table 'Galilea III' 9-max Seat #4 is the button
Seat 2: v.sting ($108.15 in chips) 
Seat 3: akbloger ($58.05 in chips) 
Seat 4: $lavik88 ($84.91 in chips) 
Seat 5: PleBeY95 ($59.64 in chips) 
Seat 6: Nestle170 ($50 in chips) 
Seat 7: danthaur ($53.86 in chips) 
Seat 8: m11k1989 ($72.85 in chips) 
Seat 9: holdemamn ($51.56 in chips) 
PleBeY95: posts small blind $0.25
Nestle170: posts big blind $0.50
An1an1: sits out 
*** HOLE CARDS ***
danthaur: raises $1 to $1.50
m11k1989: calls $1.50
holdemamn: folds 
v.sting: folds 
akbloger: folds 
$lavik88: raises $6 to $7.50
PleBeY95: folds 
Nestle170: folds 
danthaur: folds 
m11k1989: folds 
Uncalled bet ($6) returned to $lavik88
$lavik88 collected $5.25 from pot
$lavik88: doesn't show hand 
*** SUMMARY ***
Total pot $5.25 | Rake $0 
Seat 2: v.sting folded before Flop (didn't bet)
Seat 3: akbloger folded before Flop (didn't bet)
Seat 4: $lavik88 (button) collected ($5.25)
Seat 5: PleBeY95 (small blind) folded before Flop
Seat 6: Nestle170 (big blind) folded before Flop
Seat 7: danthaur folded before Flop
Seat 8: m11k1989 folded before Flop
Seat 9: holdemamn folded before Flop (didn't bet)



PokerStars Hand #228688568293:  Hold'em No Limit ($0.25/$0.50 USD) - 2021/07/30 16:29:52 ET
Table 'Galilea III' 9-max Seat #9 is the button
Seat 1: Xamil666 ($95.84 in chips) 
Seat 2: v.sting ($104.90 in chips) 
Seat 3: akbloger ($59.55 in chips) 
Seat 4: $lavik88 ($83.85 in chips) 
Seat 6: Nestle170 ($50 in chips) 
Seat 7: danthaur ($51.71 in chips) 
Seat 8: m11k1989 ($70.93 in chips) 
Seat 9: holdemamn ($53 in chips) 
Xamil666: posts small blind $0.25
v.sting: posts big blind $0.50
PleBeY95: sits out 
*** HOLE CARDS ***
akbloger: folds 
$lavik88: folds 
Nestle170: folds 
danthaur: folds 
m11k1989: calls $0.50
holdemamn: folds 
Xamil666: folds 
v.sting: checks 
*** FLOP *** [Qd 3s Ac]
v.sting: checks 
m11k1989: checks 
*** TURN *** [Qd 3s Ac] [Td]
v.sting: checks 
m11k1989: bets $1.50
v.sting: folds 
Uncalled bet ($1.50) returned to m11k1989
m11k1989 collected $1.19 from pot
m11k1989: doesn't show hand 
*** SUMMARY ***
Total pot $1.25 | Rake $0.06 
Board [Qd 3s Ac Td]
Seat 1: Xamil666 (small blind) folded before Flop
Seat 2: v.sting (big blind) folded on the Turn
Seat 3: akbloger folded before Flop (didn't bet)
Seat 4: $lavik88 folded before Flop (didn't bet)
Seat 6: Nestle170 folded before Flop (didn't bet)
Seat 7: danthaur folded before Flop (didn't bet)
Seat 8: m11k1989 collected ($1.19)
Seat 9: holdemamn (button) folded before Flop (didn't bet)



PokerStars Hand #228688650720:  Hold'em No Limit ($0.25/$0.50 USD) - 2021/07/30 16:32:38 ET
Table 'Galilea III' 9-max Seat #5 is the button
Seat 1: Xamil666 ($95.59 in chips) 
Seat 2: v.sting ($105.40 in chips) 
Seat 3: akbloger ($58.80 in chips) 
Seat 4: $lavik88 ($83.85 in chips) 
Seat 5: PleBeY95 ($60.14 in chips) 
Seat 6: Nestle170 ($50 in chips) 
Seat 7: danthaur ($51.71 in chips) 
Seat 8: m11k1989 ($76.33 in chips) 
Seat 9: holdemamn ($50.25 in chips) 
Nestle170: posts small blind $0.25
danthaur: posts big blind $0.50
*** HOLE CARDS ***
m11k1989: calls $0.50
holdemamn: folds 
Xamil666: folds 
v.sting: folds 
akbloger: folds 
$lavik88: folds 
PleBeY95: folds 
Nestle170: folds 
danthaur: raises $1.50 to $2
m11k1989: calls $1.50
*** FLOP *** [7d Jc 6d]
danthaur: checks 
m11k1989: bets $1
danthaur: folds 
Uncalled bet ($1) returned to m11k1989
m11k1989 collected $4.04 from pot
m11k1989: doesn't show hand 
*** SUMMARY ***
Total pot $4.25 | Rake $0.21 
Board [7d Jc 6d]
Seat 1: Xamil666 folded before Flop (didn't bet)
Seat 2: v.sting folded before Flop (didn't bet)
Seat 3: akbloger folded before Flop (didn't bet)
Seat 4: $lavik88 folded before Flop (didn't bet)
Seat 5: PleBeY95 (button) folded before Flop (didn't bet)
Seat 6: Nestle170 (small blind) folded before Flop
Seat 7: danthaur (big blind) folded on the Flop
Seat 8: m11k1989 collected ($4.04)
Seat 9: holdemamn folded before Flop (didn't bet)



PokerStars Hand #228688672235:  Hold'em No Limit ($0.25/$0.50 USD) - 2021/07/30 16:33:22 ET
Table 'Galilea III' 9-max Seat #6 is the button
Seat 1: Xamil666 ($95.59 in chips) 
Seat 2: v.sting ($105.40 in chips) 
Seat 3: akbloger ($58.80 in chips) 
Seat 4: $lavik88 ($83.85 in chips) 
Seat 5: PleBeY95 ($60.14 in chips) 
Seat 6: Nestle170 ($50 in chips) 
Seat 7: danthaur ($50 in chips) 
Seat 8: m11k1989 ($78.37 in chips) 
Seat 9: holdemamn ($50.25 in chips) 
danthaur: posts small blind $0.25
m11k1989: posts big blind $0.50
*** HOLE CARDS ***
holdemamn: raises $1 to $1.50
Xamil666: calls $1.50
v.sting: folds 
akbloger: folds 
$lavik88: folds 
PleBeY95: folds 
Nestle170: folds 
danthaur: folds 
m11k1989: folds 
*** FLOP *** [2c Ah 8d]
holdemamn: bets $1.19
Xamil666: folds 
Uncalled bet ($1.19) returned to holdemamn
holdemamn collected $3.56 from pot
holdemamn: doesn't show hand 
*** SUMMARY ***
Total pot $3.75 | Rake $0.19 
Board [2c Ah 8d]
Seat 1: Xamil666 folded on the Flop
Seat 2: v.sting folded before Flop (didn't bet)
Seat 3: akbloger folded before Flop (didn't bet)
Seat 4: $lavik88 folded before Flop (didn't bet)
Seat 5: PleBeY95 folded before Flop (didn't bet)
Seat 6: Nestle170 (button) folded before Flop (didn't bet)
Seat 7: danthaur (small blind) folded before Flop
Seat 8: m11k1989 (big blind) folded before Flop
Seat 9: holdemamn collected ($3.56)



PokerStars Hand #228688687183:  Hold'em No Limit ($0.25/$0.50 USD) - 2021/07/30 16:33:53 ET
Table 'Galilea III' 9-max Seat #7 is the button
Seat 1: Xamil666 ($94.09 in chips) 
Seat 2: v.sting ($105.40 in chips) 
Seat 3: akbloger ($58.80 in chips) 
Seat 4: $lavik88 ($83.85 in chips) 
Seat 5: PleBeY95 ($60.14 in chips) 
Seat 6: Nestle170 ($50 in chips) 
Seat 7: danthaur ($50 in chips) 
Seat 8: m11k1989 ($77.87 in chips) 
Seat 9: holdemamn ($52.31 in chips) 
m11k1989: posts small blind $0.25
holdemamn: posts big blind $0.50
*** HOLE CARDS ***
Xamil666: folds 
v.sting: raises $1 to $1.50
akbloger: folds 
Xamil666 leaves the table
$lavik88: folds 
PleBeY95: folds 
Nestle170: folds 
danthaur: folds 
m11k1989: raises $1.50 to $3
holdemamn: folds 
v.sting: raises $8 to $11
m11k1989: folds 
Uncalled bet ($8) returned to v.sting
v.sting collected $6.50 from pot
v.sting: doesn't show hand 
*** SUMMARY ***
Total pot $6.50 | Rake $0 
Seat 1: Xamil666 folded before Flop (didn't bet)
Seat 2: v.sting collected ($6.50)
Seat 3: akbloger folded before Flop (didn't bet)
Seat 4: $lavik88 folded before Flop (didn't bet)
Seat 5: PleBeY95 folded before Flop (didn't bet)
Seat 6: Nestle170 folded before Flop (didn't bet)
Seat 7: danthaur (button) folded before Flop (didn't bet)
Seat 8: m11k1989 (small blind) folded before Flop
Seat 9: holdemamn (big blind) folded before Flop



PokerStars Hand #228688851493:  Hold'em No Limit ($0.25/$0.50 USD) - 2021/07/30 16:39:37 ET
Table 'Galilea III' 9-max Seat #6 is the button
Seat 2: v.sting ($108.15 in chips) 
Seat 3: akbloger ($58.05 in chips) 
Seat 4: $lavik88 ($88.66 in chips) 
Seat 5: PleBeY95 ($54.89 in chips) 
Seat 6: Nestle170 ($50 in chips) 
Seat 7: danthaur ($51.86 in chips) 
Seat 8: m11k1989 ($76.11 in chips) 
Seat 9: holdemamn ($51.56 in chips) 
danthaur: posts small blind $0.25
m11k1989: posts big blind $0.50
An1an1: sits out 
*** HOLE CARDS ***
holdemamn: raises $1 to $1.50
v.sting: folds 
akbloger: folds 
$lavik88: folds 
PleBeY95: folds 
Nestle170: folds 
danthaur: folds 
m11k1989: calls $1
*** FLOP *** [5s 5h 6s]
m11k1989: bets $0.50
holdemamn: raises $2 to $2.50
m11k1989: folds 
Uncalled bet ($2) returned to holdemamn
holdemamn collected $4.04 from pot
holdemamn: doesn't show hand 
*** SUMMARY ***
Total pot $4.25 | Rake $0.21 
Board [5s 5h 6s]
Seat 2: v.sting folded before Flop (didn't bet)
Seat 3: akbloger folded before Flop (didn't bet)
Seat 4: $lavik88 folded before Flop (didn't bet)
Seat 5: PleBeY95 folded before Flop (didn't bet)
Seat 6: Nestle170 (button) folded before Flop (didn't bet)
Seat 7: danthaur (small blind) folded before Flop
Seat 8: m11k1989 (big blind) folded on the Flop
Seat 9: holdemamn collected ($4.04)



PokerStars Hand #228688865465:  Hold'em No Limit ($0.25/$0.50 USD) - 2021/07/30 16:40:06 ET
Table 'Galilea III' 9-max Seat #7 is the button
Seat 2: v.sting ($108.15 in chips) 
Seat 3: akbloger ($58.05 in chips) 
Seat 4: $lavik88 ($88.66 in chips) 
Seat 5: PleBeY95 ($54.89 in chips) 
Seat 6: Nestle170 ($50 in chips) 
Seat 7: danthaur ($51.61 in chips) 
Seat 8: m11k1989 ($74.11 in chips) 
Seat 9: holdemamn ($53.60 in chips) 
m11k1989: posts small blind $0.25
holdemamn: posts big blind $0.50
An1an1: sits out 
*** HOLE CARDS ***
v.sting: folds 
akbloger: folds 
$lavik88: raises $1 to $1.50
PleBeY95: folds 
Nestle170: folds 
danthaur: folds 
m11k1989: folds 
holdemamn: calls $1
*** FLOP *** [4s Ts 4c]
holdemamn: checks 
$lavik88: bets $0.93
holdemamn: folds 
Uncalled bet ($0.93) returned to $lavik88
$lavik88 collected $3.09 from pot
$lavik88: doesn't show hand 
*** SUMMARY ***
Total pot $3.25 | Rake $0.16 
Board [4s Ts 4c]
Seat 2: v.sting folded before Flop (didn't bet)
Seat 3: akbloger folded before Flop (didn't bet)
Seat 4: $lavik88 collected ($3.09)
Seat 5: PleBeY95 folded before Flop (didn't bet)
Seat 6: Nestle170 folded before Flop (didn't bet)
Seat 7: danthaur (button) folded before Flop (didn't bet)
Seat 8: m11k1989 (small blind) folded before Flop
Seat 9: holdemamn (big blind) folded on the Flop



PokerStars Hand #228688888267:  Hold'em No Limit ($0.25/$0.50 USD) - 2021/07/30 16:40:47 ET
Table 'Galilea III' 9-max Seat #8 is the button
Seat 1: An1an1 ($50 in chips) 
Seat 2: v.sting ($108.15 in chips) 
Seat 3: akbloger ($58.05 in chips) 
Seat 4: $lavik88 ($90.25 in chips) 
Seat 5: PleBeY95 ($54.89 in chips) 
Seat 6: Nestle170 ($50 in chips) 
Seat 7: danthaur ($51.61 in chips) 
Seat 8: m11k1989 ($73.86 in chips) 
Seat 9: holdemamn ($52.10 in chips) 
holdemamn: posts small blind $0.25
An1an1: posts big blind $0.50
*** HOLE CARDS ***
v.sting: folds 
akbloger: folds 
$lavik88: folds 
PleBeY95: folds 
Nestle170: folds 
danthaur: folds 
m11k1989: calls $0.50
holdemamn: folds 
An1an1: checks 
*** FLOP *** [Th 4h 6d]
An1an1: checks 
m11k1989: bets $0.50
An1an1: calls $0.50
*** TURN *** [Th 4h 6d] [2d]
An1an1: checks 
m11k1989: bets $0.50
An1an1: calls $0.50
*** RIVER *** [Th 4h 6d 2d] [Ts]
An1an1: checks 
m11k1989: checks 
*** SHOW DOWN ***
An1an1: shows [3h Ac] (a pair of Tens)
m11k1989: shows [2s 2h] (a full house, Deuces full of Tens)
m11k1989 collected $3.09 from pot
*** SUMMARY ***
Total pot $3.25 | Rake $0.16 
Board [Th 4h 6d 2d Ts]
Seat 1: An1an1 (big blind) showed [3h Ac] and lost with a pair of Tens
Seat 2: v.sting folded before Flop (didn't bet)
Seat 3: akbloger folded before Flop (didn't bet)
Seat 4: $lavik88 folded before Flop (didn't bet)
Seat 5: PleBeY95 folded before Flop (didn't bet)
Seat 6: Nestle170 folded before Flop (didn't bet)
Seat 7: danthaur folded before Flop (didn't bet)
Seat 8: m11k1989 (button) showed [2s 2h] and won ($3.09) with a full house, Deuces full of Tens
Seat 9: holdemamn (small blind) folded before Flop



PokerStars Hand #228688911219:  Hold'em No Limit ($0.25/$0.50 USD) - 2021/07/30 16:41:36 ET
Table 'Galilea III' 9-max Seat #9 is the button
Seat 1: An1an1 ($50 in chips) 
Seat 2: v.sting ($108.15 in chips) 
Seat 3: akbloger ($58.05 in chips) 
Seat 4: $lavik88 ($90.25 in chips) 
Seat 5: PleBeY95 ($54.89 in chips) 
Seat 6: Nestle170 ($50 in chips) 
Seat 7: danthaur ($51.61 in chips) 
Seat 8: m11k1989 ($75.45 in chips) 
Seat 9: holdemamn ($51.85 in chips) 
An1an1: posts small blind $0.25
v.sting: posts big blind $0.50
*** HOLE CARDS ***
akbloger: folds 
$lavik88: folds 
PleBeY95: folds 
Nestle170: folds 
danthaur: folds 
m11k1989: raises $1.25 to $1.75
holdemamn: folds 
An1an1: folds 
v.sting: raises $3.75 to $5.50
m11k1989: calls $3.75
*** FLOP *** [Ad Th Tc]
v.sting: bets $3.53
m11k1989: calls $3.53
*** TURN *** [Ad Th Tc] [5s]
v.sting: bets $9.56
m11k1989: folds 
Uncalled bet ($9.56) returned to v.sting
v.sting collected $17.39 from pot
v.sting: doesn't show hand 
*** SUMMARY ***
Total pot $18.31 | Rake $0.92 
Board [Ad Th Tc 5s]
Seat 1: An1an1 (small blind) folded before Flop
Seat 2: v.sting (big blind) collected ($17.39)
Seat 3: akbloger folded before Flop (didn't bet)
Seat 4: $lavik88 folded before Flop (didn't bet)
Seat 5: PleBeY95 folded before Flop (didn't bet)
Seat 6: Nestle170 folded before Flop (didn't bet)
Seat 7: danthaur folded before Flop (didn't bet)
Seat 8: m11k1989 folded on the Turn
Seat 9: holdemamn (button) folded before Flop (didn't bet)



PokerStars Hand #228688934023:  Hold'em No Limit ($0.25/$0.50 USD) - 2021/07/30 16:42:24 ET
Table 'Galilea III' 9-max Seat #1 is the button
Seat 1: An1an1 ($50 in chips) 
Seat 2: v.sting ($116.51 in chips) 
Seat 3: akbloger ($58.05 in chips) 
Seat 4: $lavik88 ($90.25 in chips) 
Seat 5: PleBeY95 ($54.89 in chips) 
Seat 6: Nestle170 ($50 in chips) 
Seat 7: danthaur ($51.61 in chips) 
Seat 8: m11k1989 ($66.42 in chips) 
Seat 9: holdemamn ($51.85 in chips) 
v.sting: posts small blind $0.25
akbloger: posts big blind $0.50
*** HOLE CARDS ***
$lavik88: folds 
PleBeY95: folds 
Nestle170: folds 
danthaur: folds 
m11k1989: folds 
holdemamn: folds 
An1an1: raises $0.85 to $1.35
v.sting: folds 
akbloger: raises $3.65 to $5
An1an1: calls $3.65
*** FLOP *** [8h 3c Ah]
akbloger: bets $3.21
An1an1: folds 
Uncalled bet ($3.21) returned to akbloger
akbloger collected $9.74 from pot
akbloger: doesn't show hand 
*** SUMMARY ***
Total pot $10.25 | Rake $0.51 
Board [8h 3c Ah]
Seat 1: An1an1 (button) folded on the Flop
Seat 2: v.sting (small blind) folded before Flop
Seat 3: akbloger (big blind) collected ($9.74)
Seat 4: $lavik88 folded before Flop (didn't bet)
Seat 5: PleBeY95 folded before Flop (didn't bet)
Seat 6: Nestle170 folded before Flop (didn't bet)
Seat 7: danthaur folded before Flop (didn't bet)
Seat 8: m11k1989 folded before Flop (didn't bet)
Seat 9: holdemamn folded before Flop (didn't bet)



PokerStars Hand #228688989054:  Hold'em No Limit ($0.25/$0.50 USD) - 2021/07/30 16:44:21 ET
Table 'Galilea III' 9-max Seat #3 is the button
Seat 1: An1an1 ($50 in chips) 
Seat 2: v.sting ($116.26 in chips) 
Seat 3: akbloger ($55.79 in chips) 
Seat 4: $lavik88 ($89.75 in chips) 
Seat 5: PleBeY95 ($54.89 in chips) 
Seat 6: Nestle170 ($59 in chips) 
Seat 7: danthaur ($51.61 in chips) 
Seat 8: m11k1989 ($64.92 in chips) 
Seat 9: holdemamn ($51.85 in chips) 
$lavik88: posts small blind $0.25
PleBeY95: posts big blind $0.50
*** HOLE CARDS ***
Nestle170: folds 
danthaur: folds 
m11k1989: raises $0.50 to $1
holdemamn: folds 
An1an1: folds 
v.sting: folds 
akbloger: folds 
$lavik88: folds 
PleBeY95: folds 
Uncalled bet ($0.50) returned to m11k1989
m11k1989 collected $1.25 from pot
m11k1989: doesn't show hand 
*** SUMMARY ***
Total pot $1.25 | Rake $0 
Seat 1: An1an1 folded before Flop (didn't bet)
Seat 2: v.sting folded before Flop (didn't bet)
Seat 3: akbloger (button) folded before Flop (didn't bet)
Seat 4: $lavik88 (small blind) folded before Flop
Seat 5: PleBeY95 (big blind) folded before Flop
Seat 6: Nestle170 folded before Flop (didn't bet)
Seat 7: danthaur folded before Flop (didn't bet)
Seat 8: m11k1989 collected ($1.25)
Seat 9: holdemamn folded before Flop (didn't bet)



PokerStars Hand #228689006213:  Hold'em No Limit ($0.25/$0.50 USD) - 2021/07/30 16:44:58 ET
Table 'Galilea III' 9-max Seat #4 is the button
Seat 1: An1an1 ($50 in chips) 
Seat 2: v.sting ($116.26 in chips) 
Seat 3: akbloger ($55.79 in chips) 
Seat 4: $lavik88 ($89.50 in chips) 
Seat 5: PleBeY95 ($54.39 in chips) 
Seat 6: Nestle170 ($59 in chips) 
Seat 7: danthaur ($51.61 in chips) 
Seat 8: m11k1989 ($65.67 in chips) 
Seat 9: holdemamn ($51.85 in chips) 
PleBeY95: posts small blind $0.25
Nestle170: posts big blind $0.50
*** HOLE CARDS ***
danthaur: folds 
m11k1989: raises $0.50 to $1
holdemamn: folds 
An1an1: folds 
v.sting: folds 
akbloger: folds 
$lavik88: folds 
PleBeY95: folds 
Nestle170: folds 
Uncalled bet ($0.50) returned to m11k1989
m11k1989 collected $1.25 from pot
m11k1989: doesn't show hand 
*** SUMMARY ***
Total pot $1.25 | Rake $0 
Seat 1: An1an1 folded before Flop (didn't bet)
Seat 2: v.sting folded before Flop (didn't bet)
Seat 3: akbloger folded before Flop (didn't bet)
Seat 4: $lavik88 (button) folded before Flop (didn't bet)
Seat 5: PleBeY95 (small blind) folded before Flop
Seat 6: Nestle170 (big blind) folded before Flop
Seat 7: danthaur folded before Flop (didn't bet)
Seat 8: m11k1989 collected ($1.25)
Seat 9: holdemamn folded before Flop (didn't bet)



PokerStars Hand #228689026082:  Hold'em No Limit ($0.25/$0.50 USD) - 2021/07/30 16:45:21 ET
Table 'Galilea III' 9-max Seat #5 is the button
Seat 1: An1an1 ($50 in chips) 
Seat 2: v.sting ($116.26 in chips) 
Seat 3: akbloger ($55.79 in chips) 
Seat 4: $lavik88 ($89.50 in chips) 
Seat 5: PleBeY95 ($54.14 in chips) 
Seat 6: Nestle170 ($58.50 in chips) 
Seat 7: danthaur ($51.61 in chips) 
Seat 8: m11k1989 ($66.42 in chips) 
Seat 9: holdemamn ($51.85 in chips) 
Nestle170: posts small blind $0.25
danthaur: posts big blind $0.50
*** HOLE CARDS ***
m11k1989: folds 
holdemamn: raises $1 to $1.50
An1an1: folds 
v.sting: folds 
akbloger: folds 
$lavik88: folds 
PleBeY95: folds 
Nestle170: folds 
danthaur: folds 
Uncalled bet ($1) returned to holdemamn
holdemamn collected $1.25 from pot
holdemamn: doesn't show hand 
*** SUMMARY ***
Total pot $1.25 | Rake $0 
Seat 1: An1an1 folded before Flop (didn't bet)
Seat 2: v.sting folded before Flop (didn't bet)
Seat 3: akbloger folded before Flop (didn't bet)
Seat 4: $lavik88 folded before Flop (didn't bet)
Seat 5: PleBeY95 (button) folded before Flop (didn't bet)
Seat 6: Nestle170 (small blind) folded before Flop
Seat 7: danthaur (big blind) folded before Flop
Seat 8: m11k1989 folded before Flop (didn't bet)
Seat 9: holdemamn collected ($1.25)



PokerStars Hand #228689040291:  Hold'em No Limit ($0.25/$0.50 USD) - 2021/07/30 16:45:51 ET
Table 'Galilea III' 9-max Seat #6 is the button
Seat 1: An1an1 ($50 in chips) 
Seat 2: v.sting ($116.26 in chips) 
Seat 3: akbloger ($55.79 in chips) 
Seat 4: $lavik88 ($89.50 in chips) 
Seat 5: PleBeY95 ($54.14 in chips) 
Seat 6: Nestle170 ($58.25 in chips) 
Seat 7: danthaur ($51.11 in chips) 
Seat 8: m11k1989 ($66.42 in chips) 
Seat 9: holdemamn ($52.60 in chips) 
danthaur: posts small blind $0.25
m11k1989: posts big blind $0.50
*** HOLE CARDS ***
holdemamn: folds 
An1an1: raises $0.75 to $1.25
v.sting: folds 
akbloger: folds 
$lavik88: folds 
PleBeY95: folds 
Nestle170: folds 
danthaur: folds 
m11k1989: calls $0.75
*** FLOP *** [8s 5c Ah]
m11k1989: checks 
An1an1: checks 
*** TURN *** [8s 5c Ah] [4h]
m11k1989: bets $1
An1an1: folds 
Uncalled bet ($1) returned to m11k1989
m11k1989 collected $2.61 from pot
m11k1989: doesn't show hand 
*** SUMMARY ***
Total pot $2.75 | Rake $0.14 
Board [8s 5c Ah 4h]
Seat 1: An1an1 folded on the Turn
Seat 2: v.sting folded before Flop (didn't bet)
Seat 3: akbloger folded before Flop (didn't bet)
Seat 4: $lavik88 folded before Flop (didn't bet)
Seat 5: PleBeY95 folded before Flop (didn't bet)
Seat 6: Nestle170 (button) folded before Flop (didn't bet)
Seat 7: danthaur (small blind) folded before Flop
Seat 8: m11k1989 (big blind) collected ($2.61)
Seat 9: holdemamn folded before Flop (didn't bet)



PokerStars Hand #228690338997:  Hold'em No Limit ($0.25/$0.50 USD) - 2021/07/30 17:32:46 ET
Table 'Galilea III' 9-max Seat #2 is the button
Seat 1: eltonmiranda ($39.83 in chips) 
Seat 2: Agent Cedric ($30.80 in chips) 
Seat 3: Smashdoge ($39.54 in chips) 
Seat 4: Corlogiro ($96.69 in chips) 
Seat 5: Ajs Miracle- ($27.58 in chips) 
Seat 6: BALAWA ($51.69 in chips) 
Seat 7: An1an1 ($50.20 in chips) 
Seat 8: Kolyan2114 ($50 in chips) 
Seat 9: nicu4you ($67.12 in chips) 
Smashdoge: posts small blind $0.25
Corlogiro: posts big blind $0.50
*** HOLE CARDS ***
Ajs Miracle-: raises $1 to $1.50
BALAWA: raises $3.75 to $5.25
An1an1: folds 
Kolyan2114: folds 
nicu4you: folds 
eltonmiranda: folds 
Agent Cedric: folds 
Smashdoge: calls $5
Corlogiro: folds 
Ajs Miracle-: calls $3.75
*** FLOP *** [Th 9h Qs]
Smashdoge: checks 
Ajs Miracle-: checks 
BALAWA: bets $46.44 and is all-in
eltonmiranda leaves the table
Smashdoge: calls $34.29 and is all-in
Ajs Miracle-: folds 
Uncalled bet ($12.15) returned to BALAWA
*** TURN *** [Th 9h Qs] [Jd]
*** RIVER *** [Th 9h Qs Jd] [2h]
*** SHOW DOWN ***
Smashdoge: shows [8c Ac] (a straight, Eight to Queen)
BALAWA: shows [Kc Ks] (a straight, Nine to King)
BALAWA collected $82.83 from pot
*** SUMMARY ***
Total pot $84.83 | Rake $2 
Board [Th 9h Qs Jd 2h]
Seat 1: eltonmiranda folded before Flop (didn't bet)
Seat 2: Agent Cedric (button) folded before Flop (didn't bet)
Seat 3: Smashdoge (small blind) showed [8c Ac] and lost with a straight, Eight to Queen
Seat 4: Corlogiro (big blind) folded before Flop
Seat 5: Ajs Miracle- folded on the Flop
Seat 6: BALAWA showed [Kc Ks] and won ($82.83) with a straight, Nine to King
Seat 7: An1an1 folded before Flop (didn't bet)
Seat 8: Kolyan2114 folded before Flop (didn't bet)
Seat 9: nicu4you folded before Flop (didn't bet)



PokerStars Hand #228690870430:  Hold'em No Limit ($0.25/$0.50 USD) - 2021/07/30 17:52:41 ET
Table 'Galilea III' 9-max Seat #3 is the button
Seat 1: Nestle170 ($57.17 in chips) 
Seat 2: StudentRB ($50 in chips) 
Seat 3: Pachebrash ($84.75 in chips) 
Seat 4: Corlogiro ($86.75 in chips) 
Seat 5: alexrus18 ($58.15 in chips) 
Seat 6: BALAWA ($109.50 in chips) 
Seat 7: __PKR__JNR__ ($58.48 in chips) 
Seat 8: christyirish ($51.37 in chips) 
Seat 9: nicu4you ($71.02 in chips) 
Corlogiro: posts small blind $0.25
alexrus18: posts big blind $0.50
*** HOLE CARDS ***
BALAWA: folds 
__PKR__JNR__: folds 
christyirish: folds 
nicu4you: folds 
Nestle170: folds 
StudentRB: folds 
Pachebrash: folds 
Corlogiro: raises $1 to $1.50
alexrus18: folds 
Uncalled bet ($1) returned to Corlogiro
Corlogiro collected $1 from pot
Corlogiro: doesn't show hand 
*** SUMMARY ***
Total pot $1 | Rake $0 
Seat 1: Nestle170 folded before Flop (didn't bet)
Seat 2: StudentRB folded before Flop (didn't bet)
Seat 3: Pachebrash (button) folded before Flop (didn't bet)
Seat 4: Corlogiro (small blind) collected ($1)
Seat 5: alexrus18 (big blind) folded before Flop
Seat 6: BALAWA folded before Flop (didn't bet)
Seat 7: __PKR__JNR__ folded before Flop (didn't bet)
Seat 8: christyirish folded before Flop (didn't bet)
Seat 9: nicu4you folded before Flop (didn't bet)



PokerStars Hand #228690879014:  Hold'em No Limit ($0.25/$0.50 USD) - 2021/07/30 17:53:01 ET
Table 'Galilea III' 9-max Seat #4 is the button
Seat 1: Nestle170 ($57.17 in chips) 
Seat 2: StudentRB ($50 in chips) 
Seat 3: Pachebrash ($84.75 in chips) 
Seat 4: Corlogiro ($87.25 in chips) 
Seat 5: alexrus18 ($57.65 in chips) 
Seat 6: BALAWA ($109.50 in chips) 
Seat 7: __PKR__JNR__ ($58.48 in chips) 
Seat 8: christyirish ($51.37 in chips) 
Seat 9: nicu4you ($71.02 in chips) 
alexrus18: posts small blind $0.25
BALAWA: posts big blind $0.50
*** HOLE CARDS ***
__PKR__JNR__: folds 
christyirish: folds 
nicu4you: folds 
Nestle170: folds 
StudentRB: raises $0.75 to $1.25
Pachebrash: folds 
Corlogiro: calls $1.25
alexrus18: calls $1
BALAWA: folds 
*** FLOP *** [Qc 2s 5c]
alexrus18: checks 
StudentRB: checks 
Corlogiro: checks 
*** TURN *** [Qc 2s 5c] [7s]
alexrus18: checks 
StudentRB: checks 
Corlogiro: checks 
*** RIVER *** [Qc 2s 5c 7s] [4d]
alexrus18: checks 
StudentRB: bets $1.21
Corlogiro: folds 
alexrus18: folds 
Uncalled bet ($1.21) returned to StudentRB
StudentRB collected $4.04 from pot
StudentRB: doesn't show hand 
*** SUMMARY ***
Total pot $4.25 | Rake $0.21 
Board [Qc 2s 5c 7s 4d]
Seat 1: Nestle170 folded before Flop (didn't bet)
Seat 2: StudentRB collected ($4.04)
Seat 3: Pachebrash folded before Flop (didn't bet)
Seat 4: Corlogiro (button) folded on the River
Seat 5: alexrus18 (small blind) folded on the River
Seat 6: BALAWA (big blind) folded before Flop
Seat 7: __PKR__JNR__ folded before Flop (didn't bet)
Seat 8: christyirish folded before Flop (didn't bet)
Seat 9: nicu4you folded before Flop (didn't bet)



PokerStars Hand #228690917567:  Hold'em No Limit ($0.25/$0.50 USD) - 2021/07/30 17:54:32 ET
Table 'Galilea III' 9-max Seat #5 is the button
Seat 1: Nestle170 ($57.17 in chips) 
Seat 2: StudentRB ($52.79 in chips) 
Seat 3: Pachebrash ($84.75 in chips) 
Seat 4: Corlogiro ($86 in chips) 
Seat 5: alexrus18 ($56.40 in chips) 
Seat 6: BALAWA ($109 in chips) 
Seat 7: __PKR__JNR__ ($58.48 in chips) 
Seat 8: christyirish ($51.37 in chips) 
Seat 9: nicu4you ($71.02 in chips) 
BALAWA: posts small blind $0.25
__PKR__JNR__: posts big blind $0.50
*** HOLE CARDS ***
christyirish: folds 
nicu4you: folds 
Nestle170: raises $1 to $1.50
StudentRB: folds 
Pachebrash: folds 
Corlogiro: folds 
alexrus18: folds 
BALAWA: calls $1.25
__PKR__JNR__: calls $1
*** FLOP *** [Qs 2h Kh]
BALAWA: checks 
__PKR__JNR__: checks 
Nestle170: checks 
*** TURN *** [Qs 2h Kh] [Th]
BALAWA: bets $4.28
__PKR__JNR__: folds 
Nestle170: folds 
Uncalled bet ($4.28) returned to BALAWA
BALAWA collected $4.28 from pot
BALAWA: doesn't show hand 
*** SUMMARY ***
Total pot $4.50 | Rake $0.22 
Board [Qs 2h Kh Th]
Seat 1: Nestle170 folded on the Turn
Seat 2: StudentRB folded before Flop (didn't bet)
Seat 3: Pachebrash folded before Flop (didn't bet)
Seat 4: Corlogiro folded before Flop (didn't bet)
Seat 5: alexrus18 (button) folded before Flop (didn't bet)
Seat 6: BALAWA (small blind) collected ($4.28)
Seat 7: __PKR__JNR__ (big blind) folded on the Turn
Seat 8: christyirish folded before Flop (didn't bet)
Seat 9: nicu4you folded before Flop (didn't bet)



PokerStars Hand #228690937186:  Hold'em No Limit ($0.25/$0.50 USD) - 2021/07/30 17:55:21 ET
Table 'Galilea III' 9-max Seat #6 is the button
Seat 1: Nestle170 ($55.67 in chips) 
Seat 2: StudentRB ($52.79 in chips) 
Seat 3: Pachebrash ($84.75 in chips) 
Seat 4: Corlogiro ($86 in chips) 
Seat 5: alexrus18 ($56.40 in chips) 
Seat 6: BALAWA ($111.78 in chips) 
Seat 7: __PKR__JNR__ ($56.98 in chips) 
Seat 8: christyirish ($51.37 in chips) 
Seat 9: nicu4you ($71.02 in chips) 
__PKR__JNR__: posts small blind $0.25
christyirish: posts big blind $0.50
*** HOLE CARDS ***
nicu4you: folds 
Nestle170: folds 
StudentRB: folds 
Pachebrash: folds 
Corlogiro: raises $0.75 to $1.25
alexrus18: folds 
BALAWA has timed out
BALAWA: folds 
__PKR__JNR__: calls $1
christyirish: folds 
*** FLOP *** [2h 8s 7d]
__PKR__JNR__: checks 
Corlogiro: bets $1.50
__PKR__JNR__: calls $1.50
*** TURN *** [2h 8s 7d] [Qh]
__PKR__JNR__: checks 
Corlogiro: bets $3
__PKR__JNR__: calls $3
*** RIVER *** [2h 8s 7d Qh] [4c]
__PKR__JNR__: checks 
Corlogiro: checks 
*** SHOW DOWN ***
__PKR__JNR__: shows [3h 3c] (a pair of Threes)
Corlogiro: shows [Td Ts] (a pair of Tens)
Corlogiro collected $11.25 from pot
*** SUMMARY ***
Total pot $12 | Rake $0.75 
Board [2h 8s 7d Qh 4c]
Seat 1: Nestle170 folded before Flop (didn't bet)
Seat 2: StudentRB folded before Flop (didn't bet)
Seat 3: Pachebrash folded before Flop (didn't bet)
Seat 4: Corlogiro showed [Td Ts] and won ($11.25) with a pair of Tens
Seat 5: alexrus18 folded before Flop (didn't bet)
Seat 6: BALAWA (button) folded before Flop (didn't bet)
Seat 7: __PKR__JNR__ (small blind) showed [3h 3c] and lost with a pair of Threes
Seat 8: christyirish (big blind) folded before Flop
Seat 9: nicu4you folded before Flop (didn't bet)



PokerStars Hand #228690560502:  Hold'em No Limit ($0.25/$0.50 USD) - 2021/07/30 17:40:55 ET
Table 'Galilea III' 9-max Seat #2 is the button
Seat 1: Nestle170 ($65.71 in chips) 
Seat 2: StudentRB ($50 in chips) 
Seat 3: Pachebrash ($84.30 in chips) 
Seat 4: Corlogiro ($96.25 in chips) 
Seat 5: grafFIN7 ($47.78 in chips) 
Seat 6: BALAWA ($110.93 in chips) 
Seat 7: goldenpig666 ($53 in chips) 
Seat 8: christyirish ($50 in chips) 
Seat 9: nicu4you ($64.87 in chips) 
Pachebrash: posts small blind $0.25
Corlogiro: posts big blind $0.50
*** HOLE CARDS ***
grafFIN7 has timed out
grafFIN7: folds 
BALAWA: folds 
goldenpig666: folds 
christyirish: folds 
nicu4you: raises $1 to $1.50
Nestle170: folds 
StudentRB: folds 
grafFIN7 leaves the table
Pachebrash: folds 
Corlogiro: folds 
Uncalled bet ($1) returned to nicu4you
nicu4you collected $1.25 from pot
nicu4you: doesn't show hand 
*** SUMMARY ***
Total pot $1.25 | Rake $0 
Seat 1: Nestle170 folded before Flop (didn't bet)
Seat 2: StudentRB (button) folded before Flop (didn't bet)
Seat 3: Pachebrash (small blind) folded before Flop
Seat 4: Corlogiro (big blind) folded before Flop
Seat 5: grafFIN7 folded before Flop (didn't bet)
Seat 6: BALAWA folded before Flop (didn't bet)
Seat 7: goldenpig666 folded before Flop (didn't bet)
Seat 8: christyirish folded before Flop (didn't bet)
Seat 9: nicu4you collected ($1.25)



PokerStars Hand #228690569750:  Hold'em No Limit ($0.25/$0.50 USD) - 2021/07/30 17:41:16 ET
Table 'Galilea III' 9-max Seat #3 is the button
Seat 1: Nestle170 ($65.71 in chips) 
Seat 2: StudentRB ($50 in chips) 
Seat 3: Pachebrash ($84.05 in chips) 
Seat 4: Corlogiro ($95.75 in chips) 
Seat 6: BALAWA ($110.93 in chips) 
Seat 7: goldenpig666 ($53 in chips) 
Seat 8: christyirish ($50 in chips) 
Seat 9: nicu4you ($65.62 in chips) 
alexrus18 joins the table at seat #5 
Corlogiro: posts small blind $0.25
BALAWA: posts big blind $0.50
*** HOLE CARDS ***
goldenpig666: folds 
christyirish: folds 
nicu4you: folds 
Nestle170: folds 
StudentRB: raises $0.75 to $1.25
Pachebrash: folds 
Corlogiro: folds 
BALAWA has timed out
BALAWA: folds 
Uncalled bet ($0.75) returned to StudentRB
StudentRB collected $1.25 from pot
StudentRB: doesn't show hand 
*** SUMMARY ***
Total pot $1.25 | Rake $0 
Seat 1: Nestle170 folded before Flop (didn't bet)
Seat 2: StudentRB collected ($1.25)
Seat 3: Pachebrash (button) folded before Flop (didn't bet)
Seat 4: Corlogiro (small blind) folded before Flop
Seat 6: BALAWA (big blind) folded before Flop
Seat 7: goldenpig666 folded before Flop (didn't bet)
Seat 8: christyirish folded before Flop (didn't bet)
Seat 9: nicu4you folded before Flop (didn't bet)



PokerStars Hand #228690592408:  Hold'em No Limit ($0.25/$0.50 USD) - 2021/07/30 17:42:07 ET
Table 'Galilea III' 9-max Seat #4 is the button
Seat 1: Nestle170 ($65.71 in chips) 
Seat 2: StudentRB ($50.75 in chips) 
Seat 3: Pachebrash ($84.05 in chips) 
Seat 4: Corlogiro ($95.50 in chips) 
Seat 7: goldenpig666 ($53 in chips) 
Seat 8: christyirish ($50 in chips) 
Seat 9: nicu4you ($65.62 in chips) 
goldenpig666: posts small blind $0.25
christyirish: posts big blind $0.50
*** HOLE CARDS ***
nicu4you: folds 
Nestle170: folds 
StudentRB: folds 
Pachebrash: raises $0.75 to $1.25
Corlogiro: folds 
goldenpig666: raises $3.75 to $5
christyirish: folds 
Pachebrash: calls $3.75
*** FLOP *** [Ah 7d 3h]
goldenpig666: checks 
Pachebrash: bets $5.09
goldenpig666: folds 
Uncalled bet ($5.09) returned to Pachebrash
Pachebrash collected $9.98 from pot
Pachebrash: doesn't show hand 
*** SUMMARY ***
Total pot $10.50 | Rake $0.52 
Board [Ah 7d 3h]
Seat 1: Nestle170 folded before Flop (didn't bet)
Seat 2: StudentRB folded before Flop (didn't bet)
Seat 3: Pachebrash collected ($9.98)
Seat 4: Corlogiro (button) folded before Flop (didn't bet)
Seat 7: goldenpig666 (small blind) folded on the Flop
Seat 8: christyirish (big blind) folded before Flop
Seat 9: nicu4you folded before Flop (didn't bet)



PokerStars Hand #228690615035:  Hold'em No Limit ($0.25/$0.50 USD) - 2021/07/30 17:42:58 ET
Table 'Galilea III' 9-max Seat #7 is the button
Seat 1: Nestle170 ($65.71 in chips) 
Seat 2: StudentRB ($50.75 in chips) 
Seat 3: Pachebrash ($89.03 in chips) 
Seat 4: Corlogiro ($95.50 in chips) 
Seat 7: goldenpig666 ($50 in chips) 
Seat 8: christyirish ($50 in chips) 
Seat 9: nicu4you ($65.62 in chips) 
christyirish: posts small blind $0.25
nicu4you: posts big blind $0.50
alexrus18: sits out 
BALAWA: sits out 
*** HOLE CARDS ***
Nestle170: folds 
StudentRB: folds 
Pachebrash: folds 
Corlogiro: folds 
goldenpig666: folds 
christyirish: folds 
Uncalled bet ($0.25) returned to nicu4you
nicu4you collected $0.50 from pot
nicu4you: doesn't show hand 
*** SUMMARY ***
Total pot $0.50 | Rake $0 
Seat 1: Nestle170 folded before Flop (didn't bet)
Seat 2: StudentRB folded before Flop (didn't bet)
Seat 3: Pachebrash folded before Flop (didn't bet)
Seat 4: Corlogiro folded before Flop (didn't bet)
Seat 7: goldenpig666 (button) folded before Flop (didn't bet)
Seat 8: christyirish (small blind) folded before Flop
Seat 9: nicu4you (big blind) collected ($0.50)



PokerStars Hand #228690621461:  Hold'em No Limit ($0.25/$0.50 USD) - 2021/07/30 17:43:12 ET
Table 'Galilea III' 9-max Seat #8 is the button
Seat 1: Nestle170 ($65.71 in chips) 
Seat 2: StudentRB ($50.75 in chips) 
Seat 3: Pachebrash ($89.03 in chips) 
Seat 4: Corlogiro ($95.50 in chips) 
Seat 6: BALAWA ($110.43 in chips) 
Seat 7: goldenpig666 ($50 in chips) 
Seat 8: christyirish ($50 in chips) 
Seat 9: nicu4you ($65.87 in chips) 
nicu4you: posts small blind $0.25
Nestle170: posts big blind $0.50
alexrus18: sits out 
BALAWA: posts small blind $0.25
*** HOLE CARDS ***
StudentRB: folds 
Pachebrash: folds 
Corlogiro: folds 
BALAWA: folds 
goldenpig666: folds 
christyirish: folds 
nicu4you: folds 
Uncalled bet ($0.25) returned to Nestle170
Nestle170 collected $0.75 from pot
Nestle170: doesn't show hand 
*** SUMMARY ***
Total pot $0.75 | Rake $0 
Seat 1: Nestle170 (big blind) collected ($0.75)
Seat 2: StudentRB folded before Flop (didn't bet)
Seat 3: Pachebrash folded before Flop (didn't bet)
Seat 4: Corlogiro folded before Flop (didn't bet)
Seat 6: BALAWA folded before Flop (didn't bet)
Seat 7: goldenpig666 folded before Flop (didn't bet)
Seat 8: christyirish (button) folded before Flop (didn't bet)
Seat 9: nicu4you (small blind) folded before Flop



PokerStars Hand #228690626400:  Hold'em No Limit ($0.25/$0.50 USD) - 2021/07/30 17:43:24 ET
Table 'Galilea III' 9-max Seat #9 is the button
Seat 1: Nestle170 ($66.21 in chips) 
Seat 2: StudentRB ($50.75 in chips) 
Seat 3: Pachebrash ($89.03 in chips) 
Seat 4: Corlogiro ($95.50 in chips) 
Seat 6: BALAWA ($110.18 in chips) 
Seat 7: goldenpig666 ($50 in chips) 
Seat 8: christyirish ($50 in chips) 
Seat 9: nicu4you ($65.62 in chips) 
Nestle170: posts small blind $0.25
StudentRB: posts big blind $0.50
alexrus18: sits out 
*** HOLE CARDS ***
Pachebrash: folds 
Corlogiro: folds 
BALAWA has timed out
BALAWA: folds 
goldenpig666: folds 
christyirish: raises $1 to $1.50
nicu4you: folds 
Nestle170: raises $3.50 to $5
StudentRB: folds 
christyirish: calls $3.50
*** FLOP *** [2d Ks 6c]
Nestle170: bets $3.29
christyirish: calls $3.29
*** TURN *** [2d Ks 6c] [3s]
Nestle170: checks 
christyirish: checks 
*** RIVER *** [2d Ks 6c 3s] [5s]
Nestle170: checks 
christyirish: bets $16.23
Nestle170: folds 
Uncalled bet ($16.23) returned to christyirish
christyirish collected $16.23 from pot
*** SUMMARY ***
Total pot $17.08 | Rake $0.85 
Board [2d Ks 6c 3s 5s]
Seat 1: Nestle170 (small blind) folded on the River
Seat 2: StudentRB (big blind) folded before Flop
Seat 3: Pachebrash folded before Flop (didn't bet)
Seat 4: Corlogiro folded before Flop (didn't bet)
Seat 6: BALAWA folded before Flop (didn't bet)
Seat 7: goldenpig666 folded before Flop (didn't bet)
Seat 8: christyirish collected ($16.23)
Seat 9: nicu4you (button) folded before Flop (didn't bet)



PokerStars Hand #228690658491:  Hold'em No Limit ($0.25/$0.50 USD) - 2021/07/30 17:44:37 ET
Table 'Galilea III' 9-max Seat #1 is the button
Seat 1: Nestle170 ($57.92 in chips) 
Seat 2: StudentRB ($50.25 in chips) 
Seat 3: Pachebrash ($89.03 in chips) 
Seat 4: Corlogiro ($95.50 in chips) 
Seat 6: BALAWA ($110.18 in chips) 
Seat 7: goldenpig666 ($50 in chips) 
Seat 8: christyirish ($57.94 in chips) 
Seat 9: nicu4you ($65.62 in chips) 
StudentRB: posts small blind $0.25
Pachebrash: posts big blind $0.50
alexrus18: sits out 
*** HOLE CARDS ***
Corlogiro: folds 
BALAWA: raises $1 to $1.50
goldenpig666: folds 
christyirish: folds 
nicu4you: calls $1.50
Nestle170: folds 
StudentRB: folds 
Pachebrash: folds 
*** FLOP *** [Jh 8d 9d]
BALAWA: bets $3.56
nicu4you: folds 
Uncalled bet ($3.56) returned to BALAWA
BALAWA collected $3.56 from pot
BALAWA: doesn't show hand 
*** SUMMARY ***
Total pot $3.75 | Rake $0.19 
Board [Jh 8d 9d]
Seat 1: Nestle170 (button) folded before Flop (didn't bet)
Seat 2: StudentRB (small blind) folded before Flop
Seat 3: Pachebrash (big blind) folded before Flop
Seat 4: Corlogiro folded before Flop (didn't bet)
Seat 6: BALAWA collected ($3.56)
Seat 7: goldenpig666 folded before Flop (didn't bet)
Seat 8: christyirish folded before Flop (didn't bet)
Seat 9: nicu4you folded on the Flop



PokerStars Hand #228690671695:  Hold'em No Limit ($0.25/$0.50 USD) - 2021/07/30 17:45:07 ET
Table 'Galilea III' 9-max Seat #2 is the button
Seat 1: Nestle170 ($57.92 in chips) 
Seat 2: StudentRB ($50 in chips) 
Seat 3: Pachebrash ($88.53 in chips) 
Seat 4: Corlogiro ($95.50 in chips) 
Seat 6: BALAWA ($112.24 in chips) 
Seat 7: goldenpig666 ($50 in chips) 
Seat 8: christyirish ($57.94 in chips) 
Seat 9: nicu4you ($64.12 in chips) 
Pachebrash: posts small blind $0.25
Corlogiro: posts big blind $0.50
alexrus18: sits out 
*** HOLE CARDS ***
BALAWA: folds 
goldenpig666: raises $1 to $1.50
christyirish: folds 
nicu4you: folds 
Nestle170: folds 
StudentRB: folds 
Pachebrash: folds 
Corlogiro: calls $1
*** FLOP *** [Jh 4c 9c]
Corlogiro: checks 
goldenpig666: bets $1.75
Corlogiro: calls $1.75
*** TURN *** [Jh 4c 9c] [9h]
Corlogiro: checks 
goldenpig666: bets $4.75
Corlogiro: calls $4.75
*** RIVER *** [Jh 4c 9c 9h] [Ah]
Corlogiro: checks 
goldenpig666: checks 
*** SHOW DOWN ***
Corlogiro: shows [Ts Td] (two pair, Tens and Nines)
goldenpig666: shows [As Js] (two pair, Aces and Jacks)
goldenpig666 collected $15.24 from pot
*** SUMMARY ***
Total pot $16.25 | Rake $1.01 
Board [Jh 4c 9c 9h Ah]
Seat 1: Nestle170 folded before Flop (didn't bet)
Seat 2: StudentRB (button) folded before Flop (didn't bet)
Seat 3: Pachebrash (small blind) folded before Flop
Seat 4: Corlogiro (big blind) showed [Ts Td] and lost with two pair, Tens and Nines
Seat 6: BALAWA folded before Flop (didn't bet)
Seat 7: goldenpig666 showed [As Js] and won ($15.24) with two pair, Aces and Jacks
Seat 8: christyirish folded before Flop (didn't bet)
Seat 9: nicu4you folded before Flop (didn't bet)



PokerStars Hand #228690710521:  Hold'em No Limit ($0.25/$0.50 USD) - 2021/07/30 17:46:36 ET
Table 'Galilea III' 9-max Seat #3 is the button
Seat 1: Nestle170 ($57.92 in chips) 
Seat 2: StudentRB ($50 in chips) 
Seat 3: Pachebrash ($88.28 in chips) 
Seat 4: Corlogiro ($87.50 in chips) 
Seat 5: alexrus18 ($61.98 in chips) 
Seat 6: BALAWA ($112.24 in chips) 
Seat 7: goldenpig666 ($57.24 in chips) 
Seat 8: christyirish ($57.94 in chips) 
Seat 9: nicu4you ($64.12 in chips) 
Corlogiro: posts small blind $0.25
alexrus18: posts big blind $0.50
*** HOLE CARDS ***
BALAWA: calls $0.50
goldenpig666: folds 
christyirish: folds 
nicu4you: folds 
Nestle170: folds 
StudentRB: folds 
Pachebrash: raises $1.50 to $2
Corlogiro: folds 
alexrus18: folds 
BALAWA: calls $1.50
*** FLOP *** [Ts Qs 8s]
BALAWA: checks 
Pachebrash: bets $1.53
BALAWA: calls $1.53
*** TURN *** [Ts Qs 8s] [2h]
BALAWA: checks 
Pachebrash: checks 
*** RIVER *** [Ts Qs 8s 2h] [6h]
BALAWA: bets $7.42
Pachebrash: folds 
Uncalled bet ($7.42) returned to BALAWA
BALAWA collected $7.42 from pot
BALAWA: doesn't show hand 
*** SUMMARY ***
Total pot $7.81 | Rake $0.39 
Board [Ts Qs 8s 2h 6h]
Seat 1: Nestle170 folded before Flop (didn't bet)
Seat 2: StudentRB folded before Flop (didn't bet)
Seat 3: Pachebrash (button) folded on the River
Seat 4: Corlogiro (small blind) folded before Flop
Seat 5: alexrus18 (big blind) folded before Flop
Seat 6: BALAWA collected ($7.42)
Seat 7: goldenpig666 folded before Flop (didn't bet)
Seat 8: christyirish folded before Flop (didn't bet)
Seat 9: nicu4you folded before Flop (didn't bet)



PokerStars Hand #228690735074:  Hold'em No Limit ($0.25/$0.50 USD) - 2021/07/30 17:47:33 ET
Table 'Galilea III' 9-max Seat #4 is the button
Seat 1: Nestle170 ($57.92 in chips) 
Seat 2: StudentRB ($50 in chips) 
Seat 3: Pachebrash ($84.75 in chips) 
Seat 4: Corlogiro ($87.25 in chips) 
Seat 5: alexrus18 ($61.48 in chips) 
Seat 6: BALAWA ($116.13 in chips) 
Seat 7: goldenpig666 ($57.24 in chips) 
Seat 8: christyirish ($57.94 in chips) 
Seat 9: nicu4you ($64.12 in chips) 
alexrus18: posts small blind $0.25
BALAWA: posts big blind $0.50
*** HOLE CARDS ***
goldenpig666: folds 
christyirish: folds 
nicu4you: folds 
Nestle170: folds 
StudentRB: folds 
Pachebrash: folds 
Corlogiro: folds 
alexrus18: raises $0.75 to $1.25
BALAWA: folds 
Uncalled bet ($0.75) returned to alexrus18
alexrus18 collected $1 from pot
alexrus18: doesn't show hand 
*** SUMMARY ***
Total pot $1 | Rake $0 
Seat 1: Nestle170 folded before Flop (didn't bet)
Seat 2: StudentRB folded before Flop (didn't bet)
Seat 3: Pachebrash folded before Flop (didn't bet)
Seat 4: Corlogiro (button) folded before Flop (didn't bet)
Seat 5: alexrus18 (small blind) collected ($1)
Seat 6: BALAWA (big blind) folded before Flop
Seat 7: goldenpig666 folded before Flop (didn't bet)
Seat 8: christyirish folded before Flop (didn't bet)
Seat 9: nicu4you folded before Flop (didn't bet)



PokerStars Hand #228690743291:  Hold'em No Limit ($0.25/$0.50 USD) - 2021/07/30 17:47:52 ET
Table 'Galilea III' 9-max Seat #5 is the button
Seat 1: Nestle170 ($57.92 in chips) 
Seat 2: StudentRB ($50 in chips) 
Seat 3: Pachebrash ($84.75 in chips) 
Seat 4: Corlogiro ($87.25 in chips) 
Seat 5: alexrus18 ($61.98 in chips) 
Seat 6: BALAWA ($115.63 in chips) 
Seat 8: christyirish ($57.94 in chips) 
Seat 9: nicu4you ($64.12 in chips) 
BALAWA: posts small blind $0.25
goldenpig666: is sitting out 
christyirish: posts big blind $0.50
*** HOLE CARDS ***
nicu4you: raises $0.75 to $1.25
goldenpig666 leaves the table
Nestle170: folds 
StudentRB: folds 
Pachebrash: folds 
Corlogiro: folds 
alexrus18: calls $1.25
BALAWA: calls $1
christyirish: folds 
*** FLOP *** [4h 6d 9c]
BALAWA: checks 
nicu4you: checks 
alexrus18: bets $1.33
BALAWA: calls $1.33
nicu4you: folds 
*** TURN *** [4h 6d 9c] [8d]
BALAWA: bets $6.56
alexrus18: folds 
Uncalled bet ($6.56) returned to BALAWA
BALAWA collected $6.56 from pot
BALAWA: doesn't show hand 
*** SUMMARY ***
Total pot $6.91 | Rake $0.35 
Board [4h 6d 9c 8d]
Seat 1: Nestle170 folded before Flop (didn't bet)
Seat 2: StudentRB folded before Flop (didn't bet)
Seat 3: Pachebrash folded before Flop (didn't bet)
Seat 4: Corlogiro folded before Flop (didn't bet)
Seat 5: alexrus18 (button) folded on the Turn
Seat 6: BALAWA (small blind) collected ($6.56)
Seat 8: christyirish (big blind) folded before Flop
Seat 9: nicu4you folded on the Flop



PokerStars Hand #228690769972:  Hold'em No Limit ($0.25/$0.50 USD) - 2021/07/30 17:48:55 ET
Table 'Galilea III' 9-max Seat #6 is the button
Seat 1: Nestle170 ($57.92 in chips) 
Seat 2: StudentRB ($50 in chips) 
Seat 3: Pachebrash ($84.75 in chips) 
Seat 4: Corlogiro ($87.25 in chips) 
Seat 5: alexrus18 ($59.40 in chips) 
Seat 6: BALAWA ($119.61 in chips) 
Seat 8: christyirish ($57.44 in chips) 
Seat 9: nicu4you ($62.87 in chips) 
christyirish: posts small blind $0.25
__PKR__JNR__ joins the table at seat #7 
nicu4you: posts big blind $0.50
*** HOLE CARDS ***
Nestle170: folds 
StudentRB: folds 
Pachebrash: folds 
Corlogiro: folds 
alexrus18: folds 
BALAWA has timed out
BALAWA: folds 
christyirish: raises $1 to $1.50
nicu4you: calls $1
*** FLOP *** [Kc 7h Ts]
christyirish: bets $1.43
nicu4you: raises $3.14 to $4.57
christyirish: calls $3.14
*** TURN *** [Kc 7h Ts] [9s]
christyirish: checks 
nicu4you: bets $6.34
christyirish: folds 
Uncalled bet ($6.34) returned to nicu4you
nicu4you collected $11.53 from pot
nicu4you: doesn't show hand 
*** SUMMARY ***
Total pot $12.14 | Rake $0.61 
Board [Kc 7h Ts 9s]
Seat 1: Nestle170 folded before Flop (didn't bet)
Seat 2: StudentRB folded before Flop (didn't bet)
Seat 3: Pachebrash folded before Flop (didn't bet)
Seat 4: Corlogiro folded before Flop (didn't bet)
Seat 5: alexrus18 folded before Flop (didn't bet)
Seat 6: BALAWA (button) folded before Flop (didn't bet)
Seat 8: christyirish (small blind) folded on the Turn
Seat 9: nicu4you (big blind) collected ($11.53)



PokerStars Hand #228690793772:  Hold'em No Limit ($0.25/$0.50 USD) - 2021/07/30 17:49:51 ET
Table 'Galilea III' 9-max Seat #8 is the button
Seat 1: Nestle170 ($57.92 in chips) 
Seat 2: StudentRB ($50 in chips) 
Seat 3: Pachebrash ($84.75 in chips) 
Seat 4: Corlogiro ($87.25 in chips) 
Seat 5: alexrus18 ($59.40 in chips) 
Seat 6: BALAWA ($119.61 in chips) 
Seat 7: __PKR__JNR__ ($50 in chips) 
Seat 8: christyirish ($51.37 in chips) 
Seat 9: nicu4you ($68.33 in chips) 
nicu4you: posts small blind $0.25
Nestle170: posts big blind $0.50
__PKR__JNR__: posts big blind $0.50
*** HOLE CARDS ***
StudentRB: folds 
Pachebrash: folds 
Corlogiro: folds 
alexrus18: folds 
BALAWA: raises $1 to $1.50
__PKR__JNR__: calls $1
christyirish: folds 
nicu4you: calls $1.25
Nestle170: folds 
*** FLOP *** [7h Kd 3d]
nicu4you: checks 
BALAWA: bets $4.75
__PKR__JNR__: calls $4.75
nicu4you: folds 
*** TURN *** [7h Kd 3d] [8d]
BALAWA: checks 
__PKR__JNR__: checks 
*** RIVER *** [7h Kd 3d 8d] [7s]
BALAWA: bets $6.89
__PKR__JNR__: calls $6.89
*** SHOW DOWN ***
BALAWA: shows [Qc Qh] (two pair, Queens and Sevens)
__PKR__JNR__: shows [Kc Jd] (two pair, Kings and Sevens)
__PKR__JNR__ collected $26.87 from pot
*** SUMMARY ***
Total pot $28.28 | Rake $1.41 
Board [7h Kd 3d 8d 7s]
Seat 1: Nestle170 (big blind) folded before Flop
Seat 2: StudentRB folded before Flop (didn't bet)
Seat 3: Pachebrash folded before Flop (didn't bet)
Seat 4: Corlogiro folded before Flop (didn't bet)
Seat 5: alexrus18 folded before Flop (didn't bet)
Seat 6: BALAWA showed [Qc Qh] and lost with two pair, Queens and Sevens
Seat 7: __PKR__JNR__ showed [Kc Jd] and won ($26.87) with two pair, Kings and Sevens
Seat 8: christyirish (button) folded before Flop (didn't bet)
Seat 9: nicu4you (small blind) folded on the Flop



PokerStars Hand #228690817617:  Hold'em No Limit ($0.25/$0.50 USD) - 2021/07/30 17:50:47 ET
Table 'Galilea III' 9-max Seat #9 is the button
Seat 1: Nestle170 ($57.42 in chips) 
Seat 2: StudentRB ($50 in chips) 
Seat 3: Pachebrash ($84.75 in chips) 
Seat 4: Corlogiro ($87.25 in chips) 
Seat 5: alexrus18 ($59.40 in chips) 
Seat 6: BALAWA ($106.47 in chips) 
Seat 7: __PKR__JNR__ ($63.73 in chips) 
Seat 8: christyirish ($51.37 in chips) 
Seat 9: nicu4you ($66.83 in chips) 
Nestle170: posts small blind $0.25
StudentRB: posts big blind $0.50
*** HOLE CARDS ***
Pachebrash: folds 
Corlogiro: folds 
alexrus18: folds 
BALAWA: folds 
__PKR__JNR__: raises $1 to $1.50
christyirish: folds 
nicu4you: raises $3.75 to $5.25
Nestle170: folds 
StudentRB: folds 
__PKR__JNR__: calls $3.75
*** FLOP *** [Jh Tc Kh]
__PKR__JNR__: checks 
nicu4you: bets $7.38
__PKR__JNR__: folds 
Uncalled bet ($7.38) returned to nicu4you
nicu4you collected $10.69 from pot
nicu4you: doesn't show hand 
*** SUMMARY ***
Total pot $11.25 | Rake $0.56 
Board [Jh Tc Kh]
Seat 1: Nestle170 (small blind) folded before Flop
Seat 2: StudentRB (big blind) folded before Flop
Seat 3: Pachebrash folded before Flop (didn't bet)
Seat 4: Corlogiro folded before Flop (didn't bet)
Seat 5: alexrus18 folded before Flop (didn't bet)
Seat 6: BALAWA folded before Flop (didn't bet)
Seat 7: __PKR__JNR__ folded on the Flop
Seat 8: christyirish folded before Flop (didn't bet)
Seat 9: nicu4you (button) collected ($10.69)



PokerStars Hand #228690843027:  Hold'em No Limit ($0.25/$0.50 USD) - 2021/07/30 17:51:39 ET
Table 'Galilea III' 9-max Seat #1 is the button
Seat 1: Nestle170 ($57.17 in chips) 
Seat 2: StudentRB ($50 in chips) 
Seat 3: Pachebrash ($84.75 in chips) 
Seat 4: Corlogiro ($87.25 in chips) 
Seat 5: alexrus18 ($59.40 in chips) 
Seat 6: BALAWA ($106.47 in chips) 
Seat 7: __PKR__JNR__ ($58.48 in chips) 
Seat 8: christyirish ($51.37 in chips) 
Seat 9: nicu4you ($72.27 in chips) 
StudentRB: posts small blind $0.25
Pachebrash: posts big blind $0.50
*** HOLE CARDS ***
Corlogiro: folds 
alexrus18: folds 
BALAWA: folds 
__PKR__JNR__: folds 
christyirish: folds 
nicu4you: folds 
Nestle170: folds 
StudentRB: folds 
Uncalled bet ($0.25) returned to Pachebrash
Pachebrash collected $0.50 from pot
Pachebrash: doesn't show hand 
*** SUMMARY ***
Total pot $0.50 | Rake $0 
Seat 1: Nestle170 (button) folded before Flop (didn't bet)
Seat 2: StudentRB (small blind) folded before Flop
Seat 3: Pachebrash (big blind) collected ($0.50)
Seat 4: Corlogiro folded before Flop (didn't bet)
Seat 5: alexrus18 folded before Flop (didn't bet)
Seat 6: BALAWA folded before Flop (didn't bet)
Seat 7: __PKR__JNR__ folded before Flop (didn't bet)
Seat 8: christyirish folded before Flop (didn't bet)
Seat 9: nicu4you folded before Flop (didn't bet)



PokerStars Hand #228690852071:  Hold'em No Limit ($0.25/$0.50 USD) - 2021/07/30 17:52:00 ET
Table 'Galilea III' 9-max Seat #2 is the button
Seat 1: Nestle170 ($57.17 in chips) 
Seat 2: StudentRB ($50 in chips) 
Seat 3: Pachebrash ($85 in chips) 
Seat 4: Corlogiro ($87.25 in chips) 
Seat 5: alexrus18 ($59.40 in chips) 
Seat 6: BALAWA ($106.47 in chips) 
Seat 7: __PKR__JNR__ ($58.48 in chips) 
Seat 8: christyirish ($51.37 in chips) 
Seat 9: nicu4you ($72.27 in chips) 
Pachebrash: posts small blind $0.25
Corlogiro: posts big blind $0.50
*** HOLE CARDS ***
alexrus18: raises $0.75 to $1.25
BALAWA: calls $1.25
__PKR__JNR__: folds 
christyirish: folds 
nicu4you: calls $1.25
Nestle170: folds 
StudentRB: folds 
Pachebrash: folds 
Corlogiro: folds 
*** FLOP *** [Ac 8d 4s]
alexrus18: checks 
BALAWA: checks 
nicu4you: checks 
*** TURN *** [Ac 8d 4s] [7h]
alexrus18: checks 
BALAWA: bets $4.28
nicu4you: folds 
alexrus18: folds 
Uncalled bet ($4.28) returned to BALAWA
BALAWA collected $4.28 from pot
BALAWA: doesn't show hand 
*** SUMMARY ***
Total pot $4.50 | Rake $0.22 
Board [Ac 8d 4s 7h]
Seat 1: Nestle170 folded before Flop (didn't bet)
Seat 2: StudentRB (button) folded before Flop (didn't bet)
Seat 3: Pachebrash (small blind) folded before Flop
Seat 4: Corlogiro (big blind) folded before Flop
Seat 5: alexrus18 folded on the Turn
Seat 6: BALAWA collected ($4.28)
Seat 7: __PKR__JNR__ folded before Flop (didn't bet)
Seat 8: christyirish folded before Flop (didn't bet)
Seat 9: nicu4you folded on the Turn



PokerStars Hand #228690963157:  Hold'em No Limit ($0.25/$0.50 USD) - 2021/07/30 17:56:42 ET
Table 'Galilea III' 9-max Seat #7 is the button
Seat 1: Nestle170 ($55.67 in chips) 
Seat 2: StudentRB ($52.79 in chips) 
Seat 3: Pachebrash ($84.75 in chips) 
Seat 4: Corlogiro ($91.50 in chips) 
Seat 5: alexrus18 ($56.40 in chips) 
Seat 7: __PKR__JNR__ ($51.23 in chips) 
Seat 8: christyirish ($50.87 in chips) 
Seat 9: nicu4you ($71.02 in chips) 
christyirish: posts small blind $0.25
nicu4you: posts big blind $0.50
*** HOLE CARDS ***
Nestle170: folds 
StudentRB: folds 
Pachebrash: folds 
Corlogiro: folds 
alexrus18: raises $0.75 to $1.25
__PKR__JNR__: folds 
christyirish: raises $3 to $4.25
BALAWA is disconnected 
nicu4you: raises $6.25 to $10.50
alexrus18: folds 
christyirish: folds 
Uncalled bet ($6.25) returned to nicu4you
nicu4you collected $9.75 from pot
nicu4you: doesn't show hand 
*** SUMMARY ***
Total pot $9.75 | Rake $0 
Seat 1: Nestle170 folded before Flop (didn't bet)
Seat 2: StudentRB folded before Flop (didn't bet)
Seat 3: Pachebrash folded before Flop (didn't bet)
Seat 4: Corlogiro folded before Flop (didn't bet)
Seat 5: alexrus18 folded before Flop
Seat 7: __PKR__JNR__ (button) folded before Flop (didn't bet)
Seat 8: christyirish (small blind) folded before Flop
Seat 9: nicu4you (big blind) collected ($9.75)



PokerStars Hand #228690976702:  Hold'em No Limit ($0.25/$0.50 USD) - 2021/07/30 17:57:23 ET
Table 'Galilea III' 9-max Seat #8 is the button
Seat 1: Nestle170 ($55.67 in chips) 
Seat 2: StudentRB ($52.79 in chips) 
Seat 3: Pachebrash ($84.75 in chips) 
Seat 4: Corlogiro ($91.50 in chips) 
Seat 5: alexrus18 ($55.15 in chips) 
Seat 7: __PKR__JNR__ ($51.23 in chips) 
Seat 8: christyirish ($50 in chips) 
Seat 9: nicu4you ($76.52 in chips) 
nicu4you: posts small blind $0.25
Nestle170: posts big blind $0.50
*** HOLE CARDS ***
StudentRB: raises $0.75 to $1.25
Pachebrash: folds 
Corlogiro: folds 
alexrus18: folds 
__PKR__JNR__: folds 
christyirish: folds 
nicu4you: folds 
Nestle170: calls $0.75
*** FLOP *** [Ac 6c 3d]
Nestle170: checks 
StudentRB: checks 
*** TURN *** [Ac 6c 3d] [Jc]
Nestle170: checks 
StudentRB: checks 
*** RIVER *** [Ac 6c 3d Jc] [Js]
Nestle170: checks 
StudentRB: bets $0.78
Nestle170: folds 
Uncalled bet ($0.78) returned to StudentRB
StudentRB collected $2.61 from pot
StudentRB: doesn't show hand 
*** SUMMARY ***
Total pot $2.75 | Rake $0.14 
Board [Ac 6c 3d Jc Js]
Seat 1: Nestle170 (big blind) folded on the River
Seat 2: StudentRB collected ($2.61)
Seat 3: Pachebrash folded before Flop (didn't bet)
Seat 4: Corlogiro folded before Flop (didn't bet)
Seat 5: alexrus18 folded before Flop (didn't bet)
Seat 7: __PKR__JNR__ folded before Flop (didn't bet)
Seat 8: christyirish (button) folded before Flop (didn't bet)
Seat 9: nicu4you (small blind) folded before Flop



PokerStars Hand #228691013752:  Hold'em No Limit ($0.25/$0.50 USD) - 2021/07/30 17:58:31 ET
Table 'Galilea III' 9-max Seat #9 is the button
Seat 1: Nestle170 ($54.42 in chips) 
Seat 2: StudentRB ($54.15 in chips) 
Seat 3: Pachebrash ($84.75 in chips) 
Seat 4: Corlogiro ($91.50 in chips) 
Seat 5: alexrus18 ($55.15 in chips) 
Seat 7: __PKR__JNR__ ($51.23 in chips) 
Seat 8: christyirish ($50 in chips) 
Seat 9: nicu4you ($76.27 in chips) 
Nestle170: posts small blind $0.25
StudentRB: posts big blind $0.50
*** HOLE CARDS ***
Pachebrash: folds 
Corlogiro: folds 
alexrus18: folds 
__PKR__JNR__: raises $1.50 to $2
christyirish: folds 
nicu4you: folds 
Nestle170: folds 
StudentRB: folds 
Uncalled bet ($1.50) returned to __PKR__JNR__
__PKR__JNR__ collected $1.25 from pot
__PKR__JNR__: doesn't show hand 
*** SUMMARY ***
Total pot $1.25 | Rake $0 
Seat 1: Nestle170 (small blind) folded before Flop
Seat 2: StudentRB (big blind) folded before Flop
Seat 3: Pachebrash folded before Flop (didn't bet)
Seat 4: Corlogiro folded before Flop (didn't bet)
Seat 5: alexrus18 folded before Flop (didn't bet)
Seat 7: __PKR__JNR__ collected ($1.25)
Seat 8: christyirish folded before Flop (didn't bet)
Seat 9: nicu4you (button) folded before Flop (didn't bet)



PokerStars Hand #228691020448:  Hold'em No Limit ($0.25/$0.50 USD) - 2021/07/30 17:58:52 ET
Table 'Galilea III' 9-max Seat #1 is the button
Seat 1: Nestle170 ($54.17 in chips) 
Seat 2: StudentRB ($53.65 in chips) 
Seat 3: Pachebrash ($84.75 in chips) 
Seat 4: Corlogiro ($91.50 in chips) 
Seat 5: alexrus18 ($55.15 in chips) 
Seat 7: __PKR__JNR__ ($51.98 in chips) 
Seat 8: christyirish ($50 in chips) 
Seat 9: nicu4you ($76.27 in chips) 
StudentRB: posts small blind $0.25
Pachebrash: posts big blind $0.50
*** HOLE CARDS ***
Corlogiro: folds 
alexrus18: folds 
__PKR__JNR__: folds 
christyirish has timed out
christyirish: folds 
nicu4you: folds 
Nestle170: raises $0.60 to $1.10
StudentRB: folds 
Pachebrash: folds 
Uncalled bet ($0.60) returned to Nestle170
Nestle170 collected $1.25 from pot
Nestle170: doesn't show hand 
*** SUMMARY ***
Total pot $1.25 | Rake $0 
Seat 1: Nestle170 (button) collected ($1.25)
Seat 2: StudentRB (small blind) folded before Flop
Seat 3: Pachebrash (big blind) folded before Flop
Seat 4: Corlogiro folded before Flop (didn't bet)
Seat 5: alexrus18 folded before Flop (didn't bet)
Seat 7: __PKR__JNR__ folded before Flop (didn't bet)
Seat 8: christyirish folded before Flop (didn't bet)
Seat 9: nicu4you folded before Flop (didn't bet)



PokerStars Hand #228691028858:  Hold'em No Limit ($0.25/$0.50 USD) - 2021/07/30 17:59:18 ET
Table 'Galilea III' 9-max Seat #2 is the button
Seat 1: Nestle170 ($54.92 in chips) 
Seat 2: StudentRB ($53.40 in chips) 
Seat 3: Pachebrash ($84.25 in chips) 
Seat 4: Corlogiro ($91.50 in chips) 
Seat 5: alexrus18 ($55.15 in chips) 
Seat 7: __PKR__JNR__ ($51.98 in chips) 
Seat 8: christyirish ($50 in chips) 
Seat 9: nicu4you ($76.27 in chips) 
Pachebrash: posts small blind $0.25
Corlogiro: posts big blind $0.50
*** HOLE CARDS ***
alexrus18: folds 
__PKR__JNR__: folds 
christyirish: folds 
nicu4you: folds 
Nestle170: folds 
StudentRB: raises $0.75 to $1.25
Pachebrash: folds 
Corlogiro: folds 
Uncalled bet ($0.75) returned to StudentRB
StudentRB collected $1.25 from pot
StudentRB: doesn't show hand 
*** SUMMARY ***
Total pot $1.25 | Rake $0 
Seat 1: Nestle170 folded before Flop (didn't bet)
Seat 2: StudentRB (button) collected ($1.25)
Seat 3: Pachebrash (small blind) folded before Flop
Seat 4: Corlogiro (big blind) folded before Flop
Seat 5: alexrus18 folded before Flop (didn't bet)
Seat 7: __PKR__JNR__ folded before Flop (didn't bet)
Seat 8: christyirish folded before Flop (didn't bet)
Seat 9: nicu4you folded before Flop (didn't bet)



PokerStars Hand #228691034120:  Hold'em No Limit ($0.25/$0.50 USD) - 2021/07/30 17:59:34 ET
Table 'Galilea III' 9-max Seat #3 is the button
Seat 1: Nestle170 ($54.92 in chips) 
Seat 2: StudentRB ($54.15 in chips) 
Seat 3: Pachebrash ($84 in chips) 
Seat 4: Corlogiro ($91 in chips) 
Seat 5: alexrus18 ($55.15 in chips) 
Seat 7: __PKR__JNR__ ($51.98 in chips) 
Seat 8: christyirish ($50 in chips) 
Seat 9: nicu4you ($76.27 in chips) 
Corlogiro: posts small blind $0.25
alexrus18: posts big blind $0.50
*** HOLE CARDS ***
__PKR__JNR__ is disconnected 
__PKR__JNR__ has timed out while being disconnected
__PKR__JNR__: folds 
christyirish: raises $1 to $1.50
nicu4you: folds 
Nestle170: folds 
StudentRB: folds 
Pachebrash: folds 
Corlogiro: folds 
alexrus18: calls $1
*** FLOP *** [5c Jc 9s]
alexrus18: checks 
christyirish: bets $1.55
alexrus18: raises $3.45 to $5
christyirish: calls $3.45
*** TURN *** [5c Jc 9s] [5d]
Nestle170 leaves the table
alexrus18: bets $6.25
christyirish: calls $6.25
*** RIVER *** [5c Jc 9s 5d] [4s]
wildermorph joins the table at seat #1 
alexrus18: bets $13.50
christyirish: calls $13.50
*** SHOW DOWN ***
alexrus18: shows [9d 9c] (a full house, Nines full of Fives)
christyirish: mucks hand 
alexrus18 collected $50.75 from pot
*** SUMMARY ***
Total pot $52.75 | Rake $2 
Board [5c Jc 9s 5d 4s]
Seat 1: Nestle170 folded before Flop (didn't bet)
Seat 2: StudentRB folded before Flop (didn't bet)
Seat 3: Pachebrash (button) folded before Flop (didn't bet)
Seat 4: Corlogiro (small blind) folded before Flop
Seat 5: alexrus18 (big blind) showed [9d 9c] and won ($50.75) with a full house, Nines full of Fives
Seat 7: __PKR__JNR__ folded before Flop (didn't bet)
Seat 8: christyirish mucked
Seat 9: nicu4you folded before Flop (didn't bet)



PokerStars Hand #228691060859:  Hold'em No Limit ($0.25/$0.50 USD) - 2021/07/30 18:00:52 ET
Table 'Galilea III' 9-max Seat #4 is the button
Seat 2: StudentRB ($54.15 in chips) 
Seat 3: Pachebrash ($84 in chips) 
Seat 4: Corlogiro ($90.75 in chips) 
Seat 5: alexrus18 ($79.65 in chips) 
Seat 8: christyirish ($50 in chips) 
Seat 9: nicu4you ($76.27 in chips) 
alexrus18: posts small blind $0.25
__PKR__JNR__ has timed out
__PKR__JNR__: is sitting out 
christyirish: posts big blind $0.50
wildermorph: is sitting out 
*** HOLE CARDS ***
wildermorph leaves the table
nicu4you: folds 
StudentRB: folds 
Pachebrash: folds 
__PKR__JNR__ is disconnected 
Corlogiro: raises $0.75 to $1.25
alexrus18: folds 
christyirish: folds 
Uncalled bet ($0.75) returned to Corlogiro
Corlogiro collected $1.25 from pot
Corlogiro: doesn't show hand 
*** SUMMARY ***
Total pot $1.25 | Rake $0 
Seat 2: StudentRB folded before Flop (didn't bet)
Seat 3: Pachebrash folded before Flop (didn't bet)
Seat 4: Corlogiro (button) collected ($1.25)
Seat 5: alexrus18 (small blind) folded before Flop
Seat 8: christyirish (big blind) folded before Flop
Seat 9: nicu4you folded before Flop (didn't bet)



PokerStars Hand #228691071442:  Hold'em No Limit ($0.25/$0.50 USD) - 2021/07/30 18:01:19 ET
Table 'Galilea III' 9-max Seat #5 is the button
Seat 2: StudentRB ($54.15 in chips) 
Seat 3: Pachebrash ($84 in chips) 
Seat 4: Corlogiro ($91.50 in chips) 
Seat 5: alexrus18 ($79.40 in chips) 
Seat 8: christyirish ($50 in chips) 
christyirish: posts small blind $0.25
nicu4you: is sitting out 
StudentRB: posts big blind $0.50
*** HOLE CARDS ***
nicu4you leaves the table
Pachebrash: folds 
Corlogiro: folds 
alexrus18: folds 
christyirish: calls $0.25
StudentRB: raises $1 to $1.50
christyirish: calls $1
*** FLOP *** [3d 2c 7h]
christyirish: checks 
StudentRB: bets $0.94
christyirish: calls $0.94
*** TURN *** [3d 2c 7h] [Qc]
christyirish: checks 
StudentRB: bets $3.48
christyirish: calls $3.48
*** RIVER *** [3d 2c 7h Qc] [Ad]
christyirish: checks 
StudentRB: bets $8.44
__PKR__JNR__ is disconnected 
christyirish: folds 
Uncalled bet ($8.44) returned to StudentRB
Mr_Ingvarr joins the table at seat #9 
StudentRB collected $11.25 from pot
StudentRB: doesn't show hand 
*** SUMMARY ***
Total pot $11.84 | Rake $0.59 
Board [3d 2c 7h Qc Ad]
Seat 2: StudentRB (big blind) collected ($11.25)
Seat 3: Pachebrash folded before Flop (didn't bet)
Seat 4: Corlogiro folded before Flop (didn't bet)
Seat 5: alexrus18 (button) folded before Flop (didn't bet)
Seat 8: christyirish (small blind) folded on the River



PokerStars Hand #228691096072:  Hold'em No Limit ($0.25/$0.50 USD) - 2021/07/30 18:02:18 ET
Table 'Galilea III' 9-max Seat #8 is the button
Seat 2: StudentRB ($59.48 in chips) 
Seat 3: Pachebrash ($84 in chips) 
Seat 4: Corlogiro ($91.50 in chips) 
Seat 5: alexrus18 ($79.40 in chips) 
Seat 7: __PKR__JNR__ ($51.98 in chips) 
Seat 8: christyirish ($50 in chips) 
StudentRB: posts small blind $0.25
Pachebrash: posts big blind $0.50
__PKR__JNR__ is connected 
__PKR__JNR__: posts small & big blinds $0.75
*** HOLE CARDS ***
Corlogiro: folds 
alexrus18: folds 
__PKR__JNR__: raises $1.50 to $2
christyirish: raises $5 to $7
StudentRB: folds 
Pachebrash: folds 
DKNicko joins the table at seat #1 
__PKR__JNR__ is disconnected 
__PKR__JNR__ is connected 
__PKR__JNR__: folds 
Uncalled bet ($5) returned to christyirish
christyirish collected $5 from pot
christyirish: doesn't show hand 
*** SUMMARY ***
Total pot $5 | Rake $0 
Seat 2: StudentRB (small blind) folded before Flop
Seat 3: Pachebrash (big blind) folded before Flop
Seat 4: Corlogiro folded before Flop (didn't bet)
Seat 5: alexrus18 folded before Flop (didn't bet)
Seat 7: __PKR__JNR__ folded before Flop
Seat 8: christyirish (button) collected ($5)



PokerStars Hand #228691121374:  Hold'em No Limit ($0.25/$0.50 USD) - 2021/07/30 18:03:19 ET
Table 'Galilea III' 9-max Seat #2 is the button
Seat 1: DKNicko ($50 in chips) 
Seat 2: StudentRB ($59.23 in chips) 
Seat 3: Pachebrash ($83.50 in chips) 
Seat 5: alexrus18 ($79.40 in chips) 
Seat 8: christyirish ($53 in chips) 
Pachebrash: posts small blind $0.25
Corlogiro: is sitting out 
alexrus18: posts big blind $0.50
Mr_Ingvarr: sits out 
DKNicko: posts big blind $0.50
*** HOLE CARDS ***
__PKR__JNR__ is disconnected 
christyirish: raises $1 to $1.50
DKNicko: folds 
StudentRB: folds 
Pachebrash: folds 
alexrus18: calls $1
*** FLOP *** [5d Qc 2d]
alexrus18: checks 
Mr_Ingvarr leaves the table
christyirish: bets $1.78
alexrus18: calls $1.78
*** TURN *** [5d Qc 2d] [3s]
alexrus18: checks 
christyirish: bets $5.21
alexrus18: folds 
Uncalled bet ($5.21) returned to christyirish
christyirish collected $6.94 from pot
christyirish: doesn't show hand 
*** SUMMARY ***
Total pot $7.31 | Rake $0.37 
Board [5d Qc 2d 3s]
Seat 1: DKNicko folded before Flop (didn't bet)
Seat 2: StudentRB (button) folded before Flop (didn't bet)
Seat 3: Pachebrash (small blind) folded before Flop
Seat 5: alexrus18 (big blind) folded on the Turn
Seat 8: christyirish collected ($6.94)



PokerStars Hand #228691135068:  Hold'em No Limit ($0.25/$0.50 USD) - 2021/07/30 18:03:50 ET
Table 'Galilea III' 9-max Seat #3 is the button
Seat 1: DKNicko ($49.50 in chips) 
Seat 2: StudentRB ($59.23 in chips) 
Seat 3: Pachebrash ($83.25 in chips) 
Seat 5: alexrus18 ($76.12 in chips) 
Seat 8: christyirish ($56.66 in chips) 
alexrus18: posts small blind $0.25
christyirish: posts big blind $0.50
*** HOLE CARDS ***
DKNicko: folds 
VandesandeBart joins the table at seat #9 
StudentRB: folds 
Pachebrash: raises $0.70 to $1.20
alexrus18: folds 
christyirish: folds 
Uncalled bet ($0.70) returned to Pachebrash
Pachebrash collected $1.25 from pot
Pachebrash: doesn't show hand 
*** SUMMARY ***
Total pot $1.25 | Rake $0 
Seat 1: DKNicko folded before Flop (didn't bet)
Seat 2: StudentRB folded before Flop (didn't bet)
Seat 3: Pachebrash (button) collected ($1.25)
Seat 5: alexrus18 (small blind) folded before Flop
Seat 8: christyirish (big blind) folded before Flop



PokerStars Hand #228691140813:  Hold'em No Limit ($0.25/$0.50 USD) - 2021/07/30 18:04:04 ET
Table 'Galilea III' 9-max Seat #5 is the button
Seat 1: DKNicko ($49.50 in chips) 
Seat 2: StudentRB ($59.23 in chips) 
Seat 3: Pachebrash ($84 in chips) 
Seat 5: alexrus18 ($75.87 in chips) 
Seat 8: christyirish ($56.16 in chips) 
Seat 9: VandesandeBart ($40 in chips) 
christyirish: posts small blind $0.25
VandesandeBart: posts big blind $0.50
*** HOLE CARDS ***
DKNicko: folds 
StudentRB: folds 
Pachebrash: raises $0.75 to $1.25
alexrus18: folds 
christyirish: folds 
VandesandeBart: raises $0.75 to $2
Pachebrash: calls $0.75
*** FLOP *** [2h 6d Tc]
VandesandeBart: bets $2.02
Pachebrash: folds 
Uncalled bet ($2.02) returned to VandesandeBart
VandesandeBart collected $4.04 from pot
VandesandeBart: doesn't show hand 
*** SUMMARY ***
Total pot $4.25 | Rake $0.21 
Board [2h 6d Tc]
Seat 1: DKNicko folded before Flop (didn't bet)
Seat 2: StudentRB folded before Flop (didn't bet)
Seat 3: Pachebrash folded on the Flop
Seat 5: alexrus18 (button) folded before Flop (didn't bet)
Seat 8: christyirish (small blind) folded before Flop
Seat 9: VandesandeBart (big blind) collected ($4.04)



PokerStars Hand #228691150913:  Hold'em No Limit ($0.25/$0.50 USD) - 2021/07/30 18:04:28 ET
Table 'Galilea III' 9-max Seat #8 is the button
Seat 1: DKNicko ($49.50 in chips) 
Seat 2: StudentRB ($59.23 in chips) 
Seat 3: Pachebrash ($82 in chips) 
Seat 5: alexrus18 ($75.87 in chips) 
Seat 8: christyirish ($55.91 in chips) 
Seat 9: VandesandeBart ($42.04 in chips) 
VandesandeBart: posts small blind $0.25
DKNicko: posts big blind $0.50
*** HOLE CARDS ***
StudentRB: folds 
Pachebrash: folds 
alexrus18: folds 
christyirish: folds 
VandesandeBart: calls $0.25
DKNicko: checks 
*** FLOP *** [Jh 3s 4s]
VandesandeBart: bets $0.50
DKNicko: folds 
Uncalled bet ($0.50) returned to VandesandeBart
VandesandeBart collected $0.95 from pot
VandesandeBart: doesn't show hand 
*** SUMMARY ***
Total pot $1 | Rake $0.05 
Board [Jh 3s 4s]
Seat 1: DKNicko (big blind) folded on the Flop
Seat 2: StudentRB folded before Flop (didn't bet)
Seat 3: Pachebrash folded before Flop (didn't bet)
Seat 5: alexrus18 folded before Flop (didn't bet)
Seat 8: christyirish (button) folded before Flop (didn't bet)
Seat 9: VandesandeBart (small blind) collected ($0.95)



PokerStars Hand #228691164259:  Hold'em No Limit ($0.25/$0.50 USD) - 2021/07/30 18:04:59 ET
Table 'Galilea III' 9-max Seat #9 is the button
Seat 1: DKNicko ($49 in chips) 
Seat 3: Pachebrash ($82 in chips) 
Seat 5: alexrus18 ($75.87 in chips) 
Seat 7: __PKR__JNR__ ($49.73 in chips) 
Seat 8: christyirish ($55.91 in chips) 
Seat 9: VandesandeBart ($42.49 in chips) 
DKNicko: posts small blind $0.25
StudentRB: is sitting out 
Pachebrash: posts big blind $0.50
__PKR__JNR__: posts small & big blinds $0.75
*** HOLE CARDS ***
alexrus18: folds 
__PKR__JNR__: checks 
christyirish: folds 
StudentRB leaves the table
VandesandeBart: calls $0.50
DKNicko: calls $0.25
Pachebrash: checks 
*** FLOP *** [Ah Ac Qc]
DKNicko: bets $0.50
Pachebrash: folds 
__PKR__JNR__: folds 
VandesandeBart: raises $0.50 to $1
MarsMiland joins the table at seat #2 
DKNicko: folds 
Uncalled bet ($0.50) returned to VandesandeBart
VandesandeBart collected $3.09 from pot
VandesandeBart: doesn't show hand 
*** SUMMARY ***
Total pot $3.25 | Rake $0.16 
Board [Ah Ac Qc]
Seat 1: DKNicko (small blind) folded on the Flop
Seat 3: Pachebrash (big blind) folded on the Flop
Seat 5: alexrus18 folded before Flop (didn't bet)
Seat 7: __PKR__JNR__ folded on the Flop (didn't bet)
Seat 8: christyirish folded before Flop (didn't bet)
Seat 9: VandesandeBart (button) collected ($3.09)



PokerStars Hand #228691177569:  Hold'em No Limit ($0.25/$0.50 USD) - 2021/07/30 18:05:31 ET
Table 'Galilea III' 9-max Seat #1 is the button
Seat 1: DKNicko ($48 in chips) 
Seat 3: Pachebrash ($81.50 in chips) 
Seat 4: Corlogiro ($91.50 in chips) 
Seat 5: alexrus18 ($75.87 in chips) 
Seat 7: __PKR__JNR__ ($48.98 in chips) 
Seat 8: christyirish ($55.91 in chips) 
Seat 9: VandesandeBart ($44.58 in chips) 
Pachebrash: posts small blind $0.25
Corlogiro: posts big blind $0.50
*** HOLE CARDS ***
alexrus18: raises $0.75 to $1.25
__PKR__JNR__: folds 
christyirish: folds 
VandesandeBart: folds 
DKNicko: raises $3.25 to $4.50
Pachebrash: folds 
Corlogiro: folds 
BALAWA is disconnected 
alexrus18: folds 
Uncalled bet ($3.25) returned to DKNicko
DKNicko collected $3.25 from pot
*** SUMMARY ***
Total pot $3.25 | Rake $0 
Seat 1: DKNicko (button) collected ($3.25)
Seat 3: Pachebrash (small blind) folded before Flop
Seat 4: Corlogiro (big blind) folded before Flop
Seat 5: alexrus18 folded before Flop
Seat 7: __PKR__JNR__ folded before Flop (didn't bet)
Seat 8: christyirish folded before Flop (didn't bet)
Seat 9: VandesandeBart folded before Flop (didn't bet)



PokerStars Hand #228691189234:  Hold'em No Limit ($0.25/$0.50 USD) - 2021/07/30 18:05:58 ET
Table 'Galilea III' 9-max Seat #3 is the button
Seat 1: DKNicko ($50 in chips) 
Seat 3: Pachebrash ($81.25 in chips) 
Seat 4: Corlogiro ($91 in chips) 
Seat 5: alexrus18 ($74.62 in chips) 
Seat 7: __PKR__JNR__ ($48.98 in chips) 
Seat 8: christyirish ($55.91 in chips) 
Seat 9: VandesandeBart ($44.58 in chips) 
Corlogiro: posts small blind $0.25
alexrus18: posts big blind $0.50
MarsMiland: sits out 
*** HOLE CARDS ***
__PKR__JNR__: folds 
christyirish: folds 
VandesandeBart: raises $0.50 to $1
DKNicko: folds 
Pachebrash: folds 
Corlogiro: folds 
alexrus18: calls $0.50
*** FLOP *** [Js 7d 5d]
alexrus18: checks 
VandesandeBart: bets $1.07
alexrus18: calls $1.07
*** TURN *** [Js 7d 5d] [Th]
alexrus18: checks 
VandesandeBart: bets $2.08
alexrus18: calls $2.08
*** RIVER *** [Js 7d 5d Th] [Qs]
alexrus18: checks 
VandesandeBart: bets $8.12
alexrus18: folds 
Uncalled bet ($8.12) returned to VandesandeBart
VandesandeBart collected $8.12 from pot
VandesandeBart: doesn't show hand 
*** SUMMARY ***
Total pot $8.55 | Rake $0.43 
Board [Js 7d 5d Th Qs]
Seat 1: DKNicko folded before Flop (didn't bet)
Seat 3: Pachebrash (button) folded before Flop (didn't bet)
Seat 4: Corlogiro (small blind) folded before Flop
Seat 5: alexrus18 (big blind) folded on the River
Seat 7: __PKR__JNR__ folded before Flop (didn't bet)
Seat 8: christyirish folded before Flop (didn't bet)
Seat 9: VandesandeBart collected ($8.12)



PokerStars Hand #228691210761:  Hold'em No Limit ($0.25/$0.50 USD) - 2021/07/30 18:06:49 ET
Table 'Galilea III' 9-max Seat #4 is the button
Seat 1: DKNicko ($50 in chips) 
Seat 3: Pachebrash ($81.25 in chips) 
Seat 4: Corlogiro ($90.75 in chips) 
Seat 5: alexrus18 ($70.47 in chips) 
Seat 7: __PKR__JNR__ ($48.98 in chips) 
Seat 8: christyirish ($55.91 in chips) 
Seat 9: VandesandeBart ($48.55 in chips) 
alexrus18: posts small blind $0.25
__PKR__JNR__: posts big blind $0.50
MarsMiland: sits out 
*** HOLE CARDS ***
christyirish: raises $1 to $1.50
VandesandeBart: calls $1.50
DKNicko: calls $1.50
Pachebrash: folds 
Corlogiro: folds 
alexrus18: calls $1.25
__PKR__JNR__: calls $1
*** FLOP *** [9h 3h 7s]
alexrus18: checks 
__PKR__JNR__: checks 
christyirish: checks 
VandesandeBart: bets $7.12
DKNicko: folds 
alexrus18: folds 
__PKR__JNR__: folds 
christyirish: folds 
Uncalled bet ($7.12) returned to VandesandeBart
VandesandeBart collected $7.12 from pot
VandesandeBart: doesn't show hand 
*** SUMMARY ***
Total pot $7.50 | Rake $0.38 
Board [9h 3h 7s]
Seat 1: DKNicko folded on the Flop
Seat 3: Pachebrash folded before Flop (didn't bet)
Seat 4: Corlogiro (button) folded before Flop (didn't bet)
Seat 5: alexrus18 (small blind) folded on the Flop
Seat 7: __PKR__JNR__ (big blind) folded on the Flop
Seat 8: christyirish folded on the Flop
Seat 9: VandesandeBart collected ($7.12)



PokerStars Hand #228691229990:  Hold'em No Limit ($0.25/$0.50 USD) - 2021/07/30 18:07:35 ET
Table 'Galilea III' 9-max Seat #5 is the button
Seat 1: DKNicko ($48.50 in chips) 
Seat 3: Pachebrash ($81.25 in chips) 
Seat 4: Corlogiro ($90.75 in chips) 
Seat 5: alexrus18 ($68.97 in chips) 
Seat 7: __PKR__JNR__ ($47.48 in chips) 
Seat 8: christyirish ($54.41 in chips) 
Seat 9: VandesandeBart ($54.17 in chips) 
__PKR__JNR__: posts small blind $0.25
christyirish: posts big blind $0.50
MarsMiland: sits out 
*** HOLE CARDS ***
VandesandeBart: calls $0.50
DKNicko: raises $1.50 to $2
Pachebrash: folds 
Corlogiro: calls $2
alexrus18: folds 
__PKR__JNR__: folds 
christyirish: folds 
VandesandeBart: calls $1.50
*** FLOP *** [Td 2h 9h]
VandesandeBart: checks 
DKNicko: checks 
Corlogiro: bets $2.50
VandesandeBart: folds 
DKNicko: folds 
Uncalled bet ($2.50) returned to Corlogiro
Corlogiro collected $6.33 from pot
Corlogiro: doesn't show hand 
*** SUMMARY ***
Total pot $6.75 | Rake $0.42 
Board [Td 2h 9h]
Seat 1: DKNicko folded on the Flop
Seat 3: Pachebrash folded before Flop (didn't bet)
Seat 4: Corlogiro collected ($6.33)
Seat 5: alexrus18 (button) folded before Flop (didn't bet)
Seat 7: __PKR__JNR__ (small blind) folded before Flop
Seat 8: christyirish (big blind) folded before Flop
Seat 9: VandesandeBart folded on the Flop



PokerStars Hand #228691258113:  Hold'em No Limit ($0.25/$0.50 USD) - 2021/07/30 18:08:24 ET
Table 'Galilea III' 9-max Seat #7 is the button
Seat 1: DKNicko ($46.50 in chips) 
Seat 3: Pachebrash ($81.25 in chips) 
Seat 4: Corlogiro ($95.08 in chips) 
Seat 5: alexrus18 ($68.97 in chips) 
Seat 7: __PKR__JNR__ ($47.23 in chips) 
Seat 8: christyirish ($53.91 in chips) 
Seat 9: VandesandeBart ($52.17 in chips) 
christyirish: posts small blind $0.25
VandesandeBart: posts big blind $0.50
MarsMiland: sits out 
*** HOLE CARDS ***
DKNicko: raises $1.25 to $1.75
Pachebrash: folds 
Corlogiro: folds 
alexrus18: folds 
__PKR__JNR__: folds 
christyirish: folds 
VandesandeBart: raises $1.25 to $3
DKNicko: calls $1.25
*** FLOP *** [Ks 2c 9d]
VandesandeBart: bets $5.94
DKNicko: folds 
Uncalled bet ($5.94) returned to VandesandeBart
VandesandeBart collected $5.94 from pot
VandesandeBart: doesn't show hand 
*** SUMMARY ***
Total pot $6.25 | Rake $0.31 
Board [Ks 2c 9d]
Seat 1: DKNicko folded on the Flop
Seat 3: Pachebrash folded before Flop (didn't bet)
Seat 4: Corlogiro folded before Flop (didn't bet)
Seat 5: alexrus18 folded before Flop (didn't bet)
Seat 7: __PKR__JNR__ (button) folded before Flop (didn't bet)
Seat 8: christyirish (small blind) folded before Flop
Seat 9: VandesandeBart (big blind) collected ($5.94)



PokerStars Hand #228691273550:  Hold'em No Limit ($0.25/$0.50 USD) - 2021/07/30 18:09:01 ET
Table 'Galilea III' 9-max Seat #8 is the button
Seat 1: DKNicko ($43.50 in chips) 
Seat 3: Pachebrash ($81.25 in chips) 
Seat 4: Corlogiro ($95.08 in chips) 
Seat 5: alexrus18 ($68.97 in chips) 
Seat 7: __PKR__JNR__ ($47.23 in chips) 
Seat 8: christyirish ($53.66 in chips) 
Seat 9: VandesandeBart ($55.11 in chips) 
VandesandeBart: posts small blind $0.25
DKNicko: posts big blind $0.50
MarsMiland: sits out 
*** HOLE CARDS ***
Pachebrash: folds 
Corlogiro: folds 
alexrus18: folds 
__PKR__JNR__: folds 
christyirish: folds 
VandesandeBart: calls $0.25
DKNicko: checks 
*** FLOP *** [8s Js 3d]
VandesandeBart: checks 
DKNicko: bets $0.95
VandesandeBart: raises $0.95 to $1.90
DKNicko: raises $4.75 to $6.65
VandesandeBart: calls $4.75
*** TURN *** [8s Js 3d] [3c]
VandesandeBart: bets $13.58
DKNicko: folds 
Uncalled bet ($13.58) returned to VandesandeBart
VandesandeBart collected $13.58 from pot
VandesandeBart: doesn't show hand 
*** SUMMARY ***
Total pot $14.30 | Rake $0.72 
Board [8s Js 3d 3c]
Seat 1: DKNicko (big blind) folded on the Turn
Seat 3: Pachebrash folded before Flop (didn't bet)
Seat 4: Corlogiro folded before Flop (didn't bet)
Seat 5: alexrus18 folded before Flop (didn't bet)
Seat 7: __PKR__JNR__ folded before Flop (didn't bet)
Seat 8: christyirish (button) folded before Flop (didn't bet)
Seat 9: VandesandeBart (small blind) collected ($13.58)



PokerStars Hand #228691300744:  Hold'em No Limit ($0.25/$0.50 USD) - 2021/07/30 18:10:06 ET
Table 'Galilea III' 9-max Seat #9 is the button
Seat 1: DKNicko ($36.35 in chips) 
Seat 2: MarsMiland ($50 in chips) 
Seat 3: Pachebrash ($81.25 in chips) 
Seat 4: Corlogiro ($95.08 in chips) 
Seat 5: alexrus18 ($68.97 in chips) 
Seat 7: __PKR__JNR__ ($47.23 in chips) 
Seat 8: christyirish ($53.66 in chips) 
Seat 9: VandesandeBart ($61.54 in chips) 
DKNicko: posts small blind $0.25
MarsMiland: posts big blind $0.50
*** HOLE CARDS ***
Pachebrash: folds 
Corlogiro: folds 
alexrus18: folds 
__PKR__JNR__: folds 
christyirish: folds 
VandesandeBart: calls $0.50
DKNicko: folds 
MarsMiland: checks 
*** FLOP *** [2d 3d Ac]
DKNicko leaves the table
MarsMiland: checks 
VandesandeBart: bets $0.50
MarsMiland: calls $0.50
*** TURN *** [2d 3d Ac] [4d]
lonely fire joins the table at seat #1 
MarsMiland: bets $1
VandesandeBart: folds 
Uncalled bet ($1) returned to MarsMiland
MarsMiland collected $2.14 from pot
MarsMiland: doesn't show hand 
*** SUMMARY ***
Total pot $2.25 | Rake $0.11 
Board [2d 3d Ac 4d]
Seat 1: DKNicko (small blind) folded before Flop
Seat 2: MarsMiland (big blind) collected ($2.14)
Seat 3: Pachebrash folded before Flop (didn't bet)
Seat 4: Corlogiro folded before Flop (didn't bet)
Seat 5: alexrus18 folded before Flop (didn't bet)
Seat 7: __PKR__JNR__ folded before Flop (didn't bet)
Seat 8: christyirish folded before Flop (didn't bet)
Seat 9: VandesandeBart (button) folded on the Turn



PokerStars Hand #228691315628:  Hold'em No Limit ($0.25/$0.50 USD) - 2021/07/30 18:10:42 ET
Table 'Galilea III' 9-max Seat #2 is the button
Seat 2: MarsMiland ($51.14 in chips) 
Seat 3: Pachebrash ($81.25 in chips) 
Seat 4: Corlogiro ($95.08 in chips) 
Seat 5: alexrus18 ($68.97 in chips) 
Seat 7: __PKR__JNR__ ($47.23 in chips) 
Seat 8: christyirish ($53.66 in chips) 
Seat 9: VandesandeBart ($60.54 in chips) 
Pachebrash: posts small blind $0.25
Corlogiro: posts big blind $0.50
lonely fire: sits out 
*** HOLE CARDS ***
alexrus18: folds 
__PKR__JNR__: raises $1.50 to $2
christyirish: calls $2
VandesandeBart: calls $2
MarsMiland: folds 
Pachebrash: folds 
Corlogiro: folds 
*** FLOP *** [6h Qc 5c]
__PKR__JNR__: bets $3.20
christyirish: calls $3.20
VandesandeBart: calls $3.20
*** TURN *** [6h Qc 5c] [9c]
__PKR__JNR__: bets $5.76
christyirish: calls $5.76
VandesandeBart: raises $5.76 to $11.52
__PKR__JNR__: calls $5.76
christyirish: calls $5.76
*** RIVER *** [6h Qc 5c 9c] [5s]
__PKR__JNR__: checks 
christyirish: bets $36.94 and is all-in
VandesandeBart: calls $36.94
__PKR__JNR__: folds 
*** SHOW DOWN ***
christyirish: shows [6d 6c] (a full house, Sixes full of Fives)
VandesandeBart: shows [7s 8d] (a straight, Five to Nine)
christyirish collected $122.79 from pot
*** SUMMARY ***
Total pot $124.79 | Rake $2 
Board [6h Qc 5c 9c 5s]
Seat 2: MarsMiland (button) folded before Flop (didn't bet)
Seat 3: Pachebrash (small blind) folded before Flop
Seat 4: Corlogiro (big blind) folded before Flop
Seat 5: alexrus18 folded before Flop (didn't bet)
Seat 7: __PKR__JNR__ folded on the River
Seat 8: christyirish showed [6d 6c] and won ($122.79) with a full house, Sixes full of Fives
Seat 9: VandesandeBart showed [7s 8d] and lost with a straight, Five to Nine



PokerStars Hand #228691345286:  Hold'em No Limit ($0.25/$0.50 USD) - 2021/07/30 18:11:54 ET
Table 'Galilea III' 9-max Seat #3 is the button
Seat 2: MarsMiland ($51.14 in chips) 
Seat 3: Pachebrash ($81 in chips) 
Seat 4: Corlogiro ($94.58 in chips) 
Seat 5: alexrus18 ($68.97 in chips) 
Seat 7: __PKR__JNR__ ($30.51 in chips) 
Seat 8: christyirish ($122.79 in chips) 
Seat 9: VandesandeBart ($6.88 in chips) 
Corlogiro: posts small blind $0.25
alexrus18: posts big blind $0.50
lonely fire: sits out 
*** HOLE CARDS ***
__PKR__JNR__: folds 
christyirish: folds 
VandesandeBart: folds 
VandesandeBart leaves the table
MarsMiland: raises $0.75 to $1.25
lonely fire leaves the table
Pachebrash: folds 
Corlogiro: folds 
alexrus18: folds 
Uncalled bet ($0.75) returned to MarsMiland
MarsMiland collected $1.25 from pot
MarsMiland: doesn't show hand 
*** SUMMARY ***
Total pot $1.25 | Rake $0 
Seat 2: MarsMiland collected ($1.25)
Seat 3: Pachebrash (button) folded before Flop (didn't bet)
Seat 4: Corlogiro (small blind) folded before Flop
Seat 5: alexrus18 (big blind) folded before Flop
Seat 7: __PKR__JNR__ folded before Flop (didn't bet)
Seat 8: christyirish folded before Flop (didn't bet)
Seat 9: VandesandeBart folded before Flop (didn't bet)



PokerStars Hand #228691353847:  Hold'em No Limit ($0.25/$0.50 USD) - 2021/07/30 18:12:15 ET
Table 'Galilea III' 9-max Seat #4 is the button
Seat 2: MarsMiland ($51.89 in chips) 
Seat 3: Pachebrash ($81 in chips) 
Seat 4: Corlogiro ($94.33 in chips) 
Seat 5: alexrus18 ($68.47 in chips) 
Seat 7: __PKR__JNR__ ($30.51 in chips) 
Seat 8: christyirish ($122.79 in chips) 
alexrus18: posts small blind $0.25
__PKR__JNR__: posts big blind $0.50
*** HOLE CARDS ***
christyirish: raises $1 to $1.50
MarsMiland: folds 
Pachebrash: folds 
Corlogiro: folds 
alexrus18: folds 
__PKR__JNR__: folds 
Uncalled bet ($1) returned to christyirish
christyirish collected $1.25 from pot
BALAWA was removed from the table for failing to post
BALAWA leaves the table
christyirish: doesn't show hand 
*** SUMMARY ***
Total pot $1.25 | Rake $0 
Seat 2: MarsMiland folded before Flop (didn't bet)
Seat 3: Pachebrash folded before Flop (didn't bet)
Seat 4: Corlogiro (button) folded before Flop (didn't bet)
Seat 5: alexrus18 (small blind) folded before Flop
Seat 7: __PKR__JNR__ (big blind) folded before Flop
Seat 8: christyirish collected ($1.25)



PokerStars Hand #228691361171:  Hold'em No Limit ($0.25/$0.50 USD) - 2021/07/30 18:12:33 ET
Table 'Galilea III' 9-max Seat #5 is the button
Seat 2: MarsMiland ($51.89 in chips) 
Seat 3: Pachebrash ($81 in chips) 
Seat 4: Corlogiro ($94.33 in chips) 
Seat 5: alexrus18 ($68.22 in chips) 
Seat 7: __PKR__JNR__ ($30.01 in chips) 
Seat 8: christyirish ($123.54 in chips) 
__PKR__JNR__: posts small blind $0.25
christyirish: posts big blind $0.50
*** HOLE CARDS ***
MarsMiland: folds 
Pachebrash: folds 
Corlogiro: folds 
MarsMiland leaves the table
alexrus18: folds 
__PKR__JNR__: calls $0.25
christyirish: raises $0.75 to $1.25
__PKR__JNR__: calls $0.75
*** FLOP *** [Th 8h 2h]
__PKR__JNR__: checks 
christyirish: checks 
*** TURN *** [Th 8h 2h] [7s]
__PKR__JNR__: checks 
christyirish: checks 
*** RIVER *** [Th 8h 2h 7s] [6h]
__PKR__JNR__: checks 
christyirish: checks 
*** SHOW DOWN ***
__PKR__JNR__: shows [Qs 5s] (high card Queen)
christyirish: shows [Jd Ks] (high card King)
christyirish collected $2.38 from pot
*** SUMMARY ***
Total pot $2.50 | Rake $0.12 
Board [Th 8h 2h 7s 6h]
Seat 2: MarsMiland folded before Flop (didn't bet)
Seat 3: Pachebrash folded before Flop (didn't bet)
Seat 4: Corlogiro folded before Flop (didn't bet)
Seat 5: alexrus18 (button) folded before Flop (didn't bet)
Seat 7: __PKR__JNR__ (small blind) showed [Qs 5s] and lost with high card Queen
Seat 8: christyirish (big blind) showed [Jd Ks] and won ($2.38) with high card King



PokerStars Hand #228691377433:  Hold'em No Limit ($0.25/$0.50 USD) - 2021/07/30 18:13:12 ET
Table 'Galilea III' 9-max Seat #7 is the button
Seat 4: Corlogiro ($94.33 in chips) 
Seat 5: alexrus18 ($68.22 in chips) 
Seat 7: __PKR__JNR__ ($48.75 in chips) 
Seat 8: christyirish ($124.67 in chips) 
christyirish: posts small blind $0.25
Pachebrash: is sitting out 
Corlogiro: posts big blind $0.50
*** HOLE CARDS ***
alexrus18: folds 
__PKR__JNR__: folds 
christyirish: raises $1 to $1.50
Pachebrash leaves the table
Corlogiro: folds 
Uncalled bet ($1) returned to christyirish
christyirish collected $1 from pot
*** SUMMARY ***
Total pot $1 | Rake $0 
Seat 4: Corlogiro (big blind) folded before Flop
Seat 5: alexrus18 folded before Flop (didn't bet)
Seat 7: __PKR__JNR__ (button) folded before Flop (didn't bet)
Seat 8: christyirish (small blind) collected ($1)



PokerStars Hand #228691387373:  Hold'em No Limit ($0.25/$0.50 USD) - 2021/07/30 18:13:36 ET
Table 'Galilea III' 9-max Seat #8 is the button
Seat 4: Corlogiro ($93.83 in chips) 
Seat 7: __PKR__JNR__ ($48.75 in chips) 
Seat 8: christyirish ($125.17 in chips) 
Corlogiro: posts small blind $0.25
alexrus18: is sitting out 
__PKR__JNR__: posts big blind $0.50
*** HOLE CARDS ***
christyirish has timed out
christyirish: folds 
Corlogiro: folds 
Uncalled bet ($0.25) returned to __PKR__JNR__
__PKR__JNR__ collected $0.50 from pot
__PKR__JNR__: doesn't show hand 
christyirish leaves the table
*** SUMMARY ***
Total pot $0.50 | Rake $0 
Seat 4: Corlogiro (small blind) folded before Flop
Seat 7: __PKR__JNR__ (big blind) collected ($0.50)
Seat 8: christyirish (button) folded before Flop (didn't bet)



PokerStars Hand #228690283902:  Hold'em No Limit ($0.25/$0.50 USD) - 2021/07/30 17:30:44 ET
Table 'Galilea III' 9-max Seat #9 is the button
Seat 1: eltonmiranda ($41.08 in chips) 
Seat 2: Agent Cedric ($26.65 in chips) 
Seat 3: Smashdoge ($68.01 in chips) 
Seat 4: Corlogiro ($96.69 in chips) 
Seat 5: Ajs Miracle- ($27.58 in chips) 
Seat 6: BALAWA ($26.22 in chips) 
Seat 7: An1an1 ($50.20 in chips) 
Seat 8: Kolyan2114 ($50 in chips) 
Seat 9: nicu4you ($69.37 in chips) 
eltonmiranda: posts small blind $0.25
Agent Cedric: posts big blind $0.50
*** HOLE CARDS ***
Smashdoge: calls $0.50
Corlogiro: folds 
Ajs Miracle-: folds 
BALAWA has timed out
BALAWA: folds 
An1an1: folds 
Kolyan2114: folds 
nicu4you: raises $1.75 to $2.25
eltonmiranda: folds 
Agent Cedric: calls $1.75
Smashdoge: calls $1.75
*** FLOP *** [4s Jd 8h]
Agent Cedric: checks 
Smashdoge: checks 
nicu4you: checks 
*** TURN *** [4s Jd 8h] [4h]
Agent Cedric: bets $3.32
Smashdoge: folds 
nicu4you: folds 
Uncalled bet ($3.32) returned to Agent Cedric
Agent Cedric collected $6.65 from pot
Agent Cedric: doesn't show hand 
*** SUMMARY ***
Total pot $7 | Rake $0.35 
Board [4s Jd 8h 4h]
Seat 1: eltonmiranda (small blind) folded before Flop
Seat 2: Agent Cedric (big blind) collected ($6.65)
Seat 3: Smashdoge folded on the Turn
Seat 4: Corlogiro folded before Flop (didn't bet)
Seat 5: Ajs Miracle- folded before Flop (didn't bet)
Seat 6: BALAWA folded before Flop (didn't bet)
Seat 7: An1an1 folded before Flop (didn't bet)
Seat 8: Kolyan2114 folded before Flop (didn't bet)
Seat 9: nicu4you (button) folded on the Turn



PokerStars Hand #228690313006:  Hold'em No Limit ($0.25/$0.50 USD) - 2021/07/30 17:31:48 ET
Table 'Galilea III' 9-max Seat #1 is the button
Seat 1: eltonmiranda ($40.83 in chips) 
Seat 2: Agent Cedric ($31.05 in chips) 
Seat 3: Smashdoge ($65.76 in chips) 
Seat 4: Corlogiro ($96.69 in chips) 
Seat 5: Ajs Miracle- ($27.58 in chips) 
Seat 6: BALAWA ($26.22 in chips) 
Seat 7: An1an1 ($50.20 in chips) 
Seat 8: Kolyan2114 ($50 in chips) 
Seat 9: nicu4you ($67.12 in chips) 
Agent Cedric: posts small blind $0.25
Smashdoge: posts big blind $0.50
*** HOLE CARDS ***
Corlogiro: folds 
Ajs Miracle-: folds 
BALAWA: raises $0.50 to $1
An1an1: folds 
Kolyan2114: folds 
nicu4you: folds 
eltonmiranda: calls $1
Agent Cedric: folds 
Smashdoge: calls $0.50
*** FLOP *** [7d Qs Ah]
Smashdoge: bets $7.50
BALAWA: calls $7.50
eltonmiranda: folds 
*** TURN *** [7d Qs Ah] [Th]
Smashdoge: bets $14
BALAWA: raises $3.72 to $17.72 and is all-in
Smashdoge: calls $3.72
*** RIVER *** [7d Qs Ah Th] [6s]
*** SHOW DOWN ***
Smashdoge: shows [Td Jd] (a pair of Tens)
BALAWA: shows [8d As] (a pair of Aces)
BALAWA collected $51.69 from pot
*** SUMMARY ***
Total pot $53.69 | Rake $2 
Board [7d Qs Ah Th 6s]
Seat 1: eltonmiranda (button) folded on the Flop
Seat 2: Agent Cedric (small blind) folded before Flop
Seat 3: Smashdoge (big blind) showed [Td Jd] and lost with a pair of Tens
Seat 4: Corlogiro folded before Flop (didn't bet)
Seat 5: Ajs Miracle- folded before Flop (didn't bet)
Seat 6: BALAWA showed [8d As] and won ($51.69) with a pair of Aces
Seat 7: An1an1 folded before Flop (didn't bet)
Seat 8: Kolyan2114 folded before Flop (didn't bet)
Seat 9: nicu4you folded before Flop (didn't bet)



PokerStars Hand #228690364174:  Hold'em No Limit ($0.25/$0.50 USD) - 2021/07/30 17:33:41 ET
Table 'Galilea III' 9-max Seat #4 is the button
Seat 2: Agent Cedric ($30.80 in chips) 
Seat 4: Corlogiro ($96.19 in chips) 
Seat 5: Ajs Miracle- ($22.33 in chips) 
Seat 6: BALAWA ($94.98 in chips) 
Seat 7: An1an1 ($50.20 in chips) 
Seat 8: Kolyan2114 ($50 in chips) 
Seat 9: nicu4you ($67.12 in chips) 
Ajs Miracle-: posts small blind $0.25
BALAWA: posts big blind $0.50
*** HOLE CARDS ***
An1an1: folds 
Kolyan2114: folds 
nicu4you: folds 
Smashdoge leaves the table
Agent Cedric: raises $0.50 to $1
Corlogiro: folds 
Ajs Miracle-: calls $0.75
BALAWA: calls $0.50
*** FLOP *** [Qh 7c Kd]
Ajs Miracle-: checks 
BALAWA: checks 
Agent Cedric: bets $1.42
Ajs Miracle-: calls $1.42
BALAWA: folds 
*** TURN *** [Qh 7c Kd] [Jd]
Nestle170 joins the table at seat #1 
Ajs Miracle-: checks 
Agent Cedric: bets $2.77
Ajs Miracle-: folds 
Uncalled bet ($2.77) returned to Agent Cedric
Agent Cedric collected $5.55 from pot
Agent Cedric: doesn't show hand 
*** SUMMARY ***
Total pot $5.84 | Rake $0.29 
Board [Qh 7c Kd Jd]
Seat 2: Agent Cedric collected ($5.55)
Seat 4: Corlogiro (button) folded before Flop (didn't bet)
Seat 5: Ajs Miracle- (small blind) folded on the Turn
Seat 6: BALAWA (big blind) folded on the Flop
Seat 7: An1an1 folded before Flop (didn't bet)
Seat 8: Kolyan2114 folded before Flop (didn't bet)
Seat 9: nicu4you folded before Flop (didn't bet)



PokerStars Hand #228690387547:  Hold'em No Limit ($0.25/$0.50 USD) - 2021/07/30 17:34:33 ET
Table 'Galilea III' 9-max Seat #5 is the button
Seat 2: Agent Cedric ($33.93 in chips) 
Seat 4: Corlogiro ($96.19 in chips) 
Seat 5: Ajs Miracle- ($19.91 in chips) 
Seat 6: BALAWA ($93.98 in chips) 
Seat 8: Kolyan2114 ($50 in chips) 
Seat 9: nicu4you ($67.12 in chips) 
BALAWA: posts small blind $0.25
An1an1: is sitting out 
Kolyan2114: posts big blind $0.50
Nestle170: sits out 
*** HOLE CARDS ***
nicu4you: folds 
An1an1 leaves the table
Pachebrash joins the table at seat #3 
Agent Cedric: folds 
MonplDCmax joins the table at seat #7 
Corlogiro: raises $0.75 to $1.25
Ajs Miracle-: folds 
BALAWA: calls $1
Kolyan2114: folds 
*** FLOP *** [Kh 3s 7d]
BALAWA: checks 
Corlogiro: checks 
*** TURN *** [Kh 3s 7d] [3d]
BALAWA: checks 
Corlogiro: checks 
*** RIVER *** [Kh 3s 7d 3d] [Js]
BALAWA: checks 
Corlogiro: checks 
*** SHOW DOWN ***
BALAWA: shows [9d Th] (a pair of Threes)
Corlogiro: shows [Td Ah] (a pair of Threes - Ace kicker)
Corlogiro collected $2.81 from pot
*** SUMMARY ***
Total pot $3 | Rake $0.19 
Board [Kh 3s 7d 3d Js]
Seat 2: Agent Cedric folded before Flop (didn't bet)
Seat 4: Corlogiro showed [Td Ah] and won ($2.81) with a pair of Threes
Seat 5: Ajs Miracle- (button) folded before Flop (didn't bet)
Seat 6: BALAWA (small blind) showed [9d Th] and lost with a pair of Threes
Seat 8: Kolyan2114 (big blind) folded before Flop
Seat 9: nicu4you folded before Flop (didn't bet)



PokerStars Hand #228690414638:  Hold'em No Limit ($0.25/$0.50 USD) - 2021/07/30 17:35:33 ET
Table 'Galilea III' 9-max Seat #6 is the button
Seat 2: Agent Cedric ($33.93 in chips) 
Seat 4: Corlogiro ($97.75 in chips) 
Seat 5: Ajs Miracle- ($19.91 in chips) 
Seat 6: BALAWA ($92.73 in chips) 
Seat 8: Kolyan2114 ($50 in chips) 
Seat 9: nicu4you ($67.12 in chips) 
Kolyan2114: posts small blind $0.25
nicu4you: posts big blind $0.50
Nestle170: sits out 
Pachebrash: sits out 
*** HOLE CARDS ***
Agent Cedric: folds 
Corlogiro: folds 
Ajs Miracle-: folds 
BALAWA: folds 
Kolyan2114: raises $1 to $1.50
nicu4you: folds 
Uncalled bet ($1) returned to Kolyan2114
Kolyan2114 collected $1 from pot
*** SUMMARY ***
Total pot $1 | Rake $0 
Seat 2: Agent Cedric folded before Flop (didn't bet)
Seat 4: Corlogiro folded before Flop (didn't bet)
Seat 5: Ajs Miracle- folded before Flop (didn't bet)
Seat 6: BALAWA (button) folded before Flop (didn't bet)
Seat 8: Kolyan2114 (small blind) collected ($1)
Seat 9: nicu4you (big blind) folded before Flop



PokerStars Hand #228690427300:  Hold'em No Limit ($0.25/$0.50 USD) - 2021/07/30 17:36:01 ET
Table 'Galilea III' 9-max Seat #8 is the button
Seat 1: Nestle170 ($65.96 in chips) 
Seat 2: Agent Cedric ($33.93 in chips) 
Seat 4: Corlogiro ($97.75 in chips) 
Seat 5: Ajs Miracle- ($19.91 in chips) 
Seat 6: BALAWA ($92.73 in chips) 
Seat 8: Kolyan2114 ($50.50 in chips) 
Seat 9: nicu4you ($66.62 in chips) 
nicu4you: posts small blind $0.25
Nestle170: posts big blind $0.50
Pachebrash: sits out 
MonplDCmax: sits out 
*** HOLE CARDS ***
Agent Cedric: folds 
Corlogiro: folds 
Ajs Miracle-: folds 
BALAWA: folds 
Kolyan2114: raises $0.75 to $1.25
nicu4you: folds 
Nestle170: folds 
Uncalled bet ($0.75) returned to Kolyan2114
Kolyan2114 collected $1.25 from pot
*** SUMMARY ***
Total pot $1.25 | Rake $0 
Seat 1: Nestle170 (big blind) folded before Flop
Seat 2: Agent Cedric folded before Flop (didn't bet)
Seat 4: Corlogiro folded before Flop (didn't bet)
Seat 5: Ajs Miracle- folded before Flop (didn't bet)
Seat 6: BALAWA folded before Flop (didn't bet)
Seat 8: Kolyan2114 (button) collected ($1.25)
Seat 9: nicu4you (small blind) folded before Flop



PokerStars Hand #228690433839:  Hold'em No Limit ($0.25/$0.50 USD) - 2021/07/30 17:36:16 ET
Table 'Galilea III' 9-max Seat #9 is the button
Seat 1: Nestle170 ($65.46 in chips) 
Seat 2: Agent Cedric ($33.93 in chips) 
Seat 4: Corlogiro ($97.75 in chips) 
Seat 5: Ajs Miracle- ($19.91 in chips) 
Seat 6: BALAWA ($92.73 in chips) 
Seat 8: Kolyan2114 ($51.25 in chips) 
Seat 9: nicu4you ($66.37 in chips) 
Nestle170: posts small blind $0.25
Agent Cedric: posts big blind $0.50
Pachebrash: sits out 
MonplDCmax: sits out 
*** HOLE CARDS ***
Corlogiro: folds 
Ajs Miracle-: raises $1 to $1.50
BALAWA: raises $3.75 to $5.25
Kolyan2114: folds 
nicu4you: folds 
Nestle170: folds 
Agent Cedric: folds 
Ajs Miracle-: calls $3.75
*** FLOP *** [7s 4c 5d]
Ajs Miracle-: checks 
BALAWA: bets $10.69
Ajs Miracle-: raises $3.97 to $14.66 and is all-in
BALAWA: calls $3.97
*** TURN *** [7s 4c 5d] [4d]
*** RIVER *** [7s 4c 5d 4d] [Js]
*** SHOW DOWN ***
Ajs Miracle-: shows [2c 6c] (a pair of Fours)
BALAWA: shows [Kh Ah] (a pair of Fours - Ace kicker)
BALAWA collected $38.57 from pot
*** SUMMARY ***
Total pot $40.57 | Rake $2 
Board [7s 4c 5d 4d Js]
Seat 1: Nestle170 (small blind) folded before Flop
Seat 2: Agent Cedric (big blind) folded before Flop
Seat 4: Corlogiro folded before Flop (didn't bet)
Seat 5: Ajs Miracle- showed [2c 6c] and lost with a pair of Fours
Seat 6: BALAWA showed [Kh Ah] and won ($38.57) with a pair of Fours
Seat 8: Kolyan2114 folded before Flop (didn't bet)
Seat 9: nicu4you (button) folded before Flop (didn't bet)



PokerStars Hand #228690450482:  Hold'em No Limit ($0.25/$0.50 USD) - 2021/07/30 17:36:53 ET
Table 'Galilea III' 9-max Seat #1 is the button
Seat 1: Nestle170 ($65.21 in chips) 
Seat 2: Agent Cedric ($33.43 in chips) 
Seat 3: Pachebrash ($50 in chips) 
Seat 4: Corlogiro ($97.75 in chips) 
Seat 6: BALAWA ($111.39 in chips) 
Seat 8: Kolyan2114 ($51.25 in chips) 
Seat 9: nicu4you ($66.37 in chips) 
Agent Cedric: posts small blind $0.25
Pachebrash: posts big blind $0.50
*** HOLE CARDS ***
Corlogiro: raises $0.75 to $1.25
BALAWA: calls $1.25
Ajs Miracle- leaves the table
Kolyan2114: folds 
nicu4you: folds 
Nestle170: folds 
Agent Cedric: calls $1
Pachebrash: calls $0.75
*** FLOP *** [4c 7c Kh]
Agent Cedric: checks 
Pachebrash: checks 
Corlogiro: checks 
BALAWA: bets $2.37
grafFIN7 joins the table at seat #5 
Agent Cedric: calls $2.37
Pachebrash: raises $5.38 to $7.75
Kolyan2114 leaves the table
christyirish joins the table at seat #8 
Corlogiro: folds 
BALAWA: folds 
Agent Cedric: raises $24.43 to $32.18 and is all-in
Pachebrash: calls $24.43
*** TURN *** [4c 7c Kh] [8s]
*** RIVER *** [4c 7c Kh 8s] [Td]
*** SHOW DOWN ***
Agent Cedric: shows [7s Ks] (two pair, Kings and Sevens)
Pachebrash: shows [4h 4d] (three of a kind, Fours)
Pachebrash collected $69.73 from pot
*** SUMMARY ***
Total pot $71.73 | Rake $2 
Board [4c 7c Kh 8s Td]
Seat 1: Nestle170 (button) folded before Flop (didn't bet)
Seat 2: Agent Cedric (small blind) showed [7s Ks] and lost with two pair, Kings and Sevens
Seat 3: Pachebrash (big blind) showed [4h 4d] and won ($69.73) with three of a kind, Fours
Seat 4: Corlogiro folded on the Flop
Seat 6: BALAWA folded on the Flop
Seat 8: Kolyan2114 folded before Flop (didn't bet)
Seat 9: nicu4you folded before Flop (didn't bet)



PokerStars Hand #228690482829:  Hold'em No Limit ($0.25/$0.50 USD) - 2021/07/30 17:37:59 ET
Table 'Galilea III' 9-max Seat #3 is the button
Seat 1: Nestle170 ($65.21 in chips) 
Seat 3: Pachebrash ($86.30 in chips) 
Seat 4: Corlogiro ($96.50 in chips) 
Seat 5: grafFIN7 ($49.78 in chips) 
Seat 6: BALAWA ($107.77 in chips) 
Seat 8: christyirish ($50 in chips) 
Seat 9: nicu4you ($66.37 in chips) 
Corlogiro: posts small blind $0.25
grafFIN7: posts big blind $0.50
MonplDCmax: sits out 
christyirish: posts big blind $0.50
*** HOLE CARDS ***
BALAWA: folds 
christyirish: checks 
nicu4you: folds 
Agent Cedric leaves the table
MonplDCmax leaves the table
Nestle170: raises $1.50 to $2
Pachebrash: folds 
Corlogiro: folds 
grafFIN7: folds 
christyirish: folds 
Uncalled bet ($1.50) returned to Nestle170
Nestle170 collected $1.75 from pot
Nestle170: doesn't show hand 
*** SUMMARY ***
Total pot $1.75 | Rake $0 
Seat 1: Nestle170 collected ($1.75)
Seat 3: Pachebrash (button) folded before Flop (didn't bet)
Seat 4: Corlogiro (small blind) folded before Flop
Seat 5: grafFIN7 (big blind) folded before Flop
Seat 6: BALAWA folded before Flop (didn't bet)
Seat 8: christyirish folded before Flop (didn't bet)
Seat 9: nicu4you folded before Flop (didn't bet)



PokerStars Hand #228690489894:  Hold'em No Limit ($0.25/$0.50 USD) - 2021/07/30 17:38:15 ET
Table 'Galilea III' 9-max Seat #4 is the button
Seat 1: Nestle170 ($66.46 in chips) 
Seat 3: Pachebrash ($86.30 in chips) 
Seat 4: Corlogiro ($96.25 in chips) 
Seat 5: grafFIN7 ($49.28 in chips) 
Seat 6: BALAWA ($107.77 in chips) 
Seat 8: christyirish ($50 in chips) 
Seat 9: nicu4you ($66.37 in chips) 
grafFIN7: posts small blind $0.25
BALAWA: posts big blind $0.50
*** HOLE CARDS ***
christyirish: folds 
nicu4you: folds 
Nestle170: folds 
Pachebrash: folds 
Corlogiro: folds 
goldenpig666 joins the table at seat #7 
grafFIN7: raises $0.50 to $1
BALAWA: calls $0.50
*** FLOP *** [7s Qd Jd]
grafFIN7: checks 
BALAWA: checks 
*** TURN *** [7s Qd Jd] [6d]
grafFIN7: bets $0.50
BALAWA: calls $0.50
*** RIVER *** [7s Qd Jd 6d] [Jc]
grafFIN7: checks 
BALAWA: bets $2.85
grafFIN7: folds 
Uncalled bet ($2.85) returned to BALAWA
BALAWA collected $2.85 from pot
BALAWA: doesn't show hand 
*** SUMMARY ***
Total pot $3 | Rake $0.15 
Board [7s Qd Jd 6d Jc]
Seat 1: Nestle170 folded before Flop (didn't bet)
Seat 3: Pachebrash folded before Flop (didn't bet)
Seat 4: Corlogiro (button) folded before Flop (didn't bet)
Seat 5: grafFIN7 (small blind) folded on the River
Seat 6: BALAWA (big blind) collected ($2.85)
Seat 8: christyirish folded before Flop (didn't bet)
Seat 9: nicu4you folded before Flop (didn't bet)



PokerStars Hand #228690505492:  Hold'em No Limit ($0.25/$0.50 USD) - 2021/07/30 17:38:50 ET
Table 'Galilea III' 9-max Seat #5 is the button
Seat 1: Nestle170 ($66.46 in chips) 
Seat 3: Pachebrash ($86.30 in chips) 
Seat 4: Corlogiro ($96.25 in chips) 
Seat 5: grafFIN7 ($47.78 in chips) 
Seat 6: BALAWA ($109.12 in chips) 
Seat 7: goldenpig666 ($50 in chips) 
Seat 8: christyirish ($50 in chips) 
Seat 9: nicu4you ($66.37 in chips) 
BALAWA: posts small blind $0.25
goldenpig666: posts big blind $0.50
*** HOLE CARDS ***
christyirish: folds 
nicu4you: folds 
Nestle170: folds 
Pachebrash: folds 
Corlogiro: folds 
grafFIN7: folds 
BALAWA: folds 
Uncalled bet ($0.25) returned to goldenpig666
goldenpig666 collected $0.50 from pot
goldenpig666: doesn't show hand 
*** SUMMARY ***
Total pot $0.50 | Rake $0 
Seat 1: Nestle170 folded before Flop (didn't bet)
Seat 3: Pachebrash folded before Flop (didn't bet)
Seat 4: Corlogiro folded before Flop (didn't bet)
Seat 5: grafFIN7 (button) folded before Flop (didn't bet)
Seat 6: BALAWA (small blind) folded before Flop
Seat 7: goldenpig666 (big blind) collected ($0.50)
Seat 8: christyirish folded before Flop (didn't bet)
Seat 9: nicu4you folded before Flop (didn't bet)



PokerStars Hand #228690509199:  Hold'em No Limit ($0.25/$0.50 USD) - 2021/07/30 17:38:59 ET
Table 'Galilea III' 9-max Seat #6 is the button
Seat 1: Nestle170 ($66.46 in chips) 
Seat 3: Pachebrash ($86.30 in chips) 
Seat 4: Corlogiro ($96.25 in chips) 
Seat 5: grafFIN7 ($47.78 in chips) 
Seat 6: BALAWA ($108.87 in chips) 
Seat 7: goldenpig666 ($50.25 in chips) 
Seat 8: christyirish ($50 in chips) 
Seat 9: nicu4you ($66.37 in chips) 
goldenpig666: posts small blind $0.25
christyirish: posts big blind $0.50
*** HOLE CARDS ***
nicu4you: folds 
Nestle170: folds 
Pachebrash: folds 
Corlogiro: folds 
grafFIN7: folds 
StudentRB joins the table at seat #2 
BALAWA has timed out
BALAWA: folds 
goldenpig666: folds 
Uncalled bet ($0.25) returned to christyirish
christyirish collected $0.50 from pot
*** SUMMARY ***
Total pot $0.50 | Rake $0 
Seat 1: Nestle170 folded before Flop (didn't bet)
Seat 3: Pachebrash folded before Flop (didn't bet)
Seat 4: Corlogiro folded before Flop (didn't bet)
Seat 5: grafFIN7 folded before Flop (didn't bet)
Seat 6: BALAWA (button) folded before Flop (didn't bet)
Seat 7: goldenpig666 (small blind) folded before Flop
Seat 8: christyirish (big blind) collected ($0.50)
Seat 9: nicu4you folded before Flop (didn't bet)



PokerStars Hand #228690517494:  Hold'em No Limit ($0.25/$0.50 USD) - 2021/07/30 17:39:18 ET
Table 'Galilea III' 9-max Seat #7 is the button
Seat 1: Nestle170 ($66.46 in chips) 
Seat 3: Pachebrash ($86.30 in chips) 
Seat 4: Corlogiro ($96.25 in chips) 
Seat 5: grafFIN7 ($47.78 in chips) 
Seat 7: goldenpig666 ($50 in chips) 
Seat 8: christyirish ($50.25 in chips) 
Seat 9: nicu4you ($66.37 in chips) 
christyirish: posts small blind $0.25
nicu4you: posts big blind $0.50
StudentRB: sits out 
*** HOLE CARDS ***
Nestle170: folds 
Pachebrash: folds 
Corlogiro: folds 
grafFIN7: folds 
goldenpig666: raises $0.75 to $1.25
christyirish: folds 
nicu4you: folds 
Uncalled bet ($0.75) returned to goldenpig666
goldenpig666 collected $1.25 from pot
goldenpig666: doesn't show hand 
*** SUMMARY ***
Total pot $1.25 | Rake $0 
Seat 1: Nestle170 folded before Flop (didn't bet)
Seat 3: Pachebrash folded before Flop (didn't bet)
Seat 4: Corlogiro folded before Flop (didn't bet)
Seat 5: grafFIN7 folded before Flop (didn't bet)
Seat 7: goldenpig666 (button) collected ($1.25)
Seat 8: christyirish (small blind) folded before Flop
Seat 9: nicu4you (big blind) folded before Flop



PokerStars Hand #228690523022:  Hold'em No Limit ($0.25/$0.50 USD) - 2021/07/30 17:39:30 ET
Table 'Galilea III' 9-max Seat #8 is the button
Seat 1: Nestle170 ($66.46 in chips) 
Seat 3: Pachebrash ($86.30 in chips) 
Seat 4: Corlogiro ($96.25 in chips) 
Seat 5: grafFIN7 ($47.78 in chips) 
Seat 6: BALAWA ($108.87 in chips) 
Seat 7: goldenpig666 ($50.75 in chips) 
Seat 8: christyirish ($50 in chips) 
Seat 9: nicu4you ($65.87 in chips) 
nicu4you: posts small blind $0.25
Nestle170: posts big blind $0.50
StudentRB: sits out 
*** HOLE CARDS ***
Pachebrash: raises $1 to $1.50
Corlogiro: folds 
grafFIN7: folds 
BALAWA: folds 
goldenpig666: raises $3 to $4.50
christyirish: folds 
nicu4you: folds 
Nestle170: folds 
Pachebrash: folds 
Uncalled bet ($3) returned to goldenpig666
goldenpig666 collected $3.75 from pot
goldenpig666: doesn't show hand 
*** SUMMARY ***
Total pot $3.75 | Rake $0 
Seat 1: Nestle170 (big blind) folded before Flop
Seat 3: Pachebrash folded before Flop
Seat 4: Corlogiro folded before Flop (didn't bet)
Seat 5: grafFIN7 folded before Flop (didn't bet)
Seat 6: BALAWA folded before Flop (didn't bet)
Seat 7: goldenpig666 collected ($3.75)
Seat 8: christyirish (button) folded before Flop (didn't bet)
Seat 9: nicu4you (small blind) folded before Flop



PokerStars Hand #228690538729:  Hold'em No Limit ($0.25/$0.50 USD) - 2021/07/30 17:40:06 ET
Table 'Galilea III' 9-max Seat #9 is the button
Seat 1: Nestle170 ($65.96 in chips) 
Seat 2: StudentRB ($50 in chips) 
Seat 3: Pachebrash ($84.80 in chips) 
Seat 4: Corlogiro ($96.25 in chips) 
Seat 5: grafFIN7 ($47.78 in chips) 
Seat 6: BALAWA ($108.87 in chips) 
Seat 7: goldenpig666 ($53 in chips) 
Seat 8: christyirish ($50 in chips) 
Seat 9: nicu4you ($65.62 in chips) 
Nestle170: posts small blind $0.25
StudentRB: posts big blind $0.50
*** HOLE CARDS ***
Pachebrash: folds 
Corlogiro: folds 
grafFIN7: folds 
BALAWA: folds 
goldenpig666: folds 
christyirish: folds 
nicu4you: raises $0.75 to $1.25
Nestle170: folds 
StudentRB: folds 
Uncalled bet ($0.75) returned to nicu4you
nicu4you collected $1.25 from pot
nicu4you: doesn't show hand 
*** SUMMARY ***
Total pot $1.25 | Rake $0 
Seat 1: Nestle170 (small blind) folded before Flop
Seat 2: StudentRB (big blind) folded before Flop
Seat 3: Pachebrash folded before Flop (didn't bet)
Seat 4: Corlogiro folded before Flop (didn't bet)
Seat 5: grafFIN7 folded before Flop (didn't bet)
Seat 6: BALAWA folded before Flop (didn't bet)
Seat 7: goldenpig666 folded before Flop (didn't bet)
Seat 8: christyirish folded before Flop (didn't bet)
Seat 9: nicu4you (button) collected ($1.25)



PokerStars Hand #228690548736:  Hold'em No Limit ($0.25/$0.50 USD) - 2021/07/30 17:40:28 ET
Table 'Galilea III' 9-max Seat #1 is the button
Seat 1: Nestle170 ($65.71 in chips) 
Seat 2: StudentRB ($50 in chips) 
Seat 3: Pachebrash ($84.80 in chips) 
Seat 4: Corlogiro ($96.25 in chips) 
Seat 5: grafFIN7 ($47.78 in chips) 
Seat 6: BALAWA ($108.87 in chips) 
Seat 7: goldenpig666 ($53 in chips) 
Seat 8: christyirish ($50 in chips) 
Seat 9: nicu4you ($66.37 in chips) 
StudentRB: posts small blind $0.25
Pachebrash: posts big blind $0.50
*** HOLE CARDS ***
Corlogiro: folds 
grafFIN7: folds 
BALAWA: raises $1 to $1.50
goldenpig666: folds 
christyirish: folds 
nicu4you: calls $1.50
Nestle170: folds 
StudentRB: folds 
Pachebrash: folds 
*** FLOP *** [5s 5c 3s]
BALAWA: bets $1.78
nicu4you: folds 
Uncalled bet ($1.78) returned to BALAWA
BALAWA collected $3.56 from pot
BALAWA: doesn't show hand 
*** SUMMARY ***
Total pot $3.75 | Rake $0.19 
Board [5s 5c 3s]
Seat 1: Nestle170 (button) folded before Flop (didn't bet)
Seat 2: StudentRB (small blind) folded before Flop
Seat 3: Pachebrash (big blind) folded before Flop
Seat 4: Corlogiro folded before Flop (didn't bet)
Seat 5: grafFIN7 folded before Flop (didn't bet)
Seat 6: BALAWA collected ($3.56)
Seat 7: goldenpig666 folded before Flop (didn't bet)
Seat 8: christyirish folded before Flop (didn't bet)
Seat 9: nicu4you folded on the Flop



PokerStars Hand #228688587613:  Hold'em No Limit ($0.25/$0.50 USD) - 2021/07/30 16:30:32 ET
Table 'Galilea III' 9-max Seat #1 is the button
Seat 1: Xamil666 ($95.59 in chips) 
Seat 2: v.sting ($104.40 in chips) 
Seat 3: akbloger ($59.55 in chips) 
Seat 4: $lavik88 ($83.85 in chips) 
Seat 6: Nestle170 ($50 in chips) 
Seat 7: danthaur ($51.71 in chips) 
Seat 8: m11k1989 ($71.62 in chips) 
Seat 9: holdemamn ($53 in chips) 
v.sting: posts small blind $0.25
akbloger: posts big blind $0.50
PleBeY95: sits out 
*** HOLE CARDS ***
$lavik88: folds 
Nestle170: folds 
danthaur: folds 
m11k1989: calls $0.50
holdemamn: folds 
Xamil666: folds 
v.sting: raises $2.50 to $3
akbloger: folds 
m11k1989: folds 
Uncalled bet ($2.50) returned to v.sting
v.sting collected $1.50 from pot
v.sting: doesn't show hand 
*** SUMMARY ***
Total pot $1.50 | Rake $0 
Seat 1: Xamil666 (button) folded before Flop (didn't bet)
Seat 2: v.sting (small blind) collected ($1.50)
Seat 3: akbloger (big blind) folded before Flop
Seat 4: $lavik88 folded before Flop (didn't bet)
Seat 6: Nestle170 folded before Flop (didn't bet)
Seat 7: danthaur folded before Flop (didn't bet)
Seat 8: m11k1989 folded before Flop
Seat 9: holdemamn folded before Flop (didn't bet)



PokerStars Hand #228688602912:  Hold'em No Limit ($0.25/$0.50 USD) - 2021/07/30 16:31:04 ET
Table 'Galilea III' 9-max Seat #2 is the button
Seat 1: Xamil666 ($95.59 in chips) 
Seat 2: v.sting ($105.40 in chips) 
Seat 3: akbloger ($59.05 in chips) 
Seat 4: $lavik88 ($83.85 in chips) 
Seat 6: Nestle170 ($50 in chips) 
Seat 7: danthaur ($51.71 in chips) 
Seat 8: m11k1989 ($71.12 in chips) 
Seat 9: holdemamn ($53 in chips) 
akbloger: posts small blind $0.25
$lavik88: posts big blind $0.50
PleBeY95: sits out 
*** HOLE CARDS ***
Nestle170: raises $1 to $1.50
danthaur: folds 
m11k1989: folds 
holdemamn: raises $3 to $4.50
Xamil666: folds 
v.sting: folds 
akbloger: folds 
$lavik88: folds 
Nestle170: folds 
Uncalled bet ($3) returned to holdemamn
holdemamn collected $3.75 from pot
holdemamn: doesn't show hand 
*** SUMMARY ***
Total pot $3.75 | Rake $0 
Seat 1: Xamil666 folded before Flop (didn't bet)
Seat 2: v.sting (button) folded before Flop (didn't bet)
Seat 3: akbloger (small blind) folded before Flop
Seat 4: $lavik88 (big blind) folded before Flop
Seat 6: Nestle170 folded before Flop
Seat 7: danthaur folded before Flop (didn't bet)
Seat 8: m11k1989 folded before Flop (didn't bet)
Seat 9: holdemamn collected ($3.75)



PokerStars Hand #228688617381:  Hold'em No Limit ($0.25/$0.50 USD) - 2021/07/30 16:31:33 ET
Table 'Galilea III' 9-max Seat #3 is the button
Seat 1: Xamil666 ($95.59 in chips) 
Seat 2: v.sting ($105.40 in chips) 
Seat 3: akbloger ($58.80 in chips) 
Seat 4: $lavik88 ($83.35 in chips) 
Seat 5: PleBeY95 ($60.89 in chips) 
Seat 6: Nestle170 ($50 in chips) 
Seat 7: danthaur ($51.71 in chips) 
Seat 8: m11k1989 ($71.12 in chips) 
Seat 9: holdemamn ($55.25 in chips) 
$lavik88: posts small blind $0.25
PleBeY95: posts big blind $0.50
*** HOLE CARDS ***
Nestle170: folds 
danthaur: folds 
m11k1989: folds 
holdemamn: folds 
Xamil666: folds 
v.sting: folds 
akbloger: folds 
$lavik88: raises $1 to $1.50
PleBeY95: folds 
Uncalled bet ($1) returned to $lavik88
$lavik88 collected $1 from pot
$lavik88: doesn't show hand 
*** SUMMARY ***
Total pot $1 | Rake $0 
Seat 1: Xamil666 folded before Flop (didn't bet)
Seat 2: v.sting folded before Flop (didn't bet)
Seat 3: akbloger (button) folded before Flop (didn't bet)
Seat 4: $lavik88 (small blind) collected ($1)
Seat 5: PleBeY95 (big blind) folded before Flop
Seat 6: Nestle170 folded before Flop (didn't bet)
Seat 7: danthaur folded before Flop (didn't bet)
Seat 8: m11k1989 folded before Flop (didn't bet)
Seat 9: holdemamn folded before Flop (didn't bet)



PokerStars Hand #228688623882:  Hold'em No Limit ($0.25/$0.50 USD) - 2021/07/30 16:31:47 ET
Table 'Galilea III' 9-max Seat #4 is the button
Seat 1: Xamil666 ($95.59 in chips) 
Seat 2: v.sting ($105.40 in chips) 
Seat 3: akbloger ($58.80 in chips) 
Seat 4: $lavik88 ($83.85 in chips) 
Seat 5: PleBeY95 ($60.39 in chips) 
Seat 6: Nestle170 ($50 in chips) 
Seat 7: danthaur ($51.71 in chips) 
Seat 8: m11k1989 ($71.12 in chips) 
Seat 9: holdemamn ($55.25 in chips) 
PleBeY95: posts small blind $0.25
Nestle170: posts big blind $0.50
*** HOLE CARDS ***
danthaur: folds 
m11k1989: calls $0.50
holdemamn: raises $1.50 to $2
Xamil666: folds 
v.sting: folds 
akbloger: folds 
$lavik88: folds 
PleBeY95: folds 
Nestle170: folds 
m11k1989: calls $1.50
*** FLOP *** [9h 5c 4h]
m11k1989: checks 
holdemamn: bets $1.50
m11k1989: calls $1.50
*** TURN *** [9h 5c 4h] [Td]
m11k1989: bets $1.50
holdemamn: calls $1.50
*** RIVER *** [9h 5c 4h Td] [4s]
m11k1989: bets $3
holdemamn: folds 
Uncalled bet ($3) returned to m11k1989
m11k1989 collected $10.21 from pot
m11k1989: doesn't show hand 
*** SUMMARY ***
Total pot $10.75 | Rake $0.54 
Board [9h 5c 4h Td 4s]
Seat 1: Xamil666 folded before Flop (didn't bet)
Seat 2: v.sting folded before Flop (didn't bet)
Seat 3: akbloger folded before Flop (didn't bet)
Seat 4: $lavik88 (button) folded before Flop (didn't bet)
Seat 5: PleBeY95 (small blind) folded before Flop
Seat 6: Nestle170 (big blind) folded before Flop
Seat 7: danthaur folded before Flop (didn't bet)
Seat 8: m11k1989 collected ($10.21)
Seat 9: holdemamn folded on the River



PokerStars Hand #228688826009:  Hold'em No Limit ($0.25/$0.50 USD) - 2021/07/30 16:38:44 ET
Table 'Galilea III' 9-max Seat #5 is the button
Seat 2: v.sting ($108.15 in chips) 
Seat 3: akbloger ($58.05 in chips) 
Seat 4: $lavik88 ($88.66 in chips) 
Seat 5: PleBeY95 ($59.39 in chips) 
Seat 6: Nestle170 ($50 in chips) 
Seat 7: danthaur ($52.36 in chips) 
Seat 8: m11k1989 ($71.35 in chips) 
Seat 9: holdemamn ($51.56 in chips) 
Nestle170: posts small blind $0.25
danthaur: posts big blind $0.50
An1an1: sits out 
*** HOLE CARDS ***
m11k1989: calls $0.50
holdemamn: folds 
v.sting: folds 
akbloger: folds 
$lavik88: folds 
PleBeY95: raises $1.50 to $2
Nestle170: folds 
danthaur: folds 
m11k1989: calls $1.50
*** FLOP *** [8d 2s Qs]
m11k1989: checks 
PleBeY95: checks 
*** TURN *** [8d 2s Qs] [4d]
m11k1989: bets $2.50
PleBeY95: calls $2.50
*** RIVER *** [8d 2s Qs 4d] [4c]
m11k1989: bets $10.50
PleBeY95: folds 
Uncalled bet ($10.50) returned to m11k1989
m11k1989 collected $9.26 from pot
m11k1989: doesn't show hand 
*** SUMMARY ***
Total pot $9.75 | Rake $0.49 
Board [8d 2s Qs 4d 4c]
Seat 2: v.sting folded before Flop (didn't bet)
Seat 3: akbloger folded before Flop (didn't bet)
Seat 4: $lavik88 folded before Flop (didn't bet)
Seat 5: PleBeY95 (button) folded on the River
Seat 6: Nestle170 (small blind) folded before Flop
Seat 7: danthaur (big blind) folded before Flop
Seat 8: m11k1989 collected ($9.26)
Seat 9: holdemamn folded before Flop (didn't bet)



PokerStars Hand #228688963146:  Hold'em No Limit ($0.25/$0.50 USD) - 2021/07/30 16:43:26 ET
Table 'Galilea III' 9-max Seat #2 is the button
Seat 1: An1an1 ($50 in chips) 
Seat 2: v.sting ($116.26 in chips) 
Seat 3: akbloger ($62.79 in chips) 
Seat 4: $lavik88 ($90.25 in chips) 
Seat 5: PleBeY95 ($54.89 in chips) 
Seat 6: Nestle170 ($50 in chips) 
Seat 7: danthaur ($51.61 in chips) 
Seat 8: m11k1989 ($66.42 in chips) 
Seat 9: holdemamn ($51.85 in chips) 
akbloger: posts small blind $0.25
$lavik88: posts big blind $0.50
*** HOLE CARDS ***
PleBeY95: folds 
Nestle170: raises $1 to $1.50
danthaur: folds 
m11k1989: calls $1.50
holdemamn: folds 
An1an1: folds 
v.sting: folds 
akbloger: raises $5.50 to $7
$lavik88: folds 
Nestle170: raises $9 to $16
m11k1989: folds 
akbloger: folds 
Uncalled bet ($9) returned to Nestle170
Nestle170 collected $16 from pot
Nestle170: doesn't show hand 
*** SUMMARY ***
Total pot $16 | Rake $0 
Seat 1: An1an1 folded before Flop (didn't bet)
Seat 2: v.sting (button) folded before Flop (didn't bet)
Seat 3: akbloger (small blind) folded before Flop
Seat 4: $lavik88 (big blind) folded before Flop
Seat 5: PleBeY95 folded before Flop (didn't bet)
Seat 6: Nestle170 collected ($16)
Seat 7: danthaur folded before Flop (didn't bet)
Seat 8: m11k1989 folded before Flop
Seat 9: holdemamn folded before Flop (didn't bet)



PokerStars Hand #228689067756:  Hold'em No Limit ($0.25/$0.50 USD) - 2021/07/30 16:46:48 ET
Table 'Galilea III' 9-max Seat #7 is the button
Seat 1: An1an1 ($50 in chips) 
Seat 2: v.sting ($116.26 in chips) 
Seat 3: akbloger ($55.79 in chips) 
Seat 4: $lavik88 ($89.50 in chips) 
Seat 5: PleBeY95 ($54.14 in chips) 
Seat 6: Nestle170 ($58.25 in chips) 
Seat 7: danthaur ($50.86 in chips) 
Seat 8: m11k1989 ($67.78 in chips) 
Seat 9: holdemamn ($52.60 in chips) 
m11k1989: posts small blind $0.25
holdemamn: posts big blind $0.50
*** HOLE CARDS ***
An1an1: raises $0.75 to $1.25
v.sting: folds 
akbloger: folds 
$lavik88: folds 
PleBeY95: folds 
Nestle170: folds 
danthaur: folds 
m11k1989: calls $1
holdemamn: folds 
*** FLOP *** [2h 2d 4d]
m11k1989: bets $1.50
An1an1: calls $1.50
*** TURN *** [2h 2d 4d] [Tc]
m11k1989: bets $1.50
An1an1: raises $5.83 to $7.33
m11k1989: calls $5.83
*** RIVER *** [2h 2d 4d Tc] [3h]
m11k1989: checks 
An1an1: checks 
*** SHOW DOWN ***
m11k1989: shows [Ks Td] (two pair, Tens and Deuces)
An1an1: mucks hand 
m11k1989 collected $19.63 from pot
*** SUMMARY ***
Total pot $20.66 | Rake $1.03 
Board [2h 2d 4d Tc 3h]
Seat 1: An1an1 mucked
Seat 2: v.sting folded before Flop (didn't bet)
Seat 3: akbloger folded before Flop (didn't bet)
Seat 4: $lavik88 folded before Flop (didn't bet)
Seat 5: PleBeY95 folded before Flop (didn't bet)
Seat 6: Nestle170 folded before Flop (didn't bet)
Seat 7: danthaur (button) folded before Flop (didn't bet)
Seat 8: m11k1989 (small blind) showed [Ks Td] and won ($19.63) with two pair, Tens and Deuces
Seat 9: holdemamn (big blind) folded before Flop



PokerStars Hand #228689114028:  Hold'em No Limit ($0.25/$0.50 USD) - 2021/07/30 16:48:24 ET
Table 'Galilea III' 9-max Seat #8 is the button
Seat 1: An1an1 ($50 in chips) 
Seat 2: v.sting ($116.26 in chips) 
Seat 3: akbloger ($55.79 in chips) 
Seat 4: $lavik88 ($89.50 in chips) 
Seat 5: PleBeY95 ($54.14 in chips) 
Seat 6: Nestle170 ($58.25 in chips) 
Seat 7: danthaur ($50.86 in chips) 
Seat 8: m11k1989 ($77.33 in chips) 
Seat 9: holdemamn ($52.10 in chips) 
holdemamn: posts small blind $0.25
An1an1: posts big blind $0.50
*** HOLE CARDS ***
v.sting: folds 
akbloger: folds 
$lavik88: folds 
PleBeY95: folds 
Nestle170: folds 
danthaur: raises $0.75 to $1.25
m11k1989: folds 
holdemamn: folds 
An1an1: calls $0.75
*** FLOP *** [6d 4h As]
An1an1: checks 
danthaur: bets $0.75
An1an1: raises $1.85 to $2.60
danthaur: folds 
Uncalled bet ($1.85) returned to An1an1
An1an1 collected $4.04 from pot
An1an1: doesn't show hand 
*** SUMMARY ***
Total pot $4.25 | Rake $0.21 
Board [6d 4h As]
Seat 1: An1an1 (big blind) collected ($4.04)
Seat 2: v.sting folded before Flop (didn't bet)
Seat 3: akbloger folded before Flop (didn't bet)
Seat 4: $lavik88 folded before Flop (didn't bet)
Seat 5: PleBeY95 folded before Flop (didn't bet)
Seat 6: Nestle170 folded before Flop (didn't bet)
Seat 7: danthaur folded on the Flop
Seat 8: m11k1989 (button) folded before Flop (didn't bet)
Seat 9: holdemamn (small blind) folded before Flop



PokerStars Hand #228689144529:  Hold'em No Limit ($0.25/$0.50 USD) - 2021/07/30 16:49:28 ET
Table 'Galilea III' 9-max Seat #9 is the button
Seat 1: An1an1 ($52.04 in chips) 
Seat 3: akbloger ($55.79 in chips) 
Seat 4: $lavik88 ($89.50 in chips) 
Seat 5: PleBeY95 ($54.14 in chips) 
Seat 6: Nestle170 ($58.25 in chips) 
Seat 7: danthaur ($50 in chips) 
Seat 8: m11k1989 ($77.33 in chips) 
Seat 9: holdemamn ($51.85 in chips) 
An1an1: posts small blind $0.25
v.sting: is sitting out 
v.sting leaves the table
akbloger: posts big blind $0.50
*** HOLE CARDS ***
$lavik88: folds 
PleBeY95: folds 
Nestle170: folds 
danthaur: raises $1 to $1.50
m11k1989: folds 
Gluck35 joins the table at seat #2 
holdemamn: folds 
An1an1: folds 
akbloger: calls $1
*** FLOP *** [Td 3h 7c]
akbloger: checks 
danthaur: bets $2.04
akbloger: calls $2.04
*** TURN *** [Td 3h 7c] [Kd]
akbloger: checks 
danthaur: checks 
*** RIVER *** [Td 3h 7c Kd] [Th]
akbloger: bets $5.22
danthaur: folds 
Uncalled bet ($5.22) returned to akbloger
akbloger collected $6.96 from pot
akbloger: doesn't show hand 
*** SUMMARY ***
Total pot $7.33 | Rake $0.37 
Board [Td 3h 7c Kd Th]
Seat 1: An1an1 (small blind) folded before Flop
Seat 3: akbloger (big blind) collected ($6.96)
Seat 4: $lavik88 folded before Flop (didn't bet)
Seat 5: PleBeY95 folded before Flop (didn't bet)
Seat 6: Nestle170 folded before Flop (didn't bet)
Seat 7: danthaur folded on the River
Seat 8: m11k1989 folded before Flop (didn't bet)
Seat 9: holdemamn (button) folded before Flop (didn't bet)



PokerStars Hand #228689168368:  Hold'em No Limit ($0.25/$0.50 USD) - 2021/07/30 16:50:17 ET
Table 'Galilea III' 9-max Seat #1 is the button
Seat 1: An1an1 ($51.79 in chips) 
Seat 3: akbloger ($59.21 in chips) 
Seat 4: $lavik88 ($89.50 in chips) 
Seat 5: PleBeY95 ($54.14 in chips) 
Seat 6: Nestle170 ($58.25 in chips) 
Seat 7: danthaur ($50 in chips) 
Seat 8: m11k1989 ($77.33 in chips) 
Seat 9: holdemamn ($51.85 in chips) 
akbloger: posts small blind $0.25
$lavik88: posts big blind $0.50
*** HOLE CARDS ***
PleBeY95: folds 
Nestle170: folds 
danthaur: folds 
m11k1989 has timed out
m11k1989: folds 
holdemamn: folds 
An1an1: folds 
akbloger: folds 
Uncalled bet ($0.25) returned to $lavik88
$lavik88 collected $0.50 from pot
$lavik88: doesn't show hand 
*** SUMMARY ***
Total pot $0.50 | Rake $0 
Seat 1: An1an1 (button) folded before Flop (didn't bet)
Seat 3: akbloger (small blind) folded before Flop
Seat 4: $lavik88 (big blind) collected ($0.50)
Seat 5: PleBeY95 folded before Flop (didn't bet)
Seat 6: Nestle170 folded before Flop (didn't bet)
Seat 7: danthaur folded before Flop (didn't bet)
Seat 8: m11k1989 folded before Flop (didn't bet)
Seat 9: holdemamn folded before Flop (didn't bet)



PokerStars Hand #228689178594:  Hold'em No Limit ($0.25/$0.50 USD) - 2021/07/30 16:50:39 ET
Table 'Galilea III' 9-max Seat #3 is the button
Seat 1: An1an1 ($51.79 in chips) 
Seat 3: akbloger ($58.96 in chips) 
Seat 4: $lavik88 ($89.75 in chips) 
Seat 5: PleBeY95 ($54.14 in chips) 
Seat 6: Nestle170 ($58.25 in chips) 
Seat 7: danthaur ($50 in chips) 
Seat 8: m11k1989 ($77.33 in chips) 
Seat 9: holdemamn ($51.85 in chips) 
$lavik88: posts small blind $0.25
PleBeY95: posts big blind $0.50
Gluck35: sits out 
*** HOLE CARDS ***
Nestle170: folds 
danthaur: folds 
m11k1989: calls $0.50
holdemamn: folds 
An1an1: raises $1.25 to $1.75
akbloger: raises $3.75 to $5.50
$lavik88: folds 
PleBeY95: folds 
m11k1989: folds 
An1an1: calls $3.75
*** FLOP *** [3s 5c 3d]
An1an1: checks 
akbloger: bets $3.84
An1an1: folds 
Uncalled bet ($3.84) returned to akbloger
akbloger collected $11.64 from pot
akbloger: doesn't show hand 
*** SUMMARY ***
Total pot $12.25 | Rake $0.61 
Board [3s 5c 3d]
Seat 1: An1an1 folded on the Flop
Seat 3: akbloger (button) collected ($11.64)
Seat 4: $lavik88 (small blind) folded before Flop
Seat 5: PleBeY95 (big blind) folded before Flop
Seat 6: Nestle170 folded before Flop (didn't bet)
Seat 7: danthaur folded before Flop (didn't bet)
Seat 8: m11k1989 folded before Flop
Seat 9: holdemamn folded before Flop (didn't bet)



PokerStars Hand #228689211096:  Hold'em No Limit ($0.25/$0.50 USD) - 2021/07/30 16:51:47 ET
Table 'Galilea III' 9-max Seat #4 is the button
Seat 1: An1an1 ($50 in chips) 
Seat 3: akbloger ($65.10 in chips) 
Seat 4: $lavik88 ($89.50 in chips) 
Seat 5: PleBeY95 ($53.64 in chips) 
Seat 6: Nestle170 ($58.25 in chips) 
Seat 7: danthaur ($50 in chips) 
Seat 8: m11k1989 ($76.83 in chips) 
Seat 9: holdemamn ($51.85 in chips) 
PleBeY95: posts small blind $0.25
Nestle170: posts big blind $0.50
Gluck35: sits out 
*** HOLE CARDS ***
danthaur: folds 
m11k1989: raises $0.50 to $1
holdemamn: folds 
An1an1: folds 
akbloger: folds 
$lavik88: folds 
PleBeY95: raises $4 to $5
Nestle170: folds 
m11k1989: folds 
Uncalled bet ($4) returned to PleBeY95
PleBeY95 collected $2.50 from pot
*** SUMMARY ***
Total pot $2.50 | Rake $0 
Seat 1: An1an1 folded before Flop (didn't bet)
Seat 3: akbloger folded before Flop (didn't bet)
Seat 4: $lavik88 (button) folded before Flop (didn't bet)
Seat 5: PleBeY95 (small blind) collected ($2.50)
Seat 6: Nestle170 (big blind) folded before Flop
Seat 7: danthaur folded before Flop (didn't bet)
Seat 8: m11k1989 folded before Flop
Seat 9: holdemamn folded before Flop (didn't bet)



PokerStars Hand #228689233369:  Hold'em No Limit ($0.25/$0.50 USD) - 2021/07/30 16:52:33 ET
Table 'Galilea III' 9-max Seat #5 is the button
Seat 1: An1an1 ($50 in chips) 
Seat 3: akbloger ($65.10 in chips) 
Seat 4: $lavik88 ($89.50 in chips) 
Seat 5: PleBeY95 ($55.14 in chips) 
Seat 6: Nestle170 ($57.75 in chips) 
Seat 7: danthaur ($50 in chips) 
Seat 8: m11k1989 ($75.83 in chips) 
Seat 9: holdemamn ($51.85 in chips) 
Nestle170: posts small blind $0.25
danthaur: posts big blind $0.50
Gluck35: sits out 
*** HOLE CARDS ***
m11k1989: calls $0.50
holdemamn: raises $1.50 to $2
An1an1: folds 
akbloger: folds 
$lavik88: folds 
PleBeY95: folds 
Nestle170: folds 
danthaur: folds 
m11k1989: calls $1.50
*** FLOP *** [4s 3h Ah]
m11k1989: checks 
holdemamn: bets $1.50
m11k1989: calls $1.50
*** TURN *** [4s 3h Ah] [9s]
m11k1989: checks 
holdemamn: checks 
*** RIVER *** [4s 3h Ah 9s] [Qd]
m11k1989: bets $5.68
holdemamn: calls $5.68
*** SHOW DOWN ***
m11k1989: shows [7h 6h] (high card Ace)
holdemamn: shows [Qh Kc] (a pair of Queens)
holdemamn collected $18.15 from pot
*** SUMMARY ***
Total pot $19.11 | Rake $0.96 
Board [4s 3h Ah 9s Qd]
Seat 1: An1an1 folded before Flop (didn't bet)
Seat 3: akbloger folded before Flop (didn't bet)
Seat 4: $lavik88 folded before Flop (didn't bet)
Seat 5: PleBeY95 (button) folded before Flop (didn't bet)
Seat 6: Nestle170 (small blind) folded before Flop
Seat 7: danthaur (big blind) folded before Flop
Seat 8: m11k1989 showed [7h 6h] and lost with high card Ace
Seat 9: holdemamn showed [Qh Kc] and won ($18.15) with a pair of Queens



PokerStars Hand #228689253727:  Hold'em No Limit ($0.25/$0.50 USD) - 2021/07/30 16:53:15 ET
Table 'Galilea III' 9-max Seat #6 is the button
Seat 1: An1an1 ($50 in chips) 
Seat 3: akbloger ($65.10 in chips) 
Seat 4: $lavik88 ($89.50 in chips) 
Seat 5: PleBeY95 ($55.14 in chips) 
Seat 6: Nestle170 ($57.50 in chips) 
Seat 7: danthaur ($50 in chips) 
Seat 8: m11k1989 ($66.65 in chips) 
Seat 9: holdemamn ($60.82 in chips) 
danthaur: posts small blind $0.25
m11k1989: posts big blind $0.50
Gluck35: sits out 
*** HOLE CARDS ***
holdemamn: folds 
An1an1: folds 
akbloger: folds 
$lavik88: folds 
PleBeY95: folds 
Nestle170: raises $0.60 to $1.10
danthaur: folds 
m11k1989: calls $0.60
*** FLOP *** [Jd 8h Ac]
m11k1989: bets $1.50
Nestle170: calls $1.50
*** TURN *** [Jd 8h Ac] [6s]
m11k1989: bets $2.50
Nestle170: calls $2.50
*** RIVER *** [Jd 8h Ac 6s] [4s]
m11k1989: checks 
Nestle170: checks 
*** SHOW DOWN ***
m11k1989: shows [9h Qs] (high card Ace)
Nestle170: shows [5d 8d] (a pair of Eights)
Nestle170 collected $9.93 from pot
*** SUMMARY ***
Total pot $10.45 | Rake $0.52 
Board [Jd 8h Ac 6s 4s]
Seat 1: An1an1 folded before Flop (didn't bet)
Seat 3: akbloger folded before Flop (didn't bet)
Seat 4: $lavik88 folded before Flop (didn't bet)
Seat 5: PleBeY95 folded before Flop (didn't bet)
Seat 6: Nestle170 (button) showed [5d 8d] and won ($9.93) with a pair of Eights
Seat 7: danthaur (small blind) folded before Flop
Seat 8: m11k1989 (big blind) showed [9h Qs] and lost with high card Ace
Seat 9: holdemamn folded before Flop (didn't bet)



PokerStars Hand #228689280011:  Hold'em No Limit ($0.25/$0.50 USD) - 2021/07/30 16:54:05 ET
Table 'Galilea III' 9-max Seat #7 is the button
Seat 1: An1an1 ($50 in chips) 
Seat 3: akbloger ($65.10 in chips) 
Seat 4: $lavik88 ($89.50 in chips) 
Seat 5: PleBeY95 ($55.14 in chips) 
Seat 6: Nestle170 ($62.33 in chips) 
Seat 7: danthaur ($50 in chips) 
Seat 8: m11k1989 ($61.55 in chips) 
m11k1989: posts small blind $0.25
holdemamn: is sitting out 
An1an1: posts big blind $0.50
Gluck35: sits out 
*** HOLE CARDS ***
akbloger: folds 
holdemamn leaves the table
$lavik88: folds 
PleBeY95: folds 
Nestle170: folds 
danthaur: raises $0.75 to $1.25
m11k1989: folds 
An1an1: calls $0.75
*** FLOP *** [2c 8s Jh]
An1an1: checks 
danthaur: bets $0.86
An1an1: calls $0.86
*** TURN *** [2c 8s Jh] [Js]
An1an1: checks 
phatom-z joins the table at seat #9 
danthaur: checks 
*** RIVER *** [2c 8s Jh Js] [4c]
An1an1: bets $2.85
danthaur: raises $5.47 to $8.32
An1an1: folds 
Uncalled bet ($5.47) returned to danthaur
danthaur collected $9.66 from pot
danthaur: doesn't show hand 
*** SUMMARY ***
Total pot $10.17 | Rake $0.51 
Board [2c 8s Jh Js 4c]
Seat 1: An1an1 (big blind) folded on the River
Seat 3: akbloger folded before Flop (didn't bet)
Seat 4: $lavik88 folded before Flop (didn't bet)
Seat 5: PleBeY95 folded before Flop (didn't bet)
Seat 6: Nestle170 folded before Flop (didn't bet)
Seat 7: danthaur (button) collected ($9.66)
Seat 8: m11k1989 (small blind) folded before Flop



PokerStars Hand #228689325403:  Hold'em No Limit ($0.25/$0.50 USD) - 2021/07/30 16:55:35 ET
Table 'Galilea III' 9-max Seat #8 is the button
Seat 1: An1an1 ($50 in chips) 
Seat 2: Gluck35 ($50 in chips) 
Seat 3: akbloger ($65.10 in chips) 
Seat 4: $lavik88 ($89.50 in chips) 
Seat 5: PleBeY95 ($55.14 in chips) 
Seat 6: Nestle170 ($62.33 in chips) 
Seat 7: danthaur ($54.70 in chips) 
Seat 8: m11k1989 ($61.30 in chips) 
An1an1: posts small blind $0.25
Gluck35: posts big blind $0.50
*** HOLE CARDS ***
akbloger: folds 
akbloger leaves the table
$lavik88: folds 
PleBeY95: folds 
Nestle170: folds 
danthaur: folds 
m11k1989: calls $0.50
An1an1: folds 
alexrus18 joins the table at seat #3 
Gluck35: checks 
*** FLOP *** [8c Tc Qh]
Gluck35: checks 
m11k1989: bets $1
Gluck35: calls $1
*** TURN *** [8c Tc Qh] [3d]
Gluck35: checks 
m11k1989: bets $3
Gluck35: folds 
Uncalled bet ($3) returned to m11k1989
m11k1989 collected $3.09 from pot
m11k1989: doesn't show hand 
*** SUMMARY ***
Total pot $3.25 | Rake $0.16 
Board [8c Tc Qh 3d]
Seat 1: An1an1 (small blind) folded before Flop
Seat 2: Gluck35 (big blind) folded on the Turn
Seat 3: akbloger folded before Flop (didn't bet)
Seat 4: $lavik88 folded before Flop (didn't bet)
Seat 5: PleBeY95 folded before Flop (didn't bet)
Seat 6: Nestle170 folded before Flop (didn't bet)
Seat 7: danthaur folded before Flop (didn't bet)
Seat 8: m11k1989 (button) collected ($3.09)



PokerStars Hand #228689339176:  Hold'em No Limit ($0.25/$0.50 USD) - 2021/07/30 16:56:16 ET
Table 'Galilea III' 9-max Seat #1 is the button
Seat 1: An1an1 ($50 in chips) 
Seat 2: Gluck35 ($50 in chips) 
Seat 3: alexrus18 ($50 in chips) 
Seat 4: $lavik88 ($89.50 in chips) 
Seat 5: PleBeY95 ($55.14 in chips) 
Seat 6: Nestle170 ($62.33 in chips) 
Seat 7: danthaur ($54.70 in chips) 
Seat 8: m11k1989 ($62.89 in chips) 
Gluck35: posts small blind $0.25
alexrus18: posts big blind $0.50
phatom-z: sits out 
*** HOLE CARDS ***
$lavik88: folds 
PleBeY95: folds 
Nestle170: folds 
danthaur: folds 
m11k1989: calls $0.50
An1an1: folds 
Gluck35: folds 
alexrus18: raises $1.50 to $2
m11k1989: calls $1.50
*** FLOP *** [Ad 3d 7c]
alexrus18: checks 
m11k1989: bets $2.02
alexrus18: folds 
Uncalled bet ($2.02) returned to m11k1989
m11k1989 collected $4.04 from pot
m11k1989: doesn't show hand 
*** SUMMARY ***
Total pot $4.25 | Rake $0.21 
Board [Ad 3d 7c]
Seat 1: An1an1 (button) folded before Flop (didn't bet)
Seat 2: Gluck35 (small blind) folded before Flop
Seat 3: alexrus18 (big blind) folded on the Flop
Seat 4: $lavik88 folded before Flop (didn't bet)
Seat 5: PleBeY95 folded before Flop (didn't bet)
Seat 6: Nestle170 folded before Flop (didn't bet)
Seat 7: danthaur folded before Flop (didn't bet)
Seat 8: m11k1989 collected ($4.04)



PokerStars Hand #228689352338:  Hold'em No Limit ($0.25/$0.50 USD) - 2021/07/30 16:56:54 ET
Table 'Galilea III' 9-max Seat #2 is the button
Seat 1: An1an1 ($50 in chips) 
Seat 2: Gluck35 ($50 in chips) 
Seat 3: alexrus18 ($50 in chips) 
Seat 4: $lavik88 ($89.50 in chips) 
Seat 5: PleBeY95 ($55.14 in chips) 
Seat 6: Nestle170 ($62.33 in chips) 
Seat 7: danthaur ($54.70 in chips) 
Seat 8: m11k1989 ($64.93 in chips) 
alexrus18: posts small blind $0.25
$lavik88: posts big blind $0.50
phatom-z: sits out 
*** HOLE CARDS ***
PleBeY95: folds 
Nestle170: folds 
danthaur: folds 
m11k1989: raises $0.50 to $1
An1an1: folds 
Gluck35: folds 
alexrus18: folds 
$lavik88: calls $0.50
*** FLOP *** [3h 8s 3d]
$lavik88: checks 
m11k1989: bets $2.14
$lavik88: folds 
Uncalled bet ($2.14) returned to m11k1989
m11k1989 collected $2.14 from pot
m11k1989: doesn't show hand 
*** SUMMARY ***
Total pot $2.25 | Rake $0.11 
Board [3h 8s 3d]
Seat 1: An1an1 folded before Flop (didn't bet)
Seat 2: Gluck35 (button) folded before Flop (didn't bet)
Seat 3: alexrus18 (small blind) folded before Flop
Seat 4: $lavik88 (big blind) folded on the Flop
Seat 5: PleBeY95 folded before Flop (didn't bet)
Seat 6: Nestle170 folded before Flop (didn't bet)
Seat 7: danthaur folded before Flop (didn't bet)
Seat 8: m11k1989 collected ($2.14)



PokerStars Hand #228689370004:  Hold'em No Limit ($0.25/$0.50 USD) - 2021/07/30 16:57:46 ET
Table 'Galilea III' 9-max Seat #3 is the button
Seat 1: An1an1 ($50 in chips) 
Seat 2: Gluck35 ($50 in chips) 
Seat 3: alexrus18 ($50 in chips) 
Seat 4: $lavik88 ($88.50 in chips) 
Seat 5: PleBeY95 ($55.14 in chips) 
Seat 6: Nestle170 ($62.33 in chips) 
Seat 7: danthaur ($54.70 in chips) 
Seat 8: m11k1989 ($66.07 in chips) 
$lavik88: posts small blind $0.25
PleBeY95: posts big blind $0.50
phatom-z: sits out 
*** HOLE CARDS ***
Nestle170: folds 
danthaur: folds 
m11k1989: calls $0.50
An1an1: folds 
Gluck35: folds 
alexrus18: raises $1.50 to $2
$lavik88: folds 
PleBeY95: raises $4.50 to $6.50
m11k1989: folds 
alexrus18: folds 
Uncalled bet ($4.50) returned to PleBeY95
PleBeY95 collected $4.75 from pot
*** SUMMARY ***
Total pot $4.75 | Rake $0 
Seat 1: An1an1 folded before Flop (didn't bet)
Seat 2: Gluck35 folded before Flop (didn't bet)
Seat 3: alexrus18 (button) folded before Flop
Seat 4: $lavik88 (small blind) folded before Flop
Seat 5: PleBeY95 (big blind) collected ($4.75)
Seat 6: Nestle170 folded before Flop (didn't bet)
Seat 7: danthaur folded before Flop (didn't bet)
Seat 8: m11k1989 folded before Flop



PokerStars Hand #228689381246:  Hold'em No Limit ($0.25/$0.50 USD) - 2021/07/30 16:58:18 ET
Table 'Galilea III' 9-max Seat #4 is the button
Seat 1: An1an1 ($50 in chips) 
Seat 2: Gluck35 ($50 in chips) 
Seat 3: alexrus18 ($50 in chips) 
Seat 4: $lavik88 ($88.25 in chips) 
Seat 5: PleBeY95 ($57.89 in chips) 
Seat 6: Nestle170 ($62.33 in chips) 
Seat 7: danthaur ($54.70 in chips) 
Seat 8: m11k1989 ($65.57 in chips) 
PleBeY95: posts small blind $0.25
Nestle170: posts big blind $0.50
phatom-z: sits out 
*** HOLE CARDS ***
danthaur: raises $1 to $1.50
m11k1989 is disconnected 
m11k1989 is connected 
m11k1989: calls $1.50
An1an1: calls $1.50
Gluck35: folds 
alexrus18: folds 
$lavik88: folds 
PleBeY95: folds 
Nestle170: raises $6.50 to $8
danthaur: folds 
m11k1989: calls $6.50
An1an1: calls $6.50
*** FLOP *** [5c 3d 6h]
Nestle170: bets $54.33 and is all-in
m11k1989: raises $3.24 to $57.57 and is all-in
An1an1: folds 
Uncalled bet ($3.24) returned to m11k1989
*** TURN *** [5c 3d 6h] [4d]
*** RIVER *** [5c 3d 6h 4d] [2d]
*** SHOW DOWN ***
Nestle170: shows [Kc Ks] (a straight, Deuce to Six)
m11k1989: shows [5d 5s] (a straight, Deuce to Six)
Nestle170 collected $66.21 from pot
m11k1989 collected $66.20 from pot
*** SUMMARY ***
Total pot $134.41 | Rake $2 
Board [5c 3d 6h 4d 2d]
Seat 1: An1an1 folded on the Flop
Seat 2: Gluck35 folded before Flop (didn't bet)
Seat 3: alexrus18 folded before Flop (didn't bet)
Seat 4: $lavik88 (button) folded before Flop (didn't bet)
Seat 5: PleBeY95 (small blind) folded before Flop
Seat 6: Nestle170 (big blind) showed [Kc Ks] and won ($66.21) with a straight, Deuce to Six
Seat 7: danthaur folded before Flop
Seat 8: m11k1989 showed [5d 5s] and won ($66.20) with a straight, Deuce to Six



PokerStars Hand #228689402631:  Hold'em No Limit ($0.25/$0.50 USD) - 2021/07/30 16:59:20 ET
Table 'Galilea III' 9-max Seat #5 is the button
Seat 1: An1an1 ($50 in chips) 
Seat 2: Gluck35 ($50 in chips) 
Seat 3: alexrus18 ($50 in chips) 
Seat 4: $lavik88 ($88.25 in chips) 
Seat 5: PleBeY95 ($57.64 in chips) 
Seat 6: Nestle170 ($66.21 in chips) 
Seat 7: danthaur ($53.20 in chips) 
Seat 8: m11k1989 ($69.44 in chips) 
Nestle170: posts small blind $0.25
danthaur: posts big blind $0.50
phatom-z: sits out 
*** HOLE CARDS ***
m11k1989: calls $0.50
An1an1: folds 
Gluck35: folds 
alexrus18: folds 
$lavik88: folds 
PleBeY95: folds 
Nestle170: folds 
danthaur: checks 
*** FLOP *** [As 8d 5s]
Nestle170 leaves the table
danthaur: checks 
m11k1989: checks 
*** TURN *** [As 8d 5s] [9c]
danthaur: checks 
m11k1989: bets $1
danthaur: calls $1
*** RIVER *** [As 8d 5s 9c] [Jh]
Popokluev joins the table at seat #6 
danthaur: checks 
m11k1989 is disconnected 
m11k1989 is connected 
m11k1989: bets $3
danthaur: folds 
Uncalled bet ($3) returned to m11k1989
m11k1989 collected $3.09 from pot
m11k1989: doesn't show hand 
*** SUMMARY ***
Total pot $3.25 | Rake $0.16 
Board [As 8d 5s 9c Jh]
Seat 1: An1an1 folded before Flop (didn't bet)
Seat 2: Gluck35 folded before Flop (didn't bet)
Seat 3: alexrus18 folded before Flop (didn't bet)
Seat 4: $lavik88 folded before Flop (didn't bet)
Seat 5: PleBeY95 (button) folded before Flop (didn't bet)
Seat 6: Nestle170 (small blind) folded before Flop
Seat 7: danthaur (big blind) folded on the River
Seat 8: m11k1989 collected ($3.09)



PokerStars Hand #228689430874:  Hold'em No Limit ($0.25/$0.50 USD) - 2021/07/30 17:00:41 ET
Table 'Galilea III' 9-max Seat #7 is the button
Seat 1: An1an1 ($50 in chips) 
Seat 2: Gluck35 ($50 in chips) 
Seat 3: alexrus18 ($50 in chips) 
Seat 4: $lavik88 ($88.25 in chips) 
Seat 5: PleBeY95 ($57.64 in chips) 
Seat 7: danthaur ($51.70 in chips) 
Seat 8: m11k1989 ($71.03 in chips) 
Seat 9: phatom-z ($50 in chips) 
m11k1989: posts small blind $0.25
phatom-z: posts big blind $0.50
Popokluev: sits out 
*** HOLE CARDS ***
An1an1: folds 
Gluck35: folds 
alexrus18: folds 
$lavik88: folds 
PleBeY95: folds 
danthaur: folds 
m11k1989: calls $0.25
phatom-z: raises $1.50 to $2
m11k1989 is disconnected 
m11k1989 is connected 
m11k1989: calls $1.50
*** FLOP *** [5c 8d 3h]
m11k1989: bets $1
phatom-z: folds 
Uncalled bet ($1) returned to m11k1989
m11k1989 collected $3.80 from pot
m11k1989: doesn't show hand 
*** SUMMARY ***
Total pot $4 | Rake $0.20 
Board [5c 8d 3h]
Seat 1: An1an1 folded before Flop (didn't bet)
Seat 2: Gluck35 folded before Flop (didn't bet)
Seat 3: alexrus18 folded before Flop (didn't bet)
Seat 4: $lavik88 folded before Flop (didn't bet)
Seat 5: PleBeY95 folded before Flop (didn't bet)
Seat 7: danthaur (button) folded before Flop (didn't bet)
Seat 8: m11k1989 (small blind) collected ($3.80)
Seat 9: phatom-z (big blind) folded on the Flop



PokerStars Hand #228689450727:  Hold'em No Limit ($0.25/$0.50 USD) - 2021/07/30 17:01:29 ET
Table 'Galilea III' 9-max Seat #8 is the button
Seat 1: An1an1 ($50 in chips) 
Seat 2: Gluck35 ($50 in chips) 
Seat 3: alexrus18 ($50 in chips) 
Seat 4: $lavik88 ($88.25 in chips) 
Seat 5: PleBeY95 ($57.64 in chips) 
Seat 7: danthaur ($51.70 in chips) 
Seat 8: m11k1989 ($72.83 in chips) 
Seat 9: phatom-z ($50 in chips) 
phatom-z: posts small blind $0.25
An1an1: posts big blind $0.50
Popokluev: sits out 
*** HOLE CARDS ***
Gluck35: folds 
alexrus18: folds 
$lavik88: folds 
PleBeY95: raises $1 to $1.50
danthaur: folds 
m11k1989: calls $1.50
phatom-z: folds 
An1an1: calls $1
*** FLOP *** [Qd 3h 3d]
An1an1: checks 
PleBeY95: checks 
m11k1989: bets $2.50
An1an1: folds 
PleBeY95: calls $2.50
*** TURN *** [Qd 3h 3d] [Jd]
PleBeY95: checks 
m11k1989: bets $10.76
PleBeY95: folds 
Uncalled bet ($10.76) returned to m11k1989
m11k1989 collected $9.26 from pot
m11k1989: doesn't show hand 
*** SUMMARY ***
Total pot $9.75 | Rake $0.49 
Board [Qd 3h 3d Jd]
Seat 1: An1an1 (big blind) folded on the Flop
Seat 2: Gluck35 folded before Flop (didn't bet)
Seat 3: alexrus18 folded before Flop (didn't bet)
Seat 4: $lavik88 folded before Flop (didn't bet)
Seat 5: PleBeY95 folded on the Turn
Seat 7: danthaur folded before Flop (didn't bet)
Seat 8: m11k1989 (button) collected ($9.26)
Seat 9: phatom-z (small blind) folded before Flop



PokerStars Hand #228689474081:  Hold'em No Limit ($0.25/$0.50 USD) - 2021/07/30 17:02:19 ET
Table 'Galilea III' 9-max Seat #9 is the button
Seat 1: An1an1 ($50 in chips) 
Seat 2: Gluck35 ($50 in chips) 
Seat 3: alexrus18 ($50 in chips) 
Seat 4: $lavik88 ($88.25 in chips) 
Seat 5: PleBeY95 ($53.64 in chips) 
Seat 7: danthaur ($51.70 in chips) 
Seat 8: m11k1989 ($78.09 in chips) 
Seat 9: phatom-z ($50 in chips) 
An1an1: posts small blind $0.25
Gluck35: posts big blind $0.50
Popokluev: sits out 
*** HOLE CARDS ***
alexrus18: folds 
$lavik88: folds 
PleBeY95: folds 
danthaur: raises $1 to $1.50
m11k1989: calls $1.50
phatom-z: folds 
An1an1: folds 
Gluck35: folds 
*** FLOP *** [Qs 3s Tc]
danthaur: bets $1.17
m11k1989: raises $1.67 to $2.84
danthaur: calls $1.67
*** TURN *** [Qs 3s Tc] [8h]
danthaur: checks 
m11k1989: bets $4.48
danthaur: calls $4.48
*** RIVER *** [Qs 3s Tc 8h] [3d]
danthaur: checks 
m11k1989: bets $5.73
danthaur: calls $5.73
*** SHOW DOWN ***
m11k1989: shows [5h 6d] (a pair of Threes)
danthaur: shows [Qh Ah] (two pair, Queens and Threes)
danthaur collected $28.36 from pot
*** SUMMARY ***
Total pot $29.85 | Rake $1.49 
Board [Qs 3s Tc 8h 3d]
Seat 1: An1an1 (small blind) folded before Flop
Seat 2: Gluck35 (big blind) folded before Flop
Seat 3: alexrus18 folded before Flop (didn't bet)
Seat 4: $lavik88 folded before Flop (didn't bet)
Seat 5: PleBeY95 folded before Flop (didn't bet)
Seat 7: danthaur showed [Qh Ah] and won ($28.36) with two pair, Queens and Threes
Seat 8: m11k1989 showed [5h 6d] and lost with a pair of Threes
Seat 9: phatom-z (button) folded before Flop (didn't bet)



PokerStars Hand #228689507628:  Hold'em No Limit ($0.25/$0.50 USD) - 2021/07/30 17:03:31 ET
Table 'Galilea III' 9-max Seat #1 is the button
Seat 1: An1an1 ($50 in chips) 
Seat 2: Gluck35 ($50 in chips) 
Seat 3: alexrus18 ($50 in chips) 
Seat 4: $lavik88 ($88.25 in chips) 
Seat 5: PleBeY95 ($53.64 in chips) 
Seat 7: danthaur ($65.51 in chips) 
Seat 9: phatom-z ($50 in chips) 
Gluck35: posts small blind $0.25
alexrus18: posts big blind $0.50
Popokluev: sits out 
*** HOLE CARDS ***
$lavik88: folds 
PleBeY95: folds 
danthaur: folds 
phatom-z: folds 
An1an1: raises $0.85 to $1.35
Gluck35: folds 
alexrus18: calls $0.85
*** FLOP *** [9h 8h 9d]
alexrus18: checks 
An1an1: bets $0.84
alexrus18: folds 
Uncalled bet ($0.84) returned to An1an1
An1an1 collected $2.80 from pot
An1an1: doesn't show hand 
m11k1989 is disconnected 
*** SUMMARY ***
Total pot $2.95 | Rake $0.15 
Board [9h 8h 9d]
Seat 1: An1an1 (button) collected ($2.80)
Seat 2: Gluck35 (small blind) folded before Flop
Seat 3: alexrus18 (big blind) folded on the Flop
Seat 4: $lavik88 folded before Flop (didn't bet)
Seat 5: PleBeY95 folded before Flop (didn't bet)
Seat 7: danthaur folded before Flop (didn't bet)
Seat 9: phatom-z folded before Flop (didn't bet)



PokerStars Hand #228689519279:  Hold'em No Limit ($0.25/$0.50 USD) - 2021/07/30 17:03:56 ET
Table 'Galilea III' 9-max Seat #2 is the button
Seat 1: An1an1 ($51.45 in chips) 
Seat 2: Gluck35 ($50 in chips) 
Seat 3: alexrus18 ($50 in chips) 
Seat 4: $lavik88 ($88.25 in chips) 
Seat 5: PleBeY95 ($53.64 in chips) 
Seat 7: danthaur ($65.51 in chips) 
Seat 8: m11k1989 ($63.54 in chips) 
Seat 9: phatom-z ($50 in chips) 
alexrus18: posts small blind $0.25
$lavik88: posts big blind $0.50
Popokluev: sits out 
*** HOLE CARDS ***
PleBeY95: folds 
danthaur: folds 
m11k1989 is connected 
m11k1989: folds 
phatom-z: folds 
An1an1: raises $0.75 to $1.25
Gluck35: folds 
alexrus18: folds 
$lavik88: folds 
Uncalled bet ($0.75) returned to An1an1
An1an1 collected $1.25 from pot
An1an1: doesn't show hand 
*** SUMMARY ***
Total pot $1.25 | Rake $0 
Seat 1: An1an1 collected ($1.25)
Seat 2: Gluck35 (button) folded before Flop (didn't bet)
Seat 3: alexrus18 (small blind) folded before Flop
Seat 4: $lavik88 (big blind) folded before Flop
Seat 5: PleBeY95 folded before Flop (didn't bet)
Seat 7: danthaur folded before Flop (didn't bet)
Seat 8: m11k1989 folded before Flop (didn't bet)
Seat 9: phatom-z folded before Flop (didn't bet)



PokerStars Hand #228689527970:  Hold'em No Limit ($0.25/$0.50 USD) - 2021/07/30 17:04:14 ET
Table 'Galilea III' 9-max Seat #3 is the button
Seat 1: An1an1 ($52.20 in chips) 
Seat 2: Gluck35 ($50 in chips) 
Seat 3: alexrus18 ($50 in chips) 
Seat 4: $lavik88 ($87.75 in chips) 
Seat 5: PleBeY95 ($53.64 in chips) 
Seat 7: danthaur ($65.51 in chips) 
Seat 8: m11k1989 ($63.54 in chips) 
Seat 9: phatom-z ($50 in chips) 
$lavik88: posts small blind $0.25
PleBeY95: posts big blind $0.50
Popokluev: sits out 
*** HOLE CARDS ***
danthaur: folds 
m11k1989 is disconnected 
m11k1989 is connected 
m11k1989: folds 
phatom-z: folds 
An1an1: raises $0.75 to $1.25
Gluck35: folds 
alexrus18: folds 
$lavik88: folds 
PleBeY95: folds 
Uncalled bet ($0.75) returned to An1an1
An1an1 collected $1.25 from pot
An1an1: doesn't show hand 
*** SUMMARY ***
Total pot $1.25 | Rake $0 
Seat 1: An1an1 collected ($1.25)
Seat 2: Gluck35 folded before Flop (didn't bet)
Seat 3: alexrus18 (button) folded before Flop (didn't bet)
Seat 4: $lavik88 (small blind) folded before Flop
Seat 5: PleBeY95 (big blind) folded before Flop
Seat 7: danthaur folded before Flop (didn't bet)
Seat 8: m11k1989 folded before Flop (didn't bet)
Seat 9: phatom-z folded before Flop (didn't bet)



PokerStars Hand #228689543832:  Hold'em No Limit ($0.25/$0.50 USD) - 2021/07/30 17:04:42 ET
Table 'Galilea III' 9-max Seat #4 is the button
Seat 1: An1an1 ($52.95 in chips) 
Seat 2: Gluck35 ($50 in chips) 
Seat 3: alexrus18 ($50 in chips) 
Seat 4: $lavik88 ($87.50 in chips) 
Seat 5: PleBeY95 ($53.14 in chips) 
Seat 6: Popokluev ($50 in chips) 
Seat 7: danthaur ($65.51 in chips) 
Seat 8: m11k1989 ($63.54 in chips) 
Seat 9: phatom-z ($50 in chips) 
PleBeY95: posts small blind $0.25
Popokluev: posts big blind $0.50
*** HOLE CARDS ***
m11k1989 is disconnected 
danthaur: folds 
m11k1989 is connected 
m11k1989: calls $0.50
phatom-z: folds 
An1an1: folds 
Gluck35: raises $1.50 to $2
alexrus18: folds 
$lavik88: folds 
PleBeY95: folds 
Popokluev: raises $5.10 to $7.10
m11k1989: calls $6.60
Gluck35: raises $42.90 to $50 and is all-in
Popokluev: folds 
m11k1989: folds 
Uncalled bet ($42.90) returned to Gluck35
Gluck35 collected $21.55 from pot
Gluck35: doesn't show hand 
*** SUMMARY ***
Total pot $21.55 | Rake $0 
Seat 1: An1an1 folded before Flop (didn't bet)
Seat 2: Gluck35 collected ($21.55)
Seat 3: alexrus18 folded before Flop (didn't bet)
Seat 4: $lavik88 (button) folded before Flop (didn't bet)
Seat 5: PleBeY95 (small blind) folded before Flop
Seat 6: Popokluev (big blind) folded before Flop
Seat 7: danthaur folded before Flop (didn't bet)
Seat 8: m11k1989 folded before Flop
Seat 9: phatom-z folded before Flop (didn't bet)



PokerStars Hand #228689565165:  Hold'em No Limit ($0.25/$0.50 USD) - 2021/07/30 17:05:27 ET
Table 'Galilea III' 9-max Seat #5 is the button
Seat 1: An1an1 ($52.95 in chips) 
Seat 2: Gluck35 ($64.45 in chips) 
Seat 3: alexrus18 ($50 in chips) 
Seat 4: $lavik88 ($87.50 in chips) 
Seat 5: PleBeY95 ($52.89 in chips) 
Seat 6: Popokluev ($50 in chips) 
Seat 7: danthaur ($65.51 in chips) 
Seat 8: m11k1989 ($56.44 in chips) 
Seat 9: phatom-z ($50 in chips) 
Popokluev: posts small blind $0.25
danthaur: posts big blind $0.50
*** HOLE CARDS ***
m11k1989: calls $0.50
phatom-z: folds 
An1an1: folds 
Gluck35: folds 
alexrus18: folds 
$lavik88: folds 
PleBeY95: folds 
Popokluev: folds 
danthaur: checks 
*** FLOP *** [Qd Th As]
danthaur: checks 
m11k1989: bets $0.59
danthaur: folds 
Uncalled bet ($0.59) returned to m11k1989
m11k1989 collected $1.19 from pot
m11k1989: doesn't show hand 
*** SUMMARY ***
Total pot $1.25 | Rake $0.06 
Board [Qd Th As]
Seat 1: An1an1 folded before Flop (didn't bet)
Seat 2: Gluck35 folded before Flop (didn't bet)
Seat 3: alexrus18 folded before Flop (didn't bet)
Seat 4: $lavik88 folded before Flop (didn't bet)
Seat 5: PleBeY95 (button) folded before Flop (didn't bet)
Seat 6: Popokluev (small blind) folded before Flop
Seat 7: danthaur (big blind) folded on the Flop
Seat 8: m11k1989 collected ($1.19)
Seat 9: phatom-z folded before Flop (didn't bet)



PokerStars Hand #228689576649:  Hold'em No Limit ($0.25/$0.50 USD) - 2021/07/30 17:05:52 ET
Table 'Galilea III' 9-max Seat #6 is the button
Seat 1: An1an1 ($52.95 in chips) 
Seat 2: Gluck35 ($64.45 in chips) 
Seat 3: alexrus18 ($50 in chips) 
Seat 4: $lavik88 ($87.50 in chips) 
Seat 5: PleBeY95 ($52.89 in chips) 
Seat 6: Popokluev ($50 in chips) 
Seat 7: danthaur ($65.01 in chips) 
Seat 8: m11k1989 ($57.13 in chips) 
Seat 9: phatom-z ($50 in chips) 
danthaur: posts small blind $0.25
m11k1989: posts big blind $0.50
*** HOLE CARDS ***
phatom-z: folds 
An1an1: raises $0.75 to $1.25
Gluck35: folds 
alexrus18: folds 
$lavik88: folds 
PleBeY95: folds 
Popokluev: folds 
danthaur: folds 
m11k1989: calls $0.75
*** FLOP *** [Jh 9d 5c]
m11k1989: bets $3
An1an1: folds 
Uncalled bet ($3) returned to m11k1989
m11k1989 collected $2.61 from pot
m11k1989: doesn't show hand 
*** SUMMARY ***
Total pot $2.75 | Rake $0.14 
Board [Jh 9d 5c]
Seat 1: An1an1 folded on the Flop
Seat 2: Gluck35 folded before Flop (didn't bet)
Seat 3: alexrus18 folded before Flop (didn't bet)
Seat 4: $lavik88 folded before Flop (didn't bet)
Seat 5: PleBeY95 folded before Flop (didn't bet)
Seat 6: Popokluev (button) folded before Flop (didn't bet)
Seat 7: danthaur (small blind) folded before Flop
Seat 8: m11k1989 (big blind) collected ($2.61)
Seat 9: phatom-z folded before Flop (didn't bet)



PokerStars Hand #228689590368:  Hold'em No Limit ($0.25/$0.50 USD) - 2021/07/30 17:06:20 ET
Table 'Galilea III' 9-max Seat #7 is the button
Seat 1: An1an1 ($51.70 in chips) 
Seat 2: Gluck35 ($64.45 in chips) 
Seat 3: alexrus18 ($50 in chips) 
Seat 4: $lavik88 ($87.50 in chips) 
Seat 5: PleBeY95 ($52.89 in chips) 
Seat 6: Popokluev ($50 in chips) 
Seat 7: danthaur ($64.76 in chips) 
Seat 8: m11k1989 ($58.49 in chips) 
m11k1989: posts small blind $0.25
phatom-z: is sitting out 
An1an1: posts big blind $0.50
*** HOLE CARDS ***
phatom-z leaves the table
Gluck35: folds 
alexrus18: folds 
$lavik88: folds 
PleBeY95: raises $1 to $1.50
Popokluev: folds 
danthaur: folds 
m11k1989 is disconnected 
m11k1989 is connected 
m11k1989: calls $1.25
An1an1: folds 
*** FLOP *** [Kh 7s Jc]
nicu4you joins the table at seat #9 
m11k1989: checks 
PleBeY95: checks 
*** TURN *** [Kh 7s Jc] [Qh]
m11k1989: bets $1.50
PleBeY95: raises $5.37 to $6.87
m11k1989: calls $5.37
*** RIVER *** [Kh 7s Jc Qh] [Qc]
m11k1989: bets $6
PleBeY95: raises $38.52 to $44.52 and is all-in
m11k1989: folds 
Uncalled bet ($38.52) returned to PleBeY95
PleBeY95 collected $27.78 from pot
*** SUMMARY ***
Total pot $29.24 | Rake $1.46 
Board [Kh 7s Jc Qh Qc]
Seat 1: An1an1 (big blind) folded before Flop
Seat 2: Gluck35 folded before Flop (didn't bet)
Seat 3: alexrus18 folded before Flop (didn't bet)
Seat 4: $lavik88 folded before Flop (didn't bet)
Seat 5: PleBeY95 collected ($27.78)
Seat 6: Popokluev folded before Flop (didn't bet)
Seat 7: danthaur (button) folded before Flop (didn't bet)
Seat 8: m11k1989 (small blind) folded on the River



PokerStars Hand #228689622629:  Hold'em No Limit ($0.25/$0.50 USD) - 2021/07/30 17:07:28 ET
Table 'Galilea III' 9-max Seat #8 is the button
Seat 1: An1an1 ($51.20 in chips) 
Seat 2: Gluck35 ($64.45 in chips) 
Seat 3: alexrus18 ($50 in chips) 
Seat 4: $lavik88 ($87.50 in chips) 
Seat 5: PleBeY95 ($66.30 in chips) 
Seat 6: Popokluev ($50 in chips) 
Seat 7: danthaur ($64.76 in chips) 
Seat 8: m11k1989 ($44.12 in chips) 
An1an1: posts small blind $0.25
Gluck35: posts big blind $0.50
*** HOLE CARDS ***
alexrus18: folds 
$lavik88: folds 
PleBeY95: folds 
Popokluev: folds 
danthaur: folds 
m11k1989: raises $0.50 to $1
An1an1: folds 
Gluck35: calls $0.50
*** FLOP *** [Ac Jc 6h]
Gluck35: checks 
m11k1989: checks 
*** TURN *** [Ac Jc 6h] [9c]
Gluck35: checks 
m11k1989: checks 
*** RIVER *** [Ac Jc 6h 9c] [4h]
Gluck35: checks 
m11k1989: bets $4.14
Gluck35: folds 
Uncalled bet ($4.14) returned to m11k1989
m11k1989 collected $2.14 from pot
m11k1989: doesn't show hand 
*** SUMMARY ***
Total pot $2.25 | Rake $0.11 
Board [Ac Jc 6h 9c 4h]
Seat 1: An1an1 (small blind) folded before Flop
Seat 2: Gluck35 (big blind) folded on the River
Seat 3: alexrus18 folded before Flop (didn't bet)
Seat 4: $lavik88 folded before Flop (didn't bet)
Seat 5: PleBeY95 folded before Flop (didn't bet)
Seat 6: Popokluev folded before Flop (didn't bet)
Seat 7: danthaur folded before Flop (didn't bet)
Seat 8: m11k1989 (button) collected ($2.14)



PokerStars Hand #228689652670:  Hold'em No Limit ($0.25/$0.50 USD) - 2021/07/30 17:08:32 ET
Table 'Galilea III' 9-max Seat #1 is the button
Seat 1: An1an1 ($50.95 in chips) 
Seat 2: Gluck35 ($63.45 in chips) 
Seat 3: alexrus18 ($50 in chips) 
Seat 4: $lavik88 ($87.50 in chips) 
Seat 6: Popokluev ($50 in chips) 
Seat 7: danthaur ($64.76 in chips) 
Seat 8: m11k1989 ($45.26 in chips) 
Gluck35: posts small blind $0.25
alexrus18: posts big blind $0.50
nicu4you: sits out 
*** HOLE CARDS ***
$lavik88: folds 
Popokluev: folds 
danthaur: folds 
m11k1989: raises $1.25 to $1.75
An1an1: folds 
Gluck35: folds 
alexrus18: calls $1.25
*** FLOP *** [4s Qh 9h]
alexrus18: checks 
m11k1989: bets $3
alexrus18: calls $3
*** TURN *** [4s Qh 9h] [As]
alexrus18: checks 
m11k1989: bets $7.50
alexrus18: calls $7.50
*** RIVER *** [4s Qh 9h As] [8s]
alexrus18: checks 
m11k1989: checks 
*** SHOW DOWN ***
alexrus18: shows [5h Ah] (a pair of Aces)
m11k1989: mucks hand 
alexrus18 collected $23.51 from pot
*** SUMMARY ***
Total pot $24.75 | Rake $1.24 
Board [4s Qh 9h As 8s]
Seat 1: An1an1 (button) folded before Flop (didn't bet)
Seat 2: Gluck35 (small blind) folded before Flop
Seat 3: alexrus18 (big blind) showed [5h Ah] and won ($23.51) with a pair of Aces
Seat 4: $lavik88 folded before Flop (didn't bet)
Seat 6: Popokluev folded before Flop (didn't bet)
Seat 7: danthaur folded before Flop (didn't bet)
Seat 8: m11k1989 mucked



PokerStars Hand #228689678526:  Hold'em No Limit ($0.25/$0.50 USD) - 2021/07/30 17:09:27 ET
Table 'Galilea III' 9-max Seat #2 is the button
Seat 1: An1an1 ($50.95 in chips) 
Seat 2: Gluck35 ($63.20 in chips) 
Seat 3: alexrus18 ($61.26 in chips) 
Seat 4: $lavik88 ($87.50 in chips) 
Seat 6: Popokluev ($50 in chips) 
Seat 7: danthaur ($64.76 in chips) 
Seat 8: m11k1989 ($33.01 in chips) 
alexrus18: posts small blind $0.25
$lavik88: posts big blind $0.50
nicu4you: sits out 
*** HOLE CARDS ***
Popokluev: folds 
danthaur: folds 
m11k1989: calls $0.50
An1an1: folds 
Gluck35: folds 
alexrus18: raises $1.75 to $2.25
$lavik88: folds 
m11k1989: calls $1.75
*** FLOP *** [2d 8h Qd]
alexrus18: checks 
m11k1989: bets $1
alexrus18: calls $1
*** TURN *** [2d 8h Qd] [Kd]
alexrus18: checks 
m11k1989: checks 
*** RIVER *** [2d 8h Qd Kd] [Jc]
alexrus18: checks 
m11k1989: checks 
*** SHOW DOWN ***
alexrus18: shows [Ac Jd] (a pair of Jacks)
m11k1989: mucks hand 
alexrus18 collected $6.65 from pot
*** SUMMARY ***
Total pot $7 | Rake $0.35 
Board [2d 8h Qd Kd Jc]
Seat 1: An1an1 folded before Flop (didn't bet)
Seat 2: Gluck35 (button) folded before Flop (didn't bet)
Seat 3: alexrus18 (small blind) showed [Ac Jd] and won ($6.65) with a pair of Jacks
Seat 4: $lavik88 (big blind) folded before Flop
Seat 6: Popokluev folded before Flop (didn't bet)
Seat 7: danthaur folded before Flop (didn't bet)
Seat 8: m11k1989 mucked



PokerStars Hand #228689701634:  Hold'em No Limit ($0.25/$0.50 USD) - 2021/07/30 17:10:16 ET
Table 'Galilea III' 9-max Seat #3 is the button
Seat 1: An1an1 ($50.95 in chips) 
Seat 2: Gluck35 ($63.20 in chips) 
Seat 3: alexrus18 ($64.66 in chips) 
Seat 4: $lavik88 ($87 in chips) 
Seat 6: Popokluev ($50 in chips) 
Seat 7: danthaur ($64.76 in chips) 
Seat 8: m11k1989 ($29.76 in chips) 
$lavik88: posts small blind $0.25
Popokluev: posts big blind $0.50
nicu4you: sits out 
*** HOLE CARDS ***
danthaur: raises $1 to $1.50
m11k1989: raises $2 to $3.50
An1an1: folds 
Gluck35: folds 
alexrus18: folds 
$lavik88: folds 
Popokluev: folds 
danthaur: raises $30.50 to $34
m11k1989: calls $26.26 and is all-in
Uncalled bet ($4.24) returned to danthaur
*** FLOP *** [2s Jc Kd]
*** TURN *** [2s Jc Kd] [9d]
*** RIVER *** [2s Jc Kd 9d] [4s]
*** SHOW DOWN ***
danthaur: shows [Kh As] (a pair of Kings)
m11k1989: shows [Ad Jh] (a pair of Jacks)
danthaur collected $58.27 from pot
*** SUMMARY ***
Total pot $60.27 | Rake $2 
Board [2s Jc Kd 9d 4s]
Seat 1: An1an1 folded before Flop (didn't bet)
Seat 2: Gluck35 folded before Flop (didn't bet)
Seat 3: alexrus18 (button) folded before Flop (didn't bet)
Seat 4: $lavik88 (small blind) folded before Flop
Seat 6: Popokluev (big blind) folded before Flop
Seat 7: danthaur showed [Kh As] and won ($58.27) with a pair of Kings
Seat 8: m11k1989 showed [Ad Jh] and lost with a pair of Jacks



PokerStars Hand #228689724089:  Hold'em No Limit ($0.25/$0.50 USD) - 2021/07/30 17:11:04 ET
Table 'Galilea III' 9-max Seat #4 is the button
Seat 1: An1an1 ($50.95 in chips) 
Seat 2: Gluck35 ($63.20 in chips) 
Seat 3: alexrus18 ($64.66 in chips) 
Seat 4: $lavik88 ($86.75 in chips) 
Seat 6: Popokluev ($50 in chips) 
Seat 7: danthaur ($93.27 in chips) 
Popokluev: posts small blind $0.25
danthaur: posts big blind $0.50
nicu4you: sits out 
*** HOLE CARDS ***
An1an1: folds 
m11k1989 is disconnected 
Gluck35: folds 
alexrus18: folds 
$lavik88: folds 
Popokluev: folds 
Uncalled bet ($0.25) returned to danthaur
danthaur collected $0.50 from pot
danthaur: doesn't show hand 
*** SUMMARY ***
Total pot $0.50 | Rake $0 
Seat 1: An1an1 folded before Flop (didn't bet)
Seat 2: Gluck35 folded before Flop (didn't bet)
Seat 3: alexrus18 folded before Flop (didn't bet)
Seat 4: $lavik88 (button) folded before Flop (didn't bet)
Seat 6: Popokluev (small blind) folded before Flop
Seat 7: danthaur (big blind) collected ($0.50)



PokerStars Hand #228689726994:  Hold'em No Limit ($0.25/$0.50 USD) - 2021/07/30 17:11:11 ET
Table 'Galilea III' 9-max Seat #6 is the button
Seat 1: An1an1 ($50.95 in chips) 
Seat 2: Gluck35 ($63.20 in chips) 
Seat 3: alexrus18 ($64.66 in chips) 
Seat 4: $lavik88 ($86.75 in chips) 
Seat 6: Popokluev ($50 in chips) 
Seat 7: danthaur ($93.52 in chips) 
Seat 9: nicu4you ($50 in chips) 
danthaur: posts small blind $0.25
nicu4you: posts big blind $0.50
*** HOLE CARDS ***
An1an1: raises $0.75 to $1.25
Gluck35: folds 
alexrus18: folds 
$lavik88: folds 
Popokluev: folds 
danthaur: folds 
nicu4you: folds 
Uncalled bet ($0.75) returned to An1an1
An1an1 collected $1.25 from pot
An1an1: doesn't show hand 
*** SUMMARY ***
Total pot $1.25 | Rake $0 
Seat 1: An1an1 collected ($1.25)
Seat 2: Gluck35 folded before Flop (didn't bet)
Seat 3: alexrus18 folded before Flop (didn't bet)
Seat 4: $lavik88 folded before Flop (didn't bet)
Seat 6: Popokluev (button) folded before Flop (didn't bet)
Seat 7: danthaur (small blind) folded before Flop
Seat 9: nicu4you (big blind) folded before Flop



PokerStars Hand #228689734213:  Hold'em No Limit ($0.25/$0.50 USD) - 2021/07/30 17:11:26 ET
Table 'Galilea III' 9-max Seat #7 is the button
Seat 3: alexrus18 ($64.66 in chips) 
Seat 4: $lavik88 ($86.75 in chips) 
Seat 6: Popokluev ($50 in chips) 
Seat 7: danthaur ($93.27 in chips) 
Seat 9: nicu4you ($50 in chips) 
nicu4you: posts small blind $0.25
An1an1: is sitting out 
Gluck35: is sitting out 
alexrus18: posts big blind $0.50
*** HOLE CARDS ***
$lavik88: raises $1 to $1.50
Popokluev: folds 
danthaur: folds 
nicu4you: folds 
Popokluev leaves the table
alexrus18: calls $1
*** FLOP *** [6d Qc 5c]
alexrus18: checks 
$lavik88: bets $0.93
Gluck35 leaves the table
alexrus18: calls $0.93
*** TURN *** [6d Qc 5c] [Jc]
An1an1 was removed from the table for failing to post
An1an1 leaves the table
alexrus18: checks 
$lavik88: bets $3.64
alexrus18: folds 
Uncalled bet ($3.64) returned to $lavik88
$lavik88 collected $4.85 from pot
$lavik88: doesn't show hand 
*** SUMMARY ***
Total pot $5.11 | Rake $0.26 
Board [6d Qc 5c Jc]
Seat 3: alexrus18 (big blind) folded on the Turn
Seat 4: $lavik88 collected ($4.85)
Seat 6: Popokluev folded before Flop (didn't bet)
Seat 7: danthaur (button) folded before Flop (didn't bet)
Seat 9: nicu4you (small blind) folded before Flop



PokerStars Hand #228689755140:  Hold'em No Limit ($0.25/$0.50 USD) - 2021/07/30 17:12:11 ET
Table 'Galilea III' 9-max Seat #9 is the button
Seat 3: alexrus18 ($62.23 in chips) 
Seat 4: $lavik88 ($89.17 in chips) 
Seat 7: danthaur ($93.27 in chips) 
Seat 9: nicu4you ($50 in chips) 
alexrus18: posts small blind $0.25
$lavik88: posts big blind $0.50
*** HOLE CARDS ***
danthaur: folds 
Sonny0306 joins the table at seat #6 
nicu4you: raises $0.75 to $1.25
alexrus18: folds 
$lavik88: folds 
Uncalled bet ($0.75) returned to nicu4you
nicu4you collected $1.25 from pot
nicu4you: doesn't show hand 
*** SUMMARY ***
Total pot $1.25 | Rake $0 
Seat 3: alexrus18 (small blind) folded before Flop
Seat 4: $lavik88 (big blind) folded before Flop
Seat 7: danthaur folded before Flop (didn't bet)
Seat 9: nicu4you (button) collected ($1.25)



PokerStars Hand #228689760020:  Hold'em No Limit ($0.25/$0.50 USD) - 2021/07/30 17:12:22 ET
Table 'Galilea III' 9-max Seat #3 is the button
Seat 3: alexrus18 ($61.98 in chips) 
Seat 4: $lavik88 ($88.67 in chips) 
Seat 6: Sonny0306 ($50 in chips) 
Seat 7: danthaur ($93.27 in chips) 
Seat 9: nicu4you ($50.75 in chips) 
$lavik88: posts small blind $0.25
Sonny0306: posts big blind $0.50
*** HOLE CARDS ***
danthaur: folds 
nicu4you has timed out
nicu4you: folds 
alexrus18: folds 
$lavik88: folds 
Uncalled bet ($0.25) returned to Sonny0306
Sonny0306 collected $0.50 from pot
Sonny0306: doesn't show hand 
*** SUMMARY ***
Total pot $0.50 | Rake $0 
Seat 3: alexrus18 (button) folded before Flop (didn't bet)
Seat 4: $lavik88 (small blind) folded before Flop
Seat 6: Sonny0306 (big blind) collected ($0.50)
Seat 7: danthaur folded before Flop (didn't bet)
Seat 9: nicu4you folded before Flop (didn't bet)



PokerStars Hand #228689768691:  Hold'em No Limit ($0.25/$0.50 USD) - 2021/07/30 17:12:41 ET
Table 'Galilea III' 9-max Seat #4 is the button
Seat 3: alexrus18 ($61.98 in chips) 
Seat 4: $lavik88 ($88.42 in chips) 
Seat 6: Sonny0306 ($50.25 in chips) 
Seat 9: nicu4you ($50.75 in chips) 
Sonny0306: posts small blind $0.25
danthaur: is sitting out 
nicu4you: posts big blind $0.50
*** HOLE CARDS ***
danthaur leaves the table
alexrus18: folds 
$lavik88: folds 
Agent Cedric joins the table at seat #2 
Sonny0306: folds 
Uncalled bet ($0.25) returned to nicu4you
nicu4you collected $0.50 from pot
nicu4you: doesn't show hand 
*** SUMMARY ***
Total pot $0.50 | Rake $0 
Seat 3: alexrus18 folded before Flop (didn't bet)
Seat 4: $lavik88 (button) folded before Flop (didn't bet)
Seat 6: Sonny0306 (small blind) folded before Flop
Seat 9: nicu4you (big blind) collected ($0.50)



PokerStars Hand #228689771598:  Hold'em No Limit ($0.25/$0.50 USD) - 2021/07/30 17:12:47 ET
Table 'Galilea III' 9-max Seat #6 is the button
Seat 2: Agent Cedric ($40 in chips) 
Seat 3: alexrus18 ($61.98 in chips) 
Seat 4: $lavik88 ($88.42 in chips) 
Seat 6: Sonny0306 ($50 in chips) 
Seat 9: nicu4you ($51 in chips) 
nicu4you: posts small blind $0.25
Agent Cedric: posts big blind $0.50
*** HOLE CARDS ***
alexrus18: folds 
$lavik88: folds 
Sonny0306: raises $1 to $1.50
nicu4you: calls $1.25
Agent Cedric: calls $1
*** FLOP *** [7c Qd Tc]
nicu4you: checks 
Agent Cedric: checks 
Sonny0306: checks 
*** TURN *** [7c Qd Tc] [9h]
nicu4you: checks 
eltonmiranda joins the table at seat #1 
Agent Cedric: bets $4.28
PleBeY95 leaves the table
Sonny0306: folds 
nicu4you: folds 
Uncalled bet ($4.28) returned to Agent Cedric
Agent Cedric collected $4.28 from pot
Agent Cedric: doesn't show hand 
*** SUMMARY ***
Total pot $4.50 | Rake $0.22 
Board [7c Qd Tc 9h]
Seat 2: Agent Cedric (big blind) collected ($4.28)
Seat 3: alexrus18 folded before Flop (didn't bet)
Seat 4: $lavik88 folded before Flop (didn't bet)
Seat 6: Sonny0306 (button) folded on the Turn
Seat 9: nicu4you (small blind) folded on the Turn



PokerStars Hand #228689785142:  Hold'em No Limit ($0.25/$0.50 USD) - 2021/07/30 17:13:16 ET
Table 'Galilea III' 9-max Seat #9 is the button
Seat 2: Agent Cedric ($42.78 in chips) 
Seat 6: Sonny0306 ($50 in chips) 
Seat 9: nicu4you ($50 in chips) 
Agent Cedric: posts small blind $0.25
alexrus18: is sitting out 
$lavik88: is sitting out 
Sonny0306: posts big blind $0.50
*** HOLE CARDS ***
$lavik88 leaves the table
nicu4you: raises $0.75 to $1.25
Agent Cedric: folds 
Sonny0306: folds 
Uncalled bet ($0.75) returned to nicu4you
Sonny0306 leaves the table
nicu4you collected $1.25 from pot
nicu4you: doesn't show hand 
*** SUMMARY ***
Total pot $1.25 | Rake $0 
Seat 2: Agent Cedric (small blind) folded before Flop
Seat 6: Sonny0306 (big blind) folded before Flop
Seat 9: nicu4you (button) collected ($1.25)



PokerStars Hand #228689800928:  Hold'em No Limit ($0.25/$0.50 USD) - 2021/07/30 17:13:29 ET
Table 'Galilea III' 9-max Seat #2 is the button
Seat 1: eltonmiranda ($39.95 in chips) 
Seat 2: Agent Cedric ($42.53 in chips) 
Seat 9: nicu4you ($50.75 in chips) 
nicu4you: posts small blind $0.25
eltonmiranda: posts big blind $0.50
*** HOLE CARDS ***
alexrus18 leaves the table
Agent Cedric: raises $0.50 to $1
nicu4you: folds 
eltonmiranda: raises $2.25 to $3.25
Agent Cedric: calls $2.25
*** FLOP *** [4s 7s Ks]
eltonmiranda: bets $3.20
Agent Cedric: folds 
Uncalled bet ($3.20) returned to eltonmiranda
eltonmiranda collected $6.41 from pot
eltonmiranda: doesn't show hand 
*** SUMMARY ***
Total pot $6.75 | Rake $0.34 
Board [4s 7s Ks]
Seat 1: eltonmiranda (big blind) collected ($6.41)
Seat 2: Agent Cedric (button) folded on the Flop
Seat 9: nicu4you (small blind) folded before Flop



PokerStars Hand #228689813986:  Hold'em No Limit ($0.25/$0.50 USD) - 2021/07/30 17:13:56 ET
Table 'Galilea III' 9-max Seat #9 is the button
Seat 1: eltonmiranda ($43.11 in chips) 
Seat 2: Agent Cedric ($39.28 in chips) 
Seat 9: nicu4you ($50.50 in chips) 
eltonmiranda: posts small blind $0.25
Agent Cedric: posts big blind $0.50
*** HOLE CARDS ***
nicu4you: raises $0.75 to $1.25
eltonmiranda: calls $1
Agent Cedric: folds 
*** FLOP *** [Jh 8h 3c]
eltonmiranda: checks 
Corlogiro joins the table at seat #4 
nicu4you: bets $0.94
Smashdoge joins the table at seat #3 
eltonmiranda: calls $0.94
*** TURN *** [Jh 8h 3c] [3h]
eltonmiranda: checks 
Ajs Miracle- joins the table at seat #5 
An1an1 joins the table at seat #7 
BALAWA joins the table at seat #6 
nicu4you: checks 
*** RIVER *** [Jh 8h 3c 3h] [5d]
eltonmiranda: bets $2.32
nicu4you: folds 
Uncalled bet ($2.32) returned to eltonmiranda
eltonmiranda collected $4.64 from pot
eltonmiranda: doesn't show hand 
*** SUMMARY ***
Total pot $4.88 | Rake $0.24 
Board [Jh 8h 3c 3h 5d]
Seat 1: eltonmiranda (small blind) collected ($4.64)
Seat 2: Agent Cedric (big blind) folded before Flop
Seat 9: nicu4you (button) folded on the River



PokerStars Hand #228689829604:  Hold'em No Limit ($0.25/$0.50 USD) - 2021/07/30 17:14:30 ET
Table 'Galilea III' 9-max Seat #1 is the button
Seat 1: eltonmiranda ($45.56 in chips) 
Seat 2: Agent Cedric ($38.78 in chips) 
Seat 3: Smashdoge ($23.22 in chips) 
Seat 5: Ajs Miracle- ($50 in chips) 
Seat 6: BALAWA ($40 in chips) 
Seat 9: nicu4you ($50 in chips) 
Agent Cedric: posts small blind $0.25
Smashdoge: posts big blind $0.50
Corlogiro: sits out 
Ajs Miracle-: posts big blind $0.50
BALAWA: posts big blind $0.50
An1an1: sits out 
*** HOLE CARDS ***
Ajs Miracle-: checks 
BALAWA: checks 
nicu4you: folds 
eltonmiranda: folds 
Agent Cedric: calls $0.25
Smashdoge: checks 
*** FLOP *** [3c 3s 2c]
Agent Cedric: checks 
Smashdoge: checks 
Ajs Miracle-: bets $2.45
BALAWA: folds 
Agent Cedric: folds 
Smashdoge: folds 
Uncalled bet ($2.45) returned to Ajs Miracle-
Ajs Miracle- collected $1.90 from pot
Ajs Miracle-: doesn't show hand 
*** SUMMARY ***
Total pot $2 | Rake $0.10 
Board [3c 3s 2c]
Seat 1: eltonmiranda (button) folded before Flop (didn't bet)
Seat 2: Agent Cedric (small blind) folded on the Flop
Seat 3: Smashdoge (big blind) folded on the Flop
Seat 5: Ajs Miracle- collected ($1.90)
Seat 6: BALAWA folded on the Flop (didn't bet)
Seat 9: nicu4you folded before Flop (didn't bet)



PokerStars Hand #228689855165:  Hold'em No Limit ($0.25/$0.50 USD) - 2021/07/30 17:15:24 ET
Table 'Galilea III' 9-max Seat #2 is the button
Seat 1: eltonmiranda ($45.56 in chips) 
Seat 2: Agent Cedric ($38.28 in chips) 
Seat 3: Smashdoge ($22.72 in chips) 
Seat 4: Corlogiro ($50 in chips) 
Seat 5: Ajs Miracle- ($51.40 in chips) 
Seat 6: BALAWA ($39.50 in chips) 
Seat 9: nicu4you ($50 in chips) 
Smashdoge: posts small blind $0.25
Corlogiro: posts big blind $0.50
An1an1: sits out 
*** HOLE CARDS ***
Ajs Miracle-: folds 
BALAWA: folds 
nicu4you: folds 
eltonmiranda: raises $0.50 to $1
Agent Cedric: folds 
Smashdoge: folds 
Corlogiro: calls $0.50
*** FLOP *** [4s Jh 5c]
Corlogiro: checks 
eltonmiranda: bets $1.07
Corlogiro: folds 
Uncalled bet ($1.07) returned to eltonmiranda
eltonmiranda collected $2.14 from pot
eltonmiranda: doesn't show hand 
*** SUMMARY ***
Total pot $2.25 | Rake $0.11 
Board [4s Jh 5c]
Seat 1: eltonmiranda collected ($2.14)
Seat 2: Agent Cedric (button) folded before Flop (didn't bet)
Seat 3: Smashdoge (small blind) folded before Flop
Seat 4: Corlogiro (big blind) folded on the Flop
Seat 5: Ajs Miracle- folded before Flop (didn't bet)
Seat 6: BALAWA folded before Flop (didn't bet)
Seat 9: nicu4you folded before Flop (didn't bet)



PokerStars Hand #228689872341:  Hold'em No Limit ($0.25/$0.50 USD) - 2021/07/30 17:16:01 ET
Table 'Galilea III' 9-max Seat #3 is the button
Seat 1: eltonmiranda ($46.70 in chips) 
Seat 2: Agent Cedric ($38.28 in chips) 
Seat 3: Smashdoge ($22.47 in chips) 
Seat 4: Corlogiro ($50 in chips) 
Seat 5: Ajs Miracle- ($51.40 in chips) 
Seat 6: BALAWA ($39.50 in chips) 
Seat 9: nicu4you ($50 in chips) 
Corlogiro: posts small blind $0.25
Ajs Miracle-: posts big blind $0.50
An1an1: sits out 
*** HOLE CARDS ***
BALAWA: folds 
nicu4you: folds 
eltonmiranda: folds 
Agent Cedric: folds 
Smashdoge: calls $0.50
Corlogiro: calls $0.25
Ajs Miracle-: checks 
*** FLOP *** [2s Td 7d]
Corlogiro: checks 
Ajs Miracle-: checks 
Smashdoge: checks 
*** TURN *** [2s Td 7d] [3s]
Corlogiro: bets $1
Ajs Miracle-: raises $3.42 to $4.42
Smashdoge: calls $4.42
Corlogiro: folds 
*** RIVER *** [2s Td 7d 3s] [Th]
Ajs Miracle-: bets $8.77
Smashdoge: calls $8.77
*** SHOW DOWN ***
Ajs Miracle-: shows [Kc Qd] (a pair of Tens)
Smashdoge: shows [7c Kh] (two pair, Tens and Sevens)
Smashdoge collected $27.08 from pot
*** SUMMARY ***
Total pot $28.88 | Rake $1.80 
Board [2s Td 7d 3s Th]
Seat 1: eltonmiranda folded before Flop (didn't bet)
Seat 2: Agent Cedric folded before Flop (didn't bet)
Seat 3: Smashdoge (button) showed [7c Kh] and won ($27.08) with two pair, Tens and Sevens
Seat 4: Corlogiro (small blind) folded on the Turn
Seat 5: Ajs Miracle- (big blind) showed [Kc Qd] and lost with a pair of Tens
Seat 6: BALAWA folded before Flop (didn't bet)
Seat 9: nicu4you folded before Flop (didn't bet)



PokerStars Hand #228689908484:  Hold'em No Limit ($0.25/$0.50 USD) - 2021/07/30 17:17:18 ET
Table 'Galilea III' 9-max Seat #4 is the button
Seat 1: eltonmiranda ($46.70 in chips) 
Seat 2: Agent Cedric ($38.28 in chips) 
Seat 3: Smashdoge ($35.86 in chips) 
Seat 4: Corlogiro ($50 in chips) 
Seat 5: Ajs Miracle- ($37.71 in chips) 
Seat 6: BALAWA ($39.50 in chips) 
Seat 9: nicu4you ($50 in chips) 
Ajs Miracle-: posts small blind $0.25
BALAWA: posts big blind $0.50
An1an1: sits out 
*** HOLE CARDS ***
nicu4you: folds 
eltonmiranda: folds 
Agent Cedric: folds 
m11k1989 was removed from the table for failing to post
m11k1989 leaves the table
Smashdoge: calls $0.50
Kolyan2114 joins the table at seat #8 
Corlogiro: raises $1.50 to $2
Ajs Miracle-: folds 
BALAWA: calls $1.50
Smashdoge: calls $1.50
*** FLOP *** [4s 6d 9d]
BALAWA: checks 
Smashdoge: bets $2.50
Corlogiro: folds 
BALAWA: raises $10.94 to $13.44
Smashdoge: calls $10.94
*** TURN *** [4s 6d 9d] [5s]
BALAWA: bets $24.06 and is all-in
Smashdoge: calls $20.42 and is all-in
Uncalled bet ($3.64) returned to BALAWA
*** RIVER *** [4s 6d 9d 5s] [Ac]
*** SHOW DOWN ***
BALAWA: shows [Ks Qd] (high card Ace)
Smashdoge: shows [Th 9s] (a pair of Nines)
Smashdoge collected $71.47 from pot
BALAWA cashed out the hand for $9.72 | Cash Out Fee $0.10
*** SUMMARY ***
Total pot $73.97 | Rake $2.50 
Board [4s 6d 9d 5s Ac]
Seat 1: eltonmiranda folded before Flop (didn't bet)
Seat 2: Agent Cedric folded before Flop (didn't bet)
Seat 3: Smashdoge showed [Th 9s] and won ($71.47) with a pair of Nines
Seat 4: Corlogiro (button) folded on the Flop
Seat 5: Ajs Miracle- (small blind) folded before Flop
Seat 6: BALAWA (big blind) showed [Ks Qd] and lost with high card Ace (cashed out).
Seat 9: nicu4you folded before Flop (didn't bet)



PokerStars Hand #228689943440:  Hold'em No Limit ($0.25/$0.50 USD) - 2021/07/30 17:18:34 ET
Table 'Galilea III' 9-max Seat #5 is the button
Seat 1: eltonmiranda ($46.70 in chips) 
Seat 2: Agent Cedric ($38.28 in chips) 
Seat 3: Smashdoge ($71.47 in chips) 
Seat 4: Corlogiro ($50 in chips) 
Seat 5: Ajs Miracle- ($37.46 in chips) 
Seat 6: BALAWA ($13.36 in chips) 
Seat 7: An1an1 ($51.70 in chips) 
Seat 9: nicu4you ($50 in chips) 
BALAWA: posts small blind $0.25
An1an1: posts big blind $0.50
Kolyan2114: sits out 
*** HOLE CARDS ***
nicu4you: raises $0.75 to $1.25
eltonmiranda: folds 
Agent Cedric: folds 
Smashdoge: folds 
Corlogiro: folds 
Ajs Miracle-: calls $1.25
BALAWA: calls $1
An1an1: folds 
*** FLOP *** [3d 6c Kd]
BALAWA: checks 
nicu4you: checks 
Ajs Miracle-: checks 
*** TURN *** [3d 6c Kd] [3h]
BALAWA: checks 
nicu4you: bets $1.33
Ajs Miracle-: calls $1.33
BALAWA: folds 
*** RIVER *** [3d 6c Kd 3h] [5s]
nicu4you: bets $4.53
Ajs Miracle-: folds 
Uncalled bet ($4.53) returned to nicu4you
nicu4you collected $6.56 from pot
nicu4you: doesn't show hand 
*** SUMMARY ***
Total pot $6.91 | Rake $0.35 
Board [3d 6c Kd 3h 5s]
Seat 1: eltonmiranda folded before Flop (didn't bet)
Seat 2: Agent Cedric folded before Flop (didn't bet)
Seat 3: Smashdoge folded before Flop (didn't bet)
Seat 4: Corlogiro folded before Flop (didn't bet)
Seat 5: Ajs Miracle- (button) folded on the River
Seat 6: BALAWA (small blind) folded on the Turn
Seat 7: An1an1 (big blind) folded before Flop
Seat 9: nicu4you collected ($6.56)



PokerStars Hand #228689985987:  Hold'em No Limit ($0.25/$0.50 USD) - 2021/07/30 17:20:06 ET
Table 'Galilea III' 9-max Seat #6 is the button
Seat 1: eltonmiranda ($46.70 in chips) 
Seat 2: Agent Cedric ($38.28 in chips) 
Seat 3: Smashdoge ($71.47 in chips) 
Seat 4: Corlogiro ($50 in chips) 
Seat 5: Ajs Miracle- ($34.88 in chips) 
Seat 6: BALAWA ($12.11 in chips) 
Seat 7: An1an1 ($51.20 in chips) 
Seat 8: Kolyan2114 ($50 in chips) 
Seat 9: nicu4you ($53.98 in chips) 
An1an1: posts small blind $0.25
Kolyan2114: posts big blind $0.50
*** HOLE CARDS ***
nicu4you: folds 
eltonmiranda: raises $1 to $1.50
Agent Cedric: folds 
Smashdoge: folds 
Corlogiro: folds 
Ajs Miracle-: folds 
BALAWA: folds 
An1an1: folds 
Kolyan2114: folds 
Uncalled bet ($1) returned to eltonmiranda
eltonmiranda collected $1.25 from pot
eltonmiranda: doesn't show hand 
*** SUMMARY ***
Total pot $1.25 | Rake $0 
Seat 1: eltonmiranda collected ($1.25)
Seat 2: Agent Cedric folded before Flop (didn't bet)
Seat 3: Smashdoge folded before Flop (didn't bet)
Seat 4: Corlogiro folded before Flop (didn't bet)
Seat 5: Ajs Miracle- folded before Flop (didn't bet)
Seat 6: BALAWA (button) folded before Flop (didn't bet)
Seat 7: An1an1 (small blind) folded before Flop
Seat 8: Kolyan2114 (big blind) folded before Flop
Seat 9: nicu4you folded before Flop (didn't bet)



PokerStars Hand #228690005406:  Hold'em No Limit ($0.25/$0.50 USD) - 2021/07/30 17:20:48 ET
Table 'Galilea III' 9-max Seat #7 is the button
Seat 1: eltonmiranda ($47.45 in chips) 
Seat 2: Agent Cedric ($38.28 in chips) 
Seat 3: Smashdoge ($71.47 in chips) 
Seat 4: Corlogiro ($50 in chips) 
Seat 5: Ajs Miracle- ($34.88 in chips) 
Seat 6: BALAWA ($12.11 in chips) 
Seat 7: An1an1 ($50.95 in chips) 
Seat 8: Kolyan2114 ($50 in chips) 
Seat 9: nicu4you ($53.98 in chips) 
Kolyan2114: posts small blind $0.25
nicu4you: posts big blind $0.50
*** HOLE CARDS ***
eltonmiranda: folds 
Agent Cedric: folds 
Smashdoge: calls $0.50
Corlogiro: folds 
Ajs Miracle-: folds 
BALAWA: raises $1 to $1.50
An1an1: folds 
Kolyan2114: folds 
nicu4you: calls $1
Smashdoge: calls $1
*** FLOP *** [Qc Qd 5h]
nicu4you: checks 
Smashdoge: checks 
BALAWA: checks 
*** TURN *** [Qc Qd 5h] [7s]
nicu4you: bets $2.48
Smashdoge: calls $2.48
BALAWA: calls $2.48
*** RIVER *** [Qc Qd 5h 7s] [Js]
nicu4you: bets $7.99
Smashdoge: folds 
BALAWA: raises $0.14 to $8.13 and is all-in
nicu4you: calls $0.14
*** SHOW DOWN ***
BALAWA: shows [Qh Jh] (a full house, Queens full of Jacks)
nicu4you: shows [Qs Jc] (a full house, Queens full of Jacks)
nicu4you collected $13.52 from pot
BALAWA collected $13.51 from pot
*** SUMMARY ***
Total pot $28.45 | Rake $1.42 
Board [Qc Qd 5h 7s Js]
Seat 1: eltonmiranda folded before Flop (didn't bet)
Seat 2: Agent Cedric folded before Flop (didn't bet)
Seat 3: Smashdoge folded on the River
Seat 4: Corlogiro folded before Flop (didn't bet)
Seat 5: Ajs Miracle- folded before Flop (didn't bet)
Seat 6: BALAWA showed [Qh Jh] and won ($13.51) with a full house, Queens full of Jacks
Seat 7: An1an1 (button) folded before Flop (didn't bet)
Seat 8: Kolyan2114 (small blind) folded before Flop
Seat 9: nicu4you (big blind) showed [Qs Jc] and won ($13.52) with a full house, Queens full of Jacks



PokerStars Hand #228690057122:  Hold'em No Limit ($0.25/$0.50 USD) - 2021/07/30 17:22:40 ET
Table 'Galilea III' 9-max Seat #8 is the button
Seat 1: eltonmiranda ($47.45 in chips) 
Seat 2: Agent Cedric ($38.28 in chips) 
Seat 3: Smashdoge ($67.49 in chips) 
Seat 4: Corlogiro ($50 in chips) 
Seat 5: Ajs Miracle- ($34.88 in chips) 
Seat 6: BALAWA ($13.51 in chips) 
Seat 7: An1an1 ($50.95 in chips) 
Seat 8: Kolyan2114 ($50 in chips) 
Seat 9: nicu4you ($55.39 in chips) 
nicu4you: posts small blind $0.25
eltonmiranda: posts big blind $0.50
*** HOLE CARDS ***
Agent Cedric: folds 
Smashdoge: folds 
Corlogiro: folds 
Ajs Miracle-: folds 
BALAWA: raises $1.25 to $1.75
An1an1: folds 
Kolyan2114: folds 
nicu4you: folds 
eltonmiranda: folds 
Uncalled bet ($1.25) returned to BALAWA
BALAWA collected $1.25 from pot
BALAWA: doesn't show hand 
*** SUMMARY ***
Total pot $1.25 | Rake $0 
Seat 1: eltonmiranda (big blind) folded before Flop
Seat 2: Agent Cedric folded before Flop (didn't bet)
Seat 3: Smashdoge folded before Flop (didn't bet)
Seat 4: Corlogiro folded before Flop (didn't bet)
Seat 5: Ajs Miracle- folded before Flop (didn't bet)
Seat 6: BALAWA collected ($1.25)
Seat 7: An1an1 folded before Flop (didn't bet)
Seat 8: Kolyan2114 (button) folded before Flop (didn't bet)
Seat 9: nicu4you (small blind) folded before Flop



PokerStars Hand #228690069114:  Hold'em No Limit ($0.25/$0.50 USD) - 2021/07/30 17:23:06 ET
Table 'Galilea III' 9-max Seat #9 is the button
Seat 1: eltonmiranda ($46.95 in chips) 
Seat 2: Agent Cedric ($38.28 in chips) 
Seat 3: Smashdoge ($67.49 in chips) 
Seat 4: Corlogiro ($50 in chips) 
Seat 5: Ajs Miracle- ($34.88 in chips) 
Seat 6: BALAWA ($14.26 in chips) 
Seat 7: An1an1 ($50.95 in chips) 
Seat 8: Kolyan2114 ($50 in chips) 
Seat 9: nicu4you ($55.14 in chips) 
eltonmiranda: posts small blind $0.25
Agent Cedric: posts big blind $0.50
*** HOLE CARDS ***
Smashdoge: calls $0.50
Corlogiro: folds 
Ajs Miracle-: folds 
BALAWA has timed out
BALAWA: folds 
An1an1: folds 
Kolyan2114: folds 
nicu4you has timed out
nicu4you: folds 
eltonmiranda: calls $0.25
Agent Cedric: checks 
*** FLOP *** [2d 9s Kc]
eltonmiranda: checks 
Agent Cedric: checks 
Smashdoge: checks 
*** TURN *** [2d 9s Kc] [8c]
eltonmiranda: bets $0.71
Agent Cedric: folds 
Smashdoge: folds 
Uncalled bet ($0.71) returned to eltonmiranda
eltonmiranda collected $1.42 from pot
eltonmiranda: doesn't show hand 
*** SUMMARY ***
Total pot $1.50 | Rake $0.08 
Board [2d 9s Kc 8c]
Seat 1: eltonmiranda (small blind) collected ($1.42)
Seat 2: Agent Cedric (big blind) folded on the Turn
Seat 3: Smashdoge folded on the Turn
Seat 4: Corlogiro folded before Flop (didn't bet)
Seat 5: Ajs Miracle- folded before Flop (didn't bet)
Seat 6: BALAWA folded before Flop (didn't bet)
Seat 7: An1an1 folded before Flop (didn't bet)
Seat 8: Kolyan2114 folded before Flop (didn't bet)
Seat 9: nicu4you (button) folded before Flop (didn't bet)



PokerStars Hand #228690102773:  Hold'em No Limit ($0.25/$0.50 USD) - 2021/07/30 17:24:19 ET
Table 'Galilea III' 9-max Seat #1 is the button
Seat 1: eltonmiranda ($47.87 in chips) 
Seat 2: Agent Cedric ($37.78 in chips) 
Seat 3: Smashdoge ($66.99 in chips) 
Seat 4: Corlogiro ($50 in chips) 
Seat 5: Ajs Miracle- ($34.88 in chips) 
Seat 6: BALAWA ($14.26 in chips) 
Seat 7: An1an1 ($50.95 in chips) 
Seat 8: Kolyan2114 ($50 in chips) 
Seat 9: nicu4you ($55.14 in chips) 
Agent Cedric: posts small blind $0.25
Smashdoge: posts big blind $0.50
*** HOLE CARDS ***
Corlogiro: folds 
Ajs Miracle-: folds 
BALAWA has timed out
BALAWA: folds 
An1an1: folds 
Kolyan2114: raises $0.75 to $1.25
nicu4you: folds 
eltonmiranda: folds 
Agent Cedric: folds 
Smashdoge: calls $0.75
*** FLOP *** [As Td 7s]
Smashdoge: bets $3.50
Kolyan2114: folds 
Uncalled bet ($3.50) returned to Smashdoge
Smashdoge collected $2.57 from pot
Smashdoge: doesn't show hand 
*** SUMMARY ***
Total pot $2.75 | Rake $0.18 
Board [As Td 7s]
Seat 1: eltonmiranda (button) folded before Flop (didn't bet)
Seat 2: Agent Cedric (small blind) folded before Flop
Seat 3: Smashdoge (big blind) collected ($2.57)
Seat 4: Corlogiro folded before Flop (didn't bet)
Seat 5: Ajs Miracle- folded before Flop (didn't bet)
Seat 6: BALAWA folded before Flop (didn't bet)
Seat 7: An1an1 folded before Flop (didn't bet)
Seat 8: Kolyan2114 folded on the Flop
Seat 9: nicu4you folded before Flop (didn't bet)



PokerStars Hand #228690125798:  Hold'em No Limit ($0.25/$0.50 USD) - 2021/07/30 17:25:09 ET
Table 'Galilea III' 9-max Seat #2 is the button
Seat 1: eltonmiranda ($47.87 in chips) 
Seat 2: Agent Cedric ($37.53 in chips) 
Seat 3: Smashdoge ($68.31 in chips) 
Seat 4: Corlogiro ($50 in chips) 
Seat 5: Ajs Miracle- ($34.88 in chips) 
Seat 6: BALAWA ($14.26 in chips) 
Seat 7: An1an1 ($50.95 in chips) 
Seat 8: Kolyan2114 ($50 in chips) 
Seat 9: nicu4you ($55.14 in chips) 
Smashdoge: posts small blind $0.25
Corlogiro: posts big blind $0.50
*** HOLE CARDS ***
Ajs Miracle-: raises $0.50 to $1
BALAWA: calls $1
An1an1: folds 
Kolyan2114: folds 
nicu4you: folds 
eltonmiranda: folds 
Agent Cedric: calls $1
Smashdoge: calls $0.75
Corlogiro: raises $5 to $6
Ajs Miracle-: calls $5
BALAWA: calls $5
Agent Cedric: calls $5
Smashdoge: folds 
*** FLOP *** [Ts Qh Ah]
Corlogiro: bets $11
Ajs Miracle-: raises $17.88 to $28.88 and is all-in
BALAWA: folds 
Agent Cedric: folds 
Corlogiro: calls $17.88
*** TURN *** [Ts Qh Ah] [2d]
*** RIVER *** [Ts Qh Ah 2d] [6d]
*** SHOW DOWN ***
Corlogiro: shows [Qc As] (two pair, Aces and Queens)
Ajs Miracle-: shows [Kd Ac] (a pair of Aces)
Corlogiro collected $80.26 from pot
*** SUMMARY ***
Total pot $82.76 | Rake $2.50 
Board [Ts Qh Ah 2d 6d]
Seat 1: eltonmiranda folded before Flop (didn't bet)
Seat 2: Agent Cedric (button) folded on the Flop
Seat 3: Smashdoge (small blind) folded before Flop
Seat 4: Corlogiro (big blind) showed [Qc As] and won ($80.26) with two pair, Aces and Queens
Seat 5: Ajs Miracle- showed [Kd Ac] and lost with a pair of Aces
Seat 6: BALAWA folded on the Flop
Seat 7: An1an1 folded before Flop (didn't bet)
Seat 8: Kolyan2114 folded before Flop (didn't bet)
Seat 9: nicu4you folded before Flop (didn't bet)



PokerStars Hand #228690160371:  Hold'em No Limit ($0.25/$0.50 USD) - 2021/07/30 17:26:25 ET
Table 'Galilea III' 9-max Seat #3 is the button
Seat 1: eltonmiranda ($47.87 in chips) 
Seat 2: Agent Cedric ($31.53 in chips) 
Seat 3: Smashdoge ($67.31 in chips) 
Seat 4: Corlogiro ($95.38 in chips) 
Seat 6: BALAWA ($8.26 in chips) 
Seat 7: An1an1 ($50.95 in chips) 
Seat 8: Kolyan2114 ($50 in chips) 
Seat 9: nicu4you ($55.14 in chips) 
Corlogiro: posts small blind $0.25
BALAWA: posts big blind $0.50
*** HOLE CARDS ***
An1an1: folds 
Kolyan2114: folds 
nicu4you: folds 
eltonmiranda: folds 
Agent Cedric: folds 
Smashdoge: folds 
Corlogiro: raises $1 to $1.50
BALAWA: calls $1
*** FLOP *** [As 9c 7c]
Corlogiro: checks 
BALAWA: checks 
*** TURN *** [As 9c 7c] [2c]
Corlogiro: bets $1.50
BALAWA: folds 
Uncalled bet ($1.50) returned to Corlogiro
Corlogiro collected $2.81 from pot
Corlogiro: doesn't show hand 
*** SUMMARY ***
Total pot $3 | Rake $0.19 
Board [As 9c 7c 2c]
Seat 1: eltonmiranda folded before Flop (didn't bet)
Seat 2: Agent Cedric folded before Flop (didn't bet)
Seat 3: Smashdoge (button) folded before Flop (didn't bet)
Seat 4: Corlogiro (small blind) collected ($2.81)
Seat 6: BALAWA (big blind) folded on the Turn
Seat 7: An1an1 folded before Flop (didn't bet)
Seat 8: Kolyan2114 folded before Flop (didn't bet)
Seat 9: nicu4you folded before Flop (didn't bet)



