PokerStars Hand #228682718244:  Hold'em No Limit ($0.25/$0.50 USD) - 2021/07/30 12:43:14 ET
Table 'Rupertwildt II' 9-max Seat #9 is the button
Seat 2: bill1961966 ($50 in chips) 
Seat 3: goldenpig666 ($50 in chips) 
Seat 4: RikaSunPay ($50 in chips) 
Seat 6: Gluck35 ($50 in chips) 
Seat 9: xZaKoNaLx ($50 in chips) 
bill1961966: posts small blind $0.25
goldenpig666: posts big blind $0.50
*** HOLE CARDS ***
phatom-z joins the table at seat #5 
RikaSunPay: folds 
Gluck35: folds 
xZaKoNaLx: folds 
bill1961966: calls $0.25
goldenpig666: checks 
*** FLOP *** [9h 6c Jd]
bill1961966: checks 
lonely fire joins the table at seat #7 
goldenpig666: bets $0.50
AlexEliseev7 joins the table at seat #8 
bill1961966: folds 
Uncalled bet ($0.50) returned to goldenpig666
goldenpig666 collected $0.94 from pot
goldenpig666: doesn't show hand 
*** SUMMARY ***
Total pot $1 | Rake $0.06 
Board [9h 6c Jd]
Seat 2: bill1961966 (small blind) folded on the Flop
Seat 3: goldenpig666 (big blind) collected ($0.94)
Seat 4: RikaSunPay folded before Flop (didn't bet)
Seat 6: Gluck35 folded before Flop (didn't bet)
Seat 9: xZaKoNaLx (button) folded before Flop (didn't bet)



PokerStars Hand #228682731242:  Hold'em No Limit ($0.25/$0.50 USD) - 2021/07/30 12:43:49 ET
Table 'Rupertwildt II' 9-max Seat #2 is the button
Seat 2: bill1961966 ($49.50 in chips) 
Seat 3: goldenpig666 ($50.44 in chips) 
Seat 4: RikaSunPay ($50 in chips) 
Seat 6: Gluck35 ($50 in chips) 
Seat 9: xZaKoNaLx ($50 in chips) 
goldenpig666: posts small blind $0.25
RikaSunPay: posts big blind $0.50
phatom-z: sits out 
lonely fire: sits out 
AlexEliseev7: sits out 
*** HOLE CARDS ***
Gluck35: folds 
xZaKoNaLx: folds 
bill1961966: calls $0.50
goldenpig666: folds 
RikaSunPay: checks 
*** FLOP *** [7s 5s Td]
RikaSunPay: checks 
bill1961966: checks 
*** TURN *** [7s 5s Td] [6h]
RikaSunPay: checks 
bill1961966: checks 
*** RIVER *** [7s 5s Td 6h] [7c]
RikaSunPay: checks 
bill1961966: checks 
*** SHOW DOWN ***
RikaSunPay: shows [3h 3s] (two pair, Sevens and Threes)
bill1961966: shows [4s 4d] (two pair, Sevens and Fours)
bill1961966 collected $1.19 from pot
*** SUMMARY ***
Total pot $1.25 | Rake $0.06 
Board [7s 5s Td 6h 7c]
Seat 2: bill1961966 (button) showed [4s 4d] and won ($1.19) with two pair, Sevens and Fours
Seat 3: goldenpig666 (small blind) folded before Flop
Seat 4: RikaSunPay (big blind) showed [3h 3s] and lost with two pair, Sevens and Threes
Seat 6: Gluck35 folded before Flop (didn't bet)
Seat 9: xZaKoNaLx folded before Flop (didn't bet)



PokerStars Hand #228682742245:  Hold'em No Limit ($0.25/$0.50 USD) - 2021/07/30 12:44:18 ET
Table 'Rupertwildt II' 9-max Seat #3 is the button
Seat 2: bill1961966 ($50.19 in chips) 
Seat 3: goldenpig666 ($50.19 in chips) 
Seat 4: RikaSunPay ($50 in chips) 
Seat 5: phatom-z ($50 in chips) 
Seat 6: Gluck35 ($50 in chips) 
Seat 9: xZaKoNaLx ($50 in chips) 
RikaSunPay: posts small blind $0.25
phatom-z: posts big blind $0.50
lonely fire: sits out 
AlexEliseev7: sits out 
Tverdinya: sits out 
*** HOLE CARDS ***
Gluck35: folds 
xZaKoNaLx: raises $0.60 to $1.10
bill1961966: folds 
goldenpig666: folds 
RikaSunPay: folds 
phatom-z: folds 
Uncalled bet ($0.60) returned to xZaKoNaLx
xZaKoNaLx collected $1.25 from pot
xZaKoNaLx: doesn't show hand 
*** SUMMARY ***
Total pot $1.25 | Rake $0 
Seat 2: bill1961966 folded before Flop (didn't bet)
Seat 3: goldenpig666 (button) folded before Flop (didn't bet)
Seat 4: RikaSunPay (small blind) folded before Flop
Seat 5: phatom-z (big blind) folded before Flop
Seat 6: Gluck35 folded before Flop (didn't bet)
Seat 9: xZaKoNaLx collected ($1.25)



PokerStars Hand #228682748021:  Hold'em No Limit ($0.25/$0.50 USD) - 2021/07/30 12:44:34 ET
Table 'Rupertwildt II' 9-max Seat #4 is the button
Seat 2: bill1961966 ($50.19 in chips) 
Seat 3: goldenpig666 ($50.19 in chips) 
Seat 4: RikaSunPay ($50 in chips) 
Seat 5: phatom-z ($50 in chips) 
Seat 6: Gluck35 ($50 in chips) 
Seat 9: xZaKoNaLx ($50.75 in chips) 
phatom-z: posts small blind $0.25
Gluck35: posts big blind $0.50
lonely fire: sits out 
AlexEliseev7: sits out 
Tverdinya: sits out 
*** HOLE CARDS ***
xZaKoNaLx: raises $0.60 to $1.10
bill1961966: folds 
goldenpig666: folds 
RikaSunPay: folds 
phatom-z: folds 
Gluck35: folds 
Uncalled bet ($0.60) returned to xZaKoNaLx
xZaKoNaLx collected $1.25 from pot
xZaKoNaLx: doesn't show hand 
*** SUMMARY ***
Total pot $1.25 | Rake $0 
Seat 2: bill1961966 folded before Flop (didn't bet)
Seat 3: goldenpig666 folded before Flop (didn't bet)
Seat 4: RikaSunPay (button) folded before Flop (didn't bet)
Seat 5: phatom-z (small blind) folded before Flop
Seat 6: Gluck35 (big blind) folded before Flop
Seat 9: xZaKoNaLx collected ($1.25)



PokerStars Hand #228682751697:  Hold'em No Limit ($0.25/$0.50 USD) - 2021/07/30 12:44:44 ET
Table 'Rupertwildt II' 9-max Seat #5 is the button
Seat 2: bill1961966 ($50.19 in chips) 
Seat 3: goldenpig666 ($50.19 in chips) 
Seat 4: RikaSunPay ($50 in chips) 
Seat 5: phatom-z ($50 in chips) 
Seat 6: Gluck35 ($50 in chips) 
Seat 7: lonely fire ($50 in chips) 
Seat 9: xZaKoNaLx ($51.50 in chips) 
Gluck35: posts small blind $0.25
lonely fire: posts big blind $0.50
AlexEliseev7: sits out 
Tverdinya: sits out 
*** HOLE CARDS ***
xZaKoNaLx: folds 
bill1961966: folds 
goldenpig666: folds 
RikaSunPay: folds 
phatom-z: calls $0.50
Gluck35: folds 
lonely fire: checks 
*** FLOP *** [2c Jd Jc]
lonely fire: checks 
phatom-z: bets $0.50
lonely fire: calls $0.50
*** TURN *** [2c Jd Jc] [3d]
lonely fire: checks 
phatom-z: bets $1.60
lonely fire: folds 
Uncalled bet ($1.60) returned to phatom-z
phatom-z collected $2.14 from pot
phatom-z: doesn't show hand 
*** SUMMARY ***
Total pot $2.25 | Rake $0.11 
Board [2c Jd Jc 3d]
Seat 2: bill1961966 folded before Flop (didn't bet)
Seat 3: goldenpig666 folded before Flop (didn't bet)
Seat 4: RikaSunPay folded before Flop (didn't bet)
Seat 5: phatom-z (button) collected ($2.14)
Seat 6: Gluck35 (small blind) folded before Flop
Seat 7: lonely fire (big blind) folded on the Turn
Seat 9: xZaKoNaLx folded before Flop (didn't bet)



PokerStars Hand #228682760366:  Hold'em No Limit ($0.25/$0.50 USD) - 2021/07/30 12:45:07 ET
Table 'Rupertwildt II' 9-max Seat #6 is the button
Seat 2: bill1961966 ($50.19 in chips) 
Seat 3: goldenpig666 ($50.19 in chips) 
Seat 4: RikaSunPay ($50 in chips) 
Seat 5: phatom-z ($51.14 in chips) 
Seat 6: Gluck35 ($50 in chips) 
Seat 7: lonely fire ($50 in chips) 
Seat 8: AlexEliseev7 ($50 in chips) 
Seat 9: xZaKoNaLx ($51.50 in chips) 
lonely fire: posts small blind $0.25
AlexEliseev7: posts big blind $0.50
Tverdinya: sits out 
*** HOLE CARDS ***
xZaKoNaLx: folds 
bill1961966: raises $1 to $1.50
goldenpig666: folds 
RikaSunPay: folds 
phatom-z: folds 
Gluck35: folds 
lonely fire: folds 
AlexEliseev7: calls $1
*** FLOP *** [Qc 8s 8c]
AlexEliseev7: checks 
bill1961966: bets $1
xZaKoNaLx leaves the table
jackr6793 joins the table at seat #9 
AlexEliseev7: calls $1
*** TURN *** [Qc 8s 8c] [3c]
AlexEliseev7: checks 
bill1961966: checks 
*** RIVER *** [Qc 8s 8c 3c] [Ks]
AlexEliseev7: bets $3.99
bill1961966: folds 
Uncalled bet ($3.99) returned to AlexEliseev7
AlexEliseev7 collected $4.99 from pot
AlexEliseev7: doesn't show hand 
*** SUMMARY ***
Total pot $5.25 | Rake $0.26 
Board [Qc 8s 8c 3c Ks]
Seat 2: bill1961966 folded on the River
Seat 3: goldenpig666 folded before Flop (didn't bet)
Seat 4: RikaSunPay folded before Flop (didn't bet)
Seat 5: phatom-z folded before Flop (didn't bet)
Seat 6: Gluck35 (button) folded before Flop (didn't bet)
Seat 7: lonely fire (small blind) folded before Flop
Seat 8: AlexEliseev7 (big blind) collected ($4.99)
Seat 9: xZaKoNaLx folded before Flop (didn't bet)



PokerStars Hand #228682782156:  Hold'em No Limit ($0.25/$0.50 USD) - 2021/07/30 12:45:59 ET
Table 'Rupertwildt II' 9-max Seat #7 is the button
Seat 2: bill1961966 ($47.69 in chips) 
Seat 3: goldenpig666 ($50.19 in chips) 
Seat 4: RikaSunPay ($50 in chips) 
Seat 5: phatom-z ($51.14 in chips) 
Seat 6: Gluck35 ($50 in chips) 
Seat 7: lonely fire ($50 in chips) 
Seat 8: AlexEliseev7 ($52.49 in chips) 
Seat 9: jackr6793 ($50 in chips) 
AlexEliseev7: posts small blind $0.25
jackr6793: posts big blind $0.50
Tverdinya: sits out 
*** HOLE CARDS ***
bill1961966: folds 
goldenpig666: folds 
RikaSunPay: folds 
phatom-z: folds 
Gluck35: raises $0.75 to $1.25
lonely fire: folds 
AlexEliseev7: folds 
jackr6793: folds 
Uncalled bet ($0.75) returned to Gluck35
Gluck35 collected $1.25 from pot
Gluck35: doesn't show hand 
*** SUMMARY ***
Total pot $1.25 | Rake $0 
Seat 2: bill1961966 folded before Flop (didn't bet)
Seat 3: goldenpig666 folded before Flop (didn't bet)
Seat 4: RikaSunPay folded before Flop (didn't bet)
Seat 5: phatom-z folded before Flop (didn't bet)
Seat 6: Gluck35 collected ($1.25)
Seat 7: lonely fire (button) folded before Flop (didn't bet)
Seat 8: AlexEliseev7 (small blind) folded before Flop
Seat 9: jackr6793 (big blind) folded before Flop



PokerStars Hand #228682790583:  Hold'em No Limit ($0.25/$0.50 USD) - 2021/07/30 12:46:21 ET
Table 'Rupertwildt II' 9-max Seat #8 is the button
Seat 1: Tverdinya ($50 in chips) 
Seat 2: bill1961966 ($47.69 in chips) 
Seat 3: goldenpig666 ($50.19 in chips) 
Seat 4: RikaSunPay ($50 in chips) 
Seat 5: phatom-z ($51.14 in chips) 
Seat 6: Gluck35 ($50.75 in chips) 
Seat 7: lonely fire ($50 in chips) 
Seat 8: AlexEliseev7 ($52.24 in chips) 
Seat 9: jackr6793 ($49.50 in chips) 
jackr6793: posts small blind $0.25
Tverdinya: posts big blind $0.50
*** HOLE CARDS ***
bill1961966: folds 
goldenpig666: raises $1 to $1.50
RikaSunPay: folds 
phatom-z: folds 
Gluck35: folds 
lonely fire: folds 
AlexEliseev7: folds 
jackr6793: folds 
Tverdinya: folds 
Uncalled bet ($1) returned to goldenpig666
goldenpig666 collected $1.25 from pot
goldenpig666: doesn't show hand 
*** SUMMARY ***
Total pot $1.25 | Rake $0 
Seat 1: Tverdinya (big blind) folded before Flop
Seat 2: bill1961966 folded before Flop (didn't bet)
Seat 3: goldenpig666 collected ($1.25)
Seat 4: RikaSunPay folded before Flop (didn't bet)
Seat 5: phatom-z folded before Flop (didn't bet)
Seat 6: Gluck35 folded before Flop (didn't bet)
Seat 7: lonely fire folded before Flop (didn't bet)
Seat 8: AlexEliseev7 (button) folded before Flop (didn't bet)
Seat 9: jackr6793 (small blind) folded before Flop



PokerStars Hand #228682796920:  Hold'em No Limit ($0.25/$0.50 USD) - 2021/07/30 12:46:38 ET
Table 'Rupertwildt II' 9-max Seat #9 is the button
Seat 1: Tverdinya ($50 in chips) 
Seat 2: bill1961966 ($47.69 in chips) 
Seat 3: goldenpig666 ($50.94 in chips) 
Seat 4: RikaSunPay ($50 in chips) 
Seat 5: phatom-z ($51.14 in chips) 
Seat 6: Gluck35 ($50.75 in chips) 
Seat 7: lonely fire ($50 in chips) 
Seat 8: AlexEliseev7 ($52.24 in chips) 
Seat 9: jackr6793 ($49.25 in chips) 
Tverdinya: posts small blind $0.25
bill1961966: posts big blind $0.50
*** HOLE CARDS ***
goldenpig666: folds 
RikaSunPay: folds 
phatom-z: folds 
Gluck35: raises $0.75 to $1.25
lonely fire: folds 
AlexEliseev7: folds 
jackr6793: folds 
Tverdinya: folds 
bill1961966: calls $0.75
*** FLOP *** [Qh 2d Td]
bill1961966: checks 
Gluck35: checks 
*** TURN *** [Qh 2d Td] [Kh]
bill1961966: checks 
Gluck35: checks 
*** RIVER *** [Qh 2d Td Kh] [Qd]
bill1961966: checks 
Gluck35: checks 
*** SHOW DOWN ***
bill1961966: shows [4s 8s] (a pair of Queens)
Gluck35: shows [9c 9s] (two pair, Queens and Nines)
Gluck35 collected $2.61 from pot
*** SUMMARY ***
Total pot $2.75 | Rake $0.14 
Board [Qh 2d Td Kh Qd]
Seat 1: Tverdinya (small blind) folded before Flop
Seat 2: bill1961966 (big blind) showed [4s 8s] and lost with a pair of Queens
Seat 3: goldenpig666 folded before Flop (didn't bet)
Seat 4: RikaSunPay folded before Flop (didn't bet)
Seat 5: phatom-z folded before Flop (didn't bet)
Seat 6: Gluck35 showed [9c 9s] and won ($2.61) with two pair, Queens and Nines
Seat 7: lonely fire folded before Flop (didn't bet)
Seat 8: AlexEliseev7 folded before Flop (didn't bet)
Seat 9: jackr6793 (button) folded before Flop (didn't bet)



PokerStars Hand #228682816248:  Hold'em No Limit ($0.25/$0.50 USD) - 2021/07/30 12:47:29 ET
Table 'Rupertwildt II' 9-max Seat #1 is the button
Seat 1: Tverdinya ($50 in chips) 
Seat 2: bill1961966 ($46.44 in chips) 
Seat 3: goldenpig666 ($50.94 in chips) 
Seat 4: RikaSunPay ($50 in chips) 
Seat 5: phatom-z ($51.14 in chips) 
Seat 6: Gluck35 ($52.11 in chips) 
Seat 7: lonely fire ($50 in chips) 
Seat 8: AlexEliseev7 ($52.24 in chips) 
Seat 9: jackr6793 ($49.25 in chips) 
bill1961966: posts small blind $0.25
goldenpig666: posts big blind $0.50
*** HOLE CARDS ***
RikaSunPay: folds 
phatom-z: folds 
Gluck35: folds 
lonely fire: folds 
AlexEliseev7: folds 
jackr6793: folds 
Tverdinya: folds 
bill1961966: calls $0.25
goldenpig666: raises $1.50 to $2
bill1961966: calls $1.50
*** FLOP *** [Kd Ah 9d]
bill1961966: checks 
goldenpig666: bets $2.47
bill1961966: calls $2.47
*** TURN *** [Kd Ah 9d] [Qh]
bill1961966: checks 
goldenpig666: checks 
*** RIVER *** [Kd Ah 9d Qh] [5c]
bill1961966: checks 
goldenpig666: checks 
*** SHOW DOWN ***
bill1961966: shows [As 4d] (a pair of Aces)
goldenpig666: mucks hand 
bill1961966 collected $8.49 from pot
*** SUMMARY ***
Total pot $8.94 | Rake $0.45 
Board [Kd Ah 9d Qh 5c]
Seat 1: Tverdinya (button) folded before Flop (didn't bet)
Seat 2: bill1961966 (small blind) showed [As 4d] and won ($8.49) with a pair of Aces
Seat 3: goldenpig666 (big blind) mucked
Seat 4: RikaSunPay folded before Flop (didn't bet)
Seat 5: phatom-z folded before Flop (didn't bet)
Seat 6: Gluck35 folded before Flop (didn't bet)
Seat 7: lonely fire folded before Flop (didn't bet)
Seat 8: AlexEliseev7 folded before Flop (didn't bet)
Seat 9: jackr6793 folded before Flop (didn't bet)



PokerStars Hand #228682833221:  Hold'em No Limit ($0.25/$0.50 USD) - 2021/07/30 12:48:14 ET
Table 'Rupertwildt II' 9-max Seat #2 is the button
Seat 1: Tverdinya ($50 in chips) 
Seat 2: bill1961966 ($50.46 in chips) 
Seat 3: goldenpig666 ($50 in chips) 
Seat 4: RikaSunPay ($50 in chips) 
Seat 5: phatom-z ($51.14 in chips) 
Seat 6: Gluck35 ($52.11 in chips) 
Seat 7: lonely fire ($50 in chips) 
Seat 8: AlexEliseev7 ($52.24 in chips) 
Seat 9: jackr6793 ($49.25 in chips) 
goldenpig666: posts small blind $0.25
RikaSunPay: posts big blind $0.50
*** HOLE CARDS ***
phatom-z: folds 
Gluck35: raises $0.75 to $1.25
lonely fire: folds 
AlexEliseev7: folds 
jackr6793: folds 
Tverdinya: calls $1.25
bill1961966: folds 
goldenpig666: folds 
RikaSunPay: calls $0.75
*** FLOP *** [4c 2c 8s]
RikaSunPay: checks 
Gluck35: bets $1.25
Tverdinya: calls $1.25
RikaSunPay: calls $1.25
*** TURN *** [4c 2c 8s] [5h]
RikaSunPay: checks 
Gluck35: bets $2.43
Tverdinya: raises $4.57 to $7
RikaSunPay: folds 
Gluck35: folds 
Uncalled bet ($4.57) returned to Tverdinya
Tverdinya collected $11.98 from pot
Tverdinya: doesn't show hand 
*** SUMMARY ***
Total pot $12.61 | Rake $0.63 
Board [4c 2c 8s 5h]
Seat 1: Tverdinya collected ($11.98)
Seat 2: bill1961966 (button) folded before Flop (didn't bet)
Seat 3: goldenpig666 (small blind) folded before Flop
Seat 4: RikaSunPay (big blind) folded on the Turn
Seat 5: phatom-z folded before Flop (didn't bet)
Seat 6: Gluck35 folded on the Turn
Seat 7: lonely fire folded before Flop (didn't bet)
Seat 8: AlexEliseev7 folded before Flop (didn't bet)
Seat 9: jackr6793 folded before Flop (didn't bet)



PokerStars Hand #228682864757:  Hold'em No Limit ($0.25/$0.50 USD) - 2021/07/30 12:49:37 ET
Table 'Rupertwildt II' 9-max Seat #3 is the button
Seat 1: Tverdinya ($57.05 in chips) 
Seat 2: bill1961966 ($50.46 in chips) 
Seat 3: goldenpig666 ($50 in chips) 
Seat 4: RikaSunPay ($50 in chips) 
Seat 5: phatom-z ($51.14 in chips) 
Seat 6: Gluck35 ($50 in chips) 
Seat 7: lonely fire ($50 in chips) 
Seat 8: AlexEliseev7 ($52.24 in chips) 
Seat 9: jackr6793 ($49.25 in chips) 
RikaSunPay: posts small blind $0.25
phatom-z: posts big blind $0.50
*** HOLE CARDS ***
Gluck35: folds 
lonely fire: raises $1 to $1.50
AlexEliseev7: folds 
jackr6793: folds 
Tverdinya: folds 
bill1961966: folds 
goldenpig666: folds 
RikaSunPay: folds 
phatom-z: folds 
Uncalled bet ($1) returned to lonely fire
lonely fire collected $1.25 from pot
lonely fire: doesn't show hand 
*** SUMMARY ***
Total pot $1.25 | Rake $0 
Seat 1: Tverdinya folded before Flop (didn't bet)
Seat 2: bill1961966 folded before Flop (didn't bet)
Seat 3: goldenpig666 (button) folded before Flop (didn't bet)
Seat 4: RikaSunPay (small blind) folded before Flop
Seat 5: phatom-z (big blind) folded before Flop
Seat 6: Gluck35 folded before Flop (didn't bet)
Seat 7: lonely fire collected ($1.25)
Seat 8: AlexEliseev7 folded before Flop (didn't bet)
Seat 9: jackr6793 folded before Flop (didn't bet)



PokerStars Hand #228682877161:  Hold'em No Limit ($0.25/$0.50 USD) - 2021/07/30 12:50:10 ET
Table 'Rupertwildt II' 9-max Seat #4 is the button
Seat 1: Tverdinya ($57.05 in chips) 
Seat 2: bill1961966 ($50.46 in chips) 
Seat 3: goldenpig666 ($50 in chips) 
Seat 4: RikaSunPay ($50 in chips) 
Seat 5: phatom-z ($50.64 in chips) 
Seat 6: Gluck35 ($50 in chips) 
Seat 7: lonely fire ($50.75 in chips) 
Seat 8: AlexEliseev7 ($52.24 in chips) 
Seat 9: jackr6793 ($49.25 in chips) 
phatom-z: posts small blind $0.25
Gluck35: posts big blind $0.50
*** HOLE CARDS ***
lonely fire: folds 
AlexEliseev7: folds 
jackr6793: calls $0.50
Tverdinya: raises $1.50 to $2
bill1961966: calls $2
goldenpig666: folds 
RikaSunPay: folds 
phatom-z: folds 
Gluck35: folds 
jackr6793: calls $1.50
*** FLOP *** [8h Jh 3s]
jackr6793: checks 
Tverdinya: bets $2.12
bill1961966: folds 
jackr6793: calls $2.12
*** TURN *** [8h Jh 3s] [5c]
jackr6793: checks 
Tverdinya: bets $9
jackr6793: folds 
Uncalled bet ($9) returned to Tverdinya
Tverdinya collected $10.44 from pot
Tverdinya: doesn't show hand 
*** SUMMARY ***
Total pot $10.99 | Rake $0.55 
Board [8h Jh 3s 5c]
Seat 1: Tverdinya collected ($10.44)
Seat 2: bill1961966 folded on the Flop
Seat 3: goldenpig666 folded before Flop (didn't bet)
Seat 4: RikaSunPay (button) folded before Flop (didn't bet)
Seat 5: phatom-z (small blind) folded before Flop
Seat 6: Gluck35 (big blind) folded before Flop
Seat 7: lonely fire folded before Flop (didn't bet)
Seat 8: AlexEliseev7 folded before Flop (didn't bet)
Seat 9: jackr6793 folded on the Turn



PokerStars Hand #228682893485:  Hold'em No Limit ($0.25/$0.50 USD) - 2021/07/30 12:50:53 ET
Table 'Rupertwildt II' 9-max Seat #5 is the button
Seat 1: Tverdinya ($63.37 in chips) 
Seat 2: bill1961966 ($48.46 in chips) 
Seat 3: goldenpig666 ($50 in chips) 
Seat 4: RikaSunPay ($50 in chips) 
Seat 5: phatom-z ($50.39 in chips) 
Seat 6: Gluck35 ($50 in chips) 
Seat 7: lonely fire ($50.75 in chips) 
Seat 8: AlexEliseev7 ($52.24 in chips) 
Seat 9: jackr6793 ($45.13 in chips) 
Gluck35: posts small blind $0.25
lonely fire: posts big blind $0.50
*** HOLE CARDS ***
AlexEliseev7: folds 
jackr6793: folds 
Tverdinya: raises $0.75 to $1.25
bill1961966: folds 
goldenpig666: folds 
RikaSunPay: folds 
phatom-z: folds 
Gluck35: folds 
lonely fire: calls $0.75
*** FLOP *** [As Jd Th]
lonely fire: checks 
Tverdinya: bets $2
lonely fire: folds 
Uncalled bet ($2) returned to Tverdinya
Tverdinya collected $2.61 from pot
Tverdinya: doesn't show hand 
*** SUMMARY ***
Total pot $2.75 | Rake $0.14 
Board [As Jd Th]
Seat 1: Tverdinya collected ($2.61)
Seat 2: bill1961966 folded before Flop (didn't bet)
Seat 3: goldenpig666 folded before Flop (didn't bet)
Seat 4: RikaSunPay folded before Flop (didn't bet)
Seat 5: phatom-z (button) folded before Flop (didn't bet)
Seat 6: Gluck35 (small blind) folded before Flop
Seat 7: lonely fire (big blind) folded on the Flop
Seat 8: AlexEliseev7 folded before Flop (didn't bet)
Seat 9: jackr6793 folded before Flop (didn't bet)



PokerStars Hand #228682901252:  Hold'em No Limit ($0.25/$0.50 USD) - 2021/07/30 12:51:13 ET
Table 'Rupertwildt II' 9-max Seat #6 is the button
Seat 1: Tverdinya ($64.73 in chips) 
Seat 2: bill1961966 ($48.46 in chips) 
Seat 3: goldenpig666 ($50 in chips) 
Seat 4: RikaSunPay ($50 in chips) 
Seat 5: phatom-z ($50.39 in chips) 
Seat 6: Gluck35 ($50 in chips) 
Seat 7: lonely fire ($50 in chips) 
Seat 8: AlexEliseev7 ($52.24 in chips) 
Seat 9: jackr6793 ($45.13 in chips) 
lonely fire: posts small blind $0.25
AlexEliseev7: posts big blind $0.50
*** HOLE CARDS ***
jackr6793: calls $0.50
Tverdinya: folds 
bill1961966: calls $0.50
goldenpig666: folds 
RikaSunPay: folds 
phatom-z: folds 
Gluck35: calls $0.50
lonely fire: calls $0.25
AlexEliseev7: checks 
*** FLOP *** [4h 3c Tc]
lonely fire: checks 
AlexEliseev7: checks 
jackr6793: bets $2.38
bill1961966: folds 
Gluck35: folds 
lonely fire: folds 
AlexEliseev7: folds 
Uncalled bet ($2.38) returned to jackr6793
jackr6793 collected $2.38 from pot
jackr6793: doesn't show hand 
*** SUMMARY ***
Total pot $2.50 | Rake $0.12 
Board [4h 3c Tc]
Seat 1: Tverdinya folded before Flop (didn't bet)
Seat 2: bill1961966 folded on the Flop
Seat 3: goldenpig666 folded before Flop (didn't bet)
Seat 4: RikaSunPay folded before Flop (didn't bet)
Seat 5: phatom-z folded before Flop (didn't bet)
Seat 6: Gluck35 (button) folded on the Flop
Seat 7: lonely fire (small blind) folded on the Flop
Seat 8: AlexEliseev7 (big blind) folded on the Flop
Seat 9: jackr6793 collected ($2.38)



PokerStars Hand #228682916845:  Hold'em No Limit ($0.25/$0.50 USD) - 2021/07/30 12:51:54 ET
Table 'Rupertwildt II' 9-max Seat #7 is the button
Seat 1: Tverdinya ($64.73 in chips) 
Seat 2: bill1961966 ($47.96 in chips) 
Seat 3: goldenpig666 ($50 in chips) 
Seat 4: RikaSunPay ($50 in chips) 
Seat 5: phatom-z ($50.39 in chips) 
Seat 6: Gluck35 ($50 in chips) 
Seat 7: lonely fire ($50 in chips) 
Seat 8: AlexEliseev7 ($51.74 in chips) 
Seat 9: jackr6793 ($47.01 in chips) 
AlexEliseev7: posts small blind $0.25
jackr6793: posts big blind $0.50
*** HOLE CARDS ***
Tverdinya: folds 
bill1961966: folds 
goldenpig666: folds 
RikaSunPay: folds 
phatom-z: folds 
Gluck35: folds 
lonely fire: raises $0.75 to $1.25
AlexEliseev7: folds 
jackr6793: folds 
Uncalled bet ($0.75) returned to lonely fire
lonely fire collected $1.25 from pot
lonely fire: doesn't show hand 
*** SUMMARY ***
Total pot $1.25 | Rake $0 
Seat 1: Tverdinya folded before Flop (didn't bet)
Seat 2: bill1961966 folded before Flop (didn't bet)
Seat 3: goldenpig666 folded before Flop (didn't bet)
Seat 4: RikaSunPay folded before Flop (didn't bet)
Seat 5: phatom-z folded before Flop (didn't bet)
Seat 6: Gluck35 folded before Flop (didn't bet)
Seat 7: lonely fire (button) collected ($1.25)
Seat 8: AlexEliseev7 (small blind) folded before Flop
Seat 9: jackr6793 (big blind) folded before Flop



PokerStars Hand #228682923609:  Hold'em No Limit ($0.25/$0.50 USD) - 2021/07/30 12:52:12 ET
Table 'Rupertwildt II' 9-max Seat #8 is the button
Seat 1: Tverdinya ($64.73 in chips) 
Seat 2: bill1961966 ($47.96 in chips) 
Seat 3: goldenpig666 ($50 in chips) 
Seat 4: RikaSunPay ($50 in chips) 
Seat 5: phatom-z ($50.39 in chips) 
Seat 6: Gluck35 ($50 in chips) 
Seat 7: lonely fire ($50.75 in chips) 
Seat 8: AlexEliseev7 ($51.49 in chips) 
Seat 9: jackr6793 ($46.51 in chips) 
jackr6793: posts small blind $0.25
Tverdinya: posts big blind $0.50
*** HOLE CARDS ***
bill1961966: raises $3 to $3.50
goldenpig666: raises $4 to $7.50
RikaSunPay: folds 
phatom-z: folds 
Gluck35: folds 
lonely fire: folds 
AlexEliseev7: folds 
jackr6793: folds 
Tverdinya: folds 
bill1961966: calls $4
*** FLOP *** [4c 3d 9h]
bill1961966: checks 
goldenpig666: bets $5
bill1961966: calls $5
*** TURN *** [4c 3d 9h] [Th]
bill1961966: checks 
goldenpig666: checks 
*** RIVER *** [4c 3d 9h Th] [4d]
bill1961966: bets $10
goldenpig666: folds 
Uncalled bet ($10) returned to bill1961966
bill1961966 collected $24.46 from pot
bill1961966: doesn't show hand 
*** SUMMARY ***
Total pot $25.75 | Rake $1.29 
Board [4c 3d 9h Th 4d]
Seat 1: Tverdinya (big blind) folded before Flop
Seat 2: bill1961966 collected ($24.46)
Seat 3: goldenpig666 folded on the River
Seat 4: RikaSunPay folded before Flop (didn't bet)
Seat 5: phatom-z folded before Flop (didn't bet)
Seat 6: Gluck35 folded before Flop (didn't bet)
Seat 7: lonely fire folded before Flop (didn't bet)
Seat 8: AlexEliseev7 (button) folded before Flop (didn't bet)
Seat 9: jackr6793 (small blind) folded before Flop



PokerStars Hand #228682951586:  Hold'em No Limit ($0.25/$0.50 USD) - 2021/07/30 12:53:26 ET
Table 'Rupertwildt II' 9-max Seat #9 is the button
Seat 1: Tverdinya ($64.23 in chips) 
Seat 2: bill1961966 ($59.92 in chips) 
Seat 3: goldenpig666 ($50 in chips) 
Seat 4: RikaSunPay ($50 in chips) 
Seat 5: phatom-z ($50.39 in chips) 
Seat 6: Gluck35 ($50 in chips) 
Seat 7: lonely fire ($50.75 in chips) 
Seat 8: AlexEliseev7 ($51.49 in chips) 
Seat 9: jackr6793 ($46.26 in chips) 
Tverdinya: posts small blind $0.25
bill1961966: posts big blind $0.50
*** HOLE CARDS ***
goldenpig666: folds 
RikaSunPay: folds 
phatom-z: folds 
Gluck35: folds 
lonely fire: folds 
AlexEliseev7: folds 
jackr6793: raises $1 to $1.50
Tverdinya: calls $1.25
bill1961966: calls $1
*** FLOP *** [Td Kc Jh]
Tverdinya: checks 
bill1961966: checks 
jackr6793: checks 
*** TURN *** [Td Kc Jh] [Qs]
Tverdinya: bets $1.50
bill1961966: raises $56.92 to $58.42 and is all-in
jackr6793: calls $44.76 and is all-in
Tverdinya: calls $56.92
*** RIVER *** [Td Kc Jh Qs] [6s]
*** SHOW DOWN ***
Tverdinya: shows [Jd As] (a straight, Ten to Ace)
bill1961966: shows [2c Ah] (a straight, Ten to Ace)
Tverdinya collected $13.66 from side pot
bill1961966 collected $13.66 from side pot
jackr6793: shows [5s Ac] (a straight, Ten to Ace)
Tverdinya collected $45.60 from main pot
bill1961966 collected $45.59 from main pot
jackr6793 collected $45.59 from main pot
*** SUMMARY ***
Total pot $166.10 Main pot $136.78. Side pot $27.32. | Rake $2 
Board [Td Kc Jh Qs 6s]
Seat 1: Tverdinya (small blind) showed [Jd As] and won ($59.26) with a straight, Ten to Ace
Seat 2: bill1961966 (big blind) showed [2c Ah] and won ($59.25) with a straight, Ten to Ace
Seat 3: goldenpig666 folded before Flop (didn't bet)
Seat 4: RikaSunPay folded before Flop (didn't bet)
Seat 5: phatom-z folded before Flop (didn't bet)
Seat 6: Gluck35 folded before Flop (didn't bet)
Seat 7: lonely fire folded before Flop (didn't bet)
Seat 8: AlexEliseev7 folded before Flop (didn't bet)
Seat 9: jackr6793 (button) showed [5s Ac] and won ($45.59) with a straight, Ten to Ace



PokerStars Hand #228682974215:  Hold'em No Limit ($0.25/$0.50 USD) - 2021/07/30 12:54:26 ET
Table 'Rupertwildt II' 9-max Seat #1 is the button
Seat 1: Tverdinya ($63.57 in chips) 
Seat 2: bill1961966 ($59.25 in chips) 
Seat 3: goldenpig666 ($50 in chips) 
Seat 4: RikaSunPay ($50 in chips) 
Seat 5: phatom-z ($50.39 in chips) 
Seat 6: Gluck35 ($50 in chips) 
Seat 7: lonely fire ($50.75 in chips) 
Seat 8: AlexEliseev7 ($51.49 in chips) 
Seat 9: jackr6793 ($45.59 in chips) 
bill1961966: posts small blind $0.25
goldenpig666: posts big blind $0.50
*** HOLE CARDS ***
RikaSunPay: folds 
phatom-z: folds 
Gluck35: folds 
lonely fire: raises $1 to $1.50
AlexEliseev7: folds 
jackr6793: folds 
Tverdinya: folds 
bill1961966: folds 
goldenpig666: folds 
Uncalled bet ($1) returned to lonely fire
lonely fire collected $1.25 from pot
lonely fire: doesn't show hand 
*** SUMMARY ***
Total pot $1.25 | Rake $0 
Seat 1: Tverdinya (button) folded before Flop (didn't bet)
Seat 2: bill1961966 (small blind) folded before Flop
Seat 3: goldenpig666 (big blind) folded before Flop
Seat 4: RikaSunPay folded before Flop (didn't bet)
Seat 5: phatom-z folded before Flop (didn't bet)
Seat 6: Gluck35 folded before Flop (didn't bet)
Seat 7: lonely fire collected ($1.25)
Seat 8: AlexEliseev7 folded before Flop (didn't bet)
Seat 9: jackr6793 folded before Flop (didn't bet)



PokerStars Hand #228682986389:  Hold'em No Limit ($0.25/$0.50 USD) - 2021/07/30 12:54:58 ET
Table 'Rupertwildt II' 9-max Seat #2 is the button
Seat 1: Tverdinya ($63.57 in chips) 
Seat 2: bill1961966 ($59 in chips) 
Seat 3: goldenpig666 ($50 in chips) 
Seat 4: RikaSunPay ($50 in chips) 
Seat 5: phatom-z ($50.39 in chips) 
Seat 6: Gluck35 ($50 in chips) 
Seat 7: lonely fire ($51.50 in chips) 
Seat 8: AlexEliseev7 ($51.49 in chips) 
Seat 9: jackr6793 ($45.59 in chips) 
goldenpig666: posts small blind $0.25
RikaSunPay: posts big blind $0.50
*** HOLE CARDS ***
phatom-z: raises $1 to $1.50
Gluck35: folds 
lonely fire: folds 
AlexEliseev7: folds 
jackr6793: folds 
Tverdinya: folds 
bill1961966: folds 
goldenpig666: folds 
RikaSunPay: folds 
Uncalled bet ($1) returned to phatom-z
phatom-z collected $1.25 from pot
phatom-z: doesn't show hand 
*** SUMMARY ***
Total pot $1.25 | Rake $0 
Seat 1: Tverdinya folded before Flop (didn't bet)
Seat 2: bill1961966 (button) folded before Flop (didn't bet)
Seat 3: goldenpig666 (small blind) folded before Flop
Seat 4: RikaSunPay (big blind) folded before Flop
Seat 5: phatom-z collected ($1.25)
Seat 6: Gluck35 folded before Flop (didn't bet)
Seat 7: lonely fire folded before Flop (didn't bet)
Seat 8: AlexEliseev7 folded before Flop (didn't bet)
Seat 9: jackr6793 folded before Flop (didn't bet)



PokerStars Hand #228682993392:  Hold'em No Limit ($0.25/$0.50 USD) - 2021/07/30 12:55:19 ET
Table 'Rupertwildt II' 9-max Seat #3 is the button
Seat 1: Tverdinya ($63.57 in chips) 
Seat 2: bill1961966 ($59 in chips) 
Seat 3: goldenpig666 ($50 in chips) 
Seat 4: RikaSunPay ($50 in chips) 
Seat 5: phatom-z ($51.14 in chips) 
Seat 6: Gluck35 ($50 in chips) 
Seat 7: lonely fire ($51.50 in chips) 
Seat 8: AlexEliseev7 ($51.49 in chips) 
Seat 9: jackr6793 ($45.59 in chips) 
RikaSunPay: posts small blind $0.25
phatom-z: posts big blind $0.50
*** HOLE CARDS ***
Gluck35: folds 
lonely fire: folds 
AlexEliseev7: folds 
jackr6793: folds 
Tverdinya: raises $0.75 to $1.25
bill1961966: folds 
goldenpig666: folds 
RikaSunPay: folds 
phatom-z: folds 
Uncalled bet ($0.75) returned to Tverdinya
Tverdinya collected $1.25 from pot
Tverdinya: doesn't show hand 
*** SUMMARY ***
Total pot $1.25 | Rake $0 
Seat 1: Tverdinya collected ($1.25)
Seat 2: bill1961966 folded before Flop (didn't bet)
Seat 3: goldenpig666 (button) folded before Flop (didn't bet)
Seat 4: RikaSunPay (small blind) folded before Flop
Seat 5: phatom-z (big blind) folded before Flop
Seat 6: Gluck35 folded before Flop (didn't bet)
Seat 7: lonely fire folded before Flop (didn't bet)
Seat 8: AlexEliseev7 folded before Flop (didn't bet)
Seat 9: jackr6793 folded before Flop (didn't bet)



PokerStars Hand #228683002923:  Hold'em No Limit ($0.25/$0.50 USD) - 2021/07/30 12:55:52 ET
Table 'Rupertwildt II' 9-max Seat #4 is the button
Seat 1: Tverdinya ($64.32 in chips) 
Seat 2: bill1961966 ($59 in chips) 
Seat 3: goldenpig666 ($50 in chips) 
Seat 4: RikaSunPay ($50 in chips) 
Seat 5: phatom-z ($50.64 in chips) 
Seat 6: Gluck35 ($50 in chips) 
Seat 7: lonely fire ($51.50 in chips) 
Seat 8: AlexEliseev7 ($51.49 in chips) 
Seat 9: jackr6793 ($45.59 in chips) 
phatom-z: posts small blind $0.25
Gluck35: posts big blind $0.50
*** HOLE CARDS ***
lonely fire: folds 
AlexEliseev7: folds 
jackr6793: folds 
Tverdinya: folds 
bill1961966: folds 
goldenpig666: raises $0.75 to $1.25
RikaSunPay: folds 
phatom-z: raises $3.50 to $4.75
Gluck35: folds 
goldenpig666: folds 
Uncalled bet ($3.50) returned to phatom-z
phatom-z collected $3 from pot
phatom-z: doesn't show hand 
*** SUMMARY ***
Total pot $3 | Rake $0 
Seat 1: Tverdinya folded before Flop (didn't bet)
Seat 2: bill1961966 folded before Flop (didn't bet)
Seat 3: goldenpig666 folded before Flop
Seat 4: RikaSunPay (button) folded before Flop (didn't bet)
Seat 5: phatom-z (small blind) collected ($3)
Seat 6: Gluck35 (big blind) folded before Flop
Seat 7: lonely fire folded before Flop (didn't bet)
Seat 8: AlexEliseev7 folded before Flop (didn't bet)
Seat 9: jackr6793 folded before Flop (didn't bet)



PokerStars Hand #228683010566:  Hold'em No Limit ($0.25/$0.50 USD) - 2021/07/30 12:56:19 ET
Table 'Rupertwildt II' 9-max Seat #5 is the button
Seat 1: Tverdinya ($64.32 in chips) 
Seat 2: bill1961966 ($59 in chips) 
Seat 3: goldenpig666 ($50 in chips) 
Seat 4: RikaSunPay ($50 in chips) 
Seat 5: phatom-z ($52.39 in chips) 
Seat 6: Gluck35 ($50 in chips) 
Seat 7: lonely fire ($51.50 in chips) 
Seat 8: AlexEliseev7 ($51.49 in chips) 
Seat 9: jackr6793 ($45.59 in chips) 
Gluck35: posts small blind $0.25
lonely fire: posts big blind $0.50
*** HOLE CARDS ***
AlexEliseev7: folds 
jackr6793: folds 
Tverdinya: folds 
bill1961966: folds 
goldenpig666: raises $1 to $1.50
RikaSunPay: folds 
phatom-z: folds 
Gluck35: folds 
lonely fire: folds 
Uncalled bet ($1) returned to goldenpig666
goldenpig666 collected $1.25 from pot
goldenpig666: doesn't show hand 
*** SUMMARY ***
Total pot $1.25 | Rake $0 
Seat 1: Tverdinya folded before Flop (didn't bet)
Seat 2: bill1961966 folded before Flop (didn't bet)
Seat 3: goldenpig666 collected ($1.25)
Seat 4: RikaSunPay folded before Flop (didn't bet)
Seat 5: phatom-z (button) folded before Flop (didn't bet)
Seat 6: Gluck35 (small blind) folded before Flop
Seat 7: lonely fire (big blind) folded before Flop
Seat 8: AlexEliseev7 folded before Flop (didn't bet)
Seat 9: jackr6793 folded before Flop (didn't bet)



PokerStars Hand #228683016008:  Hold'em No Limit ($0.25/$0.50 USD) - 2021/07/30 12:56:38 ET
Table 'Rupertwildt II' 9-max Seat #6 is the button
Seat 1: Tverdinya ($64.32 in chips) 
Seat 2: bill1961966 ($59 in chips) 
Seat 3: goldenpig666 ($50.75 in chips) 
Seat 4: RikaSunPay ($50 in chips) 
Seat 5: phatom-z ($52.39 in chips) 
Seat 6: Gluck35 ($50 in chips) 
Seat 7: lonely fire ($51 in chips) 
Seat 8: AlexEliseev7 ($51.49 in chips) 
Seat 9: jackr6793 ($45.59 in chips) 
lonely fire: posts small blind $0.25
AlexEliseev7: posts big blind $0.50
*** HOLE CARDS ***
jackr6793: folds 
Tverdinya: folds 
bill1961966: folds 
goldenpig666: folds 
RikaSunPay: folds 
phatom-z: folds 
Gluck35: folds 
lonely fire: folds 
Uncalled bet ($0.25) returned to AlexEliseev7
AlexEliseev7 collected $0.50 from pot
AlexEliseev7: doesn't show hand 
*** SUMMARY ***
Total pot $0.50 | Rake $0 
Seat 1: Tverdinya folded before Flop (didn't bet)
Seat 2: bill1961966 folded before Flop (didn't bet)
Seat 3: goldenpig666 folded before Flop (didn't bet)
Seat 4: RikaSunPay folded before Flop (didn't bet)
Seat 5: phatom-z folded before Flop (didn't bet)
Seat 6: Gluck35 (button) folded before Flop (didn't bet)
Seat 7: lonely fire (small blind) folded before Flop
Seat 8: AlexEliseev7 (big blind) collected ($0.50)
Seat 9: jackr6793 folded before Flop (didn't bet)



PokerStars Hand #228683020099:  Hold'em No Limit ($0.25/$0.50 USD) - 2021/07/30 12:56:53 ET
Table 'Rupertwildt II' 9-max Seat #7 is the button
Seat 1: Tverdinya ($64.32 in chips) 
Seat 2: bill1961966 ($59 in chips) 
Seat 3: goldenpig666 ($50.75 in chips) 
Seat 4: RikaSunPay ($50 in chips) 
Seat 5: phatom-z ($52.39 in chips) 
Seat 6: Gluck35 ($50 in chips) 
Seat 7: lonely fire ($50.75 in chips) 
Seat 8: AlexEliseev7 ($51.74 in chips) 
Seat 9: jackr6793 ($45.59 in chips) 
AlexEliseev7: posts small blind $0.25
jackr6793: posts big blind $0.50
*** HOLE CARDS ***
Tverdinya: folds 
bill1961966: calls $0.50
goldenpig666: folds 
RikaSunPay: folds 
phatom-z: folds 
Gluck35: folds 
lonely fire: folds 
AlexEliseev7: folds 
jackr6793: checks 
*** FLOP *** [3d 4d As]
jackr6793: checks 
bill1961966: checks 
*** TURN *** [3d 4d As] [Qs]
jackr6793: checks 
bill1961966: bets $1
jackr6793: folds 
Uncalled bet ($1) returned to bill1961966
bill1961966 collected $1.19 from pot
bill1961966: doesn't show hand 
*** SUMMARY ***
Total pot $1.25 | Rake $0.06 
Board [3d 4d As Qs]
Seat 1: Tverdinya folded before Flop (didn't bet)
Seat 2: bill1961966 collected ($1.19)
Seat 3: goldenpig666 folded before Flop (didn't bet)
Seat 4: RikaSunPay folded before Flop (didn't bet)
Seat 5: phatom-z folded before Flop (didn't bet)
Seat 6: Gluck35 folded before Flop (didn't bet)
Seat 7: lonely fire (button) folded before Flop (didn't bet)
Seat 8: AlexEliseev7 (small blind) folded before Flop
Seat 9: jackr6793 (big blind) folded on the Turn



PokerStars Hand #228683029996:  Hold'em No Limit ($0.25/$0.50 USD) - 2021/07/30 12:57:27 ET
Table 'Rupertwildt II' 9-max Seat #8 is the button
Seat 1: Tverdinya ($64.32 in chips) 
Seat 2: bill1961966 ($59.69 in chips) 
Seat 3: goldenpig666 ($50.75 in chips) 
Seat 4: RikaSunPay ($50 in chips) 
Seat 5: phatom-z ($52.39 in chips) 
Seat 6: Gluck35 ($50 in chips) 
Seat 7: lonely fire ($50.75 in chips) 
Seat 8: AlexEliseev7 ($51.49 in chips) 
Seat 9: jackr6793 ($45.09 in chips) 
jackr6793: posts small blind $0.25
Tverdinya: posts big blind $0.50
*** HOLE CARDS ***
bill1961966: calls $0.50
goldenpig666: raises $2 to $2.50
RikaSunPay: folds 
phatom-z: folds 
Gluck35: folds 
lonely fire: folds 
AlexEliseev7: folds 
jackr6793: calls $2.25
Tverdinya: folds 
bill1961966: calls $2
*** FLOP *** [Qd Kc Ad]
jackr6793: checks 
bill1961966: bets $2.50
goldenpig666: raises $4.25 to $6.75
jackr6793: folds 
bill1961966: calls $4.25
*** TURN *** [Qd Kc Ad] [7s]
bill1961966: checks 
goldenpig666: bets $13.27
bill1961966: folds 
Uncalled bet ($13.27) returned to goldenpig666
goldenpig666 collected $20.15 from pot
goldenpig666: doesn't show hand 
*** SUMMARY ***
Total pot $21.50 | Rake $1.35 
Board [Qd Kc Ad 7s]
Seat 1: Tverdinya (big blind) folded before Flop
Seat 2: bill1961966 folded on the Turn
Seat 3: goldenpig666 collected ($20.15)
Seat 4: RikaSunPay folded before Flop (didn't bet)
Seat 5: phatom-z folded before Flop (didn't bet)
Seat 6: Gluck35 folded before Flop (didn't bet)
Seat 7: lonely fire folded before Flop (didn't bet)
Seat 8: AlexEliseev7 (button) folded before Flop (didn't bet)
Seat 9: jackr6793 (small blind) folded on the Flop



PokerStars Hand #228683045308:  Hold'em No Limit ($0.25/$0.50 USD) - 2021/07/30 12:58:20 ET
Table 'Rupertwildt II' 9-max Seat #9 is the button
Seat 1: Tverdinya ($63.82 in chips) 
Seat 2: bill1961966 ($50.44 in chips) 
Seat 3: goldenpig666 ($61.65 in chips) 
Seat 4: RikaSunPay ($50 in chips) 
Seat 5: phatom-z ($52.39 in chips) 
Seat 6: Gluck35 ($50 in chips) 
Seat 7: lonely fire ($50.75 in chips) 
Seat 8: AlexEliseev7 ($51.49 in chips) 
Seat 9: jackr6793 ($42.59 in chips) 
Tverdinya: posts small blind $0.25
bill1961966: posts big blind $0.50
*** HOLE CARDS ***
goldenpig666: folds 
RikaSunPay: folds 
phatom-z: folds 
Gluck35: raises $0.75 to $1.25
lonely fire: folds 
AlexEliseev7: folds 
jackr6793: folds 
Tverdinya: folds 
bill1961966: folds 
Uncalled bet ($0.75) returned to Gluck35
Gluck35 collected $1.25 from pot
Gluck35: doesn't show hand 
*** SUMMARY ***
Total pot $1.25 | Rake $0 
Seat 1: Tverdinya (small blind) folded before Flop
Seat 2: bill1961966 (big blind) folded before Flop
Seat 3: goldenpig666 folded before Flop (didn't bet)
Seat 4: RikaSunPay folded before Flop (didn't bet)
Seat 5: phatom-z folded before Flop (didn't bet)
Seat 6: Gluck35 collected ($1.25)
Seat 7: lonely fire folded before Flop (didn't bet)
Seat 8: AlexEliseev7 folded before Flop (didn't bet)
Seat 9: jackr6793 (button) folded before Flop (didn't bet)



PokerStars Hand #228683050450:  Hold'em No Limit ($0.25/$0.50 USD) - 2021/07/30 12:58:37 ET
Table 'Rupertwildt II' 9-max Seat #1 is the button
Seat 1: Tverdinya ($63.57 in chips) 
Seat 2: bill1961966 ($49.94 in chips) 
Seat 3: goldenpig666 ($61.65 in chips) 
Seat 4: RikaSunPay ($50 in chips) 
Seat 5: phatom-z ($52.39 in chips) 
Seat 6: Gluck35 ($50.75 in chips) 
Seat 7: lonely fire ($50.75 in chips) 
Seat 8: AlexEliseev7 ($51.49 in chips) 
Seat 9: jackr6793 ($42.59 in chips) 
bill1961966: posts small blind $0.25
goldenpig666: posts big blind $0.50
*** HOLE CARDS ***
RikaSunPay: folds 
phatom-z: folds 
Gluck35: folds 
lonely fire: folds 
AlexEliseev7: folds 
jackr6793: folds 
Tverdinya: raises $0.75 to $1.25
bill1961966: calls $1
goldenpig666: raises $5.25 to $6.50
Tverdinya: folds 
bill1961966: folds 
Uncalled bet ($5.25) returned to goldenpig666
goldenpig666 collected $3.75 from pot
goldenpig666: doesn't show hand 
*** SUMMARY ***
Total pot $3.75 | Rake $0 
Seat 1: Tverdinya (button) folded before Flop
Seat 2: bill1961966 (small blind) folded before Flop
Seat 3: goldenpig666 (big blind) collected ($3.75)
Seat 4: RikaSunPay folded before Flop (didn't bet)
Seat 5: phatom-z folded before Flop (didn't bet)
Seat 6: Gluck35 folded before Flop (didn't bet)
Seat 7: lonely fire folded before Flop (didn't bet)
Seat 8: AlexEliseev7 folded before Flop (didn't bet)
Seat 9: jackr6793 folded before Flop (didn't bet)



PokerStars Hand #228683057827:  Hold'em No Limit ($0.25/$0.50 USD) - 2021/07/30 12:59:03 ET
Table 'Rupertwildt II' 9-max Seat #2 is the button
Seat 1: Tverdinya ($62.32 in chips) 
Seat 2: bill1961966 ($48.69 in chips) 
Seat 3: goldenpig666 ($64.15 in chips) 
Seat 4: RikaSunPay ($50 in chips) 
Seat 5: phatom-z ($52.39 in chips) 
Seat 6: Gluck35 ($50.75 in chips) 
Seat 7: lonely fire ($50.75 in chips) 
Seat 8: AlexEliseev7 ($51.49 in chips) 
Seat 9: jackr6793 ($42.59 in chips) 
goldenpig666: posts small blind $0.25
RikaSunPay: posts big blind $0.50
*** HOLE CARDS ***
phatom-z: folds 
Gluck35: folds 
lonely fire: folds 
AlexEliseev7: folds 
jackr6793: folds 
Tverdinya: folds 
bill1961966: folds 
goldenpig666: raises $1 to $1.50
RikaSunPay: raises $2.75 to $4.25
goldenpig666: folds 
Uncalled bet ($2.75) returned to RikaSunPay
RikaSunPay collected $3 from pot
RikaSunPay: doesn't show hand 
*** SUMMARY ***
Total pot $3 | Rake $0 
Seat 1: Tverdinya folded before Flop (didn't bet)
Seat 2: bill1961966 (button) folded before Flop (didn't bet)
Seat 3: goldenpig666 (small blind) folded before Flop
Seat 4: RikaSunPay (big blind) collected ($3)
Seat 5: phatom-z folded before Flop (didn't bet)
Seat 6: Gluck35 folded before Flop (didn't bet)
Seat 7: lonely fire folded before Flop (didn't bet)
Seat 8: AlexEliseev7 folded before Flop (didn't bet)
Seat 9: jackr6793 folded before Flop (didn't bet)



PokerStars Hand #228683072437:  Hold'em No Limit ($0.25/$0.50 USD) - 2021/07/30 12:59:53 ET
Table 'Rupertwildt II' 9-max Seat #3 is the button
Seat 1: Tverdinya ($62.32 in chips) 
Seat 2: bill1961966 ($48.69 in chips) 
Seat 3: goldenpig666 ($62.65 in chips) 
Seat 4: RikaSunPay ($51.50 in chips) 
Seat 5: phatom-z ($52.39 in chips) 
Seat 6: Gluck35 ($50.75 in chips) 
Seat 7: lonely fire ($50.75 in chips) 
Seat 8: AlexEliseev7 ($51.49 in chips) 
Seat 9: jackr6793 ($42.59 in chips) 
RikaSunPay: posts small blind $0.25
phatom-z: posts big blind $0.50
*** HOLE CARDS ***
Gluck35: folds 
lonely fire: raises $1 to $1.50
AlexEliseev7: folds 
jackr6793: folds 
Tverdinya: folds 
bill1961966: folds 
goldenpig666: folds 
RikaSunPay: folds 
phatom-z: folds 
Uncalled bet ($1) returned to lonely fire
lonely fire collected $1.25 from pot
lonely fire: doesn't show hand 
*** SUMMARY ***
Total pot $1.25 | Rake $0 
Seat 1: Tverdinya folded before Flop (didn't bet)
Seat 2: bill1961966 folded before Flop (didn't bet)
Seat 3: goldenpig666 (button) folded before Flop (didn't bet)
Seat 4: RikaSunPay (small blind) folded before Flop
Seat 5: phatom-z (big blind) folded before Flop
Seat 6: Gluck35 folded before Flop (didn't bet)
Seat 7: lonely fire collected ($1.25)
Seat 8: AlexEliseev7 folded before Flop (didn't bet)
Seat 9: jackr6793 folded before Flop (didn't bet)



PokerStars Hand #228683077571:  Hold'em No Limit ($0.25/$0.50 USD) - 2021/07/30 13:00:09 ET
Table 'Rupertwildt II' 9-max Seat #4 is the button
Seat 1: Tverdinya ($62.32 in chips) 
Seat 2: bill1961966 ($48.69 in chips) 
Seat 3: goldenpig666 ($62.65 in chips) 
Seat 4: RikaSunPay ($51.25 in chips) 
Seat 5: phatom-z ($51.89 in chips) 
Seat 6: Gluck35 ($50.75 in chips) 
Seat 7: lonely fire ($51.50 in chips) 
Seat 8: AlexEliseev7 ($51.49 in chips) 
Seat 9: jackr6793 ($42.59 in chips) 
phatom-z: posts small blind $0.25
Gluck35: posts big blind $0.50
*** HOLE CARDS ***
lonely fire: folds 
AlexEliseev7: folds 
jackr6793: calls $0.50
Tverdinya: folds 
bill1961966: folds 
goldenpig666: folds 
RikaSunPay: folds 
phatom-z: folds 
Gluck35: checks 
*** FLOP *** [2s 7s Ks]
Gluck35: checks 
jackr6793: checks 
*** TURN *** [2s 7s Ks] [Ac]
Gluck35: bets $0.60
jackr6793: raises $1.40 to $2
Gluck35: folds 
Uncalled bet ($1.40) returned to jackr6793
jackr6793 collected $2.33 from pot
jackr6793: doesn't show hand 
*** SUMMARY ***
Total pot $2.45 | Rake $0.12 
Board [2s 7s Ks Ac]
Seat 1: Tverdinya folded before Flop (didn't bet)
Seat 2: bill1961966 folded before Flop (didn't bet)
Seat 3: goldenpig666 folded before Flop (didn't bet)
Seat 4: RikaSunPay (button) folded before Flop (didn't bet)
Seat 5: phatom-z (small blind) folded before Flop
Seat 6: Gluck35 (big blind) folded on the Turn
Seat 7: lonely fire folded before Flop (didn't bet)
Seat 8: AlexEliseev7 folded before Flop (didn't bet)
Seat 9: jackr6793 collected ($2.33)



PokerStars Hand #228683094062:  Hold'em No Limit ($0.25/$0.50 USD) - 2021/07/30 13:01:01 ET
Table 'Rupertwildt II' 9-max Seat #5 is the button
Seat 1: Tverdinya ($62.32 in chips) 
Seat 2: bill1961966 ($48.69 in chips) 
Seat 3: goldenpig666 ($62.65 in chips) 
Seat 4: RikaSunPay ($51.25 in chips) 
Seat 5: phatom-z ($51.64 in chips) 
Seat 6: Gluck35 ($50 in chips) 
Seat 7: lonely fire ($51.50 in chips) 
Seat 8: AlexEliseev7 ($51.49 in chips) 
Seat 9: jackr6793 ($43.82 in chips) 
Gluck35: posts small blind $0.25
lonely fire: posts big blind $0.50
*** HOLE CARDS ***
AlexEliseev7: folds 
jackr6793: folds 
Tverdinya: raises $0.75 to $1.25
bill1961966: folds 
goldenpig666: folds 
RikaSunPay: folds 
phatom-z: folds 
Gluck35: folds 
bill1961966 leaves the table
lonely fire: folds 
Uncalled bet ($0.75) returned to Tverdinya
Tverdinya collected $1.25 from pot
Tverdinya: doesn't show hand 
*** SUMMARY ***
Total pot $1.25 | Rake $0 
Seat 1: Tverdinya collected ($1.25)
Seat 2: bill1961966 folded before Flop (didn't bet)
Seat 3: goldenpig666 folded before Flop (didn't bet)
Seat 4: RikaSunPay folded before Flop (didn't bet)
Seat 5: phatom-z (button) folded before Flop (didn't bet)
Seat 6: Gluck35 (small blind) folded before Flop
Seat 7: lonely fire (big blind) folded before Flop
Seat 8: AlexEliseev7 folded before Flop (didn't bet)
Seat 9: jackr6793 folded before Flop (didn't bet)



PokerStars Hand #228683103202:  Hold'em No Limit ($0.25/$0.50 USD) - 2021/07/30 13:01:27 ET
Table 'Rupertwildt II' 9-max Seat #6 is the button
Seat 1: Tverdinya ($63.07 in chips) 
Seat 3: goldenpig666 ($62.65 in chips) 
Seat 4: RikaSunPay ($51.25 in chips) 
Seat 5: phatom-z ($51.64 in chips) 
Seat 6: Gluck35 ($50 in chips) 
Seat 7: lonely fire ($51 in chips) 
Seat 8: AlexEliseev7 ($51.49 in chips) 
Seat 9: jackr6793 ($43.82 in chips) 
lonely fire: posts small blind $0.25
AlexEliseev7: posts big blind $0.50
*** HOLE CARDS ***
jackr6793: calls $0.50
Tverdinya: folds 
goldenpig666: folds 
RikaSunPay: folds 
phatom-z: folds 
Gluck35: raises $1.50 to $2
lonely fire: folds 
AlexEliseev7: folds 
jackr6793: calls $1.50
*** FLOP *** [2s 9d 4c]
jackr6793: checks 
Gluck35: bets $2.50
jackr6793: calls $2.50
*** TURN *** [2s 9d 4c] [Js]
jackr6793: checks 
kars0n joins the table at seat #2 
Gluck35: bets $5
jackr6793: folds 
Uncalled bet ($5) returned to Gluck35
Gluck35 collected $9.26 from pot
Gluck35: doesn't show hand 
*** SUMMARY ***
Total pot $9.75 | Rake $0.49 
Board [2s 9d 4c Js]
Seat 1: Tverdinya folded before Flop (didn't bet)
Seat 3: goldenpig666 folded before Flop (didn't bet)
Seat 4: RikaSunPay folded before Flop (didn't bet)
Seat 5: phatom-z folded before Flop (didn't bet)
Seat 6: Gluck35 (button) collected ($9.26)
Seat 7: lonely fire (small blind) folded before Flop
Seat 8: AlexEliseev7 (big blind) folded before Flop
Seat 9: jackr6793 folded on the Turn



PokerStars Hand #228683120092:  Hold'em No Limit ($0.25/$0.50 USD) - 2021/07/30 13:02:13 ET
Table 'Rupertwildt II' 9-max Seat #7 is the button
Seat 1: Tverdinya ($63.07 in chips) 
Seat 3: goldenpig666 ($62.65 in chips) 
Seat 4: RikaSunPay ($51.25 in chips) 
Seat 5: phatom-z ($51.64 in chips) 
Seat 6: Gluck35 ($54.76 in chips) 
Seat 7: lonely fire ($50.75 in chips) 
Seat 8: AlexEliseev7 ($50.99 in chips) 
Seat 9: jackr6793 ($39.32 in chips) 
AlexEliseev7: posts small blind $0.25
jackr6793: posts big blind $0.50
kars0n: sits out 
*** HOLE CARDS ***
Tverdinya: folds 
goldenpig666: folds 
RikaSunPay: raises $1.13 to $1.63
phatom-z: folds 
Gluck35: folds 
lonely fire: raises $2.87 to $4.50
AlexEliseev7: folds 
jackr6793: folds 
RikaSunPay: folds 
Uncalled bet ($2.87) returned to lonely fire
lonely fire collected $4.01 from pot
lonely fire: doesn't show hand 
*** SUMMARY ***
Total pot $4.01 | Rake $0 
Seat 1: Tverdinya folded before Flop (didn't bet)
Seat 3: goldenpig666 folded before Flop (didn't bet)
Seat 4: RikaSunPay folded before Flop
Seat 5: phatom-z folded before Flop (didn't bet)
Seat 6: Gluck35 folded before Flop (didn't bet)
Seat 7: lonely fire (button) collected ($4.01)
Seat 8: AlexEliseev7 (small blind) folded before Flop
Seat 9: jackr6793 (big blind) folded before Flop



PokerStars Hand #228683132526:  Hold'em No Limit ($0.25/$0.50 USD) - 2021/07/30 13:02:46 ET
Table 'Rupertwildt II' 9-max Seat #8 is the button
Seat 1: Tverdinya ($63.07 in chips) 
Seat 3: goldenpig666 ($62.65 in chips) 
Seat 4: RikaSunPay ($50 in chips) 
Seat 5: phatom-z ($51.64 in chips) 
Seat 6: Gluck35 ($54.76 in chips) 
Seat 7: lonely fire ($53.13 in chips) 
Seat 8: AlexEliseev7 ($50.74 in chips) 
Seat 9: jackr6793 ($38.82 in chips) 
jackr6793: posts small blind $0.25
Tverdinya: posts big blind $0.50
kars0n is disconnected 
kars0n has timed out while disconnected
kars0n: is sitting out 
*** HOLE CARDS ***
goldenpig666: folds 
RikaSunPay: folds 
phatom-z: folds 
Gluck35: raises $0.75 to $1.25
lonely fire: folds 
AlexEliseev7: folds 
jackr6793: calls $1
Tverdinya: folds 
*** FLOP *** [2c Ts 4d]
jackr6793: checks 
Gluck35: bets $1.50
jackr6793: folds 
Uncalled bet ($1.50) returned to Gluck35
Gluck35 collected $2.85 from pot
Gluck35: doesn't show hand 
*** SUMMARY ***
Total pot $3 | Rake $0.15 
Board [2c Ts 4d]
Seat 1: Tverdinya (big blind) folded before Flop
Seat 3: goldenpig666 folded before Flop (didn't bet)
Seat 4: RikaSunPay folded before Flop (didn't bet)
Seat 5: phatom-z folded before Flop (didn't bet)
Seat 6: Gluck35 collected ($2.85)
Seat 7: lonely fire folded before Flop (didn't bet)
Seat 8: AlexEliseev7 (button) folded before Flop (didn't bet)
Seat 9: jackr6793 (small blind) folded on the Flop



PokerStars Hand #228683149810:  Hold'em No Limit ($0.25/$0.50 USD) - 2021/07/30 13:03:30 ET
Table 'Rupertwildt II' 9-max Seat #9 is the button
Seat 1: Tverdinya ($62.57 in chips) 
Seat 3: goldenpig666 ($62.65 in chips) 
Seat 4: RikaSunPay ($50 in chips) 
Seat 5: phatom-z ($51.64 in chips) 
Seat 6: Gluck35 ($56.36 in chips) 
Seat 7: lonely fire ($53.13 in chips) 
Seat 8: AlexEliseev7 ($50.74 in chips) 
Seat 9: jackr6793 ($37.57 in chips) 
Tverdinya: posts small blind $0.25
goldenpig666: posts big blind $0.50
*** HOLE CARDS ***
RikaSunPay: folds 
phatom-z: folds 
Gluck35: folds 
lonely fire: folds 
AlexEliseev7: folds 
jackr6793: calls $0.50
Tverdinya: folds 
goldenpig666: checks 
*** FLOP *** [6c 7d Js]
goldenpig666: checks 
jackr6793: bets $1.19
goldenpig666: folds 
Uncalled bet ($1.19) returned to jackr6793
jackr6793 collected $1.19 from pot
jackr6793: doesn't show hand 
*** SUMMARY ***
Total pot $1.25 | Rake $0.06 
Board [6c 7d Js]
Seat 1: Tverdinya (small blind) folded before Flop
Seat 3: goldenpig666 (big blind) folded on the Flop
Seat 4: RikaSunPay folded before Flop (didn't bet)
Seat 5: phatom-z folded before Flop (didn't bet)
Seat 6: Gluck35 folded before Flop (didn't bet)
Seat 7: lonely fire folded before Flop (didn't bet)
Seat 8: AlexEliseev7 folded before Flop (didn't bet)
Seat 9: jackr6793 (button) collected ($1.19)



PokerStars Hand #228683160788:  Hold'em No Limit ($0.25/$0.50 USD) - 2021/07/30 13:03:58 ET
Table 'Rupertwildt II' 9-max Seat #1 is the button
Seat 1: Tverdinya ($62.32 in chips) 
Seat 3: goldenpig666 ($62.15 in chips) 
Seat 4: RikaSunPay ($50 in chips) 
Seat 5: phatom-z ($51.64 in chips) 
Seat 6: Gluck35 ($56.36 in chips) 
Seat 7: lonely fire ($53.13 in chips) 
Seat 8: AlexEliseev7 ($50.74 in chips) 
Seat 9: jackr6793 ($38.26 in chips) 
goldenpig666: posts small blind $0.25
RikaSunPay: posts big blind $0.50
*** HOLE CARDS ***
phatom-z: folds 
Gluck35: folds 
lonely fire: raises $1 to $1.50
AlexEliseev7: raises $2.50 to $4
jackr6793: calls $4
Tverdinya: folds 
goldenpig666: folds 
RikaSunPay: folds 
lonely fire: raises $8.50 to $12.50
AlexEliseev7: folds 
jackr6793: raises $25.76 to $38.26 and is all-in
lonely fire: calls $25.76
*** FLOP *** [Th 8c 4c]
*** TURN *** [Th 8c 4c] [6s]
*** RIVER *** [Th 8c 4c 6s] [3c]
*** SHOW DOWN ***
lonely fire: shows [Ad Ah] (a pair of Aces)
jackr6793: shows [Kc Js] (high card King)
lonely fire collected $79.27 from pot
*** SUMMARY ***
Total pot $81.27 | Rake $2 
Board [Th 8c 4c 6s 3c]
Seat 1: Tverdinya (button) folded before Flop (didn't bet)
Seat 3: goldenpig666 (small blind) folded before Flop
Seat 4: RikaSunPay (big blind) folded before Flop
Seat 5: phatom-z folded before Flop (didn't bet)
Seat 6: Gluck35 folded before Flop (didn't bet)
Seat 7: lonely fire showed [Ad Ah] and won ($79.27) with a pair of Aces
Seat 8: AlexEliseev7 folded before Flop
Seat 9: jackr6793 showed [Kc Js] and lost with high card King



PokerStars Hand #228683180193:  Hold'em No Limit ($0.25/$0.50 USD) - 2021/07/30 13:04:46 ET
Table 'Rupertwildt II' 9-max Seat #3 is the button
Seat 1: Tverdinya ($62.32 in chips) 
Seat 3: goldenpig666 ($61.90 in chips) 
Seat 4: RikaSunPay ($50 in chips) 
Seat 6: Gluck35 ($56.36 in chips) 
Seat 7: lonely fire ($94.14 in chips) 
Seat 8: AlexEliseev7 ($50 in chips) 
RikaSunPay: posts small blind $0.25
phatom-z: is sitting out 
Gluck35: posts big blind $0.50
phatom-z leaves the table
kars0n: sits out 
*** HOLE CARDS ***
lonely fire: folds 
AlexEliseev7: folds 
Tverdinya: folds 
goldenpig666: folds 
jackr6793 leaves the table
RikaSunPay: raises $1.13 to $1.63
Gluck35: raises $2.87 to $4.50
RikaSunPay: folds 
Uncalled bet ($2.87) returned to Gluck35
Gluck35 collected $3.26 from pot
Gluck35: doesn't show hand 
*** SUMMARY ***
Total pot $3.26 | Rake $0 
Seat 1: Tverdinya folded before Flop (didn't bet)
Seat 3: goldenpig666 (button) folded before Flop (didn't bet)
Seat 4: RikaSunPay (small blind) folded before Flop
Seat 6: Gluck35 (big blind) collected ($3.26)
Seat 7: lonely fire folded before Flop (didn't bet)
Seat 8: AlexEliseev7 folded before Flop (didn't bet)



PokerStars Hand #228683195052:  Hold'em No Limit ($0.25/$0.50 USD) - 2021/07/30 13:05:23 ET
Table 'Rupertwildt II' 9-max Seat #4 is the button
Seat 1: Tverdinya ($62.32 in chips) 
Seat 3: goldenpig666 ($61.90 in chips) 
Seat 4: RikaSunPay ($50 in chips) 
Seat 6: Gluck35 ($57.99 in chips) 
Seat 8: AlexEliseev7 ($50 in chips) 
Gluck35: posts small blind $0.25
lonely fire: is sitting out 
AlexEliseev7: posts big blind $0.50
kars0n: sits out 
*** HOLE CARDS ***
Tverdinya: folds 
goldenpig666: folds 
lonely fire leaves the table
RikaSunPay: raises $1.13 to $1.63
Gluck35: folds 
AlexEliseev7: calls $1.13
*** FLOP *** [Jc Qc Ad]
AlexEliseev7: checks 
RikaSunPay: bets $1.75
kars0n leaves the table
AlexEliseev7: folds 
Uncalled bet ($1.75) returned to RikaSunPay
RikaSunPay collected $3.33 from pot
RikaSunPay: doesn't show hand 
*** SUMMARY ***
Total pot $3.51 | Rake $0.18 
Board [Jc Qc Ad]
Seat 1: Tverdinya folded before Flop (didn't bet)
Seat 3: goldenpig666 folded before Flop (didn't bet)
Seat 4: RikaSunPay (button) collected ($3.33)
Seat 6: Gluck35 (small blind) folded before Flop
Seat 8: AlexEliseev7 (big blind) folded on the Flop



PokerStars Hand #228683208854:  Hold'em No Limit ($0.25/$0.50 USD) - 2021/07/30 13:05:57 ET
Table 'Rupertwildt II' 9-max Seat #8 is the button
Seat 6: Gluck35 ($57.74 in chips) 
Seat 8: AlexEliseev7 ($50 in chips) 
AlexEliseev7: posts small blind $0.25
goldenpig666: is sitting out 
RikaSunPay: is sitting out 
Gluck35: posts big blind $0.50
*** HOLE CARDS ***
goldenpig666 leaves the table
RikaSunPay leaves the table
AlexEliseev7: raises $1 to $1.50
Gluck35: folds 
Uncalled bet ($1) returned to AlexEliseev7
AlexEliseev7 collected $1 from pot
AlexEliseev7: doesn't show hand 
*** SUMMARY ***
Total pot $1 | Rake $0 
Seat 6: Gluck35 (big blind) folded before Flop
Seat 8: AlexEliseev7 (button) (small blind) collected ($1)



