PokerStars Hand #228679492309:  Hold'em No Limit ($0.25/$0.50 USD) - 2021/07/30 10:00:42 ET
Table 'Aitne III' 9-max Seat #2 is the button
Seat 1: kazuking0318 ($44.13 in chips) 
Seat 2: speedbird uk ($35.21 in chips) 
Seat 3: o-chan1986 ($69.39 in chips) 
Seat 4: Thefinster71 ($44.55 in chips) 
Seat 5: artemxxl ($60.62 in chips) 
Seat 7: takakensu ($42.13 in chips) 
Seat 8: Pete007poker ($57.33 in chips) 
Seat 9: Petrof98 ($26.18 in chips) 
o-chan1986: posts small blind $0.25
Thefinster71: posts big blind $0.50
Zhud19: sits out 
*** HOLE CARDS ***
artemxxl: folds 
takakensu: folds 
Pete007poker: raises $0.75 to $1.25
Petrof98: folds 
kazuking0318: calls $1.25
speedbird uk: folds 
o-chan1986: folds 
Thefinster71: folds 
*** FLOP *** [7h 2d 7s]
Pete007poker: bets $1.55
kazuking0318: raises $3.20 to $4.75
Pete007poker: raises $9.44 to $14.19
kazuking0318: folds 
Uncalled bet ($9.44) returned to Pete007poker
Pete007poker collected $12.11 from pot
*** SUMMARY ***
Total pot $12.75 | Rake $0.64 
Board [7h 2d 7s]
Seat 1: kazuking0318 folded on the Flop
Seat 2: speedbird uk (button) folded before Flop (didn't bet)
Seat 3: o-chan1986 (small blind) folded before Flop
Seat 4: Thefinster71 (big blind) folded before Flop
Seat 5: artemxxl folded before Flop (didn't bet)
Seat 7: takakensu folded before Flop (didn't bet)
Seat 8: Pete007poker collected ($12.11)
Seat 9: Petrof98 folded before Flop (didn't bet)



PokerStars Hand #228679512264:  Hold'em No Limit ($0.25/$0.50 USD) - 2021/07/30 10:01:55 ET
Table 'Aitne III' 9-max Seat #3 is the button
Seat 1: kazuking0318 ($38.13 in chips) 
Seat 2: speedbird uk ($35.21 in chips) 
Seat 3: o-chan1986 ($69.14 in chips) 
Seat 4: Thefinster71 ($44.05 in chips) 
Seat 5: artemxxl ($60.62 in chips) 
Seat 7: takakensu ($42.13 in chips) 
Seat 8: Pete007poker ($63.44 in chips) 
Seat 9: Petrof98 ($26.18 in chips) 
Thefinster71: posts small blind $0.25
artemxxl: posts big blind $0.50
Zhud19: sits out 
*** HOLE CARDS ***
takakensu: folds 
Pete007poker: folds 
Petrof98: folds 
kazuking0318: folds 
speedbird uk: folds 
o-chan1986: raises $0.75 to $1.25
Thefinster71: calls $1
artemxxl: raises $4 to $5.25
o-chan1986: folds 
Thefinster71: raises $38.80 to $44.05 and is all-in
artemxxl: folds 
Uncalled bet ($38.80) returned to Thefinster71
Thefinster71 collected $11.75 from pot
Thefinster71: doesn't show hand 
*** SUMMARY ***
Total pot $11.75 | Rake $0 
Seat 1: kazuking0318 folded before Flop (didn't bet)
Seat 2: speedbird uk folded before Flop (didn't bet)
Seat 3: o-chan1986 (button) folded before Flop
Seat 4: Thefinster71 (small blind) collected ($11.75)
Seat 5: artemxxl (big blind) folded before Flop
Seat 7: takakensu folded before Flop (didn't bet)
Seat 8: Pete007poker folded before Flop (didn't bet)
Seat 9: Petrof98 folded before Flop (didn't bet)



PokerStars Hand #228679524690:  Hold'em No Limit ($0.25/$0.50 USD) - 2021/07/30 10:02:38 ET
Table 'Aitne III' 9-max Seat #4 is the button
Seat 1: kazuking0318 ($38.13 in chips) 
Seat 2: speedbird uk ($35.21 in chips) 
Seat 3: o-chan1986 ($67.89 in chips) 
Seat 4: Thefinster71 ($50.55 in chips) 
Seat 5: artemxxl ($55.37 in chips) 
Seat 6: Zhud19 ($50 in chips) 
Seat 7: takakensu ($42.13 in chips) 
Seat 8: Pete007poker ($63.44 in chips) 
Seat 9: Petrof98 ($26.18 in chips) 
artemxxl: posts small blind $0.25
Zhud19: posts big blind $0.50
*** HOLE CARDS ***
takakensu: folds 
Pete007poker: raises $0.75 to $1.25
Petrof98: folds 
kazuking0318: folds 
speedbird uk: folds 
o-chan1986: folds 
Thefinster71: folds 
artemxxl: folds 
Zhud19: folds 
Uncalled bet ($0.75) returned to Pete007poker
Pete007poker collected $1.25 from pot
*** SUMMARY ***
Total pot $1.25 | Rake $0 
Seat 1: kazuking0318 folded before Flop (didn't bet)
Seat 2: speedbird uk folded before Flop (didn't bet)
Seat 3: o-chan1986 folded before Flop (didn't bet)
Seat 4: Thefinster71 (button) folded before Flop (didn't bet)
Seat 5: artemxxl (small blind) folded before Flop
Seat 6: Zhud19 (big blind) folded before Flop
Seat 7: takakensu folded before Flop (didn't bet)
Seat 8: Pete007poker collected ($1.25)
Seat 9: Petrof98 folded before Flop (didn't bet)



PokerStars Hand #228679528673:  Hold'em No Limit ($0.25/$0.50 USD) - 2021/07/30 10:02:51 ET
Table 'Aitne III' 9-max Seat #5 is the button
Seat 1: kazuking0318 ($38.13 in chips) 
Seat 2: speedbird uk ($35.21 in chips) 
Seat 3: o-chan1986 ($67.89 in chips) 
Seat 4: Thefinster71 ($50.55 in chips) 
Seat 5: artemxxl ($55.12 in chips) 
Seat 6: Zhud19 ($50 in chips) 
Seat 7: takakensu ($42.13 in chips) 
Seat 8: Pete007poker ($64.19 in chips) 
Seat 9: Petrof98 ($26.18 in chips) 
Zhud19: posts small blind $0.25
takakensu: posts big blind $0.50
*** HOLE CARDS ***
Pete007poker: folds 
Petrof98: folds 
kazuking0318: raises $1 to $1.50
speedbird uk: calls $1.50
o-chan1986: folds 
Thefinster71: calls $1.50
artemxxl: folds 
Zhud19: folds 
takakensu: folds 
*** FLOP *** [8h Jc As]
kazuking0318: checks 
speedbird uk: checks 
Thefinster71: bets $2.50
kazuking0318: calls $2.50
speedbird uk: calls $2.50
*** TURN *** [8h Jc As] [2h]
kazuking0318: checks 
speedbird uk: checks 
Thefinster71: bets $4
kazuking0318: raises $5.25 to $9.25
speedbird uk: folds 
Thefinster71: calls $5.25
*** RIVER *** [8h Jc As 2h] [3h]
kazuking0318: checks 
Thefinster71: checks 
*** SHOW DOWN ***
kazuking0318: shows [2c Ac] (two pair, Aces and Deuces)
Thefinster71: mucks hand 
kazuking0318 collected $29.69 from pot
*** SUMMARY ***
Total pot $31.25 | Rake $1.56 
Board [8h Jc As 2h 3h]
Seat 1: kazuking0318 showed [2c Ac] and won ($29.69) with two pair, Aces and Deuces
Seat 2: speedbird uk folded on the Turn
Seat 3: o-chan1986 folded before Flop (didn't bet)
Seat 4: Thefinster71 mucked
Seat 5: artemxxl (button) folded before Flop (didn't bet)
Seat 6: Zhud19 (small blind) folded before Flop
Seat 7: takakensu (big blind) folded before Flop
Seat 8: Pete007poker folded before Flop (didn't bet)
Seat 9: Petrof98 folded before Flop (didn't bet)



PokerStars Hand #228679556634:  Hold'em No Limit ($0.25/$0.50 USD) - 2021/07/30 10:04:28 ET
Table 'Aitne III' 9-max Seat #6 is the button
Seat 1: kazuking0318 ($54.57 in chips) 
Seat 2: speedbird uk ($31.21 in chips) 
Seat 3: o-chan1986 ($67.89 in chips) 
Seat 4: Thefinster71 ($37.30 in chips) 
Seat 5: artemxxl ($55.12 in chips) 
Seat 6: Zhud19 ($50 in chips) 
Seat 7: takakensu ($41.63 in chips) 
Seat 8: Pete007poker ($64.19 in chips) 
Seat 9: Petrof98 ($26.18 in chips) 
takakensu: posts small blind $0.25
Pete007poker: posts big blind $0.50
*** HOLE CARDS ***
Petrof98: raises $0.75 to $1.25
kazuking0318: folds 
speedbird uk: folds 
o-chan1986: folds 
Thefinster71: calls $1.25
artemxxl: folds 
Zhud19: folds 
takakensu: folds 
Pete007poker: calls $0.75
*** FLOP *** [5s Ac Qd]
Pete007poker: checks 
Petrof98: bets $1.29
Thefinster71: folds 
Pete007poker: folds 
Uncalled bet ($1.29) returned to Petrof98
Petrof98 collected $3.80 from pot
Petrof98: doesn't show hand 
*** SUMMARY ***
Total pot $4 | Rake $0.20 
Board [5s Ac Qd]
Seat 1: kazuking0318 folded before Flop (didn't bet)
Seat 2: speedbird uk folded before Flop (didn't bet)
Seat 3: o-chan1986 folded before Flop (didn't bet)
Seat 4: Thefinster71 folded on the Flop
Seat 5: artemxxl folded before Flop (didn't bet)
Seat 6: Zhud19 (button) folded before Flop (didn't bet)
Seat 7: takakensu (small blind) folded before Flop
Seat 8: Pete007poker (big blind) folded on the Flop
Seat 9: Petrof98 collected ($3.80)



PokerStars Hand #228679567117:  Hold'em No Limit ($0.25/$0.50 USD) - 2021/07/30 10:05:04 ET
Table 'Aitne III' 9-max Seat #7 is the button
Seat 1: kazuking0318 ($54.57 in chips) 
Seat 2: speedbird uk ($31.21 in chips) 
Seat 3: o-chan1986 ($67.89 in chips) 
Seat 4: Thefinster71 ($36.05 in chips) 
Seat 5: artemxxl ($55.12 in chips) 
Seat 6: Zhud19 ($50 in chips) 
Seat 7: takakensu ($41.38 in chips) 
Seat 8: Pete007poker ($62.94 in chips) 
Seat 9: Petrof98 ($28.73 in chips) 
Pete007poker: posts small blind $0.25
Petrof98: posts big blind $0.50
*** HOLE CARDS ***
kazuking0318: folds 
speedbird uk: folds 
o-chan1986: folds 
Thefinster71: calls $0.50
artemxxl: folds 
Zhud19: folds 
takakensu: raises $1 to $1.50
Pete007poker: calls $1.25
Petrof98: folds 
Thefinster71: calls $1
*** FLOP *** [Qd 8h 9h]
Pete007poker: checks 
Thefinster71: checks 
takakensu: checks 
*** TURN *** [Qd 8h 9h] [7s]
Pete007poker: checks 
Thefinster71: checks 
takakensu: bets $2.37
Pete007poker: folds 
Thefinster71: folds 
Uncalled bet ($2.37) returned to takakensu
takakensu collected $4.75 from pot
takakensu: doesn't show hand 
*** SUMMARY ***
Total pot $5 | Rake $0.25 
Board [Qd 8h 9h 7s]
Seat 1: kazuking0318 folded before Flop (didn't bet)
Seat 2: speedbird uk folded before Flop (didn't bet)
Seat 3: o-chan1986 folded before Flop (didn't bet)
Seat 4: Thefinster71 folded on the Turn
Seat 5: artemxxl folded before Flop (didn't bet)
Seat 6: Zhud19 folded before Flop (didn't bet)
Seat 7: takakensu (button) collected ($4.75)
Seat 8: Pete007poker (small blind) folded on the Turn
Seat 9: Petrof98 (big blind) folded before Flop



PokerStars Hand #228679580966:  Hold'em No Limit ($0.25/$0.50 USD) - 2021/07/30 10:05:51 ET
Table 'Aitne III' 9-max Seat #8 is the button
Seat 1: kazuking0318 ($54.57 in chips) 
Seat 2: speedbird uk ($31.21 in chips) 
Seat 3: o-chan1986 ($67.89 in chips) 
Seat 4: Thefinster71 ($34.55 in chips) 
Seat 5: artemxxl ($55.12 in chips) 
Seat 6: Zhud19 ($50 in chips) 
Seat 7: takakensu ($44.63 in chips) 
Seat 8: Pete007poker ($61.44 in chips) 
Seat 9: Petrof98 ($28.23 in chips) 
Petrof98: posts small blind $0.25
kazuking0318: posts big blind $0.50
*** HOLE CARDS ***
speedbird uk: folds 
o-chan1986: folds 
Thefinster71: folds 
artemxxl: folds 
Zhud19: raises $1 to $1.50
takakensu: folds 
Pete007poker: folds 
Petrof98: folds 
kazuking0318: folds 
Uncalled bet ($1) returned to Zhud19
Zhud19 collected $1.25 from pot
*** SUMMARY ***
Total pot $1.25 | Rake $0 
Seat 1: kazuking0318 (big blind) folded before Flop
Seat 2: speedbird uk folded before Flop (didn't bet)
Seat 3: o-chan1986 folded before Flop (didn't bet)
Seat 4: Thefinster71 folded before Flop (didn't bet)
Seat 5: artemxxl folded before Flop (didn't bet)
Seat 6: Zhud19 collected ($1.25)
Seat 7: takakensu folded before Flop (didn't bet)
Seat 8: Pete007poker (button) folded before Flop (didn't bet)
Seat 9: Petrof98 (small blind) folded before Flop



PokerStars Hand #228679586404:  Hold'em No Limit ($0.25/$0.50 USD) - 2021/07/30 10:06:10 ET
Table 'Aitne III' 9-max Seat #9 is the button
Seat 1: kazuking0318 ($54.07 in chips) 
Seat 2: speedbird uk ($31.21 in chips) 
Seat 3: o-chan1986 ($67.89 in chips) 
Seat 4: Thefinster71 ($34.55 in chips) 
Seat 5: artemxxl ($55.12 in chips) 
Seat 6: Zhud19 ($50.75 in chips) 
Seat 7: takakensu ($44.63 in chips) 
Seat 8: Pete007poker ($61.44 in chips) 
Seat 9: Petrof98 ($27.98 in chips) 
kazuking0318: posts small blind $0.25
speedbird uk: posts big blind $0.50
*** HOLE CARDS ***
o-chan1986: folds 
Thefinster71: folds 
artemxxl: folds 
Zhud19: folds 
takakensu: raises $1 to $1.50
Pete007poker: folds 
Petrof98: folds 
kazuking0318: calls $1.25
speedbird uk: calls $1
*** FLOP *** [5d 4c Ts]
kazuking0318: bets $1.75
speedbird uk: calls $1.75
takakensu: calls $1.75
*** TURN *** [5d 4c Ts] [Tc]
kazuking0318: checks 
speedbird uk: checks 
takakensu: bets $4.63
kazuking0318: folds 
speedbird uk: folds 
Uncalled bet ($4.63) returned to takakensu
takakensu collected $9.26 from pot
takakensu: doesn't show hand 
*** SUMMARY ***
Total pot $9.75 | Rake $0.49 
Board [5d 4c Ts Tc]
Seat 1: kazuking0318 (small blind) folded on the Turn
Seat 2: speedbird uk (big blind) folded on the Turn
Seat 3: o-chan1986 folded before Flop (didn't bet)
Seat 4: Thefinster71 folded before Flop (didn't bet)
Seat 5: artemxxl folded before Flop (didn't bet)
Seat 6: Zhud19 folded before Flop (didn't bet)
Seat 7: takakensu collected ($9.26)
Seat 8: Pete007poker folded before Flop (didn't bet)
Seat 9: Petrof98 (button) folded before Flop (didn't bet)



PokerStars Hand #228679610437:  Hold'em No Limit ($0.25/$0.50 USD) - 2021/07/30 10:07:02 ET
Table 'Aitne III' 9-max Seat #1 is the button
Seat 1: kazuking0318 ($50.82 in chips) 
Seat 2: speedbird uk ($47.96 in chips) 
Seat 3: o-chan1986 ($67.89 in chips) 
Seat 4: Thefinster71 ($34.55 in chips) 
Seat 5: artemxxl ($55.12 in chips) 
Seat 6: Zhud19 ($50.75 in chips) 
Seat 7: takakensu ($50.64 in chips) 
Seat 8: Pete007poker ($61.44 in chips) 
Seat 9: Petrof98 ($27.98 in chips) 
speedbird uk: posts small blind $0.25
o-chan1986: posts big blind $0.50
*** HOLE CARDS ***
Thefinster71: folds 
artemxxl: folds 
Zhud19: folds 
takakensu: folds 
Pete007poker: folds 
Petrof98: folds 
kazuking0318: raises $1 to $1.50
speedbird uk: folds 
o-chan1986: raises $2.50 to $4
kazuking0318: calls $2.50
*** FLOP *** [Th As Tc]
o-chan1986: checks 
kazuking0318: bets $2.25
o-chan1986: calls $2.25
*** TURN *** [Th As Tc] [Js]
o-chan1986: checks 
kazuking0318: bets $3.25
o-chan1986: calls $3.25
*** RIVER *** [Th As Tc Js] [Td]
o-chan1986: bets $12.19
kazuking0318: folds 
Uncalled bet ($12.19) returned to o-chan1986
o-chan1986 collected $18.29 from pot
o-chan1986: doesn't show hand 
*** SUMMARY ***
Total pot $19.25 | Rake $0.96 
Board [Th As Tc Js Td]
Seat 1: kazuking0318 (button) folded on the River
Seat 2: speedbird uk (small blind) folded before Flop
Seat 3: o-chan1986 (big blind) collected ($18.29)
Seat 4: Thefinster71 folded before Flop (didn't bet)
Seat 5: artemxxl folded before Flop (didn't bet)
Seat 6: Zhud19 folded before Flop (didn't bet)
Seat 7: takakensu folded before Flop (didn't bet)
Seat 8: Pete007poker folded before Flop (didn't bet)
Seat 9: Petrof98 folded before Flop (didn't bet)



PokerStars Hand #228679639872:  Hold'em No Limit ($0.25/$0.50 USD) - 2021/07/30 10:08:41 ET
Table 'Aitne III' 9-max Seat #2 is the button
Seat 1: kazuking0318 ($41.32 in chips) 
Seat 2: speedbird uk ($47.71 in chips) 
Seat 3: o-chan1986 ($76.68 in chips) 
Seat 4: Thefinster71 ($34.55 in chips) 
Seat 5: artemxxl ($55.12 in chips) 
Seat 6: Zhud19 ($50.75 in chips) 
Seat 7: takakensu ($50.64 in chips) 
Seat 8: Pete007poker ($61.44 in chips) 
Seat 9: Petrof98 ($27.98 in chips) 
o-chan1986: posts small blind $0.25
Thefinster71: posts big blind $0.50
*** HOLE CARDS ***
artemxxl: folds 
Zhud19: folds 
takakensu: folds 
Pete007poker: folds 
Petrof98: folds 
kazuking0318: folds 
speedbird uk: raises $1 to $1.50
o-chan1986: calls $1.25
Thefinster71: calls $1
*** FLOP *** [8s 5h Th]
o-chan1986: checks 
Thefinster71: checks 
speedbird uk: bets $1.50
o-chan1986: calls $1.50
Thefinster71: calls $1.50
*** TURN *** [8s 5h Th] [Ac]
o-chan1986: checks 
Thefinster71: checks 
speedbird uk: bets $3
o-chan1986: folds 
Thefinster71: calls $3
*** RIVER *** [8s 5h Th Ac] [Ts]
Thefinster71: checks 
speedbird uk: checks 
*** SHOW DOWN ***
Thefinster71: shows [5s As] (two pair, Aces and Tens)
speedbird uk: shows [Kc Ad] (two pair, Aces and Tens - King kicker)
speedbird uk collected $14.25 from pot
*** SUMMARY ***
Total pot $15 | Rake $0.75 
Board [8s 5h Th Ac Ts]
Seat 1: kazuking0318 folded before Flop (didn't bet)
Seat 2: speedbird uk (button) showed [Kc Ad] and won ($14.25) with two pair, Aces and Tens
Seat 3: o-chan1986 (small blind) folded on the Turn
Seat 4: Thefinster71 (big blind) showed [5s As] and lost with two pair, Aces and Tens
Seat 5: artemxxl folded before Flop (didn't bet)
Seat 6: Zhud19 folded before Flop (didn't bet)
Seat 7: takakensu folded before Flop (didn't bet)
Seat 8: Pete007poker folded before Flop (didn't bet)
Seat 9: Petrof98 folded before Flop (didn't bet)



PokerStars Hand #228679658710:  Hold'em No Limit ($0.25/$0.50 USD) - 2021/07/30 10:09:45 ET
Table 'Aitne III' 9-max Seat #3 is the button
Seat 1: kazuking0318 ($41.32 in chips) 
Seat 2: speedbird uk ($55.96 in chips) 
Seat 3: o-chan1986 ($73.68 in chips) 
Seat 4: Thefinster71 ($28.55 in chips) 
Seat 5: artemxxl ($55.12 in chips) 
Seat 6: Zhud19 ($50.75 in chips) 
Seat 7: takakensu ($50.64 in chips) 
Seat 8: Pete007poker ($61.44 in chips) 
Seat 9: Petrof98 ($27.98 in chips) 
Thefinster71: posts small blind $0.25
artemxxl: posts big blind $0.50
*** HOLE CARDS ***
Zhud19: folds 
takakensu: raises $1.50 to $2
Pete007poker: folds 
Petrof98: folds 
kazuking0318: folds 
speedbird uk: folds 
o-chan1986: calls $2
Thefinster71: calls $1.75
artemxxl: folds 
*** FLOP *** [6d 8h 6h]
Thefinster71: checks 
takakensu: bets $3.09
o-chan1986: folds 
Thefinster71: folds 
Uncalled bet ($3.09) returned to takakensu
takakensu collected $6.18 from pot
takakensu: doesn't show hand 
*** SUMMARY ***
Total pot $6.50 | Rake $0.32 
Board [6d 8h 6h]
Seat 1: kazuking0318 folded before Flop (didn't bet)
Seat 2: speedbird uk folded before Flop (didn't bet)
Seat 3: o-chan1986 (button) folded on the Flop
Seat 4: Thefinster71 (small blind) folded on the Flop
Seat 5: artemxxl (big blind) folded before Flop
Seat 6: Zhud19 folded before Flop (didn't bet)
Seat 7: takakensu collected ($6.18)
Seat 8: Pete007poker folded before Flop (didn't bet)
Seat 9: Petrof98 folded before Flop (didn't bet)



PokerStars Hand #228679673359:  Hold'em No Limit ($0.25/$0.50 USD) - 2021/07/30 10:10:34 ET
Table 'Aitne III' 9-max Seat #4 is the button
Seat 1: kazuking0318 ($41.32 in chips) 
Seat 2: speedbird uk ($55.96 in chips) 
Seat 3: o-chan1986 ($71.68 in chips) 
Seat 4: Thefinster71 ($46.55 in chips) 
Seat 5: artemxxl ($54.62 in chips) 
Seat 6: Zhud19 ($50.75 in chips) 
Seat 7: takakensu ($54.82 in chips) 
Seat 8: Pete007poker ($61.44 in chips) 
Seat 9: Petrof98 ($27.98 in chips) 
artemxxl: posts small blind $0.25
Zhud19: posts big blind $0.50
*** HOLE CARDS ***
takakensu: folds 
Pete007poker: folds 
Petrof98: raises $0.75 to $1.25
kazuking0318: folds 
speedbird uk: folds 
o-chan1986: folds 
Thefinster71: folds 
artemxxl: folds 
Zhud19: folds 
Uncalled bet ($0.75) returned to Petrof98
Petrof98 collected $1.25 from pot
Petrof98: doesn't show hand 
*** SUMMARY ***
Total pot $1.25 | Rake $0 
Seat 1: kazuking0318 folded before Flop (didn't bet)
Seat 2: speedbird uk folded before Flop (didn't bet)
Seat 3: o-chan1986 folded before Flop (didn't bet)
Seat 4: Thefinster71 (button) folded before Flop (didn't bet)
Seat 5: artemxxl (small blind) folded before Flop
Seat 6: Zhud19 (big blind) folded before Flop
Seat 7: takakensu folded before Flop (didn't bet)
Seat 8: Pete007poker folded before Flop (didn't bet)
Seat 9: Petrof98 collected ($1.25)



PokerStars Hand #228679679587:  Hold'em No Limit ($0.25/$0.50 USD) - 2021/07/30 10:10:54 ET
Table 'Aitne III' 9-max Seat #5 is the button
Seat 1: kazuking0318 ($41.32 in chips) 
Seat 2: speedbird uk ($55.96 in chips) 
Seat 3: o-chan1986 ($71.68 in chips) 
Seat 4: Thefinster71 ($46.55 in chips) 
Seat 5: artemxxl ($54.37 in chips) 
Seat 6: Zhud19 ($50.25 in chips) 
Seat 7: takakensu ($54.82 in chips) 
Seat 8: Pete007poker ($61.44 in chips) 
Seat 9: Petrof98 ($28.73 in chips) 
Zhud19: posts small blind $0.25
takakensu: posts big blind $0.50
*** HOLE CARDS ***
Pete007poker: folds 
Petrof98: raises $0.75 to $1.25
kazuking0318: calls $1.25
speedbird uk: folds 
o-chan1986: folds 
Thefinster71: folds 
artemxxl: folds 
Zhud19: folds 
takakensu: folds 
*** FLOP *** [Kc 9s 6d]
Petrof98: bets $1.05
kazuking0318: calls $1.05
*** TURN *** [Kc 9s 6d] [Ah]
Petrof98: bets $2.79
kazuking0318: folds 
Uncalled bet ($2.79) returned to Petrof98
Petrof98 collected $5.08 from pot
Petrof98: doesn't show hand 
*** SUMMARY ***
Total pot $5.35 | Rake $0.27 
Board [Kc 9s 6d Ah]
Seat 1: kazuking0318 folded on the Turn
Seat 2: speedbird uk folded before Flop (didn't bet)
Seat 3: o-chan1986 folded before Flop (didn't bet)
Seat 4: Thefinster71 folded before Flop (didn't bet)
Seat 5: artemxxl (button) folded before Flop (didn't bet)
Seat 6: Zhud19 (small blind) folded before Flop
Seat 7: takakensu (big blind) folded before Flop
Seat 8: Pete007poker folded before Flop (didn't bet)
Seat 9: Petrof98 collected ($5.08)



PokerStars Hand #228679691601:  Hold'em No Limit ($0.25/$0.50 USD) - 2021/07/30 10:11:35 ET
Table 'Aitne III' 9-max Seat #6 is the button
Seat 1: kazuking0318 ($39.02 in chips) 
Seat 2: speedbird uk ($55.96 in chips) 
Seat 3: o-chan1986 ($71.68 in chips) 
Seat 4: Thefinster71 ($46.55 in chips) 
Seat 5: artemxxl ($54.37 in chips) 
Seat 6: Zhud19 ($50 in chips) 
Seat 7: takakensu ($54.32 in chips) 
Seat 8: Pete007poker ($61.44 in chips) 
Seat 9: Petrof98 ($31.51 in chips) 
takakensu: posts small blind $0.25
Pete007poker: posts big blind $0.50
*** HOLE CARDS ***
Petrof98: folds 
kazuking0318: folds 
speedbird uk: folds 
o-chan1986: folds 
Thefinster71: raises $1 to $1.50
artemxxl: folds 
Zhud19: folds 
takakensu: folds 
Pete007poker: folds 
Uncalled bet ($1) returned to Thefinster71
Thefinster71 collected $1.25 from pot
Thefinster71: doesn't show hand 
*** SUMMARY ***
Total pot $1.25 | Rake $0 
Seat 1: kazuking0318 folded before Flop (didn't bet)
Seat 2: speedbird uk folded before Flop (didn't bet)
Seat 3: o-chan1986 folded before Flop (didn't bet)
Seat 4: Thefinster71 collected ($1.25)
Seat 5: artemxxl folded before Flop (didn't bet)
Seat 6: Zhud19 (button) folded before Flop (didn't bet)
Seat 7: takakensu (small blind) folded before Flop
Seat 8: Pete007poker (big blind) folded before Flop
Seat 9: Petrof98 folded before Flop (didn't bet)



PokerStars Hand #228679697545:  Hold'em No Limit ($0.25/$0.50 USD) - 2021/07/30 10:11:54 ET
Table 'Aitne III' 9-max Seat #7 is the button
Seat 1: kazuking0318 ($39.02 in chips) 
Seat 2: speedbird uk ($55.96 in chips) 
Seat 3: o-chan1986 ($71.68 in chips) 
Seat 4: Thefinster71 ($47.30 in chips) 
Seat 5: artemxxl ($54.37 in chips) 
Seat 6: Zhud19 ($50 in chips) 
Seat 7: takakensu ($54.07 in chips) 
Seat 8: Pete007poker ($60.94 in chips) 
Seat 9: Petrof98 ($31.51 in chips) 
Pete007poker: posts small blind $0.25
Petrof98: posts big blind $0.50
*** HOLE CARDS ***
kazuking0318: folds 
speedbird uk: folds 
o-chan1986: folds 
Thefinster71: folds 
artemxxl: folds 
Zhud19: raises $1 to $1.50
takakensu: folds 
Pete007poker: folds 
Petrof98: folds 
Uncalled bet ($1) returned to Zhud19
Zhud19 collected $1.25 from pot
*** SUMMARY ***
Total pot $1.25 | Rake $0 
Seat 1: kazuking0318 folded before Flop (didn't bet)
Seat 2: speedbird uk folded before Flop (didn't bet)
Seat 3: o-chan1986 folded before Flop (didn't bet)
Seat 4: Thefinster71 folded before Flop (didn't bet)
Seat 5: artemxxl folded before Flop (didn't bet)
Seat 6: Zhud19 collected ($1.25)
Seat 7: takakensu (button) folded before Flop (didn't bet)
Seat 8: Pete007poker (small blind) folded before Flop
Seat 9: Petrof98 (big blind) folded before Flop



PokerStars Hand #228679703722:  Hold'em No Limit ($0.25/$0.50 USD) - 2021/07/30 10:12:15 ET
Table 'Aitne III' 9-max Seat #8 is the button
Seat 1: kazuking0318 ($39.02 in chips) 
Seat 2: speedbird uk ($55.96 in chips) 
Seat 3: o-chan1986 ($71.68 in chips) 
Seat 4: Thefinster71 ($47.30 in chips) 
Seat 5: artemxxl ($54.37 in chips) 
Seat 6: Zhud19 ($50.75 in chips) 
Seat 7: takakensu ($54.07 in chips) 
Seat 8: Pete007poker ($60.69 in chips) 
Seat 9: Petrof98 ($31.01 in chips) 
Petrof98: posts small blind $0.25
kazuking0318: posts big blind $0.50
*** HOLE CARDS ***
speedbird uk: raises $1 to $1.50
o-chan1986: folds 
Thefinster71: folds 
artemxxl: folds 
Zhud19: folds 
takakensu: folds 
Pete007poker: calls $1.50
Petrof98: folds 
kazuking0318: calls $1
*** FLOP *** [Th 8c Jc]
kazuking0318: checks 
speedbird uk: bets $1.50
Pete007poker: calls $1.50
kazuking0318: calls $1.50
*** TURN *** [Th 8c Jc] [Qc]
kazuking0318: checks 
speedbird uk: checks 
Pete007poker: checks 
*** RIVER *** [Th 8c Jc Qc] [5c]
kazuking0318: checks 
speedbird uk: checks 
Pete007poker: checks 
*** SHOW DOWN ***
kazuking0318: shows [Ah 9s] (a straight, Eight to Queen)
speedbird uk: mucks hand 
Pete007poker: mucks hand 
kazuking0318 collected $8.79 from pot
*** SUMMARY ***
Total pot $9.25 | Rake $0.46 
Board [Th 8c Jc Qc 5c]
Seat 1: kazuking0318 (big blind) showed [Ah 9s] and won ($8.79) with a straight, Eight to Queen
Seat 2: speedbird uk mucked
Seat 3: o-chan1986 folded before Flop (didn't bet)
Seat 4: Thefinster71 folded before Flop (didn't bet)
Seat 5: artemxxl folded before Flop (didn't bet)
Seat 6: Zhud19 folded before Flop (didn't bet)
Seat 7: takakensu folded before Flop (didn't bet)
Seat 8: Pete007poker (button) mucked
Seat 9: Petrof98 (small blind) folded before Flop



PokerStars Hand #228679721422:  Hold'em No Limit ($0.25/$0.50 USD) - 2021/07/30 10:13:14 ET
Table 'Aitne III' 9-max Seat #9 is the button
Seat 1: kazuking0318 ($44.81 in chips) 
Seat 2: speedbird uk ($52.96 in chips) 
Seat 3: o-chan1986 ($71.68 in chips) 
Seat 4: Thefinster71 ($47.30 in chips) 
Seat 5: artemxxl ($54.37 in chips) 
Seat 6: Zhud19 ($50.75 in chips) 
Seat 7: takakensu ($54.07 in chips) 
Seat 8: Pete007poker ($57.69 in chips) 
Seat 9: Petrof98 ($30.76 in chips) 
kazuking0318: posts small blind $0.25
speedbird uk: posts big blind $0.50
*** HOLE CARDS ***
o-chan1986: folds 
Thefinster71: folds 
artemxxl: folds 
Zhud19: folds 
takakensu: folds 
Pete007poker: folds 
Petrof98: folds 
kazuking0318: raises $1 to $1.50
speedbird uk: folds 
Uncalled bet ($1) returned to kazuking0318
kazuking0318 collected $1 from pot
kazuking0318: doesn't show hand 
*** SUMMARY ***
Total pot $1 | Rake $0 
Seat 1: kazuking0318 (small blind) collected ($1)
Seat 2: speedbird uk (big blind) folded before Flop
Seat 3: o-chan1986 folded before Flop (didn't bet)
Seat 4: Thefinster71 folded before Flop (didn't bet)
Seat 5: artemxxl folded before Flop (didn't bet)
Seat 6: Zhud19 folded before Flop (didn't bet)
Seat 7: takakensu folded before Flop (didn't bet)
Seat 8: Pete007poker folded before Flop (didn't bet)
Seat 9: Petrof98 (button) folded before Flop (didn't bet)



PokerStars Hand #228679727086:  Hold'em No Limit ($0.25/$0.50 USD) - 2021/07/30 10:13:33 ET
Table 'Aitne III' 9-max Seat #1 is the button
Seat 1: kazuking0318 ($45.31 in chips) 
Seat 2: speedbird uk ($52.46 in chips) 
Seat 3: o-chan1986 ($71.68 in chips) 
Seat 4: Thefinster71 ($47.30 in chips) 
Seat 5: artemxxl ($54.37 in chips) 
Seat 6: Zhud19 ($50.75 in chips) 
Seat 7: takakensu ($54.07 in chips) 
Seat 8: Pete007poker ($57.69 in chips) 
Seat 9: Petrof98 ($30.76 in chips) 
speedbird uk: posts small blind $0.25
o-chan1986: posts big blind $0.50
*** HOLE CARDS ***
Thefinster71: raises $1 to $1.50
artemxxl: folds 
Zhud19: folds 
takakensu: folds 
Pete007poker: folds 
Petrof98: calls $1.50
kazuking0318: folds 
speedbird uk: folds 
o-chan1986: folds 
*** FLOP *** [3s Qh 5h]
Thefinster71: bets $1.50
Petrof98: folds 
Uncalled bet ($1.50) returned to Thefinster71
Thefinster71 collected $3.56 from pot
Thefinster71: doesn't show hand 
*** SUMMARY ***
Total pot $3.75 | Rake $0.19 
Board [3s Qh 5h]
Seat 1: kazuking0318 (button) folded before Flop (didn't bet)
Seat 2: speedbird uk (small blind) folded before Flop
Seat 3: o-chan1986 (big blind) folded before Flop
Seat 4: Thefinster71 collected ($3.56)
Seat 5: artemxxl folded before Flop (didn't bet)
Seat 6: Zhud19 folded before Flop (didn't bet)
Seat 7: takakensu folded before Flop (didn't bet)
Seat 8: Pete007poker folded before Flop (didn't bet)
Seat 9: Petrof98 folded on the Flop



PokerStars Hand #228679739055:  Hold'em No Limit ($0.25/$0.50 USD) - 2021/07/30 10:14:13 ET
Table 'Aitne III' 9-max Seat #2 is the button
Seat 1: kazuking0318 ($45.31 in chips) 
Seat 2: speedbird uk ($52.21 in chips) 
Seat 3: o-chan1986 ($71.18 in chips) 
Seat 4: Thefinster71 ($49.36 in chips) 
Seat 5: artemxxl ($54.37 in chips) 
Seat 6: Zhud19 ($50.75 in chips) 
Seat 7: takakensu ($54.07 in chips) 
Seat 8: Pete007poker ($57.69 in chips) 
Seat 9: Petrof98 ($29.26 in chips) 
o-chan1986: posts small blind $0.25
Thefinster71: posts big blind $0.50
*** HOLE CARDS ***
artemxxl: folds 
Zhud19: folds 
takakensu: folds 
Pete007poker: folds 
Petrof98: raises $0.75 to $1.25
kazuking0318: folds 
speedbird uk: folds 
o-chan1986: folds 
Thefinster71: folds 
Uncalled bet ($0.75) returned to Petrof98
Petrof98 collected $1.25 from pot
Petrof98: doesn't show hand 
*** SUMMARY ***
Total pot $1.25 | Rake $0 
Seat 1: kazuking0318 folded before Flop (didn't bet)
Seat 2: speedbird uk (button) folded before Flop (didn't bet)
Seat 3: o-chan1986 (small blind) folded before Flop
Seat 4: Thefinster71 (big blind) folded before Flop
Seat 5: artemxxl folded before Flop (didn't bet)
Seat 6: Zhud19 folded before Flop (didn't bet)
Seat 7: takakensu folded before Flop (didn't bet)
Seat 8: Pete007poker folded before Flop (didn't bet)
Seat 9: Petrof98 collected ($1.25)



PokerStars Hand #228679743490:  Hold'em No Limit ($0.25/$0.50 USD) - 2021/07/30 10:14:28 ET
Table 'Aitne III' 9-max Seat #3 is the button
Seat 1: kazuking0318 ($45.31 in chips) 
Seat 2: speedbird uk ($52.21 in chips) 
Seat 3: o-chan1986 ($70.93 in chips) 
Seat 4: Thefinster71 ($48.86 in chips) 
Seat 5: artemxxl ($54.37 in chips) 
Seat 6: Zhud19 ($50.75 in chips) 
Seat 7: takakensu ($54.07 in chips) 
Seat 8: Pete007poker ($57.69 in chips) 
Seat 9: Petrof98 ($30.01 in chips) 
Thefinster71: posts small blind $0.25
artemxxl: posts big blind $0.50
*** HOLE CARDS ***
Zhud19: folds 
takakensu: raises $1 to $1.50
Pete007poker: folds 
Petrof98: folds 
kazuking0318: folds 
speedbird uk: calls $1.50
o-chan1986: calls $1.50
Thefinster71: folds 
artemxxl: folds 
*** FLOP *** [2d Ts 9h]
takakensu: bets $2.49
speedbird uk: folds 
o-chan1986: folds 
Uncalled bet ($2.49) returned to takakensu
takakensu collected $4.99 from pot
takakensu: doesn't show hand 
*** SUMMARY ***
Total pot $5.25 | Rake $0.26 
Board [2d Ts 9h]
Seat 1: kazuking0318 folded before Flop (didn't bet)
Seat 2: speedbird uk folded on the Flop
Seat 3: o-chan1986 (button) folded on the Flop
Seat 4: Thefinster71 (small blind) folded before Flop
Seat 5: artemxxl (big blind) folded before Flop
Seat 6: Zhud19 folded before Flop (didn't bet)
Seat 7: takakensu collected ($4.99)
Seat 8: Pete007poker folded before Flop (didn't bet)
Seat 9: Petrof98 folded before Flop (didn't bet)



PokerStars Hand #228679752205:  Hold'em No Limit ($0.25/$0.50 USD) - 2021/07/30 10:14:57 ET
Table 'Aitne III' 9-max Seat #4 is the button
Seat 1: kazuking0318 ($45.31 in chips) 
Seat 2: speedbird uk ($50.71 in chips) 
Seat 3: o-chan1986 ($69.43 in chips) 
Seat 4: Thefinster71 ($48.61 in chips) 
Seat 5: artemxxl ($53.87 in chips) 
Seat 6: Zhud19 ($50.75 in chips) 
Seat 7: takakensu ($57.56 in chips) 
Seat 8: Pete007poker ($57.69 in chips) 
Seat 9: Petrof98 ($30.01 in chips) 
artemxxl: posts small blind $0.25
Zhud19: posts big blind $0.50
*** HOLE CARDS ***
takakensu: folds 
Pete007poker: folds 
Petrof98: folds 
kazuking0318: folds 
speedbird uk: calls $0.50
o-chan1986: folds 
Thefinster71: folds 
artemxxl: calls $0.25
Zhud19: checks 
*** FLOP *** [Qd Ad 9d]
artemxxl: bets $0.94
Zhud19: calls $0.94
speedbird uk: calls $0.94
*** TURN *** [Qd Ad 9d] [Ts]
artemxxl: checks 
Zhud19: checks 
speedbird uk: checks 
*** RIVER *** [Qd Ad 9d Ts] [5h]
artemxxl: bets $1.23
Zhud19: calls $1.23
speedbird uk: folds 
*** SHOW DOWN ***
artemxxl: shows [9h Qs] (two pair, Queens and Nines)
Zhud19: mucks hand 
artemxxl collected $6.44 from pot
*** SUMMARY ***
Total pot $6.78 | Rake $0.34 
Board [Qd Ad 9d Ts 5h]
Seat 1: kazuking0318 folded before Flop (didn't bet)
Seat 2: speedbird uk folded on the River
Seat 3: o-chan1986 folded before Flop (didn't bet)
Seat 4: Thefinster71 (button) folded before Flop (didn't bet)
Seat 5: artemxxl (small blind) showed [9h Qs] and won ($6.44) with two pair, Queens and Nines
Seat 6: Zhud19 (big blind) mucked
Seat 7: takakensu folded before Flop (didn't bet)
Seat 8: Pete007poker folded before Flop (didn't bet)
Seat 9: Petrof98 folded before Flop (didn't bet)



PokerStars Hand #228679765776:  Hold'em No Limit ($0.25/$0.50 USD) - 2021/07/30 10:15:42 ET
Table 'Aitne III' 9-max Seat #5 is the button
Seat 1: kazuking0318 ($45.31 in chips) 
Seat 2: speedbird uk ($49.27 in chips) 
Seat 3: o-chan1986 ($69.43 in chips) 
Seat 4: Thefinster71 ($48.61 in chips) 
Seat 5: artemxxl ($57.64 in chips) 
Seat 6: Zhud19 ($50 in chips) 
Seat 7: takakensu ($57.56 in chips) 
Seat 8: Pete007poker ($57.69 in chips) 
Seat 9: Petrof98 ($30.01 in chips) 
Zhud19: posts small blind $0.25
takakensu: posts big blind $0.50
*** HOLE CARDS ***
Pete007poker: folds 
Petrof98: raises $0.75 to $1.25
kazuking0318: calls $1.25
speedbird uk: folds 
o-chan1986: calls $1.25
Thefinster71: folds 
artemxxl: folds 
Zhud19: folds 
takakensu: folds 
*** FLOP *** [8h 2h Jh]
Petrof98: bets $1.46
kazuking0318: calls $1.46
o-chan1986: calls $1.46
*** TURN *** [8h 2h Jh] [2c]
Petrof98: bets $4.64
kazuking0318: folds 
o-chan1986: folds 
Uncalled bet ($4.64) returned to Petrof98
Petrof98 collected $8.44 from pot
Petrof98: doesn't show hand 
*** SUMMARY ***
Total pot $8.88 | Rake $0.44 
Board [8h 2h Jh 2c]
Seat 1: kazuking0318 folded on the Turn
Seat 2: speedbird uk folded before Flop (didn't bet)
Seat 3: o-chan1986 folded on the Turn
Seat 4: Thefinster71 folded before Flop (didn't bet)
Seat 5: artemxxl (button) folded before Flop (didn't bet)
Seat 6: Zhud19 (small blind) folded before Flop
Seat 7: takakensu (big blind) folded before Flop
Seat 8: Pete007poker folded before Flop (didn't bet)
Seat 9: Petrof98 collected ($8.44)



PokerStars Hand #228679785415:  Hold'em No Limit ($0.25/$0.50 USD) - 2021/07/30 10:16:47 ET
Table 'Aitne III' 9-max Seat #6 is the button
Seat 1: kazuking0318 ($42.60 in chips) 
Seat 2: speedbird uk ($49.27 in chips) 
Seat 3: o-chan1986 ($66.72 in chips) 
Seat 4: Thefinster71 ($48.61 in chips) 
Seat 5: artemxxl ($57.64 in chips) 
Seat 6: Zhud19 ($50 in chips) 
Seat 7: takakensu ($57.06 in chips) 
Seat 8: Pete007poker ($57.69 in chips) 
Seat 9: Petrof98 ($35.74 in chips) 
takakensu: posts small blind $0.25
Pete007poker: posts big blind $0.50
*** HOLE CARDS ***
Petrof98: folds 
kazuking0318: folds 
speedbird uk: folds 
o-chan1986: folds 
Thefinster71: folds 
artemxxl: folds 
Zhud19: raises $1 to $1.50
takakensu: calls $1.25
Pete007poker: folds 
*** FLOP *** [As 2d 9h]
takakensu: bets $1.66
Zhud19: calls $1.66
*** TURN *** [As 2d 9h] [8s]
takakensu: checks 
Zhud19: checks 
*** RIVER *** [As 2d 9h 8s] [6h]
takakensu: bets $3.24
Zhud19: folds 
Uncalled bet ($3.24) returned to takakensu
takakensu collected $6.48 from pot
takakensu: doesn't show hand 
*** SUMMARY ***
Total pot $6.82 | Rake $0.34 
Board [As 2d 9h 8s 6h]
Seat 1: kazuking0318 folded before Flop (didn't bet)
Seat 2: speedbird uk folded before Flop (didn't bet)
Seat 3: o-chan1986 folded before Flop (didn't bet)
Seat 4: Thefinster71 folded before Flop (didn't bet)
Seat 5: artemxxl folded before Flop (didn't bet)
Seat 6: Zhud19 (button) folded on the River
Seat 7: takakensu (small blind) collected ($6.48)
Seat 8: Pete007poker (big blind) folded before Flop
Seat 9: Petrof98 folded before Flop (didn't bet)



PokerStars Hand #228679799792:  Hold'em No Limit ($0.25/$0.50 USD) - 2021/07/30 10:17:34 ET
Table 'Aitne III' 9-max Seat #7 is the button
Seat 1: kazuking0318 ($42.60 in chips) 
Seat 2: speedbird uk ($49.27 in chips) 
Seat 3: o-chan1986 ($66.72 in chips) 
Seat 4: Thefinster71 ($48.61 in chips) 
Seat 5: artemxxl ($57.64 in chips) 
Seat 6: Zhud19 ($50 in chips) 
Seat 7: takakensu ($60.38 in chips) 
Seat 8: Pete007poker ($57.19 in chips) 
Seat 9: Petrof98 ($35.74 in chips) 
Pete007poker: posts small blind $0.25
Petrof98: posts big blind $0.50
*** HOLE CARDS ***
kazuking0318: folds 
speedbird uk: folds 
o-chan1986: raises $0.75 to $1.25
Thefinster71: folds 
kazuking0318 leaves the table
artemxxl: folds 
Zhud19: folds 
takakensu: raises $1.25 to $2.50
Infinities4 joins the table at seat #1 
Pete007poker: folds 
Petrof98: folds 
o-chan1986: folds 
Uncalled bet ($1.25) returned to takakensu
takakensu collected $3.25 from pot
takakensu: doesn't show hand 
*** SUMMARY ***
Total pot $3.25 | Rake $0 
Seat 1: kazuking0318 folded before Flop (didn't bet)
Seat 2: speedbird uk folded before Flop (didn't bet)
Seat 3: o-chan1986 folded before Flop
Seat 4: Thefinster71 folded before Flop (didn't bet)
Seat 5: artemxxl folded before Flop (didn't bet)
Seat 6: Zhud19 folded before Flop (didn't bet)
Seat 7: takakensu (button) collected ($3.25)
Seat 8: Pete007poker (small blind) folded before Flop
Seat 9: Petrof98 (big blind) folded before Flop



PokerStars Hand #228679809325:  Hold'em No Limit ($0.25/$0.50 USD) - 2021/07/30 10:18:05 ET
Table 'Aitne III' 9-max Seat #8 is the button
Seat 1: Infinities4 ($51.65 in chips) 
Seat 2: speedbird uk ($49.27 in chips) 
Seat 3: o-chan1986 ($65.47 in chips) 
Seat 4: Thefinster71 ($48.61 in chips) 
Seat 5: artemxxl ($57.64 in chips) 
Seat 6: Zhud19 ($50 in chips) 
Seat 7: takakensu ($62.38 in chips) 
Seat 8: Pete007poker ($56.94 in chips) 
Seat 9: Petrof98 ($35.24 in chips) 
Petrof98: posts small blind $0.25
Infinities4: posts big blind $0.50
*** HOLE CARDS ***
speedbird uk: folds 
o-chan1986: folds 
Thefinster71: raises $1 to $1.50
artemxxl: folds 
Zhud19: folds 
takakensu: folds 
Pete007poker: folds 
Petrof98: folds 
Infinities4: folds 
Uncalled bet ($1) returned to Thefinster71
Thefinster71 collected $1.25 from pot
Thefinster71: doesn't show hand 
*** SUMMARY ***
Total pot $1.25 | Rake $0 
Seat 1: Infinities4 (big blind) folded before Flop
Seat 2: speedbird uk folded before Flop (didn't bet)
Seat 3: o-chan1986 folded before Flop (didn't bet)
Seat 4: Thefinster71 collected ($1.25)
Seat 5: artemxxl folded before Flop (didn't bet)
Seat 6: Zhud19 folded before Flop (didn't bet)
Seat 7: takakensu folded before Flop (didn't bet)
Seat 8: Pete007poker (button) folded before Flop (didn't bet)
Seat 9: Petrof98 (small blind) folded before Flop



PokerStars Hand #228679814064:  Hold'em No Limit ($0.25/$0.50 USD) - 2021/07/30 10:18:21 ET
Table 'Aitne III' 9-max Seat #9 is the button
Seat 1: Infinities4 ($51.15 in chips) 
Seat 2: speedbird uk ($49.27 in chips) 
Seat 3: o-chan1986 ($65.47 in chips) 
Seat 4: Thefinster71 ($49.36 in chips) 
Seat 5: artemxxl ($57.64 in chips) 
Seat 6: Zhud19 ($50 in chips) 
Seat 7: takakensu ($62.38 in chips) 
Seat 8: Pete007poker ($56.94 in chips) 
Seat 9: Petrof98 ($34.99 in chips) 
Infinities4: posts small blind $0.25
speedbird uk: posts big blind $0.50
*** HOLE CARDS ***
o-chan1986: folds 
Thefinster71: raises $1 to $1.50
artemxxl: folds 
Zhud19: folds 
takakensu: folds 
Pete007poker: calls $1.50
Petrof98: folds 
Infinities4: folds 
speedbird uk: calls $1
*** FLOP *** [Td 5h 4h]
speedbird uk: checks 
Thefinster71: checks 
Pete007poker: bets $2.26
speedbird uk: folds 
Thefinster71: calls $2.26
*** TURN *** [Td 5h 4h] [Qd]
Thefinster71: checks 
Pete007poker: checks 
*** RIVER *** [Td 5h 4h Qd] [As]
Thefinster71: checks 
Pete007poker: bets $2.64
Thefinster71: calls $2.64
*** SHOW DOWN ***
Pete007poker: shows [6h Ah] (a pair of Aces)
Thefinster71: mucks hand 
Pete007poker collected $13.82 from pot
*** SUMMARY ***
Total pot $14.55 | Rake $0.73 
Board [Td 5h 4h Qd As]
Seat 1: Infinities4 (small blind) folded before Flop
Seat 2: speedbird uk (big blind) folded on the Flop
Seat 3: o-chan1986 folded before Flop (didn't bet)
Seat 4: Thefinster71 mucked
Seat 5: artemxxl folded before Flop (didn't bet)
Seat 6: Zhud19 folded before Flop (didn't bet)
Seat 7: takakensu folded before Flop (didn't bet)
Seat 8: Pete007poker showed [6h Ah] and won ($13.82) with a pair of Aces
Seat 9: Petrof98 (button) folded before Flop (didn't bet)



PokerStars Hand #228679832417:  Hold'em No Limit ($0.25/$0.50 USD) - 2021/07/30 10:19:22 ET
Table 'Aitne III' 9-max Seat #1 is the button
Seat 1: Infinities4 ($50.90 in chips) 
Seat 2: speedbird uk ($47.77 in chips) 
Seat 3: o-chan1986 ($65.47 in chips) 
Seat 4: Thefinster71 ($42.96 in chips) 
Seat 5: artemxxl ($57.64 in chips) 
Seat 6: Zhud19 ($50 in chips) 
Seat 7: takakensu ($62.38 in chips) 
Seat 8: Pete007poker ($64.36 in chips) 
Seat 9: Petrof98 ($34.99 in chips) 
speedbird uk: posts small blind $0.25
o-chan1986: posts big blind $0.50
*** HOLE CARDS ***
Thefinster71: folds 
artemxxl: folds 
Zhud19: raises $1 to $1.50
takakensu: folds 
Pete007poker: folds 
Petrof98: folds 
Infinities4: folds 
speedbird uk: folds 
o-chan1986: folds 
Uncalled bet ($1) returned to Zhud19
Zhud19 collected $1.25 from pot
*** SUMMARY ***
Total pot $1.25 | Rake $0 
Seat 1: Infinities4 (button) folded before Flop (didn't bet)
Seat 2: speedbird uk (small blind) folded before Flop
Seat 3: o-chan1986 (big blind) folded before Flop
Seat 4: Thefinster71 folded before Flop (didn't bet)
Seat 5: artemxxl folded before Flop (didn't bet)
Seat 6: Zhud19 collected ($1.25)
Seat 7: takakensu folded before Flop (didn't bet)
Seat 8: Pete007poker folded before Flop (didn't bet)
Seat 9: Petrof98 folded before Flop (didn't bet)



PokerStars Hand #228679839575:  Hold'em No Limit ($0.25/$0.50 USD) - 2021/07/30 10:19:45 ET
Table 'Aitne III' 9-max Seat #2 is the button
Seat 1: Infinities4 ($50.90 in chips) 
Seat 2: speedbird uk ($47.52 in chips) 
Seat 3: o-chan1986 ($64.97 in chips) 
Seat 4: Thefinster71 ($42.96 in chips) 
Seat 5: artemxxl ($57.64 in chips) 
Seat 6: Zhud19 ($50.75 in chips) 
Seat 7: takakensu ($62.38 in chips) 
Seat 8: Pete007poker ($64.36 in chips) 
Seat 9: Petrof98 ($34.99 in chips) 
o-chan1986: posts small blind $0.25
Thefinster71: posts big blind $0.50
*** HOLE CARDS ***
artemxxl: folds 
Zhud19: folds 
takakensu: folds 
Pete007poker: raises $0.75 to $1.25
Petrof98: folds 
Infinities4: folds 
speedbird uk: folds 
o-chan1986: folds 
Thefinster71: folds 
Uncalled bet ($0.75) returned to Pete007poker
Pete007poker collected $1.25 from pot
*** SUMMARY ***
Total pot $1.25 | Rake $0 
Seat 1: Infinities4 folded before Flop (didn't bet)
Seat 2: speedbird uk (button) folded before Flop (didn't bet)
Seat 3: o-chan1986 (small blind) folded before Flop
Seat 4: Thefinster71 (big blind) folded before Flop
Seat 5: artemxxl folded before Flop (didn't bet)
Seat 6: Zhud19 folded before Flop (didn't bet)
Seat 7: takakensu folded before Flop (didn't bet)
Seat 8: Pete007poker collected ($1.25)
Seat 9: Petrof98 folded before Flop (didn't bet)



PokerStars Hand #228679843146:  Hold'em No Limit ($0.25/$0.50 USD) - 2021/07/30 10:19:57 ET
Table 'Aitne III' 9-max Seat #3 is the button
Seat 1: Infinities4 ($50.90 in chips) 
Seat 2: speedbird uk ($47.52 in chips) 
Seat 3: o-chan1986 ($64.72 in chips) 
Seat 4: Thefinster71 ($42.46 in chips) 
Seat 5: artemxxl ($57.64 in chips) 
Seat 6: Zhud19 ($50.75 in chips) 
Seat 7: takakensu ($62.38 in chips) 
Seat 8: Pete007poker ($65.11 in chips) 
Seat 9: Petrof98 ($34.99 in chips) 
Thefinster71: posts small blind $0.25
artemxxl: posts big blind $0.50
*** HOLE CARDS ***
Zhud19: folds 
takakensu: folds 
Pete007poker: folds 
Petrof98: folds 
Infinities4: folds 
speedbird uk: folds 
o-chan1986: raises $0.75 to $1.25
Thefinster71: folds 
artemxxl: folds 
Uncalled bet ($0.75) returned to o-chan1986
o-chan1986 collected $1.25 from pot
o-chan1986: doesn't show hand 
*** SUMMARY ***
Total pot $1.25 | Rake $0 
Seat 1: Infinities4 folded before Flop (didn't bet)
Seat 2: speedbird uk folded before Flop (didn't bet)
Seat 3: o-chan1986 (button) collected ($1.25)
Seat 4: Thefinster71 (small blind) folded before Flop
Seat 5: artemxxl (big blind) folded before Flop
Seat 6: Zhud19 folded before Flop (didn't bet)
Seat 7: takakensu folded before Flop (didn't bet)
Seat 8: Pete007poker folded before Flop (didn't bet)
Seat 9: Petrof98 folded before Flop (didn't bet)



PokerStars Hand #228679847968:  Hold'em No Limit ($0.25/$0.50 USD) - 2021/07/30 10:20:13 ET
Table 'Aitne III' 9-max Seat #4 is the button
Seat 1: Infinities4 ($50.90 in chips) 
Seat 2: speedbird uk ($47.52 in chips) 
Seat 3: o-chan1986 ($65.47 in chips) 
Seat 4: Thefinster71 ($42.21 in chips) 
Seat 5: artemxxl ($57.14 in chips) 
Seat 6: Zhud19 ($50.75 in chips) 
Seat 7: takakensu ($62.38 in chips) 
Seat 8: Pete007poker ($65.11 in chips) 
Seat 9: Petrof98 ($34.99 in chips) 
artemxxl: posts small blind $0.25
Zhud19: posts big blind $0.50
*** HOLE CARDS ***
takakensu: folds 
Pete007poker: folds 
Petrof98: folds 
Infinities4: folds 
speedbird uk: folds 
o-chan1986: folds 
Thefinster71: raises $1 to $1.50
artemxxl: raises $4 to $5.50
Zhud19: folds 
Thefinster71: folds 
Uncalled bet ($4) returned to artemxxl
artemxxl collected $3.50 from pot
*** SUMMARY ***
Total pot $3.50 | Rake $0 
Seat 1: Infinities4 folded before Flop (didn't bet)
Seat 2: speedbird uk folded before Flop (didn't bet)
Seat 3: o-chan1986 folded before Flop (didn't bet)
Seat 4: Thefinster71 (button) folded before Flop
Seat 5: artemxxl (small blind) collected ($3.50)
Seat 6: Zhud19 (big blind) folded before Flop
Seat 7: takakensu folded before Flop (didn't bet)
Seat 8: Pete007poker folded before Flop (didn't bet)
Seat 9: Petrof98 folded before Flop (didn't bet)



PokerStars Hand #228679855258:  Hold'em No Limit ($0.25/$0.50 USD) - 2021/07/30 10:20:37 ET
Table 'Aitne III' 9-max Seat #5 is the button
Seat 1: Infinities4 ($50.90 in chips) 
Seat 2: speedbird uk ($47.52 in chips) 
Seat 3: o-chan1986 ($65.47 in chips) 
Seat 4: Thefinster71 ($40.71 in chips) 
Seat 5: artemxxl ($59.14 in chips) 
Seat 6: Zhud19 ($50.25 in chips) 
Seat 7: takakensu ($62.38 in chips) 
Seat 8: Pete007poker ($65.11 in chips) 
Seat 9: Petrof98 ($34.99 in chips) 
Zhud19: posts small blind $0.25
takakensu: posts big blind $0.50
*** HOLE CARDS ***
Pete007poker: folds 
Petrof98: folds 
Infinities4: folds 
speedbird uk: folds 
o-chan1986: folds 
Thefinster71: folds 
artemxxl: folds 
Zhud19: folds 
Uncalled bet ($0.25) returned to takakensu
takakensu collected $0.50 from pot
takakensu: doesn't show hand 
*** SUMMARY ***
Total pot $0.50 | Rake $0 
Seat 1: Infinities4 folded before Flop (didn't bet)
Seat 2: speedbird uk folded before Flop (didn't bet)
Seat 3: o-chan1986 folded before Flop (didn't bet)
Seat 4: Thefinster71 folded before Flop (didn't bet)
Seat 5: artemxxl (button) folded before Flop (didn't bet)
Seat 6: Zhud19 (small blind) folded before Flop
Seat 7: takakensu (big blind) collected ($0.50)
Seat 8: Pete007poker folded before Flop (didn't bet)
Seat 9: Petrof98 folded before Flop (didn't bet)



PokerStars Hand #228678934949:  Hold'em No Limit ($0.25/$0.50 USD) - 2021/07/30 9:27:58 ET
Table 'Aitne III' 9-max Seat #7 is the button
Seat 1: Gad7dee ($37.09 in chips) 
Seat 3: akbloger ($64.65 in chips) 
Seat 4: xandr67 ($50 in chips) 
Seat 5: artemxxl ($61.10 in chips) 
Seat 6: Slami4 ($50 in chips) 
Seat 7: takakensu ($50 in chips) 
Seat 8: Pete007poker ($50 in chips) 
Seat 9: Infinities4 ($50 in chips) 
Pete007poker: posts small blind $0.25
Infinities4: posts big blind $0.50
speedbird uk: sits out 
*** HOLE CARDS ***
Gad7dee: calls $0.50
akbloger: folds 
xandr67: folds 
artemxxl: folds 
Slami4: folds 
takakensu: folds 
Pete007poker: calls $0.25
Infinities4: checks 
*** FLOP *** [Jd 9d 4s]
Pete007poker: checks 
Infinities4: bets $0.58
Gad7dee: calls $0.58
Pete007poker: calls $0.58
*** TURN *** [Jd 9d 4s] [Tc]
Pete007poker: checks 
Infinities4: checks 
Gad7dee: bets $1.54
Pete007poker: folds 
Infinities4: calls $1.54
*** RIVER *** [Jd 9d 4s Tc] [6d]
Infinities4: checks 
Gad7dee: bets $3
Infinities4: calls $3
*** SHOW DOWN ***
Gad7dee: shows [Kc Jc] (a pair of Jacks)
Infinities4: mucks hand 
Gad7dee collected $11.70 from pot
*** SUMMARY ***
Total pot $12.32 | Rake $0.62 
Board [Jd 9d 4s Tc 6d]
Seat 1: Gad7dee showed [Kc Jc] and won ($11.70) with a pair of Jacks
Seat 3: akbloger folded before Flop (didn't bet)
Seat 4: xandr67 folded before Flop (didn't bet)
Seat 5: artemxxl folded before Flop (didn't bet)
Seat 6: Slami4 folded before Flop (didn't bet)
Seat 7: takakensu (button) folded before Flop (didn't bet)
Seat 8: Pete007poker (small blind) folded on the Turn
Seat 9: Infinities4 (big blind) mucked



PokerStars Hand #228678962032:  Hold'em No Limit ($0.25/$0.50 USD) - 2021/07/30 9:29:37 ET
Table 'Aitne III' 9-max Seat #8 is the button
Seat 1: Gad7dee ($43.17 in chips) 
Seat 3: akbloger ($64.65 in chips) 
Seat 4: xandr67 ($50 in chips) 
Seat 5: artemxxl ($61.10 in chips) 
Seat 6: Slami4 ($50 in chips) 
Seat 7: takakensu ($50 in chips) 
Seat 8: Pete007poker ($50 in chips) 
Seat 9: Infinities4 ($50 in chips) 
Infinities4: posts small blind $0.25
Gad7dee: posts big blind $0.50
speedbird uk: sits out 
*** HOLE CARDS ***
akbloger: folds 
xandr67: folds 
artemxxl: folds 
Slami4: folds 
takakensu: raises $1 to $1.50
Pete007poker: folds 
Infinities4: folds 
Gad7dee: folds 
Uncalled bet ($1) returned to takakensu
takakensu collected $1.25 from pot
takakensu: doesn't show hand 
*** SUMMARY ***
Total pot $1.25 | Rake $0 
Seat 1: Gad7dee (big blind) folded before Flop
Seat 3: akbloger folded before Flop (didn't bet)
Seat 4: xandr67 folded before Flop (didn't bet)
Seat 5: artemxxl folded before Flop (didn't bet)
Seat 6: Slami4 folded before Flop (didn't bet)
Seat 7: takakensu collected ($1.25)
Seat 8: Pete007poker (button) folded before Flop (didn't bet)
Seat 9: Infinities4 (small blind) folded before Flop



PokerStars Hand #228678966973:  Hold'em No Limit ($0.25/$0.50 USD) - 2021/07/30 9:29:55 ET
Table 'Aitne III' 9-max Seat #9 is the button
Seat 1: Gad7dee ($42.67 in chips) 
Seat 2: speedbird uk ($40 in chips) 
Seat 3: akbloger ($64.65 in chips) 
Seat 4: xandr67 ($50 in chips) 
Seat 5: artemxxl ($61.10 in chips) 
Seat 6: Slami4 ($50 in chips) 
Seat 7: takakensu ($50.75 in chips) 
Seat 8: Pete007poker ($50 in chips) 
Seat 9: Infinities4 ($50 in chips) 
Gad7dee: posts small blind $0.25
speedbird uk: posts big blind $0.50
*** HOLE CARDS ***
akbloger: folds 
akbloger leaves the table
xandr67: raises $0.75 to $1.25
artemxxl: folds 
Slami4: folds 
CocoAlexMix joins the table at seat #3 
takakensu: raises $2.25 to $3.50
Pete007poker: folds 
Infinities4: folds 
Gad7dee: folds 
speedbird uk: folds 
xandr67: calls $2.25
*** FLOP *** [2s 3d 4d]
xandr67: checks 
takakensu: bets $3.68
xandr67: calls $3.68
*** TURN *** [2s 3d 4d] [5d]
xandr67: checks 
takakensu: bets $7.17
xandr67: calls $7.17
*** RIVER *** [2s 3d 4d 5d] [Ks]
xandr67: checks 
takakensu: bets $13.99
xandr67: calls $13.99
*** SHOW DOWN ***
takakensu: shows [As Qh] (a straight, Ace to Five)
xandr67: shows [Ac 3c] (a straight, Ace to Five)
xandr67 collected $27.72 from pot
takakensu collected $27.71 from pot
*** SUMMARY ***
Total pot $57.43 | Rake $2 
Board [2s 3d 4d 5d Ks]
Seat 1: Gad7dee (small blind) folded before Flop
Seat 2: speedbird uk (big blind) folded before Flop
Seat 3: akbloger folded before Flop (didn't bet)
Seat 4: xandr67 showed [Ac 3c] and won ($27.72) with a straight, Ace to Five
Seat 5: artemxxl folded before Flop (didn't bet)
Seat 6: Slami4 folded before Flop (didn't bet)
Seat 7: takakensu showed [As Qh] and won ($27.71) with a straight, Ace to Five
Seat 8: Pete007poker folded before Flop (didn't bet)
Seat 9: Infinities4 (button) folded before Flop (didn't bet)



PokerStars Hand #228678986132:  Hold'em No Limit ($0.25/$0.50 USD) - 2021/07/30 9:31:03 ET
Table 'Aitne III' 9-max Seat #1 is the button
Seat 1: Gad7dee ($42.42 in chips) 
Seat 2: speedbird uk ($39.50 in chips) 
Seat 3: CocoAlexMix ($50 in chips) 
Seat 4: xandr67 ($50 in chips) 
Seat 5: artemxxl ($61.10 in chips) 
Seat 6: Slami4 ($50 in chips) 
Seat 7: takakensu ($50.12 in chips) 
Seat 8: Pete007poker ($50 in chips) 
Seat 9: Infinities4 ($50 in chips) 
speedbird uk: posts small blind $0.25
CocoAlexMix: posts big blind $0.50
*** HOLE CARDS ***
xandr67: folds 
artemxxl: folds 
Slami4: folds 
takakensu: folds 
Pete007poker: folds 
Infinities4: raises $0.74 to $1.24
Gad7dee: calls $1.24
speedbird uk: folds 
CocoAlexMix: folds 
*** FLOP *** [Qs Ks 3c]
Infinities4: bets $1.26
Gad7dee: calls $1.26
*** TURN *** [Qs Ks 3c] [4h]
Infinities4: checks 
Gad7dee: bets $1.50
Infinities4: folds 
Uncalled bet ($1.50) returned to Gad7dee
Gad7dee collected $5.46 from pot
Gad7dee: doesn't show hand 
*** SUMMARY ***
Total pot $5.75 | Rake $0.29 
Board [Qs Ks 3c 4h]
Seat 1: Gad7dee (button) collected ($5.46)
Seat 2: speedbird uk (small blind) folded before Flop
Seat 3: CocoAlexMix (big blind) folded before Flop
Seat 4: xandr67 folded before Flop (didn't bet)
Seat 5: artemxxl folded before Flop (didn't bet)
Seat 6: Slami4 folded before Flop (didn't bet)
Seat 7: takakensu folded before Flop (didn't bet)
Seat 8: Pete007poker folded before Flop (didn't bet)
Seat 9: Infinities4 folded on the Turn



PokerStars Hand #228678998865:  Hold'em No Limit ($0.25/$0.50 USD) - 2021/07/30 9:31:49 ET
Table 'Aitne III' 9-max Seat #2 is the button
Seat 1: Gad7dee ($45.38 in chips) 
Seat 2: speedbird uk ($39.25 in chips) 
Seat 3: CocoAlexMix ($50 in chips) 
Seat 4: xandr67 ($50 in chips) 
Seat 5: artemxxl ($61.10 in chips) 
Seat 6: Slami4 ($50 in chips) 
Seat 7: takakensu ($50.12 in chips) 
Seat 8: Pete007poker ($50 in chips) 
Seat 9: Infinities4 ($50 in chips) 
CocoAlexMix: posts small blind $0.25
xandr67: posts big blind $0.50
*** HOLE CARDS ***
artemxxl: folds 
Slami4: folds 
takakensu: folds 
Pete007poker: folds 
Infinities4: folds 
Gad7dee: folds 
speedbird uk: folds 
CocoAlexMix: folds 
Uncalled bet ($0.25) returned to xandr67
xandr67 collected $0.50 from pot
xandr67: doesn't show hand 
*** SUMMARY ***
Total pot $0.50 | Rake $0 
Seat 1: Gad7dee folded before Flop (didn't bet)
Seat 2: speedbird uk (button) folded before Flop (didn't bet)
Seat 3: CocoAlexMix (small blind) folded before Flop
Seat 4: xandr67 (big blind) collected ($0.50)
Seat 5: artemxxl folded before Flop (didn't bet)
Seat 6: Slami4 folded before Flop (didn't bet)
Seat 7: takakensu folded before Flop (didn't bet)
Seat 8: Pete007poker folded before Flop (didn't bet)
Seat 9: Infinities4 folded before Flop (didn't bet)



PokerStars Hand #228679003564:  Hold'em No Limit ($0.25/$0.50 USD) - 2021/07/30 9:32:06 ET
Table 'Aitne III' 9-max Seat #3 is the button
Seat 1: Gad7dee ($45.38 in chips) 
Seat 2: speedbird uk ($39.25 in chips) 
Seat 3: CocoAlexMix ($50 in chips) 
Seat 4: xandr67 ($50.25 in chips) 
Seat 5: artemxxl ($61.10 in chips) 
Seat 6: Slami4 ($50 in chips) 
Seat 7: takakensu ($50.12 in chips) 
Seat 8: Pete007poker ($50 in chips) 
Seat 9: Infinities4 ($50 in chips) 
xandr67: posts small blind $0.25
artemxxl: posts big blind $0.50
*** HOLE CARDS ***
Slami4: raises $1 to $1.50
takakensu: calls $1.50
Pete007poker: calls $1.50
Infinities4: folds 
Gad7dee: raises $6.75 to $8.25
speedbird uk: folds 
CocoAlexMix: folds 
xandr67: folds 
artemxxl: folds 
Slami4: calls $6.75
takakensu: folds 
Pete007poker: folds 
*** FLOP *** [Qc 4c 7s]
Slami4: checks 
Gad7dee: bets $19.24
Slami4: folds 
Uncalled bet ($19.24) returned to Gad7dee
Gad7dee collected $19.24 from pot
Gad7dee: doesn't show hand 
*** SUMMARY ***
Total pot $20.25 | Rake $1.01 
Board [Qc 4c 7s]
Seat 1: Gad7dee collected ($19.24)
Seat 2: speedbird uk folded before Flop (didn't bet)
Seat 3: CocoAlexMix (button) folded before Flop (didn't bet)
Seat 4: xandr67 (small blind) folded before Flop
Seat 5: artemxxl (big blind) folded before Flop
Seat 6: Slami4 folded on the Flop
Seat 7: takakensu folded before Flop
Seat 8: Pete007poker folded before Flop
Seat 9: Infinities4 folded before Flop (didn't bet)



PokerStars Hand #228679019144:  Hold'em No Limit ($0.25/$0.50 USD) - 2021/07/30 9:33:01 ET
Table 'Aitne III' 9-max Seat #4 is the button
Seat 1: Gad7dee ($56.37 in chips) 
Seat 2: speedbird uk ($39.25 in chips) 
Seat 3: CocoAlexMix ($50 in chips) 
Seat 4: xandr67 ($50 in chips) 
Seat 5: artemxxl ($60.60 in chips) 
Seat 6: Slami4 ($50 in chips) 
Seat 7: takakensu ($48.62 in chips) 
Seat 8: Pete007poker ($50 in chips) 
Seat 9: Infinities4 ($50 in chips) 
artemxxl: posts small blind $0.25
Slami4: posts big blind $0.50
*** HOLE CARDS ***
takakensu: folds 
Pete007poker: folds 
Infinities4: folds 
Gad7dee: folds 
speedbird uk: folds 
CocoAlexMix: raises $0.75 to $1.25
xandr67: folds 
artemxxl: folds 
Slami4: calls $0.75
*** FLOP *** [Ah Ts 4s]
Slami4: checks 
CocoAlexMix: bets $0.86
Slami4: calls $0.86
*** TURN *** [Ah Ts 4s] [Qs]
Slami4: checks 
CocoAlexMix: checks 
*** RIVER *** [Ah Ts 4s Qs] [Th]
Slami4: bets $3.19
CocoAlexMix: folds 
Uncalled bet ($3.19) returned to Slami4
Slami4 collected $4.25 from pot
*** SUMMARY ***
Total pot $4.47 | Rake $0.22 
Board [Ah Ts 4s Qs Th]
Seat 1: Gad7dee folded before Flop (didn't bet)
Seat 2: speedbird uk folded before Flop (didn't bet)
Seat 3: CocoAlexMix folded on the River
Seat 4: xandr67 (button) folded before Flop (didn't bet)
Seat 5: artemxxl (small blind) folded before Flop
Seat 6: Slami4 (big blind) collected ($4.25)
Seat 7: takakensu folded before Flop (didn't bet)
Seat 8: Pete007poker folded before Flop (didn't bet)
Seat 9: Infinities4 folded before Flop (didn't bet)



PokerStars Hand #228679032840:  Hold'em No Limit ($0.25/$0.50 USD) - 2021/07/30 9:33:50 ET
Table 'Aitne III' 9-max Seat #5 is the button
Seat 1: Gad7dee ($56.37 in chips) 
Seat 2: speedbird uk ($39.25 in chips) 
Seat 3: CocoAlexMix ($50 in chips) 
Seat 4: xandr67 ($50 in chips) 
Seat 5: artemxxl ($60.35 in chips) 
Seat 6: Slami4 ($52.14 in chips) 
Seat 7: takakensu ($48.62 in chips) 
Seat 8: Pete007poker ($50 in chips) 
Seat 9: Infinities4 ($50 in chips) 
Slami4: posts small blind $0.25
takakensu: posts big blind $0.50
*** HOLE CARDS ***
Pete007poker: folds 
Infinities4: folds 
Gad7dee: folds 
speedbird uk: folds 
CocoAlexMix: folds 
xandr67: folds 
artemxxl: folds 
Slami4: folds 
Uncalled bet ($0.25) returned to takakensu
takakensu collected $0.50 from pot
takakensu: doesn't show hand 
*** SUMMARY ***
Total pot $0.50 | Rake $0 
Seat 1: Gad7dee folded before Flop (didn't bet)
Seat 2: speedbird uk folded before Flop (didn't bet)
Seat 3: CocoAlexMix folded before Flop (didn't bet)
Seat 4: xandr67 folded before Flop (didn't bet)
Seat 5: artemxxl (button) folded before Flop (didn't bet)
Seat 6: Slami4 (small blind) folded before Flop
Seat 7: takakensu (big blind) collected ($0.50)
Seat 8: Pete007poker folded before Flop (didn't bet)
Seat 9: Infinities4 folded before Flop (didn't bet)



PokerStars Hand #228679037443:  Hold'em No Limit ($0.25/$0.50 USD) - 2021/07/30 9:34:07 ET
Table 'Aitne III' 9-max Seat #6 is the button
Seat 1: Gad7dee ($56.37 in chips) 
Seat 2: speedbird uk ($39.25 in chips) 
Seat 3: CocoAlexMix ($50 in chips) 
Seat 4: xandr67 ($50 in chips) 
Seat 5: artemxxl ($60.35 in chips) 
Seat 6: Slami4 ($51.89 in chips) 
Seat 7: takakensu ($48.87 in chips) 
Seat 8: Pete007poker ($50 in chips) 
Seat 9: Infinities4 ($50 in chips) 
takakensu: posts small blind $0.25
Pete007poker: posts big blind $0.50
*** HOLE CARDS ***
Infinities4: folds 
Gad7dee: calls $0.50
speedbird uk: raises $1 to $1.50
CocoAlexMix: folds 
xandr67: calls $1.50
artemxxl: folds 
Slami4: folds 
takakensu: folds 
Pete007poker: folds 
Gad7dee: calls $1
*** FLOP *** [3c Ts Js]
Gad7dee: checks 
speedbird uk: checks 
xandr67: checks 
*** TURN *** [3c Ts Js] [8s]
Gad7dee: bets $1
speedbird uk: calls $1
xandr67: folds 
*** RIVER *** [3c Ts Js 8s] [Th]
Gad7dee: bets $3.44
speedbird uk: folds 
Uncalled bet ($3.44) returned to Gad7dee
Gad7dee collected $6.89 from pot
Gad7dee: doesn't show hand 
*** SUMMARY ***
Total pot $7.25 | Rake $0.36 
Board [3c Ts Js 8s Th]
Seat 1: Gad7dee collected ($6.89)
Seat 2: speedbird uk folded on the River
Seat 3: CocoAlexMix folded before Flop (didn't bet)
Seat 4: xandr67 folded on the Turn
Seat 5: artemxxl folded before Flop (didn't bet)
Seat 6: Slami4 (button) folded before Flop (didn't bet)
Seat 7: takakensu (small blind) folded before Flop
Seat 8: Pete007poker (big blind) folded before Flop
Seat 9: Infinities4 folded before Flop (didn't bet)



PokerStars Hand #228679061960:  Hold'em No Limit ($0.25/$0.50 USD) - 2021/07/30 9:35:23 ET
Table 'Aitne III' 9-max Seat #7 is the button
Seat 1: Gad7dee ($60.76 in chips) 
Seat 2: speedbird uk ($36.75 in chips) 
Seat 3: CocoAlexMix ($50 in chips) 
Seat 4: xandr67 ($50 in chips) 
Seat 5: artemxxl ($60.35 in chips) 
Seat 6: Slami4 ($51.89 in chips) 
Seat 7: takakensu ($48.62 in chips) 
Seat 8: Pete007poker ($50 in chips) 
Seat 9: Infinities4 ($50 in chips) 
Pete007poker: posts small blind $0.25
Infinities4: posts big blind $0.50
*** HOLE CARDS ***
Gad7dee: folds 
speedbird uk: folds 
CocoAlexMix: folds 
xandr67: folds 
artemxxl: raises $0.75 to $1.25
Slami4: folds 
takakensu: folds 
Pete007poker: folds 
Infinities4: folds 
Uncalled bet ($0.75) returned to artemxxl
artemxxl collected $1.25 from pot
*** SUMMARY ***
Total pot $1.25 | Rake $0 
Seat 1: Gad7dee folded before Flop (didn't bet)
Seat 2: speedbird uk folded before Flop (didn't bet)
Seat 3: CocoAlexMix folded before Flop (didn't bet)
Seat 4: xandr67 folded before Flop (didn't bet)
Seat 5: artemxxl collected ($1.25)
Seat 6: Slami4 folded before Flop (didn't bet)
Seat 7: takakensu (button) folded before Flop (didn't bet)
Seat 8: Pete007poker (small blind) folded before Flop
Seat 9: Infinities4 (big blind) folded before Flop



PokerStars Hand #228679066493:  Hold'em No Limit ($0.25/$0.50 USD) - 2021/07/30 9:35:40 ET
Table 'Aitne III' 9-max Seat #8 is the button
Seat 1: Gad7dee ($60.76 in chips) 
Seat 2: speedbird uk ($36.75 in chips) 
Seat 3: CocoAlexMix ($50 in chips) 
Seat 4: xandr67 ($50 in chips) 
Seat 5: artemxxl ($61.10 in chips) 
Seat 6: Slami4 ($51.89 in chips) 
Seat 7: takakensu ($48.62 in chips) 
Seat 8: Pete007poker ($50 in chips) 
Seat 9: Infinities4 ($50 in chips) 
Infinities4: posts small blind $0.25
Gad7dee: posts big blind $0.50
*** HOLE CARDS ***
speedbird uk: folds 
CocoAlexMix: folds 
xandr67: folds 
artemxxl: raises $1 to $1.50
Slami4: folds 
takakensu: folds 
Pete007poker: folds 
Infinities4: folds 
Gad7dee: calls $1
*** FLOP *** [3d 8s 8c]
Gad7dee: checks 
artemxxl: bets $2
Gad7dee: calls $2
*** TURN *** [3d 8s 8c] [9c]
Gad7dee: checks 
artemxxl: bets $4.50
Gad7dee: calls $4.50
*** RIVER *** [3d 8s 8c 9c] [As]
Gad7dee: checks 
artemxxl: checks 
*** SHOW DOWN ***
Gad7dee: shows [7c 7s] (two pair, Eights and Sevens)
artemxxl: shows [Qs Qd] (two pair, Queens and Eights)
artemxxl collected $15.44 from pot
*** SUMMARY ***
Total pot $16.25 | Rake $0.81 
Board [3d 8s 8c 9c As]
Seat 1: Gad7dee (big blind) showed [7c 7s] and lost with two pair, Eights and Sevens
Seat 2: speedbird uk folded before Flop (didn't bet)
Seat 3: CocoAlexMix folded before Flop (didn't bet)
Seat 4: xandr67 folded before Flop (didn't bet)
Seat 5: artemxxl showed [Qs Qd] and won ($15.44) with two pair, Queens and Eights
Seat 6: Slami4 folded before Flop (didn't bet)
Seat 7: takakensu folded before Flop (didn't bet)
Seat 8: Pete007poker (button) folded before Flop (didn't bet)
Seat 9: Infinities4 (small blind) folded before Flop



PokerStars Hand #228679087247:  Hold'em No Limit ($0.25/$0.50 USD) - 2021/07/30 9:36:53 ET
Table 'Aitne III' 9-max Seat #9 is the button
Seat 1: Gad7dee ($52.76 in chips) 
Seat 2: speedbird uk ($36.75 in chips) 
Seat 3: CocoAlexMix ($50 in chips) 
Seat 4: xandr67 ($50 in chips) 
Seat 5: artemxxl ($68.54 in chips) 
Seat 6: Slami4 ($51.89 in chips) 
Seat 7: takakensu ($48.62 in chips) 
Seat 8: Pete007poker ($50 in chips) 
Seat 9: Infinities4 ($50 in chips) 
Gad7dee: posts small blind $0.25
speedbird uk: posts big blind $0.50
*** HOLE CARDS ***
CocoAlexMix: folds 
xandr67: raises $0.75 to $1.25
artemxxl: folds 
Slami4: folds 
takakensu: folds 
Pete007poker: folds 
Infinities4: folds 
Gad7dee: folds 
speedbird uk: folds 
Uncalled bet ($0.75) returned to xandr67
xandr67 collected $1.25 from pot
xandr67: doesn't show hand 
*** SUMMARY ***
Total pot $1.25 | Rake $0 
Seat 1: Gad7dee (small blind) folded before Flop
Seat 2: speedbird uk (big blind) folded before Flop
Seat 3: CocoAlexMix folded before Flop (didn't bet)
Seat 4: xandr67 collected ($1.25)
Seat 5: artemxxl folded before Flop (didn't bet)
Seat 6: Slami4 folded before Flop (didn't bet)
Seat 7: takakensu folded before Flop (didn't bet)
Seat 8: Pete007poker folded before Flop (didn't bet)
Seat 9: Infinities4 (button) folded before Flop (didn't bet)



PokerStars Hand #228679095006:  Hold'em No Limit ($0.25/$0.50 USD) - 2021/07/30 9:37:20 ET
Table 'Aitne III' 9-max Seat #1 is the button
Seat 1: Gad7dee ($52.51 in chips) 
Seat 2: speedbird uk ($36.25 in chips) 
Seat 3: CocoAlexMix ($50 in chips) 
Seat 4: xandr67 ($50.75 in chips) 
Seat 5: artemxxl ($68.54 in chips) 
Seat 6: Slami4 ($51.89 in chips) 
Seat 7: takakensu ($48.62 in chips) 
Seat 8: Pete007poker ($50 in chips) 
Seat 9: Infinities4 ($50 in chips) 
speedbird uk: posts small blind $0.25
CocoAlexMix: posts big blind $0.50
*** HOLE CARDS ***
xandr67: folds 
artemxxl: folds 
Slami4: raises $1 to $1.50
takakensu: folds 
Pete007poker: folds 
Infinities4: folds 
Gad7dee: folds 
speedbird uk: calls $1.25
CocoAlexMix: folds 
*** FLOP *** [Qd 5h Tc]
speedbird uk: checks 
Slami4: bets $1.10
speedbird uk: calls $1.10
*** TURN *** [Qd 5h Tc] [7s]
speedbird uk: checks 
Slami4: checks 
*** RIVER *** [Qd 5h Tc 7s] [9c]
speedbird uk: bets $1
Slami4: folds 
Uncalled bet ($1) returned to speedbird uk
speedbird uk collected $5.42 from pot
speedbird uk: doesn't show hand 
*** SUMMARY ***
Total pot $5.70 | Rake $0.28 
Board [Qd 5h Tc 7s 9c]
Seat 1: Gad7dee (button) folded before Flop (didn't bet)
Seat 2: speedbird uk (small blind) collected ($5.42)
Seat 3: CocoAlexMix (big blind) folded before Flop
Seat 4: xandr67 folded before Flop (didn't bet)
Seat 5: artemxxl folded before Flop (didn't bet)
Seat 6: Slami4 folded on the River
Seat 7: takakensu folded before Flop (didn't bet)
Seat 8: Pete007poker folded before Flop (didn't bet)
Seat 9: Infinities4 folded before Flop (didn't bet)



PokerStars Hand #228679107582:  Hold'em No Limit ($0.25/$0.50 USD) - 2021/07/30 9:38:05 ET
Table 'Aitne III' 9-max Seat #2 is the button
Seat 1: Gad7dee ($52.51 in chips) 
Seat 2: speedbird uk ($39.07 in chips) 
Seat 3: CocoAlexMix ($50 in chips) 
Seat 4: xandr67 ($50.75 in chips) 
Seat 5: artemxxl ($68.54 in chips) 
Seat 6: Slami4 ($50 in chips) 
Seat 7: takakensu ($48.62 in chips) 
Seat 8: Pete007poker ($50 in chips) 
Seat 9: Infinities4 ($50 in chips) 
CocoAlexMix: posts small blind $0.25
xandr67: posts big blind $0.50
*** HOLE CARDS ***
artemxxl: folds 
Slami4: folds 
takakensu: folds 
Pete007poker: folds 
Infinities4: folds 
Gad7dee: raises $1 to $1.50
speedbird uk: folds 
CocoAlexMix: folds 
xandr67: folds 
Uncalled bet ($1) returned to Gad7dee
Gad7dee collected $1.25 from pot
Gad7dee: doesn't show hand 
*** SUMMARY ***
Total pot $1.25 | Rake $0 
Seat 1: Gad7dee collected ($1.25)
Seat 2: speedbird uk (button) folded before Flop (didn't bet)
Seat 3: CocoAlexMix (small blind) folded before Flop
Seat 4: xandr67 (big blind) folded before Flop
Seat 5: artemxxl folded before Flop (didn't bet)
Seat 6: Slami4 folded before Flop (didn't bet)
Seat 7: takakensu folded before Flop (didn't bet)
Seat 8: Pete007poker folded before Flop (didn't bet)
Seat 9: Infinities4 folded before Flop (didn't bet)



PokerStars Hand #228679112968:  Hold'em No Limit ($0.25/$0.50 USD) - 2021/07/30 9:38:24 ET
Table 'Aitne III' 9-max Seat #3 is the button
Seat 1: Gad7dee ($53.26 in chips) 
Seat 2: speedbird uk ($39.07 in chips) 
Seat 3: CocoAlexMix ($50 in chips) 
Seat 4: xandr67 ($50.25 in chips) 
Seat 5: artemxxl ($68.54 in chips) 
Seat 6: Slami4 ($50 in chips) 
Seat 7: takakensu ($48.62 in chips) 
Seat 8: Pete007poker ($50 in chips) 
Seat 9: Infinities4 ($50 in chips) 
xandr67: posts small blind $0.25
artemxxl: posts big blind $0.50
*** HOLE CARDS ***
Slami4: folds 
takakensu: raises $1 to $1.50
Pete007poker: folds 
Infinities4: folds 
Gad7dee: folds 
speedbird uk: folds 
CocoAlexMix: folds 
xandr67: folds 
artemxxl: folds 
Uncalled bet ($1) returned to takakensu
takakensu collected $1.25 from pot
takakensu: doesn't show hand 
*** SUMMARY ***
Total pot $1.25 | Rake $0 
Seat 1: Gad7dee folded before Flop (didn't bet)
Seat 2: speedbird uk folded before Flop (didn't bet)
Seat 3: CocoAlexMix (button) folded before Flop (didn't bet)
Seat 4: xandr67 (small blind) folded before Flop
Seat 5: artemxxl (big blind) folded before Flop
Seat 6: Slami4 folded before Flop (didn't bet)
Seat 7: takakensu collected ($1.25)
Seat 8: Pete007poker folded before Flop (didn't bet)
Seat 9: Infinities4 folded before Flop (didn't bet)



PokerStars Hand #228679116965:  Hold'em No Limit ($0.25/$0.50 USD) - 2021/07/30 9:38:38 ET
Table 'Aitne III' 9-max Seat #4 is the button
Seat 1: Gad7dee ($53.26 in chips) 
Seat 2: speedbird uk ($39.07 in chips) 
Seat 3: CocoAlexMix ($50 in chips) 
Seat 4: xandr67 ($50 in chips) 
Seat 5: artemxxl ($68.04 in chips) 
Seat 6: Slami4 ($50 in chips) 
Seat 7: takakensu ($49.37 in chips) 
Seat 8: Pete007poker ($50 in chips) 
Seat 9: Infinities4 ($50 in chips) 
artemxxl: posts small blind $0.25
Slami4: posts big blind $0.50
*** HOLE CARDS ***
takakensu: folds 
Pete007poker: folds 
Infinities4: folds 
Gad7dee: calls $0.50
speedbird uk: folds 
CocoAlexMix: folds 
xandr67: raises $1.50 to $2
artemxxl: folds 
Slami4: calls $1.50
Gad7dee: calls $1.50
*** FLOP *** [Js Qs 5c]
Slami4: checks 
Gad7dee: checks 
xandr67: bets $1.96
Slami4: calls $1.96
Gad7dee: folds 
*** TURN *** [Js Qs 5c] [3c]
Slami4: checks 
xandr67: bets $7.11
Slami4: folds 
Uncalled bet ($7.11) returned to xandr67
xandr67 collected $9.66 from pot
xandr67: doesn't show hand 
*** SUMMARY ***
Total pot $10.17 | Rake $0.51 
Board [Js Qs 5c 3c]
Seat 1: Gad7dee folded on the Flop
Seat 2: speedbird uk folded before Flop (didn't bet)
Seat 3: CocoAlexMix folded before Flop (didn't bet)
Seat 4: xandr67 (button) collected ($9.66)
Seat 5: artemxxl (small blind) folded before Flop
Seat 6: Slami4 (big blind) folded on the Turn
Seat 7: takakensu folded before Flop (didn't bet)
Seat 8: Pete007poker folded before Flop (didn't bet)
Seat 9: Infinities4 folded before Flop (didn't bet)



PokerStars Hand #228679138630:  Hold'em No Limit ($0.25/$0.50 USD) - 2021/07/30 9:39:54 ET
Table 'Aitne III' 9-max Seat #5 is the button
Seat 1: Gad7dee ($51.26 in chips) 
Seat 2: speedbird uk ($39.07 in chips) 
Seat 3: CocoAlexMix ($50 in chips) 
Seat 4: xandr67 ($55.70 in chips) 
Seat 5: artemxxl ($67.79 in chips) 
Seat 6: Slami4 ($50 in chips) 
Seat 7: takakensu ($49.37 in chips) 
Seat 8: Pete007poker ($50 in chips) 
Seat 9: Infinities4 ($50 in chips) 
Slami4: posts small blind $0.25
takakensu: posts big blind $0.50
*** HOLE CARDS ***
Pete007poker: folds 
Infinities4: folds 
Gad7dee: folds 
speedbird uk: raises $1 to $1.50
CocoAlexMix: folds 
xandr67: folds 
artemxxl: folds 
Slami4: folds 
takakensu: folds 
Uncalled bet ($1) returned to speedbird uk
speedbird uk collected $1.25 from pot
speedbird uk: doesn't show hand 
*** SUMMARY ***
Total pot $1.25 | Rake $0 
Seat 1: Gad7dee folded before Flop (didn't bet)
Seat 2: speedbird uk collected ($1.25)
Seat 3: CocoAlexMix folded before Flop (didn't bet)
Seat 4: xandr67 folded before Flop (didn't bet)
Seat 5: artemxxl (button) folded before Flop (didn't bet)
Seat 6: Slami4 (small blind) folded before Flop
Seat 7: takakensu (big blind) folded before Flop
Seat 8: Pete007poker folded before Flop (didn't bet)
Seat 9: Infinities4 folded before Flop (didn't bet)



PokerStars Hand #228679145001:  Hold'em No Limit ($0.25/$0.50 USD) - 2021/07/30 9:40:16 ET
Table 'Aitne III' 9-max Seat #6 is the button
Seat 1: Gad7dee ($51.26 in chips) 
Seat 2: speedbird uk ($39.82 in chips) 
Seat 3: CocoAlexMix ($50 in chips) 
Seat 4: xandr67 ($55.70 in chips) 
Seat 5: artemxxl ($67.79 in chips) 
Seat 6: Slami4 ($50 in chips) 
Seat 7: takakensu ($48.87 in chips) 
Seat 8: Pete007poker ($50 in chips) 
Seat 9: Infinities4 ($50 in chips) 
takakensu: posts small blind $0.25
Pete007poker: posts big blind $0.50
*** HOLE CARDS ***
Infinities4: folds 
Gad7dee: folds 
speedbird uk: raises $1 to $1.50
CocoAlexMix: folds 
xandr67: folds 
artemxxl: folds 
Slami4: folds 
takakensu: calls $1.25
Pete007poker: folds 
*** FLOP *** [Qd 9d 4c]
takakensu: checks 
speedbird uk: bets $1.50
takakensu: calls $1.50
*** TURN *** [Qd 9d 4c] [6d]
takakensu: checks 
speedbird uk: bets $2
takakensu: folds 
Uncalled bet ($2) returned to speedbird uk
speedbird uk collected $6.18 from pot
speedbird uk: doesn't show hand 
*** SUMMARY ***
Total pot $6.50 | Rake $0.32 
Board [Qd 9d 4c 6d]
Seat 1: Gad7dee folded before Flop (didn't bet)
Seat 2: speedbird uk collected ($6.18)
Seat 3: CocoAlexMix folded before Flop (didn't bet)
Seat 4: xandr67 folded before Flop (didn't bet)
Seat 5: artemxxl folded before Flop (didn't bet)
Seat 6: Slami4 (button) folded before Flop (didn't bet)
Seat 7: takakensu (small blind) folded on the Turn
Seat 8: Pete007poker (big blind) folded before Flop
Seat 9: Infinities4 folded before Flop (didn't bet)



PokerStars Hand #228679157865:  Hold'em No Limit ($0.25/$0.50 USD) - 2021/07/30 9:41:02 ET
Table 'Aitne III' 9-max Seat #7 is the button
Seat 1: Gad7dee ($51.26 in chips) 
Seat 2: speedbird uk ($43 in chips) 
Seat 3: CocoAlexMix ($50 in chips) 
Seat 4: xandr67 ($55.70 in chips) 
Seat 5: artemxxl ($67.79 in chips) 
Seat 6: Slami4 ($50 in chips) 
Seat 7: takakensu ($45.87 in chips) 
Seat 8: Pete007poker ($50 in chips) 
Seat 9: Infinities4 ($50 in chips) 
Pete007poker: posts small blind $0.25
Infinities4: posts big blind $0.50
*** HOLE CARDS ***
Gad7dee: folds 
speedbird uk: folds 
CocoAlexMix: folds 
xandr67: folds 
artemxxl: folds 
Gad7dee leaves the table
Slami4: folds 
takakensu: folds 
Pete007poker: folds 
Uncalled bet ($0.25) returned to Infinities4
Infinities4 collected $0.50 from pot
Infinities4: doesn't show hand 
*** SUMMARY ***
Total pot $0.50 | Rake $0 
Seat 1: Gad7dee folded before Flop (didn't bet)
Seat 2: speedbird uk folded before Flop (didn't bet)
Seat 3: CocoAlexMix folded before Flop (didn't bet)
Seat 4: xandr67 folded before Flop (didn't bet)
Seat 5: artemxxl folded before Flop (didn't bet)
Seat 6: Slami4 folded before Flop (didn't bet)
Seat 7: takakensu (button) folded before Flop (didn't bet)
Seat 8: Pete007poker (small blind) folded before Flop
Seat 9: Infinities4 (big blind) collected ($0.50)



PokerStars Hand #228679162402:  Hold'em No Limit ($0.25/$0.50 USD) - 2021/07/30 9:41:18 ET
Table 'Aitne III' 9-max Seat #8 is the button
Seat 2: speedbird uk ($43 in chips) 
Seat 3: CocoAlexMix ($50 in chips) 
Seat 4: xandr67 ($55.70 in chips) 
Seat 5: artemxxl ($67.79 in chips) 
Seat 6: Slami4 ($50 in chips) 
Seat 7: takakensu ($45.87 in chips) 
Seat 8: Pete007poker ($50 in chips) 
Seat 9: Infinities4 ($50.25 in chips) 
Infinities4: posts small blind $0.25
speedbird uk: posts big blind $0.50
*** HOLE CARDS ***
CocoAlexMix: raises $1 to $1.50
xandr67: folds 
artemxxl: calls $1.50
Slami4: folds 
takakensu: folds 
Pete007poker: folds 
Infinities4: folds 
speedbird uk: folds 
*** FLOP *** [7d Th Qh]
kazuking0318 joins the table at seat #1 
CocoAlexMix: bets $1.17
artemxxl: calls $1.17
*** TURN *** [7d Th Qh] [5s]
CocoAlexMix: bets $4.34
artemxxl: folds 
Uncalled bet ($4.34) returned to CocoAlexMix
CocoAlexMix collected $5.79 from pot
CocoAlexMix: doesn't show hand 
*** SUMMARY ***
Total pot $6.09 | Rake $0.30 
Board [7d Th Qh 5s]
Seat 2: speedbird uk (big blind) folded before Flop
Seat 3: CocoAlexMix collected ($5.79)
Seat 4: xandr67 folded before Flop (didn't bet)
Seat 5: artemxxl folded on the Turn
Seat 6: Slami4 folded before Flop (didn't bet)
Seat 7: takakensu folded before Flop (didn't bet)
Seat 8: Pete007poker (button) folded before Flop (didn't bet)
Seat 9: Infinities4 (small blind) folded before Flop



PokerStars Hand #228679171025:  Hold'em No Limit ($0.25/$0.50 USD) - 2021/07/30 9:41:49 ET
Table 'Aitne III' 9-max Seat #9 is the button
Seat 2: speedbird uk ($42.50 in chips) 
Seat 4: xandr67 ($55.70 in chips) 
Seat 5: artemxxl ($65.12 in chips) 
Seat 6: Slami4 ($50 in chips) 
Seat 7: takakensu ($45.87 in chips) 
Seat 8: Pete007poker ($50 in chips) 
Seat 9: Infinities4 ($50 in chips) 
speedbird uk: posts small blind $0.25
xandr67: posts big blind $0.50
*** HOLE CARDS ***
artemxxl: raises $1 to $1.50
CocoAlexMix leaves the table
Slami4: folds 
takakensu: folds 
Pete007poker: folds 
Infinities4: folds 
speedbird uk: folds 
xandr67: folds 
Uncalled bet ($1) returned to artemxxl
artemxxl collected $1.25 from pot
*** SUMMARY ***
Total pot $1.25 | Rake $0 
Seat 2: speedbird uk (small blind) folded before Flop
Seat 4: xandr67 (big blind) folded before Flop
Seat 5: artemxxl collected ($1.25)
Seat 6: Slami4 folded before Flop (didn't bet)
Seat 7: takakensu folded before Flop (didn't bet)
Seat 8: Pete007poker folded before Flop (didn't bet)
Seat 9: Infinities4 (button) folded before Flop (didn't bet)



PokerStars Hand #228679176254:  Hold'em No Limit ($0.25/$0.50 USD) - 2021/07/30 9:42:07 ET
Table 'Aitne III' 9-max Seat #2 is the button
Seat 2: speedbird uk ($42.25 in chips) 
Seat 4: xandr67 ($55.20 in chips) 
Seat 5: artemxxl ($65.87 in chips) 
Seat 6: Slami4 ($50 in chips) 
Seat 7: takakensu ($45.87 in chips) 
Seat 8: Pete007poker ($50 in chips) 
Seat 9: Infinities4 ($50 in chips) 
xandr67: posts small blind $0.25
artemxxl: posts big blind $0.50
kazuking0318: sits out 
*** HOLE CARDS ***
Slami4: folds 
takakensu: folds 
Pete007poker: folds 
Infinities4: raises $0.74 to $1.24
speedbird uk: folds 
xandr67: raises $3.76 to $5
artemxxl: folds 
Roger_LeClerc joins the table at seat #3 
Infinities4: calls $3.76
*** FLOP *** [5s 9h 4c]
xandr67: bets $3.29
Infinities4: calls $3.29
*** TURN *** [5s 9h 4c] [6d]
xandr67: checks 
Infinities4: bets $5.68
xandr67: folds 
Uncalled bet ($5.68) returned to Infinities4
Infinities4 collected $16.23 from pot
Infinities4: doesn't show hand 
*** SUMMARY ***
Total pot $17.08 | Rake $0.85 
Board [5s 9h 4c 6d]
Seat 2: speedbird uk (button) folded before Flop (didn't bet)
Seat 4: xandr67 (small blind) folded on the Turn
Seat 5: artemxxl (big blind) folded before Flop
Seat 6: Slami4 folded before Flop (didn't bet)
Seat 7: takakensu folded before Flop (didn't bet)
Seat 8: Pete007poker folded before Flop (didn't bet)
Seat 9: Infinities4 collected ($16.23)



PokerStars Hand #228679199921:  Hold'em No Limit ($0.25/$0.50 USD) - 2021/07/30 9:43:32 ET
Table 'Aitne III' 9-max Seat #4 is the button
Seat 2: speedbird uk ($42.25 in chips) 
Seat 3: Roger_LeClerc ($20 in chips) 
Seat 4: xandr67 ($50 in chips) 
Seat 5: artemxxl ($65.37 in chips) 
Seat 6: Slami4 ($50 in chips) 
Seat 7: takakensu ($45.87 in chips) 
Seat 8: Pete007poker ($50 in chips) 
Seat 9: Infinities4 ($57.94 in chips) 
artemxxl: posts small blind $0.25
Slami4: posts big blind $0.50
kazuking0318: sits out 
Roger_LeClerc: posts big blind $0.50
*** HOLE CARDS ***
takakensu: folds 
Pete007poker has timed out
Pete007poker: folds 
Infinities4: folds 
speedbird uk: calls $0.50
Roger_LeClerc: checks 
xandr67: folds 
artemxxl: calls $0.25
Slami4: checks 
*** FLOP *** [6d 3c 2c]
artemxxl: checks 
Slami4: checks 
speedbird uk: checks 
Roger_LeClerc: checks 
*** TURN *** [6d 3c 2c] [9c]
artemxxl: checks 
Slami4: checks 
speedbird uk: checks 
Roger_LeClerc: checks 
*** RIVER *** [6d 3c 2c 9c] [5h]
artemxxl: checks 
Slami4: checks 
speedbird uk: checks 
Roger_LeClerc: checks 
*** SHOW DOWN ***
artemxxl: shows [8d Jh] (high card Jack)
Slami4: shows [5d 7d] (a pair of Fives)
speedbird uk: mucks hand 
Roger_LeClerc: shows [Td 9h] (a pair of Nines)
Roger_LeClerc collected $1.90 from pot
*** SUMMARY ***
Total pot $2 | Rake $0.10 
Board [6d 3c 2c 9c 5h]
Seat 2: speedbird uk mucked
Seat 3: Roger_LeClerc showed [Td 9h] and won ($1.90) with a pair of Nines
Seat 4: xandr67 (button) folded before Flop (didn't bet)
Seat 5: artemxxl (small blind) showed [8d Jh] and lost with high card Jack
Seat 6: Slami4 (big blind) showed [5d 7d] and lost with a pair of Fives
Seat 7: takakensu folded before Flop (didn't bet)
Seat 8: Pete007poker folded before Flop (didn't bet)
Seat 9: Infinities4 folded before Flop (didn't bet)



PokerStars Hand #228679222669:  Hold'em No Limit ($0.25/$0.50 USD) - 2021/07/30 9:44:52 ET
Table 'Aitne III' 9-max Seat #5 is the button
Seat 2: speedbird uk ($41.75 in chips) 
Seat 3: Roger_LeClerc ($21.40 in chips) 
Seat 4: xandr67 ($50 in chips) 
Seat 5: artemxxl ($64.87 in chips) 
Seat 6: Slami4 ($50 in chips) 
Seat 7: takakensu ($45.87 in chips) 
Seat 8: Pete007poker ($50 in chips) 
Seat 9: Infinities4 ($57.94 in chips) 
Slami4: posts small blind $0.25
takakensu: posts big blind $0.50
kazuking0318: sits out 
*** HOLE CARDS ***
Pete007poker: folds 
Infinities4: folds 
speedbird uk: folds 
Roger_LeClerc: calls $0.50
xandr67: raises $1.50 to $2
artemxxl: folds 
Slami4: folds 
takakensu: calls $1.50
Roger_LeClerc: calls $1.50
*** FLOP *** [3d Kd Ah]
takakensu: bets $2.97
Roger_LeClerc: calls $2.97
xandr67: folds 
*** TURN *** [3d Kd Ah] [Ts]
takakensu: checks 
Roger_LeClerc: bets $5.79
takakensu: calls $5.79
*** RIVER *** [3d Kd Ah Ts] [9d]
takakensu: checks 
Roger_LeClerc: checks 
*** SHOW DOWN ***
takakensu: shows [As 5h] (a pair of Aces)
Roger_LeClerc: mucks hand 
takakensu collected $22.58 from pot
*** SUMMARY ***
Total pot $23.77 | Rake $1.19 
Board [3d Kd Ah Ts 9d]
Seat 2: speedbird uk folded before Flop (didn't bet)
Seat 3: Roger_LeClerc mucked
Seat 4: xandr67 folded on the Flop
Seat 5: artemxxl (button) folded before Flop (didn't bet)
Seat 6: Slami4 (small blind) folded before Flop
Seat 7: takakensu (big blind) showed [As 5h] and won ($22.58) with a pair of Aces
Seat 8: Pete007poker folded before Flop (didn't bet)
Seat 9: Infinities4 folded before Flop (didn't bet)



PokerStars Hand #228679240153:  Hold'em No Limit ($0.25/$0.50 USD) - 2021/07/30 9:45:53 ET
Table 'Aitne III' 9-max Seat #6 is the button
Seat 2: speedbird uk ($41.75 in chips) 
Seat 3: Roger_LeClerc ($10.64 in chips) 
Seat 4: xandr67 ($50 in chips) 
Seat 5: artemxxl ($64.87 in chips) 
Seat 6: Slami4 ($50 in chips) 
Seat 7: takakensu ($57.69 in chips) 
Seat 8: Pete007poker ($50 in chips) 
Seat 9: Infinities4 ($57.94 in chips) 
takakensu: posts small blind $0.25
Pete007poker: posts big blind $0.50
kazuking0318: sits out 
*** HOLE CARDS ***
Infinities4: raises $0.74 to $1.24
speedbird uk: calls $1.24
Roger_LeClerc: folds 
xandr67: folds 
artemxxl: folds 
Slami4: folds 
takakensu: folds 
Pete007poker: folds 
*** FLOP *** [Js 3d 3c]
Infinities4: bets $1.26
speedbird uk: calls $1.26
*** TURN *** [Js 3d 3c] [Qc]
Infinities4: checks 
speedbird uk: bets $1.50
Infinities4: calls $1.50
*** RIVER *** [Js 3d 3c Qc] [Jc]
Infinities4: checks 
speedbird uk: checks 
*** SHOW DOWN ***
Infinities4: shows [8d 8c] (two pair, Jacks and Eights)
speedbird uk: shows [9d 9c] (two pair, Jacks and Nines)
speedbird uk collected $8.31 from pot
*** SUMMARY ***
Total pot $8.75 | Rake $0.44 
Board [Js 3d 3c Qc Jc]
Seat 2: speedbird uk showed [9d 9c] and won ($8.31) with two pair, Jacks and Nines
Seat 3: Roger_LeClerc folded before Flop (didn't bet)
Seat 4: xandr67 folded before Flop (didn't bet)
Seat 5: artemxxl folded before Flop (didn't bet)
Seat 6: Slami4 (button) folded before Flop (didn't bet)
Seat 7: takakensu (small blind) folded before Flop
Seat 8: Pete007poker (big blind) folded before Flop
Seat 9: Infinities4 showed [8d 8c] and lost with two pair, Jacks and Eights



PokerStars Hand #228679258351:  Hold'em No Limit ($0.25/$0.50 USD) - 2021/07/30 9:46:57 ET
Table 'Aitne III' 9-max Seat #7 is the button
Seat 2: speedbird uk ($46.06 in chips) 
Seat 3: Roger_LeClerc ($10.64 in chips) 
Seat 4: xandr67 ($50 in chips) 
Seat 5: artemxxl ($64.87 in chips) 
Seat 6: Slami4 ($50 in chips) 
Seat 7: takakensu ($57.44 in chips) 
Seat 8: Pete007poker ($50 in chips) 
Seat 9: Infinities4 ($53.94 in chips) 
Pete007poker: posts small blind $0.25
Infinities4: posts big blind $0.50
kazuking0318: sits out 
*** HOLE CARDS ***
speedbird uk has timed out
speedbird uk: folds 
Roger_LeClerc: folds 
xandr67: folds 
Roger_LeClerc leaves the table
artemxxl: folds 
Slami4: folds 
takakensu: folds 
Pete007poker: raises $2 to $2.50
Infinities4: folds 
Uncalled bet ($2) returned to Pete007poker
Pete007poker collected $1 from pot
*** SUMMARY ***
Total pot $1 | Rake $0 
Seat 2: speedbird uk folded before Flop (didn't bet)
Seat 3: Roger_LeClerc folded before Flop (didn't bet)
Seat 4: xandr67 folded before Flop (didn't bet)
Seat 5: artemxxl folded before Flop (didn't bet)
Seat 6: Slami4 folded before Flop (didn't bet)
Seat 7: takakensu (button) folded before Flop (didn't bet)
Seat 8: Pete007poker (small blind) collected ($1)
Seat 9: Infinities4 (big blind) folded before Flop



PokerStars Hand #228679267503:  Hold'em No Limit ($0.25/$0.50 USD) - 2021/07/30 9:47:29 ET
Table 'Aitne III' 9-max Seat #8 is the button
Seat 1: kazuking0318 ($50 in chips) 
Seat 4: xandr67 ($50 in chips) 
Seat 5: artemxxl ($64.87 in chips) 
Seat 6: Slami4 ($50 in chips) 
Seat 7: takakensu ($57.44 in chips) 
Seat 8: Pete007poker ($50.50 in chips) 
Seat 9: Infinities4 ($53.44 in chips) 
Infinities4: posts small blind $0.25
kazuking0318: posts big blind $0.50
*** HOLE CARDS ***
xandr67: folds 
artemxxl: folds 
o-chan1986 joins the table at seat #3 
Slami4: folds 
takakensu: folds 
Pete007poker: folds 
Infinities4: folds 
Uncalled bet ($0.25) returned to kazuking0318
kazuking0318 collected $0.50 from pot
kazuking0318: doesn't show hand 
*** SUMMARY ***
Total pot $0.50 | Rake $0 
Seat 1: kazuking0318 (big blind) collected ($0.50)
Seat 4: xandr67 folded before Flop (didn't bet)
Seat 5: artemxxl folded before Flop (didn't bet)
Seat 6: Slami4 folded before Flop (didn't bet)
Seat 7: takakensu folded before Flop (didn't bet)
Seat 8: Pete007poker (button) folded before Flop (didn't bet)
Seat 9: Infinities4 (small blind) folded before Flop



PokerStars Hand #228679270400:  Hold'em No Limit ($0.25/$0.50 USD) - 2021/07/30 9:47:39 ET
Table 'Aitne III' 9-max Seat #9 is the button
Seat 1: kazuking0318 ($50.25 in chips) 
Seat 3: o-chan1986 ($50 in chips) 
Seat 4: xandr67 ($50 in chips) 
Seat 5: artemxxl ($64.87 in chips) 
Seat 6: Slami4 ($50 in chips) 
Seat 7: takakensu ($57.44 in chips) 
Seat 8: Pete007poker ($50.50 in chips) 
Seat 9: Infinities4 ($53.19 in chips) 
kazuking0318: posts small blind $0.25
o-chan1986: posts big blind $0.50
*** HOLE CARDS ***
xandr67: folds 
artemxxl: folds 
Slami4: folds 
takakensu: folds 
Pete007poker: folds 
Infinities4: raises $0.54 to $1.04
kazuking0318: calls $0.79
o-chan1986: raises $2.46 to $3.50
Infinities4: folds 
kazuking0318: folds 
Uncalled bet ($2.46) returned to o-chan1986
o-chan1986 collected $3.12 from pot
o-chan1986: doesn't show hand 
*** SUMMARY ***
Total pot $3.12 | Rake $0 
Seat 1: kazuking0318 (small blind) folded before Flop
Seat 3: o-chan1986 (big blind) collected ($3.12)
Seat 4: xandr67 folded before Flop (didn't bet)
Seat 5: artemxxl folded before Flop (didn't bet)
Seat 6: Slami4 folded before Flop (didn't bet)
Seat 7: takakensu folded before Flop (didn't bet)
Seat 8: Pete007poker folded before Flop (didn't bet)
Seat 9: Infinities4 (button) folded before Flop



PokerStars Hand #228679277530:  Hold'em No Limit ($0.25/$0.50 USD) - 2021/07/30 9:48:04 ET
Table 'Aitne III' 9-max Seat #1 is the button
Seat 1: kazuking0318 ($49.21 in chips) 
Seat 3: o-chan1986 ($52.08 in chips) 
Seat 4: xandr67 ($50 in chips) 
Seat 5: artemxxl ($64.87 in chips) 
Seat 6: Slami4 ($50 in chips) 
Seat 7: takakensu ($57.44 in chips) 
Seat 8: Pete007poker ($50.50 in chips) 
Seat 9: Infinities4 ($52.15 in chips) 
o-chan1986: posts small blind $0.25
xandr67: posts big blind $0.50
*** HOLE CARDS ***
artemxxl: folds 
Slami4: folds 
takakensu: folds 
Pete007poker: folds 
Infinities4: folds 
kazuking0318: raises $1 to $1.50
o-chan1986: folds 
xandr67: folds 
Uncalled bet ($1) returned to kazuking0318
kazuking0318 collected $1.25 from pot
kazuking0318: doesn't show hand 
*** SUMMARY ***
Total pot $1.25 | Rake $0 
Seat 1: kazuking0318 (button) collected ($1.25)
Seat 3: o-chan1986 (small blind) folded before Flop
Seat 4: xandr67 (big blind) folded before Flop
Seat 5: artemxxl folded before Flop (didn't bet)
Seat 6: Slami4 folded before Flop (didn't bet)
Seat 7: takakensu folded before Flop (didn't bet)
Seat 8: Pete007poker folded before Flop (didn't bet)
Seat 9: Infinities4 folded before Flop (didn't bet)



PokerStars Hand #228679282150:  Hold'em No Limit ($0.25/$0.50 USD) - 2021/07/30 9:48:20 ET
Table 'Aitne III' 9-max Seat #3 is the button
Seat 1: kazuking0318 ($49.96 in chips) 
Seat 3: o-chan1986 ($51.83 in chips) 
Seat 4: xandr67 ($50 in chips) 
Seat 5: artemxxl ($64.87 in chips) 
Seat 6: Slami4 ($50 in chips) 
Seat 7: takakensu ($57.44 in chips) 
Seat 8: Pete007poker ($50.50 in chips) 
Seat 9: Infinities4 ($52.15 in chips) 
xandr67: posts small blind $0.25
artemxxl: posts big blind $0.50
speedbird uk: sits out 
*** HOLE CARDS ***
Slami4: folds 
takakensu: folds 
Pete007poker: folds 
Infinities4: folds 
kazuking0318: raises $1 to $1.50
o-chan1986: folds 
xandr67: folds 
artemxxl: folds 
Uncalled bet ($1) returned to kazuking0318
kazuking0318 collected $1.25 from pot
kazuking0318: doesn't show hand 
*** SUMMARY ***
Total pot $1.25 | Rake $0 
Seat 1: kazuking0318 collected ($1.25)
Seat 3: o-chan1986 (button) folded before Flop (didn't bet)
Seat 4: xandr67 (small blind) folded before Flop
Seat 5: artemxxl (big blind) folded before Flop
Seat 6: Slami4 folded before Flop (didn't bet)
Seat 7: takakensu folded before Flop (didn't bet)
Seat 8: Pete007poker folded before Flop (didn't bet)
Seat 9: Infinities4 folded before Flop (didn't bet)



PokerStars Hand #228679290550:  Hold'em No Limit ($0.25/$0.50 USD) - 2021/07/30 9:48:49 ET
Table 'Aitne III' 9-max Seat #4 is the button
Seat 1: kazuking0318 ($50.71 in chips) 
Seat 3: o-chan1986 ($51.83 in chips) 
Seat 4: xandr67 ($50 in chips) 
Seat 5: artemxxl ($64.37 in chips) 
Seat 6: Slami4 ($50 in chips) 
Seat 7: takakensu ($57.44 in chips) 
Seat 8: Pete007poker ($50.50 in chips) 
Seat 9: Infinities4 ($52.15 in chips) 
artemxxl: posts small blind $0.25
Slami4: posts big blind $0.50
speedbird uk: sits out 
*** HOLE CARDS ***
takakensu: folds 
Pete007poker: folds 
Infinities4: folds 
kazuking0318: folds 
o-chan1986: folds 
xandr67: raises $0.60 to $1.10
artemxxl: folds 
Slami4: calls $0.60
*** FLOP *** [Td 8c Qc]
Slami4: checks 
xandr67: checks 
*** TURN *** [Td 8c Qc] [5s]
Slami4: bets $1.75
xandr67: folds 
Uncalled bet ($1.75) returned to Slami4
Slami4 collected $2.33 from pot
*** SUMMARY ***
Total pot $2.45 | Rake $0.12 
Board [Td 8c Qc 5s]
Seat 1: kazuking0318 folded before Flop (didn't bet)
Seat 3: o-chan1986 folded before Flop (didn't bet)
Seat 4: xandr67 (button) folded on the Turn
Seat 5: artemxxl (small blind) folded before Flop
Seat 6: Slami4 (big blind) collected ($2.33)
Seat 7: takakensu folded before Flop (didn't bet)
Seat 8: Pete007poker folded before Flop (didn't bet)
Seat 9: Infinities4 folded before Flop (didn't bet)



PokerStars Hand #228679298185:  Hold'em No Limit ($0.25/$0.50 USD) - 2021/07/30 9:49:16 ET
Table 'Aitne III' 9-max Seat #5 is the button
Seat 1: kazuking0318 ($50.71 in chips) 
Seat 3: o-chan1986 ($51.83 in chips) 
Seat 4: xandr67 ($50 in chips) 
Seat 5: artemxxl ($64.12 in chips) 
Seat 6: Slami4 ($51.23 in chips) 
Seat 7: takakensu ($57.44 in chips) 
Seat 8: Pete007poker ($50.50 in chips) 
Seat 9: Infinities4 ($52.15 in chips) 
Slami4: posts small blind $0.25
takakensu: posts big blind $0.50
speedbird uk: sits out 
*** HOLE CARDS ***
Pete007poker: folds 
Infinities4: folds 
kazuking0318: raises $1 to $1.50
o-chan1986: folds 
xandr67: folds 
artemxxl: folds 
Slami4: folds 
takakensu: folds 
Uncalled bet ($1) returned to kazuking0318
kazuking0318 collected $1.25 from pot
kazuking0318: doesn't show hand 
*** SUMMARY ***
Total pot $1.25 | Rake $0 
Seat 1: kazuking0318 collected ($1.25)
Seat 3: o-chan1986 folded before Flop (didn't bet)
Seat 4: xandr67 folded before Flop (didn't bet)
Seat 5: artemxxl (button) folded before Flop (didn't bet)
Seat 6: Slami4 (small blind) folded before Flop
Seat 7: takakensu (big blind) folded before Flop
Seat 8: Pete007poker folded before Flop (didn't bet)
Seat 9: Infinities4 folded before Flop (didn't bet)



PokerStars Hand #228679303363:  Hold'em No Limit ($0.25/$0.50 USD) - 2021/07/30 9:49:34 ET
Table 'Aitne III' 9-max Seat #6 is the button
Seat 1: kazuking0318 ($51.46 in chips) 
Seat 3: o-chan1986 ($51.83 in chips) 
Seat 4: xandr67 ($50 in chips) 
Seat 5: artemxxl ($64.12 in chips) 
Seat 6: Slami4 ($50.98 in chips) 
Seat 7: takakensu ($56.94 in chips) 
Seat 8: Pete007poker ($50.50 in chips) 
Seat 9: Infinities4 ($52.15 in chips) 
takakensu: posts small blind $0.25
Pete007poker: posts big blind $0.50
speedbird uk: sits out 
*** HOLE CARDS ***
Infinities4: folds 
kazuking0318: folds 
o-chan1986: raises $0.75 to $1.25
xandr67: folds 
artemxxl: folds 
Slami4: folds 
takakensu: calls $1
Pete007poker: folds 
*** FLOP *** [Ah 2h 8c]
takakensu: checks 
o-chan1986: bets $1.43
takakensu: calls $1.43
*** TURN *** [Ah 2h 8c] [4c]
takakensu: checks 
o-chan1986: bets $2.79
takakensu: calls $2.79
*** RIVER *** [Ah 2h 8c 4c] [As]
takakensu: checks 
o-chan1986: bets $4
takakensu: calls $4
*** SHOW DOWN ***
o-chan1986: shows [Ac Jc] (three of a kind, Aces)
takakensu: mucks hand 
o-chan1986 collected $18.47 from pot
*** SUMMARY ***
Total pot $19.44 | Rake $0.97 
Board [Ah 2h 8c 4c As]
Seat 1: kazuking0318 folded before Flop (didn't bet)
Seat 3: o-chan1986 showed [Ac Jc] and won ($18.47) with three of a kind, Aces
Seat 4: xandr67 folded before Flop (didn't bet)
Seat 5: artemxxl folded before Flop (didn't bet)
Seat 6: Slami4 (button) folded before Flop (didn't bet)
Seat 7: takakensu (small blind) mucked
Seat 8: Pete007poker (big blind) folded before Flop
Seat 9: Infinities4 folded before Flop (didn't bet)



PokerStars Hand #228679327266:  Hold'em No Limit ($0.25/$0.50 USD) - 2021/07/30 9:50:36 ET
Table 'Aitne III' 9-max Seat #7 is the button
Seat 1: kazuking0318 ($51.46 in chips) 
Seat 3: o-chan1986 ($60.83 in chips) 
Seat 4: xandr67 ($50 in chips) 
Seat 5: artemxxl ($64.12 in chips) 
Seat 6: Slami4 ($50.98 in chips) 
Seat 7: takakensu ($47.47 in chips) 
Seat 8: Pete007poker ($50 in chips) 
Seat 9: Infinities4 ($52.15 in chips) 
Pete007poker: posts small blind $0.25
Infinities4: posts big blind $0.50
speedbird uk: sits out 
*** HOLE CARDS ***
kazuking0318: folds 
o-chan1986: raises $0.75 to $1.25
xandr67: folds 
artemxxl: folds 
Slami4: calls $1.25
takakensu: folds 
Pete007poker: folds 
Infinities4: folds 
*** FLOP *** [Qs Ac 6h]
o-chan1986: bets $1.55
Infinities4 leaves the table
Slami4: folds 
Uncalled bet ($1.55) returned to o-chan1986
o-chan1986 collected $3.09 from pot
o-chan1986: doesn't show hand 
*** SUMMARY ***
Total pot $3.25 | Rake $0.16 
Board [Qs Ac 6h]
Seat 1: kazuking0318 folded before Flop (didn't bet)
Seat 3: o-chan1986 collected ($3.09)
Seat 4: xandr67 folded before Flop (didn't bet)
Seat 5: artemxxl folded before Flop (didn't bet)
Seat 6: Slami4 folded on the Flop
Seat 7: takakensu (button) folded before Flop (didn't bet)
Seat 8: Pete007poker (small blind) folded before Flop
Seat 9: Infinities4 (big blind) folded before Flop



PokerStars Hand #228679336578:  Hold'em No Limit ($0.25/$0.50 USD) - 2021/07/30 9:51:09 ET
Table 'Aitne III' 9-max Seat #8 is the button
Seat 1: kazuking0318 ($51.46 in chips) 
Seat 2: speedbird uk ($46.06 in chips) 
Seat 3: o-chan1986 ($62.67 in chips) 
Seat 4: xandr67 ($50 in chips) 
Seat 5: artemxxl ($64.12 in chips) 
Seat 6: Slami4 ($50 in chips) 
Seat 7: takakensu ($47.47 in chips) 
Seat 8: Pete007poker ($50 in chips) 
kazuking0318: posts small blind $0.25
speedbird uk: posts big blind $0.50
*** HOLE CARDS ***
o-chan1986: folds 
xandr67: folds 
artemxxl: folds 
Slami4: folds 
Dragonclawss joins the table at seat #9 
takakensu: raises $1 to $1.50
Pete007poker: folds 
kazuking0318: folds 
speedbird uk: folds 
Uncalled bet ($1) returned to takakensu
takakensu collected $1.25 from pot
takakensu: doesn't show hand 
*** SUMMARY ***
Total pot $1.25 | Rake $0 
Seat 1: kazuking0318 (small blind) folded before Flop
Seat 2: speedbird uk (big blind) folded before Flop
Seat 3: o-chan1986 folded before Flop (didn't bet)
Seat 4: xandr67 folded before Flop (didn't bet)
Seat 5: artemxxl folded before Flop (didn't bet)
Seat 6: Slami4 folded before Flop (didn't bet)
Seat 7: takakensu collected ($1.25)
Seat 8: Pete007poker (button) folded before Flop (didn't bet)



PokerStars Hand #228679341033:  Hold'em No Limit ($0.25/$0.50 USD) - 2021/07/30 9:51:24 ET
Table 'Aitne III' 9-max Seat #1 is the button
Seat 1: kazuking0318 ($51.21 in chips) 
Seat 2: speedbird uk ($45.56 in chips) 
Seat 3: o-chan1986 ($62.67 in chips) 
Seat 4: xandr67 ($50 in chips) 
Seat 5: artemxxl ($64.12 in chips) 
Seat 6: Slami4 ($50 in chips) 
Seat 7: takakensu ($48.22 in chips) 
Seat 8: Pete007poker ($50 in chips) 
speedbird uk: posts small blind $0.25
o-chan1986: posts big blind $0.50
Dragonclawss: sits out 
*** HOLE CARDS ***
xandr67: folds 
artemxxl: folds 
Slami4: folds 
takakensu: folds 
Pete007poker: raises $0.75 to $1.25
kazuking0318: folds 
speedbird uk: folds 
o-chan1986: folds 
Uncalled bet ($0.75) returned to Pete007poker
Pete007poker collected $1.25 from pot
*** SUMMARY ***
Total pot $1.25 | Rake $0 
Seat 1: kazuking0318 (button) folded before Flop (didn't bet)
Seat 2: speedbird uk (small blind) folded before Flop
Seat 3: o-chan1986 (big blind) folded before Flop
Seat 4: xandr67 folded before Flop (didn't bet)
Seat 5: artemxxl folded before Flop (didn't bet)
Seat 6: Slami4 folded before Flop (didn't bet)
Seat 7: takakensu folded before Flop (didn't bet)
Seat 8: Pete007poker collected ($1.25)



PokerStars Hand #228679345950:  Hold'em No Limit ($0.25/$0.50 USD) - 2021/07/30 9:51:42 ET
Table 'Aitne III' 9-max Seat #2 is the button
Seat 1: kazuking0318 ($51.21 in chips) 
Seat 2: speedbird uk ($45.31 in chips) 
Seat 3: o-chan1986 ($62.17 in chips) 
Seat 4: xandr67 ($50 in chips) 
Seat 5: artemxxl ($64.12 in chips) 
Seat 6: Slami4 ($50 in chips) 
Seat 7: takakensu ($48.22 in chips) 
Seat 8: Pete007poker ($50.75 in chips) 
o-chan1986: posts small blind $0.25
xandr67: posts big blind $0.50
Dragonclawss: sits out 
*** HOLE CARDS ***
artemxxl: folds 
Slami4: folds 
takakensu: folds 
Pete007poker: folds 
kazuking0318: folds 
speedbird uk: folds 
o-chan1986: raises $0.75 to $1.25
xandr67: folds 
Uncalled bet ($0.75) returned to o-chan1986
o-chan1986 collected $1 from pot
o-chan1986: doesn't show hand 
*** SUMMARY ***
Total pot $1 | Rake $0 
Seat 1: kazuking0318 folded before Flop (didn't bet)
Seat 2: speedbird uk (button) folded before Flop (didn't bet)
Seat 3: o-chan1986 (small blind) collected ($1)
Seat 4: xandr67 (big blind) folded before Flop
Seat 5: artemxxl folded before Flop (didn't bet)
Seat 6: Slami4 folded before Flop (didn't bet)
Seat 7: takakensu folded before Flop (didn't bet)
Seat 8: Pete007poker folded before Flop (didn't bet)



PokerStars Hand #228679351988:  Hold'em No Limit ($0.25/$0.50 USD) - 2021/07/30 9:52:03 ET
Table 'Aitne III' 9-max Seat #3 is the button
Seat 1: kazuking0318 ($51.21 in chips) 
Seat 2: speedbird uk ($45.31 in chips) 
Seat 3: o-chan1986 ($62.67 in chips) 
Seat 4: xandr67 ($50 in chips) 
Seat 5: artemxxl ($64.12 in chips) 
Seat 6: Slami4 ($50 in chips) 
Seat 7: takakensu ($48.22 in chips) 
Seat 8: Pete007poker ($50.75 in chips) 
xandr67: posts small blind $0.25
artemxxl: posts big blind $0.50
Dragonclawss: sits out 
*** HOLE CARDS ***
Slami4: folds 
takakensu: folds 
Pete007poker: folds 
kazuking0318: folds 
speedbird uk: folds 
o-chan1986: raises $0.75 to $1.25
xandr67: folds 
artemxxl: folds 
Uncalled bet ($0.75) returned to o-chan1986
o-chan1986 collected $1.25 from pot
o-chan1986: doesn't show hand 
*** SUMMARY ***
Total pot $1.25 | Rake $0 
Seat 1: kazuking0318 folded before Flop (didn't bet)
Seat 2: speedbird uk folded before Flop (didn't bet)
Seat 3: o-chan1986 (button) collected ($1.25)
Seat 4: xandr67 (small blind) folded before Flop
Seat 5: artemxxl (big blind) folded before Flop
Seat 6: Slami4 folded before Flop (didn't bet)
Seat 7: takakensu folded before Flop (didn't bet)
Seat 8: Pete007poker folded before Flop (didn't bet)



PokerStars Hand #228679357798:  Hold'em No Limit ($0.25/$0.50 USD) - 2021/07/30 9:52:23 ET
Table 'Aitne III' 9-max Seat #4 is the button
Seat 1: kazuking0318 ($51.21 in chips) 
Seat 2: speedbird uk ($45.31 in chips) 
Seat 3: o-chan1986 ($63.42 in chips) 
Seat 4: xandr67 ($50 in chips) 
Seat 5: artemxxl ($63.62 in chips) 
Seat 6: Slami4 ($50 in chips) 
Seat 7: takakensu ($48.22 in chips) 
Seat 8: Pete007poker ($50.75 in chips) 
artemxxl: posts small blind $0.25
Slami4: posts big blind $0.50
Dragonclawss: sits out 
*** HOLE CARDS ***
takakensu: folds 
Pete007poker: folds 
kazuking0318: raises $1 to $1.50
speedbird uk: folds 
o-chan1986: folds 
xandr67: folds 
artemxxl: folds 
Slami4: folds 
Uncalled bet ($1) returned to kazuking0318
kazuking0318 collected $1.25 from pot
kazuking0318: doesn't show hand 
*** SUMMARY ***
Total pot $1.25 | Rake $0 
Seat 1: kazuking0318 collected ($1.25)
Seat 2: speedbird uk folded before Flop (didn't bet)
Seat 3: o-chan1986 folded before Flop (didn't bet)
Seat 4: xandr67 (button) folded before Flop (didn't bet)
Seat 5: artemxxl (small blind) folded before Flop
Seat 6: Slami4 (big blind) folded before Flop
Seat 7: takakensu folded before Flop (didn't bet)
Seat 8: Pete007poker folded before Flop (didn't bet)



PokerStars Hand #228679366109:  Hold'em No Limit ($0.25/$0.50 USD) - 2021/07/30 9:52:52 ET
Table 'Aitne III' 9-max Seat #5 is the button
Seat 1: kazuking0318 ($51.96 in chips) 
Seat 2: speedbird uk ($45.31 in chips) 
Seat 3: o-chan1986 ($63.42 in chips) 
Seat 4: xandr67 ($50 in chips) 
Seat 5: artemxxl ($63.37 in chips) 
Seat 6: Slami4 ($50 in chips) 
Seat 7: takakensu ($48.22 in chips) 
Seat 8: Pete007poker ($50.75 in chips) 
Slami4: posts small blind $0.25
takakensu: posts big blind $0.50
Dragonclawss: sits out 
*** HOLE CARDS ***
Pete007poker: folds 
kazuking0318: raises $1 to $1.50
speedbird uk: folds 
o-chan1986: calls $1.50
xandr67: folds 
artemxxl: folds 
Slami4: folds 
takakensu: folds 
*** FLOP *** [3h As 6s]
kazuking0318: bets $1.75
o-chan1986: folds 
Uncalled bet ($1.75) returned to kazuking0318
kazuking0318 collected $3.56 from pot
kazuking0318: doesn't show hand 
*** SUMMARY ***
Total pot $3.75 | Rake $0.19 
Board [3h As 6s]
Seat 1: kazuking0318 collected ($3.56)
Seat 2: speedbird uk folded before Flop (didn't bet)
Seat 3: o-chan1986 folded on the Flop
Seat 4: xandr67 folded before Flop (didn't bet)
Seat 5: artemxxl (button) folded before Flop (didn't bet)
Seat 6: Slami4 (small blind) folded before Flop
Seat 7: takakensu (big blind) folded before Flop
Seat 8: Pete007poker folded before Flop (didn't bet)



PokerStars Hand #228679376136:  Hold'em No Limit ($0.25/$0.50 USD) - 2021/07/30 9:53:26 ET
Table 'Aitne III' 9-max Seat #6 is the button
Seat 1: kazuking0318 ($54.02 in chips) 
Seat 2: speedbird uk ($45.31 in chips) 
Seat 3: o-chan1986 ($61.92 in chips) 
Seat 4: xandr67 ($50 in chips) 
Seat 5: artemxxl ($63.37 in chips) 
Seat 6: Slami4 ($50 in chips) 
Seat 7: takakensu ($47.72 in chips) 
Seat 8: Pete007poker ($50.75 in chips) 
takakensu: posts small blind $0.25
Pete007poker: posts big blind $0.50
Dragonclawss: sits out 
*** HOLE CARDS ***
kazuking0318: folds 
speedbird uk: raises $1 to $1.50
o-chan1986: folds 
xandr67: folds 
artemxxl: folds 
Slami4: calls $1.50
takakensu: folds 
Pete007poker: folds 
*** FLOP *** [4s Ah 7s]
speedbird uk: checks 
Slami4: bets $2.35
speedbird uk: calls $2.35
*** TURN *** [4s Ah 7s] [Td]
speedbird uk: bets $2.50
Slami4: calls $2.50
*** RIVER *** [4s Ah 7s Td] [8c]
speedbird uk: bets $1
Slami4: calls $1
*** SHOW DOWN ***
speedbird uk: shows [8s 9s] (a pair of Eights)
Slami4: shows [3s As] (a pair of Aces)
Slami4 collected $14.68 from pot
*** SUMMARY ***
Total pot $15.45 | Rake $0.77 
Board [4s Ah 7s Td 8c]
Seat 1: kazuking0318 folded before Flop (didn't bet)
Seat 2: speedbird uk showed [8s 9s] and lost with a pair of Eights
Seat 3: o-chan1986 folded before Flop (didn't bet)
Seat 4: xandr67 folded before Flop (didn't bet)
Seat 5: artemxxl folded before Flop (didn't bet)
Seat 6: Slami4 (button) showed [3s As] and won ($14.68) with a pair of Aces
Seat 7: takakensu (small blind) folded before Flop
Seat 8: Pete007poker (big blind) folded before Flop



PokerStars Hand #228679391514:  Hold'em No Limit ($0.25/$0.50 USD) - 2021/07/30 9:54:19 ET
Table 'Aitne III' 9-max Seat #7 is the button
Seat 1: kazuking0318 ($54.02 in chips) 
Seat 2: speedbird uk ($37.96 in chips) 
Seat 3: o-chan1986 ($61.92 in chips) 
Seat 4: xandr67 ($50 in chips) 
Seat 5: artemxxl ($63.37 in chips) 
Seat 6: Slami4 ($57.33 in chips) 
Seat 7: takakensu ($47.47 in chips) 
Seat 8: Pete007poker ($50.25 in chips) 
Seat 9: Dragonclawss ($50 in chips) 
Pete007poker: posts small blind $0.25
Dragonclawss: posts big blind $0.50
*** HOLE CARDS ***
kazuking0318: folds 
speedbird uk: raises $1 to $1.50
o-chan1986: calls $1.50
xandr67: folds 
artemxxl: folds 
Slami4: folds 
takakensu: folds 
Pete007poker: folds 
Dragonclawss: folds 
*** FLOP *** [Ac Kd 2c]
speedbird uk: checks 
o-chan1986: bets $1.78
speedbird uk: folds 
Uncalled bet ($1.78) returned to o-chan1986
o-chan1986 collected $3.56 from pot
o-chan1986: doesn't show hand 
*** SUMMARY ***
Total pot $3.75 | Rake $0.19 
Board [Ac Kd 2c]
Seat 1: kazuking0318 folded before Flop (didn't bet)
Seat 2: speedbird uk folded on the Flop
Seat 3: o-chan1986 collected ($3.56)
Seat 4: xandr67 folded before Flop (didn't bet)
Seat 5: artemxxl folded before Flop (didn't bet)
Seat 6: Slami4 folded before Flop (didn't bet)
Seat 7: takakensu (button) folded before Flop (didn't bet)
Seat 8: Pete007poker (small blind) folded before Flop
Seat 9: Dragonclawss (big blind) folded before Flop



PokerStars Hand #228679402391:  Hold'em No Limit ($0.25/$0.50 USD) - 2021/07/30 9:54:57 ET
Table 'Aitne III' 9-max Seat #8 is the button
Seat 1: kazuking0318 ($54.02 in chips) 
Seat 2: speedbird uk ($36.46 in chips) 
Seat 3: o-chan1986 ($63.98 in chips) 
Seat 4: xandr67 ($50 in chips) 
Seat 5: artemxxl ($63.37 in chips) 
Seat 6: Slami4 ($57.33 in chips) 
Seat 7: takakensu ($47.47 in chips) 
Seat 8: Pete007poker ($50 in chips) 
Seat 9: Dragonclawss ($50 in chips) 
Dragonclawss: posts small blind $0.25
kazuking0318: posts big blind $0.50
*** HOLE CARDS ***
speedbird uk: folds 
o-chan1986: folds 
xandr67: folds 
artemxxl: folds 
Slami4: raises $1 to $1.50
takakensu: folds 
Pete007poker: folds 
Dragonclawss: folds 
kazuking0318: folds 
Uncalled bet ($1) returned to Slami4
Slami4 collected $1.25 from pot
*** SUMMARY ***
Total pot $1.25 | Rake $0 
Seat 1: kazuking0318 (big blind) folded before Flop
Seat 2: speedbird uk folded before Flop (didn't bet)
Seat 3: o-chan1986 folded before Flop (didn't bet)
Seat 4: xandr67 folded before Flop (didn't bet)
Seat 5: artemxxl folded before Flop (didn't bet)
Seat 6: Slami4 collected ($1.25)
Seat 7: takakensu folded before Flop (didn't bet)
Seat 8: Pete007poker (button) folded before Flop (didn't bet)
Seat 9: Dragonclawss (small blind) folded before Flop



PokerStars Hand #228679409122:  Hold'em No Limit ($0.25/$0.50 USD) - 2021/07/30 9:55:23 ET
Table 'Aitne III' 9-max Seat #9 is the button
Seat 1: kazuking0318 ($53.52 in chips) 
Seat 2: speedbird uk ($36.46 in chips) 
Seat 3: o-chan1986 ($63.98 in chips) 
Seat 4: xandr67 ($50 in chips) 
Seat 5: artemxxl ($63.37 in chips) 
Seat 6: Slami4 ($58.08 in chips) 
Seat 7: takakensu ($47.47 in chips) 
Seat 8: Pete007poker ($50 in chips) 
Seat 9: Dragonclawss ($50 in chips) 
kazuking0318: posts small blind $0.25
speedbird uk: posts big blind $0.50
*** HOLE CARDS ***
o-chan1986: folds 
xandr67: folds 
artemxxl: folds 
Slami4: folds 
takakensu: folds 
Pete007poker: raises $1 to $1.50
Dragonclawss: folds 
kazuking0318: calls $1.25
speedbird uk: calls $1
*** FLOP *** [9s 7s Tc]
kazuking0318: checks 
speedbird uk: checks 
Pete007poker: bets $2.14
kazuking0318: calls $2.14
speedbird uk: folds 
*** TURN *** [9s 7s Tc] [Qd]
kazuking0318: checks 
Pete007poker: checks 
*** RIVER *** [9s 7s Tc Qd] [Th]
kazuking0318: bets $3.75
Pete007poker: calls $3.75
*** SHOW DOWN ***
kazuking0318: shows [Js Jc] (two pair, Jacks and Tens)
Pete007poker: shows [As Qs] (two pair, Queens and Tens)
Pete007poker collected $15.47 from pot
*** SUMMARY ***
Total pot $16.28 | Rake $0.81 
Board [9s 7s Tc Qd Th]
Seat 1: kazuking0318 (small blind) showed [Js Jc] and lost with two pair, Jacks and Tens
Seat 2: speedbird uk (big blind) folded on the Flop
Seat 3: o-chan1986 folded before Flop (didn't bet)
Seat 4: xandr67 folded before Flop (didn't bet)
Seat 5: artemxxl folded before Flop (didn't bet)
Seat 6: Slami4 folded before Flop (didn't bet)
Seat 7: takakensu folded before Flop (didn't bet)
Seat 8: Pete007poker showed [As Qs] and won ($15.47) with two pair, Queens and Tens
Seat 9: Dragonclawss (button) folded before Flop (didn't bet)



PokerStars Hand #228679423616:  Hold'em No Limit ($0.25/$0.50 USD) - 2021/07/30 9:56:22 ET
Table 'Aitne III' 9-max Seat #1 is the button
Seat 1: kazuking0318 ($46.13 in chips) 
Seat 2: speedbird uk ($34.96 in chips) 
Seat 3: o-chan1986 ($63.98 in chips) 
Seat 4: xandr67 ($50 in chips) 
Seat 5: artemxxl ($63.37 in chips) 
Seat 6: Slami4 ($58.08 in chips) 
Seat 7: takakensu ($47.47 in chips) 
Seat 8: Pete007poker ($58.08 in chips) 
Seat 9: Dragonclawss ($50 in chips) 
speedbird uk: posts small blind $0.25
o-chan1986: posts big blind $0.50
*** HOLE CARDS ***
xandr67: folds 
artemxxl: raises $1 to $1.50
Slami4: folds 
takakensu: folds 
Pete007poker: folds 
Dragonclawss: folds 
kazuking0318: folds 
speedbird uk: folds 
o-chan1986: calls $1
*** FLOP *** [8c 5h Ts]
o-chan1986: checks 
artemxxl: checks 
*** TURN *** [8c 5h Ts] [5d]
o-chan1986: bets $1.55
artemxxl: folds 
Uncalled bet ($1.55) returned to o-chan1986
o-chan1986 collected $3.09 from pot
o-chan1986: doesn't show hand 
*** SUMMARY ***
Total pot $3.25 | Rake $0.16 
Board [8c 5h Ts 5d]
Seat 1: kazuking0318 (button) folded before Flop (didn't bet)
Seat 2: speedbird uk (small blind) folded before Flop
Seat 3: o-chan1986 (big blind) collected ($3.09)
Seat 4: xandr67 folded before Flop (didn't bet)
Seat 5: artemxxl folded on the Turn
Seat 6: Slami4 folded before Flop (didn't bet)
Seat 7: takakensu folded before Flop (didn't bet)
Seat 8: Pete007poker folded before Flop (didn't bet)
Seat 9: Dragonclawss folded before Flop (didn't bet)



PokerStars Hand #228679435003:  Hold'em No Limit ($0.25/$0.50 USD) - 2021/07/30 9:57:10 ET
Table 'Aitne III' 9-max Seat #2 is the button
Seat 1: kazuking0318 ($46.13 in chips) 
Seat 2: speedbird uk ($34.71 in chips) 
Seat 3: o-chan1986 ($65.57 in chips) 
Seat 5: artemxxl ($61.87 in chips) 
Seat 6: Slami4 ($58.08 in chips) 
Seat 7: takakensu ($47.47 in chips) 
Seat 8: Pete007poker ($58.08 in chips) 
Seat 9: Dragonclawss ($50 in chips) 
o-chan1986: posts small blind $0.25
xandr67: is sitting out 
xandr67 leaves the table
artemxxl: posts big blind $0.50
*** HOLE CARDS ***
Slami4: folds 
takakensu: folds 
Pete007poker: folds 
Dragonclawss: folds 
kazuking0318: folds 
speedbird uk: folds 
o-chan1986: raises $0.75 to $1.25
artemxxl: raises $2.50 to $3.75
o-chan1986: folds 
Uncalled bet ($2.50) returned to artemxxl
Thefinster71 joins the table at seat #4 
artemxxl collected $2.50 from pot
*** SUMMARY ***
Total pot $2.50 | Rake $0 
Seat 1: kazuking0318 folded before Flop (didn't bet)
Seat 2: speedbird uk (button) folded before Flop (didn't bet)
Seat 3: o-chan1986 (small blind) folded before Flop
Seat 5: artemxxl (big blind) collected ($2.50)
Seat 6: Slami4 folded before Flop (didn't bet)
Seat 7: takakensu folded before Flop (didn't bet)
Seat 8: Pete007poker folded before Flop (didn't bet)
Seat 9: Dragonclawss folded before Flop (didn't bet)



PokerStars Hand #228679442106:  Hold'em No Limit ($0.25/$0.50 USD) - 2021/07/30 9:57:40 ET
Table 'Aitne III' 9-max Seat #3 is the button
Seat 1: kazuking0318 ($46.13 in chips) 
Seat 2: speedbird uk ($34.71 in chips) 
Seat 3: o-chan1986 ($64.32 in chips) 
Seat 5: artemxxl ($63.12 in chips) 
Seat 7: takakensu ($47.47 in chips) 
Seat 8: Pete007poker ($58.08 in chips) 
Seat 9: Dragonclawss ($50 in chips) 
artemxxl: posts small blind $0.25
Slami4: is sitting out 
takakensu: posts big blind $0.50
*** HOLE CARDS ***
Pete007poker: folds 
Dragonclawss: folds 
kazuking0318: folds 
speedbird uk: folds 
Slami4 leaves the table
o-chan1986: raises $0.75 to $1.25
artemxxl: folds 
takakensu: calls $0.75
*** FLOP *** [2s Th 2c]
Zhud19 joins the table at seat #6 
takakensu: bets $1.30
o-chan1986: calls $1.30
*** TURN *** [2s Th 2c] [4s]
takakensu: checks 
o-chan1986: checks 
*** RIVER *** [2s Th 2c 4s] [7h]
takakensu: bets $2.54
o-chan1986: calls $2.54
*** SHOW DOWN ***
takakensu: shows [Kd 5c] (a pair of Deuces)
o-chan1986: shows [Qd As] (a pair of Deuces - Ace kicker)
o-chan1986 collected $9.91 from pot
*** SUMMARY ***
Total pot $10.43 | Rake $0.52 
Board [2s Th 2c 4s 7h]
Seat 1: kazuking0318 folded before Flop (didn't bet)
Seat 2: speedbird uk folded before Flop (didn't bet)
Seat 3: o-chan1986 (button) showed [Qd As] and won ($9.91) with a pair of Deuces
Seat 5: artemxxl (small blind) folded before Flop
Seat 7: takakensu (big blind) showed [Kd 5c] and lost with a pair of Deuces
Seat 8: Pete007poker folded before Flop (didn't bet)
Seat 9: Dragonclawss folded before Flop (didn't bet)



PokerStars Hand #228679452679:  Hold'em No Limit ($0.25/$0.50 USD) - 2021/07/30 9:58:24 ET
Table 'Aitne III' 9-max Seat #5 is the button
Seat 1: kazuking0318 ($46.13 in chips) 
Seat 2: speedbird uk ($34.71 in chips) 
Seat 3: o-chan1986 ($69.14 in chips) 
Seat 5: artemxxl ($62.87 in chips) 
Seat 7: takakensu ($42.38 in chips) 
Seat 8: Pete007poker ($58.08 in chips) 
Seat 9: Dragonclawss ($50 in chips) 
takakensu: posts small blind $0.25
Pete007poker: posts big blind $0.50
Thefinster71: sits out 
*** HOLE CARDS ***
Dragonclawss: folds 
kazuking0318: folds 
speedbird uk: folds 
o-chan1986: raises $0.75 to $1.25
artemxxl: folds 
takakensu: folds 
Pete007poker: folds 
Uncalled bet ($0.75) returned to o-chan1986
o-chan1986 collected $1.25 from pot
o-chan1986: doesn't show hand 
*** SUMMARY ***
Total pot $1.25 | Rake $0 
Seat 1: kazuking0318 folded before Flop (didn't bet)
Seat 2: speedbird uk folded before Flop (didn't bet)
Seat 3: o-chan1986 collected ($1.25)
Seat 5: artemxxl (button) folded before Flop (didn't bet)
Seat 7: takakensu (small blind) folded before Flop
Seat 8: Pete007poker (big blind) folded before Flop
Seat 9: Dragonclawss folded before Flop (didn't bet)



PokerStars Hand #228679468975:  Hold'em No Limit ($0.25/$0.50 USD) - 2021/07/30 9:59:07 ET
Table 'Aitne III' 9-max Seat #7 is the button
Seat 1: kazuking0318 ($46.13 in chips) 
Seat 2: speedbird uk ($34.71 in chips) 
Seat 3: o-chan1986 ($69.89 in chips) 
Seat 4: Thefinster71 ($40 in chips) 
Seat 5: artemxxl ($62.87 in chips) 
Seat 7: takakensu ($42.13 in chips) 
Seat 8: Pete007poker ($57.58 in chips) 
Pete007poker: posts small blind $0.25
Dragonclawss: is sitting out 
Dragonclawss leaves the table
kazuking0318: posts big blind $0.50
Thefinster71: posts big blind $0.50
Zhud19: sits out 
*** HOLE CARDS ***
speedbird uk: raises $1 to $1.50
o-chan1986: folds 
Petrof98 joins the table at seat #9 
Thefinster71: folds 
artemxxl: folds 
takakensu: folds 
Pete007poker: folds 
kazuking0318: folds 
Uncalled bet ($1) returned to speedbird uk
speedbird uk collected $1.75 from pot
speedbird uk: doesn't show hand 
*** SUMMARY ***
Total pot $1.75 | Rake $0 
Seat 1: kazuking0318 (big blind) folded before Flop
Seat 2: speedbird uk collected ($1.75)
Seat 3: o-chan1986 folded before Flop (didn't bet)
Seat 4: Thefinster71 folded before Flop (didn't bet)
Seat 5: artemxxl folded before Flop (didn't bet)
Seat 7: takakensu (button) folded before Flop (didn't bet)
Seat 8: Pete007poker (small blind) folded before Flop



PokerStars Hand #228679475225:  Hold'em No Limit ($0.25/$0.50 USD) - 2021/07/30 9:59:33 ET
Table 'Aitne III' 9-max Seat #8 is the button
Seat 1: kazuking0318 ($45.63 in chips) 
Seat 2: speedbird uk ($35.96 in chips) 
Seat 3: o-chan1986 ($69.89 in chips) 
Seat 4: Thefinster71 ($39.50 in chips) 
Seat 5: artemxxl ($62.87 in chips) 
Seat 7: takakensu ($42.13 in chips) 
Seat 8: Pete007poker ($57.33 in chips) 
kazuking0318: posts small blind $0.25
speedbird uk: posts big blind $0.50
Zhud19: sits out 
*** HOLE CARDS ***
o-chan1986: folds 
Thefinster71: raises $1 to $1.50
artemxxl: calls $1.50
takakensu: folds 
Pete007poker: folds 
kazuking0318: calls $1.25
speedbird uk: folds 
*** FLOP *** [Td Th 7d]
kazuking0318: checks 
Thefinster71: bets $2
artemxxl: calls $2
kazuking0318: folds 
*** TURN *** [Td Th 7d] [Kd]
Thefinster71: bets $3
artemxxl: folds 
Uncalled bet ($3) returned to Thefinster71
Thefinster71 collected $8.55 from pot
Thefinster71: doesn't show hand 
*** SUMMARY ***
Total pot $9 | Rake $0.45 
Board [Td Th 7d Kd]
Seat 1: kazuking0318 (small blind) folded on the Flop
Seat 2: speedbird uk (big blind) folded before Flop
Seat 3: o-chan1986 folded before Flop (didn't bet)
Seat 4: Thefinster71 collected ($8.55)
Seat 5: artemxxl folded on the Turn
Seat 7: takakensu folded before Flop (didn't bet)
Seat 8: Pete007poker (button) folded before Flop (didn't bet)



PokerStars Hand #228679487605:  Hold'em No Limit ($0.25/$0.50 USD) - 2021/07/30 10:00:24 ET
Table 'Aitne III' 9-max Seat #1 is the button
Seat 1: kazuking0318 ($44.13 in chips) 
Seat 2: speedbird uk ($35.46 in chips) 
Seat 3: o-chan1986 ($69.89 in chips) 
Seat 4: Thefinster71 ($44.55 in chips) 
Seat 5: artemxxl ($59.37 in chips) 
Seat 7: takakensu ($42.13 in chips) 
Seat 8: Pete007poker ($57.33 in chips) 
Seat 9: Petrof98 ($26.68 in chips) 
speedbird uk: posts small blind $0.25
o-chan1986: posts big blind $0.50
Zhud19: sits out 
Petrof98: posts big blind $0.50
*** HOLE CARDS ***
Thefinster71: folds 
artemxxl: raises $1.25 to $1.75
takakensu: folds 
Pete007poker: folds 
Petrof98: folds 
kazuking0318: folds 
speedbird uk: folds 
o-chan1986: folds 
Uncalled bet ($1.25) returned to artemxxl
artemxxl collected $1.75 from pot
*** SUMMARY ***
Total pot $1.75 | Rake $0 
Seat 1: kazuking0318 (button) folded before Flop (didn't bet)
Seat 2: speedbird uk (small blind) folded before Flop
Seat 3: o-chan1986 (big blind) folded before Flop
Seat 4: Thefinster71 folded before Flop (didn't bet)
Seat 5: artemxxl collected ($1.75)
Seat 7: takakensu folded before Flop (didn't bet)
Seat 8: Pete007poker folded before Flop (didn't bet)
Seat 9: Petrof98 folded before Flop (didn't bet)



PokerStars Hand #228680057876:  Hold'em No Limit ($0.25/$0.50 USD) - 2021/07/30 10:31:40 ET
Table 'Aitne III' 9-max Seat #8 is the button
Seat 1: Infinities4 ($50 in chips) 
Seat 2: speedbird uk ($43.53 in chips) 
Seat 3: o-chan1986 ($65.87 in chips) 
Seat 4: Stingg ($50 in chips) 
Seat 5: artemxxl ($77.26 in chips) 
Seat 7: takakensu ($100.91 in chips) 
Seat 8: 7lubcak7 ($11.23 in chips) 
Seat 9: Petrof98 ($41.11 in chips) 
Petrof98: posts small blind $0.25
Infinities4: posts big blind $0.50
alexrus18: sits out 
*** HOLE CARDS ***
speedbird uk: folds 
o-chan1986: folds 
Stingg: folds 
artemxxl: folds 
takakensu: folds 
7lubcak7: folds 
Petrof98: raises $0.75 to $1.25
Infinities4: calls $0.75
*** FLOP *** [5c 3s 2s]
Petrof98: checks 
Infinities4: bets $1.79
Petrof98: calls $1.79
*** TURN *** [5c 3s 2s] [Ad]
Petrof98: checks 
Infinities4: checks 
*** RIVER *** [5c 3s 2s Ad] [3d]
Petrof98: bets $6.94
Infinities4: folds 
Uncalled bet ($6.94) returned to Petrof98
Petrof98 collected $5.78 from pot
*** SUMMARY ***
Total pot $6.08 | Rake $0.30 
Board [5c 3s 2s Ad 3d]
Seat 1: Infinities4 (big blind) folded on the River
Seat 2: speedbird uk folded before Flop (didn't bet)
Seat 3: o-chan1986 folded before Flop (didn't bet)
Seat 4: Stingg folded before Flop (didn't bet)
Seat 5: artemxxl folded before Flop (didn't bet)
Seat 7: takakensu folded before Flop (didn't bet)
Seat 8: 7lubcak7 (button) folded before Flop (didn't bet)
Seat 9: Petrof98 (small blind) collected ($5.78)



PokerStars Hand #228681033454:  Hold'em No Limit ($0.25/$0.50 USD) - 2021/07/30 11:22:03 ET
Table 'Aitne III' 9-max Seat #5 is the button
Seat 2: VTcomp ($66.27 in chips) 
Seat 4: vkfls ($74.09 in chips) 
Seat 5: 11omsk11 ($50.50 in chips) 
Seat 6: hheman ($50 in chips) 
Seat 7: takakensu ($130.89 in chips) 
Seat 8: MKennyRltr ($40.82 in chips) 
Seat 9: siskin vrach ($50 in chips) 
hheman: posts small blind $0.25
takakensu: posts big blind $0.50
CocoAlexMix: sits out 
Lemmi846: sits out 
*** HOLE CARDS ***
MKennyRltr: folds 
siskin vrach: folds 
VTcomp: raises $1 to $1.50
vkfls: folds 
11omsk11: folds 
hheman: raises $3.50 to $5
takakensu: folds 
VTcomp: calls $3.50
*** FLOP *** [Ts 4s 9c]
hheman: bets $5
VTcomp: raises $5 to $10
hheman: folds 
Uncalled bet ($5) returned to VTcomp
VTcomp collected $19.48 from pot
VTcomp: doesn't show hand 
*** SUMMARY ***
Total pot $20.50 | Rake $1.02 
Board [Ts 4s 9c]
Seat 2: VTcomp collected ($19.48)
Seat 4: vkfls folded before Flop (didn't bet)
Seat 5: 11omsk11 (button) folded before Flop (didn't bet)
Seat 6: hheman (small blind) folded on the Flop
Seat 7: takakensu (big blind) folded before Flop
Seat 8: MKennyRltr folded before Flop (didn't bet)
Seat 9: siskin vrach folded before Flop (didn't bet)



PokerStars Hand #228681051809:  Hold'em No Limit ($0.25/$0.50 USD) - 2021/07/30 11:22:57 ET
Table 'Aitne III' 9-max Seat #6 is the button
Seat 2: VTcomp ($75.75 in chips) 
Seat 4: vkfls ($74.09 in chips) 
Seat 5: 11omsk11 ($50.50 in chips) 
Seat 6: hheman ($50 in chips) 
Seat 7: takakensu ($130.39 in chips) 
Seat 8: MKennyRltr ($40.82 in chips) 
Seat 9: siskin vrach ($50 in chips) 
takakensu: posts small blind $0.25
MKennyRltr: posts big blind $0.50
CocoAlexMix: sits out 
Lemmi846: sits out 
*** HOLE CARDS ***
siskin vrach: folds 
VTcomp: folds 
vkfls: folds 
11omsk11: raises $0.75 to $1.25
hheman: folds 
takakensu: folds 
MKennyRltr: folds 
Uncalled bet ($0.75) returned to 11omsk11
11omsk11 collected $1.25 from pot
11omsk11: doesn't show hand 
*** SUMMARY ***
Total pot $1.25 | Rake $0 
Seat 2: VTcomp folded before Flop (didn't bet)
Seat 4: vkfls folded before Flop (didn't bet)
Seat 5: 11omsk11 collected ($1.25)
Seat 6: hheman (button) folded before Flop (didn't bet)
Seat 7: takakensu (small blind) folded before Flop
Seat 8: MKennyRltr (big blind) folded before Flop
Seat 9: siskin vrach folded before Flop (didn't bet)



PokerStars Hand #228681056058:  Hold'em No Limit ($0.25/$0.50 USD) - 2021/07/30 11:23:10 ET
Table 'Aitne III' 9-max Seat #7 is the button
Seat 2: VTcomp ($75.75 in chips) 
Seat 4: vkfls ($74.09 in chips) 
Seat 5: 11omsk11 ($51.25 in chips) 
Seat 6: hheman ($50 in chips) 
Seat 7: takakensu ($130.14 in chips) 
Seat 8: MKennyRltr ($40.32 in chips) 
Seat 9: siskin vrach ($50 in chips) 
MKennyRltr: posts small blind $0.25
siskin vrach: posts big blind $0.50
CocoAlexMix: sits out 
Lemmi846: sits out 
*** HOLE CARDS ***
VTcomp: folds 
vkfls: folds 
11omsk11: folds 
vkfls leaves the table
hheman: raises $0.75 to $1.25
takakensu: raises $1.25 to $2.50
MKennyRltr: folds 
siskin vrach: folds 
hheman: calls $1.25
*** FLOP *** [3c Qh 5h]
hheman: checks 
takakensu: checks 
*** TURN *** [3c Qh 5h] [7d]
hheman: bets $3
takakensu: calls $3
*** RIVER *** [3c Qh 5h 7d] [9d]
hheman: checks 
takakensu: bets $5.58
hheman: calls $5.58
*** SHOW DOWN ***
takakensu: shows [9c As] (a pair of Nines)
hheman: shows [Ts Qc] (a pair of Queens)
hheman collected $21.76 from pot
*** SUMMARY ***
Total pot $22.91 | Rake $1.15 
Board [3c Qh 5h 7d 9d]
Seat 2: VTcomp folded before Flop (didn't bet)
Seat 4: vkfls folded before Flop (didn't bet)
Seat 5: 11omsk11 folded before Flop (didn't bet)
Seat 6: hheman showed [Ts Qc] and won ($21.76) with a pair of Queens
Seat 7: takakensu (button) showed [9c As] and lost with a pair of Nines
Seat 8: MKennyRltr (small blind) folded before Flop
Seat 9: siskin vrach (big blind) folded before Flop



PokerStars Hand #228681072679:  Hold'em No Limit ($0.25/$0.50 USD) - 2021/07/30 11:23:59 ET
Table 'Aitne III' 9-max Seat #8 is the button
Seat 1: CocoAlexMix ($53.12 in chips) 
Seat 2: VTcomp ($75.75 in chips) 
Seat 5: 11omsk11 ($51.25 in chips) 
Seat 6: hheman ($60.68 in chips) 
Seat 7: takakensu ($119.06 in chips) 
Seat 8: MKennyRltr ($40.07 in chips) 
Seat 9: siskin vrach ($50 in chips) 
siskin vrach: posts small blind $0.25
CocoAlexMix: posts big blind $0.50
Lemmi846: sits out 
*** HOLE CARDS ***
VTcomp: folds 
11omsk11: folds 
hheman: folds 
takakensu: folds 
MKennyRltr: folds 
siskin vrach: raises $1.26 to $1.76
CocoAlexMix: folds 
Uncalled bet ($1.26) returned to siskin vrach
siskin vrach collected $1 from pot
*** SUMMARY ***
Total pot $1 | Rake $0 
Seat 1: CocoAlexMix (big blind) folded before Flop
Seat 2: VTcomp folded before Flop (didn't bet)
Seat 5: 11omsk11 folded before Flop (didn't bet)
Seat 6: hheman folded before Flop (didn't bet)
Seat 7: takakensu folded before Flop (didn't bet)
Seat 8: MKennyRltr (button) folded before Flop (didn't bet)
Seat 9: siskin vrach (small blind) collected ($1)



PokerStars Hand #228681076543:  Hold'em No Limit ($0.25/$0.50 USD) - 2021/07/30 11:24:11 ET
Table 'Aitne III' 9-max Seat #9 is the button
Seat 1: CocoAlexMix ($52.62 in chips) 
Seat 2: VTcomp ($75.75 in chips) 
Seat 5: 11omsk11 ($51.25 in chips) 
Seat 6: hheman ($60.68 in chips) 
Seat 7: takakensu ($119.06 in chips) 
Seat 8: MKennyRltr ($40.07 in chips) 
Seat 9: siskin vrach ($50.50 in chips) 
CocoAlexMix: posts small blind $0.25
VTcomp: posts big blind $0.50
Lemmi846: sits out 
*** HOLE CARDS ***
11omsk11: folds 
JoePsycho joins the table at seat #4 
hheman: folds 
takakensu: raises $1 to $1.50
MKennyRltr: calls $1.50
siskin vrach: folds 
CocoAlexMix: folds 
VTcomp: folds 
*** FLOP *** [Qs 4d Js]
takakensu: bets $1.78
MKennyRltr: folds 
Uncalled bet ($1.78) returned to takakensu
takakensu collected $3.56 from pot
takakensu: doesn't show hand 
*** SUMMARY ***
Total pot $3.75 | Rake $0.19 
Board [Qs 4d Js]
Seat 1: CocoAlexMix (small blind) folded before Flop
Seat 2: VTcomp (big blind) folded before Flop
Seat 5: 11omsk11 folded before Flop (didn't bet)
Seat 6: hheman folded before Flop (didn't bet)
Seat 7: takakensu collected ($3.56)
Seat 8: MKennyRltr folded on the Flop
Seat 9: siskin vrach (button) folded before Flop (didn't bet)



PokerStars Hand #228681089650:  Hold'em No Limit ($0.25/$0.50 USD) - 2021/07/30 11:24:49 ET
Table 'Aitne III' 9-max Seat #1 is the button
Seat 1: CocoAlexMix ($52.37 in chips) 
Seat 2: VTcomp ($75.25 in chips) 
Seat 3: Lemmi846 ($50 in chips) 
Seat 5: 11omsk11 ($51.25 in chips) 
Seat 6: hheman ($60.68 in chips) 
Seat 7: takakensu ($121.12 in chips) 
Seat 8: MKennyRltr ($38.57 in chips) 
Seat 9: siskin vrach ($50.50 in chips) 
VTcomp: posts small blind $0.25
Lemmi846: posts big blind $0.50
JoePsycho: sits out 
*** HOLE CARDS ***
11omsk11: folds 
hheman: raises $1 to $1.50
takakensu: raises $1.50 to $3
MKennyRltr: folds 
siskin vrach: folds 
CocoAlexMix: folds 
VTcomp: folds 
Lemmi846: folds 
hheman: calls $1.50
*** FLOP *** [Jc 8c 7d]
hheman: checks 
takakensu: bets $6.41
hheman: folds 
Uncalled bet ($6.41) returned to takakensu
takakensu collected $6.41 from pot
takakensu: doesn't show hand 
*** SUMMARY ***
Total pot $6.75 | Rake $0.34 
Board [Jc 8c 7d]
Seat 1: CocoAlexMix (button) folded before Flop (didn't bet)
Seat 2: VTcomp (small blind) folded before Flop
Seat 3: Lemmi846 (big blind) folded before Flop
Seat 5: 11omsk11 folded before Flop (didn't bet)
Seat 6: hheman folded on the Flop
Seat 7: takakensu collected ($6.41)
Seat 8: MKennyRltr folded before Flop (didn't bet)
Seat 9: siskin vrach folded before Flop (didn't bet)



PokerStars Hand #228681099241:  Hold'em No Limit ($0.25/$0.50 USD) - 2021/07/30 11:25:18 ET
Table 'Aitne III' 9-max Seat #2 is the button
Seat 1: CocoAlexMix ($52.37 in chips) 
Seat 2: VTcomp ($75 in chips) 
Seat 3: Lemmi846 ($50 in chips) 
Seat 4: JoePsycho ($50 in chips) 
Seat 5: 11omsk11 ($51.25 in chips) 
Seat 6: hheman ($57.68 in chips) 
Seat 7: takakensu ($124.53 in chips) 
Seat 8: MKennyRltr ($38.57 in chips) 
Seat 9: siskin vrach ($50.50 in chips) 
Lemmi846: posts small blind $0.25
JoePsycho: posts big blind $0.50
*** HOLE CARDS ***
11omsk11: folds 
hheman: folds 
takakensu: folds 
MKennyRltr: calls $0.50
siskin vrach: folds 
CocoAlexMix: folds 
takakensu leaves the table
VTcomp: folds 
Lemmi846: calls $0.25
AlexEliseev7 joins the table at seat #7 
JoePsycho: checks 
*** FLOP *** [9s Jc Qs]
Lemmi846: checks 
JoePsycho: checks 
MKennyRltr: checks 
*** TURN *** [9s Jc Qs] [Jh]
Lemmi846: checks 
JoePsycho: checks 
MKennyRltr: checks 
*** RIVER *** [9s Jc Qs Jh] [Kh]
Lemmi846: checks 
JoePsycho: checks 
MKennyRltr: bets $1
Lemmi846: folds 
JoePsycho: folds 
Uncalled bet ($1) returned to MKennyRltr
MKennyRltr collected $1.42 from pot
MKennyRltr: doesn't show hand 
*** SUMMARY ***
Total pot $1.50 | Rake $0.08 
Board [9s Jc Qs Jh Kh]
Seat 1: CocoAlexMix folded before Flop (didn't bet)
Seat 2: VTcomp (button) folded before Flop (didn't bet)
Seat 3: Lemmi846 (small blind) folded on the River
Seat 4: JoePsycho (big blind) folded on the River
Seat 5: 11omsk11 folded before Flop (didn't bet)
Seat 6: hheman folded before Flop (didn't bet)
Seat 7: takakensu folded before Flop (didn't bet)
Seat 8: MKennyRltr collected ($1.42)
Seat 9: siskin vrach folded before Flop (didn't bet)



PokerStars Hand #228681118879:  Hold'em No Limit ($0.25/$0.50 USD) - 2021/07/30 11:26:16 ET
Table 'Aitne III' 9-max Seat #3 is the button
Seat 1: CocoAlexMix ($52.37 in chips) 
Seat 2: VTcomp ($75 in chips) 
Seat 3: Lemmi846 ($50 in chips) 
Seat 4: JoePsycho ($49.50 in chips) 
Seat 5: 11omsk11 ($51.25 in chips) 
Seat 6: hheman ($57.68 in chips) 
Seat 8: MKennyRltr ($39.49 in chips) 
Seat 9: siskin vrach ($50.50 in chips) 
JoePsycho: posts small blind $0.25
11omsk11: posts big blind $0.50
AlexEliseev7: sits out 
*** HOLE CARDS ***
hheman: folds 
MKennyRltr: calls $0.50
siskin vrach: raises $1.50 to $2
CocoAlexMix: folds 
VTcomp: folds 
Lemmi846: folds 
JoePsycho: folds 
11omsk11: folds 
MKennyRltr: folds 
Uncalled bet ($1.50) returned to siskin vrach
siskin vrach collected $1.75 from pot
*** SUMMARY ***
Total pot $1.75 | Rake $0 
Seat 1: CocoAlexMix folded before Flop (didn't bet)
Seat 2: VTcomp folded before Flop (didn't bet)
Seat 3: Lemmi846 (button) folded before Flop (didn't bet)
Seat 4: JoePsycho (small blind) folded before Flop
Seat 5: 11omsk11 (big blind) folded before Flop
Seat 6: hheman folded before Flop (didn't bet)
Seat 8: MKennyRltr folded before Flop
Seat 9: siskin vrach collected ($1.75)



PokerStars Hand #228681125370:  Hold'em No Limit ($0.25/$0.50 USD) - 2021/07/30 11:26:35 ET
Table 'Aitne III' 9-max Seat #4 is the button
Seat 1: CocoAlexMix ($52.37 in chips) 
Seat 2: VTcomp ($75 in chips) 
Seat 3: Lemmi846 ($50 in chips) 
Seat 4: JoePsycho ($49.25 in chips) 
Seat 5: 11omsk11 ($50.75 in chips) 
Seat 6: hheman ($57.68 in chips) 
Seat 8: MKennyRltr ($38.99 in chips) 
Seat 9: siskin vrach ($51.75 in chips) 
11omsk11: posts small blind $0.25
hheman: posts big blind $0.50
AlexEliseev7: sits out 
*** HOLE CARDS ***
MKennyRltr: folds 
siskin vrach: folds 
CocoAlexMix: raises $1 to $1.50
VTcomp: folds 
Lemmi846: folds 
JoePsycho: folds 
11omsk11: folds 
hheman: folds 
Uncalled bet ($1) returned to CocoAlexMix
CocoAlexMix collected $1.25 from pot
CocoAlexMix: doesn't show hand 
*** SUMMARY ***
Total pot $1.25 | Rake $0 
Seat 1: CocoAlexMix collected ($1.25)
Seat 2: VTcomp folded before Flop (didn't bet)
Seat 3: Lemmi846 folded before Flop (didn't bet)
Seat 4: JoePsycho (button) folded before Flop (didn't bet)
Seat 5: 11omsk11 (small blind) folded before Flop
Seat 6: hheman (big blind) folded before Flop
Seat 8: MKennyRltr folded before Flop (didn't bet)
Seat 9: siskin vrach folded before Flop (didn't bet)



PokerStars Hand #228681130626:  Hold'em No Limit ($0.25/$0.50 USD) - 2021/07/30 11:26:51 ET
Table 'Aitne III' 9-max Seat #5 is the button
Seat 1: CocoAlexMix ($53.12 in chips) 
Seat 2: VTcomp ($75 in chips) 
Seat 3: Lemmi846 ($50 in chips) 
Seat 4: JoePsycho ($49.25 in chips) 
Seat 5: 11omsk11 ($50.50 in chips) 
Seat 6: hheman ($57.18 in chips) 
Seat 7: AlexEliseev7 ($50 in chips) 
Seat 8: MKennyRltr ($38.99 in chips) 
Seat 9: siskin vrach ($51.75 in chips) 
hheman: posts small blind $0.25
AlexEliseev7: posts big blind $0.50
*** HOLE CARDS ***
MKennyRltr: folds 
siskin vrach: folds 
CocoAlexMix: folds 
VTcomp: folds 
Lemmi846: raises $0.50 to $1
JoePsycho: calls $1
11omsk11: folds 
hheman: folds 
CocoAlexMix leaves the table
AlexEliseev7: folds 
*** FLOP *** [6c 2h Th]
Lemmi846: checks 
JoePsycho: checks 
*** TURN *** [6c 2h Th] [Ts]
Lemmi846: checks 
JoePsycho: checks 
*** RIVER *** [6c 2h Th Ts] [Js]
Lemmi846: bets $2
JoePsycho: folds 
Uncalled bet ($2) returned to Lemmi846
Lemmi846 collected $2.57 from pot
Lemmi846: doesn't show hand 
*** SUMMARY ***
Total pot $2.75 | Rake $0.18 
Board [6c 2h Th Ts Js]
Seat 1: CocoAlexMix folded before Flop (didn't bet)
Seat 2: VTcomp folded before Flop (didn't bet)
Seat 3: Lemmi846 collected ($2.57)
Seat 4: JoePsycho folded on the River
Seat 5: 11omsk11 (button) folded before Flop (didn't bet)
Seat 6: hheman (small blind) folded before Flop
Seat 7: AlexEliseev7 (big blind) folded before Flop
Seat 8: MKennyRltr folded before Flop (didn't bet)
Seat 9: siskin vrach folded before Flop (didn't bet)



PokerStars Hand #228681149273:  Hold'em No Limit ($0.25/$0.50 USD) - 2021/07/30 11:27:46 ET
Table 'Aitne III' 9-max Seat #6 is the button
Seat 2: VTcomp ($75 in chips) 
Seat 3: Lemmi846 ($51.57 in chips) 
Seat 4: JoePsycho ($48.25 in chips) 
Seat 5: 11omsk11 ($50.50 in chips) 
Seat 6: hheman ($56.93 in chips) 
Seat 7: AlexEliseev7 ($50 in chips) 
Seat 8: MKennyRltr ($38.99 in chips) 
Seat 9: siskin vrach ($51.75 in chips) 
AlexEliseev7: posts small blind $0.25
MKennyRltr: posts big blind $0.50
*** HOLE CARDS ***
siskin vrach: folds 
VTcomp: folds 
alex_matsuka joins the table at seat #1 
Lemmi846: folds 
JoePsycho: folds 
11omsk11: raises $0.75 to $1.25
hheman: folds 
AlexEliseev7: folds 
MKennyRltr: calls $0.75
*** FLOP *** [7s 9d 2d]
MKennyRltr: checks 
11omsk11: bets $0.78
MKennyRltr: calls $0.78
*** TURN *** [7s 9d 2d] [Qd]
MKennyRltr: checks 
11omsk11: checks 
*** RIVER *** [7s 9d 2d Qd] [2h]
MKennyRltr: checks 
11omsk11: bets $2.25
MKennyRltr: folds 
Uncalled bet ($2.25) returned to 11omsk11
11omsk11 collected $4.09 from pot
11omsk11: doesn't show hand 
*** SUMMARY ***
Total pot $4.31 | Rake $0.22 
Board [7s 9d 2d Qd 2h]
Seat 2: VTcomp folded before Flop (didn't bet)
Seat 3: Lemmi846 folded before Flop (didn't bet)
Seat 4: JoePsycho folded before Flop (didn't bet)
Seat 5: 11omsk11 collected ($4.09)
Seat 6: hheman (button) folded before Flop (didn't bet)
Seat 7: AlexEliseev7 (small blind) folded before Flop
Seat 8: MKennyRltr (big blind) folded on the River
Seat 9: siskin vrach folded before Flop (didn't bet)



PokerStars Hand #228681171362:  Hold'em No Limit ($0.25/$0.50 USD) - 2021/07/30 11:28:52 ET
Table 'Aitne III' 9-max Seat #7 is the button
Seat 2: VTcomp ($75 in chips) 
Seat 3: Lemmi846 ($51.57 in chips) 
Seat 4: JoePsycho ($48.25 in chips) 
Seat 5: 11omsk11 ($52.56 in chips) 
Seat 6: hheman ($56.93 in chips) 
Seat 7: AlexEliseev7 ($50 in chips) 
Seat 8: MKennyRltr ($36.96 in chips) 
Seat 9: siskin vrach ($51.75 in chips) 
MKennyRltr: posts small blind $0.25
siskin vrach: posts big blind $0.50
alex_matsuka: sits out 
*** HOLE CARDS ***
VTcomp: raises $1 to $1.50
Lemmi846: folds 
JoePsycho: folds 
11omsk11: folds 
hheman: folds 
AlexEliseev7: folds 
MKennyRltr: calls $1.25
siskin vrach: folds 
*** FLOP *** [9s Ts 8h]
MKennyRltr: checks 
VTcomp: checks 
*** TURN *** [9s Ts 8h] [Qd]
MKennyRltr: bets $1
VTcomp: calls $1
*** RIVER *** [9s Ts 8h Qd] [Jc]
MKennyRltr: bets $1
VTcomp: calls $1
*** SHOW DOWN ***
MKennyRltr: shows [Js Kd] (a straight, Nine to King)
VTcomp: mucks hand 
MKennyRltr collected $7.12 from pot
*** SUMMARY ***
Total pot $7.50 | Rake $0.38 
Board [9s Ts 8h Qd Jc]
Seat 2: VTcomp mucked
Seat 3: Lemmi846 folded before Flop (didn't bet)
Seat 4: JoePsycho folded before Flop (didn't bet)
Seat 5: 11omsk11 folded before Flop (didn't bet)
Seat 6: hheman folded before Flop (didn't bet)
Seat 7: AlexEliseev7 (button) folded before Flop (didn't bet)
Seat 8: MKennyRltr (small blind) showed [Js Kd] and won ($7.12) with a straight, Nine to King
Seat 9: siskin vrach (big blind) folded before Flop



PokerStars Hand #228681194696:  Hold'em No Limit ($0.25/$0.50 USD) - 2021/07/30 11:30:01 ET
Table 'Aitne III' 9-max Seat #8 is the button
Seat 1: alex_matsuka ($50 in chips) 
Seat 2: VTcomp ($71.50 in chips) 
Seat 3: Lemmi846 ($51.57 in chips) 
Seat 4: JoePsycho ($48.25 in chips) 
Seat 5: 11omsk11 ($52.56 in chips) 
Seat 6: hheman ($56.93 in chips) 
Seat 7: AlexEliseev7 ($50 in chips) 
Seat 8: MKennyRltr ($40.58 in chips) 
Seat 9: siskin vrach ($51.25 in chips) 
siskin vrach: posts small blind $0.25
alex_matsuka: posts big blind $0.50
*** HOLE CARDS ***
VTcomp: folds 
Lemmi846: folds 
JoePsycho: folds 
11omsk11: folds 
hheman: folds 
AlexEliseev7: raises $0.75 to $1.25
MKennyRltr: folds 
siskin vrach: folds 
alex_matsuka: calls $0.75
*** FLOP *** [6d 9s 4d]
alex_matsuka: checks 
AlexEliseev7: bets $1.28
alex_matsuka: calls $1.28
*** TURN *** [6d 9s 4d] [7h]
alex_matsuka: checks 
AlexEliseev7: bets $4.03
alex_matsuka: folds 
Uncalled bet ($4.03) returned to AlexEliseev7
AlexEliseev7 collected $5.04 from pot
AlexEliseev7: doesn't show hand 
*** SUMMARY ***
Total pot $5.31 | Rake $0.27 
Board [6d 9s 4d 7h]
Seat 1: alex_matsuka (big blind) folded on the Turn
Seat 2: VTcomp folded before Flop (didn't bet)
Seat 3: Lemmi846 folded before Flop (didn't bet)
Seat 4: JoePsycho folded before Flop (didn't bet)
Seat 5: 11omsk11 folded before Flop (didn't bet)
Seat 6: hheman folded before Flop (didn't bet)
Seat 7: AlexEliseev7 collected ($5.04)
Seat 8: MKennyRltr (button) folded before Flop (didn't bet)
Seat 9: siskin vrach (small blind) folded before Flop



PokerStars Hand #228681213268:  Hold'em No Limit ($0.25/$0.50 USD) - 2021/07/30 11:30:56 ET
Table 'Aitne III' 9-max Seat #9 is the button
Seat 1: alex_matsuka ($50 in chips) 
Seat 2: VTcomp ($71.50 in chips) 
Seat 3: Lemmi846 ($51.57 in chips) 
Seat 4: JoePsycho ($48.25 in chips) 
Seat 5: 11omsk11 ($52.56 in chips) 
Seat 6: hheman ($56.93 in chips) 
Seat 7: AlexEliseev7 ($52.51 in chips) 
Seat 8: MKennyRltr ($40.58 in chips) 
Seat 9: siskin vrach ($51 in chips) 
alex_matsuka: posts small blind $0.25
VTcomp: posts big blind $0.50
*** HOLE CARDS ***
Lemmi846: folds 
JoePsycho: folds 
11omsk11: raises $1 to $1.50
hheman: folds 
AlexEliseev7: folds 
MKennyRltr: folds 
siskin vrach: folds 
alex_matsuka: folds 
VTcomp: folds 
Uncalled bet ($1) returned to 11omsk11
11omsk11 collected $1.25 from pot
11omsk11: doesn't show hand 
*** SUMMARY ***
Total pot $1.25 | Rake $0 
Seat 1: alex_matsuka (small blind) folded before Flop
Seat 2: VTcomp (big blind) folded before Flop
Seat 3: Lemmi846 folded before Flop (didn't bet)
Seat 4: JoePsycho folded before Flop (didn't bet)
Seat 5: 11omsk11 collected ($1.25)
Seat 6: hheman folded before Flop (didn't bet)
Seat 7: AlexEliseev7 folded before Flop (didn't bet)
Seat 8: MKennyRltr folded before Flop (didn't bet)
Seat 9: siskin vrach (button) folded before Flop (didn't bet)



PokerStars Hand #228679860126:  Hold'em No Limit ($0.25/$0.50 USD) - 2021/07/30 10:20:53 ET
Table 'Aitne III' 9-max Seat #6 is the button
Seat 1: Infinities4 ($50.90 in chips) 
Seat 2: speedbird uk ($47.52 in chips) 
Seat 3: o-chan1986 ($65.47 in chips) 
Seat 4: Thefinster71 ($40.71 in chips) 
Seat 5: artemxxl ($59.14 in chips) 
Seat 6: Zhud19 ($50 in chips) 
Seat 7: takakensu ($62.63 in chips) 
Seat 8: Pete007poker ($65.11 in chips) 
Seat 9: Petrof98 ($34.99 in chips) 
takakensu: posts small blind $0.25
Pete007poker: posts big blind $0.50
*** HOLE CARDS ***
Petrof98: folds 
Infinities4: folds 
speedbird uk: folds 
o-chan1986: raises $0.75 to $1.25
Thefinster71: folds 
artemxxl: folds 
Zhud19: folds 
takakensu: folds 
Pete007poker: calls $0.75
*** FLOP *** [As 7h 2h]
Pete007poker: checks 
o-chan1986: checks 
*** TURN *** [As 7h 2h] [5s]
Pete007poker: bets $0.50
o-chan1986: raises $1.81 to $2.31
Pete007poker: folds 
Uncalled bet ($1.81) returned to o-chan1986
o-chan1986 collected $3.56 from pot
o-chan1986: doesn't show hand 
*** SUMMARY ***
Total pot $3.75 | Rake $0.19 
Board [As 7h 2h 5s]
Seat 1: Infinities4 folded before Flop (didn't bet)
Seat 2: speedbird uk folded before Flop (didn't bet)
Seat 3: o-chan1986 collected ($3.56)
Seat 4: Thefinster71 folded before Flop (didn't bet)
Seat 5: artemxxl folded before Flop (didn't bet)
Seat 6: Zhud19 (button) folded before Flop (didn't bet)
Seat 7: takakensu (small blind) folded before Flop
Seat 8: Pete007poker (big blind) folded on the Turn
Seat 9: Petrof98 folded before Flop (didn't bet)



PokerStars Hand #228679876524:  Hold'em No Limit ($0.25/$0.50 USD) - 2021/07/30 10:21:48 ET
Table 'Aitne III' 9-max Seat #7 is the button
Seat 1: Infinities4 ($50.90 in chips) 
Seat 2: speedbird uk ($47.52 in chips) 
Seat 3: o-chan1986 ($67.28 in chips) 
Seat 4: Thefinster71 ($40.71 in chips) 
Seat 5: artemxxl ($59.14 in chips) 
Seat 6: Zhud19 ($50 in chips) 
Seat 7: takakensu ($62.38 in chips) 
Seat 8: Pete007poker ($63.36 in chips) 
Seat 9: Petrof98 ($34.99 in chips) 
Pete007poker: posts small blind $0.25
Petrof98: posts big blind $0.50
*** HOLE CARDS ***
Infinities4: folds 
speedbird uk: folds 
o-chan1986: folds 
Thefinster71: folds 
artemxxl: folds 
Zhud19: folds 
takakensu: folds 
Pete007poker: folds 
Uncalled bet ($0.25) returned to Petrof98
Petrof98 collected $0.50 from pot
Petrof98: doesn't show hand 
*** SUMMARY ***
Total pot $0.50 | Rake $0 
Seat 1: Infinities4 folded before Flop (didn't bet)
Seat 2: speedbird uk folded before Flop (didn't bet)
Seat 3: o-chan1986 folded before Flop (didn't bet)
Seat 4: Thefinster71 folded before Flop (didn't bet)
Seat 5: artemxxl folded before Flop (didn't bet)
Seat 6: Zhud19 folded before Flop (didn't bet)
Seat 7: takakensu (button) folded before Flop (didn't bet)
Seat 8: Pete007poker (small blind) folded before Flop
Seat 9: Petrof98 (big blind) collected ($0.50)



PokerStars Hand #228679883384:  Hold'em No Limit ($0.25/$0.50 USD) - 2021/07/30 10:22:10 ET
Table 'Aitne III' 9-max Seat #8 is the button
Seat 1: Infinities4 ($50.90 in chips) 
Seat 2: speedbird uk ($47.52 in chips) 
Seat 3: o-chan1986 ($67.28 in chips) 
Seat 4: Thefinster71 ($40.71 in chips) 
Seat 5: artemxxl ($59.14 in chips) 
Seat 6: Zhud19 ($50 in chips) 
Seat 7: takakensu ($62.38 in chips) 
Seat 8: Pete007poker ($63.11 in chips) 
Seat 9: Petrof98 ($35.24 in chips) 
Petrof98: posts small blind $0.25
Infinities4: posts big blind $0.50
*** HOLE CARDS ***
speedbird uk: raises $1 to $1.50
o-chan1986: folds 
Thefinster71: folds 
artemxxl: folds 
Zhud19: folds 
takakensu: folds 
Pete007poker: folds 
Petrof98: raises $3 to $4.50
Infinities4: folds 
speedbird uk: calls $3
*** FLOP *** [Kd 8h 7h]
Petrof98: checks 
speedbird uk: checks 
*** TURN *** [Kd 8h 7h] [Td]
Petrof98: checks 
speedbird uk: checks 
*** RIVER *** [Kd 8h 7h Td] [4c]
Petrof98: bets $3.07
speedbird uk: folds 
Uncalled bet ($3.07) returned to Petrof98
Petrof98 collected $9.02 from pot
Petrof98: doesn't show hand 
*** SUMMARY ***
Total pot $9.50 | Rake $0.48 
Board [Kd 8h 7h Td 4c]
Seat 1: Infinities4 (big blind) folded before Flop
Seat 2: speedbird uk folded on the River
Seat 3: o-chan1986 folded before Flop (didn't bet)
Seat 4: Thefinster71 folded before Flop (didn't bet)
Seat 5: artemxxl folded before Flop (didn't bet)
Seat 6: Zhud19 folded before Flop (didn't bet)
Seat 7: takakensu folded before Flop (didn't bet)
Seat 8: Pete007poker (button) folded before Flop (didn't bet)
Seat 9: Petrof98 (small blind) collected ($9.02)



PokerStars Hand #228679899552:  Hold'em No Limit ($0.25/$0.50 USD) - 2021/07/30 10:23:04 ET
Table 'Aitne III' 9-max Seat #9 is the button
Seat 1: Infinities4 ($50.40 in chips) 
Seat 2: speedbird uk ($43.02 in chips) 
Seat 3: o-chan1986 ($67.28 in chips) 
Seat 4: Thefinster71 ($40.71 in chips) 
Seat 5: artemxxl ($59.14 in chips) 
Seat 6: Zhud19 ($50 in chips) 
Seat 7: takakensu ($62.38 in chips) 
Seat 8: Pete007poker ($63.11 in chips) 
Seat 9: Petrof98 ($39.76 in chips) 
Infinities4: posts small blind $0.25
speedbird uk: posts big blind $0.50
*** HOLE CARDS ***
o-chan1986: folds 
Thefinster71: folds 
artemxxl: folds 
Zhud19: folds 
takakensu: raises $1 to $1.50
Pete007poker: folds 
Petrof98: folds 
Infinities4: folds 
speedbird uk: folds 
Uncalled bet ($1) returned to takakensu
takakensu collected $1.25 from pot
takakensu: doesn't show hand 
*** SUMMARY ***
Total pot $1.25 | Rake $0 
Seat 1: Infinities4 (small blind) folded before Flop
Seat 2: speedbird uk (big blind) folded before Flop
Seat 3: o-chan1986 folded before Flop (didn't bet)
Seat 4: Thefinster71 folded before Flop (didn't bet)
Seat 5: artemxxl folded before Flop (didn't bet)
Seat 6: Zhud19 folded before Flop (didn't bet)
Seat 7: takakensu collected ($1.25)
Seat 8: Pete007poker folded before Flop (didn't bet)
Seat 9: Petrof98 (button) folded before Flop (didn't bet)



PokerStars Hand #228679908901:  Hold'em No Limit ($0.25/$0.50 USD) - 2021/07/30 10:23:34 ET
Table 'Aitne III' 9-max Seat #1 is the button
Seat 1: Infinities4 ($50.15 in chips) 
Seat 2: speedbird uk ($42.52 in chips) 
Seat 3: o-chan1986 ($67.28 in chips) 
Seat 4: Thefinster71 ($40.71 in chips) 
Seat 5: artemxxl ($59.14 in chips) 
Seat 6: Zhud19 ($50 in chips) 
Seat 7: takakensu ($63.13 in chips) 
Seat 8: Pete007poker ($63.11 in chips) 
Seat 9: Petrof98 ($39.76 in chips) 
speedbird uk: posts small blind $0.25
o-chan1986: posts big blind $0.50
*** HOLE CARDS ***
Thefinster71: folds 
artemxxl: folds 
Zhud19: folds 
takakensu: folds 
Pete007poker: folds 
Petrof98: folds 
Infinities4: raises $0.54 to $1.04
speedbird uk: folds 
o-chan1986: folds 
Uncalled bet ($0.54) returned to Infinities4
Infinities4 collected $1.25 from pot
Infinities4: doesn't show hand 
*** SUMMARY ***
Total pot $1.25 | Rake $0 
Seat 1: Infinities4 (button) collected ($1.25)
Seat 2: speedbird uk (small blind) folded before Flop
Seat 3: o-chan1986 (big blind) folded before Flop
Seat 4: Thefinster71 folded before Flop (didn't bet)
Seat 5: artemxxl folded before Flop (didn't bet)
Seat 6: Zhud19 folded before Flop (didn't bet)
Seat 7: takakensu folded before Flop (didn't bet)
Seat 8: Pete007poker folded before Flop (didn't bet)
Seat 9: Petrof98 folded before Flop (didn't bet)



PokerStars Hand #228679913163:  Hold'em No Limit ($0.25/$0.50 USD) - 2021/07/30 10:23:48 ET
Table 'Aitne III' 9-max Seat #2 is the button
Seat 1: Infinities4 ($50.90 in chips) 
Seat 2: speedbird uk ($42.27 in chips) 
Seat 3: o-chan1986 ($66.78 in chips) 
Seat 4: Thefinster71 ($40.71 in chips) 
Seat 5: artemxxl ($59.14 in chips) 
Seat 6: Zhud19 ($50 in chips) 
Seat 7: takakensu ($63.13 in chips) 
Seat 8: Pete007poker ($63.11 in chips) 
Seat 9: Petrof98 ($39.76 in chips) 
o-chan1986: posts small blind $0.25
Thefinster71: posts big blind $0.50
*** HOLE CARDS ***
artemxxl: folds 
Zhud19: raises $1 to $1.50
takakensu: raises $1 to $2.50
Pete007poker: folds 
Petrof98: folds 
Infinities4: folds 
speedbird uk: folds 
o-chan1986: folds 
Thefinster71: raises $3.50 to $6
Zhud19: folds 
takakensu: calls $3.50
*** FLOP *** [Qc 8s 4c]
Thefinster71: bets $13.06
takakensu: calls $13.06
*** TURN *** [Qc 8s 4c] [9h]
Thefinster71: bets $21.65 and is all-in
takakensu: calls $21.65
*** RIVER *** [Qc 8s 4c 9h] [Js]
*** SHOW DOWN ***
Thefinster71: shows [Kc Kh] (a pair of Kings)
takakensu: shows [Td Tc] (a straight, Eight to Queen)
takakensu collected $81.17 from pot
*** SUMMARY ***
Total pot $83.17 | Rake $2 
Board [Qc 8s 4c 9h Js]
Seat 1: Infinities4 folded before Flop (didn't bet)
Seat 2: speedbird uk (button) folded before Flop (didn't bet)
Seat 3: o-chan1986 (small blind) folded before Flop
Seat 4: Thefinster71 (big blind) showed [Kc Kh] and lost with a pair of Kings
Seat 5: artemxxl folded before Flop (didn't bet)
Seat 6: Zhud19 folded before Flop
Seat 7: takakensu showed [Td Tc] and won ($81.17) with a straight, Eight to Queen
Seat 8: Pete007poker folded before Flop (didn't bet)
Seat 9: Petrof98 folded before Flop (didn't bet)



PokerStars Hand #228679935044:  Hold'em No Limit ($0.25/$0.50 USD) - 2021/07/30 10:25:01 ET
Table 'Aitne III' 9-max Seat #3 is the button
Seat 1: Infinities4 ($50.90 in chips) 
Seat 2: speedbird uk ($42.27 in chips) 
Seat 3: o-chan1986 ($66.53 in chips) 
Seat 5: artemxxl ($59.14 in chips) 
Seat 6: Zhud19 ($50 in chips) 
Seat 7: takakensu ($103.59 in chips) 
Seat 8: Pete007poker ($63.11 in chips) 
Seat 9: Petrof98 ($39.76 in chips) 
artemxxl: posts small blind $0.25
Zhud19: posts big blind $0.50
*** HOLE CARDS ***
takakensu: folds 
Pete007poker: folds 
Petrof98: folds 
Infinities4: folds 
speedbird uk: folds 
Thefinster71 leaves the table
o-chan1986: raises $0.75 to $1.25
Stingg joins the table at seat #4 
artemxxl: raises $3.50 to $4.75
Zhud19: folds 
o-chan1986: folds 
Uncalled bet ($3.50) returned to artemxxl
artemxxl collected $3 from pot
*** SUMMARY ***
Total pot $3 | Rake $0 
Seat 1: Infinities4 folded before Flop (didn't bet)
Seat 2: speedbird uk folded before Flop (didn't bet)
Seat 3: o-chan1986 (button) folded before Flop
Seat 5: artemxxl (small blind) collected ($3)
Seat 6: Zhud19 (big blind) folded before Flop
Seat 7: takakensu folded before Flop (didn't bet)
Seat 8: Pete007poker folded before Flop (didn't bet)
Seat 9: Petrof98 folded before Flop (didn't bet)



PokerStars Hand #228679944730:  Hold'em No Limit ($0.25/$0.50 USD) - 2021/07/30 10:25:33 ET
Table 'Aitne III' 9-max Seat #5 is the button
Seat 1: Infinities4 ($50.90 in chips) 
Seat 2: speedbird uk ($42.27 in chips) 
Seat 3: o-chan1986 ($65.28 in chips) 
Seat 5: artemxxl ($60.89 in chips) 
Seat 6: Zhud19 ($50 in chips) 
Seat 7: takakensu ($103.59 in chips) 
Seat 8: Pete007poker ($63.11 in chips) 
Seat 9: Petrof98 ($39.76 in chips) 
Zhud19: posts small blind $0.25
takakensu: posts big blind $0.50
Stingg: sits out 
*** HOLE CARDS ***
Pete007poker: folds 
Petrof98: folds 
Infinities4: folds 
speedbird uk: folds 
o-chan1986: folds 
artemxxl: raises $0.75 to $1.25
Zhud19: folds 
takakensu: calls $0.75
*** FLOP *** [Ts 9d 8d]
takakensu: bets $1.30
artemxxl: folds 
Uncalled bet ($1.30) returned to takakensu
takakensu collected $2.61 from pot
takakensu: doesn't show hand 
*** SUMMARY ***
Total pot $2.75 | Rake $0.14 
Board [Ts 9d 8d]
Seat 1: Infinities4 folded before Flop (didn't bet)
Seat 2: speedbird uk folded before Flop (didn't bet)
Seat 3: o-chan1986 folded before Flop (didn't bet)
Seat 5: artemxxl (button) folded on the Flop
Seat 6: Zhud19 (small blind) folded before Flop
Seat 7: takakensu (big blind) collected ($2.61)
Seat 8: Pete007poker folded before Flop (didn't bet)
Seat 9: Petrof98 folded before Flop (didn't bet)



PokerStars Hand #228679952803:  Hold'em No Limit ($0.25/$0.50 USD) - 2021/07/30 10:25:59 ET
Table 'Aitne III' 9-max Seat #6 is the button
Seat 1: Infinities4 ($50.90 in chips) 
Seat 2: speedbird uk ($42.27 in chips) 
Seat 3: o-chan1986 ($65.28 in chips) 
Seat 5: artemxxl ($59.64 in chips) 
Seat 6: Zhud19 ($50 in chips) 
Seat 7: takakensu ($104.95 in chips) 
Seat 9: Petrof98 ($39.76 in chips) 
takakensu: posts small blind $0.25
Pete007poker: is sitting out 
Pete007poker leaves the table
Petrof98: posts big blind $0.50
Stingg: sits out 
*** HOLE CARDS ***
Infinities4: folds 
speedbird uk: folds 
7lubcak7 joins the table at seat #8 
o-chan1986: folds 
artemxxl: folds 
Zhud19: folds 
takakensu: raises $1 to $1.50
Petrof98: folds 
Uncalled bet ($1) returned to takakensu
takakensu collected $1 from pot
takakensu: doesn't show hand 
*** SUMMARY ***
Total pot $1 | Rake $0 
Seat 1: Infinities4 folded before Flop (didn't bet)
Seat 2: speedbird uk folded before Flop (didn't bet)
Seat 3: o-chan1986 folded before Flop (didn't bet)
Seat 5: artemxxl folded before Flop (didn't bet)
Seat 6: Zhud19 (button) folded before Flop (didn't bet)
Seat 7: takakensu (small blind) collected ($1)
Seat 9: Petrof98 (big blind) folded before Flop



PokerStars Hand #228679959348:  Hold'em No Limit ($0.25/$0.50 USD) - 2021/07/30 10:26:20 ET
Table 'Aitne III' 9-max Seat #7 is the button
Seat 1: Infinities4 ($50.90 in chips) 
Seat 2: speedbird uk ($42.27 in chips) 
Seat 3: o-chan1986 ($65.28 in chips) 
Seat 5: artemxxl ($59.64 in chips) 
Seat 6: Zhud19 ($50 in chips) 
Seat 7: takakensu ($105.45 in chips) 
Seat 9: Petrof98 ($39.26 in chips) 
Petrof98: posts small blind $0.25
Infinities4: posts big blind $0.50
Stingg: sits out 
*** HOLE CARDS ***
speedbird uk: calls $0.50
o-chan1986: folds 
artemxxl: folds 
Zhud19: folds 
takakensu: folds 
Petrof98: folds 
Infinities4: checks 
*** FLOP *** [Ah 9s Kd]
Infinities4: bets $0.64
speedbird uk: calls $0.64
*** TURN *** [Ah 9s Kd] [3d]
Infinities4: checks 
speedbird uk: bets $1.50
Infinities4: folds 
Uncalled bet ($1.50) returned to speedbird uk
speedbird uk collected $2.40 from pot
speedbird uk: doesn't show hand 
*** SUMMARY ***
Total pot $2.53 | Rake $0.13 
Board [Ah 9s Kd 3d]
Seat 1: Infinities4 (big blind) folded on the Turn
Seat 2: speedbird uk collected ($2.40)
Seat 3: o-chan1986 folded before Flop (didn't bet)
Seat 5: artemxxl folded before Flop (didn't bet)
Seat 6: Zhud19 folded before Flop (didn't bet)
Seat 7: takakensu (button) folded before Flop (didn't bet)
Seat 9: Petrof98 (small blind) folded before Flop



PokerStars Hand #228679973840:  Hold'em No Limit ($0.25/$0.50 USD) - 2021/07/30 10:27:08 ET
Table 'Aitne III' 9-max Seat #9 is the button
Seat 1: Infinities4 ($50 in chips) 
Seat 2: speedbird uk ($43.53 in chips) 
Seat 3: o-chan1986 ($65.28 in chips) 
Seat 5: artemxxl ($59.64 in chips) 
Seat 6: Zhud19 ($50 in chips) 
Seat 7: takakensu ($105.45 in chips) 
Seat 8: 7lubcak7 ($28.37 in chips) 
Seat 9: Petrof98 ($39.01 in chips) 
Infinities4: posts small blind $0.25
speedbird uk: posts big blind $0.50
Stingg: sits out 
7lubcak7: posts big blind $0.50
*** HOLE CARDS ***
o-chan1986: raises $0.75 to $1.25
artemxxl: folds 
Zhud19: folds 
takakensu: folds 
7lubcak7: calls $0.75
Petrof98: folds 
Infinities4: folds 
speedbird uk: folds 
*** FLOP *** [5s Jc Tc]
o-chan1986: bets $1.55
7lubcak7: folds 
Uncalled bet ($1.55) returned to o-chan1986
o-chan1986 collected $3.09 from pot
o-chan1986: doesn't show hand 
*** SUMMARY ***
Total pot $3.25 | Rake $0.16 
Board [5s Jc Tc]
Seat 1: Infinities4 (small blind) folded before Flop
Seat 2: speedbird uk (big blind) folded before Flop
Seat 3: o-chan1986 collected ($3.09)
Seat 5: artemxxl folded before Flop (didn't bet)
Seat 6: Zhud19 folded before Flop (didn't bet)
Seat 7: takakensu folded before Flop (didn't bet)
Seat 8: 7lubcak7 folded on the Flop
Seat 9: Petrof98 (button) folded before Flop (didn't bet)



PokerStars Hand #228679982406:  Hold'em No Limit ($0.25/$0.50 USD) - 2021/07/30 10:27:35 ET
Table 'Aitne III' 9-max Seat #1 is the button
Seat 1: Infinities4 ($50 in chips) 
Seat 2: speedbird uk ($43.03 in chips) 
Seat 3: o-chan1986 ($67.12 in chips) 
Seat 5: artemxxl ($59.64 in chips) 
Seat 6: Zhud19 ($50 in chips) 
Seat 7: takakensu ($105.45 in chips) 
Seat 8: 7lubcak7 ($27.12 in chips) 
Seat 9: Petrof98 ($39.01 in chips) 
speedbird uk: posts small blind $0.25
o-chan1986: posts big blind $0.50
Stingg: sits out 
*** HOLE CARDS ***
artemxxl: folds 
Zhud19: folds 
takakensu: folds 
7lubcak7: folds 
Petrof98: folds 
Infinities4: folds 
speedbird uk: folds 
Uncalled bet ($0.25) returned to o-chan1986
o-chan1986 collected $0.50 from pot
o-chan1986: doesn't show hand 
*** SUMMARY ***
Total pot $0.50 | Rake $0 
Seat 1: Infinities4 (button) folded before Flop (didn't bet)
Seat 2: speedbird uk (small blind) folded before Flop
Seat 3: o-chan1986 (big blind) collected ($0.50)
Seat 5: artemxxl folded before Flop (didn't bet)
Seat 6: Zhud19 folded before Flop (didn't bet)
Seat 7: takakensu folded before Flop (didn't bet)
Seat 8: 7lubcak7 folded before Flop (didn't bet)
Seat 9: Petrof98 folded before Flop (didn't bet)



PokerStars Hand #228679986468:  Hold'em No Limit ($0.25/$0.50 USD) - 2021/07/30 10:27:48 ET
Table 'Aitne III' 9-max Seat #2 is the button
Seat 1: Infinities4 ($50 in chips) 
Seat 2: speedbird uk ($42.78 in chips) 
Seat 3: o-chan1986 ($67.37 in chips) 
Seat 4: Stingg ($50 in chips) 
Seat 5: artemxxl ($59.64 in chips) 
Seat 6: Zhud19 ($50 in chips) 
Seat 7: takakensu ($105.45 in chips) 
Seat 8: 7lubcak7 ($27.12 in chips) 
Seat 9: Petrof98 ($39.01 in chips) 
o-chan1986: posts small blind $0.25
Stingg: posts big blind $0.50
*** HOLE CARDS ***
artemxxl: raises $1 to $1.50
Zhud19: folds 
takakensu: folds 
7lubcak7: calls $1.50
Petrof98: calls $1.50
Infinities4: folds 
speedbird uk: folds 
o-chan1986: calls $1.25
Stingg: folds 
*** FLOP *** [6s 8s Tc]
o-chan1986: checks 
artemxxl: bets $4.64
7lubcak7: calls $4.64
Petrof98: folds 
o-chan1986: folds 
*** TURN *** [6s 8s Tc] [Kd]
artemxxl: bets $11.24
7lubcak7: folds 
Uncalled bet ($11.24) returned to artemxxl
artemxxl collected $14.99 from pot
artemxxl: doesn't show hand 
*** SUMMARY ***
Total pot $15.78 | Rake $0.79 
Board [6s 8s Tc Kd]
Seat 1: Infinities4 folded before Flop (didn't bet)
Seat 2: speedbird uk (button) folded before Flop (didn't bet)
Seat 3: o-chan1986 (small blind) folded on the Flop
Seat 4: Stingg (big blind) folded before Flop
Seat 5: artemxxl collected ($14.99)
Seat 6: Zhud19 folded before Flop (didn't bet)
Seat 7: takakensu folded before Flop (didn't bet)
Seat 8: 7lubcak7 folded on the Turn
Seat 9: Petrof98 folded on the Flop



PokerStars Hand #228680004653:  Hold'em No Limit ($0.25/$0.50 USD) - 2021/07/30 10:28:47 ET
Table 'Aitne III' 9-max Seat #3 is the button
Seat 1: Infinities4 ($50 in chips) 
Seat 2: speedbird uk ($42.78 in chips) 
Seat 3: o-chan1986 ($65.87 in chips) 
Seat 4: Stingg ($50 in chips) 
Seat 5: artemxxl ($68.49 in chips) 
Seat 6: Zhud19 ($50 in chips) 
Seat 7: takakensu ($105.45 in chips) 
Seat 8: 7lubcak7 ($20.98 in chips) 
Seat 9: Petrof98 ($37.51 in chips) 
Stingg: posts small blind $0.25
artemxxl: posts big blind $0.50
*** HOLE CARDS ***
Zhud19: folds 
takakensu: folds 
Zhud19 leaves the table
7lubcak7: raises $0.50 to $1
Petrof98: folds 
Infinities4: folds 
speedbird uk: folds 
o-chan1986: folds 
Stingg: folds 
artemxxl: calls $0.50
*** FLOP *** [Qc 6h 7d]
artemxxl: checks 
Dragonclawss joins the table at seat #6 
7lubcak7: checks 
*** TURN *** [Qc 6h 7d] [4d]
artemxxl: bets $1.50
7lubcak7: calls $1.50
*** RIVER *** [Qc 6h 7d 4d] [Js]
artemxxl: bets $3.75
7lubcak7: calls $3.75
*** SHOW DOWN ***
artemxxl: shows [6d Jd] (two pair, Jacks and Sixes)
7lubcak7: mucks hand 
artemxxl collected $12.11 from pot
*** SUMMARY ***
Total pot $12.75 | Rake $0.64 
Board [Qc 6h 7d 4d Js]
Seat 1: Infinities4 folded before Flop (didn't bet)
Seat 2: speedbird uk folded before Flop (didn't bet)
Seat 3: o-chan1986 (button) folded before Flop (didn't bet)
Seat 4: Stingg (small blind) folded before Flop
Seat 5: artemxxl (big blind) showed [6d Jd] and won ($12.11) with two pair, Jacks and Sixes
Seat 6: Zhud19 folded before Flop (didn't bet)
Seat 7: takakensu folded before Flop (didn't bet)
Seat 8: 7lubcak7 mucked
Seat 9: Petrof98 folded before Flop (didn't bet)



PokerStars Hand #228680017874:  Hold'em No Limit ($0.25/$0.50 USD) - 2021/07/30 10:29:30 ET
Table 'Aitne III' 9-max Seat #4 is the button
Seat 1: Infinities4 ($50 in chips) 
Seat 2: speedbird uk ($42.78 in chips) 
Seat 3: o-chan1986 ($65.87 in chips) 
Seat 4: Stingg ($50 in chips) 
Seat 5: artemxxl ($74.35 in chips) 
Seat 7: takakensu ($105.45 in chips) 
Seat 8: 7lubcak7 ($14.73 in chips) 
Seat 9: Petrof98 ($37.51 in chips) 
artemxxl: posts small blind $0.25
takakensu: posts big blind $0.50
*** HOLE CARDS ***
7lubcak7: folds 
Petrof98: raises $0.75 to $1.25
Infinities4: folds 
speedbird uk: folds 
o-chan1986: folds 
Stingg: folds 
artemxxl: folds 
takakensu: calls $0.75
*** FLOP *** [Jh 9d 5d]
takakensu: checks 
Petrof98: bets $0.89
takakensu: calls $0.89
*** TURN *** [Jh 9d 5d] [Qh]
takakensu: checks 
Petrof98: checks 
*** RIVER *** [Jh 9d 5d Qh] [Ks]
Dragonclawss leaves the table
takakensu: bets $2.15
CocoAlexMix joins the table at seat #6 
Petrof98: raises $10.32 to $12.47
takakensu: folds 
Uncalled bet ($10.32) returned to Petrof98
Petrof98 collected $8.39 from pot
Petrof98: doesn't show hand 
*** SUMMARY ***
Total pot $8.83 | Rake $0.44 
Board [Jh 9d 5d Qh Ks]
Seat 1: Infinities4 folded before Flop (didn't bet)
Seat 2: speedbird uk folded before Flop (didn't bet)
Seat 3: o-chan1986 folded before Flop (didn't bet)
Seat 4: Stingg (button) folded before Flop (didn't bet)
Seat 5: artemxxl (small blind) folded before Flop
Seat 7: takakensu (big blind) folded on the River
Seat 8: 7lubcak7 folded before Flop (didn't bet)
Seat 9: Petrof98 collected ($8.39)



PokerStars Hand #228680036691:  Hold'em No Limit ($0.25/$0.50 USD) - 2021/07/30 10:30:32 ET
Table 'Aitne III' 9-max Seat #5 is the button
Seat 1: Infinities4 ($50 in chips) 
Seat 2: speedbird uk ($42.78 in chips) 
Seat 3: o-chan1986 ($65.87 in chips) 
Seat 4: Stingg ($50 in chips) 
Seat 5: artemxxl ($74.10 in chips) 
Seat 7: takakensu ($101.16 in chips) 
Seat 8: 7lubcak7 ($14.73 in chips) 
Seat 9: Petrof98 ($41.61 in chips) 
takakensu: posts small blind $0.25
7lubcak7: posts big blind $0.50
*** HOLE CARDS ***
CocoAlexMix leaves the table
Petrof98: folds 
Infinities4: folds 
speedbird uk: folds 
o-chan1986: folds 
Stingg: folds 
artemxxl: raises $0.75 to $1.25
takakensu: folds 
7lubcak7: calls $0.75
*** FLOP *** [Kd Ts 8d]
alexrus18 joins the table at seat #6 
7lubcak7: checks 
artemxxl: bets $2
7lubcak7: calls $2
*** TURN *** [Kd Ts 8d] [9d]
7lubcak7: checks 
artemxxl: bets $4.81
7lubcak7: folds 
Uncalled bet ($4.81) returned to artemxxl
artemxxl collected $6.41 from pot
*** SUMMARY ***
Total pot $6.75 | Rake $0.34 
Board [Kd Ts 8d 9d]
Seat 1: Infinities4 folded before Flop (didn't bet)
Seat 2: speedbird uk folded before Flop (didn't bet)
Seat 3: o-chan1986 folded before Flop (didn't bet)
Seat 4: Stingg folded before Flop (didn't bet)
Seat 5: artemxxl (button) collected ($6.41)
Seat 7: takakensu (small blind) folded before Flop
Seat 8: 7lubcak7 (big blind) folded on the Turn
Seat 9: Petrof98 folded before Flop (didn't bet)



PokerStars Hand #228680049286:  Hold'em No Limit ($0.25/$0.50 USD) - 2021/07/30 10:31:12 ET
Table 'Aitne III' 9-max Seat #7 is the button
Seat 1: Infinities4 ($50 in chips) 
Seat 2: speedbird uk ($42.78 in chips) 
Seat 3: o-chan1986 ($65.87 in chips) 
Seat 4: Stingg ($50 in chips) 
Seat 5: artemxxl ($77.26 in chips) 
Seat 7: takakensu ($100.91 in chips) 
Seat 8: 7lubcak7 ($11.48 in chips) 
Seat 9: Petrof98 ($41.61 in chips) 
7lubcak7: posts small blind $0.25
Petrof98: posts big blind $0.50
alexrus18: sits out 
*** HOLE CARDS ***
Infinities4: folds 
speedbird uk: raises $1 to $1.50
o-chan1986: folds 
Stingg: folds 
artemxxl: folds 
takakensu: folds 
7lubcak7: folds 
Petrof98: folds 
Uncalled bet ($1) returned to speedbird uk
speedbird uk collected $1.25 from pot
speedbird uk: doesn't show hand 
*** SUMMARY ***
Total pot $1.25 | Rake $0 
Seat 1: Infinities4 folded before Flop (didn't bet)
Seat 2: speedbird uk collected ($1.25)
Seat 3: o-chan1986 folded before Flop (didn't bet)
Seat 4: Stingg folded before Flop (didn't bet)
Seat 5: artemxxl folded before Flop (didn't bet)
Seat 7: takakensu (button) folded before Flop (didn't bet)
Seat 8: 7lubcak7 (small blind) folded before Flop
Seat 9: Petrof98 (big blind) folded before Flop



PokerStars Hand #228680077299:  Hold'em No Limit ($0.25/$0.50 USD) - 2021/07/30 10:32:44 ET
Table 'Aitne III' 9-max Seat #9 is the button
Seat 1: Infinities4 ($50 in chips) 
Seat 2: speedbird uk ($43.53 in chips) 
Seat 3: o-chan1986 ($65.87 in chips) 
Seat 4: Stingg ($50 in chips) 
Seat 5: artemxxl ($77.26 in chips) 
Seat 7: takakensu ($100.91 in chips) 
Seat 8: 7lubcak7 ($11.23 in chips) 
Seat 9: Petrof98 ($43.85 in chips) 
Infinities4: posts small blind $0.25
speedbird uk: posts big blind $0.50
alexrus18: sits out 
*** HOLE CARDS ***
o-chan1986: folds 
Stingg: raises $0.75 to $1.25
artemxxl: folds 
takakensu: calls $1.25
7lubcak7: calls $1.25
Petrof98: folds 
Infinities4: folds 
speedbird uk: raises $2.25 to $3.50
Stingg: calls $2.25
takakensu: calls $2.25
7lubcak7: folds 
*** FLOP *** [Js 8c Jd]
speedbird uk: bets $3
Stingg: folds 
takakensu: calls $3
*** TURN *** [Js 8c Jd] [6s]
speedbird uk: bets $3.50
takakensu: calls $3.50
*** RIVER *** [Js 8c Jd 6s] [Qc]
speedbird uk: bets $3.50
takakensu: calls $3.50
*** SHOW DOWN ***
speedbird uk: shows [Ks Kc] (two pair, Kings and Jacks)
takakensu: mucks hand 
speedbird uk collected $30.40 from pot
*** SUMMARY ***
Total pot $32 | Rake $1.60 
Board [Js 8c Jd 6s Qc]
Seat 1: Infinities4 (small blind) folded before Flop
Seat 2: speedbird uk (big blind) showed [Ks Kc] and won ($30.40) with two pair, Kings and Jacks
Seat 3: o-chan1986 folded before Flop (didn't bet)
Seat 4: Stingg folded on the Flop
Seat 5: artemxxl folded before Flop (didn't bet)
Seat 7: takakensu mucked
Seat 8: 7lubcak7 folded before Flop
Seat 9: Petrof98 (button) folded before Flop (didn't bet)



PokerStars Hand #228680093783:  Hold'em No Limit ($0.25/$0.50 USD) - 2021/07/30 10:33:37 ET
Table 'Aitne III' 9-max Seat #1 is the button
Seat 1: Infinities4 ($50 in chips) 
Seat 2: speedbird uk ($60.43 in chips) 
Seat 3: o-chan1986 ($65.87 in chips) 
Seat 4: Stingg ($50 in chips) 
Seat 5: artemxxl ($77.26 in chips) 
Seat 7: takakensu ($87.41 in chips) 
Seat 8: 7lubcak7 ($9.98 in chips) 
Seat 9: Petrof98 ($43.85 in chips) 
speedbird uk: posts small blind $0.25
o-chan1986: posts big blind $0.50
alexrus18: sits out 
*** HOLE CARDS ***
Stingg: folds 
artemxxl: folds 
takakensu: folds 
7lubcak7: folds 
Petrof98: folds 
Infinities4: folds 
speedbird uk: raises $1 to $1.50
o-chan1986: calls $1
*** FLOP *** [Td Qs 8s]
speedbird uk: checks 
o-chan1986: bets $1.43
speedbird uk: folds 
Uncalled bet ($1.43) returned to o-chan1986
o-chan1986 collected $2.85 from pot
o-chan1986: doesn't show hand 
*** SUMMARY ***
Total pot $3 | Rake $0.15 
Board [Td Qs 8s]
Seat 1: Infinities4 (button) folded before Flop (didn't bet)
Seat 2: speedbird uk (small blind) folded on the Flop
Seat 3: o-chan1986 (big blind) collected ($2.85)
Seat 4: Stingg folded before Flop (didn't bet)
Seat 5: artemxxl folded before Flop (didn't bet)
Seat 7: takakensu folded before Flop (didn't bet)
Seat 8: 7lubcak7 folded before Flop (didn't bet)
Seat 9: Petrof98 folded before Flop (didn't bet)



PokerStars Hand #228680100853:  Hold'em No Limit ($0.25/$0.50 USD) - 2021/07/30 10:34:00 ET
Table 'Aitne III' 9-max Seat #2 is the button
Seat 1: Infinities4 ($50 in chips) 
Seat 2: speedbird uk ($58.93 in chips) 
Seat 3: o-chan1986 ($67.22 in chips) 
Seat 4: Stingg ($50 in chips) 
Seat 5: artemxxl ($77.26 in chips) 
Seat 7: takakensu ($87.41 in chips) 
Seat 8: 7lubcak7 ($9.98 in chips) 
Seat 9: Petrof98 ($43.85 in chips) 
o-chan1986: posts small blind $0.25
Stingg: posts big blind $0.50
alexrus18: sits out 
*** HOLE CARDS ***
artemxxl: folds 
takakensu: folds 
7lubcak7: folds 
Petrof98: folds 
Infinities4: raises $0.74 to $1.24
speedbird uk: folds 
o-chan1986: folds 
Stingg: folds 
Uncalled bet ($0.74) returned to Infinities4
Infinities4 collected $1.25 from pot
Infinities4: doesn't show hand 
*** SUMMARY ***
Total pot $1.25 | Rake $0 
Seat 1: Infinities4 collected ($1.25)
Seat 2: speedbird uk (button) folded before Flop (didn't bet)
Seat 3: o-chan1986 (small blind) folded before Flop
Seat 4: Stingg (big blind) folded before Flop
Seat 5: artemxxl folded before Flop (didn't bet)
Seat 7: takakensu folded before Flop (didn't bet)
Seat 8: 7lubcak7 folded before Flop (didn't bet)
Seat 9: Petrof98 folded before Flop (didn't bet)



PokerStars Hand #228680104835:  Hold'em No Limit ($0.25/$0.50 USD) - 2021/07/30 10:34:13 ET
Table 'Aitne III' 9-max Seat #3 is the button
Seat 1: Infinities4 ($50.75 in chips) 
Seat 2: speedbird uk ($58.93 in chips) 
Seat 3: o-chan1986 ($66.97 in chips) 
Seat 4: Stingg ($50 in chips) 
Seat 5: artemxxl ($77.26 in chips) 
Seat 7: takakensu ($87.41 in chips) 
Seat 8: 7lubcak7 ($9.98 in chips) 
Seat 9: Petrof98 ($43.85 in chips) 
Stingg: posts small blind $0.25
artemxxl: posts big blind $0.50
alexrus18: sits out 
*** HOLE CARDS ***
takakensu: folds 
7lubcak7: folds 
Petrof98: folds 
Infinities4: folds 
speedbird uk: raises $1 to $1.50
o-chan1986: folds 
Stingg: folds 
artemxxl: folds 
Uncalled bet ($1) returned to speedbird uk
speedbird uk collected $1.25 from pot
speedbird uk: doesn't show hand 
*** SUMMARY ***
Total pot $1.25 | Rake $0 
Seat 1: Infinities4 folded before Flop (didn't bet)
Seat 2: speedbird uk collected ($1.25)
Seat 3: o-chan1986 (button) folded before Flop (didn't bet)
Seat 4: Stingg (small blind) folded before Flop
Seat 5: artemxxl (big blind) folded before Flop
Seat 7: takakensu folded before Flop (didn't bet)
Seat 8: 7lubcak7 folded before Flop (didn't bet)
Seat 9: Petrof98 folded before Flop (didn't bet)



PokerStars Hand #228680110447:  Hold'em No Limit ($0.25/$0.50 USD) - 2021/07/30 10:34:31 ET
Table 'Aitne III' 9-max Seat #4 is the button
Seat 1: Infinities4 ($50.75 in chips) 
Seat 2: speedbird uk ($59.68 in chips) 
Seat 3: o-chan1986 ($66.97 in chips) 
Seat 4: Stingg ($50 in chips) 
Seat 5: artemxxl ($76.76 in chips) 
Seat 6: alexrus18 ($50 in chips) 
Seat 7: takakensu ($87.41 in chips) 
Seat 8: 7lubcak7 ($9.98 in chips) 
Seat 9: Petrof98 ($43.85 in chips) 
artemxxl: posts small blind $0.25
alexrus18: posts big blind $0.50
*** HOLE CARDS ***
takakensu: folds 
7lubcak7: raises $0.50 to $1
Petrof98: folds 
Infinities4: folds 
speedbird uk: calls $1
o-chan1986: calls $1
Stingg: folds 
artemxxl: folds 
alexrus18: calls $0.50
*** FLOP *** [4h Jd Kh]
alexrus18: checks 
7lubcak7: checks 
speedbird uk: bets $1.50
o-chan1986: calls $1.50
alexrus18: folds 
7lubcak7: calls $1.50
*** TURN *** [4h Jd Kh] [Qs]
7lubcak7: checks 
speedbird uk: checks 
o-chan1986: bets $4
7lubcak7: raises $3.48 to $7.48 and is all-in
speedbird uk: folds 
o-chan1986: calls $3.48
o-chan1986 has timed out
*** RIVER *** [4h Jd Kh Qs] [4s]
*** SHOW DOWN ***
7lubcak7: shows [Tc 9d] (a straight, Nine to King)
o-chan1986: shows [9h Th] (a straight, Nine to King)
7lubcak7 collected $11.26 from pot
o-chan1986 collected $11.26 from pot
*** SUMMARY ***
Total pot $23.71 | Rake $1.19 
Board [4h Jd Kh Qs 4s]
Seat 1: Infinities4 folded before Flop (didn't bet)
Seat 2: speedbird uk folded on the Turn
Seat 3: o-chan1986 showed [9h Th] and won ($11.26) with a straight, Nine to King
Seat 4: Stingg (button) folded before Flop (didn't bet)
Seat 5: artemxxl (small blind) folded before Flop
Seat 6: alexrus18 (big blind) folded on the Flop
Seat 7: takakensu folded before Flop (didn't bet)
Seat 8: 7lubcak7 showed [Tc 9d] and won ($11.26) with a straight, Nine to King
Seat 9: Petrof98 folded before Flop (didn't bet)



PokerStars Hand #228680133515:  Hold'em No Limit ($0.25/$0.50 USD) - 2021/07/30 10:35:46 ET
Table 'Aitne III' 9-max Seat #5 is the button
Seat 1: Infinities4 ($50.75 in chips) 
Seat 2: speedbird uk ($57.18 in chips) 
Seat 3: o-chan1986 ($68.25 in chips) 
Seat 4: Stingg ($50 in chips) 
Seat 5: artemxxl ($76.51 in chips) 
Seat 6: alexrus18 ($50 in chips) 
Seat 7: takakensu ($87.41 in chips) 
Seat 8: 7lubcak7 ($11.26 in chips) 
Seat 9: Petrof98 ($43.85 in chips) 
alexrus18: posts small blind $0.25
takakensu: posts big blind $0.50
*** HOLE CARDS ***
7lubcak7: folds 
Petrof98: folds 
Infinities4: folds 
speedbird uk: folds 
o-chan1986: folds 
Stingg: folds 
artemxxl: raises $1 to $1.50
alexrus18: folds 
takakensu: calls $1
*** FLOP *** [6c 6h Qd]
takakensu: bets $1.54
artemxxl: calls $1.54
*** TURN *** [6c 6h Qd] [Js]
takakensu: bets $3
artemxxl: calls $3
*** RIVER *** [6c 6h Qd Js] [Kd]
takakensu: bets $5.85
artemxxl: raises $13.90 to $19.75
takakensu: calls $13.90
*** SHOW DOWN ***
artemxxl: shows [Ts Ad] (a straight, Ten to Ace)
takakensu: mucks hand 
artemxxl collected $49.83 from pot
*** SUMMARY ***
Total pot $51.83 | Rake $2 
Board [6c 6h Qd Js Kd]
Seat 1: Infinities4 folded before Flop (didn't bet)
Seat 2: speedbird uk folded before Flop (didn't bet)
Seat 3: o-chan1986 folded before Flop (didn't bet)
Seat 4: Stingg folded before Flop (didn't bet)
Seat 5: artemxxl (button) showed [Ts Ad] and won ($49.83) with a straight, Ten to Ace
Seat 6: alexrus18 (small blind) folded before Flop
Seat 7: takakensu (big blind) mucked
Seat 8: 7lubcak7 folded before Flop (didn't bet)
Seat 9: Petrof98 folded before Flop (didn't bet)



PokerStars Hand #228680146603:  Hold'em No Limit ($0.25/$0.50 USD) - 2021/07/30 10:36:28 ET
Table 'Aitne III' 9-max Seat #6 is the button
Seat 1: Infinities4 ($50.75 in chips) 
Seat 2: speedbird uk ($57.18 in chips) 
Seat 3: o-chan1986 ($68.25 in chips) 
Seat 4: Stingg ($50 in chips) 
Seat 5: artemxxl ($100.55 in chips) 
Seat 6: alexrus18 ($50 in chips) 
Seat 7: takakensu ($61.62 in chips) 
Seat 8: 7lubcak7 ($11.26 in chips) 
Seat 9: Petrof98 ($43.85 in chips) 
takakensu: posts small blind $0.25
7lubcak7: posts big blind $0.50
*** HOLE CARDS ***
Petrof98: folds 
Infinities4: folds 
speedbird uk: folds 
Petrof98 leaves the table
o-chan1986: folds 
Stingg: folds 
artemxxl: raises $1 to $1.50
alexrus18: folds 
takakensu: folds 
dstrola joins the table at seat #9 
7lubcak7: raises $9.76 to $11.26 and is all-in
artemxxl: calls $9.76
*** FLOP *** [Tc Ac 9d]
*** TURN *** [Tc Ac 9d] [2c]
*** RIVER *** [Tc Ac 9d 2c] [4d]
*** SHOW DOWN ***
7lubcak7: shows [As Td] (two pair, Aces and Tens)
artemxxl: shows [Ad Jc] (a pair of Aces)
7lubcak7 collected $21.63 from pot
*** SUMMARY ***
Total pot $22.77 | Rake $1.14 
Board [Tc Ac 9d 2c 4d]
Seat 1: Infinities4 folded before Flop (didn't bet)
Seat 2: speedbird uk folded before Flop (didn't bet)
Seat 3: o-chan1986 folded before Flop (didn't bet)
Seat 4: Stingg folded before Flop (didn't bet)
Seat 5: artemxxl showed [Ad Jc] and lost with a pair of Aces
Seat 6: alexrus18 (button) folded before Flop (didn't bet)
Seat 7: takakensu (small blind) folded before Flop
Seat 8: 7lubcak7 (big blind) showed [As Td] and won ($21.63) with two pair, Aces and Tens
Seat 9: Petrof98 folded before Flop (didn't bet)



PokerStars Hand #228680159690:  Hold'em No Limit ($0.25/$0.50 USD) - 2021/07/30 10:37:09 ET
Table 'Aitne III' 9-max Seat #7 is the button
Seat 1: Infinities4 ($50.75 in chips) 
Seat 2: speedbird uk ($57.18 in chips) 
Seat 3: o-chan1986 ($68.25 in chips) 
Seat 4: Stingg ($50 in chips) 
Seat 5: artemxxl ($89.29 in chips) 
Seat 6: alexrus18 ($50 in chips) 
Seat 7: takakensu ($61.37 in chips) 
Seat 8: 7lubcak7 ($21.63 in chips) 
Seat 9: dstrola ($50 in chips) 
7lubcak7: posts small blind $0.25
dstrola: posts big blind $0.50
*** HOLE CARDS ***
Infinities4: folds 
speedbird uk: folds 
o-chan1986: folds 
Stingg: folds 
artemxxl: raises $0.75 to $1.25
alexrus18: folds 
takakensu: folds 
7lubcak7: calls $1
dstrola: raises $3.75 to $5
artemxxl: folds 
7lubcak7: folds 
Uncalled bet ($3.75) returned to dstrola
dstrola collected $3.75 from pot
*** SUMMARY ***
Total pot $3.75 | Rake $0 
Seat 1: Infinities4 folded before Flop (didn't bet)
Seat 2: speedbird uk folded before Flop (didn't bet)
Seat 3: o-chan1986 folded before Flop (didn't bet)
Seat 4: Stingg folded before Flop (didn't bet)
Seat 5: artemxxl folded before Flop
Seat 6: alexrus18 folded before Flop (didn't bet)
Seat 7: takakensu (button) folded before Flop (didn't bet)
Seat 8: 7lubcak7 (small blind) folded before Flop
Seat 9: dstrola (big blind) collected ($3.75)



PokerStars Hand #228680168560:  Hold'em No Limit ($0.25/$0.50 USD) - 2021/07/30 10:37:37 ET
Table 'Aitne III' 9-max Seat #8 is the button
Seat 1: Infinities4 ($50.75 in chips) 
Seat 2: speedbird uk ($57.18 in chips) 
Seat 3: o-chan1986 ($68.25 in chips) 
Seat 4: Stingg ($50 in chips) 
Seat 5: artemxxl ($88.04 in chips) 
Seat 6: alexrus18 ($50 in chips) 
Seat 7: takakensu ($61.37 in chips) 
Seat 8: 7lubcak7 ($20.38 in chips) 
Seat 9: dstrola ($52.50 in chips) 
dstrola: posts small blind $0.25
Infinities4: posts big blind $0.50
*** HOLE CARDS ***
speedbird uk: folds 
o-chan1986: folds 
Stingg: folds 
artemxxl: raises $1 to $1.50
alexrus18: raises $3 to $4.50
takakensu: folds 
7lubcak7: folds 
dstrola: folds 
Infinities4: folds 
artemxxl: folds 
Uncalled bet ($3) returned to alexrus18
alexrus18 collected $3.75 from pot
alexrus18: doesn't show hand 
*** SUMMARY ***
Total pot $3.75 | Rake $0 
Seat 1: Infinities4 (big blind) folded before Flop
Seat 2: speedbird uk folded before Flop (didn't bet)
Seat 3: o-chan1986 folded before Flop (didn't bet)
Seat 4: Stingg folded before Flop (didn't bet)
Seat 5: artemxxl folded before Flop
Seat 6: alexrus18 collected ($3.75)
Seat 7: takakensu folded before Flop (didn't bet)
Seat 8: 7lubcak7 (button) folded before Flop (didn't bet)
Seat 9: dstrola (small blind) folded before Flop



PokerStars Hand #228680177141:  Hold'em No Limit ($0.25/$0.50 USD) - 2021/07/30 10:38:05 ET
Table 'Aitne III' 9-max Seat #9 is the button
Seat 1: Infinities4 ($50.25 in chips) 
Seat 2: speedbird uk ($57.18 in chips) 
Seat 3: o-chan1986 ($68.25 in chips) 
Seat 4: Stingg ($50 in chips) 
Seat 5: artemxxl ($86.54 in chips) 
Seat 6: alexrus18 ($52.25 in chips) 
Seat 7: takakensu ($61.37 in chips) 
Seat 8: 7lubcak7 ($20.38 in chips) 
Seat 9: dstrola ($52.25 in chips) 
Infinities4: posts small blind $0.25
speedbird uk: posts big blind $0.50
*** HOLE CARDS ***
o-chan1986: folds 
Stingg: folds 
artemxxl: folds 
alexrus18: folds 
takakensu: raises $1 to $1.50
7lubcak7: calls $1.50
dstrola: folds 
Infinities4: folds 
speedbird uk: folds 
*** FLOP *** [9s Ac 5h]
Infinities4 leaves the table
takakensu: bets $1.78
Lisenok110 joins the table at seat #1 
7lubcak7: calls $1.78
*** TURN *** [9s Ac 5h] [Kd]
takakensu: bets $3.47
7lubcak7: calls $3.47
*** RIVER *** [9s Ac 5h Kd] [Ah]
takakensu: bets $13.54
7lubcak7: calls $13.54
*** SHOW DOWN ***
takakensu: shows [As Jh] (three of a kind, Aces)
7lubcak7: mucks hand 
takakensu collected $39.33 from pot
*** SUMMARY ***
Total pot $41.33 | Rake $2 
Board [9s Ac 5h Kd Ah]
Seat 1: Infinities4 (small blind) folded before Flop
Seat 2: speedbird uk (big blind) folded before Flop
Seat 3: o-chan1986 folded before Flop (didn't bet)
Seat 4: Stingg folded before Flop (didn't bet)
Seat 5: artemxxl folded before Flop (didn't bet)
Seat 6: alexrus18 folded before Flop (didn't bet)
Seat 7: takakensu showed [As Jh] and won ($39.33) with three of a kind, Aces
Seat 8: 7lubcak7 mucked
Seat 9: dstrola (button) folded before Flop (didn't bet)



PokerStars Hand #228680189560:  Hold'em No Limit ($0.25/$0.50 USD) - 2021/07/30 10:38:45 ET
Table 'Aitne III' 9-max Seat #2 is the button
Seat 2: speedbird uk ($56.68 in chips) 
Seat 3: o-chan1986 ($68.25 in chips) 
Seat 4: Stingg ($50 in chips) 
Seat 5: artemxxl ($86.54 in chips) 
Seat 6: alexrus18 ($52.25 in chips) 
Seat 7: takakensu ($80.41 in chips) 
Seat 9: dstrola ($52.25 in chips) 
o-chan1986: posts small blind $0.25
Stingg: posts big blind $0.50
Lisenok110: sits out 
*** HOLE CARDS ***
artemxxl: folds 
alexrus18: raises $0.75 to $1.25
takakensu: raises $1.75 to $3
dstrola: folds 
speedbird uk: folds 
o-chan1986: calls $2.75
Stingg: folds 
alexrus18: calls $1.75
*** FLOP *** [5s 6c Th]
o-chan1986: checks 
alexrus18: checks 
takakensu: bets $4.51
o-chan1986: folds 
7lubcak7 leaves the table
alexrus18: folds 
Uncalled bet ($4.51) returned to takakensu
takakensu collected $9.02 from pot
takakensu: doesn't show hand 
*** SUMMARY ***
Total pot $9.50 | Rake $0.48 
Board [5s 6c Th]
Seat 2: speedbird uk (button) folded before Flop (didn't bet)
Seat 3: o-chan1986 (small blind) folded on the Flop
Seat 4: Stingg (big blind) folded before Flop
Seat 5: artemxxl folded before Flop (didn't bet)
Seat 6: alexrus18 folded on the Flop
Seat 7: takakensu collected ($9.02)
Seat 9: dstrola folded before Flop (didn't bet)



PokerStars Hand #228680204742:  Hold'em No Limit ($0.25/$0.50 USD) - 2021/07/30 10:39:33 ET
Table 'Aitne III' 9-max Seat #3 is the button
Seat 2: speedbird uk ($56.68 in chips) 
Seat 3: o-chan1986 ($65.25 in chips) 
Seat 4: Stingg ($50 in chips) 
Seat 5: artemxxl ($86.54 in chips) 
Seat 6: alexrus18 ($50 in chips) 
Seat 7: takakensu ($86.43 in chips) 
Seat 9: dstrola ($52.25 in chips) 
Stingg: posts small blind $0.25
artemxxl: posts big blind $0.50
Lisenok110: sits out 
*** HOLE CARDS ***
alexrus18: raises $0.75 to $1.25
takakensu: folds 
dstrola: folds 
speedbird uk: calls $1.25
o-chan1986: calls $1.25
Stingg: folds 
artemxxl: folds 
*** FLOP *** [Ks 7c 3s]
alexrus18: checks 
7lubcak7 joins the table at seat #8 
speedbird uk: bets $1
o-chan1986: folds 
alexrus18: folds 
Uncalled bet ($1) returned to speedbird uk
speedbird uk collected $4.28 from pot
speedbird uk: doesn't show hand 
*** SUMMARY ***
Total pot $4.50 | Rake $0.22 
Board [Ks 7c 3s]
Seat 2: speedbird uk collected ($4.28)
Seat 3: o-chan1986 (button) folded on the Flop
Seat 4: Stingg (small blind) folded before Flop
Seat 5: artemxxl (big blind) folded before Flop
Seat 6: alexrus18 folded on the Flop
Seat 7: takakensu folded before Flop (didn't bet)
Seat 9: dstrola folded before Flop (didn't bet)



PokerStars Hand #228680214756:  Hold'em No Limit ($0.25/$0.50 USD) - 2021/07/30 10:40:05 ET
Table 'Aitne III' 9-max Seat #4 is the button
Seat 2: speedbird uk ($59.71 in chips) 
Seat 3: o-chan1986 ($64 in chips) 
Seat 4: Stingg ($50 in chips) 
Seat 5: artemxxl ($86.04 in chips) 
Seat 6: alexrus18 ($50 in chips) 
Seat 7: takakensu ($86.43 in chips) 
Seat 9: dstrola ($52.25 in chips) 
artemxxl: posts small blind $0.25
alexrus18: posts big blind $0.50
7lubcak7: sits out 
Lisenok110: sits out 
*** HOLE CARDS ***
takakensu: folds 
dstrola: raises $0.75 to $1.25
speedbird uk: folds 
o-chan1986: folds 
Stingg: folds 
artemxxl: folds 
alexrus18: folds 
Uncalled bet ($0.75) returned to dstrola
dstrola collected $1.25 from pot
*** SUMMARY ***
Total pot $1.25 | Rake $0 
Seat 2: speedbird uk folded before Flop (didn't bet)
Seat 3: o-chan1986 folded before Flop (didn't bet)
Seat 4: Stingg (button) folded before Flop (didn't bet)
Seat 5: artemxxl (small blind) folded before Flop
Seat 6: alexrus18 (big blind) folded before Flop
Seat 7: takakensu folded before Flop (didn't bet)
Seat 9: dstrola collected ($1.25)



PokerStars Hand #228680221121:  Hold'em No Limit ($0.25/$0.50 USD) - 2021/07/30 10:40:26 ET
Table 'Aitne III' 9-max Seat #5 is the button
Seat 2: speedbird uk ($59.71 in chips) 
Seat 3: o-chan1986 ($64 in chips) 
Seat 4: Stingg ($50 in chips) 
Seat 5: artemxxl ($85.79 in chips) 
Seat 6: alexrus18 ($50 in chips) 
Seat 7: takakensu ($86.43 in chips) 
Seat 8: 7lubcak7 ($35.70 in chips) 
Seat 9: dstrola ($53 in chips) 
alexrus18: posts small blind $0.25
takakensu: posts big blind $0.50
7lubcak7: posts big blind $0.50
Lisenok110: sits out 
*** HOLE CARDS ***
7lubcak7: checks 
dstrola: folds 
speedbird uk: raises $1 to $1.50
o-chan1986: folds 
Stingg: folds 
artemxxl: folds 
alexrus18: folds 
takakensu: raises $2 to $3.50
7lubcak7: raises $7.75 to $11.25
speedbird uk: folds 
takakensu: calls $7.75
*** FLOP *** [2c 4s Jc]
takakensu: bets $11.52
7lubcak7: raises $12.93 to $24.45 and is all-in
takakensu: calls $12.93
*** TURN *** [2c 4s Jc] [3s]
*** RIVER *** [2c 4s Jc 3s] [8d]
*** SHOW DOWN ***
takakensu: shows [Qh Qs] (a pair of Queens)
7lubcak7: shows [Qc Kc] (high card King)
takakensu collected $71.15 from pot
*** SUMMARY ***
Total pot $73.15 | Rake $2 
Board [2c 4s Jc 3s 8d]
Seat 2: speedbird uk folded before Flop
Seat 3: o-chan1986 folded before Flop (didn't bet)
Seat 4: Stingg folded before Flop (didn't bet)
Seat 5: artemxxl (button) folded before Flop (didn't bet)
Seat 6: alexrus18 (small blind) folded before Flop
Seat 7: takakensu (big blind) showed [Qh Qs] and won ($71.15) with a pair of Queens
Seat 8: 7lubcak7 showed [Qc Kc] and lost with high card King
Seat 9: dstrola folded before Flop (didn't bet)



PokerStars Hand #228680235346:  Hold'em No Limit ($0.25/$0.50 USD) - 2021/07/30 10:41:12 ET
Table 'Aitne III' 9-max Seat #6 is the button
Seat 2: speedbird uk ($58.21 in chips) 
Seat 3: o-chan1986 ($64 in chips) 
Seat 4: Stingg ($50 in chips) 
Seat 5: artemxxl ($85.79 in chips) 
Seat 6: alexrus18 ($50 in chips) 
Seat 7: takakensu ($121.88 in chips) 
Seat 9: dstrola ($53 in chips) 
takakensu: posts small blind $0.25
dstrola: posts big blind $0.50
Lisenok110: sits out 
*** HOLE CARDS ***
speedbird uk: folds 
o-chan1986: raises $0.75 to $1.25
Stingg: folds 
artemxxl: folds 
alexrus18: folds 
takakensu: folds 
7lubcak7 leaves the table
dstrola: folds 
Uncalled bet ($0.75) returned to o-chan1986
o-chan1986 collected $1.25 from pot
o-chan1986: doesn't show hand 
*** SUMMARY ***
Total pot $1.25 | Rake $0 
Seat 2: speedbird uk folded before Flop (didn't bet)
Seat 3: o-chan1986 collected ($1.25)
Seat 4: Stingg folded before Flop (didn't bet)
Seat 5: artemxxl folded before Flop (didn't bet)
Seat 6: alexrus18 (button) folded before Flop (didn't bet)
Seat 7: takakensu (small blind) folded before Flop
Seat 9: dstrola (big blind) folded before Flop



PokerStars Hand #228680242438:  Hold'em No Limit ($0.25/$0.50 USD) - 2021/07/30 10:41:35 ET
Table 'Aitne III' 9-max Seat #7 is the button
Seat 1: Lisenok110 ($50 in chips) 
Seat 2: speedbird uk ($58.21 in chips) 
Seat 3: o-chan1986 ($64.75 in chips) 
Seat 4: Stingg ($50 in chips) 
Seat 5: artemxxl ($85.79 in chips) 
Seat 6: alexrus18 ($50 in chips) 
Seat 7: takakensu ($121.63 in chips) 
Seat 9: dstrola ($52.50 in chips) 
dstrola: posts small blind $0.25
Lisenok110: posts big blind $0.50
*** HOLE CARDS ***
speedbird uk: folds 
o-chan1986: folds 
Stingg: folds 
artemxxl: folds 
alexrus18: folds 
takakensu: folds 
dstrola: folds 
Uncalled bet ($0.25) returned to Lisenok110
Lisenok110 collected $0.50 from pot
Lisenok110: doesn't show hand 
*** SUMMARY ***
Total pot $0.50 | Rake $0 
Seat 1: Lisenok110 (big blind) collected ($0.50)
Seat 2: speedbird uk folded before Flop (didn't bet)
Seat 3: o-chan1986 folded before Flop (didn't bet)
Seat 4: Stingg folded before Flop (didn't bet)
Seat 5: artemxxl folded before Flop (didn't bet)
Seat 6: alexrus18 folded before Flop (didn't bet)
Seat 7: takakensu (button) folded before Flop (didn't bet)
Seat 9: dstrola (small blind) folded before Flop



PokerStars Hand #228680246219:  Hold'em No Limit ($0.25/$0.50 USD) - 2021/07/30 10:41:47 ET
Table 'Aitne III' 9-max Seat #9 is the button
Seat 1: Lisenok110 ($50.25 in chips) 
Seat 3: o-chan1986 ($64.75 in chips) 
Seat 4: Stingg ($50 in chips) 
Seat 5: artemxxl ($85.79 in chips) 
Seat 6: alexrus18 ($50 in chips) 
Seat 7: takakensu ($121.63 in chips) 
Seat 9: dstrola ($52.25 in chips) 
Lisenok110: posts small blind $0.25
o-chan1986: posts big blind $0.50
*** HOLE CARDS ***
Philheil joins the table at seat #8 
Stingg: folds 
Stingg leaves the table
artemxxl: folds 
alexrus18: raises $0.75 to $1.25
takakensu: raises $1.75 to $3
dstrola: folds 
Lisenok110: folds 
o-chan1986: folds 
alexrus18: calls $1.75
*** FLOP *** [7c 2h 6d]
Dihabet joins the table at seat #4 
alexrus18: checks 
takakensu: bets $3.20
alexrus18: calls $3.20
*** TURN *** [7c 2h 6d] [2s]
alexrus18: checks 
takakensu: bets $6.24
alexrus18: folds 
Uncalled bet ($6.24) returned to takakensu
takakensu collected $12.49 from pot
takakensu: doesn't show hand 
*** SUMMARY ***
Total pot $13.15 | Rake $0.66 
Board [7c 2h 6d 2s]
Seat 1: Lisenok110 (small blind) folded before Flop
Seat 3: o-chan1986 (big blind) folded before Flop
Seat 4: Stingg folded before Flop (didn't bet)
Seat 5: artemxxl folded before Flop (didn't bet)
Seat 6: alexrus18 folded on the Turn
Seat 7: takakensu collected ($12.49)
Seat 9: dstrola (button) folded before Flop (didn't bet)



PokerStars Hand #228680270202:  Hold'em No Limit ($0.25/$0.50 USD) - 2021/07/30 10:43:04 ET
Table 'Aitne III' 9-max Seat #1 is the button
Seat 1: Lisenok110 ($50 in chips) 
Seat 3: o-chan1986 ($64.25 in chips) 
Seat 4: Dihabet ($50 in chips) 
Seat 5: artemxxl ($85.79 in chips) 
Seat 6: alexrus18 ($50 in chips) 
Seat 7: takakensu ($127.92 in chips) 
Seat 8: Philheil ($40 in chips) 
Seat 9: dstrola ($52.25 in chips) 
o-chan1986: posts small blind $0.25
Dihabet: posts big blind $0.50
Philheil: posts big blind $0.50
*** HOLE CARDS ***
artemxxl: folds 
alexrus18: folds 
takakensu: folds 
Philheil: checks 
dstrola: folds 
Lisenok110: folds 
o-chan1986: folds 
Dihabet: checks 
*** FLOP *** [4c As 8h]
Dihabet: checks 
Philheil: checks 
*** TURN *** [4c As 8h] [Td]
Dihabet: checks 
Philheil: checks 
*** RIVER *** [4c As 8h Td] [9c]
Dihabet: checks 
Philheil: checks 
*** SHOW DOWN ***
Dihabet: shows [6d Qs] (high card Ace)
Philheil: shows [4h 6h] (a pair of Fours)
Philheil collected $1.17 from pot
*** SUMMARY ***
Total pot $1.25 | Rake $0.08 
Board [4c As 8h Td 9c]
Seat 1: Lisenok110 (button) folded before Flop (didn't bet)
Seat 3: o-chan1986 (small blind) folded before Flop
Seat 4: Dihabet (big blind) showed [6d Qs] and lost with high card Ace
Seat 5: artemxxl folded before Flop (didn't bet)
Seat 6: alexrus18 folded before Flop (didn't bet)
Seat 7: takakensu folded before Flop (didn't bet)
Seat 8: Philheil showed [4h 6h] and won ($1.17) with a pair of Fours
Seat 9: dstrola folded before Flop (didn't bet)



PokerStars Hand #228680284311:  Hold'em No Limit ($0.25/$0.50 USD) - 2021/07/30 10:43:49 ET
Table 'Aitne III' 9-max Seat #3 is the button
Seat 1: Lisenok110 ($50 in chips) 
Seat 3: o-chan1986 ($64 in chips) 
Seat 4: Dihabet ($50 in chips) 
Seat 5: artemxxl ($85.79 in chips) 
Seat 6: alexrus18 ($50 in chips) 
Seat 7: takakensu ($127.92 in chips) 
Seat 8: Philheil ($40.67 in chips) 
Seat 9: dstrola ($52.25 in chips) 
Dihabet: posts small blind $0.25
artemxxl: posts big blind $0.50
*** HOLE CARDS ***
alexrus18: folds 
takakensu: folds 
Philheil: folds 
dstrola: folds 
Lisenok110: raises $0.75 to $1.25
o-chan1986: raises $2.75 to $4
Dihabet: folds 
artemxxl: folds 
Lisenok110: folds 
Uncalled bet ($2.75) returned to o-chan1986
o-chan1986 collected $3.25 from pot
o-chan1986: doesn't show hand 
*** SUMMARY ***
Total pot $3.25 | Rake $0 
Seat 1: Lisenok110 folded before Flop
Seat 3: o-chan1986 (button) collected ($3.25)
Seat 4: Dihabet (small blind) folded before Flop
Seat 5: artemxxl (big blind) folded before Flop
Seat 6: alexrus18 folded before Flop (didn't bet)
Seat 7: takakensu folded before Flop (didn't bet)
Seat 8: Philheil folded before Flop (didn't bet)
Seat 9: dstrola folded before Flop (didn't bet)



PokerStars Hand #228680292322:  Hold'em No Limit ($0.25/$0.50 USD) - 2021/07/30 10:44:15 ET
Table 'Aitne III' 9-max Seat #4 is the button
Seat 1: Lisenok110 ($50 in chips) 
Seat 3: o-chan1986 ($66 in chips) 
Seat 4: Dihabet ($50 in chips) 
Seat 5: artemxxl ($85.29 in chips) 
Seat 7: takakensu ($127.92 in chips) 
Seat 8: Philheil ($40.67 in chips) 
Seat 9: dstrola ($52.25 in chips) 
artemxxl: posts small blind $0.25
alexrus18: is sitting out 
takakensu: posts big blind $0.50
*** HOLE CARDS ***
Philheil: folds 
dstrola: raises $1 to $1.50
Lisenok110: folds 
o-chan1986: folds 
Dihabet: folds 
artemxxl: folds 
takakensu: raises $2 to $3.50
dstrola: calls $2
*** FLOP *** [Ac 9h 3s]
takakensu: bets $3.44
dstrola: folds 
Uncalled bet ($3.44) returned to takakensu
takakensu collected $6.89 from pot
takakensu: doesn't show hand 
*** SUMMARY ***
Total pot $7.25 | Rake $0.36 
Board [Ac 9h 3s]
Seat 1: Lisenok110 folded before Flop (didn't bet)
Seat 3: o-chan1986 folded before Flop (didn't bet)
Seat 4: Dihabet (button) folded before Flop (didn't bet)
Seat 5: artemxxl (small blind) folded before Flop
Seat 7: takakensu (big blind) collected ($6.89)
Seat 8: Philheil folded before Flop (didn't bet)
Seat 9: dstrola folded on the Flop



PokerStars Hand #228680303133:  Hold'em No Limit ($0.25/$0.50 USD) - 2021/07/30 10:44:50 ET
Table 'Aitne III' 9-max Seat #5 is the button
Seat 1: Lisenok110 ($50 in chips) 
Seat 3: o-chan1986 ($66 in chips) 
Seat 4: Dihabet ($50 in chips) 
Seat 5: artemxxl ($85.04 in chips) 
Seat 7: takakensu ($131.31 in chips) 
Seat 8: Philheil ($40.67 in chips) 
Seat 9: dstrola ($50 in chips) 
takakensu: posts small blind $0.25
Philheil: posts big blind $0.50
*** HOLE CARDS ***
dstrola: folds 
Lisenok110: folds 
o-chan1986: folds 
Dihabet: folds 
artemxxl: raises $1 to $1.50
takakensu: folds 
Philheil: folds 
Uncalled bet ($1) returned to artemxxl
artemxxl collected $1.25 from pot
*** SUMMARY ***
Total pot $1.25 | Rake $0 
Seat 1: Lisenok110 folded before Flop (didn't bet)
Seat 3: o-chan1986 folded before Flop (didn't bet)
Seat 4: Dihabet folded before Flop (didn't bet)
Seat 5: artemxxl (button) collected ($1.25)
Seat 7: takakensu (small blind) folded before Flop
Seat 8: Philheil (big blind) folded before Flop
Seat 9: dstrola folded before Flop (didn't bet)



PokerStars Hand #228680307754:  Hold'em No Limit ($0.25/$0.50 USD) - 2021/07/30 10:45:04 ET
Table 'Aitne III' 9-max Seat #7 is the button
Seat 1: Lisenok110 ($50 in chips) 
Seat 3: o-chan1986 ($66 in chips) 
Seat 4: Dihabet ($50 in chips) 
Seat 5: artemxxl ($85.79 in chips) 
Seat 7: takakensu ($131.06 in chips) 
Seat 8: Philheil ($40.17 in chips) 
Seat 9: dstrola ($50 in chips) 
Philheil: posts small blind $0.25
dstrola: posts big blind $0.50
*** HOLE CARDS ***
Lisenok110: raises $0.75 to $1.25
o-chan1986: folds 
Dihabet: folds 
artemxxl: calls $1.25
takakensu: folds 
Philheil: folds 
dstrola: folds 
*** FLOP *** [Kh 6d 7c]
Lisenok110: bets $0.99
artemxxl: raises $3.01 to $4
Lisenok110: folds 
Uncalled bet ($3.01) returned to artemxxl
artemxxl collected $4.97 from pot
*** SUMMARY ***
Total pot $5.23 | Rake $0.26 
Board [Kh 6d 7c]
Seat 1: Lisenok110 folded on the Flop
Seat 3: o-chan1986 folded before Flop (didn't bet)
Seat 4: Dihabet folded before Flop (didn't bet)
Seat 5: artemxxl collected ($4.97)
Seat 7: takakensu (button) folded before Flop (didn't bet)
Seat 8: Philheil (small blind) folded before Flop
Seat 9: dstrola (big blind) folded before Flop



PokerStars Hand #228680316400:  Hold'em No Limit ($0.25/$0.50 USD) - 2021/07/30 10:45:32 ET
Table 'Aitne III' 9-max Seat #8 is the button
Seat 1: Lisenok110 ($50 in chips) 
Seat 3: o-chan1986 ($66 in chips) 
Seat 4: Dihabet ($50 in chips) 
Seat 5: artemxxl ($88.52 in chips) 
Seat 7: takakensu ($131.06 in chips) 
Seat 8: Philheil ($39.92 in chips) 
Seat 9: dstrola ($50 in chips) 
dstrola: posts small blind $0.25
Lisenok110: posts big blind $0.50
alexrus18: sits out 
*** HOLE CARDS ***
o-chan1986: folds 
Dihabet: folds 
artemxxl: folds 
takakensu: folds 
Philheil: folds 
dstrola: folds 
Uncalled bet ($0.25) returned to Lisenok110
Lisenok110 collected $0.50 from pot
Lisenok110: doesn't show hand 
*** SUMMARY ***
Total pot $0.50 | Rake $0 
Seat 1: Lisenok110 (big blind) collected ($0.50)
Seat 3: o-chan1986 folded before Flop (didn't bet)
Seat 4: Dihabet folded before Flop (didn't bet)
Seat 5: artemxxl folded before Flop (didn't bet)
Seat 7: takakensu folded before Flop (didn't bet)
Seat 8: Philheil (button) folded before Flop (didn't bet)
Seat 9: dstrola (small blind) folded before Flop



PokerStars Hand #228680320388:  Hold'em No Limit ($0.25/$0.50 USD) - 2021/07/30 10:45:45 ET
Table 'Aitne III' 9-max Seat #9 is the button
Seat 1: Lisenok110 ($50.25 in chips) 
Seat 3: o-chan1986 ($66 in chips) 
Seat 4: Dihabet ($50 in chips) 
Seat 5: artemxxl ($88.52 in chips) 
Seat 7: takakensu ($131.06 in chips) 
Seat 8: Philheil ($39.92 in chips) 
Seat 9: dstrola ($50 in chips) 
Lisenok110: posts small blind $0.25
o-chan1986: posts big blind $0.50
alexrus18: sits out 
*** HOLE CARDS ***
Dihabet: folds 
artemxxl: folds 
takakensu: folds 
Philheil: calls $0.50
dstrola: folds 
Lisenok110: folds 
o-chan1986: checks 
*** FLOP *** [As 6c 8c]
o-chan1986: checks 
Philheil: checks 
*** TURN *** [As 6c 8c] [Kc]
o-chan1986: checks 
Philheil: bets $0.50
o-chan1986: calls $0.50
*** RIVER *** [As 6c 8c Kc] [9c]
o-chan1986: checks 
Philheil: bets $2.50
o-chan1986: calls $2.50
*** SHOW DOWN ***
Philheil: shows [Qd Qc] (a flush, King high)
o-chan1986: mucks hand 
Philheil collected $6.80 from pot
*** SUMMARY ***
Total pot $7.25 | Rake $0.45 
Board [As 6c 8c Kc 9c]
Seat 1: Lisenok110 (small blind) folded before Flop
Seat 3: o-chan1986 (big blind) mucked
Seat 4: Dihabet folded before Flop (didn't bet)
Seat 5: artemxxl folded before Flop (didn't bet)
Seat 7: takakensu folded before Flop (didn't bet)
Seat 8: Philheil showed [Qd Qc] and won ($6.80) with a flush, King high
Seat 9: dstrola (button) folded before Flop (didn't bet)



PokerStars Hand #228680335750:  Hold'em No Limit ($0.25/$0.50 USD) - 2021/07/30 10:46:34 ET
Table 'Aitne III' 9-max Seat #1 is the button
Seat 1: Lisenok110 ($50 in chips) 
Seat 3: o-chan1986 ($62.50 in chips) 
Seat 4: Dihabet ($50 in chips) 
Seat 5: artemxxl ($88.52 in chips) 
Seat 7: takakensu ($131.06 in chips) 
Seat 8: Philheil ($43.22 in chips) 
Seat 9: dstrola ($50 in chips) 
o-chan1986: posts small blind $0.25
Dihabet: posts big blind $0.50
alexrus18: sits out 
*** HOLE CARDS ***
artemxxl: folds 
takakensu: folds 
Philheil: calls $0.50
dstrola: folds 
Lisenok110: folds 
o-chan1986: folds 
Dihabet: raises $1.50 to $2
Philheil: folds 
Uncalled bet ($1.50) returned to Dihabet
Dihabet collected $1.25 from pot
Dihabet: doesn't show hand 
*** SUMMARY ***
Total pot $1.25 | Rake $0 
Seat 1: Lisenok110 (button) folded before Flop (didn't bet)
Seat 3: o-chan1986 (small blind) folded before Flop
Seat 4: Dihabet (big blind) collected ($1.25)
Seat 5: artemxxl folded before Flop (didn't bet)
Seat 7: takakensu folded before Flop (didn't bet)
Seat 8: Philheil folded before Flop
Seat 9: dstrola folded before Flop (didn't bet)



PokerStars Hand #228680342120:  Hold'em No Limit ($0.25/$0.50 USD) - 2021/07/30 10:46:55 ET
Table 'Aitne III' 9-max Seat #3 is the button
Seat 1: Lisenok110 ($50 in chips) 
Seat 3: o-chan1986 ($62.25 in chips) 
Seat 4: Dihabet ($50.75 in chips) 
Seat 5: artemxxl ($88.52 in chips) 
Seat 7: takakensu ($131.06 in chips) 
Seat 8: Philheil ($42.72 in chips) 
Seat 9: dstrola ($50 in chips) 
Dihabet: posts small blind $0.25
artemxxl: posts big blind $0.50
alexrus18: sits out 
*** HOLE CARDS ***
takakensu: folds 
Philheil: folds 
dstrola: folds 
Lisenok110: raises $0.75 to $1.25
o-chan1986: folds 
Dihabet: folds 
artemxxl: folds 
Uncalled bet ($0.75) returned to Lisenok110
Lisenok110 collected $1.25 from pot
Lisenok110: doesn't show hand 
*** SUMMARY ***
Total pot $1.25 | Rake $0 
Seat 1: Lisenok110 collected ($1.25)
Seat 3: o-chan1986 (button) folded before Flop (didn't bet)
Seat 4: Dihabet (small blind) folded before Flop
Seat 5: artemxxl (big blind) folded before Flop
Seat 7: takakensu folded before Flop (didn't bet)
Seat 8: Philheil folded before Flop (didn't bet)
Seat 9: dstrola folded before Flop (didn't bet)



PokerStars Hand #228680347194:  Hold'em No Limit ($0.25/$0.50 USD) - 2021/07/30 10:47:11 ET
Table 'Aitne III' 9-max Seat #4 is the button
Seat 1: Lisenok110 ($50.75 in chips) 
Seat 3: o-chan1986 ($62.25 in chips) 
Seat 4: Dihabet ($50.50 in chips) 
Seat 5: artemxxl ($88.02 in chips) 
Seat 6: alexrus18 ($50 in chips) 
Seat 7: takakensu ($131.06 in chips) 
Seat 8: Philheil ($42.72 in chips) 
Seat 9: dstrola ($50 in chips) 
artemxxl: posts small blind $0.25
alexrus18: posts big blind $0.50
*** HOLE CARDS ***
takakensu: folds 
Philheil: folds 
dstrola: folds 
Lisenok110: folds 
o-chan1986: folds 
Dihabet: raises $0.85 to $1.35
artemxxl: folds 
alexrus18: folds 
Uncalled bet ($0.85) returned to Dihabet
Dihabet collected $1.25 from pot
Dihabet: doesn't show hand 
*** SUMMARY ***
Total pot $1.25 | Rake $0 
Seat 1: Lisenok110 folded before Flop (didn't bet)
Seat 3: o-chan1986 folded before Flop (didn't bet)
Seat 4: Dihabet (button) collected ($1.25)
Seat 5: artemxxl (small blind) folded before Flop
Seat 6: alexrus18 (big blind) folded before Flop
Seat 7: takakensu folded before Flop (didn't bet)
Seat 8: Philheil folded before Flop (didn't bet)
Seat 9: dstrola folded before Flop (didn't bet)



PokerStars Hand #228680351727:  Hold'em No Limit ($0.25/$0.50 USD) - 2021/07/30 10:47:26 ET
Table 'Aitne III' 9-max Seat #5 is the button
Seat 1: Lisenok110 ($50.75 in chips) 
Seat 3: o-chan1986 ($62.25 in chips) 
Seat 4: Dihabet ($51.25 in chips) 
Seat 5: artemxxl ($87.77 in chips) 
Seat 6: alexrus18 ($50 in chips) 
Seat 7: takakensu ($131.06 in chips) 
Seat 8: Philheil ($42.72 in chips) 
Seat 9: dstrola ($50 in chips) 
alexrus18: posts small blind $0.25
takakensu: posts big blind $0.50
*** HOLE CARDS ***
Philheil: folds 
dstrola: folds 
Lisenok110: raises $0.75 to $1.25
o-chan1986: folds 
Dihabet: folds 
artemxxl: folds 
alexrus18: folds 
takakensu: folds 
Uncalled bet ($0.75) returned to Lisenok110
Lisenok110 collected $1.25 from pot
Lisenok110: doesn't show hand 
*** SUMMARY ***
Total pot $1.25 | Rake $0 
Seat 1: Lisenok110 collected ($1.25)
Seat 3: o-chan1986 folded before Flop (didn't bet)
Seat 4: Dihabet folded before Flop (didn't bet)
Seat 5: artemxxl (button) folded before Flop (didn't bet)
Seat 6: alexrus18 (small blind) folded before Flop
Seat 7: takakensu (big blind) folded before Flop
Seat 8: Philheil folded before Flop (didn't bet)
Seat 9: dstrola folded before Flop (didn't bet)



PokerStars Hand #228680364095:  Hold'em No Limit ($0.25/$0.50 USD) - 2021/07/30 10:48:05 ET
Table 'Aitne III' 9-max Seat #6 is the button
Seat 1: Lisenok110 ($51.50 in chips) 
Seat 3: o-chan1986 ($62.25 in chips) 
Seat 4: Dihabet ($51.25 in chips) 
Seat 5: artemxxl ($87.77 in chips) 
Seat 6: alexrus18 ($50 in chips) 
Seat 7: takakensu ($130.56 in chips) 
Seat 8: Philheil ($42.72 in chips) 
Seat 9: dstrola ($50 in chips) 
takakensu: posts small blind $0.25
Philheil: posts big blind $0.50
*** HOLE CARDS ***
dstrola: raises $0.75 to $1.25
Lisenok110: folds 
o-chan1986: folds 
Dihabet: folds 
artemxxl: folds 
alexrus18: folds 
takakensu: calls $1
Philheil: folds 
*** FLOP *** [Js 3d 3c]
takakensu: bets $1.42
dstrola: folds 
Uncalled bet ($1.42) returned to takakensu
takakensu collected $2.85 from pot
takakensu: doesn't show hand 
*** SUMMARY ***
Total pot $3 | Rake $0.15 
Board [Js 3d 3c]
Seat 1: Lisenok110 folded before Flop (didn't bet)
Seat 3: o-chan1986 folded before Flop (didn't bet)
Seat 4: Dihabet folded before Flop (didn't bet)
Seat 5: artemxxl folded before Flop (didn't bet)
Seat 6: alexrus18 (button) folded before Flop (didn't bet)
Seat 7: takakensu (small blind) collected ($2.85)
Seat 8: Philheil (big blind) folded before Flop
Seat 9: dstrola folded on the Flop



PokerStars Hand #228680371008:  Hold'em No Limit ($0.25/$0.50 USD) - 2021/07/30 10:48:28 ET
Table 'Aitne III' 9-max Seat #7 is the button
Seat 1: Lisenok110 ($51.50 in chips) 
Seat 3: o-chan1986 ($62.25 in chips) 
Seat 4: Dihabet ($51.25 in chips) 
Seat 5: artemxxl ($87.77 in chips) 
Seat 6: alexrus18 ($50 in chips) 
Seat 7: takakensu ($132.16 in chips) 
Seat 8: Philheil ($42.22 in chips) 
Seat 9: dstrola ($50 in chips) 
Philheil: posts small blind $0.25
dstrola: posts big blind $0.50
*** HOLE CARDS ***
Lisenok110: folds 
o-chan1986: folds 
Dihabet: raises $0.85 to $1.35
artemxxl: calls $1.35
alexrus18: folds 
takakensu: folds 
Philheil: calls $1.10
dstrola: folds 
*** FLOP *** [Tc Kc 3s]
Philheil: checks 
Dihabet: bets $2.16
artemxxl: folds 
Philheil: calls $2.16
*** TURN *** [Tc Kc 3s] [2s]
Philheil: checks 
Dihabet: checks 
*** RIVER *** [Tc Kc 3s 2s] [5s]
Philheil: bets $2.50
Dihabet: folds 
Uncalled bet ($2.50) returned to Philheil
Philheil collected $8.32 from pot
Philheil: doesn't show hand 
*** SUMMARY ***
Total pot $8.87 | Rake $0.55 
Board [Tc Kc 3s 2s 5s]
Seat 1: Lisenok110 folded before Flop (didn't bet)
Seat 3: o-chan1986 folded before Flop (didn't bet)
Seat 4: Dihabet folded on the River
Seat 5: artemxxl folded on the Flop
Seat 6: alexrus18 folded before Flop (didn't bet)
Seat 7: takakensu (button) folded before Flop (didn't bet)
Seat 8: Philheil (small blind) collected ($8.32)
Seat 9: dstrola (big blind) folded before Flop



PokerStars Hand #228680386818:  Hold'em No Limit ($0.25/$0.50 USD) - 2021/07/30 10:49:19 ET
Table 'Aitne III' 9-max Seat #8 is the button
Seat 1: Lisenok110 ($51.50 in chips) 
Seat 3: o-chan1986 ($62.25 in chips) 
Seat 4: Dihabet ($50 in chips) 
Seat 5: artemxxl ($86.42 in chips) 
Seat 6: alexrus18 ($50 in chips) 
Seat 7: takakensu ($132.16 in chips) 
Seat 8: Philheil ($47.03 in chips) 
Seat 9: dstrola ($50 in chips) 
dstrola: posts small blind $0.25
Lisenok110: posts big blind $0.50
*** HOLE CARDS ***
o-chan1986: raises $0.75 to $1.25
Dihabet: folds 
artemxxl: raises $3.50 to $4.75
alexrus18: folds 
takakensu: folds 
Philheil: folds 
dstrola: folds 
Lisenok110: folds 
o-chan1986: calls $3.50
*** FLOP *** [Qc 5d 5h]
o-chan1986: checks 
artemxxl: checks 
*** TURN *** [Qc 5d 5h] [3d]
o-chan1986: bets $4.87
artemxxl: calls $4.87
*** RIVER *** [Qc 5d 5h 3d] [7d]
o-chan1986: bets $9.50
artemxxl: folds 
Uncalled bet ($9.50) returned to o-chan1986
o-chan1986 collected $18.99 from pot
o-chan1986: doesn't show hand 
*** SUMMARY ***
Total pot $19.99 | Rake $1 
Board [Qc 5d 5h 3d 7d]
Seat 1: Lisenok110 (big blind) folded before Flop
Seat 3: o-chan1986 collected ($18.99)
Seat 4: Dihabet folded before Flop (didn't bet)
Seat 5: artemxxl folded on the River
Seat 6: alexrus18 folded before Flop (didn't bet)
Seat 7: takakensu folded before Flop (didn't bet)
Seat 8: Philheil (button) folded before Flop (didn't bet)
Seat 9: dstrola (small blind) folded before Flop



PokerStars Hand #228680405644:  Hold'em No Limit ($0.25/$0.50 USD) - 2021/07/30 10:50:13 ET
Table 'Aitne III' 9-max Seat #9 is the button
Seat 1: Lisenok110 ($51 in chips) 
Seat 3: o-chan1986 ($71.62 in chips) 
Seat 4: Dihabet ($50 in chips) 
Seat 5: artemxxl ($76.80 in chips) 
Seat 6: alexrus18 ($50 in chips) 
Seat 7: takakensu ($132.16 in chips) 
Seat 8: Philheil ($47.03 in chips) 
Seat 9: dstrola ($50 in chips) 
Lisenok110: posts small blind $0.25
o-chan1986: posts big blind $0.50
*** HOLE CARDS ***
Dihabet: folds 
artemxxl: folds 
alexrus18: folds 
takakensu: raises $1 to $1.50
Philheil: folds 
dstrola: folds 
Lisenok110: folds 
o-chan1986: folds 
Uncalled bet ($1) returned to takakensu
takakensu collected $1.25 from pot
takakensu: doesn't show hand 
*** SUMMARY ***
Total pot $1.25 | Rake $0 
Seat 1: Lisenok110 (small blind) folded before Flop
Seat 3: o-chan1986 (big blind) folded before Flop
Seat 4: Dihabet folded before Flop (didn't bet)
Seat 5: artemxxl folded before Flop (didn't bet)
Seat 6: alexrus18 folded before Flop (didn't bet)
Seat 7: takakensu collected ($1.25)
Seat 8: Philheil folded before Flop (didn't bet)
Seat 9: dstrola (button) folded before Flop (didn't bet)



PokerStars Hand #228680411189:  Hold'em No Limit ($0.25/$0.50 USD) - 2021/07/30 10:50:31 ET
Table 'Aitne III' 9-max Seat #1 is the button
Seat 1: Lisenok110 ($50.75 in chips) 
Seat 3: o-chan1986 ($71.12 in chips) 
Seat 4: Dihabet ($50 in chips) 
Seat 5: artemxxl ($76.80 in chips) 
Seat 6: alexrus18 ($50 in chips) 
Seat 7: takakensu ($132.91 in chips) 
Seat 8: Philheil ($47.03 in chips) 
Seat 9: dstrola ($50 in chips) 
o-chan1986: posts small blind $0.25
Dihabet: posts big blind $0.50
*** HOLE CARDS ***
artemxxl: folds 
alexrus18: folds 
takakensu: folds 
Philheil: folds 
dstrola: folds 
Lisenok110: folds 
o-chan1986: folds 
Uncalled bet ($0.25) returned to Dihabet
Dihabet collected $0.50 from pot
Dihabet: doesn't show hand 
*** SUMMARY ***
Total pot $0.50 | Rake $0 
Seat 1: Lisenok110 (button) folded before Flop (didn't bet)
Seat 3: o-chan1986 (small blind) folded before Flop
Seat 4: Dihabet (big blind) collected ($0.50)
Seat 5: artemxxl folded before Flop (didn't bet)
Seat 6: alexrus18 folded before Flop (didn't bet)
Seat 7: takakensu folded before Flop (didn't bet)
Seat 8: Philheil folded before Flop (didn't bet)
Seat 9: dstrola folded before Flop (didn't bet)



PokerStars Hand #228680414863:  Hold'em No Limit ($0.25/$0.50 USD) - 2021/07/30 10:50:42 ET
Table 'Aitne III' 9-max Seat #3 is the button
Seat 1: Lisenok110 ($50.75 in chips) 
Seat 3: o-chan1986 ($70.87 in chips) 
Seat 4: Dihabet ($50.25 in chips) 
Seat 5: artemxxl ($76.80 in chips) 
Seat 6: alexrus18 ($50 in chips) 
Seat 7: takakensu ($132.91 in chips) 
Seat 8: Philheil ($47.03 in chips) 
Seat 9: dstrola ($50 in chips) 
Dihabet: posts small blind $0.25
artemxxl: posts big blind $0.50
*** HOLE CARDS ***
alexrus18: folds 
takakensu: folds 
Philheil: folds 
dstrola: folds 
Lisenok110: folds 
o-chan1986: raises $0.75 to $1.25
Dihabet: folds 
artemxxl: folds 
Uncalled bet ($0.75) returned to o-chan1986
o-chan1986 collected $1.25 from pot
o-chan1986: doesn't show hand 
*** SUMMARY ***
Total pot $1.25 | Rake $0 
Seat 1: Lisenok110 folded before Flop (didn't bet)
Seat 3: o-chan1986 (button) collected ($1.25)
Seat 4: Dihabet (small blind) folded before Flop
Seat 5: artemxxl (big blind) folded before Flop
Seat 6: alexrus18 folded before Flop (didn't bet)
Seat 7: takakensu folded before Flop (didn't bet)
Seat 8: Philheil folded before Flop (didn't bet)
Seat 9: dstrola folded before Flop (didn't bet)



PokerStars Hand #228680419230:  Hold'em No Limit ($0.25/$0.50 USD) - 2021/07/30 10:50:56 ET
Table 'Aitne III' 9-max Seat #4 is the button
Seat 1: Lisenok110 ($50.75 in chips) 
Seat 3: o-chan1986 ($71.62 in chips) 
Seat 4: Dihabet ($50 in chips) 
Seat 5: artemxxl ($76.30 in chips) 
Seat 6: alexrus18 ($50 in chips) 
Seat 7: takakensu ($132.91 in chips) 
Seat 8: Philheil ($47.03 in chips) 
Seat 9: dstrola ($50 in chips) 
artemxxl: posts small blind $0.25
alexrus18: posts big blind $0.50
*** HOLE CARDS ***
takakensu: folds 
Philheil: folds 
dstrola: folds 
Lisenok110: folds 
o-chan1986: folds 
Dihabet: raises $0.85 to $1.35
artemxxl: folds 
alexrus18: folds 
Uncalled bet ($0.85) returned to Dihabet
Dihabet collected $1.25 from pot
Dihabet: doesn't show hand 
*** SUMMARY ***
Total pot $1.25 | Rake $0 
Seat 1: Lisenok110 folded before Flop (didn't bet)
Seat 3: o-chan1986 folded before Flop (didn't bet)
Seat 4: Dihabet (button) collected ($1.25)
Seat 5: artemxxl (small blind) folded before Flop
Seat 6: alexrus18 (big blind) folded before Flop
Seat 7: takakensu folded before Flop (didn't bet)
Seat 8: Philheil folded before Flop (didn't bet)
Seat 9: dstrola folded before Flop (didn't bet)



PokerStars Hand #228680425932:  Hold'em No Limit ($0.25/$0.50 USD) - 2021/07/30 10:51:18 ET
Table 'Aitne III' 9-max Seat #5 is the button
Seat 1: Lisenok110 ($50.75 in chips) 
Seat 3: o-chan1986 ($71.62 in chips) 
Seat 4: Dihabet ($50.75 in chips) 
Seat 5: artemxxl ($76.05 in chips) 
Seat 6: alexrus18 ($50 in chips) 
Seat 7: takakensu ($132.91 in chips) 
Seat 8: Philheil ($47.03 in chips) 
Seat 9: dstrola ($50 in chips) 
alexrus18: posts small blind $0.25
takakensu: posts big blind $0.50
*** HOLE CARDS ***
Philheil: folds 
dstrola: folds 
Lisenok110: folds 
Lisenok110 leaves the table
o-chan1986: folds 
Dihabet: folds 
artemxxl: raises $1 to $1.50
alexrus18: folds 
takakensu: folds 
Uncalled bet ($1) returned to artemxxl
artemxxl collected $1.25 from pot
*** SUMMARY ***
Total pot $1.25 | Rake $0 
Seat 1: Lisenok110 folded before Flop (didn't bet)
Seat 3: o-chan1986 folded before Flop (didn't bet)
Seat 4: Dihabet folded before Flop (didn't bet)
Seat 5: artemxxl (button) collected ($1.25)
Seat 6: alexrus18 (small blind) folded before Flop
Seat 7: takakensu (big blind) folded before Flop
Seat 8: Philheil folded before Flop (didn't bet)
Seat 9: dstrola folded before Flop (didn't bet)



PokerStars Hand #228680431245:  Hold'em No Limit ($0.25/$0.50 USD) - 2021/07/30 10:51:35 ET
Table 'Aitne III' 9-max Seat #6 is the button
Seat 3: o-chan1986 ($71.62 in chips) 
Seat 4: Dihabet ($50.75 in chips) 
Seat 5: artemxxl ($76.80 in chips) 
Seat 6: alexrus18 ($50 in chips) 
Seat 7: takakensu ($132.41 in chips) 
Seat 8: Philheil ($47.03 in chips) 
Seat 9: dstrola ($50 in chips) 
takakensu: posts small blind $0.25
Philheil: posts big blind $0.50
*** HOLE CARDS ***
dstrola: folds 
o-chan1986: folds 
Dihabet: folds 
artemxxl: folds 
6l4ck joins the table at seat #1 
alexrus18: folds 
takakensu: raises $1 to $1.50
Philheil: calls $1
*** FLOP *** [Ac Jd 7s]
takakensu: bets $1.42
Philheil: calls $1.42
*** TURN *** [Ac Jd 7s] [8c]
takakensu: bets $2.77
Philheil: calls $2.77
*** RIVER *** [Ac Jd 7s 8c] [8h]
takakensu: bets $5.40
Philheil: raises $5.40 to $10.80
takakensu: calls $5.40
*** SHOW DOWN ***
Philheil: shows [9d 8s] (three of a kind, Eights)
takakensu: mucks hand 
Philheil collected $30.92 from pot
*** SUMMARY ***
Total pot $32.98 | Rake $2.06 
Board [Ac Jd 7s 8c 8h]
Seat 3: o-chan1986 folded before Flop (didn't bet)
Seat 4: Dihabet folded before Flop (didn't bet)
Seat 5: artemxxl folded before Flop (didn't bet)
Seat 6: alexrus18 (button) folded before Flop (didn't bet)
Seat 7: takakensu (small blind) mucked
Seat 8: Philheil (big blind) showed [9d 8s] and won ($30.92) with three of a kind, Eights
Seat 9: dstrola folded before Flop (didn't bet)



PokerStars Hand #228680444139:  Hold'em No Limit ($0.25/$0.50 USD) - 2021/07/30 10:52:16 ET
Table 'Aitne III' 9-max Seat #7 is the button
Seat 3: o-chan1986 ($71.62 in chips) 
Seat 4: Dihabet ($50.75 in chips) 
Seat 5: artemxxl ($76.80 in chips) 
Seat 6: alexrus18 ($50 in chips) 
Seat 7: takakensu ($115.92 in chips) 
Seat 8: Philheil ($61.46 in chips) 
Seat 9: dstrola ($50 in chips) 
Philheil: posts small blind $0.25
dstrola: posts big blind $0.50
6l4ck: sits out 
*** HOLE CARDS ***
o-chan1986: folds 
Dihabet: folds 
artemxxl: folds 
alexrus18: folds 
takakensu: folds 
Philheil: calls $0.25
dstrola: checks 
*** FLOP *** [Qc Ts Qh]
Philheil: checks 
dstrola: checks 
*** TURN *** [Qc Ts Qh] [5s]
Philheil: checks 
dstrola: checks 
*** RIVER *** [Qc Ts Qh 5s] [Th]
Philheil: bets $0.50
dstrola: folds 
Uncalled bet ($0.50) returned to Philheil
Philheil collected $0.94 from pot
Philheil: doesn't show hand 
*** SUMMARY ***
Total pot $1 | Rake $0.06 
Board [Qc Ts Qh 5s Th]
Seat 3: o-chan1986 folded before Flop (didn't bet)
Seat 4: Dihabet folded before Flop (didn't bet)
Seat 5: artemxxl folded before Flop (didn't bet)
Seat 6: alexrus18 folded before Flop (didn't bet)
Seat 7: takakensu (button) folded before Flop (didn't bet)
Seat 8: Philheil (small blind) collected ($0.94)
Seat 9: dstrola (big blind) folded on the River



PokerStars Hand #228680458185:  Hold'em No Limit ($0.25/$0.50 USD) - 2021/07/30 10:53:01 ET
Table 'Aitne III' 9-max Seat #8 is the button
Seat 1: 6l4ck ($50 in chips) 
Seat 3: o-chan1986 ($71.62 in chips) 
Seat 4: Dihabet ($50.75 in chips) 
Seat 5: artemxxl ($76.80 in chips) 
Seat 6: alexrus18 ($50 in chips) 
Seat 7: takakensu ($115.92 in chips) 
Seat 8: Philheil ($61.90 in chips) 
Seat 9: dstrola ($50 in chips) 
dstrola: posts small blind $0.25
6l4ck: posts big blind $0.50
*** HOLE CARDS ***
o-chan1986: folds 
Dihabet: raises $0.85 to $1.35
artemxxl: folds 
alexrus18: folds 
takakensu: folds 
Philheil: folds 
dstrola: folds 
6l4ck: folds 
Uncalled bet ($0.85) returned to Dihabet
Dihabet collected $1.25 from pot
Dihabet: doesn't show hand 
*** SUMMARY ***
Total pot $1.25 | Rake $0 
Seat 1: 6l4ck (big blind) folded before Flop
Seat 3: o-chan1986 folded before Flop (didn't bet)
Seat 4: Dihabet collected ($1.25)
Seat 5: artemxxl folded before Flop (didn't bet)
Seat 6: alexrus18 folded before Flop (didn't bet)
Seat 7: takakensu folded before Flop (didn't bet)
Seat 8: Philheil (button) folded before Flop (didn't bet)
Seat 9: dstrola (small blind) folded before Flop



PokerStars Hand #228680463778:  Hold'em No Limit ($0.25/$0.50 USD) - 2021/07/30 10:53:19 ET
Table 'Aitne III' 9-max Seat #9 is the button
Seat 1: 6l4ck ($50 in chips) 
Seat 3: o-chan1986 ($71.62 in chips) 
Seat 4: Dihabet ($51.50 in chips) 
Seat 5: artemxxl ($76.80 in chips) 
Seat 6: alexrus18 ($50 in chips) 
Seat 7: takakensu ($115.92 in chips) 
Seat 8: Philheil ($61.90 in chips) 
Seat 9: dstrola ($50 in chips) 
6l4ck: posts small blind $0.25
o-chan1986: posts big blind $0.50
*** HOLE CARDS ***
Dihabet: raises $0.85 to $1.35
artemxxl: folds 
alexrus18: folds 
takakensu: folds 
Philheil: folds 
dstrola: folds 
6l4ck: folds 
o-chan1986: calls $0.85
*** FLOP *** [Ac 8c 6c]
o-chan1986: checks 
Dihabet: checks 
*** TURN *** [Ac 8c 6c] [Th]
o-chan1986: bets $1.40
Dihabet: calls $1.40
*** RIVER *** [Ac 8c 6c Th] [6h]
o-chan1986: checks 
Dihabet: checks 
*** SHOW DOWN ***
o-chan1986: shows [3s 3d] (two pair, Sixes and Threes)
Dihabet: shows [Js Jh] (two pair, Jacks and Sixes)
Dihabet collected $5.46 from pot
speedbird uk was removed from the table for failing to post
speedbird uk leaves the table
*** SUMMARY ***
Total pot $5.75 | Rake $0.29 
Board [Ac 8c 6c Th 6h]
Seat 1: 6l4ck (small blind) folded before Flop
Seat 3: o-chan1986 (big blind) showed [3s 3d] and lost with two pair, Sixes and Threes
Seat 4: Dihabet showed [Js Jh] and won ($5.46) with two pair, Jacks and Sixes
Seat 5: artemxxl folded before Flop (didn't bet)
Seat 6: alexrus18 folded before Flop (didn't bet)
Seat 7: takakensu folded before Flop (didn't bet)
Seat 8: Philheil folded before Flop (didn't bet)
Seat 9: dstrola (button) folded before Flop (didn't bet)



PokerStars Hand #228680474351:  Hold'em No Limit ($0.25/$0.50 USD) - 2021/07/30 10:53:52 ET
Table 'Aitne III' 9-max Seat #1 is the button
Seat 1: 6l4ck ($50 in chips) 
Seat 3: o-chan1986 ($68.87 in chips) 
Seat 4: Dihabet ($54.21 in chips) 
Seat 5: artemxxl ($76.80 in chips) 
Seat 6: alexrus18 ($50 in chips) 
Seat 7: takakensu ($115.92 in chips) 
Seat 8: Philheil ($61.90 in chips) 
Seat 9: dstrola ($50 in chips) 
o-chan1986: posts small blind $0.25
Dihabet: posts big blind $0.50
*** HOLE CARDS ***
artemxxl: folds 
alexrus18: folds 
takakensu: raises $1.50 to $2
Philheil: folds 
dstrola: folds 
6l4ck: folds 
rebol2 joins the table at seat #2 
o-chan1986: calls $1.75
Dihabet: folds 
*** FLOP *** [Qc Qs 3s]
o-chan1986: checks 
takakensu: bets $2.14
o-chan1986: calls $2.14
*** TURN *** [Qc Qs 3s] [5c]
o-chan1986: checks 
takakensu: checks 
*** RIVER *** [Qc Qs 3s 5c] [6s]
o-chan1986: checks 
takakensu: checks 
*** SHOW DOWN ***
o-chan1986: shows [9c Ac] (a pair of Queens)
takakensu: shows [Jc Ad] (a pair of Queens - Ace+Jack kicker)
takakensu collected $8.34 from pot
*** SUMMARY ***
Total pot $8.78 | Rake $0.44 
Board [Qc Qs 3s 5c 6s]
Seat 1: 6l4ck (button) folded before Flop (didn't bet)
Seat 3: o-chan1986 (small blind) showed [9c Ac] and lost with a pair of Queens
Seat 4: Dihabet (big blind) folded before Flop
Seat 5: artemxxl folded before Flop (didn't bet)
Seat 6: alexrus18 folded before Flop (didn't bet)
Seat 7: takakensu showed [Jc Ad] and won ($8.34) with a pair of Queens
Seat 8: Philheil folded before Flop (didn't bet)
Seat 9: dstrola folded before Flop (didn't bet)



PokerStars Hand #228680487980:  Hold'em No Limit ($0.25/$0.50 USD) - 2021/07/30 10:54:36 ET
Table 'Aitne III' 9-max Seat #3 is the button
Seat 1: 6l4ck ($50 in chips) 
Seat 3: o-chan1986 ($64.73 in chips) 
Seat 4: Dihabet ($53.71 in chips) 
Seat 5: artemxxl ($76.80 in chips) 
Seat 6: alexrus18 ($50 in chips) 
Seat 7: takakensu ($120.12 in chips) 
Seat 8: Philheil ($61.90 in chips) 
Seat 9: dstrola ($50 in chips) 
Dihabet: posts small blind $0.25
artemxxl: posts big blind $0.50
rebol2: sits out 
*** HOLE CARDS ***
alexrus18: folds 
takakensu: folds 
Philheil: calls $0.50
dstrola: folds 
6l4ck: raises $1.40 to $1.90
o-chan1986: calls $1.90
Dihabet: raises $7.10 to $9
artemxxl: folds 
Philheil: folds 
6l4ck: raises $41 to $50 and is all-in
o-chan1986: folds 
Dihabet: calls $41
*** FIRST FLOP *** [Jd Ac 6c]
*** FIRST TURN *** [Jd Ac 6c] [Kh]
*** FIRST RIVER *** [Jd Ac 6c Kh] [Kc]
*** SECOND FLOP *** [7d 8c 5h]
*** SECOND TURN *** [7d 8c 5h] [2s]
*** SECOND RIVER *** [7d 8c 5h 2s] [Ad]
*** FIRST SHOW DOWN ***
Dihabet: shows [Qc Qd] (two pair, Kings and Queens)
6l4ck: shows [Kd Ah] (a full house, Kings full of Aces)
6l4ck collected $50.45 from pot
*** SECOND SHOW DOWN ***
Dihabet: shows [Qc Qd] (a pair of Queens)
6l4ck: shows [Kd Ah] (a pair of Aces)
6l4ck collected $50.45 from pot
*** SUMMARY ***
Total pot $102.90 | Rake $2 
Hand was run twice
FIRST Board [Jd Ac 6c Kh Kc]
SECOND Board [7d 8c 5h 2s Ad]
Seat 1: 6l4ck showed [Kd Ah] and won ($50.45) with a full house, Kings full of Aces, and won ($50.45) with a pair of Aces
Seat 3: o-chan1986 (button) folded before Flop
Seat 4: Dihabet (small blind) showed [Qc Qd] and lost with two pair, Kings and Queens, and lost with a pair of Queens
Seat 5: artemxxl (big blind) folded before Flop
Seat 6: alexrus18 folded before Flop (didn't bet)
Seat 7: takakensu folded before Flop (didn't bet)
Seat 8: Philheil folded before Flop
Seat 9: dstrola folded before Flop (didn't bet)



PokerStars Hand #228680502726:  Hold'em No Limit ($0.25/$0.50 USD) - 2021/07/30 10:55:25 ET
Table 'Aitne III' 9-max Seat #4 is the button
Seat 1: 6l4ck ($100.90 in chips) 
Seat 2: rebol2 ($50 in chips) 
Seat 3: o-chan1986 ($62.83 in chips) 
Seat 4: Dihabet ($50 in chips) 
Seat 5: artemxxl ($76.30 in chips) 
Seat 6: alexrus18 ($50 in chips) 
Seat 7: takakensu ($120.12 in chips) 
Seat 8: Philheil ($61.40 in chips) 
Seat 9: dstrola ($50 in chips) 
artemxxl: posts small blind $0.25
alexrus18: posts big blind $0.50
rebol2: posts big blind $0.50
*** HOLE CARDS ***
takakensu: folds 
Philheil: folds 
dstrola: folds 
6l4ck: folds 
rebol2: raises $1 to $1.50
o-chan1986: folds 
Dihabet: calls $1.50
artemxxl: raises $5 to $6.50
alexrus18: folds 
rebol2: calls $5
Dihabet: calls $5
*** FLOP *** [Kh Qd Qs]
artemxxl: bets $9.50
rebol2: folds 
Dihabet: folds 
Uncalled bet ($9.50) returned to artemxxl
artemxxl collected $19 from pot
*** SUMMARY ***
Total pot $20 | Rake $1 
Board [Kh Qd Qs]
Seat 1: 6l4ck folded before Flop (didn't bet)
Seat 2: rebol2 folded on the Flop
Seat 3: o-chan1986 folded before Flop (didn't bet)
Seat 4: Dihabet (button) folded on the Flop
Seat 5: artemxxl (small blind) collected ($19)
Seat 6: alexrus18 (big blind) folded before Flop
Seat 7: takakensu folded before Flop (didn't bet)
Seat 8: Philheil folded before Flop (didn't bet)
Seat 9: dstrola folded before Flop (didn't bet)



PokerStars Hand #228680517727:  Hold'em No Limit ($0.25/$0.50 USD) - 2021/07/30 10:56:23 ET
Table 'Aitne III' 9-max Seat #5 is the button
Seat 1: 6l4ck ($100.90 in chips) 
Seat 2: rebol2 ($50 in chips) 
Seat 3: o-chan1986 ($62.83 in chips) 
Seat 4: Dihabet ($50 in chips) 
Seat 5: artemxxl ($88.80 in chips) 
Seat 6: alexrus18 ($50 in chips) 
Seat 7: takakensu ($120.12 in chips) 
Seat 8: Philheil ($61.40 in chips) 
Seat 9: dstrola ($50 in chips) 
alexrus18: posts small blind $0.25
takakensu: posts big blind $0.50
*** HOLE CARDS ***
Philheil: raises $0.50 to $1
dstrola: folds 
6l4ck: folds 
rebol2: raises $2.50 to $3.50
o-chan1986: folds 
Dihabet: raises $8 to $11.50
artemxxl: folds 
alexrus18: folds 
takakensu: folds 
Philheil: folds 
rebol2: folds 
Uncalled bet ($8) returned to Dihabet
Dihabet collected $8.75 from pot
Dihabet: doesn't show hand 
*** SUMMARY ***
Total pot $8.75 | Rake $0 
Seat 1: 6l4ck folded before Flop (didn't bet)
Seat 2: rebol2 folded before Flop
Seat 3: o-chan1986 folded before Flop (didn't bet)
Seat 4: Dihabet collected ($8.75)
Seat 5: artemxxl (button) folded before Flop (didn't bet)
Seat 6: alexrus18 (small blind) folded before Flop
Seat 7: takakensu (big blind) folded before Flop
Seat 8: Philheil folded before Flop
Seat 9: dstrola folded before Flop (didn't bet)



PokerStars Hand #228680533680:  Hold'em No Limit ($0.25/$0.50 USD) - 2021/07/30 10:57:24 ET
Table 'Aitne III' 9-max Seat #6 is the button
Seat 1: 6l4ck ($100.90 in chips) 
Seat 2: rebol2 ($50 in chips) 
Seat 3: o-chan1986 ($62.83 in chips) 
Seat 4: Dihabet ($55.25 in chips) 
Seat 5: artemxxl ($88.80 in chips) 
Seat 6: alexrus18 ($50 in chips) 
Seat 7: takakensu ($119.62 in chips) 
Seat 8: Philheil ($60.40 in chips) 
Seat 9: dstrola ($50 in chips) 
takakensu: posts small blind $0.25
Philheil: posts big blind $0.50
*** HOLE CARDS ***
dstrola: folds 
6l4ck: folds 
rebol2: folds 
o-chan1986: folds 
Dihabet: folds 
artemxxl: folds 
alexrus18: folds 
takakensu: raises $1 to $1.50
Philheil: calls $1
*** FLOP *** [6d Jc Jd]
takakensu: bets $1.42
Philheil: folds 
Uncalled bet ($1.42) returned to takakensu
takakensu collected $2.85 from pot
takakensu: doesn't show hand 
*** SUMMARY ***
Total pot $3 | Rake $0.15 
Board [6d Jc Jd]
Seat 1: 6l4ck folded before Flop (didn't bet)
Seat 2: rebol2 folded before Flop (didn't bet)
Seat 3: o-chan1986 folded before Flop (didn't bet)
Seat 4: Dihabet folded before Flop (didn't bet)
Seat 5: artemxxl folded before Flop (didn't bet)
Seat 6: alexrus18 (button) folded before Flop (didn't bet)
Seat 7: takakensu (small blind) collected ($2.85)
Seat 8: Philheil (big blind) folded on the Flop
Seat 9: dstrola folded before Flop (didn't bet)



PokerStars Hand #228680539947:  Hold'em No Limit ($0.25/$0.50 USD) - 2021/07/30 10:57:48 ET
Table 'Aitne III' 9-max Seat #7 is the button
Seat 1: 6l4ck ($100.90 in chips) 
Seat 2: rebol2 ($50 in chips) 
Seat 3: o-chan1986 ($62.83 in chips) 
Seat 4: Dihabet ($55.25 in chips) 
Seat 5: artemxxl ($88.80 in chips) 
Seat 6: alexrus18 ($50 in chips) 
Seat 7: takakensu ($120.97 in chips) 
Seat 8: Philheil ($58.90 in chips) 
Seat 9: dstrola ($50 in chips) 
Philheil: posts small blind $0.25
dstrola: posts big blind $0.50
*** HOLE CARDS ***
6l4ck: folds 
rebol2: folds 
o-chan1986: folds 
Dihabet: raises $0.85 to $1.35
artemxxl: folds 
alexrus18: folds 
takakensu: folds 
Philheil: folds 
dstrola: calls $0.85
*** FLOP *** [Th Ad 8h]
dstrola: checks 
Dihabet: checks 
*** TURN *** [Th Ad 8h] [Ts]
dstrola: bets $1.96
Dihabet: calls $1.96
*** RIVER *** [Th Ad 8h Ts] [9c]
dstrola: bets $6.53
Dihabet: folds 
Uncalled bet ($6.53) returned to dstrola
dstrola collected $6.53 from pot
*** SUMMARY ***
Total pot $6.87 | Rake $0.34 
Board [Th Ad 8h Ts 9c]
Seat 1: 6l4ck folded before Flop (didn't bet)
Seat 2: rebol2 folded before Flop (didn't bet)
Seat 3: o-chan1986 folded before Flop (didn't bet)
Seat 4: Dihabet folded on the River
Seat 5: artemxxl folded before Flop (didn't bet)
Seat 6: alexrus18 folded before Flop (didn't bet)
Seat 7: takakensu (button) folded before Flop (didn't bet)
Seat 8: Philheil (small blind) folded before Flop
Seat 9: dstrola (big blind) collected ($6.53)



PokerStars Hand #228680548265:  Hold'em No Limit ($0.25/$0.50 USD) - 2021/07/30 10:58:20 ET
Table 'Aitne III' 9-max Seat #8 is the button
Seat 1: 6l4ck ($100.90 in chips) 
Seat 2: rebol2 ($50 in chips) 
Seat 3: o-chan1986 ($62.83 in chips) 
Seat 4: Dihabet ($51.94 in chips) 
Seat 5: artemxxl ($88.80 in chips) 
Seat 6: alexrus18 ($50 in chips) 
Seat 7: takakensu ($120.97 in chips) 
Seat 8: Philheil ($58.65 in chips) 
Seat 9: dstrola ($53.22 in chips) 
dstrola: posts small blind $0.25
6l4ck: posts big blind $0.50
*** HOLE CARDS ***
rebol2: folds 
o-chan1986: folds 
Dihabet: folds 
artemxxl: folds 
alexrus18: raises $0.75 to $1.25
takakensu: folds 
Philheil: folds 
dstrola: folds 
6l4ck: folds 
Uncalled bet ($0.75) returned to alexrus18
alexrus18 collected $1.25 from pot
alexrus18: doesn't show hand 
*** SUMMARY ***
Total pot $1.25 | Rake $0 
Seat 1: 6l4ck (big blind) folded before Flop
Seat 2: rebol2 folded before Flop (didn't bet)
Seat 3: o-chan1986 folded before Flop (didn't bet)
Seat 4: Dihabet folded before Flop (didn't bet)
Seat 5: artemxxl folded before Flop (didn't bet)
Seat 6: alexrus18 collected ($1.25)
Seat 7: takakensu folded before Flop (didn't bet)
Seat 8: Philheil (button) folded before Flop (didn't bet)
Seat 9: dstrola (small blind) folded before Flop



PokerStars Hand #228680551728:  Hold'em No Limit ($0.25/$0.50 USD) - 2021/07/30 10:58:33 ET
Table 'Aitne III' 9-max Seat #9 is the button
Seat 1: 6l4ck ($100.40 in chips) 
Seat 2: rebol2 ($50 in chips) 
Seat 3: o-chan1986 ($62.83 in chips) 
Seat 4: Dihabet ($51.94 in chips) 
Seat 5: artemxxl ($88.80 in chips) 
Seat 6: alexrus18 ($50.75 in chips) 
Seat 7: takakensu ($120.97 in chips) 
Seat 8: Philheil ($58.65 in chips) 
Seat 9: dstrola ($52.97 in chips) 
6l4ck: posts small blind $0.25
rebol2: posts big blind $0.50
*** HOLE CARDS ***
o-chan1986: folds 
Dihabet: folds 
artemxxl: folds 
alexrus18: folds 
takakensu: folds 
Philheil: calls $0.50
dstrola: folds 
6l4ck: raises $1.50 to $2
rebol2: folds 
Philheil: folds 
Uncalled bet ($1.50) returned to 6l4ck
6l4ck collected $1.50 from pot
6l4ck: doesn't show hand 
*** SUMMARY ***
Total pot $1.50 | Rake $0 
Seat 1: 6l4ck (small blind) collected ($1.50)
Seat 2: rebol2 (big blind) folded before Flop
Seat 3: o-chan1986 folded before Flop (didn't bet)
Seat 4: Dihabet folded before Flop (didn't bet)
Seat 5: artemxxl folded before Flop (didn't bet)
Seat 6: alexrus18 folded before Flop (didn't bet)
Seat 7: takakensu folded before Flop (didn't bet)
Seat 8: Philheil folded before Flop
Seat 9: dstrola (button) folded before Flop (didn't bet)



PokerStars Hand #228680556370:  Hold'em No Limit ($0.25/$0.50 USD) - 2021/07/30 10:58:51 ET
Table 'Aitne III' 9-max Seat #1 is the button
Seat 1: 6l4ck ($101.40 in chips) 
Seat 2: rebol2 ($50 in chips) 
Seat 3: o-chan1986 ($62.83 in chips) 
Seat 4: Dihabet ($51.94 in chips) 
Seat 5: artemxxl ($88.80 in chips) 
Seat 6: alexrus18 ($50.75 in chips) 
Seat 7: takakensu ($120.97 in chips) 
Seat 8: Philheil ($58.15 in chips) 
Seat 9: dstrola ($52.97 in chips) 
rebol2: posts small blind $0.25
o-chan1986: posts big blind $0.50
*** HOLE CARDS ***
Dihabet: folds 
artemxxl: folds 
alexrus18: folds 
takakensu: folds 
Philheil: calls $0.50
dstrola: folds 
6l4ck: raises $1.40 to $1.90
rebol2: folds 
o-chan1986: folds 
Philheil: calls $1.40
*** FLOP *** [7h 6s Ad]
Philheil: checks 
6l4ck: bets $2.16
Philheil: calls $2.16
*** TURN *** [7h 6s Ad] [2s]
Philheil: bets $1.50
6l4ck: raises $5.72 to $7.22
Philheil: calls $5.72
*** RIVER *** [7h 6s Ad 2s] [7c]
Philheil: bets $8
6l4ck: calls $8
*** SHOW DOWN ***
Philheil: shows [Ah 5s] (two pair, Aces and Sevens)
6l4ck: shows [Ac Th] (two pair, Aces and Sevens - Ten kicker)
6l4ck collected $37.34 from pot
*** SUMMARY ***
Total pot $39.31 | Rake $1.97 
Board [7h 6s Ad 2s 7c]
Seat 1: 6l4ck (button) showed [Ac Th] and won ($37.34) with two pair, Aces and Sevens
Seat 2: rebol2 (small blind) folded before Flop
Seat 3: o-chan1986 (big blind) folded before Flop
Seat 4: Dihabet folded before Flop (didn't bet)
Seat 5: artemxxl folded before Flop (didn't bet)
Seat 6: alexrus18 folded before Flop (didn't bet)
Seat 7: takakensu folded before Flop (didn't bet)
Seat 8: Philheil showed [Ah 5s] and lost with two pair, Aces and Sevens
Seat 9: dstrola folded before Flop (didn't bet)



PokerStars Hand #228680574439:  Hold'em No Limit ($0.25/$0.50 USD) - 2021/07/30 11:00:00 ET
Table 'Aitne III' 9-max Seat #2 is the button
Seat 1: 6l4ck ($119.46 in chips) 
Seat 2: rebol2 ($50 in chips) 
Seat 3: o-chan1986 ($62.33 in chips) 
Seat 5: artemxxl ($88.80 in chips) 
Seat 6: alexrus18 ($50.75 in chips) 
Seat 7: takakensu ($120.97 in chips) 
Seat 8: Philheil ($38.87 in chips) 
Seat 9: dstrola ($52.97 in chips) 
o-chan1986: posts small blind $0.25
Dihabet: is sitting out 
artemxxl: posts big blind $0.50
*** HOLE CARDS ***
Dihabet leaves the table
alexrus18: raises $0.75 to $1.25
takakensu: folds 
Philheil: folds 
dstrola: calls $1.25
6l4ck: folds 
rebol2: folds 
rebol2 leaves the table
o-chan1986: folds 
artemxxl: folds 
*** FLOP *** [6d Qs 3d]
alexrus18: checks 
dstrola: bets $1.50
VTcomp joins the table at seat #2 
alexrus18: calls $1.50
*** TURN *** [6d Qs 3d] [Ah]
alexrus18: checks 
dstrola: checks 
*** RIVER *** [6d Qs 3d Ah] [2c]
alexrus18: bets $3.50
dstrola: folds 
Uncalled bet ($3.50) returned to alexrus18
alexrus18 collected $5.94 from pot
alexrus18: doesn't show hand 
*** SUMMARY ***
Total pot $6.25 | Rake $0.31 
Board [6d Qs 3d Ah 2c]
Seat 1: 6l4ck folded before Flop (didn't bet)
Seat 2: rebol2 (button) folded before Flop (didn't bet)
Seat 3: o-chan1986 (small blind) folded before Flop
Seat 5: artemxxl (big blind) folded before Flop
Seat 6: alexrus18 collected ($5.94)
Seat 7: takakensu folded before Flop (didn't bet)
Seat 8: Philheil folded before Flop (didn't bet)
Seat 9: dstrola folded on the River



PokerStars Hand #228680587537:  Hold'em No Limit ($0.25/$0.50 USD) - 2021/07/30 11:00:49 ET
Table 'Aitne III' 9-max Seat #3 is the button
Seat 1: 6l4ck ($119.46 in chips) 
Seat 3: o-chan1986 ($62.08 in chips) 
Seat 5: artemxxl ($88.30 in chips) 
Seat 6: alexrus18 ($53.94 in chips) 
Seat 7: takakensu ($120.97 in chips) 
Seat 8: Philheil ($38.87 in chips) 
Seat 9: dstrola ($50.22 in chips) 
artemxxl: posts small blind $0.25
alexrus18: posts big blind $0.50
VTcomp: sits out 
*** HOLE CARDS ***
takakensu: folds 
Philheil: folds 
dstrola: folds 
6l4ck: folds 
o-chan1986: folds 
artemxxl: folds 
Uncalled bet ($0.25) returned to alexrus18
alexrus18 collected $0.50 from pot
alexrus18: doesn't show hand 
*** SUMMARY ***
Total pot $0.50 | Rake $0 
Seat 1: 6l4ck folded before Flop (didn't bet)
Seat 3: o-chan1986 (button) folded before Flop (didn't bet)
Seat 5: artemxxl (small blind) folded before Flop
Seat 6: alexrus18 (big blind) collected ($0.50)
Seat 7: takakensu folded before Flop (didn't bet)
Seat 8: Philheil folded before Flop (didn't bet)
Seat 9: dstrola folded before Flop (didn't bet)



PokerStars Hand #228680590692:  Hold'em No Limit ($0.25/$0.50 USD) - 2021/07/30 11:01:00 ET
Table 'Aitne III' 9-max Seat #5 is the button
Seat 1: 6l4ck ($119.46 in chips) 
Seat 3: o-chan1986 ($62.08 in chips) 
Seat 5: artemxxl ($88.05 in chips) 
Seat 6: alexrus18 ($54.19 in chips) 
Seat 7: takakensu ($120.97 in chips) 
Seat 8: Philheil ($38.87 in chips) 
Seat 9: dstrola ($50.22 in chips) 
alexrus18: posts small blind $0.25
takakensu: posts big blind $0.50
VTcomp: sits out 
*** HOLE CARDS ***
Philheil: folds 
dstrola: raises $0.75 to $1.25
6l4ck: folds 
o-chan1986: folds 
artemxxl: folds 
alexrus18: folds 
takakensu: folds 
Uncalled bet ($0.75) returned to dstrola
dstrola collected $1.25 from pot
*** SUMMARY ***
Total pot $1.25 | Rake $0 
Seat 1: 6l4ck folded before Flop (didn't bet)
Seat 3: o-chan1986 folded before Flop (didn't bet)
Seat 5: artemxxl (button) folded before Flop (didn't bet)
Seat 6: alexrus18 (small blind) folded before Flop
Seat 7: takakensu (big blind) folded before Flop
Seat 8: Philheil folded before Flop (didn't bet)
Seat 9: dstrola collected ($1.25)



PokerStars Hand #228680596980:  Hold'em No Limit ($0.25/$0.50 USD) - 2021/07/30 11:01:21 ET
Table 'Aitne III' 9-max Seat #6 is the button
Seat 1: 6l4ck ($119.46 in chips) 
Seat 3: o-chan1986 ($62.08 in chips) 
Seat 5: artemxxl ($88.05 in chips) 
Seat 6: alexrus18 ($53.94 in chips) 
Seat 7: takakensu ($120.47 in chips) 
Seat 8: Philheil ($38.87 in chips) 
Seat 9: dstrola ($50.97 in chips) 
takakensu: posts small blind $0.25
Philheil: posts big blind $0.50
VTcomp: sits out 
*** HOLE CARDS ***
dstrola: raises $1 to $1.50
6l4ck: folds 
o-chan1986: folds 
artemxxl: folds 
alexrus18: folds 
takakensu: folds 
Philheil: folds 
Uncalled bet ($1) returned to dstrola
dstrola collected $1.25 from pot
*** SUMMARY ***
Total pot $1.25 | Rake $0 
Seat 1: 6l4ck folded before Flop (didn't bet)
Seat 3: o-chan1986 folded before Flop (didn't bet)
Seat 5: artemxxl folded before Flop (didn't bet)
Seat 6: alexrus18 (button) folded before Flop (didn't bet)
Seat 7: takakensu (small blind) folded before Flop
Seat 8: Philheil (big blind) folded before Flop
Seat 9: dstrola collected ($1.25)



PokerStars Hand #228680600640:  Hold'em No Limit ($0.25/$0.50 USD) - 2021/07/30 11:01:34 ET
Table 'Aitne III' 9-max Seat #7 is the button
Seat 1: 6l4ck ($119.46 in chips) 
Seat 3: o-chan1986 ($62.08 in chips) 
Seat 5: artemxxl ($88.05 in chips) 
Seat 6: alexrus18 ($53.94 in chips) 
Seat 7: takakensu ($120.22 in chips) 
Seat 8: Philheil ($38.37 in chips) 
Philheil: posts small blind $0.25
6l4ck: posts big blind $0.50
VTcomp: sits out 
*** HOLE CARDS ***
dstrola leaves the table
o-chan1986: folds 
artemxxl: raises $0.75 to $1.25
alexrus18: folds 
takakensu: folds 
Philheil: calls $1
Lisenok110 joins the table at seat #4 
6l4ck: calls $0.75
*** FLOP *** [Ac Js 2c]
Philheil: checks 
6l4ck: checks 
artemxxl: bets $2.50
Philheil: calls $2.50
6l4ck: raises $8.30 to $10.80
artemxxl: calls $8.30
Philheil: folds 
*** TURN *** [Ac Js 2c] [7d]
6l4ck: bets $19.85
artemxxl: calls $19.85
*** RIVER *** [Ac Js 2c 7d] [8c]
6l4ck: checks 
artemxxl: checks 
*** SHOW DOWN ***
6l4ck: shows [Jd As] (two pair, Aces and Jacks)
artemxxl: shows [Ah Jc] (two pair, Aces and Jacks)
6l4ck collected $32.78 from pot
artemxxl collected $32.77 from pot
*** SUMMARY ***
Total pot $67.55 | Rake $2 
Board [Ac Js 2c 7d 8c]
Seat 1: 6l4ck (big blind) showed [Jd As] and won ($32.78) with two pair, Aces and Jacks
Seat 3: o-chan1986 folded before Flop (didn't bet)
Seat 5: artemxxl showed [Ah Jc] and won ($32.77) with two pair, Aces and Jacks
Seat 6: alexrus18 folded before Flop (didn't bet)
Seat 7: takakensu (button) folded before Flop (didn't bet)
Seat 8: Philheil (small blind) folded on the Flop



PokerStars Hand #228680625120:  Hold'em No Limit ($0.25/$0.50 USD) - 2021/07/30 11:02:53 ET
Table 'Aitne III' 9-max Seat #8 is the button
Seat 1: 6l4ck ($120.34 in chips) 
Seat 2: VTcomp ($40 in chips) 
Seat 3: o-chan1986 ($62.08 in chips) 
Seat 5: artemxxl ($88.92 in chips) 
Seat 6: alexrus18 ($53.94 in chips) 
Seat 7: takakensu ($120.22 in chips) 
Seat 8: Philheil ($34.62 in chips) 
6l4ck: posts small blind $0.25
VTcomp: posts big blind $0.50
Lisenok110: sits out 
*** HOLE CARDS ***
o-chan1986: folds 
artemxxl: folds 
alexrus18: raises $0.75 to $1.25
takakensu: folds 
Philheil: folds 
6l4ck: folds 
VTcomp: calls $0.75
*** FLOP *** [Qh Th 6c]
VTcomp: checks 
alexrus18: checks 
*** TURN *** [Qh Th 6c] [6h]
VTcomp: bets $1.31
alexrus18: folds 
Uncalled bet ($1.31) returned to VTcomp
VTcomp collected $2.61 from pot
VTcomp: doesn't show hand 
*** SUMMARY ***
Total pot $2.75 | Rake $0.14 
Board [Qh Th 6c 6h]
Seat 1: 6l4ck (small blind) folded before Flop
Seat 2: VTcomp (big blind) collected ($2.61)
Seat 3: o-chan1986 folded before Flop (didn't bet)
Seat 5: artemxxl folded before Flop (didn't bet)
Seat 6: alexrus18 folded on the Turn
Seat 7: takakensu folded before Flop (didn't bet)
Seat 8: Philheil (button) folded before Flop (didn't bet)



PokerStars Hand #228680635744:  Hold'em No Limit ($0.25/$0.50 USD) - 2021/07/30 11:03:27 ET
Table 'Aitne III' 9-max Seat #1 is the button
Seat 1: 6l4ck ($120.09 in chips) 
Seat 2: VTcomp ($41.36 in chips) 
Seat 3: o-chan1986 ($62.08 in chips) 
Seat 5: artemxxl ($88.92 in chips) 
Seat 6: alexrus18 ($52.69 in chips) 
Seat 7: takakensu ($120.22 in chips) 
Seat 8: Philheil ($34.62 in chips) 
VTcomp: posts small blind $0.25
o-chan1986: posts big blind $0.50
Lisenok110: sits out 
*** HOLE CARDS ***
artemxxl: folds 
alexrus18: folds 
takakensu: folds 
Philheil: folds 
6l4ck: folds 
VTcomp: folds 
Uncalled bet ($0.25) returned to o-chan1986
o-chan1986 collected $0.50 from pot
o-chan1986: doesn't show hand 
*** SUMMARY ***
Total pot $0.50 | Rake $0 
Seat 1: 6l4ck (button) folded before Flop (didn't bet)
Seat 2: VTcomp (small blind) folded before Flop
Seat 3: o-chan1986 (big blind) collected ($0.50)
Seat 5: artemxxl folded before Flop (didn't bet)
Seat 6: alexrus18 folded before Flop (didn't bet)
Seat 7: takakensu folded before Flop (didn't bet)
Seat 8: Philheil folded before Flop (didn't bet)



PokerStars Hand #228680639114:  Hold'em No Limit ($0.25/$0.50 USD) - 2021/07/30 11:03:37 ET
Table 'Aitne III' 9-max Seat #2 is the button
Seat 1: 6l4ck ($120.09 in chips) 
Seat 2: VTcomp ($41.11 in chips) 
Seat 3: o-chan1986 ($62.33 in chips) 
Seat 4: Lisenok110 ($50.75 in chips) 
Seat 5: artemxxl ($88.92 in chips) 
Seat 6: alexrus18 ($52.69 in chips) 
Seat 7: takakensu ($120.22 in chips) 
Seat 8: Philheil ($34.62 in chips) 
o-chan1986: posts small blind $0.25
Lisenok110: posts big blind $0.50
*** HOLE CARDS ***
artemxxl: folds 
alexrus18: folds 
takakensu: folds 
Philheil: folds 
6l4ck: folds 
VTcomp: folds 
o-chan1986: raises $0.75 to $1.25
Lisenok110: calls $0.75
*** FLOP *** [6c Jh 8s]
o-chan1986: checks 
Lisenok110: bets $0.76
o-chan1986: calls $0.76
*** TURN *** [6c Jh 8s] [6s]
o-chan1986: checks 
Lisenok110: checks 
*** RIVER *** [6c Jh 8s 6s] [5s]
o-chan1986: checks 
Lisenok110: bets $2.55
o-chan1986: folds 
Uncalled bet ($2.55) returned to Lisenok110
Lisenok110 collected $3.82 from pot
Lisenok110: doesn't show hand 
*** SUMMARY ***
Total pot $4.02 | Rake $0.20 
Board [6c Jh 8s 6s 5s]
Seat 1: 6l4ck folded before Flop (didn't bet)
Seat 2: VTcomp (button) folded before Flop (didn't bet)
Seat 3: o-chan1986 (small blind) folded on the River
Seat 4: Lisenok110 (big blind) collected ($3.82)
Seat 5: artemxxl folded before Flop (didn't bet)
Seat 6: alexrus18 folded before Flop (didn't bet)
Seat 7: takakensu folded before Flop (didn't bet)
Seat 8: Philheil folded before Flop (didn't bet)



PokerStars Hand #228680667120:  Hold'em No Limit ($0.25/$0.50 USD) - 2021/07/30 11:04:25 ET
Table 'Aitne III' 9-max Seat #3 is the button
Seat 1: 6l4ck ($120.09 in chips) 
Seat 2: VTcomp ($41.11 in chips) 
Seat 3: o-chan1986 ($60.32 in chips) 
Seat 4: Lisenok110 ($52.56 in chips) 
Seat 5: artemxxl ($88.92 in chips) 
Seat 6: alexrus18 ($52.69 in chips) 
Seat 7: takakensu ($120.22 in chips) 
Seat 8: Philheil ($34.62 in chips) 
Lisenok110: posts small blind $0.25
artemxxl: posts big blind $0.50
*** HOLE CARDS ***
alexrus18: folds 
takakensu: folds 
Philheil: calls $0.50
6l4ck: folds 
VTcomp: folds 
o-chan1986: raises $2 to $2.50
Lisenok110: calls $2.25
artemxxl: folds 
Philheil: folds 
*** FLOP *** [6d 3d Td]
Lisenok110: checks 
o-chan1986: bets $3.80
Lisenok110: folds 
Uncalled bet ($3.80) returned to o-chan1986
o-chan1986 collected $5.70 from pot
o-chan1986: doesn't show hand 
*** SUMMARY ***
Total pot $6 | Rake $0.30 
Board [6d 3d Td]
Seat 1: 6l4ck folded before Flop (didn't bet)
Seat 2: VTcomp folded before Flop (didn't bet)
Seat 3: o-chan1986 (button) collected ($5.70)
Seat 4: Lisenok110 (small blind) folded on the Flop
Seat 5: artemxxl (big blind) folded before Flop
Seat 6: alexrus18 folded before Flop (didn't bet)
Seat 7: takakensu folded before Flop (didn't bet)
Seat 8: Philheil folded before Flop



PokerStars Hand #228680677029:  Hold'em No Limit ($0.25/$0.50 USD) - 2021/07/30 11:04:56 ET
Table 'Aitne III' 9-max Seat #4 is the button
Seat 1: 6l4ck ($120.09 in chips) 
Seat 2: VTcomp ($41.11 in chips) 
Seat 3: o-chan1986 ($63.52 in chips) 
Seat 4: Lisenok110 ($50.06 in chips) 
Seat 5: artemxxl ($88.42 in chips) 
Seat 7: takakensu ($120.22 in chips) 
Seat 8: Philheil ($34.12 in chips) 
artemxxl: posts small blind $0.25
alexrus18: is sitting out 
takakensu: posts big blind $0.50
*** HOLE CARDS ***
siskin vrach joins the table at seat #9 
Philheil: raises $0.50 to $1
6l4ck: folds 
VTcomp: calls $1
o-chan1986: folds 
Lisenok110: folds 
artemxxl: folds 
takakensu: calls $0.50
*** FLOP *** [Qc 6s 3s]
takakensu: bets $1.54
Philheil: calls $1.54
VTcomp: folds 
*** TURN *** [Qc 6s 3s] [8s]
takakensu: checks 
Philheil: bets $3.50
takakensu: folds 
Uncalled bet ($3.50) returned to Philheil
Philheil collected $5.93 from pot
Philheil: doesn't show hand 
*** SUMMARY ***
Total pot $6.33 | Rake $0.40 
Board [Qc 6s 3s 8s]
Seat 1: 6l4ck folded before Flop (didn't bet)
Seat 2: VTcomp folded on the Flop
Seat 3: o-chan1986 folded before Flop (didn't bet)
Seat 4: Lisenok110 (button) folded before Flop (didn't bet)
Seat 5: artemxxl (small blind) folded before Flop
Seat 7: takakensu (big blind) folded on the Turn
Seat 8: Philheil collected ($5.93)



PokerStars Hand #228680687468:  Hold'em No Limit ($0.25/$0.50 USD) - 2021/07/30 11:05:27 ET
Table 'Aitne III' 9-max Seat #5 is the button
Seat 1: 6l4ck ($120.09 in chips) 
Seat 2: VTcomp ($40.11 in chips) 
Seat 3: o-chan1986 ($63.52 in chips) 
Seat 4: Lisenok110 ($50.06 in chips) 
Seat 5: artemxxl ($88.17 in chips) 
Seat 7: takakensu ($117.68 in chips) 
Seat 8: Philheil ($37.51 in chips) 
takakensu: posts small blind $0.25
Philheil: posts big blind $0.50
siskin vrach: sits out 
*** HOLE CARDS ***
6l4ck: folds 
VTcomp: folds 
o-chan1986: raises $0.75 to $1.25
Lisenok110: raises $3.25 to $4.50
artemxxl: folds 
takakensu: folds 
Philheil: folds 
o-chan1986: calls $3.25
*** FLOP *** [8s 2s As]
o-chan1986: checks 
Lisenok110: bets $2.96
o-chan1986: calls $2.96
*** TURN *** [8s 2s As] [7h]
o-chan1986: checks 
Lisenok110: checks 
*** RIVER *** [8s 2s As 7h] [Ad]
o-chan1986: bets $7.45
Lisenok110: calls $7.45
*** SHOW DOWN ***
o-chan1986: shows [Td Ts] (two pair, Aces and Tens)
Lisenok110: shows [Ah Th] (three of a kind, Aces)
Lisenok110 collected $29.04 from pot
*** SUMMARY ***
Total pot $30.57 | Rake $1.53 
Board [8s 2s As 7h Ad]
Seat 1: 6l4ck folded before Flop (didn't bet)
Seat 2: VTcomp folded before Flop (didn't bet)
Seat 3: o-chan1986 showed [Td Ts] and lost with two pair, Aces and Tens
Seat 4: Lisenok110 showed [Ah Th] and won ($29.04) with three of a kind, Aces
Seat 5: artemxxl (button) folded before Flop (didn't bet)
Seat 7: takakensu (small blind) folded before Flop
Seat 8: Philheil (big blind) folded before Flop



PokerStars Hand #228680699021:  Hold'em No Limit ($0.25/$0.50 USD) - 2021/07/30 11:06:02 ET
Table 'Aitne III' 9-max Seat #7 is the button
Seat 1: 6l4ck ($120.09 in chips) 
Seat 2: VTcomp ($40.11 in chips) 
Seat 3: o-chan1986 ($48.61 in chips) 
Seat 4: Lisenok110 ($64.19 in chips) 
Seat 5: artemxxl ($88.17 in chips) 
Seat 7: takakensu ($117.43 in chips) 
Seat 8: Philheil ($37.01 in chips) 
Seat 9: siskin vrach ($50 in chips) 
Philheil: posts small blind $0.25
siskin vrach: posts big blind $0.50
*** HOLE CARDS ***
6l4ck: folds 
VTcomp: raises $1 to $1.50
o-chan1986: folds 
Lisenok110: folds 
artemxxl: folds 
takakensu: folds 
Philheil: folds 
siskin vrach: folds 
Uncalled bet ($1) returned to VTcomp
VTcomp collected $1.25 from pot
VTcomp: doesn't show hand 
*** SUMMARY ***
Total pot $1.25 | Rake $0 
Seat 1: 6l4ck folded before Flop (didn't bet)
Seat 2: VTcomp collected ($1.25)
Seat 3: o-chan1986 folded before Flop (didn't bet)
Seat 4: Lisenok110 folded before Flop (didn't bet)
Seat 5: artemxxl folded before Flop (didn't bet)
Seat 7: takakensu (button) folded before Flop (didn't bet)
Seat 8: Philheil (small blind) folded before Flop
Seat 9: siskin vrach (big blind) folded before Flop



PokerStars Hand #228680703179:  Hold'em No Limit ($0.25/$0.50 USD) - 2021/07/30 11:06:15 ET
Table 'Aitne III' 9-max Seat #8 is the button
Seat 1: 6l4ck ($120.09 in chips) 
Seat 2: VTcomp ($40.86 in chips) 
Seat 3: o-chan1986 ($48.61 in chips) 
Seat 4: Lisenok110 ($64.19 in chips) 
Seat 5: artemxxl ($88.17 in chips) 
Seat 7: takakensu ($117.43 in chips) 
Seat 8: Philheil ($36.76 in chips) 
Seat 9: siskin vrach ($50 in chips) 
siskin vrach: posts small blind $0.25
6l4ck: posts big blind $0.50
*** HOLE CARDS ***
alexrus18 leaves the table
VTcomp: folds 
o-chan1986: folds 
Lisenok110: raises $0.75 to $1.25
artemxxl: folds 
takakensu: folds 
Philheil: folds 
siskin vrach: folds 
6l4ck: folds 
Uncalled bet ($0.75) returned to Lisenok110
Lisenok110 collected $1.25 from pot
Lisenok110: doesn't show hand 
*** SUMMARY ***
Total pot $1.25 | Rake $0 
Seat 1: 6l4ck (big blind) folded before Flop
Seat 2: VTcomp folded before Flop (didn't bet)
Seat 3: o-chan1986 folded before Flop (didn't bet)
Seat 4: Lisenok110 collected ($1.25)
Seat 5: artemxxl folded before Flop (didn't bet)
Seat 7: takakensu folded before Flop (didn't bet)
Seat 8: Philheil (button) folded before Flop (didn't bet)
Seat 9: siskin vrach (small blind) folded before Flop



PokerStars Hand #228680708925:  Hold'em No Limit ($0.25/$0.50 USD) - 2021/07/30 11:06:32 ET
Table 'Aitne III' 9-max Seat #9 is the button
Seat 1: 6l4ck ($119.59 in chips) 
Seat 2: VTcomp ($40.86 in chips) 
Seat 3: o-chan1986 ($48.61 in chips) 
Seat 4: Lisenok110 ($64.94 in chips) 
Seat 5: artemxxl ($88.17 in chips) 
Seat 7: takakensu ($117.43 in chips) 
Seat 8: Philheil ($36.76 in chips) 
Seat 9: siskin vrach ($50 in chips) 
6l4ck: posts small blind $0.25
VTcomp: posts big blind $0.50
*** HOLE CARDS ***
o-chan1986: folds 
Lisenok110: folds 
artemxxl: folds 
takakensu: folds 
Philheil: folds 
siskin vrach: raises $1 to $1.50
6l4ck: folds 
VTcomp: raises $3.25 to $4.75
siskin vrach: folds 
Uncalled bet ($3.25) returned to VTcomp
VTcomp collected $3.25 from pot
VTcomp: doesn't show hand 
*** SUMMARY ***
Total pot $3.25 | Rake $0 
Seat 1: 6l4ck (small blind) folded before Flop
Seat 2: VTcomp (big blind) collected ($3.25)
Seat 3: o-chan1986 folded before Flop (didn't bet)
Seat 4: Lisenok110 folded before Flop (didn't bet)
Seat 5: artemxxl folded before Flop (didn't bet)
Seat 7: takakensu folded before Flop (didn't bet)
Seat 8: Philheil folded before Flop (didn't bet)
Seat 9: siskin vrach (button) folded before Flop



PokerStars Hand #228680716985:  Hold'em No Limit ($0.25/$0.50 USD) - 2021/07/30 11:06:57 ET
Table 'Aitne III' 9-max Seat #1 is the button
Seat 1: 6l4ck ($119.34 in chips) 
Seat 2: VTcomp ($42.61 in chips) 
Seat 3: o-chan1986 ($48.61 in chips) 
Seat 4: Lisenok110 ($64.94 in chips) 
Seat 5: artemxxl ($88.17 in chips) 
Seat 7: takakensu ($117.43 in chips) 
Seat 8: Philheil ($36.76 in chips) 
Seat 9: siskin vrach ($50 in chips) 
VTcomp: posts small blind $0.25
o-chan1986: posts big blind $0.50
*** HOLE CARDS ***
Lisenok110: folds 
artemxxl: folds 
takakensu: raises $1.50 to $2
Philheil: folds 
siskin vrach: folds 
6l4ck: folds 
VTcomp: folds 
o-chan1986: folds 
Uncalled bet ($1.50) returned to takakensu
takakensu collected $1.25 from pot
takakensu: doesn't show hand 
*** SUMMARY ***
Total pot $1.25 | Rake $0 
Seat 1: 6l4ck (button) folded before Flop (didn't bet)
Seat 2: VTcomp (small blind) folded before Flop
Seat 3: o-chan1986 (big blind) folded before Flop
Seat 4: Lisenok110 folded before Flop (didn't bet)
Seat 5: artemxxl folded before Flop (didn't bet)
Seat 7: takakensu collected ($1.25)
Seat 8: Philheil folded before Flop (didn't bet)
Seat 9: siskin vrach folded before Flop (didn't bet)



PokerStars Hand #228680724508:  Hold'em No Limit ($0.25/$0.50 USD) - 2021/07/30 11:07:20 ET
Table 'Aitne III' 9-max Seat #2 is the button
Seat 1: 6l4ck ($119.34 in chips) 
Seat 2: VTcomp ($42.36 in chips) 
Seat 3: o-chan1986 ($48.11 in chips) 
Seat 4: Lisenok110 ($64.94 in chips) 
Seat 5: artemxxl ($88.17 in chips) 
Seat 7: takakensu ($118.18 in chips) 
Seat 8: Philheil ($36.76 in chips) 
Seat 9: siskin vrach ($50 in chips) 
o-chan1986: posts small blind $0.25
Lisenok110: posts big blind $0.50
*** HOLE CARDS ***
artemxxl: folds 
takakensu: folds 
Philheil: calls $0.50
siskin vrach: raises $1.50 to $2
6l4ck: folds 
VTcomp: folds 
o-chan1986: folds 
hheman joins the table at seat #6 
Lisenok110: folds 
Philheil: calls $1.50
*** FLOP *** [Td Qh 6d]
Philheil: checks 
siskin vrach: bets $1.31
Philheil: calls $1.31
*** TURN *** [Td Qh 6d] [As]
Philheil: bets $2
siskin vrach: calls $2
*** RIVER *** [Td Qh 6d As] [Qd]
Philheil: bets $7.50
siskin vrach: calls $7.50
*** SHOW DOWN ***
Philheil: shows [Jd Ts] (two pair, Queens and Tens)
siskin vrach: shows [Qc Kh] (three of a kind, Queens)
siskin vrach collected $25.05 from pot
*** SUMMARY ***
Total pot $26.37 | Rake $1.32 
Board [Td Qh 6d As Qd]
Seat 1: 6l4ck folded before Flop (didn't bet)
Seat 2: VTcomp (button) folded before Flop (didn't bet)
Seat 3: o-chan1986 (small blind) folded before Flop
Seat 4: Lisenok110 (big blind) folded before Flop
Seat 5: artemxxl folded before Flop (didn't bet)
Seat 7: takakensu folded before Flop (didn't bet)
Seat 8: Philheil showed [Jd Ts] and lost with two pair, Queens and Tens
Seat 9: siskin vrach showed [Qc Kh] and won ($25.05) with three of a kind, Queens



PokerStars Hand #228680748907:  Hold'em No Limit ($0.25/$0.50 USD) - 2021/07/30 11:08:04 ET
Table 'Aitne III' 9-max Seat #3 is the button
Seat 1: 6l4ck ($119.34 in chips) 
Seat 2: VTcomp ($42.36 in chips) 
Seat 3: o-chan1986 ($47.86 in chips) 
Seat 4: Lisenok110 ($64.44 in chips) 
Seat 5: artemxxl ($88.17 in chips) 
Seat 7: takakensu ($118.18 in chips) 
Seat 8: Philheil ($23.95 in chips) 
Seat 9: siskin vrach ($62.24 in chips) 
Lisenok110: posts small blind $0.25
artemxxl: posts big blind $0.50
hheman: sits out 
*** HOLE CARDS ***
takakensu: folds 
Philheil: calls $0.50
siskin vrach: folds 
6l4ck: folds 
VTcomp: folds 
o-chan1986: raises $0.75 to $1.25
Lisenok110: calls $1
artemxxl: folds 
Philheil: calls $0.75
*** FLOP *** [Ah Th Kc]
Lisenok110: checks 
Philheil: checks 
o-chan1986: checks 
*** TURN *** [Ah Th Kc] [7s]
Lisenok110: bets $1.29
Philheil: folds 
o-chan1986: calls $1.29
*** RIVER *** [Ah Th Kc 7s] [6s]
Lisenok110: bets $4.33
o-chan1986: folds 
Uncalled bet ($4.33) returned to Lisenok110
Lisenok110 collected $6.49 from pot
Lisenok110: doesn't show hand 
*** SUMMARY ***
Total pot $6.83 | Rake $0.34 
Board [Ah Th Kc 7s 6s]
Seat 1: 6l4ck folded before Flop (didn't bet)
Seat 2: VTcomp folded before Flop (didn't bet)
Seat 3: o-chan1986 (button) folded on the River
Seat 4: Lisenok110 (small blind) collected ($6.49)
Seat 5: artemxxl (big blind) folded before Flop
Seat 7: takakensu folded before Flop (didn't bet)
Seat 8: Philheil folded on the Turn
Seat 9: siskin vrach folded before Flop (didn't bet)



PokerStars Hand #228680765452:  Hold'em No Limit ($0.25/$0.50 USD) - 2021/07/30 11:08:53 ET
Table 'Aitne III' 9-max Seat #4 is the button
Seat 1: 6l4ck ($119.34 in chips) 
Seat 2: VTcomp ($42.36 in chips) 
Seat 3: o-chan1986 ($45.32 in chips) 
Seat 4: Lisenok110 ($68.39 in chips) 
Seat 5: artemxxl ($87.67 in chips) 
Seat 6: hheman ($50 in chips) 
Seat 7: takakensu ($118.18 in chips) 
Seat 8: Philheil ($22.70 in chips) 
Seat 9: siskin vrach ($62.24 in chips) 
artemxxl: posts small blind $0.25
hheman: posts big blind $0.50
*** HOLE CARDS ***
takakensu: folds 
Philheil: folds 
siskin vrach: folds 
6l4ck: folds 
VTcomp: folds 
o-chan1986: folds 
Lisenok110: folds 
artemxxl: raises $1 to $1.50
hheman: folds 
Uncalled bet ($1) returned to artemxxl
artemxxl collected $1 from pot
*** SUMMARY ***
Total pot $1 | Rake $0 
Seat 1: 6l4ck folded before Flop (didn't bet)
Seat 2: VTcomp folded before Flop (didn't bet)
Seat 3: o-chan1986 folded before Flop (didn't bet)
Seat 4: Lisenok110 (button) folded before Flop (didn't bet)
Seat 5: artemxxl (small blind) collected ($1)
Seat 6: hheman (big blind) folded before Flop
Seat 7: takakensu folded before Flop (didn't bet)
Seat 8: Philheil folded before Flop (didn't bet)
Seat 9: siskin vrach folded before Flop (didn't bet)



PokerStars Hand #228680772837:  Hold'em No Limit ($0.25/$0.50 USD) - 2021/07/30 11:09:15 ET
Table 'Aitne III' 9-max Seat #5 is the button
Seat 1: 6l4ck ($119.34 in chips) 
Seat 2: VTcomp ($42.36 in chips) 
Seat 3: o-chan1986 ($45.32 in chips) 
Seat 4: Lisenok110 ($68.39 in chips) 
Seat 5: artemxxl ($88.17 in chips) 
Seat 6: hheman ($50 in chips) 
Seat 7: takakensu ($118.18 in chips) 
Seat 8: Philheil ($22.70 in chips) 
Seat 9: siskin vrach ($62.24 in chips) 
hheman: posts small blind $0.25
takakensu: posts big blind $0.50
*** HOLE CARDS ***
Philheil: folds 
siskin vrach: raises $1 to $1.50
6l4ck: folds 
VTcomp: raises $3.75 to $5.25
o-chan1986: folds 
Lisenok110: folds 
artemxxl: folds 
hheman: folds 
takakensu: folds 
siskin vrach: calls $3.75
*** FLOP *** [Kc 3h 7h]
siskin vrach: checks 
VTcomp: bets $5.35
siskin vrach: calls $5.35
*** TURN *** [Kc 3h 7h] [4d]
siskin vrach: checks 
VTcomp: checks 
*** RIVER *** [Kc 3h 7h 4d] [9c]
siskin vrach: bets $10
VTcomp: calls $10
*** SHOW DOWN ***
siskin vrach: shows [Ah Jh] (high card Ace)
VTcomp: shows [Qs Qc] (a pair of Queens)
VTcomp collected $39.95 from pot
*** SUMMARY ***
Total pot $41.95 | Rake $2 
Board [Kc 3h 7h 4d 9c]
Seat 1: 6l4ck folded before Flop (didn't bet)
Seat 2: VTcomp showed [Qs Qc] and won ($39.95) with a pair of Queens
Seat 3: o-chan1986 folded before Flop (didn't bet)
Seat 4: Lisenok110 folded before Flop (didn't bet)
Seat 5: artemxxl (button) folded before Flop (didn't bet)
Seat 6: hheman (small blind) folded before Flop
Seat 7: takakensu (big blind) folded before Flop
Seat 8: Philheil folded before Flop (didn't bet)
Seat 9: siskin vrach showed [Ah Jh] and lost with high card Ace



PokerStars Hand #228680788684:  Hold'em No Limit ($0.25/$0.50 USD) - 2021/07/30 11:10:02 ET
Table 'Aitne III' 9-max Seat #6 is the button
Seat 1: 6l4ck ($119.34 in chips) 
Seat 2: VTcomp ($61.71 in chips) 
Seat 3: o-chan1986 ($45.32 in chips) 
Seat 4: Lisenok110 ($68.39 in chips) 
Seat 5: artemxxl ($88.17 in chips) 
Seat 6: hheman ($50 in chips) 
Seat 7: takakensu ($117.68 in chips) 
Seat 8: Philheil ($22.70 in chips) 
Seat 9: siskin vrach ($50 in chips) 
takakensu: posts small blind $0.25
Philheil: posts big blind $0.50
*** HOLE CARDS ***
siskin vrach: folds 
6l4ck: folds 
VTcomp: folds 
o-chan1986: folds 
Lisenok110: folds 
artemxxl: raises $1 to $1.50
hheman: folds 
takakensu: folds 
Philheil: calls $1
*** FLOP *** [6d 7h Jd]
Philheil: checks 
artemxxl: checks 
*** TURN *** [6d 7h Jd] [Ah]
Philheil: checks 
artemxxl: bets $2.50
Philheil: calls $2.50
*** RIVER *** [6d 7h Jd Ah] [5c]
Philheil: checks 
artemxxl: bets $6.25
Philheil: raises $6.25 to $12.50
artemxxl: calls $6.25
*** SHOW DOWN ***
Philheil: shows [Js 9c] (a pair of Jacks)
artemxxl: shows [As 6s] (two pair, Aces and Sixes)
artemxxl collected $31.59 from pot
*** SUMMARY ***
Total pot $33.25 | Rake $1.66 
Board [6d 7h Jd Ah 5c]
Seat 1: 6l4ck folded before Flop (didn't bet)
Seat 2: VTcomp folded before Flop (didn't bet)
Seat 3: o-chan1986 folded before Flop (didn't bet)
Seat 4: Lisenok110 folded before Flop (didn't bet)
Seat 5: artemxxl showed [As 6s] and won ($31.59) with two pair, Aces and Sixes
Seat 6: hheman (button) folded before Flop (didn't bet)
Seat 7: takakensu (small blind) folded before Flop
Seat 8: Philheil (big blind) showed [Js 9c] and lost with a pair of Jacks
Seat 9: siskin vrach folded before Flop (didn't bet)



PokerStars Hand #228680804377:  Hold'em No Limit ($0.25/$0.50 USD) - 2021/07/30 11:10:48 ET
Table 'Aitne III' 9-max Seat #7 is the button
Seat 1: 6l4ck ($119.34 in chips) 
Seat 2: VTcomp ($61.71 in chips) 
Seat 3: o-chan1986 ($45.32 in chips) 
Seat 4: Lisenok110 ($68.39 in chips) 
Seat 5: artemxxl ($103.26 in chips) 
Seat 6: hheman ($50 in chips) 
Seat 7: takakensu ($117.43 in chips) 
Seat 8: Philheil ($6.20 in chips) 
Seat 9: siskin vrach ($50 in chips) 
Philheil: posts small blind $0.25
siskin vrach: posts big blind $0.50
*** HOLE CARDS ***
6l4ck: raises $1 to $1.50
VTcomp: folds 
o-chan1986: folds 
Lisenok110: folds 
artemxxl: folds 
hheman: folds 
takakensu: folds 
Philheil: calls $1.25
siskin vrach: folds 
*** FLOP *** [9s 4d 5c]
Philheil: checks 
6l4ck: checks 
*** TURN *** [9s 4d 5c] [Qh]
Philheil: checks 
6l4ck: checks 
*** RIVER *** [9s 4d 5c Qh] [5s]
Philheil: checks 
6l4ck: bets $2.49
Philheil: calls $2.49
*** SHOW DOWN ***
6l4ck: shows [Qs Ac] (two pair, Queens and Fives)
Philheil: mucks hand 
6l4ck collected $8.06 from pot
*** SUMMARY ***
Total pot $8.48 | Rake $0.42 
Board [9s 4d 5c Qh 5s]
Seat 1: 6l4ck showed [Qs Ac] and won ($8.06) with two pair, Queens and Fives
Seat 2: VTcomp folded before Flop (didn't bet)
Seat 3: o-chan1986 folded before Flop (didn't bet)
Seat 4: Lisenok110 folded before Flop (didn't bet)
Seat 5: artemxxl folded before Flop (didn't bet)
Seat 6: hheman folded before Flop (didn't bet)
Seat 7: takakensu (button) folded before Flop (didn't bet)
Seat 8: Philheil (small blind) mucked
Seat 9: siskin vrach (big blind) folded before Flop



PokerStars Hand #228680817848:  Hold'em No Limit ($0.25/$0.50 USD) - 2021/07/30 11:11:29 ET
Table 'Aitne III' 9-max Seat #8 is the button
Seat 1: 6l4ck ($123.41 in chips) 
Seat 2: VTcomp ($61.71 in chips) 
Seat 3: o-chan1986 ($45.32 in chips) 
Seat 4: Lisenok110 ($68.39 in chips) 
Seat 5: artemxxl ($103.26 in chips) 
Seat 6: hheman ($50 in chips) 
Seat 7: takakensu ($117.43 in chips) 
Seat 8: Philheil ($2.21 in chips) 
Seat 9: siskin vrach ($50 in chips) 
siskin vrach: posts small blind $0.25
6l4ck: posts big blind $0.50
*** HOLE CARDS ***
VTcomp: raises $1 to $1.50
o-chan1986: folds 
Lisenok110 has timed out
Lisenok110: folds 
artemxxl: folds 
hheman: folds 
takakensu: folds 
Philheil: raises $0.71 to $2.21 and is all-in
siskin vrach: calls $1.96
6l4ck: folds 
VTcomp: calls $0.71
*** FLOP *** [2c Jh 3c]
siskin vrach: checks 
VTcomp: bets $3.39
siskin vrach: folds 
Uncalled bet ($3.39) returned to VTcomp
*** TURN *** [2c Jh 3c] [Js]
*** RIVER *** [2c Jh 3c Js] [Td]
*** SHOW DOWN ***
VTcomp: shows [9c 9s] (two pair, Jacks and Nines)
Philheil: shows [Ad 5h] (a pair of Jacks)
VTcomp collected $6.77 from pot
*** SUMMARY ***
Total pot $7.13 | Rake $0.36 
Board [2c Jh 3c Js Td]
Seat 1: 6l4ck (big blind) folded before Flop
Seat 2: VTcomp showed [9c 9s] and won ($6.77) with two pair, Jacks and Nines
Seat 3: o-chan1986 folded before Flop (didn't bet)
Seat 4: Lisenok110 folded before Flop (didn't bet)
Seat 5: artemxxl folded before Flop (didn't bet)
Seat 6: hheman folded before Flop (didn't bet)
Seat 7: takakensu folded before Flop (didn't bet)
Seat 8: Philheil (button) showed [Ad 5h] and lost with a pair of Jacks
Seat 9: siskin vrach (small blind) folded on the Flop



PokerStars Hand #228680840313:  Hold'em No Limit ($0.25/$0.50 USD) - 2021/07/30 11:12:35 ET
Table 'Aitne III' 9-max Seat #9 is the button
Seat 1: 6l4ck ($122.91 in chips) 
Seat 2: VTcomp ($66.27 in chips) 
Seat 3: o-chan1986 ($45.32 in chips) 
Seat 4: Lisenok110 ($68.39 in chips) 
Seat 5: artemxxl ($103.26 in chips) 
Seat 6: hheman ($50 in chips) 
Seat 7: takakensu ($117.43 in chips) 
Seat 9: siskin vrach ($50 in chips) 
6l4ck: posts small blind $0.25
VTcomp: posts big blind $0.50
*** HOLE CARDS ***
o-chan1986: folds 
Lisenok110: folds 
artemxxl: folds 
hheman: folds 
takakensu: folds 
siskin vrach: folds 
Philheil leaves the table
6l4ck: raises $1 to $1.50
VTcomp: folds 
Uncalled bet ($1) returned to 6l4ck
6l4ck collected $1 from pot
6l4ck: doesn't show hand 
*** SUMMARY ***
Total pot $1 | Rake $0 
Seat 1: 6l4ck (small blind) collected ($1)
Seat 2: VTcomp (big blind) folded before Flop
Seat 3: o-chan1986 folded before Flop (didn't bet)
Seat 4: Lisenok110 folded before Flop (didn't bet)
Seat 5: artemxxl folded before Flop (didn't bet)
Seat 6: hheman folded before Flop (didn't bet)
Seat 7: takakensu folded before Flop (didn't bet)
Seat 9: siskin vrach (button) folded before Flop (didn't bet)



PokerStars Hand #228680846728:  Hold'em No Limit ($0.25/$0.50 USD) - 2021/07/30 11:12:55 ET
Table 'Aitne III' 9-max Seat #1 is the button
Seat 1: 6l4ck ($123.41 in chips) 
Seat 2: VTcomp ($65.77 in chips) 
Seat 3: o-chan1986 ($45.32 in chips) 
Seat 4: Lisenok110 ($68.39 in chips) 
Seat 5: artemxxl ($103.26 in chips) 
Seat 6: hheman ($50 in chips) 
Seat 7: takakensu ($117.43 in chips) 
Seat 9: siskin vrach ($50 in chips) 
VTcomp: posts small blind $0.25
o-chan1986: posts big blind $0.50
*** HOLE CARDS ***
Lisenok110 has timed out
Lisenok110: folds 
artemxxl: folds 
hheman: folds 
takakensu: folds 
siskin vrach: folds 
6l4ck: folds 
VTcomp: folds 
Uncalled bet ($0.25) returned to o-chan1986
o-chan1986 collected $0.50 from pot
o-chan1986: doesn't show hand 
*** SUMMARY ***
Total pot $0.50 | Rake $0 
Seat 1: 6l4ck (button) folded before Flop (didn't bet)
Seat 2: VTcomp (small blind) folded before Flop
Seat 3: o-chan1986 (big blind) collected ($0.50)
Seat 4: Lisenok110 folded before Flop (didn't bet)
Seat 5: artemxxl folded before Flop (didn't bet)
Seat 6: hheman folded before Flop (didn't bet)
Seat 7: takakensu folded before Flop (didn't bet)
Seat 9: siskin vrach folded before Flop (didn't bet)



PokerStars Hand #228680852961:  Hold'em No Limit ($0.25/$0.50 USD) - 2021/07/30 11:13:13 ET
Table 'Aitne III' 9-max Seat #2 is the button
Seat 1: 6l4ck ($123.41 in chips) 
Seat 2: VTcomp ($65.52 in chips) 
Seat 3: o-chan1986 ($45.57 in chips) 
Seat 6: hheman ($50 in chips) 
Seat 7: takakensu ($117.43 in chips) 
Seat 9: siskin vrach ($50 in chips) 
o-chan1986: posts small blind $0.25
artemxxl: is sitting out 
hheman: posts big blind $0.50
*** HOLE CARDS ***
artemxxl leaves the table
takakensu: folds 
MKennyRltr joins the table at seat #8 
11omsk11 joins the table at seat #5 
siskin vrach: folds 
6l4ck: folds 
Lisenok110 leaves the table
VTcomp: raises $1 to $1.50
o-chan1986: folds 
hheman: folds 
Uncalled bet ($1) returned to VTcomp
VTcomp collected $1.25 from pot
VTcomp: doesn't show hand 
*** SUMMARY ***
Total pot $1.25 | Rake $0 
Seat 1: 6l4ck folded before Flop (didn't bet)
Seat 2: VTcomp (button) collected ($1.25)
Seat 3: o-chan1986 (small blind) folded before Flop
Seat 6: hheman (big blind) folded before Flop
Seat 7: takakensu folded before Flop (didn't bet)
Seat 9: siskin vrach folded before Flop (didn't bet)



PokerStars Hand #228680857427:  Hold'em No Limit ($0.25/$0.50 USD) - 2021/07/30 11:13:27 ET
Table 'Aitne III' 9-max Seat #3 is the button
Seat 1: 6l4ck ($123.41 in chips) 
Seat 2: VTcomp ($66.27 in chips) 
Seat 3: o-chan1986 ($45.32 in chips) 
Seat 6: hheman ($50 in chips) 
Seat 7: takakensu ($117.43 in chips) 
Seat 8: MKennyRltr ($40 in chips) 
Seat 9: siskin vrach ($50 in chips) 
hheman: posts small blind $0.25
takakensu: posts big blind $0.50
MKennyRltr: posts big blind $0.50
*** HOLE CARDS ***
vkfls joins the table at seat #4 
MKennyRltr: checks 
siskin vrach: folds 
6l4ck: folds 
VTcomp: folds 
o-chan1986: folds 
hheman: folds 
takakensu: raises $1 to $1.50
MKennyRltr: calls $1
*** FLOP *** [6h Kc Qd]
takakensu: bets $3.09
MKennyRltr: folds 
Uncalled bet ($3.09) returned to takakensu
takakensu collected $3.09 from pot
takakensu: doesn't show hand 
*** SUMMARY ***
Total pot $3.25 | Rake $0.16 
Board [6h Kc Qd]
Seat 1: 6l4ck folded before Flop (didn't bet)
Seat 2: VTcomp folded before Flop (didn't bet)
Seat 3: o-chan1986 (button) folded before Flop (didn't bet)
Seat 6: hheman (small blind) folded before Flop
Seat 7: takakensu (big blind) collected ($3.09)
Seat 8: MKennyRltr folded on the Flop
Seat 9: siskin vrach folded before Flop (didn't bet)



PokerStars Hand #228680868287:  Hold'em No Limit ($0.25/$0.50 USD) - 2021/07/30 11:13:59 ET
Table 'Aitne III' 9-max Seat #6 is the button
Seat 1: 6l4ck ($123.41 in chips) 
Seat 2: VTcomp ($66.27 in chips) 
Seat 3: o-chan1986 ($45.32 in chips) 
Seat 4: vkfls ($50 in chips) 
Seat 6: hheman ($50 in chips) 
Seat 7: takakensu ($119.02 in chips) 
Seat 8: MKennyRltr ($38.50 in chips) 
Seat 9: siskin vrach ($50 in chips) 
takakensu: posts small blind $0.25
MKennyRltr: posts big blind $0.50
vkfls: posts big blind $0.50
11omsk11: sits out 
*** HOLE CARDS ***
siskin vrach: folds 
6l4ck: folds 
VTcomp: folds 
o-chan1986: folds 
vkfls: checks 
hheman: folds 
takakensu: folds 
MKennyRltr: checks 
*** FLOP *** [Kc 6h Qs]
MKennyRltr: checks 
vkfls: bets $0.89
MKennyRltr: calls $0.89
*** TURN *** [Kc 6h Qs] [Ad]
MKennyRltr: checks 
vkfls: checks 
*** RIVER *** [Kc 6h Qs Ad] [6d]
MKennyRltr: checks 
vkfls: checks 
*** SHOW DOWN ***
MKennyRltr: shows [Th Qc] (two pair, Queens and Sixes)
vkfls: mucks hand 
MKennyRltr collected $2.88 from pot
*** SUMMARY ***
Total pot $3.03 | Rake $0.15 
Board [Kc 6h Qs Ad 6d]
Seat 1: 6l4ck folded before Flop (didn't bet)
Seat 2: VTcomp folded before Flop (didn't bet)
Seat 3: o-chan1986 folded before Flop (didn't bet)
Seat 4: vkfls mucked
Seat 6: hheman (button) folded before Flop (didn't bet)
Seat 7: takakensu (small blind) folded before Flop
Seat 8: MKennyRltr (big blind) showed [Th Qc] and won ($2.88) with two pair, Queens and Sixes
Seat 9: siskin vrach folded before Flop (didn't bet)



PokerStars Hand #228680881524:  Hold'em No Limit ($0.25/$0.50 USD) - 2021/07/30 11:14:39 ET
Table 'Aitne III' 9-max Seat #7 is the button
Seat 1: 6l4ck ($123.41 in chips) 
Seat 2: VTcomp ($66.27 in chips) 
Seat 3: o-chan1986 ($45.32 in chips) 
Seat 4: vkfls ($50 in chips) 
Seat 6: hheman ($50 in chips) 
Seat 7: takakensu ($118.77 in chips) 
Seat 8: MKennyRltr ($39.99 in chips) 
Seat 9: siskin vrach ($50 in chips) 
MKennyRltr: posts small blind $0.25
siskin vrach: posts big blind $0.50
11omsk11: sits out 
*** HOLE CARDS ***
6l4ck: folds 
VTcomp: folds 
o-chan1986: raises $0.75 to $1.25
vkfls: folds 
hheman: folds 
takakensu: folds 
MKennyRltr: folds 
siskin vrach: raises $3.25 to $4.50
o-chan1986: folds 
Uncalled bet ($3.25) returned to siskin vrach
siskin vrach collected $2.75 from pot
*** SUMMARY ***
Total pot $2.75 | Rake $0 
Seat 1: 6l4ck folded before Flop (didn't bet)
Seat 2: VTcomp folded before Flop (didn't bet)
Seat 3: o-chan1986 folded before Flop
Seat 4: vkfls folded before Flop (didn't bet)
Seat 6: hheman folded before Flop (didn't bet)
Seat 7: takakensu (button) folded before Flop (didn't bet)
Seat 8: MKennyRltr (small blind) folded before Flop
Seat 9: siskin vrach (big blind) collected ($2.75)



PokerStars Hand #228680888001:  Hold'em No Limit ($0.25/$0.50 USD) - 2021/07/30 11:14:59 ET
Table 'Aitne III' 9-max Seat #8 is the button
Seat 1: 6l4ck ($123.41 in chips) 
Seat 2: VTcomp ($66.27 in chips) 
Seat 3: o-chan1986 ($44.07 in chips) 
Seat 4: vkfls ($50 in chips) 
Seat 6: hheman ($50 in chips) 
Seat 7: takakensu ($118.77 in chips) 
Seat 8: MKennyRltr ($39.74 in chips) 
Seat 9: siskin vrach ($51.50 in chips) 
siskin vrach: posts small blind $0.25
6l4ck: posts big blind $0.50
11omsk11: sits out 
*** HOLE CARDS ***
VTcomp: raises $1 to $1.50
o-chan1986: folds 
vkfls: folds 
hheman: folds 
takakensu: folds 
MKennyRltr: folds 
siskin vrach: folds 
6l4ck: folds 
Uncalled bet ($1) returned to VTcomp
VTcomp collected $1.25 from pot
VTcomp: doesn't show hand 
*** SUMMARY ***
Total pot $1.25 | Rake $0 
Seat 1: 6l4ck (big blind) folded before Flop
Seat 2: VTcomp collected ($1.25)
Seat 3: o-chan1986 folded before Flop (didn't bet)
Seat 4: vkfls folded before Flop (didn't bet)
Seat 6: hheman folded before Flop (didn't bet)
Seat 7: takakensu folded before Flop (didn't bet)
Seat 8: MKennyRltr (button) folded before Flop (didn't bet)
Seat 9: siskin vrach (small blind) folded before Flop



PokerStars Hand #228680893825:  Hold'em No Limit ($0.25/$0.50 USD) - 2021/07/30 11:15:16 ET
Table 'Aitne III' 9-max Seat #9 is the button
Seat 1: 6l4ck ($122.91 in chips) 
Seat 2: VTcomp ($67.02 in chips) 
Seat 3: o-chan1986 ($44.07 in chips) 
Seat 4: vkfls ($50 in chips) 
Seat 6: hheman ($50 in chips) 
Seat 7: takakensu ($118.77 in chips) 
Seat 8: MKennyRltr ($39.74 in chips) 
Seat 9: siskin vrach ($51.25 in chips) 
6l4ck: posts small blind $0.25
VTcomp: posts big blind $0.50
11omsk11: sits out 
*** HOLE CARDS ***
o-chan1986: folds 
vkfls: folds 
hheman: folds 
takakensu: folds 
MKennyRltr: folds 
siskin vrach: folds 
6l4ck: folds 
Uncalled bet ($0.25) returned to VTcomp
VTcomp collected $0.50 from pot
VTcomp: doesn't show hand 
*** SUMMARY ***
Total pot $0.50 | Rake $0 
Seat 1: 6l4ck (small blind) folded before Flop
Seat 2: VTcomp (big blind) collected ($0.50)
Seat 3: o-chan1986 folded before Flop (didn't bet)
Seat 4: vkfls folded before Flop (didn't bet)
Seat 6: hheman folded before Flop (didn't bet)
Seat 7: takakensu folded before Flop (didn't bet)
Seat 8: MKennyRltr folded before Flop (didn't bet)
Seat 9: siskin vrach (button) folded before Flop (didn't bet)



PokerStars Hand #228680898585:  Hold'em No Limit ($0.25/$0.50 USD) - 2021/07/30 11:15:30 ET
Table 'Aitne III' 9-max Seat #1 is the button
Seat 1: 6l4ck ($122.66 in chips) 
Seat 2: VTcomp ($67.27 in chips) 
Seat 3: o-chan1986 ($44.07 in chips) 
Seat 4: vkfls ($50 in chips) 
Seat 6: hheman ($50 in chips) 
Seat 7: takakensu ($118.77 in chips) 
Seat 8: MKennyRltr ($39.74 in chips) 
Seat 9: siskin vrach ($51.25 in chips) 
VTcomp: posts small blind $0.25
o-chan1986: posts big blind $0.50
11omsk11: sits out 
*** HOLE CARDS ***
vkfls: folds 
hheman: folds 
takakensu: raises $1 to $1.50
MKennyRltr: folds 
siskin vrach: folds 
6l4ck: folds 
VTcomp: folds 
o-chan1986: calls $1
*** FLOP *** [Tc 9s Js]
o-chan1986: checks 
takakensu: bets $1.54
o-chan1986: calls $1.54
*** TURN *** [Tc 9s Js] [Jh]
o-chan1986: checks 
takakensu: bets $3
o-chan1986: calls $3
*** RIVER *** [Tc 9s Js Jh] [9c]
o-chan1986: checks 
takakensu: checks 
*** SHOW DOWN ***
o-chan1986: shows [8c Kh] (two pair, Jacks and Nines)
takakensu: shows [Kc Th] (two pair, Jacks and Tens)
takakensu collected $11.71 from pot
*** SUMMARY ***
Total pot $12.33 | Rake $0.62 
Board [Tc 9s Js Jh 9c]
Seat 1: 6l4ck (button) folded before Flop (didn't bet)
Seat 2: VTcomp (small blind) folded before Flop
Seat 3: o-chan1986 (big blind) showed [8c Kh] and lost with two pair, Jacks and Nines
Seat 4: vkfls folded before Flop (didn't bet)
Seat 6: hheman folded before Flop (didn't bet)
Seat 7: takakensu showed [Kc Th] and won ($11.71) with two pair, Jacks and Tens
Seat 8: MKennyRltr folded before Flop (didn't bet)
Seat 9: siskin vrach folded before Flop (didn't bet)



PokerStars Hand #228680911507:  Hold'em No Limit ($0.25/$0.50 USD) - 2021/07/30 11:16:09 ET
Table 'Aitne III' 9-max Seat #2 is the button
Seat 1: 6l4ck ($122.66 in chips) 
Seat 2: VTcomp ($67.02 in chips) 
Seat 3: o-chan1986 ($38.03 in chips) 
Seat 4: vkfls ($50 in chips) 
Seat 6: hheman ($50 in chips) 
Seat 7: takakensu ($124.44 in chips) 
Seat 8: MKennyRltr ($39.74 in chips) 
Seat 9: siskin vrach ($51.25 in chips) 
o-chan1986: posts small blind $0.25
vkfls: posts big blind $0.50
11omsk11: sits out 
*** HOLE CARDS ***
hheman: folds 
takakensu: folds 
MKennyRltr: folds 
siskin vrach: folds 
6l4ck: folds 
VTcomp: folds 
o-chan1986: raises $0.75 to $1.25
vkfls: folds 
Uncalled bet ($0.75) returned to o-chan1986
o-chan1986 collected $1 from pot
o-chan1986: doesn't show hand 
*** SUMMARY ***
Total pot $1 | Rake $0 
Seat 1: 6l4ck folded before Flop (didn't bet)
Seat 2: VTcomp (button) folded before Flop (didn't bet)
Seat 3: o-chan1986 (small blind) collected ($1)
Seat 4: vkfls (big blind) folded before Flop
Seat 6: hheman folded before Flop (didn't bet)
Seat 7: takakensu folded before Flop (didn't bet)
Seat 8: MKennyRltr folded before Flop (didn't bet)
Seat 9: siskin vrach folded before Flop (didn't bet)



PokerStars Hand #228680917765:  Hold'em No Limit ($0.25/$0.50 USD) - 2021/07/30 11:16:28 ET
Table 'Aitne III' 9-max Seat #3 is the button
Seat 1: 6l4ck ($122.66 in chips) 
Seat 2: VTcomp ($67.02 in chips) 
Seat 3: o-chan1986 ($38.53 in chips) 
Seat 4: vkfls ($50 in chips) 
Seat 5: 11omsk11 ($50 in chips) 
Seat 6: hheman ($50 in chips) 
Seat 7: takakensu ($124.44 in chips) 
Seat 8: MKennyRltr ($39.74 in chips) 
Seat 9: siskin vrach ($51.25 in chips) 
vkfls: posts small blind $0.25
11omsk11: posts big blind $0.50
*** HOLE CARDS ***
hheman: folds 
takakensu: folds 
MKennyRltr: folds 
siskin vrach: folds 
6l4ck: folds 
VTcomp: folds 
o-chan1986: folds 
vkfls: folds 
Uncalled bet ($0.25) returned to 11omsk11
11omsk11 collected $0.50 from pot
11omsk11: doesn't show hand 
*** SUMMARY ***
Total pot $0.50 | Rake $0 
Seat 1: 6l4ck folded before Flop (didn't bet)
Seat 2: VTcomp folded before Flop (didn't bet)
Seat 3: o-chan1986 (button) folded before Flop (didn't bet)
Seat 4: vkfls (small blind) folded before Flop
Seat 5: 11omsk11 (big blind) collected ($0.50)
Seat 6: hheman folded before Flop (didn't bet)
Seat 7: takakensu folded before Flop (didn't bet)
Seat 8: MKennyRltr folded before Flop (didn't bet)
Seat 9: siskin vrach folded before Flop (didn't bet)



PokerStars Hand #228680922205:  Hold'em No Limit ($0.25/$0.50 USD) - 2021/07/30 11:16:41 ET
Table 'Aitne III' 9-max Seat #4 is the button
Seat 1: 6l4ck ($122.66 in chips) 
Seat 2: VTcomp ($67.02 in chips) 
Seat 3: o-chan1986 ($38.53 in chips) 
Seat 4: vkfls ($50 in chips) 
Seat 5: 11omsk11 ($50.25 in chips) 
Seat 6: hheman ($50 in chips) 
Seat 7: takakensu ($124.44 in chips) 
Seat 8: MKennyRltr ($39.74 in chips) 
Seat 9: siskin vrach ($51.25 in chips) 
11omsk11: posts small blind $0.25
hheman: posts big blind $0.50
*** HOLE CARDS ***
takakensu: folds 
MKennyRltr: calls $0.50
siskin vrach: folds 
6l4ck: folds 
VTcomp: folds 
o-chan1986: folds 
vkfls: folds 
11omsk11: folds 
hheman: checks 
*** FLOP *** [Ah 3c 7h]
hheman: checks 
MKennyRltr: bets $0.50
hheman: folds 
Uncalled bet ($0.50) returned to MKennyRltr
MKennyRltr collected $1.19 from pot
MKennyRltr: doesn't show hand 
*** SUMMARY ***
Total pot $1.25 | Rake $0.06 
Board [Ah 3c 7h]
Seat 1: 6l4ck folded before Flop (didn't bet)
Seat 2: VTcomp folded before Flop (didn't bet)
Seat 3: o-chan1986 folded before Flop (didn't bet)
Seat 4: vkfls (button) folded before Flop (didn't bet)
Seat 5: 11omsk11 (small blind) folded before Flop
Seat 6: hheman (big blind) folded on the Flop
Seat 7: takakensu folded before Flop (didn't bet)
Seat 8: MKennyRltr collected ($1.19)
Seat 9: siskin vrach folded before Flop (didn't bet)



PokerStars Hand #228680932931:  Hold'em No Limit ($0.25/$0.50 USD) - 2021/07/30 11:17:12 ET
Table 'Aitne III' 9-max Seat #5 is the button
Seat 1: 6l4ck ($122.66 in chips) 
Seat 2: VTcomp ($67.02 in chips) 
Seat 3: o-chan1986 ($38.53 in chips) 
Seat 4: vkfls ($50 in chips) 
Seat 5: 11omsk11 ($50 in chips) 
Seat 6: hheman ($50 in chips) 
Seat 7: takakensu ($124.44 in chips) 
Seat 8: MKennyRltr ($40.43 in chips) 
Seat 9: siskin vrach ($51.25 in chips) 
hheman: posts small blind $0.25
takakensu: posts big blind $0.50
*** HOLE CARDS ***
MKennyRltr: folds 
siskin vrach: folds 
6l4ck: raises $1 to $1.50
VTcomp: folds 
o-chan1986: folds 
vkfls: folds 
11omsk11: folds 
hheman: raises $3.50 to $5
takakensu: folds 
6l4ck: calls $3.50
*** FLOP *** [9h Qs 9s]
hheman: bets $5
6l4ck: calls $5
*** TURN *** [9h Qs 9s] [Kh]
hheman: bets $10
6l4ck: raises $102.66 to $112.66 and is all-in
hheman: folds 
Uncalled bet ($102.66) returned to 6l4ck
6l4ck collected $38.50 from pot
6l4ck: doesn't show hand 
*** SUMMARY ***
Total pot $40.50 | Rake $2 
Board [9h Qs 9s Kh]
Seat 1: 6l4ck collected ($38.50)
Seat 2: VTcomp folded before Flop (didn't bet)
Seat 3: o-chan1986 folded before Flop (didn't bet)
Seat 4: vkfls folded before Flop (didn't bet)
Seat 5: 11omsk11 (button) folded before Flop (didn't bet)
Seat 6: hheman (small blind) folded on the Turn
Seat 7: takakensu (big blind) folded before Flop
Seat 8: MKennyRltr folded before Flop (didn't bet)
Seat 9: siskin vrach folded before Flop (didn't bet)



PokerStars Hand #228680959726:  Hold'em No Limit ($0.25/$0.50 USD) - 2021/07/30 11:18:33 ET
Table 'Aitne III' 9-max Seat #6 is the button
Seat 1: 6l4ck ($141.16 in chips) 
Seat 2: VTcomp ($67.02 in chips) 
Seat 3: o-chan1986 ($38.53 in chips) 
Seat 4: vkfls ($50 in chips) 
Seat 5: 11omsk11 ($50 in chips) 
Seat 6: hheman ($50 in chips) 
Seat 7: takakensu ($123.94 in chips) 
Seat 8: MKennyRltr ($40.43 in chips) 
Seat 9: siskin vrach ($51.25 in chips) 
takakensu: posts small blind $0.25
MKennyRltr: posts big blind $0.50
*** HOLE CARDS ***
siskin vrach: raises $1 to $1.50
6l4ck: folds 
VTcomp: folds 
o-chan1986: calls $1.50
vkfls: folds 
11omsk11: folds 
hheman: folds 
takakensu: raises $2 to $3.50
MKennyRltr: folds 
siskin vrach: calls $2
o-chan1986: calls $2
*** FLOP *** [4s As 3c]
takakensu: bets $5.22
siskin vrach: folds 
o-chan1986: folds 
Uncalled bet ($5.22) returned to takakensu
takakensu collected $10.45 from pot
takakensu: doesn't show hand 
*** SUMMARY ***
Total pot $11 | Rake $0.55 
Board [4s As 3c]
Seat 1: 6l4ck folded before Flop (didn't bet)
Seat 2: VTcomp folded before Flop (didn't bet)
Seat 3: o-chan1986 folded on the Flop
Seat 4: vkfls folded before Flop (didn't bet)
Seat 5: 11omsk11 folded before Flop (didn't bet)
Seat 6: hheman (button) folded before Flop (didn't bet)
Seat 7: takakensu (small blind) collected ($10.45)
Seat 8: MKennyRltr (big blind) folded before Flop
Seat 9: siskin vrach folded on the Flop



PokerStars Hand #228680975838:  Hold'em No Limit ($0.25/$0.50 USD) - 2021/07/30 11:19:20 ET
Table 'Aitne III' 9-max Seat #7 is the button
Seat 1: 6l4ck ($141.16 in chips) 
Seat 2: VTcomp ($67.02 in chips) 
Seat 3: o-chan1986 ($35.03 in chips) 
Seat 4: vkfls ($50 in chips) 
Seat 5: 11omsk11 ($50 in chips) 
Seat 6: hheman ($50 in chips) 
Seat 7: takakensu ($130.89 in chips) 
Seat 8: MKennyRltr ($39.93 in chips) 
Seat 9: siskin vrach ($50 in chips) 
MKennyRltr: posts small blind $0.25
siskin vrach: posts big blind $0.50
*** HOLE CARDS ***
6l4ck: folds 
6l4ck leaves the table
VTcomp: folds 
o-chan1986: folds 
vkfls: folds 
11omsk11: folds 
hheman: folds 
takakensu: folds 
MKennyRltr: folds 
Uncalled bet ($0.25) returned to siskin vrach
siskin vrach collected $0.50 from pot
*** SUMMARY ***
Total pot $0.50 | Rake $0 
Seat 1: 6l4ck folded before Flop (didn't bet)
Seat 2: VTcomp folded before Flop (didn't bet)
Seat 3: o-chan1986 folded before Flop (didn't bet)
Seat 4: vkfls folded before Flop (didn't bet)
Seat 5: 11omsk11 folded before Flop (didn't bet)
Seat 6: hheman folded before Flop (didn't bet)
Seat 7: takakensu (button) folded before Flop (didn't bet)
Seat 8: MKennyRltr (small blind) folded before Flop
Seat 9: siskin vrach (big blind) collected ($0.50)



PokerStars Hand #228680981084:  Hold'em No Limit ($0.25/$0.50 USD) - 2021/07/30 11:19:36 ET
Table 'Aitne III' 9-max Seat #8 is the button
Seat 2: VTcomp ($67.02 in chips) 
Seat 3: o-chan1986 ($35.03 in chips) 
Seat 4: vkfls ($50 in chips) 
Seat 5: 11omsk11 ($50 in chips) 
Seat 6: hheman ($50 in chips) 
Seat 7: takakensu ($130.89 in chips) 
Seat 8: MKennyRltr ($39.68 in chips) 
Seat 9: siskin vrach ($50.25 in chips) 
siskin vrach: posts small blind $0.25
VTcomp: posts big blind $0.50
*** HOLE CARDS ***
CocoAlexMix joins the table at seat #1 
o-chan1986: folds 
vkfls: folds 
11omsk11: raises $1 to $1.50
hheman: folds 
takakensu: folds 
MKennyRltr: folds 
siskin vrach: folds 
VTcomp: folds 
Uncalled bet ($1) returned to 11omsk11
11omsk11 collected $1.25 from pot
11omsk11: doesn't show hand 
*** SUMMARY ***
Total pot $1.25 | Rake $0 
Seat 2: VTcomp (big blind) folded before Flop
Seat 3: o-chan1986 folded before Flop (didn't bet)
Seat 4: vkfls folded before Flop (didn't bet)
Seat 5: 11omsk11 collected ($1.25)
Seat 6: hheman folded before Flop (didn't bet)
Seat 7: takakensu folded before Flop (didn't bet)
Seat 8: MKennyRltr (button) folded before Flop (didn't bet)
Seat 9: siskin vrach (small blind) folded before Flop



PokerStars Hand #228680990137:  Hold'em No Limit ($0.25/$0.50 USD) - 2021/07/30 11:19:54 ET
Table 'Aitne III' 9-max Seat #9 is the button
Seat 2: VTcomp ($66.52 in chips) 
Seat 3: o-chan1986 ($35.03 in chips) 
Seat 4: vkfls ($50 in chips) 
Seat 5: 11omsk11 ($50.75 in chips) 
Seat 6: hheman ($50 in chips) 
Seat 7: takakensu ($130.89 in chips) 
Seat 8: MKennyRltr ($39.68 in chips) 
Seat 9: siskin vrach ($50 in chips) 
VTcomp: posts small blind $0.25
o-chan1986: posts big blind $0.50
*** HOLE CARDS ***
vkfls: folds 
11omsk11: folds 
hheman: folds 
takakensu: folds 
MKennyRltr: folds 
siskin vrach: raises $1 to $1.50
VTcomp: folds 
o-chan1986: folds 
Uncalled bet ($1) returned to siskin vrach
siskin vrach collected $1.25 from pot
*** SUMMARY ***
Total pot $1.25 | Rake $0 
Seat 2: VTcomp (small blind) folded before Flop
Seat 3: o-chan1986 (big blind) folded before Flop
Seat 4: vkfls folded before Flop (didn't bet)
Seat 5: 11omsk11 folded before Flop (didn't bet)
Seat 6: hheman folded before Flop (didn't bet)
Seat 7: takakensu folded before Flop (didn't bet)
Seat 8: MKennyRltr folded before Flop (didn't bet)
Seat 9: siskin vrach (button) collected ($1.25)



PokerStars Hand #228681565822:  Hold'em No Limit ($0.25/$0.50 USD) - 2021/07/30 11:47:54 ET
Table 'Aitne III' 9-max Seat #9 is the button
Seat 1: alex_matsuka ($50 in chips) 
Seat 2: zheka656 ($53.75 in chips) 
Seat 3: Lemmi846 ($50 in chips) 
Seat 4: JoePsycho ($56.59 in chips) 
Seat 5: chiruha0523 ($38.50 in chips) 
Seat 7: AlexEliseev7 ($51.12 in chips) 
Seat 8: MKennyRltr ($31.19 in chips) 
Seat 9: siskin vrach ($59.13 in chips) 
alex_matsuka: posts small blind $0.25
zheka656: posts big blind $0.50
RipZip: sits out 
*** HOLE CARDS ***
Lemmi846: folds 
JoePsycho: folds 
chiruha0523: folds 
AlexEliseev7: folds 
MKennyRltr: calls $0.50
siskin vrach: folds 
alex_matsuka: folds 
zheka656: checks 
*** FLOP *** [3h 2c 7h]
zheka656: checks 
MKennyRltr: checks 
*** TURN *** [3h 2c 7h] [Ad]
zheka656: checks 
MKennyRltr: checks 
*** RIVER *** [3h 2c 7h Ad] [5d]
zheka656: checks 
MKennyRltr: checks 
*** SHOW DOWN ***
zheka656: shows [4s 4c] (a straight, Ace to Five)
MKennyRltr: mucks hand 
zheka656 collected $1.19 from pot
*** SUMMARY ***
Total pot $1.25 | Rake $0.06 
Board [3h 2c 7h Ad 5d]
Seat 1: alex_matsuka (small blind) folded before Flop
Seat 2: zheka656 (big blind) showed [4s 4c] and won ($1.19) with a straight, Ace to Five
Seat 3: Lemmi846 folded before Flop (didn't bet)
Seat 4: JoePsycho folded before Flop (didn't bet)
Seat 5: chiruha0523 folded before Flop (didn't bet)
Seat 7: AlexEliseev7 folded before Flop (didn't bet)
Seat 8: MKennyRltr mucked
Seat 9: siskin vrach (button) folded before Flop (didn't bet)



PokerStars Hand #228681574451:  Hold'em No Limit ($0.25/$0.50 USD) - 2021/07/30 11:48:20 ET
Table 'Aitne III' 9-max Seat #1 is the button
Seat 1: alex_matsuka ($50 in chips) 
Seat 2: zheka656 ($54.44 in chips) 
Seat 3: Lemmi846 ($50 in chips) 
Seat 4: JoePsycho ($56.59 in chips) 
Seat 5: chiruha0523 ($38.50 in chips) 
Seat 7: AlexEliseev7 ($51.12 in chips) 
Seat 8: MKennyRltr ($30.69 in chips) 
Seat 9: siskin vrach ($59.13 in chips) 
zheka656: posts small blind $0.25
Lemmi846: posts big blind $0.50
RipZip: sits out 
*** HOLE CARDS ***
JoePsycho: folds 
chiruha0523: folds 
AlexEliseev7: folds 
MKennyRltr: folds 
siskin vrach: folds 
alex_matsuka: raises $1 to $1.50
zheka656: folds 
Lemmi846: raises $4 to $5.50
alex_matsuka: calls $4
*** FLOP *** [Jd 4c 6h]
Lemmi846: bets $7.50
alex_matsuka: calls $7.50
*** TURN *** [Jd 4c 6h] [Ah]
Lemmi846: checks 
alex_matsuka: checks 
*** RIVER *** [Jd 4c 6h Ah] [2c]
Lemmi846: checks 
alex_matsuka: bets $17.50
Lemmi846: folds 
Uncalled bet ($17.50) returned to alex_matsuka
alex_matsuka collected $24.94 from pot
alex_matsuka: doesn't show hand 
*** SUMMARY ***
Total pot $26.25 | Rake $1.31 
Board [Jd 4c 6h Ah 2c]
Seat 1: alex_matsuka (button) collected ($24.94)
Seat 2: zheka656 (small blind) folded before Flop
Seat 3: Lemmi846 (big blind) folded on the River
Seat 4: JoePsycho folded before Flop (didn't bet)
Seat 5: chiruha0523 folded before Flop (didn't bet)
Seat 7: AlexEliseev7 folded before Flop (didn't bet)
Seat 8: MKennyRltr folded before Flop (didn't bet)
Seat 9: siskin vrach folded before Flop (didn't bet)



PokerStars Hand #228681609873:  Hold'em No Limit ($0.25/$0.50 USD) - 2021/07/30 11:50:03 ET
Table 'Aitne III' 9-max Seat #2 is the button
Seat 1: alex_matsuka ($61.94 in chips) 
Seat 2: zheka656 ($54.19 in chips) 
Seat 3: Lemmi846 ($50 in chips) 
Seat 4: JoePsycho ($56.59 in chips) 
Seat 5: chiruha0523 ($38.50 in chips) 
Seat 7: AlexEliseev7 ($51.12 in chips) 
Seat 8: MKennyRltr ($30.69 in chips) 
Seat 9: siskin vrach ($59.13 in chips) 
Lemmi846: posts small blind $0.25
JoePsycho: posts big blind $0.50
RipZip: sits out 
*** HOLE CARDS ***
chiruha0523: raises $1 to $1.50
AlexEliseev7: folds 
MKennyRltr: folds 
siskin vrach: calls $1.50
alex_matsuka: calls $1.50
zheka656: folds 
Lemmi846: folds 
JoePsycho: calls $1
*** FLOP *** [9h 9d 5h]
JoePsycho: checks 
chiruha0523: checks 
siskin vrach: checks 
alex_matsuka: bets $2.67
JoePsycho: folds 
chiruha0523: folds 
siskin vrach: folds 
Uncalled bet ($2.67) returned to alex_matsuka
alex_matsuka collected $5.94 from pot
alex_matsuka: doesn't show hand 
*** SUMMARY ***
Total pot $6.25 | Rake $0.31 
Board [9h 9d 5h]
Seat 1: alex_matsuka collected ($5.94)
Seat 2: zheka656 (button) folded before Flop (didn't bet)
Seat 3: Lemmi846 (small blind) folded before Flop
Seat 4: JoePsycho (big blind) folded on the Flop
Seat 5: chiruha0523 folded on the Flop
Seat 7: AlexEliseev7 folded before Flop (didn't bet)
Seat 8: MKennyRltr folded before Flop (didn't bet)
Seat 9: siskin vrach folded on the Flop



PokerStars Hand #228681631216:  Hold'em No Limit ($0.25/$0.50 USD) - 2021/07/30 11:51:05 ET
Table 'Aitne III' 9-max Seat #3 is the button
Seat 1: alex_matsuka ($66.38 in chips) 
Seat 2: zheka656 ($54.19 in chips) 
Seat 3: Lemmi846 ($50 in chips) 
Seat 4: JoePsycho ($55.09 in chips) 
Seat 5: chiruha0523 ($37 in chips) 
Seat 7: AlexEliseev7 ($51.12 in chips) 
Seat 8: MKennyRltr ($30.69 in chips) 
Seat 9: siskin vrach ($57.63 in chips) 
JoePsycho: posts small blind $0.25
chiruha0523: posts big blind $0.50
RipZip: sits out 
*** HOLE CARDS ***
AlexEliseev7: raises $0.75 to $1.25
MKennyRltr: folds 
siskin vrach: folds 
alex_matsuka: raises $3.25 to $4.50
zheka656: folds 
Lemmi846: folds 
JoePsycho: folds 
chiruha0523: folds 
AlexEliseev7: calls $3.25
*** FLOP *** [3h Ks 7c]
AlexEliseev7: checks 
alex_matsuka: bets $6.48
AlexEliseev7: folds 
Uncalled bet ($6.48) returned to alex_matsuka
alex_matsuka collected $9.26 from pot
alex_matsuka: doesn't show hand 
*** SUMMARY ***
Total pot $9.75 | Rake $0.49 
Board [3h Ks 7c]
Seat 1: alex_matsuka collected ($9.26)
Seat 2: zheka656 folded before Flop (didn't bet)
Seat 3: Lemmi846 (button) folded before Flop (didn't bet)
Seat 4: JoePsycho (small blind) folded before Flop
Seat 5: chiruha0523 (big blind) folded before Flop
Seat 7: AlexEliseev7 folded on the Flop
Seat 8: MKennyRltr folded before Flop (didn't bet)
Seat 9: siskin vrach folded before Flop (didn't bet)



PokerStars Hand #228681648074:  Hold'em No Limit ($0.25/$0.50 USD) - 2021/07/30 11:51:54 ET
Table 'Aitne III' 9-max Seat #4 is the button
Seat 1: alex_matsuka ($71.14 in chips) 
Seat 2: zheka656 ($54.19 in chips) 
Seat 3: Lemmi846 ($50 in chips) 
Seat 4: JoePsycho ($54.84 in chips) 
Seat 5: chiruha0523 ($36.50 in chips) 
Seat 6: RipZip ($50 in chips) 
Seat 7: AlexEliseev7 ($50 in chips) 
Seat 8: MKennyRltr ($30.69 in chips) 
Seat 9: siskin vrach ($57.63 in chips) 
chiruha0523: posts small blind $0.25
RipZip: posts big blind $0.50
*** HOLE CARDS ***
AlexEliseev7: folds 
MKennyRltr: folds 
siskin vrach: folds 
alex_matsuka: folds 
zheka656: folds 
Lemmi846: folds 
JoePsycho: raises $0.75 to $1.25
chiruha0523: calls $1
RipZip: folds 
*** FLOP *** [8d 6d 4d]
chiruha0523: checks 
JoePsycho: bets $2
chiruha0523: folds 
Uncalled bet ($2) returned to JoePsycho
JoePsycho collected $2.85 from pot
JoePsycho: doesn't show hand 
*** SUMMARY ***
Total pot $3 | Rake $0.15 
Board [8d 6d 4d]
Seat 1: alex_matsuka folded before Flop (didn't bet)
Seat 2: zheka656 folded before Flop (didn't bet)
Seat 3: Lemmi846 folded before Flop (didn't bet)
Seat 4: JoePsycho (button) collected ($2.85)
Seat 5: chiruha0523 (small blind) folded on the Flop
Seat 6: RipZip (big blind) folded before Flop
Seat 7: AlexEliseev7 folded before Flop (didn't bet)
Seat 8: MKennyRltr folded before Flop (didn't bet)
Seat 9: siskin vrach folded before Flop (didn't bet)



PokerStars Hand #228681660170:  Hold'em No Limit ($0.25/$0.50 USD) - 2021/07/30 11:52:30 ET
Table 'Aitne III' 9-max Seat #5 is the button
Seat 1: alex_matsuka ($71.14 in chips) 
Seat 2: zheka656 ($54.19 in chips) 
Seat 3: Lemmi846 ($50 in chips) 
Seat 4: JoePsycho ($56.44 in chips) 
Seat 5: chiruha0523 ($35.25 in chips) 
Seat 6: RipZip ($49.50 in chips) 
Seat 8: MKennyRltr ($30.69 in chips) 
Seat 9: siskin vrach ($57.63 in chips) 
RipZip: posts small blind $0.25
AlexEliseev7: is sitting out 
MKennyRltr: posts big blind $0.50
*** HOLE CARDS ***
siskin vrach: folds 
alex_matsuka: folds 
zheka656: folds 
Lemmi846: folds 
JoePsycho: folds 
chiruha0523: folds 
RipZip: raises $0.75 to $1.25
MKennyRltr: folds 
Uncalled bet ($0.75) returned to RipZip
RipZip collected $1 from pot
RipZip: doesn't show hand 
*** SUMMARY ***
Total pot $1 | Rake $0 
Seat 1: alex_matsuka folded before Flop (didn't bet)
Seat 2: zheka656 folded before Flop (didn't bet)
Seat 3: Lemmi846 folded before Flop (didn't bet)
Seat 4: JoePsycho folded before Flop (didn't bet)
Seat 5: chiruha0523 (button) folded before Flop (didn't bet)
Seat 6: RipZip (small blind) collected ($1)
Seat 8: MKennyRltr (big blind) folded before Flop
Seat 9: siskin vrach folded before Flop (didn't bet)



PokerStars Hand #228681667356:  Hold'em No Limit ($0.25/$0.50 USD) - 2021/07/30 11:52:51 ET
Table 'Aitne III' 9-max Seat #6 is the button
Seat 1: alex_matsuka ($71.14 in chips) 
Seat 2: zheka656 ($54.19 in chips) 
Seat 3: Lemmi846 ($50 in chips) 
Seat 4: JoePsycho ($56.44 in chips) 
Seat 5: chiruha0523 ($35.25 in chips) 
Seat 6: RipZip ($50 in chips) 
Seat 8: MKennyRltr ($30.19 in chips) 
Seat 9: siskin vrach ($57.63 in chips) 
MKennyRltr: posts small blind $0.25
siskin vrach: posts big blind $0.50
*** HOLE CARDS ***
alex_matsuka: folds 
zheka656: folds 
Lemmi846: folds 
JoePsycho: folds 
chiruha0523: folds 
RipZip: folds 
MKennyRltr: folds 
Uncalled bet ($0.25) returned to siskin vrach
siskin vrach collected $0.50 from pot
*** SUMMARY ***
Total pot $0.50 | Rake $0 
Seat 1: alex_matsuka folded before Flop (didn't bet)
Seat 2: zheka656 folded before Flop (didn't bet)
Seat 3: Lemmi846 folded before Flop (didn't bet)
Seat 4: JoePsycho folded before Flop (didn't bet)
Seat 5: chiruha0523 folded before Flop (didn't bet)
Seat 6: RipZip (button) folded before Flop (didn't bet)
Seat 8: MKennyRltr (small blind) folded before Flop
Seat 9: siskin vrach (big blind) collected ($0.50)



PokerStars Hand #228681670848:  Hold'em No Limit ($0.25/$0.50 USD) - 2021/07/30 11:53:01 ET
Table 'Aitne III' 9-max Seat #8 is the button
Seat 1: alex_matsuka ($71.14 in chips) 
Seat 2: zheka656 ($54.19 in chips) 
Seat 3: Lemmi846 ($50 in chips) 
Seat 4: JoePsycho ($56.44 in chips) 
Seat 5: chiruha0523 ($35.25 in chips) 
Seat 6: RipZip ($50 in chips) 
Seat 8: MKennyRltr ($29.94 in chips) 
Seat 9: siskin vrach ($57.88 in chips) 
siskin vrach: posts small blind $0.25
alex_matsuka: posts big blind $0.50
AlexEliseev7: sits out 
*** HOLE CARDS ***
zheka656: folds 
Lemmi846: folds 
JoePsycho: folds 
chiruha0523: raises $1 to $1.50
RipZip: folds 
MKennyRltr: folds 
siskin vrach: calls $1.25
alex_matsuka: calls $1
*** FLOP *** [7h 9c 6c]
siskin vrach: checks 
alex_matsuka: bets $1.93
chiruha0523: folds 
siskin vrach: calls $1.93
*** TURN *** [7h 9c 6c] [5s]
siskin vrach: checks 
alex_matsuka: bets $5.56
siskin vrach: calls $5.56
*** RIVER *** [7h 9c 6c 5s] [3h]
siskin vrach: checks 
alex_matsuka: bets $12.50
siskin vrach: calls $12.50
*** SHOW DOWN ***
alex_matsuka: shows [8d 6d] (a straight, Five to Nine)
siskin vrach: mucks hand 
alex_matsuka collected $42.48 from pot
*** SUMMARY ***
Total pot $44.48 | Rake $2 
Board [7h 9c 6c 5s 3h]
Seat 1: alex_matsuka (big blind) showed [8d 6d] and won ($42.48) with a straight, Five to Nine
Seat 2: zheka656 folded before Flop (didn't bet)
Seat 3: Lemmi846 folded before Flop (didn't bet)
Seat 4: JoePsycho folded before Flop (didn't bet)
Seat 5: chiruha0523 folded on the Flop
Seat 6: RipZip folded before Flop (didn't bet)
Seat 8: MKennyRltr (button) folded before Flop (didn't bet)
Seat 9: siskin vrach (small blind) mucked



PokerStars Hand #228681697136:  Hold'em No Limit ($0.25/$0.50 USD) - 2021/07/30 11:54:19 ET
Table 'Aitne III' 9-max Seat #9 is the button
Seat 1: alex_matsuka ($92.13 in chips) 
Seat 2: zheka656 ($54.19 in chips) 
Seat 3: Lemmi846 ($50 in chips) 
Seat 4: JoePsycho ($56.44 in chips) 
Seat 5: chiruha0523 ($33.75 in chips) 
Seat 6: RipZip ($50 in chips) 
Seat 8: MKennyRltr ($29.94 in chips) 
Seat 9: siskin vrach ($50 in chips) 
alex_matsuka: posts small blind $0.25
zheka656: posts big blind $0.50
AlexEliseev7: sits out 
*** HOLE CARDS ***
Lemmi846: folds 
JoePsycho: folds 
chiruha0523: folds 
RipZip: folds 
MKennyRltr: folds 
siskin vrach: folds 
alex_matsuka: folds 
Uncalled bet ($0.25) returned to zheka656
zheka656 collected $0.50 from pot
zheka656: doesn't show hand 
*** SUMMARY ***
Total pot $0.50 | Rake $0 
Seat 1: alex_matsuka (small blind) folded before Flop
Seat 2: zheka656 (big blind) collected ($0.50)
Seat 3: Lemmi846 folded before Flop (didn't bet)
Seat 4: JoePsycho folded before Flop (didn't bet)
Seat 5: chiruha0523 folded before Flop (didn't bet)
Seat 6: RipZip folded before Flop (didn't bet)
Seat 8: MKennyRltr folded before Flop (didn't bet)
Seat 9: siskin vrach (button) folded before Flop (didn't bet)



PokerStars Hand #228681701239:  Hold'em No Limit ($0.25/$0.50 USD) - 2021/07/30 11:54:31 ET
Table 'Aitne III' 9-max Seat #1 is the button
Seat 1: alex_matsuka ($91.88 in chips) 
Seat 2: zheka656 ($54.44 in chips) 
Seat 3: Lemmi846 ($50 in chips) 
Seat 4: JoePsycho ($56.44 in chips) 
Seat 5: chiruha0523 ($33.75 in chips) 
Seat 6: RipZip ($50 in chips) 
Seat 8: MKennyRltr ($29.94 in chips) 
Seat 9: siskin vrach ($50 in chips) 
zheka656: posts small blind $0.25
Lemmi846: posts big blind $0.50
AlexEliseev7: sits out 
*** HOLE CARDS ***
JoePsycho: folds 
chiruha0523: folds 
RipZip: folds 
MKennyRltr: folds 
siskin vrach: folds 
alex_matsuka: folds 
zheka656: raises $1 to $1.50
Lemmi846: folds 
Uncalled bet ($1) returned to zheka656
zheka656 collected $1 from pot
zheka656: doesn't show hand 
*** SUMMARY ***
Total pot $1 | Rake $0 
Seat 1: alex_matsuka (button) folded before Flop (didn't bet)
Seat 2: zheka656 (small blind) collected ($1)
Seat 3: Lemmi846 (big blind) folded before Flop
Seat 4: JoePsycho folded before Flop (didn't bet)
Seat 5: chiruha0523 folded before Flop (didn't bet)
Seat 6: RipZip folded before Flop (didn't bet)
Seat 8: MKennyRltr folded before Flop (didn't bet)
Seat 9: siskin vrach folded before Flop (didn't bet)



PokerStars Hand #228681705957:  Hold'em No Limit ($0.25/$0.50 USD) - 2021/07/30 11:54:45 ET
Table 'Aitne III' 9-max Seat #2 is the button
Seat 1: alex_matsuka ($91.88 in chips) 
Seat 2: zheka656 ($54.94 in chips) 
Seat 3: Lemmi846 ($50 in chips) 
Seat 4: JoePsycho ($56.44 in chips) 
Seat 5: chiruha0523 ($33.75 in chips) 
Seat 6: RipZip ($50 in chips) 
Seat 8: MKennyRltr ($29.94 in chips) 
Seat 9: siskin vrach ($50 in chips) 
Lemmi846: posts small blind $0.25
JoePsycho: posts big blind $0.50
AlexEliseev7: sits out 
*** HOLE CARDS ***
chiruha0523: folds 
RipZip: folds 
MKennyRltr: folds 
siskin vrach: folds 
alex_matsuka: raises $1 to $1.50
zheka656: folds 
Lemmi846: folds 
JoePsycho: folds 
Uncalled bet ($1) returned to alex_matsuka
alex_matsuka collected $1.25 from pot
alex_matsuka: doesn't show hand 
*** SUMMARY ***
Total pot $1.25 | Rake $0 
Seat 1: alex_matsuka collected ($1.25)
Seat 2: zheka656 (button) folded before Flop (didn't bet)
Seat 3: Lemmi846 (small blind) folded before Flop
Seat 4: JoePsycho (big blind) folded before Flop
Seat 5: chiruha0523 folded before Flop (didn't bet)
Seat 6: RipZip folded before Flop (didn't bet)
Seat 8: MKennyRltr folded before Flop (didn't bet)
Seat 9: siskin vrach folded before Flop (didn't bet)



PokerStars Hand #228681712915:  Hold'em No Limit ($0.25/$0.50 USD) - 2021/07/30 11:55:06 ET
Table 'Aitne III' 9-max Seat #3 is the button
Seat 1: alex_matsuka ($92.63 in chips) 
Seat 2: zheka656 ($54.94 in chips) 
Seat 3: Lemmi846 ($50 in chips) 
Seat 4: JoePsycho ($55.94 in chips) 
Seat 5: chiruha0523 ($33.75 in chips) 
Seat 6: RipZip ($50 in chips) 
Seat 8: MKennyRltr ($29.94 in chips) 
Seat 9: siskin vrach ($50 in chips) 
JoePsycho: posts small blind $0.25
chiruha0523: posts big blind $0.50
AlexEliseev7: sits out 
*** HOLE CARDS ***
RipZip: folds 
MKennyRltr: calls $0.50
siskin vrach: raises $1.50 to $2
alex_matsuka: folds 
zheka656: folds 
Lemmi846: folds 
JoePsycho: calls $1.75
chiruha0523: folds 
MKennyRltr: folds 
*** FLOP *** [2d 2c 3c]
JoePsycho: checks 
siskin vrach: bets $1.50
JoePsycho: calls $1.50
*** TURN *** [2d 2c 3c] [9s]
JoePsycho: checks 
siskin vrach: checks 
*** RIVER *** [2d 2c 3c 9s] [7h]
JoePsycho: checks 
siskin vrach: checks 
*** SHOW DOWN ***
JoePsycho: shows [Js As] (a pair of Deuces)
siskin vrach: shows [Ah Qd] (a pair of Deuces - Ace+Queen kicker)
siskin vrach collected $7.60 from pot
*** SUMMARY ***
Total pot $8 | Rake $0.40 
Board [2d 2c 3c 9s 7h]
Seat 1: alex_matsuka folded before Flop (didn't bet)
Seat 2: zheka656 folded before Flop (didn't bet)
Seat 3: Lemmi846 (button) folded before Flop (didn't bet)
Seat 4: JoePsycho (small blind) showed [Js As] and lost with a pair of Deuces
Seat 5: chiruha0523 (big blind) folded before Flop
Seat 6: RipZip folded before Flop (didn't bet)
Seat 8: MKennyRltr folded before Flop
Seat 9: siskin vrach showed [Ah Qd] and won ($7.60) with a pair of Deuces



PokerStars Hand #228681724947:  Hold'em No Limit ($0.25/$0.50 USD) - 2021/07/30 11:55:50 ET
Table 'Aitne III' 9-max Seat #4 is the button
Seat 1: alex_matsuka ($92.63 in chips) 
Seat 2: zheka656 ($54.94 in chips) 
Seat 3: Lemmi846 ($50 in chips) 
Seat 4: JoePsycho ($52.44 in chips) 
Seat 5: chiruha0523 ($33.25 in chips) 
Seat 6: RipZip ($50 in chips) 
Seat 8: MKennyRltr ($29.44 in chips) 
Seat 9: siskin vrach ($54.10 in chips) 
chiruha0523: posts small blind $0.25
RipZip: posts big blind $0.50
AlexEliseev7: sits out 
*** HOLE CARDS ***
MKennyRltr: calls $0.50
siskin vrach: folds 
alex_matsuka: raises $2 to $2.50
zheka656: folds 
Lemmi846: folds 
JoePsycho: folds 
chiruha0523: folds 
RipZip: folds 
MKennyRltr: folds 
Uncalled bet ($2) returned to alex_matsuka
alex_matsuka collected $1.75 from pot
alex_matsuka: doesn't show hand 
*** SUMMARY ***
Total pot $1.75 | Rake $0 
Seat 1: alex_matsuka collected ($1.75)
Seat 2: zheka656 folded before Flop (didn't bet)
Seat 3: Lemmi846 folded before Flop (didn't bet)
Seat 4: JoePsycho (button) folded before Flop (didn't bet)
Seat 5: chiruha0523 (small blind) folded before Flop
Seat 6: RipZip (big blind) folded before Flop
Seat 8: MKennyRltr folded before Flop
Seat 9: siskin vrach folded before Flop (didn't bet)



PokerStars Hand #228681729476:  Hold'em No Limit ($0.25/$0.50 USD) - 2021/07/30 11:56:07 ET
Table 'Aitne III' 9-max Seat #5 is the button
Seat 1: alex_matsuka ($93.88 in chips) 
Seat 2: zheka656 ($54.94 in chips) 
Seat 3: Lemmi846 ($50 in chips) 
Seat 4: JoePsycho ($52.44 in chips) 
Seat 5: chiruha0523 ($33 in chips) 
Seat 6: RipZip ($49.50 in chips) 
Seat 7: AlexEliseev7 ($50 in chips) 
Seat 8: MKennyRltr ($28.94 in chips) 
Seat 9: siskin vrach ($54.10 in chips) 
RipZip: posts small blind $0.25
AlexEliseev7: posts big blind $0.50
*** HOLE CARDS ***
MKennyRltr: folds 
siskin vrach: folds 
alex_matsuka: folds 
zheka656: folds 
Lemmi846: raises $0.50 to $1
JoePsycho: folds 
chiruha0523: folds 
RipZip: folds 
AlexEliseev7: folds 
Uncalled bet ($0.50) returned to Lemmi846
Lemmi846 collected $1.25 from pot
Lemmi846: doesn't show hand 
*** SUMMARY ***
Total pot $1.25 | Rake $0 
Seat 1: alex_matsuka folded before Flop (didn't bet)
Seat 2: zheka656 folded before Flop (didn't bet)
Seat 3: Lemmi846 collected ($1.25)
Seat 4: JoePsycho folded before Flop (didn't bet)
Seat 5: chiruha0523 (button) folded before Flop (didn't bet)
Seat 6: RipZip (small blind) folded before Flop
Seat 7: AlexEliseev7 (big blind) folded before Flop
Seat 8: MKennyRltr folded before Flop (didn't bet)
Seat 9: siskin vrach folded before Flop (didn't bet)



PokerStars Hand #228681735359:  Hold'em No Limit ($0.25/$0.50 USD) - 2021/07/30 11:56:30 ET
Table 'Aitne III' 9-max Seat #6 is the button
Seat 1: alex_matsuka ($93.88 in chips) 
Seat 2: zheka656 ($54.94 in chips) 
Seat 3: Lemmi846 ($50.75 in chips) 
Seat 4: JoePsycho ($52.44 in chips) 
Seat 5: chiruha0523 ($33 in chips) 
Seat 6: RipZip ($49.25 in chips) 
Seat 7: AlexEliseev7 ($50 in chips) 
Seat 8: MKennyRltr ($28.94 in chips) 
Seat 9: siskin vrach ($54.10 in chips) 
AlexEliseev7: posts small blind $0.25
MKennyRltr: posts big blind $0.50
*** HOLE CARDS ***
siskin vrach: folds 
alex_matsuka: folds 
zheka656: folds 
Lemmi846: folds 
JoePsycho: folds 
chiruha0523: folds 
RipZip: folds 
AlexEliseev7: raises $1 to $1.50
MKennyRltr: folds 
Uncalled bet ($1) returned to AlexEliseev7
AlexEliseev7 collected $1 from pot
AlexEliseev7: doesn't show hand 
*** SUMMARY ***
Total pot $1 | Rake $0 
Seat 1: alex_matsuka folded before Flop (didn't bet)
Seat 2: zheka656 folded before Flop (didn't bet)
Seat 3: Lemmi846 folded before Flop (didn't bet)
Seat 4: JoePsycho folded before Flop (didn't bet)
Seat 5: chiruha0523 folded before Flop (didn't bet)
Seat 6: RipZip (button) folded before Flop (didn't bet)
Seat 7: AlexEliseev7 (small blind) collected ($1)
Seat 8: MKennyRltr (big blind) folded before Flop
Seat 9: siskin vrach folded before Flop (didn't bet)



PokerStars Hand #228681740976:  Hold'em No Limit ($0.25/$0.50 USD) - 2021/07/30 11:56:50 ET
Table 'Aitne III' 9-max Seat #7 is the button
Seat 1: alex_matsuka ($93.88 in chips) 
Seat 2: zheka656 ($54.94 in chips) 
Seat 3: Lemmi846 ($50.75 in chips) 
Seat 4: JoePsycho ($52.44 in chips) 
Seat 5: chiruha0523 ($33 in chips) 
Seat 6: RipZip ($49.25 in chips) 
Seat 7: AlexEliseev7 ($50.50 in chips) 
Seat 8: MKennyRltr ($28.44 in chips) 
Seat 9: siskin vrach ($54.10 in chips) 
MKennyRltr: posts small blind $0.25
siskin vrach: posts big blind $0.50
*** HOLE CARDS ***
alex_matsuka: folds 
zheka656: folds 
Lemmi846: raises $1 to $1.50
JoePsycho: folds 
chiruha0523: calls $1.50
RipZip: folds 
AlexEliseev7: folds 
MKennyRltr: folds 
siskin vrach: folds 
*** FLOP *** [8s Ah 8c]
Lemmi846: bets $1.78
chiruha0523: folds 
Uncalled bet ($1.78) returned to Lemmi846
Lemmi846 collected $3.51 from pot
Lemmi846: doesn't show hand 
*** SUMMARY ***
Total pot $3.75 | Rake $0.24 
Board [8s Ah 8c]
Seat 1: alex_matsuka folded before Flop (didn't bet)
Seat 2: zheka656 folded before Flop (didn't bet)
Seat 3: Lemmi846 collected ($3.51)
Seat 4: JoePsycho folded before Flop (didn't bet)
Seat 5: chiruha0523 folded on the Flop
Seat 6: RipZip folded before Flop (didn't bet)
Seat 7: AlexEliseev7 (button) folded before Flop (didn't bet)
Seat 8: MKennyRltr (small blind) folded before Flop
Seat 9: siskin vrach (big blind) folded before Flop



PokerStars Hand #228681747860:  Hold'em No Limit ($0.25/$0.50 USD) - 2021/07/30 11:57:17 ET
Table 'Aitne III' 9-max Seat #8 is the button
Seat 1: alex_matsuka ($93.88 in chips) 
Seat 2: zheka656 ($54.94 in chips) 
Seat 3: Lemmi846 ($52.76 in chips) 
Seat 4: JoePsycho ($52.44 in chips) 
Seat 5: chiruha0523 ($31.50 in chips) 
Seat 6: RipZip ($49.25 in chips) 
Seat 7: AlexEliseev7 ($50.50 in chips) 
Seat 8: MKennyRltr ($28.19 in chips) 
Seat 9: siskin vrach ($53.60 in chips) 
siskin vrach: posts small blind $0.25
alex_matsuka: posts big blind $0.50
*** HOLE CARDS ***
zheka656: folds 
Lemmi846: raises $1 to $1.50
JoePsycho: folds 
chiruha0523: folds 
RipZip: folds 
AlexEliseev7: folds 
MKennyRltr: calls $1.50
siskin vrach: calls $1.25
alex_matsuka: folds 
*** FLOP *** [2d 6h 2h]
siskin vrach: checks 
Lemmi846: bets $3.50
MKennyRltr: folds 
siskin vrach: folds 
Uncalled bet ($3.50) returned to Lemmi846
Lemmi846 collected $4.69 from pot
Lemmi846: doesn't show hand 
*** SUMMARY ***
Total pot $5 | Rake $0.31 
Board [2d 6h 2h]
Seat 1: alex_matsuka (big blind) folded before Flop
Seat 2: zheka656 folded before Flop (didn't bet)
Seat 3: Lemmi846 collected ($4.69)
Seat 4: JoePsycho folded before Flop (didn't bet)
Seat 5: chiruha0523 folded before Flop (didn't bet)
Seat 6: RipZip folded before Flop (didn't bet)
Seat 7: AlexEliseev7 folded before Flop (didn't bet)
Seat 8: MKennyRltr (button) folded on the Flop
Seat 9: siskin vrach (small blind) folded on the Flop



PokerStars Hand #228681763152:  Hold'em No Limit ($0.25/$0.50 USD) - 2021/07/30 11:58:14 ET
Table 'Aitne III' 9-max Seat #9 is the button
Seat 1: alex_matsuka ($93.38 in chips) 
Seat 2: zheka656 ($54.94 in chips) 
Seat 3: Lemmi846 ($55.95 in chips) 
Seat 4: JoePsycho ($52.44 in chips) 
Seat 5: chiruha0523 ($31.50 in chips) 
Seat 6: RipZip ($49.25 in chips) 
Seat 7: AlexEliseev7 ($50.50 in chips) 
Seat 8: MKennyRltr ($26.69 in chips) 
Seat 9: siskin vrach ($52.10 in chips) 
alex_matsuka: posts small blind $0.25
zheka656: posts big blind $0.50
*** HOLE CARDS ***
Lemmi846: folds 
JoePsycho: folds 
chiruha0523: folds 
RipZip: folds 
AlexEliseev7: folds 
MKennyRltr: folds 
siskin vrach: raises $1 to $1.50
alex_matsuka: folds 
zheka656: folds 
Uncalled bet ($1) returned to siskin vrach
siskin vrach collected $1.25 from pot
*** SUMMARY ***
Total pot $1.25 | Rake $0 
Seat 1: alex_matsuka (small blind) folded before Flop
Seat 2: zheka656 (big blind) folded before Flop
Seat 3: Lemmi846 folded before Flop (didn't bet)
Seat 4: JoePsycho folded before Flop (didn't bet)
Seat 5: chiruha0523 folded before Flop (didn't bet)
Seat 6: RipZip folded before Flop (didn't bet)
Seat 7: AlexEliseev7 folded before Flop (didn't bet)
Seat 8: MKennyRltr folded before Flop (didn't bet)
Seat 9: siskin vrach (button) collected ($1.25)



PokerStars Hand #228681769911:  Hold'em No Limit ($0.25/$0.50 USD) - 2021/07/30 11:58:40 ET
Table 'Aitne III' 9-max Seat #1 is the button
Seat 1: alex_matsuka ($93.13 in chips) 
Seat 2: zheka656 ($54.44 in chips) 
Seat 3: Lemmi846 ($55.95 in chips) 
Seat 4: JoePsycho ($52.44 in chips) 
Seat 5: chiruha0523 ($31.50 in chips) 
Seat 6: RipZip ($49.25 in chips) 
Seat 7: AlexEliseev7 ($50.50 in chips) 
Seat 8: MKennyRltr ($26.69 in chips) 
Seat 9: siskin vrach ($52.85 in chips) 
zheka656: posts small blind $0.25
Lemmi846: posts big blind $0.50
*** HOLE CARDS ***
JoePsycho: folds 
chiruha0523: raises $1 to $1.50
RipZip: calls $1.50
AlexEliseev7: calls $1.50
MKennyRltr: folds 
siskin vrach: folds 
alex_matsuka: folds 
zheka656: folds 
Lemmi846: folds 
*** FLOP *** [2s 3d 4c]
chiruha0523: bets $2.50
RipZip: folds 
AlexEliseev7: folds 
Uncalled bet ($2.50) returned to chiruha0523
chiruha0523 collected $4.99 from pot
chiruha0523: doesn't show hand 
*** SUMMARY ***
Total pot $5.25 | Rake $0.26 
Board [2s 3d 4c]
Seat 1: alex_matsuka (button) folded before Flop (didn't bet)
Seat 2: zheka656 (small blind) folded before Flop
Seat 3: Lemmi846 (big blind) folded before Flop
Seat 4: JoePsycho folded before Flop (didn't bet)
Seat 5: chiruha0523 collected ($4.99)
Seat 6: RipZip folded on the Flop
Seat 7: AlexEliseev7 folded on the Flop
Seat 8: MKennyRltr folded before Flop (didn't bet)
Seat 9: siskin vrach folded before Flop (didn't bet)



PokerStars Hand #228681779881:  Hold'em No Limit ($0.25/$0.50 USD) - 2021/07/30 11:59:18 ET
Table 'Aitne III' 9-max Seat #2 is the button
Seat 1: alex_matsuka ($93.13 in chips) 
Seat 2: zheka656 ($54.19 in chips) 
Seat 3: Lemmi846 ($55.45 in chips) 
Seat 4: JoePsycho ($52.44 in chips) 
Seat 5: chiruha0523 ($34.99 in chips) 
Seat 6: RipZip ($47.75 in chips) 
Seat 7: AlexEliseev7 ($50 in chips) 
Seat 8: MKennyRltr ($26.69 in chips) 
Seat 9: siskin vrach ($52.85 in chips) 
Lemmi846: posts small blind $0.25
JoePsycho: posts big blind $0.50
*** HOLE CARDS ***
chiruha0523: folds 
RipZip: folds 
AlexEliseev7: folds 
MKennyRltr: folds 
siskin vrach: folds 
alex_matsuka: folds 
zheka656: raises $0.75 to $1.25
Lemmi846: folds 
JoePsycho: folds 
Uncalled bet ($0.75) returned to zheka656
zheka656 collected $1.25 from pot
zheka656: doesn't show hand 
*** SUMMARY ***
Total pot $1.25 | Rake $0 
Seat 1: alex_matsuka folded before Flop (didn't bet)
Seat 2: zheka656 (button) collected ($1.25)
Seat 3: Lemmi846 (small blind) folded before Flop
Seat 4: JoePsycho (big blind) folded before Flop
Seat 5: chiruha0523 folded before Flop (didn't bet)
Seat 6: RipZip folded before Flop (didn't bet)
Seat 7: AlexEliseev7 folded before Flop (didn't bet)
Seat 8: MKennyRltr folded before Flop (didn't bet)
Seat 9: siskin vrach folded before Flop (didn't bet)



PokerStars Hand #228681783864:  Hold'em No Limit ($0.25/$0.50 USD) - 2021/07/30 11:59:33 ET
Table 'Aitne III' 9-max Seat #3 is the button
Seat 1: alex_matsuka ($93.13 in chips) 
Seat 2: zheka656 ($54.94 in chips) 
Seat 3: Lemmi846 ($55.20 in chips) 
Seat 4: JoePsycho ($51.94 in chips) 
Seat 5: chiruha0523 ($34.99 in chips) 
Seat 6: RipZip ($50 in chips) 
Seat 7: AlexEliseev7 ($50 in chips) 
Seat 8: MKennyRltr ($26.69 in chips) 
Seat 9: siskin vrach ($52.85 in chips) 
JoePsycho: posts small blind $0.25
chiruha0523: posts big blind $0.50
*** HOLE CARDS ***
RipZip: folds 
AlexEliseev7: folds 
MKennyRltr: folds 
siskin vrach: raises $1 to $1.50
alex_matsuka: raises $3 to $4.50
zheka656: folds 
Lemmi846: folds 
JoePsycho: folds 
chiruha0523: folds 
siskin vrach: calls $3
*** FLOP *** [4c 7s 3d]
siskin vrach: checks 
alex_matsuka: bets $6.48
siskin vrach: calls $6.48
*** TURN *** [4c 7s 3d] [4d]
siskin vrach: checks 
alex_matsuka: bets $15
siskin vrach: calls $15
*** RIVER *** [4c 7s 3d 4d] [Tc]
siskin vrach: checks 
alex_matsuka: checks 
*** SHOW DOWN ***
siskin vrach: shows [Qd Qc] (two pair, Queens and Fours)
alex_matsuka: mucks hand 
siskin vrach collected $50.71 from pot
*** SUMMARY ***
Total pot $52.71 | Rake $2 
Board [4c 7s 3d 4d Tc]
Seat 1: alex_matsuka mucked
Seat 2: zheka656 folded before Flop (didn't bet)
Seat 3: Lemmi846 (button) folded before Flop (didn't bet)
Seat 4: JoePsycho (small blind) folded before Flop
Seat 5: chiruha0523 (big blind) folded before Flop
Seat 6: RipZip folded before Flop (didn't bet)
Seat 7: AlexEliseev7 folded before Flop (didn't bet)
Seat 8: MKennyRltr folded before Flop (didn't bet)
Seat 9: siskin vrach showed [Qd Qc] and won ($50.71) with two pair, Queens and Fours



PokerStars Hand #228681811669:  Hold'em No Limit ($0.25/$0.50 USD) - 2021/07/30 12:01:12 ET
Table 'Aitne III' 9-max Seat #4 is the button
Seat 1: alex_matsuka ($67.15 in chips) 
Seat 2: zheka656 ($54.94 in chips) 
Seat 3: Lemmi846 ($55.20 in chips) 
Seat 4: JoePsycho ($51.69 in chips) 
Seat 5: chiruha0523 ($34.49 in chips) 
Seat 6: RipZip ($50 in chips) 
Seat 7: AlexEliseev7 ($50 in chips) 
Seat 8: MKennyRltr ($26.69 in chips) 
Seat 9: siskin vrach ($77.58 in chips) 
chiruha0523: posts small blind $0.25
RipZip: posts big blind $0.50
*** HOLE CARDS ***
AlexEliseev7: folds 
MKennyRltr: folds 
siskin vrach: raises $1 to $1.50
alex_matsuka: folds 
zheka656: folds 
Lemmi846: folds 
JoePsycho: folds 
chiruha0523: folds 
RipZip: folds 
Uncalled bet ($1) returned to siskin vrach
siskin vrach collected $1.25 from pot
*** SUMMARY ***
Total pot $1.25 | Rake $0 
Seat 1: alex_matsuka folded before Flop (didn't bet)
Seat 2: zheka656 folded before Flop (didn't bet)
Seat 3: Lemmi846 folded before Flop (didn't bet)
Seat 4: JoePsycho (button) folded before Flop (didn't bet)
Seat 5: chiruha0523 (small blind) folded before Flop
Seat 6: RipZip (big blind) folded before Flop
Seat 7: AlexEliseev7 folded before Flop (didn't bet)
Seat 8: MKennyRltr folded before Flop (didn't bet)
Seat 9: siskin vrach collected ($1.25)



PokerStars Hand #228681819571:  Hold'em No Limit ($0.25/$0.50 USD) - 2021/07/30 12:01:37 ET
Table 'Aitne III' 9-max Seat #5 is the button
Seat 1: alex_matsuka ($67.15 in chips) 
Seat 2: zheka656 ($54.94 in chips) 
Seat 3: Lemmi846 ($55.20 in chips) 
Seat 4: JoePsycho ($51.69 in chips) 
Seat 5: chiruha0523 ($34.24 in chips) 
Seat 6: RipZip ($49.50 in chips) 
Seat 7: AlexEliseev7 ($50 in chips) 
Seat 8: MKennyRltr ($26.69 in chips) 
Seat 9: siskin vrach ($78.33 in chips) 
RipZip: posts small blind $0.25
AlexEliseev7: posts big blind $0.50
*** HOLE CARDS ***
MKennyRltr: folds 
siskin vrach: folds 
alex_matsuka: folds 
zheka656: folds 
MKennyRltr leaves the table
Lemmi846: folds 
JoePsycho: folds 
chiruha0523: folds 
RipZip: folds 
Uncalled bet ($0.25) returned to AlexEliseev7
AlexEliseev7 collected $0.50 from pot
AlexEliseev7: doesn't show hand 
*** SUMMARY ***
Total pot $0.50 | Rake $0 
Seat 1: alex_matsuka folded before Flop (didn't bet)
Seat 2: zheka656 folded before Flop (didn't bet)
Seat 3: Lemmi846 folded before Flop (didn't bet)
Seat 4: JoePsycho folded before Flop (didn't bet)
Seat 5: chiruha0523 (button) folded before Flop (didn't bet)
Seat 6: RipZip (small blind) folded before Flop
Seat 7: AlexEliseev7 (big blind) collected ($0.50)
Seat 8: MKennyRltr folded before Flop (didn't bet)
Seat 9: siskin vrach folded before Flop (didn't bet)



PokerStars Hand #228681823839:  Hold'em No Limit ($0.25/$0.50 USD) - 2021/07/30 12:01:50 ET
Table 'Aitne III' 9-max Seat #6 is the button
Seat 1: alex_matsuka ($67.15 in chips) 
Seat 2: zheka656 ($54.94 in chips) 
Seat 3: Lemmi846 ($55.20 in chips) 
Seat 4: JoePsycho ($51.69 in chips) 
Seat 5: chiruha0523 ($34.24 in chips) 
Seat 6: RipZip ($49.25 in chips) 
Seat 7: AlexEliseev7 ($50.25 in chips) 
Seat 9: siskin vrach ($78.33 in chips) 
AlexEliseev7: posts small blind $0.25
siskin vrach: posts big blind $0.50
*** HOLE CARDS ***
alex_matsuka: folds 
zheka656: folds 
Lemmi846: raises $0.50 to $1
JoePsycho: folds 
chiruha0523: folds 
RipZip: folds 
AlexEliseev7: folds 
siskin vrach: calls $0.50
*** FLOP *** [Kd 6d 8d]
siskin vrach: checks 
Lemmi846: bets $1.50
siskin vrach: calls $1.50
*** TURN *** [Kd 6d 8d] [5h]
siskin vrach: checks 
Lemmi846: bets $3.50
siskin vrach: folds 
Uncalled bet ($3.50) returned to Lemmi846
Lemmi846 collected $4.93 from pot
Lemmi846: doesn't show hand 
*** SUMMARY ***
Total pot $5.25 | Rake $0.32 
Board [Kd 6d 8d 5h]
Seat 1: alex_matsuka folded before Flop (didn't bet)
Seat 2: zheka656 folded before Flop (didn't bet)
Seat 3: Lemmi846 collected ($4.93)
Seat 4: JoePsycho folded before Flop (didn't bet)
Seat 5: chiruha0523 folded before Flop (didn't bet)
Seat 6: RipZip (button) folded before Flop (didn't bet)
Seat 7: AlexEliseev7 (small blind) folded before Flop
Seat 9: siskin vrach (big blind) folded on the Turn



PokerStars Hand #228681837264:  Hold'em No Limit ($0.25/$0.50 USD) - 2021/07/30 12:02:30 ET
Table 'Aitne III' 9-max Seat #7 is the button
Seat 1: alex_matsuka ($67.15 in chips) 
Seat 2: zheka656 ($54.94 in chips) 
Seat 3: Lemmi846 ($57.63 in chips) 
Seat 4: JoePsycho ($51.69 in chips) 
Seat 5: chiruha0523 ($34.24 in chips) 
Seat 6: RipZip ($49.25 in chips) 
Seat 7: AlexEliseev7 ($50 in chips) 
Seat 9: siskin vrach ($75.83 in chips) 
siskin vrach: posts small blind $0.25
alex_matsuka: posts big blind $0.50
*** HOLE CARDS ***
zheka656: folds 
Lemmi846: folds 
JoePsycho: folds 
chiruha0523: folds 
RipZip: folds 
AlexEliseev7: raises $0.75 to $1.25
siskin vrach: raises $3.25 to $4.50
alex_matsuka: folds 
AlexEliseev7: folds 
Uncalled bet ($3.25) returned to siskin vrach
siskin vrach collected $3 from pot
ludemix joins the table at seat #8 
*** SUMMARY ***
Total pot $3 | Rake $0 
Seat 1: alex_matsuka (big blind) folded before Flop
Seat 2: zheka656 folded before Flop (didn't bet)
Seat 3: Lemmi846 folded before Flop (didn't bet)
Seat 4: JoePsycho folded before Flop (didn't bet)
Seat 5: chiruha0523 folded before Flop (didn't bet)
Seat 6: RipZip folded before Flop (didn't bet)
Seat 7: AlexEliseev7 (button) folded before Flop
Seat 9: siskin vrach (small blind) collected ($3)



PokerStars Hand #228681844077:  Hold'em No Limit ($0.25/$0.50 USD) - 2021/07/30 12:02:51 ET
Table 'Aitne III' 9-max Seat #9 is the button
Seat 1: alex_matsuka ($66.65 in chips) 
Seat 2: zheka656 ($54.94 in chips) 
Seat 3: Lemmi846 ($57.63 in chips) 
Seat 4: JoePsycho ($51.69 in chips) 
Seat 5: chiruha0523 ($34.24 in chips) 
Seat 6: RipZip ($49.25 in chips) 
Seat 7: AlexEliseev7 ($50 in chips) 
Seat 9: siskin vrach ($77.58 in chips) 
alex_matsuka: posts small blind $0.25
zheka656: posts big blind $0.50
ludemix: sits out 
*** HOLE CARDS ***
Lemmi846: folds 
JoePsycho: folds 
chiruha0523: folds 
RipZip: folds 
AlexEliseev7: folds 
siskin vrach: raises $1 to $1.50
alex_matsuka: folds 
zheka656: folds 
Uncalled bet ($1) returned to siskin vrach
siskin vrach collected $1.25 from pot
*** SUMMARY ***
Total pot $1.25 | Rake $0 
Seat 1: alex_matsuka (small blind) folded before Flop
Seat 2: zheka656 (big blind) folded before Flop
Seat 3: Lemmi846 folded before Flop (didn't bet)
Seat 4: JoePsycho folded before Flop (didn't bet)
Seat 5: chiruha0523 folded before Flop (didn't bet)
Seat 6: RipZip folded before Flop (didn't bet)
Seat 7: AlexEliseev7 folded before Flop (didn't bet)
Seat 9: siskin vrach (button) collected ($1.25)



PokerStars Hand #228681851248:  Hold'em No Limit ($0.25/$0.50 USD) - 2021/07/30 12:03:12 ET
Table 'Aitne III' 9-max Seat #1 is the button
Seat 1: alex_matsuka ($66.40 in chips) 
Seat 2: zheka656 ($54.44 in chips) 
Seat 3: Lemmi846 ($57.63 in chips) 
Seat 4: JoePsycho ($51.69 in chips) 
Seat 5: chiruha0523 ($34.24 in chips) 
Seat 6: RipZip ($49.25 in chips) 
Seat 7: AlexEliseev7 ($50 in chips) 
Seat 9: siskin vrach ($78.33 in chips) 
zheka656: posts small blind $0.25
Lemmi846: posts big blind $0.50
ludemix: sits out 
*** HOLE CARDS ***
JoePsycho: folds 
chiruha0523: folds 
RipZip: folds 
AlexEliseev7: folds 
siskin vrach: raises $1 to $1.50
alex_matsuka: folds 
zheka656: folds 
Lemmi846: folds 
Uncalled bet ($1) returned to siskin vrach
siskin vrach collected $1.25 from pot
*** SUMMARY ***
Total pot $1.25 | Rake $0 
Seat 1: alex_matsuka (button) folded before Flop (didn't bet)
Seat 2: zheka656 (small blind) folded before Flop
Seat 3: Lemmi846 (big blind) folded before Flop
Seat 4: JoePsycho folded before Flop (didn't bet)
Seat 5: chiruha0523 folded before Flop (didn't bet)
Seat 6: RipZip folded before Flop (didn't bet)
Seat 7: AlexEliseev7 folded before Flop (didn't bet)
Seat 9: siskin vrach collected ($1.25)



PokerStars Hand #228681859446:  Hold'em No Limit ($0.25/$0.50 USD) - 2021/07/30 12:03:37 ET
Table 'Aitne III' 9-max Seat #2 is the button
Seat 1: alex_matsuka ($66.40 in chips) 
Seat 2: zheka656 ($54.19 in chips) 
Seat 3: Lemmi846 ($57.13 in chips) 
Seat 4: JoePsycho ($51.69 in chips) 
Seat 5: chiruha0523 ($34.24 in chips) 
Seat 6: RipZip ($49.25 in chips) 
Seat 7: AlexEliseev7 ($50 in chips) 
Seat 9: siskin vrach ($79.08 in chips) 
Lemmi846: posts small blind $0.25
JoePsycho: posts big blind $0.50
ludemix: sits out 
*** HOLE CARDS ***
chiruha0523: folds 
RipZip: folds 
AlexEliseev7: folds 
siskin vrach: raises $1 to $1.50
alex_matsuka: calls $1.50
zheka656: folds 
Lemmi846: folds 
JoePsycho: folds 
*** FLOP *** [8c Kh 8s]
siskin vrach: bets $1.03
alex_matsuka: calls $1.03
*** TURN *** [8c Kh 8s] [Kc]
siskin vrach: checks 
alex_matsuka: checks 
*** RIVER *** [8c Kh 8s Kc] [4c]
siskin vrach: checks 
alex_matsuka: checks 
*** SHOW DOWN ***
siskin vrach: shows [As Qh] (two pair, Kings and Eights)
alex_matsuka: shows [9s 9h] (two pair, Kings and Nines)
alex_matsuka collected $5.52 from pot
*** SUMMARY ***
Total pot $5.81 | Rake $0.29 
Board [8c Kh 8s Kc 4c]
Seat 1: alex_matsuka showed [9s 9h] and won ($5.52) with two pair, Kings and Nines
Seat 2: zheka656 (button) folded before Flop (didn't bet)
Seat 3: Lemmi846 (small blind) folded before Flop
Seat 4: JoePsycho (big blind) folded before Flop
Seat 5: chiruha0523 folded before Flop (didn't bet)
Seat 6: RipZip folded before Flop (didn't bet)
Seat 7: AlexEliseev7 folded before Flop (didn't bet)
Seat 9: siskin vrach showed [As Qh] and lost with two pair, Kings and Eights



PokerStars Hand #228681876226:  Hold'em No Limit ($0.25/$0.50 USD) - 2021/07/30 12:04:27 ET
Table 'Aitne III' 9-max Seat #3 is the button
Seat 1: alex_matsuka ($69.39 in chips) 
Seat 2: zheka656 ($54.19 in chips) 
Seat 3: Lemmi846 ($56.88 in chips) 
Seat 4: JoePsycho ($51.19 in chips) 
Seat 5: chiruha0523 ($34.24 in chips) 
Seat 6: RipZip ($49.25 in chips) 
Seat 7: AlexEliseev7 ($50 in chips) 
Seat 9: siskin vrach ($76.55 in chips) 
JoePsycho: posts small blind $0.25
chiruha0523: posts big blind $0.50
ludemix: sits out 
*** HOLE CARDS ***
RipZip: folds 
AlexEliseev7: raises $0.75 to $1.25
siskin vrach: calls $1.25
alex_matsuka: folds 
zheka656: folds 
Lemmi846: folds 
JoePsycho: calls $1
chiruha0523: folds 
*** FLOP *** [8s 9h Ac]
JoePsycho: checks 
AlexEliseev7: checks 
siskin vrach: checks 
*** TURN *** [8s 9h Ac] [2h]
JoePsycho: checks 
AlexEliseev7: checks 
siskin vrach: checks 
*** RIVER *** [8s 9h Ac 2h] [Qs]
JoePsycho: bets $4
AlexEliseev7: calls $4
siskin vrach: folds 
*** SHOW DOWN ***
JoePsycho: shows [2c 2d] (three of a kind, Deuces)
AlexEliseev7: shows [Qh Qd] (three of a kind, Queens)
AlexEliseev7 collected $11.64 from pot
*** SUMMARY ***
Total pot $12.25 | Rake $0.61 
Board [8s 9h Ac 2h Qs]
Seat 1: alex_matsuka folded before Flop (didn't bet)
Seat 2: zheka656 folded before Flop (didn't bet)
Seat 3: Lemmi846 (button) folded before Flop (didn't bet)
Seat 4: JoePsycho (small blind) showed [2c 2d] and lost with three of a kind, Deuces
Seat 5: chiruha0523 (big blind) folded before Flop
Seat 6: RipZip folded before Flop (didn't bet)
Seat 7: AlexEliseev7 showed [Qh Qd] and won ($11.64) with three of a kind, Queens
Seat 9: siskin vrach folded on the River



PokerStars Hand #228681904126:  Hold'em No Limit ($0.25/$0.50 USD) - 2021/07/30 12:05:48 ET
Table 'Aitne III' 9-max Seat #4 is the button
Seat 1: alex_matsuka ($69.39 in chips) 
Seat 2: zheka656 ($54.19 in chips) 
Seat 3: Lemmi846 ($56.88 in chips) 
Seat 4: JoePsycho ($45.94 in chips) 
Seat 5: chiruha0523 ($33.74 in chips) 
Seat 6: RipZip ($49.25 in chips) 
Seat 7: AlexEliseev7 ($56.39 in chips) 
Seat 9: siskin vrach ($75.30 in chips) 
chiruha0523: posts small blind $0.25
RipZip: posts big blind $0.50
ludemix: sits out 
*** HOLE CARDS ***
AlexEliseev7: folds 
siskin vrach: folds 
alex_matsuka: folds 
zheka656: folds 
Lemmi846: folds 
JoePsycho: calls $0.50
chiruha0523: folds 
RipZip: checks 
*** FLOP *** [3c Th 7h]
RipZip: bets $0.60
JoePsycho: calls $0.60
*** TURN *** [3c Th 7h] [As]
RipZip: checks 
JoePsycho: bets $1.50
RipZip: folds 
Uncalled bet ($1.50) returned to JoePsycho
JoePsycho collected $2.33 from pot
JoePsycho: doesn't show hand 
*** SUMMARY ***
Total pot $2.45 | Rake $0.12 
Board [3c Th 7h As]
Seat 1: alex_matsuka folded before Flop (didn't bet)
Seat 2: zheka656 folded before Flop (didn't bet)
Seat 3: Lemmi846 folded before Flop (didn't bet)
Seat 4: JoePsycho (button) collected ($2.33)
Seat 5: chiruha0523 (small blind) folded before Flop
Seat 6: RipZip (big blind) folded on the Turn
Seat 7: AlexEliseev7 folded before Flop (didn't bet)
Seat 9: siskin vrach folded before Flop (didn't bet)



PokerStars Hand #228681921301:  Hold'em No Limit ($0.25/$0.50 USD) - 2021/07/30 12:06:39 ET
Table 'Aitne III' 9-max Seat #5 is the button
Seat 1: alex_matsuka ($69.39 in chips) 
Seat 2: zheka656 ($54.19 in chips) 
Seat 3: Lemmi846 ($56.88 in chips) 
Seat 4: JoePsycho ($47.17 in chips) 
Seat 5: chiruha0523 ($33.49 in chips) 
Seat 6: RipZip ($48.15 in chips) 
Seat 7: AlexEliseev7 ($56.39 in chips) 
Seat 9: siskin vrach ($75.30 in chips) 
RipZip: posts small blind $0.25
AlexEliseev7: posts big blind $0.50
ludemix: sits out 
*** HOLE CARDS ***
siskin vrach: folds 
alex_matsuka: raises $1 to $1.50
zheka656: folds 
Lemmi846: folds 
JoePsycho: folds 
chiruha0523: folds 
RipZip: folds 
AlexEliseev7: calls $1
*** FLOP *** [6s 6d Kd]
AlexEliseev7: checks 
alex_matsuka: bets $1.39
AlexEliseev7: calls $1.39
*** TURN *** [6s 6d Kd] [3h]
AlexEliseev7: checks 
alex_matsuka: bets $4.01
AlexEliseev7: folds 
Uncalled bet ($4.01) returned to alex_matsuka
alex_matsuka collected $5.73 from pot
alex_matsuka: doesn't show hand 
*** SUMMARY ***
Total pot $6.03 | Rake $0.30 
Board [6s 6d Kd 3h]
Seat 1: alex_matsuka collected ($5.73)
Seat 2: zheka656 folded before Flop (didn't bet)
Seat 3: Lemmi846 folded before Flop (didn't bet)
Seat 4: JoePsycho folded before Flop (didn't bet)
Seat 5: chiruha0523 (button) folded before Flop (didn't bet)
Seat 6: RipZip (small blind) folded before Flop
Seat 7: AlexEliseev7 (big blind) folded on the Turn
Seat 9: siskin vrach folded before Flop (didn't bet)



PokerStars Hand #228681936531:  Hold'em No Limit ($0.25/$0.50 USD) - 2021/07/30 12:07:24 ET
Table 'Aitne III' 9-max Seat #6 is the button
Seat 1: alex_matsuka ($72.23 in chips) 
Seat 2: zheka656 ($54.19 in chips) 
Seat 3: Lemmi846 ($56.88 in chips) 
Seat 4: JoePsycho ($47.17 in chips) 
Seat 5: chiruha0523 ($33.49 in chips) 
Seat 6: RipZip ($47.90 in chips) 
Seat 7: AlexEliseev7 ($53.50 in chips) 
Seat 8: ludemix ($50 in chips) 
Seat 9: siskin vrach ($75.30 in chips) 
AlexEliseev7: posts small blind $0.25
ludemix: posts big blind $0.50
*** HOLE CARDS ***
siskin vrach: raises $1 to $1.50
alex_matsuka: folds 
zheka656: folds 
Lemmi846: folds 
JoePsycho: folds 
chiruha0523: folds 
RipZip: folds 
AlexEliseev7: folds 
ludemix: folds 
Uncalled bet ($1) returned to siskin vrach
siskin vrach collected $1.25 from pot
*** SUMMARY ***
Total pot $1.25 | Rake $0 
Seat 1: alex_matsuka folded before Flop (didn't bet)
Seat 2: zheka656 folded before Flop (didn't bet)
Seat 3: Lemmi846 folded before Flop (didn't bet)
Seat 4: JoePsycho folded before Flop (didn't bet)
Seat 5: chiruha0523 folded before Flop (didn't bet)
Seat 6: RipZip (button) folded before Flop (didn't bet)
Seat 7: AlexEliseev7 (small blind) folded before Flop
Seat 8: ludemix (big blind) folded before Flop
Seat 9: siskin vrach collected ($1.25)



PokerStars Hand #228681943171:  Hold'em No Limit ($0.25/$0.50 USD) - 2021/07/30 12:07:44 ET
Table 'Aitne III' 9-max Seat #7 is the button
Seat 1: alex_matsuka ($72.23 in chips) 
Seat 2: zheka656 ($54.19 in chips) 
Seat 3: Lemmi846 ($56.88 in chips) 
Seat 4: JoePsycho ($47.17 in chips) 
Seat 5: chiruha0523 ($33.49 in chips) 
Seat 6: RipZip ($47.90 in chips) 
Seat 7: AlexEliseev7 ($53.25 in chips) 
Seat 8: ludemix ($50 in chips) 
Seat 9: siskin vrach ($76.05 in chips) 
ludemix: posts small blind $0.25
siskin vrach: posts big blind $0.50
*** HOLE CARDS ***
alex_matsuka: raises $1 to $1.50
zheka656: folds 
Lemmi846: folds 
JoePsycho: folds 
chiruha0523: folds 
RipZip: folds 
AlexEliseev7: folds 
ludemix: raises $4.50 to $6
siskin vrach: folds 
alex_matsuka: raises $5.50 to $11.50
ludemix: calls $5.50
*** FLOP *** [9c 2c 6h]
ludemix: checks 
alex_matsuka: bets $8.50
ludemix: folds 
Uncalled bet ($8.50) returned to alex_matsuka
alex_matsuka collected $22.32 from pot
alex_matsuka: doesn't show hand 
*** SUMMARY ***
Total pot $23.50 | Rake $1.18 
Board [9c 2c 6h]
Seat 1: alex_matsuka collected ($22.32)
Seat 2: zheka656 folded before Flop (didn't bet)
Seat 3: Lemmi846 folded before Flop (didn't bet)
Seat 4: JoePsycho folded before Flop (didn't bet)
Seat 5: chiruha0523 folded before Flop (didn't bet)
Seat 6: RipZip folded before Flop (didn't bet)
Seat 7: AlexEliseev7 (button) folded before Flop (didn't bet)
Seat 8: ludemix (small blind) folded on the Flop
Seat 9: siskin vrach (big blind) folded before Flop



PokerStars Hand #228681963368:  Hold'em No Limit ($0.25/$0.50 USD) - 2021/07/30 12:08:43 ET
Table 'Aitne III' 9-max Seat #8 is the button
Seat 1: alex_matsuka ($83.05 in chips) 
Seat 2: zheka656 ($54.19 in chips) 
Seat 3: Lemmi846 ($56.88 in chips) 
Seat 4: JoePsycho ($47.17 in chips) 
Seat 5: chiruha0523 ($33.49 in chips) 
Seat 6: RipZip ($47.90 in chips) 
Seat 7: AlexEliseev7 ($53.25 in chips) 
Seat 8: ludemix ($50 in chips) 
Seat 9: siskin vrach ($75.55 in chips) 
siskin vrach: posts small blind $0.25
alex_matsuka: posts big blind $0.50
*** HOLE CARDS ***
zheka656: folds 
Lemmi846: folds 
JoePsycho: folds 
chiruha0523: folds 
RipZip: folds 
AlexEliseev7: folds 
ludemix: raises $0.75 to $1.25
siskin vrach: folds 
alex_matsuka: folds 
Uncalled bet ($0.75) returned to ludemix
ludemix collected $1.25 from pot
ludemix: doesn't show hand 
*** SUMMARY ***
Total pot $1.25 | Rake $0 
Seat 1: alex_matsuka (big blind) folded before Flop
Seat 2: zheka656 folded before Flop (didn't bet)
Seat 3: Lemmi846 folded before Flop (didn't bet)
Seat 4: JoePsycho folded before Flop (didn't bet)
Seat 5: chiruha0523 folded before Flop (didn't bet)
Seat 6: RipZip folded before Flop (didn't bet)
Seat 7: AlexEliseev7 folded before Flop (didn't bet)
Seat 8: ludemix (button) collected ($1.25)
Seat 9: siskin vrach (small blind) folded before Flop



PokerStars Hand #228681968865:  Hold'em No Limit ($0.25/$0.50 USD) - 2021/07/30 12:08:59 ET
Table 'Aitne III' 9-max Seat #9 is the button
Seat 1: alex_matsuka ($82.55 in chips) 
Seat 2: zheka656 ($54.19 in chips) 
Seat 3: Lemmi846 ($56.88 in chips) 
Seat 4: JoePsycho ($47.17 in chips) 
Seat 5: chiruha0523 ($33.49 in chips) 
Seat 6: RipZip ($47.90 in chips) 
Seat 7: AlexEliseev7 ($53.25 in chips) 
Seat 8: ludemix ($50.75 in chips) 
Seat 9: siskin vrach ($75.30 in chips) 
alex_matsuka: posts small blind $0.25
zheka656: posts big blind $0.50
*** HOLE CARDS ***
Lemmi846: folds 
JoePsycho: folds 
chiruha0523: folds 
RipZip: folds 
AlexEliseev7: raises $0.75 to $1.25
ludemix: folds 
siskin vrach: folds 
alex_matsuka: folds 
zheka656: folds 
Uncalled bet ($0.75) returned to AlexEliseev7
AlexEliseev7 collected $1.25 from pot
AlexEliseev7: doesn't show hand 
*** SUMMARY ***
Total pot $1.25 | Rake $0 
Seat 1: alex_matsuka (small blind) folded before Flop
Seat 2: zheka656 (big blind) folded before Flop
Seat 3: Lemmi846 folded before Flop (didn't bet)
Seat 4: JoePsycho folded before Flop (didn't bet)
Seat 5: chiruha0523 folded before Flop (didn't bet)
Seat 6: RipZip folded before Flop (didn't bet)
Seat 7: AlexEliseev7 collected ($1.25)
Seat 8: ludemix folded before Flop (didn't bet)
Seat 9: siskin vrach (button) folded before Flop (didn't bet)



PokerStars Hand #228681973902:  Hold'em No Limit ($0.25/$0.50 USD) - 2021/07/30 12:09:14 ET
Table 'Aitne III' 9-max Seat #1 is the button
Seat 1: alex_matsuka ($82.30 in chips) 
Seat 2: zheka656 ($53.69 in chips) 
Seat 3: Lemmi846 ($56.88 in chips) 
Seat 4: JoePsycho ($47.17 in chips) 
Seat 5: chiruha0523 ($33.49 in chips) 
Seat 6: RipZip ($47.90 in chips) 
Seat 7: AlexEliseev7 ($54 in chips) 
Seat 8: ludemix ($50.75 in chips) 
Seat 9: siskin vrach ($75.30 in chips) 
zheka656: posts small blind $0.25
Lemmi846: posts big blind $0.50
*** HOLE CARDS ***
JoePsycho: folds 
chiruha0523: folds 
RipZip: folds 
AlexEliseev7: folds 
ludemix: folds 
siskin vrach: raises $1 to $1.50
alex_matsuka: folds 
zheka656: folds 
Lemmi846: folds 
Uncalled bet ($1) returned to siskin vrach
siskin vrach collected $1.25 from pot
*** SUMMARY ***
Total pot $1.25 | Rake $0 
Seat 1: alex_matsuka (button) folded before Flop (didn't bet)
Seat 2: zheka656 (small blind) folded before Flop
Seat 3: Lemmi846 (big blind) folded before Flop
Seat 4: JoePsycho folded before Flop (didn't bet)
Seat 5: chiruha0523 folded before Flop (didn't bet)
Seat 6: RipZip folded before Flop (didn't bet)
Seat 7: AlexEliseev7 folded before Flop (didn't bet)
Seat 8: ludemix folded before Flop (didn't bet)
Seat 9: siskin vrach collected ($1.25)



PokerStars Hand #228681981402:  Hold'em No Limit ($0.25/$0.50 USD) - 2021/07/30 12:09:36 ET
Table 'Aitne III' 9-max Seat #2 is the button
Seat 1: alex_matsuka ($82.30 in chips) 
Seat 2: zheka656 ($53.44 in chips) 
Seat 3: Lemmi846 ($56.38 in chips) 
Seat 4: JoePsycho ($47.17 in chips) 
Seat 5: chiruha0523 ($33.49 in chips) 
Seat 6: RipZip ($47.90 in chips) 
Seat 7: AlexEliseev7 ($54 in chips) 
Seat 8: ludemix ($50.75 in chips) 
Seat 9: siskin vrach ($76.05 in chips) 
Lemmi846: posts small blind $0.25
JoePsycho: posts big blind $0.50
*** HOLE CARDS ***
chiruha0523: folds 
RipZip: raises $0.75 to $1.25
AlexEliseev7: folds 
ludemix: folds 
siskin vrach: folds 
alex_matsuka: folds 
zheka656: folds 
Lemmi846: calls $1
JoePsycho: calls $0.75
*** FLOP *** [9c 3c 4c]
Lemmi846: checks 
JoePsycho: checks 
RipZip: bets $1.78
Lemmi846: calls $1.78
JoePsycho: folds 
*** TURN *** [9c 3c 4c] [Qh]
Lemmi846: checks 
RipZip: checks 
*** RIVER *** [9c 3c 4c Qh] [Qd]
Lemmi846: checks 
RipZip: bets $3.47
Lemmi846: folds 
Uncalled bet ($3.47) returned to RipZip
RipZip collected $6.94 from pot
RipZip: doesn't show hand 
*** SUMMARY ***
Total pot $7.31 | Rake $0.37 
Board [9c 3c 4c Qh Qd]
Seat 1: alex_matsuka folded before Flop (didn't bet)
Seat 2: zheka656 (button) folded before Flop (didn't bet)
Seat 3: Lemmi846 (small blind) folded on the River
Seat 4: JoePsycho (big blind) folded on the Flop
Seat 5: chiruha0523 folded before Flop (didn't bet)
Seat 6: RipZip collected ($6.94)
Seat 7: AlexEliseev7 folded before Flop (didn't bet)
Seat 8: ludemix folded before Flop (didn't bet)
Seat 9: siskin vrach folded before Flop (didn't bet)



PokerStars Hand #228682002049:  Hold'em No Limit ($0.25/$0.50 USD) - 2021/07/30 12:10:37 ET
Table 'Aitne III' 9-max Seat #3 is the button
Seat 1: alex_matsuka ($82.30 in chips) 
Seat 2: zheka656 ($53.44 in chips) 
Seat 3: Lemmi846 ($53.35 in chips) 
Seat 4: JoePsycho ($45.92 in chips) 
Seat 5: chiruha0523 ($33.49 in chips) 
Seat 6: RipZip ($51.81 in chips) 
Seat 7: AlexEliseev7 ($54 in chips) 
Seat 8: ludemix ($50.75 in chips) 
Seat 9: siskin vrach ($76.05 in chips) 
JoePsycho: posts small blind $0.25
chiruha0523: posts big blind $0.50
*** HOLE CARDS ***
RipZip: folds 
AlexEliseev7: folds 
ludemix: folds 
siskin vrach: folds 
alex_matsuka: folds 
zheka656: folds 
Lemmi846: folds 
JoePsycho: calls $0.25
chiruha0523: checks 
*** FLOP *** [Qd Qs 2c]
JoePsycho: checks 
chiruha0523: checks 
*** TURN *** [Qd Qs 2c] [Th]
JoePsycho: bets $1
chiruha0523: calls $1
*** RIVER *** [Qd Qs 2c Th] [Ts]
JoePsycho: bets $2.50
chiruha0523: folds 
Uncalled bet ($2.50) returned to JoePsycho
JoePsycho collected $2.85 from pot
JoePsycho: doesn't show hand 
*** SUMMARY ***
Total pot $3 | Rake $0.15 
Board [Qd Qs 2c Th Ts]
Seat 1: alex_matsuka folded before Flop (didn't bet)
Seat 2: zheka656 folded before Flop (didn't bet)
Seat 3: Lemmi846 (button) folded before Flop (didn't bet)
Seat 4: JoePsycho (small blind) collected ($2.85)
Seat 5: chiruha0523 (big blind) folded on the River
Seat 6: RipZip folded before Flop (didn't bet)
Seat 7: AlexEliseev7 folded before Flop (didn't bet)
Seat 8: ludemix folded before Flop (didn't bet)
Seat 9: siskin vrach folded before Flop (didn't bet)



PokerStars Hand #228682012300:  Hold'em No Limit ($0.25/$0.50 USD) - 2021/07/30 12:11:07 ET
Table 'Aitne III' 9-max Seat #4 is the button
Seat 1: alex_matsuka ($82.30 in chips) 
Seat 2: zheka656 ($53.44 in chips) 
Seat 3: Lemmi846 ($53.35 in chips) 
Seat 4: JoePsycho ($47.27 in chips) 
Seat 5: chiruha0523 ($31.99 in chips) 
Seat 7: AlexEliseev7 ($54 in chips) 
Seat 8: ludemix ($50.75 in chips) 
Seat 9: siskin vrach ($76.05 in chips) 
chiruha0523: posts small blind $0.25
RipZip: is sitting out 
AlexEliseev7: posts big blind $0.50
*** HOLE CARDS ***
ludemix: folds 
siskin vrach: folds 
alex_matsuka: folds 
zheka656: raises $1 to $1.50
Lemmi846: calls $1.50
JoePsycho: folds 
chiruha0523: folds 
AlexEliseev7: folds 
*** FLOP *** [Qd 8d 4c]
zheka656: bets $1.92
Lemmi846: calls $1.92
*** TURN *** [Qd 8d 4c] [9s]
zheka656: checks 
Lemmi846: checks 
*** RIVER *** [Qd 8d 4c 9s] [6s]
zheka656: checks 
Lemmi846: checks 
*** SHOW DOWN ***
zheka656: shows [Th Ah] (high card Ace)
Lemmi846: shows [Jd Js] (a pair of Jacks)
Lemmi846 collected $7.11 from pot
*** SUMMARY ***
Total pot $7.59 | Rake $0.48 
Board [Qd 8d 4c 9s 6s]
Seat 1: alex_matsuka folded before Flop (didn't bet)
Seat 2: zheka656 showed [Th Ah] and lost with high card Ace
Seat 3: Lemmi846 showed [Jd Js] and won ($7.11) with a pair of Jacks
Seat 4: JoePsycho (button) folded before Flop (didn't bet)
Seat 5: chiruha0523 (small blind) folded before Flop
Seat 7: AlexEliseev7 (big blind) folded before Flop
Seat 8: ludemix folded before Flop (didn't bet)
Seat 9: siskin vrach folded before Flop (didn't bet)



PokerStars Hand #228682037238:  Hold'em No Limit ($0.25/$0.50 USD) - 2021/07/30 12:12:21 ET
Table 'Aitne III' 9-max Seat #5 is the button
Seat 1: alex_matsuka ($82.30 in chips) 
Seat 2: zheka656 ($50.02 in chips) 
Seat 3: Lemmi846 ($57.04 in chips) 
Seat 4: JoePsycho ($47.27 in chips) 
Seat 5: chiruha0523 ($31.74 in chips) 
Seat 7: AlexEliseev7 ($53.50 in chips) 
Seat 8: ludemix ($50.75 in chips) 
Seat 9: siskin vrach ($76.05 in chips) 
AlexEliseev7: posts small blind $0.25
ludemix: posts big blind $0.50
*** HOLE CARDS ***
siskin vrach: folds 
alex_matsuka: raises $1 to $1.50
zheka656: folds 
Lemmi846: folds 
JoePsycho: calls $1.50
chiruha0523: folds 
AlexEliseev7: folds 
ludemix: folds 
*** FLOP *** [Kd Js 5h]
alex_matsuka: bets $1.60
JoePsycho: calls $1.60
*** TURN *** [Kd Js 5h] [6s]
alex_matsuka: bets $4.62
JoePsycho: folds 
Uncalled bet ($4.62) returned to alex_matsuka
alex_matsuka collected $6.60 from pot
alex_matsuka: doesn't show hand 
*** SUMMARY ***
Total pot $6.95 | Rake $0.35 
Board [Kd Js 5h 6s]
Seat 1: alex_matsuka collected ($6.60)
Seat 2: zheka656 folded before Flop (didn't bet)
Seat 3: Lemmi846 folded before Flop (didn't bet)
Seat 4: JoePsycho folded on the Turn
Seat 5: chiruha0523 (button) folded before Flop (didn't bet)
Seat 7: AlexEliseev7 (small blind) folded before Flop
Seat 8: ludemix (big blind) folded before Flop
Seat 9: siskin vrach folded before Flop (didn't bet)



PokerStars Hand #228682056064:  Hold'em No Limit ($0.25/$0.50 USD) - 2021/07/30 12:13:06 ET
Table 'Aitne III' 9-max Seat #7 is the button
Seat 1: alex_matsuka ($85.80 in chips) 
Seat 2: zheka656 ($50.02 in chips) 
Seat 3: Lemmi846 ($57.04 in chips) 
Seat 4: JoePsycho ($44.17 in chips) 
Seat 5: chiruha0523 ($31.74 in chips) 
Seat 7: AlexEliseev7 ($53.25 in chips) 
Seat 8: ludemix ($50.25 in chips) 
Seat 9: siskin vrach ($76.05 in chips) 
ludemix: posts small blind $0.25
siskin vrach: posts big blind $0.50
*** HOLE CARDS ***
alex_matsuka: folds 
zheka656: folds 
Lemmi846: raises $1 to $1.50
JoePsycho: folds 
chiruha0523: calls $1.50
AlexEliseev7: folds 
ludemix: folds 
siskin vrach: folds 
*** FLOP *** [Js 2s 5c]
Lemmi846: bets $2.50
chiruha0523: folds 
Uncalled bet ($2.50) returned to Lemmi846
Lemmi846 collected $3.51 from pot
Lemmi846: doesn't show hand 
*** SUMMARY ***
Total pot $3.75 | Rake $0.24 
Board [Js 2s 5c]
Seat 1: alex_matsuka folded before Flop (didn't bet)
Seat 2: zheka656 folded before Flop (didn't bet)
Seat 3: Lemmi846 collected ($3.51)
Seat 4: JoePsycho folded before Flop (didn't bet)
Seat 5: chiruha0523 folded on the Flop
Seat 7: AlexEliseev7 (button) folded before Flop (didn't bet)
Seat 8: ludemix (small blind) folded before Flop
Seat 9: siskin vrach (big blind) folded before Flop



PokerStars Hand #228682065940:  Hold'em No Limit ($0.25/$0.50 USD) - 2021/07/30 12:13:35 ET
Table 'Aitne III' 9-max Seat #8 is the button
Seat 1: alex_matsuka ($85.80 in chips) 
Seat 2: zheka656 ($50.02 in chips) 
Seat 3: Lemmi846 ($59.05 in chips) 
Seat 4: JoePsycho ($44.17 in chips) 
Seat 5: chiruha0523 ($30.24 in chips) 
Seat 7: AlexEliseev7 ($53.25 in chips) 
Seat 8: ludemix ($50 in chips) 
Seat 9: siskin vrach ($75.55 in chips) 
siskin vrach: posts small blind $0.25
alex_matsuka: posts big blind $0.50
*** HOLE CARDS ***
zheka656: raises $1 to $1.50
Lemmi846: folds 
JoePsycho: folds 
chiruha0523: folds 
AlexEliseev7: folds 
ludemix: folds 
siskin vrach: raises $3 to $4.50
alex_matsuka: folds 
zheka656: folds 
Uncalled bet ($3) returned to siskin vrach
siskin vrach collected $3.50 from pot
*** SUMMARY ***
Total pot $3.50 | Rake $0 
Seat 1: alex_matsuka (big blind) folded before Flop
Seat 2: zheka656 folded before Flop
Seat 3: Lemmi846 folded before Flop (didn't bet)
Seat 4: JoePsycho folded before Flop (didn't bet)
Seat 5: chiruha0523 folded before Flop (didn't bet)
Seat 7: AlexEliseev7 folded before Flop (didn't bet)
Seat 8: ludemix (button) folded before Flop (didn't bet)
Seat 9: siskin vrach (small blind) collected ($3.50)



PokerStars Hand #228682073902:  Hold'em No Limit ($0.25/$0.50 USD) - 2021/07/30 12:13:59 ET
Table 'Aitne III' 9-max Seat #9 is the button
Seat 1: alex_matsuka ($85.30 in chips) 
Seat 2: zheka656 ($50 in chips) 
Seat 3: Lemmi846 ($59.05 in chips) 
Seat 4: JoePsycho ($44.17 in chips) 
Seat 5: chiruha0523 ($30.24 in chips) 
Seat 7: AlexEliseev7 ($53.25 in chips) 
Seat 8: ludemix ($50 in chips) 
Seat 9: siskin vrach ($77.55 in chips) 
alex_matsuka: posts small blind $0.25
zheka656: posts big blind $0.50
*** HOLE CARDS ***
Lemmi846: folds 
JoePsycho: raises $0.75 to $1.25
chiruha0523: calls $1.25
AlexEliseev7: folds 
ludemix: folds 
siskin vrach: folds 
alex_matsuka: folds 
zheka656: folds 
*** FLOP *** [8s 6h 9c]
JoePsycho: bets $2
chiruha0523: folds 
Uncalled bet ($2) returned to JoePsycho
JoePsycho collected $3.09 from pot
JoePsycho: doesn't show hand 
*** SUMMARY ***
Total pot $3.25 | Rake $0.16 
Board [8s 6h 9c]
Seat 1: alex_matsuka (small blind) folded before Flop
Seat 2: zheka656 (big blind) folded before Flop
Seat 3: Lemmi846 folded before Flop (didn't bet)
Seat 4: JoePsycho collected ($3.09)
Seat 5: chiruha0523 folded on the Flop
Seat 7: AlexEliseev7 folded before Flop (didn't bet)
Seat 8: ludemix folded before Flop (didn't bet)
Seat 9: siskin vrach (button) folded before Flop (didn't bet)



PokerStars Hand #228682083649:  Hold'em No Limit ($0.25/$0.50 USD) - 2021/07/30 12:14:27 ET
Table 'Aitne III' 9-max Seat #1 is the button
Seat 1: alex_matsuka ($85.05 in chips) 
Seat 2: zheka656 ($50 in chips) 
Seat 3: Lemmi846 ($59.05 in chips) 
Seat 4: JoePsycho ($46.01 in chips) 
Seat 5: chiruha0523 ($28.99 in chips) 
Seat 7: AlexEliseev7 ($53.25 in chips) 
Seat 8: ludemix ($50 in chips) 
Seat 9: siskin vrach ($77.55 in chips) 
zheka656: posts small blind $0.25
Lemmi846: posts big blind $0.50
RipZip: sits out 
*** HOLE CARDS ***
JoePsycho: folds 
chiruha0523: folds 
AlexEliseev7: raises $0.75 to $1.25
ludemix: calls $1.25
siskin vrach: folds 
alex_matsuka: folds 
zheka656: folds 
Lemmi846: folds 
*** FLOP *** [4d 6s 2d]
AlexEliseev7: bets $1.51
ludemix: calls $1.51
*** TURN *** [4d 6s 2d] [Kd]
AlexEliseev7: checks 
ludemix: checks 
*** RIVER *** [4d 6s 2d Kd] [5s]
AlexEliseev7: checks 
ludemix: checks 
*** SHOW DOWN ***
AlexEliseev7: shows [Tc Td] (a pair of Tens)
ludemix: mucks hand 
AlexEliseev7 collected $5.96 from pot
*** SUMMARY ***
Total pot $6.27 | Rake $0.31 
Board [4d 6s 2d Kd 5s]
Seat 1: alex_matsuka (button) folded before Flop (didn't bet)
Seat 2: zheka656 (small blind) folded before Flop
Seat 3: Lemmi846 (big blind) folded before Flop
Seat 4: JoePsycho folded before Flop (didn't bet)
Seat 5: chiruha0523 folded before Flop (didn't bet)
Seat 7: AlexEliseev7 showed [Tc Td] and won ($5.96) with a pair of Tens
Seat 8: ludemix mucked
Seat 9: siskin vrach folded before Flop (didn't bet)



PokerStars Hand #228682104659:  Hold'em No Limit ($0.25/$0.50 USD) - 2021/07/30 12:15:28 ET
Table 'Aitne III' 9-max Seat #2 is the button
Seat 1: alex_matsuka ($85.05 in chips) 
Seat 2: zheka656 ($50 in chips) 
Seat 3: Lemmi846 ($58.55 in chips) 
Seat 4: JoePsycho ($46.01 in chips) 
Seat 5: chiruha0523 ($28.99 in chips) 
Seat 7: AlexEliseev7 ($56.45 in chips) 
Seat 8: ludemix ($50 in chips) 
Seat 9: siskin vrach ($77.55 in chips) 
Lemmi846: posts small blind $0.25
JoePsycho: posts big blind $0.50
RipZip: sits out 
*** HOLE CARDS ***
chiruha0523: folds 
AlexEliseev7: folds 
ludemix: folds 
siskin vrach: raises $1 to $1.50
alex_matsuka: folds 
zheka656: folds 
Lemmi846: folds 
JoePsycho: calls $1
*** FLOP *** [Th 2d 2s]
JoePsycho: checks 
siskin vrach: checks 
*** TURN *** [Th 2d 2s] [Ks]
JoePsycho: checks 
siskin vrach: bets $0.96
JoePsycho: raises $1.54 to $2.50
siskin vrach: calls $1.54
*** RIVER *** [Th 2d 2s Ks] [8h]
JoePsycho: bets $6
siskin vrach: folds 
Uncalled bet ($6) returned to JoePsycho
JoePsycho collected $7.84 from pot
JoePsycho: doesn't show hand 
*** SUMMARY ***
Total pot $8.25 | Rake $0.41 
Board [Th 2d 2s Ks 8h]
Seat 1: alex_matsuka folded before Flop (didn't bet)
Seat 2: zheka656 (button) folded before Flop (didn't bet)
Seat 3: Lemmi846 (small blind) folded before Flop
Seat 4: JoePsycho (big blind) collected ($7.84)
Seat 5: chiruha0523 folded before Flop (didn't bet)
Seat 7: AlexEliseev7 folded before Flop (didn't bet)
Seat 8: ludemix folded before Flop (didn't bet)
Seat 9: siskin vrach folded on the River



PokerStars Hand #228682124121:  Hold'em No Limit ($0.25/$0.50 USD) - 2021/07/30 12:16:26 ET
Table 'Aitne III' 9-max Seat #3 is the button
Seat 1: alex_matsuka ($85.05 in chips) 
Seat 2: zheka656 ($50 in chips) 
Seat 3: Lemmi846 ($58.30 in chips) 
Seat 4: JoePsycho ($49.85 in chips) 
Seat 5: chiruha0523 ($28.99 in chips) 
Seat 7: AlexEliseev7 ($56.45 in chips) 
Seat 8: ludemix ($50 in chips) 
Seat 9: siskin vrach ($73.55 in chips) 
JoePsycho: posts small blind $0.25
chiruha0523: posts big blind $0.50
RipZip: sits out 
*** HOLE CARDS ***
AlexEliseev7: folds 
ludemix: folds 
siskin vrach: folds 
alex_matsuka: folds 
zheka656: raises $1 to $1.50
Lemmi846: folds 
JoePsycho: calls $1.25
chiruha0523: calls $1
*** FLOP *** [4h 3d Qs]
JoePsycho: checks 
chiruha0523: checks 
zheka656: checks 
*** TURN *** [4h 3d Qs] [Js]
JoePsycho: checks 
chiruha0523: checks 
zheka656: checks 
*** RIVER *** [4h 3d Qs Js] [Tc]
JoePsycho: checks 
chiruha0523: checks 
zheka656: checks 
*** SHOW DOWN ***
JoePsycho: shows [Kh Jc] (a pair of Jacks)
chiruha0523: mucks hand 
zheka656: mucks hand 
JoePsycho collected $4.28 from pot
*** SUMMARY ***
Total pot $4.50 | Rake $0.22 
Board [4h 3d Qs Js Tc]
Seat 1: alex_matsuka folded before Flop (didn't bet)
Seat 2: zheka656 mucked
Seat 3: Lemmi846 (button) folded before Flop (didn't bet)
Seat 4: JoePsycho (small blind) showed [Kh Jc] and won ($4.28) with a pair of Jacks
Seat 5: chiruha0523 (big blind) mucked
Seat 7: AlexEliseev7 folded before Flop (didn't bet)
Seat 8: ludemix folded before Flop (didn't bet)
Seat 9: siskin vrach folded before Flop (didn't bet)



PokerStars Hand #228682140830:  Hold'em No Limit ($0.25/$0.50 USD) - 2021/07/30 12:17:14 ET
Table 'Aitne III' 9-max Seat #4 is the button
Seat 1: alex_matsuka ($85.05 in chips) 
Seat 2: zheka656 ($50 in chips) 
Seat 3: Lemmi846 ($58.30 in chips) 
Seat 4: JoePsycho ($52.63 in chips) 
Seat 5: chiruha0523 ($27.49 in chips) 
Seat 6: RipZip ($51.81 in chips) 
Seat 7: AlexEliseev7 ($56.45 in chips) 
Seat 8: ludemix ($50 in chips) 
Seat 9: siskin vrach ($73.55 in chips) 
chiruha0523: posts small blind $0.25
RipZip: posts big blind $0.50
*** HOLE CARDS ***
AlexEliseev7: raises $0.75 to $1.25
ludemix: folds 
siskin vrach: folds 
alex_matsuka: folds 
zheka656: folds 
Lemmi846: calls $1.25
JoePsycho: folds 
chiruha0523: folds 
RipZip: folds 
*** FLOP *** [8s 4s Ac]
AlexEliseev7: checks 
Lemmi846: checks 
*** TURN *** [8s 4s Ac] [9s]
AlexEliseev7: checks 
Lemmi846: checks 
*** RIVER *** [8s 4s Ac 9s] [8c]
AlexEliseev7: checks 
Lemmi846: checks 
*** SHOW DOWN ***
AlexEliseev7: shows [Kd Jd] (a pair of Eights)
Lemmi846: shows [5h 5d] (two pair, Eights and Fives)
Lemmi846 collected $3.05 from pot
*** SUMMARY ***
Total pot $3.25 | Rake $0.20 
Board [8s 4s Ac 9s 8c]
Seat 1: alex_matsuka folded before Flop (didn't bet)
Seat 2: zheka656 folded before Flop (didn't bet)
Seat 3: Lemmi846 showed [5h 5d] and won ($3.05) with two pair, Eights and Fives
Seat 4: JoePsycho (button) folded before Flop (didn't bet)
Seat 5: chiruha0523 (small blind) folded before Flop
Seat 6: RipZip (big blind) folded before Flop
Seat 7: AlexEliseev7 showed [Kd Jd] and lost with a pair of Eights
Seat 8: ludemix folded before Flop (didn't bet)
Seat 9: siskin vrach folded before Flop (didn't bet)



PokerStars Hand #228682160012:  Hold'em No Limit ($0.25/$0.50 USD) - 2021/07/30 12:18:09 ET
Table 'Aitne III' 9-max Seat #5 is the button
Seat 1: alex_matsuka ($85.05 in chips) 
Seat 2: zheka656 ($50 in chips) 
Seat 3: Lemmi846 ($60.10 in chips) 
Seat 4: JoePsycho ($52.63 in chips) 
Seat 5: chiruha0523 ($27.24 in chips) 
Seat 6: RipZip ($51.31 in chips) 
Seat 7: AlexEliseev7 ($55.20 in chips) 
Seat 8: ludemix ($50 in chips) 
Seat 9: siskin vrach ($73.55 in chips) 
RipZip: posts small blind $0.25
AlexEliseev7: posts big blind $0.50
*** HOLE CARDS ***
ludemix: raises $0.75 to $1.25
siskin vrach: folds 
alex_matsuka: folds 
zheka656: folds 
Lemmi846: folds 
JoePsycho: folds 
chiruha0523: calls $1.25
RipZip: folds 
AlexEliseev7: raises $5.75 to $7
ludemix: calls $5.75
chiruha0523: folds 
*** FLOP *** [Tc 5h 2c]
AlexEliseev7: checks 
ludemix: bets $5.15
AlexEliseev7: calls $5.15
*** TURN *** [Tc 5h 2c] [5d]
AlexEliseev7: checks 
ludemix: checks 
*** RIVER *** [Tc 5h 2c 5d] [Qs]
AlexEliseev7: bets $19.61
ludemix: calls $19.61
*** SHOW DOWN ***
AlexEliseev7: shows [Kh As] (a pair of Fives)
ludemix: shows [Qd Jd] (two pair, Queens and Fives)
ludemix collected $63.02 from pot
*** SUMMARY ***
Total pot $65.02 | Rake $2 
Board [Tc 5h 2c 5d Qs]
Seat 1: alex_matsuka folded before Flop (didn't bet)
Seat 2: zheka656 folded before Flop (didn't bet)
Seat 3: Lemmi846 folded before Flop (didn't bet)
Seat 4: JoePsycho folded before Flop (didn't bet)
Seat 5: chiruha0523 (button) folded before Flop
Seat 6: RipZip (small blind) folded before Flop
Seat 7: AlexEliseev7 (big blind) showed [Kh As] and lost with a pair of Fives
Seat 8: ludemix showed [Qd Jd] and won ($63.02) with two pair, Queens and Fives
Seat 9: siskin vrach folded before Flop (didn't bet)



PokerStars Hand #228682190518:  Hold'em No Limit ($0.25/$0.50 USD) - 2021/07/30 12:19:38 ET
Table 'Aitne III' 9-max Seat #6 is the button
Seat 1: alex_matsuka ($85.05 in chips) 
Seat 2: zheka656 ($50 in chips) 
Seat 3: Lemmi846 ($60.10 in chips) 
Seat 4: JoePsycho ($52.63 in chips) 
Seat 5: chiruha0523 ($25.99 in chips) 
Seat 6: RipZip ($51.06 in chips) 
Seat 7: AlexEliseev7 ($50 in chips) 
Seat 8: ludemix ($81.26 in chips) 
Seat 9: siskin vrach ($73.55 in chips) 
AlexEliseev7: posts small blind $0.25
ludemix: posts big blind $0.50
*** HOLE CARDS ***
siskin vrach: raises $1 to $1.50
alex_matsuka: folds 
zheka656: folds 
Lemmi846: folds 
JoePsycho: folds 
chiruha0523: calls $1.50
RipZip: folds 
AlexEliseev7: folds 
ludemix: folds 
*** FLOP *** [Ah Ad 8s]
siskin vrach: checks 
chiruha0523: checks 
*** TURN *** [Ah Ad 8s] [3d]
siskin vrach: bets $1.50
chiruha0523: calls $1.50
*** RIVER *** [Ah Ad 8s 3d] [4h]
siskin vrach: bets $5.38
chiruha0523: calls $5.38
*** SHOW DOWN ***
siskin vrach: shows [Ac 6c] (three of a kind, Aces)
chiruha0523: mucks hand 
siskin vrach collected $16.63 from pot
*** SUMMARY ***
Total pot $17.51 | Rake $0.88 
Board [Ah Ad 8s 3d 4h]
Seat 1: alex_matsuka folded before Flop (didn't bet)
Seat 2: zheka656 folded before Flop (didn't bet)
Seat 3: Lemmi846 folded before Flop (didn't bet)
Seat 4: JoePsycho folded before Flop (didn't bet)
Seat 5: chiruha0523 mucked
Seat 6: RipZip (button) folded before Flop (didn't bet)
Seat 7: AlexEliseev7 (small blind) folded before Flop
Seat 8: ludemix (big blind) folded before Flop
Seat 9: siskin vrach showed [Ac 6c] and won ($16.63) with three of a kind, Aces



PokerStars Hand #228682210601:  Hold'em No Limit ($0.25/$0.50 USD) - 2021/07/30 12:20:37 ET
Table 'Aitne III' 9-max Seat #7 is the button
Seat 1: alex_matsuka ($85.05 in chips) 
Seat 2: zheka656 ($50 in chips) 
Seat 3: Lemmi846 ($60.10 in chips) 
Seat 4: JoePsycho ($52.63 in chips) 
Seat 5: chiruha0523 ($17.61 in chips) 
Seat 6: RipZip ($51.06 in chips) 
Seat 7: AlexEliseev7 ($50 in chips) 
Seat 8: ludemix ($80.76 in chips) 
Seat 9: siskin vrach ($81.80 in chips) 
ludemix: posts small blind $0.25
siskin vrach: posts big blind $0.50
*** HOLE CARDS ***
alex_matsuka: folds 
zheka656: folds 
Lemmi846: folds 
JoePsycho: raises $0.75 to $1.25
chiruha0523: folds 
RipZip: folds 
AlexEliseev7: folds 
ludemix: folds 
siskin vrach: folds 
Uncalled bet ($0.75) returned to JoePsycho
JoePsycho collected $1.25 from pot
JoePsycho: doesn't show hand 
*** SUMMARY ***
Total pot $1.25 | Rake $0 
Seat 1: alex_matsuka folded before Flop (didn't bet)
Seat 2: zheka656 folded before Flop (didn't bet)
Seat 3: Lemmi846 folded before Flop (didn't bet)
Seat 4: JoePsycho collected ($1.25)
Seat 5: chiruha0523 folded before Flop (didn't bet)
Seat 6: RipZip folded before Flop (didn't bet)
Seat 7: AlexEliseev7 (button) folded before Flop (didn't bet)
Seat 8: ludemix (small blind) folded before Flop
Seat 9: siskin vrach (big blind) folded before Flop



PokerStars Hand #228682219345:  Hold'em No Limit ($0.25/$0.50 USD) - 2021/07/30 12:21:02 ET
Table 'Aitne III' 9-max Seat #8 is the button
Seat 1: alex_matsuka ($85.05 in chips) 
Seat 3: Lemmi846 ($60.10 in chips) 
Seat 4: JoePsycho ($53.38 in chips) 
Seat 5: chiruha0523 ($17.61 in chips) 
Seat 6: RipZip ($51.06 in chips) 
Seat 7: AlexEliseev7 ($50 in chips) 
Seat 8: ludemix ($80.51 in chips) 
alex_matsuka: posts small blind $0.25
zheka656: is sitting out 
Lemmi846: posts big blind $0.50
*** HOLE CARDS ***
JoePsycho: folds 
zheka656 leaves the table
chiruha0523: folds 
RipZip: folds 
Dragonclawss joins the table at seat #2 
JoePsycho leaves the table
AlexEliseev7: raises $0.75 to $1.25
ludemix: folds 
alex_matsuka: raises $3.25 to $4.50
Lemmi846: folds 
juwnas joins the table at seat #4 
AlexEliseev7: calls $3.25
*** FLOP *** [9c 3d 8d]
alex_matsuka: bets $4.06
AlexEliseev7: folds 
Uncalled bet ($4.06) returned to alex_matsuka
alex_matsuka collected $9.02 from pot
alex_matsuka: doesn't show hand 
*** SUMMARY ***
Total pot $9.50 | Rake $0.48 
Board [9c 3d 8d]
Seat 1: alex_matsuka (small blind) collected ($9.02)
Seat 3: Lemmi846 (big blind) folded before Flop
Seat 4: JoePsycho folded before Flop (didn't bet)
Seat 5: chiruha0523 folded before Flop (didn't bet)
Seat 6: RipZip folded before Flop (didn't bet)
Seat 7: AlexEliseev7 folded on the Flop
Seat 8: ludemix (button) folded before Flop (didn't bet)



PokerStars Hand #228682233322:  Hold'em No Limit ($0.25/$0.50 USD) - 2021/07/30 12:21:43 ET
Table 'Aitne III' 9-max Seat #1 is the button
Seat 1: alex_matsuka ($89.57 in chips) 
Seat 3: Lemmi846 ($59.60 in chips) 
Seat 4: juwnas ($50 in chips) 
Seat 5: chiruha0523 ($17.61 in chips) 
Seat 6: RipZip ($51.06 in chips) 
Seat 7: AlexEliseev7 ($50 in chips) 
Seat 8: ludemix ($80.51 in chips) 
Lemmi846: posts small blind $0.25
juwnas: posts big blind $0.50
*** HOLE CARDS ***
chiruha0523: folds 
RipZip: raises $0.75 to $1.25
AlexEliseev7: folds 
ludemix: folds 
alex_matsuka: folds 
Lemmi846: folds 
juwnas: calls $0.75
*** FLOP *** [4d Qc 9d]
juwnas: checks 
RipZip: bets $1.31
juwnas: calls $1.31
*** TURN *** [4d Qc 9d] [Td]
juwnas: bets $4.05
RipZip: folds 
Uncalled bet ($4.05) returned to juwnas
juwnas collected $5.10 from pot
juwnas: doesn't show hand 
*** SUMMARY ***
Total pot $5.37 | Rake $0.27 
Board [4d Qc 9d Td]
Seat 1: alex_matsuka (button) folded before Flop (didn't bet)
Seat 3: Lemmi846 (small blind) folded before Flop
Seat 4: juwnas (big blind) collected ($5.10)
Seat 5: chiruha0523 folded before Flop (didn't bet)
Seat 6: RipZip folded on the Turn
Seat 7: AlexEliseev7 folded before Flop (didn't bet)
Seat 8: ludemix folded before Flop (didn't bet)



PokerStars Hand #228682250789:  Hold'em No Limit ($0.25/$0.50 USD) - 2021/07/30 12:22:34 ET
Table 'Aitne III' 9-max Seat #3 is the button
Seat 1: alex_matsuka ($89.57 in chips) 
Seat 3: Lemmi846 ($59.35 in chips) 
Seat 4: juwnas ($52.54 in chips) 
Seat 5: chiruha0523 ($17.61 in chips) 
Seat 6: RipZip ($48.50 in chips) 
Seat 7: AlexEliseev7 ($50 in chips) 
Seat 8: ludemix ($80.51 in chips) 
juwnas: posts small blind $0.25
chiruha0523: posts big blind $0.50
Dragonclawss: sits out 
*** HOLE CARDS ***
RipZip: folds 
AlexEliseev7: folds 
ludemix: folds 
alex_matsuka: raises $1 to $1.50
Lemmi846: folds 
juwnas: calls $1.25
chiruha0523: folds 
*** FLOP *** [7h Jh 2d]
juwnas: checks 
alex_matsuka: checks 
*** TURN *** [7h Jh 2d] [As]
juwnas: checks 
alex_matsuka: bets $1.49
juwnas: calls $1.49
*** RIVER *** [7h Jh 2d As] [3h]
juwnas: checks 
alex_matsuka: checks 
*** SHOW DOWN ***
juwnas: shows [Ad 3d] (two pair, Aces and Threes)
alex_matsuka: mucks hand 
juwnas collected $6.16 from pot
*** SUMMARY ***
Total pot $6.48 | Rake $0.32 
Board [7h Jh 2d As 3h]
Seat 1: alex_matsuka mucked
Seat 3: Lemmi846 (button) folded before Flop (didn't bet)
Seat 4: juwnas (small blind) showed [Ad 3d] and won ($6.16) with two pair, Aces and Threes
Seat 5: chiruha0523 (big blind) folded before Flop
Seat 6: RipZip folded before Flop (didn't bet)
Seat 7: AlexEliseev7 folded before Flop (didn't bet)
Seat 8: ludemix folded before Flop (didn't bet)



PokerStars Hand #228682261842:  Hold'em No Limit ($0.25/$0.50 USD) - 2021/07/30 12:23:06 ET
Table 'Aitne III' 9-max Seat #4 is the button
Seat 1: alex_matsuka ($86.58 in chips) 
Seat 3: Lemmi846 ($59.35 in chips) 
Seat 4: juwnas ($55.71 in chips) 
Seat 5: chiruha0523 ($17.11 in chips) 
Seat 6: RipZip ($50 in chips) 
Seat 7: AlexEliseev7 ($50 in chips) 
Seat 8: ludemix ($80.51 in chips) 
chiruha0523: posts small blind $0.25
RipZip: posts big blind $0.50
siskin vrach: sits out 
Dragonclawss: sits out 
*** HOLE CARDS ***
AlexEliseev7: folds 
ludemix: folds 
alex_matsuka: raises $1 to $1.50
Lemmi846: folds 
juwnas: folds 
chiruha0523: folds 
RipZip: folds 
Uncalled bet ($1) returned to alex_matsuka
alex_matsuka collected $1.25 from pot
alex_matsuka: doesn't show hand 
*** SUMMARY ***
Total pot $1.25 | Rake $0 
Seat 1: alex_matsuka collected ($1.25)
Seat 3: Lemmi846 folded before Flop (didn't bet)
Seat 4: juwnas (button) folded before Flop (didn't bet)
Seat 5: chiruha0523 (small blind) folded before Flop
Seat 6: RipZip (big blind) folded before Flop
Seat 7: AlexEliseev7 folded before Flop (didn't bet)
Seat 8: ludemix folded before Flop (didn't bet)



PokerStars Hand #228682268069:  Hold'em No Limit ($0.25/$0.50 USD) - 2021/07/30 12:23:24 ET
Table 'Aitne III' 9-max Seat #5 is the button
Seat 1: alex_matsuka ($87.33 in chips) 
Seat 3: Lemmi846 ($59.35 in chips) 
Seat 4: juwnas ($55.71 in chips) 
Seat 5: chiruha0523 ($16.86 in chips) 
Seat 6: RipZip ($49.50 in chips) 
Seat 8: ludemix ($80.51 in chips) 
RipZip: posts small blind $0.25
AlexEliseev7: is sitting out 
ludemix: posts big blind $0.50
siskin vrach: sits out 
Dragonclawss: sits out 
*** HOLE CARDS ***
alex_matsuka: folds 
AlexEliseev7 leaves the table
Lemmi846: folds 
juwnas: folds 
chiruha0523: folds 
RipZip: folds 
Uncalled bet ($0.25) returned to ludemix
ludemix collected $0.50 from pot
ludemix: doesn't show hand 
*** SUMMARY ***
Total pot $0.50 | Rake $0 
Seat 1: alex_matsuka folded before Flop (didn't bet)
Seat 3: Lemmi846 folded before Flop (didn't bet)
Seat 4: juwnas folded before Flop (didn't bet)
Seat 5: chiruha0523 (button) folded before Flop (didn't bet)
Seat 6: RipZip (small blind) folded before Flop
Seat 8: ludemix (big blind) collected ($0.50)



PokerStars Hand #228682275178:  Hold'em No Limit ($0.25/$0.50 USD) - 2021/07/30 12:23:45 ET
Table 'Aitne III' 9-max Seat #6 is the button
Seat 1: alex_matsuka ($87.33 in chips) 
Seat 3: Lemmi846 ($59.35 in chips) 
Seat 4: juwnas ($55.71 in chips) 
Seat 5: chiruha0523 ($16.86 in chips) 
Seat 6: RipZip ($49.25 in chips) 
Seat 8: ludemix ($80.76 in chips) 
Seat 9: siskin vrach ($81.30 in chips) 
ludemix: posts small blind $0.25
siskin vrach: posts big blind $0.50
Dragonclawss: sits out 
*** HOLE CARDS ***
alex_matsuka: folds 
Lemmi846: folds 
juwnas: folds 
chiruha0523: folds 
RipZip: raises $0.75 to $1.25
ludemix: folds 
any2cardsxx joins the table at seat #7 
siskin vrach: calls $0.75
*** FLOP *** [Kd 7s 2s]
siskin vrach: checks 
RipZip: checks 
*** TURN *** [Kd 7s 2s] [4c]
siskin vrach: checks 
RipZip: bets $1.31
siskin vrach: calls $1.31
*** RIVER *** [Kd 7s 2s 4c] [6s]
siskin vrach: checks 
RipZip: bets $2
siskin vrach: folds 
Uncalled bet ($2) returned to RipZip
RipZip collected $5.10 from pot
RipZip: doesn't show hand 
*** SUMMARY ***
Total pot $5.37 | Rake $0.27 
Board [Kd 7s 2s 4c 6s]
Seat 1: alex_matsuka folded before Flop (didn't bet)
Seat 3: Lemmi846 folded before Flop (didn't bet)
Seat 4: juwnas folded before Flop (didn't bet)
Seat 5: chiruha0523 folded before Flop (didn't bet)
Seat 6: RipZip (button) collected ($5.10)
Seat 8: ludemix (small blind) folded before Flop
Seat 9: siskin vrach (big blind) folded on the River



PokerStars Hand #228682324257:  Hold'em No Limit ($0.25/$0.50 USD) - 2021/07/30 12:25:41 ET
Table 'Aitne III' 9-max Seat #8 is the button
Seat 1: alex_matsuka ($87.33 in chips) 
Seat 3: Lemmi846 ($59.35 in chips) 
Seat 4: juwnas ($55.71 in chips) 
Seat 5: chiruha0523 ($16.86 in chips) 
Seat 6: RipZip ($51.79 in chips) 
Seat 7: any2cardsxx ($45.21 in chips) 
Seat 8: ludemix ($80.51 in chips) 
Seat 9: siskin vrach ($78.74 in chips) 
siskin vrach: posts small blind $0.25
alex_matsuka: posts big blind $0.50
Dragonclawss: sits out 
any2cardsxx: posts big blind $0.50
*** HOLE CARDS ***
Lemmi846: folds 
juwnas: folds 
chiruha0523: folds 
RipZip: folds 
any2cardsxx: checks 
ludemix: folds 
siskin vrach: raises $2 to $2.50
alex_matsuka: folds 
any2cardsxx: calls $2
*** FLOP *** [9h Kd 5d]
siskin vrach: checks 
any2cardsxx: checks 
*** TURN *** [9h Kd 5d] [6h]
siskin vrach: bets $2.50
any2cardsxx: folds 
Uncalled bet ($2.50) returned to siskin vrach
siskin vrach collected $5.22 from pot
*** SUMMARY ***
Total pot $5.50 | Rake $0.28 
Board [9h Kd 5d 6h]
Seat 1: alex_matsuka (big blind) folded before Flop
Seat 3: Lemmi846 folded before Flop (didn't bet)
Seat 4: juwnas folded before Flop (didn't bet)
Seat 5: chiruha0523 folded before Flop (didn't bet)
Seat 6: RipZip folded before Flop (didn't bet)
Seat 7: any2cardsxx folded on the Turn
Seat 8: ludemix (button) folded before Flop (didn't bet)
Seat 9: siskin vrach (small blind) collected ($5.22)



PokerStars Hand #228682344312:  Hold'em No Limit ($0.25/$0.50 USD) - 2021/07/30 12:26:38 ET
Table 'Aitne III' 9-max Seat #9 is the button
Seat 1: alex_matsuka ($86.83 in chips) 
Seat 2: Dragonclawss ($50 in chips) 
Seat 3: Lemmi846 ($59.35 in chips) 
Seat 4: juwnas ($55.71 in chips) 
Seat 5: chiruha0523 ($16.86 in chips) 
Seat 6: RipZip ($51.79 in chips) 
Seat 7: any2cardsxx ($42.71 in chips) 
Seat 8: ludemix ($80.51 in chips) 
Seat 9: siskin vrach ($81.46 in chips) 
alex_matsuka: posts small blind $0.25
Dragonclawss: posts big blind $0.50
*** HOLE CARDS ***
Lemmi846: folds 
juwnas: folds 
chiruha0523: raises $1 to $1.50
RipZip: calls $1.50
any2cardsxx: folds 
ludemix: folds 
siskin vrach: folds 
alex_matsuka: folds 
Dragonclawss: folds 
*** FLOP *** [Td Qd 3c]
chiruha0523: bets $1.78
RipZip: calls $1.78
*** TURN *** [Td Qd 3c] [2s]
chiruha0523: checks 
RipZip: checks 
*** RIVER *** [Td Qd 3c 2s] [2c]
chiruha0523: bets $13.58 and is all-in
RipZip: folds 
Uncalled bet ($13.58) returned to chiruha0523
chiruha0523 collected $6.94 from pot
chiruha0523: doesn't show hand 
*** SUMMARY ***
Total pot $7.31 | Rake $0.37 
Board [Td Qd 3c 2s 2c]
Seat 1: alex_matsuka (small blind) folded before Flop
Seat 2: Dragonclawss (big blind) folded before Flop
Seat 3: Lemmi846 folded before Flop (didn't bet)
Seat 4: juwnas folded before Flop (didn't bet)
Seat 5: chiruha0523 collected ($6.94)
Seat 6: RipZip folded on the River
Seat 7: any2cardsxx folded before Flop (didn't bet)
Seat 8: ludemix folded before Flop (didn't bet)
Seat 9: siskin vrach (button) folded before Flop (didn't bet)



PokerStars Hand #228682368753:  Hold'em No Limit ($0.25/$0.50 USD) - 2021/07/30 12:27:46 ET
Table 'Aitne III' 9-max Seat #1 is the button
Seat 1: alex_matsuka ($86.58 in chips) 
Seat 2: Dragonclawss ($50 in chips) 
Seat 3: Lemmi846 ($59.35 in chips) 
Seat 4: juwnas ($55.71 in chips) 
Seat 5: chiruha0523 ($20.52 in chips) 
Seat 6: RipZip ($48.51 in chips) 
Seat 7: any2cardsxx ($42.71 in chips) 
Seat 8: ludemix ($80.51 in chips) 
Seat 9: siskin vrach ($81.46 in chips) 
Dragonclawss: posts small blind $0.25
Lemmi846: posts big blind $0.50
*** HOLE CARDS ***
juwnas has timed out
juwnas: folds 
chiruha0523: folds 
RipZip: raises $0.75 to $1.25
any2cardsxx: folds 
ludemix: folds 
siskin vrach: folds 
alex_matsuka: folds 
Dragonclawss: folds 
Lemmi846: folds 
Uncalled bet ($0.75) returned to RipZip
RipZip collected $1.25 from pot
RipZip: doesn't show hand 
*** SUMMARY ***
Total pot $1.25 | Rake $0 
Seat 1: alex_matsuka (button) folded before Flop (didn't bet)
Seat 2: Dragonclawss (small blind) folded before Flop
Seat 3: Lemmi846 (big blind) folded before Flop
Seat 4: juwnas folded before Flop (didn't bet)
Seat 5: chiruha0523 folded before Flop (didn't bet)
Seat 6: RipZip collected ($1.25)
Seat 7: any2cardsxx folded before Flop (didn't bet)
Seat 8: ludemix folded before Flop (didn't bet)
Seat 9: siskin vrach folded before Flop (didn't bet)



PokerStars Hand #228682377861:  Hold'em No Limit ($0.25/$0.50 USD) - 2021/07/30 12:28:12 ET
Table 'Aitne III' 9-max Seat #2 is the button
Seat 1: alex_matsuka ($86.58 in chips) 
Seat 2: Dragonclawss ($50 in chips) 
Seat 3: Lemmi846 ($58.85 in chips) 
Seat 4: juwnas ($55.71 in chips) 
Seat 5: chiruha0523 ($20.52 in chips) 
Seat 6: RipZip ($49.26 in chips) 
Seat 7: any2cardsxx ($42.71 in chips) 
Seat 8: ludemix ($80.51 in chips) 
Seat 9: siskin vrach ($81.46 in chips) 
Lemmi846: posts small blind $0.25
juwnas: posts big blind $0.50
*** HOLE CARDS ***
chiruha0523: raises $1 to $1.50
RipZip: folds 
any2cardsxx: folds 
ludemix: folds 
siskin vrach: folds 
alex_matsuka: folds 
Dragonclawss: folds 
Lemmi846: folds 
juwnas: folds 
Uncalled bet ($1) returned to chiruha0523
chiruha0523 collected $1.25 from pot
chiruha0523: doesn't show hand 
*** SUMMARY ***
Total pot $1.25 | Rake $0 
Seat 1: alex_matsuka folded before Flop (didn't bet)
Seat 2: Dragonclawss (button) folded before Flop (didn't bet)
Seat 3: Lemmi846 (small blind) folded before Flop
Seat 4: juwnas (big blind) folded before Flop
Seat 5: chiruha0523 collected ($1.25)
Seat 6: RipZip folded before Flop (didn't bet)
Seat 7: any2cardsxx folded before Flop (didn't bet)
Seat 8: ludemix folded before Flop (didn't bet)
Seat 9: siskin vrach folded before Flop (didn't bet)



PokerStars Hand #228682389412:  Hold'em No Limit ($0.25/$0.50 USD) - 2021/07/30 12:28:45 ET
Table 'Aitne III' 9-max Seat #3 is the button
Seat 1: alex_matsuka ($86.58 in chips) 
Seat 2: Dragonclawss ($50 in chips) 
Seat 3: Lemmi846 ($58.60 in chips) 
Seat 4: juwnas ($55.21 in chips) 
Seat 5: chiruha0523 ($21.27 in chips) 
Seat 6: RipZip ($49.26 in chips) 
Seat 7: any2cardsxx ($42.71 in chips) 
Seat 8: ludemix ($80.51 in chips) 
Seat 9: siskin vrach ($81.46 in chips) 
juwnas: posts small blind $0.25
chiruha0523: posts big blind $0.50
*** HOLE CARDS ***
RipZip: folds 
any2cardsxx: folds 
ludemix: folds 
siskin vrach: folds 
alex_matsuka: folds 
Dragonclawss: raises $0.75 to $1.25
Lemmi846: folds 
juwnas: folds 
chiruha0523: calls $0.75
*** FLOP *** [4h Kh Jd]
chiruha0523: checks 
Dragonclawss: bets $2
chiruha0523: folds 
Uncalled bet ($2) returned to Dragonclawss
Dragonclawss collected $2.61 from pot
Dragonclawss: doesn't show hand 
*** SUMMARY ***
Total pot $2.75 | Rake $0.14 
Board [4h Kh Jd]
Seat 1: alex_matsuka folded before Flop (didn't bet)
Seat 2: Dragonclawss collected ($2.61)
Seat 3: Lemmi846 (button) folded before Flop (didn't bet)
Seat 4: juwnas (small blind) folded before Flop
Seat 5: chiruha0523 (big blind) folded on the Flop
Seat 6: RipZip folded before Flop (didn't bet)
Seat 7: any2cardsxx folded before Flop (didn't bet)
Seat 8: ludemix folded before Flop (didn't bet)
Seat 9: siskin vrach folded before Flop (didn't bet)



PokerStars Hand #228682410327:  Hold'em No Limit ($0.25/$0.50 USD) - 2021/07/30 12:29:45 ET
Table 'Aitne III' 9-max Seat #4 is the button
Seat 1: alex_matsuka ($86.58 in chips) 
Seat 2: Dragonclawss ($51.36 in chips) 
Seat 3: Lemmi846 ($58.60 in chips) 
Seat 4: juwnas ($54.96 in chips) 
Seat 5: chiruha0523 ($20.02 in chips) 
Seat 6: RipZip ($49.26 in chips) 
Seat 7: any2cardsxx ($42.71 in chips) 
Seat 8: ludemix ($80.51 in chips) 
Seat 9: siskin vrach ($81.46 in chips) 
chiruha0523: posts small blind $0.25
RipZip: posts big blind $0.50
*** HOLE CARDS ***
any2cardsxx: folds 
ludemix: folds 
siskin vrach: folds 
alex_matsuka: folds 
Dragonclawss: folds 
Lemmi846: folds 
juwnas: folds 
chiruha0523: folds 
Uncalled bet ($0.25) returned to RipZip
RipZip collected $0.50 from pot
RipZip: doesn't show hand 
*** SUMMARY ***
Total pot $0.50 | Rake $0 
Seat 1: alex_matsuka folded before Flop (didn't bet)
Seat 2: Dragonclawss folded before Flop (didn't bet)
Seat 3: Lemmi846 folded before Flop (didn't bet)
Seat 4: juwnas (button) folded before Flop (didn't bet)
Seat 5: chiruha0523 (small blind) folded before Flop
Seat 6: RipZip (big blind) collected ($0.50)
Seat 7: any2cardsxx folded before Flop (didn't bet)
Seat 8: ludemix folded before Flop (didn't bet)
Seat 9: siskin vrach folded before Flop (didn't bet)



PokerStars Hand #228682417303:  Hold'em No Limit ($0.25/$0.50 USD) - 2021/07/30 12:30:05 ET
Table 'Aitne III' 9-max Seat #5 is the button
Seat 1: alex_matsuka ($86.58 in chips) 
Seat 2: Dragonclawss ($51.36 in chips) 
Seat 3: Lemmi846 ($58.60 in chips) 
Seat 4: juwnas ($54.96 in chips) 
Seat 5: chiruha0523 ($19.77 in chips) 
Seat 6: RipZip ($49.51 in chips) 
Seat 7: any2cardsxx ($42.71 in chips) 
Seat 8: ludemix ($80.51 in chips) 
Seat 9: siskin vrach ($81.46 in chips) 
RipZip: posts small blind $0.25
any2cardsxx: posts big blind $0.50
*** HOLE CARDS ***
ludemix: folds 
siskin vrach: raises $1 to $1.50
alex_matsuka: folds 
Dragonclawss: folds 
Lemmi846: folds 
juwnas: folds 
chiruha0523: folds 
RipZip: folds 
any2cardsxx: folds 
Uncalled bet ($1) returned to siskin vrach
siskin vrach collected $1.25 from pot
*** SUMMARY ***
Total pot $1.25 | Rake $0 
Seat 1: alex_matsuka folded before Flop (didn't bet)
Seat 2: Dragonclawss folded before Flop (didn't bet)
Seat 3: Lemmi846 folded before Flop (didn't bet)
Seat 4: juwnas folded before Flop (didn't bet)
Seat 5: chiruha0523 (button) folded before Flop (didn't bet)
Seat 6: RipZip (small blind) folded before Flop
Seat 7: any2cardsxx (big blind) folded before Flop
Seat 8: ludemix folded before Flop (didn't bet)
Seat 9: siskin vrach collected ($1.25)



PokerStars Hand #228683199496:  Hold'em No Limit ($0.25/$0.50 USD) - 2021/07/30 13:05:34 ET
Table 'Aitne III' 9-max Seat #8 is the button
Seat 2: dstrola ($50 in chips) 
Seat 3: Lemmi846 ($67.77 in chips) 
Seat 4: juwnas ($98.21 in chips) 
Seat 5: x_ROSH125_x ($60.39 in chips) 
Seat 8: ludemix ($94.04 in chips) 
Seat 9: siskin vrach ($101.94 in chips) 
siskin vrach: posts small blind $0.25
alex_matsuka: is sitting out 
alex_matsuka leaves the table
dstrola: posts big blind $0.50
*** HOLE CARDS ***
Lemmi846: folds 
juwnas: folds 
x_ROSH125_x: folds 
ludemix: raises $0.75 to $1.25
siskin vrach: folds 
dstrola: folds 
Uncalled bet ($0.75) returned to ludemix
ludemix collected $1.25 from pot
ludemix: doesn't show hand 
*** SUMMARY ***
Total pot $1.25 | Rake $0 
Seat 2: dstrola (big blind) folded before Flop
Seat 3: Lemmi846 folded before Flop (didn't bet)
Seat 4: juwnas folded before Flop (didn't bet)
Seat 5: x_ROSH125_x folded before Flop (didn't bet)
Seat 8: ludemix (button) collected ($1.25)
Seat 9: siskin vrach (small blind) folded before Flop



PokerStars Hand #228683210414:  Hold'em No Limit ($0.25/$0.50 USD) - 2021/07/30 13:06:01 ET
Table 'Aitne III' 9-max Seat #9 is the button
Seat 2: dstrola ($50 in chips) 
Seat 3: Lemmi846 ($67.77 in chips) 
Seat 4: juwnas ($98.21 in chips) 
Seat 5: x_ROSH125_x ($60.39 in chips) 
Seat 8: ludemix ($94.79 in chips) 
Seat 9: siskin vrach ($101.69 in chips) 
dstrola: posts small blind $0.25
Lemmi846: posts big blind $0.50
*** HOLE CARDS ***
juwnas: folds 
x_ROSH125_x: folds 
ludemix: folds 
siskin vrach: raises $1 to $1.50
dstrola: folds 
Lemmi846: folds 
Uncalled bet ($1) returned to siskin vrach
siskin vrach collected $1.25 from pot
*** SUMMARY ***
Total pot $1.25 | Rake $0 
Seat 2: dstrola (small blind) folded before Flop
Seat 3: Lemmi846 (big blind) folded before Flop
Seat 4: juwnas folded before Flop (didn't bet)
Seat 5: x_ROSH125_x folded before Flop (didn't bet)
Seat 8: ludemix folded before Flop (didn't bet)
Seat 9: siskin vrach (button) collected ($1.25)



PokerStars Hand #228683215871:  Hold'em No Limit ($0.25/$0.50 USD) - 2021/07/30 13:06:15 ET
Table 'Aitne III' 9-max Seat #2 is the button
Seat 2: dstrola ($50 in chips) 
Seat 3: Lemmi846 ($67.27 in chips) 
Seat 4: juwnas ($98.21 in chips) 
Seat 5: x_ROSH125_x ($60.39 in chips) 
Seat 8: ludemix ($94.79 in chips) 
Seat 9: siskin vrach ($102.44 in chips) 
Lemmi846: posts small blind $0.25
juwnas: posts big blind $0.50
*** HOLE CARDS ***
x_ROSH125_x: folds 
ludemix: folds 
siskin vrach: folds 
dstrola: folds 
Lemmi846: raises $0.50 to $1
dikanmax joins the table at seat #7 
juwnas: folds 
Uncalled bet ($0.50) returned to Lemmi846
Lemmi846 collected $1 from pot
Lemmi846: doesn't show hand 
*** SUMMARY ***
Total pot $1 | Rake $0 
Seat 2: dstrola (button) folded before Flop (didn't bet)
Seat 3: Lemmi846 (small blind) collected ($1)
Seat 4: juwnas (big blind) folded before Flop
Seat 5: x_ROSH125_x folded before Flop (didn't bet)
Seat 8: ludemix folded before Flop (didn't bet)
Seat 9: siskin vrach folded before Flop (didn't bet)



PokerStars Hand #228683224710:  Hold'em No Limit ($0.25/$0.50 USD) - 2021/07/30 13:06:37 ET
Table 'Aitne III' 9-max Seat #3 is the button
Seat 2: dstrola ($50 in chips) 
Seat 3: Lemmi846 ($67.77 in chips) 
Seat 4: juwnas ($97.71 in chips) 
Seat 8: ludemix ($94.79 in chips) 
Seat 9: siskin vrach ($102.44 in chips) 
juwnas: posts small blind $0.25
x_ROSH125_x: is sitting out 
ludemix: posts big blind $0.50
*** HOLE CARDS ***
siskin vrach: folds 
dstrola: raises $1 to $1.50
Lemmi846: calls $1.50
juwnas: folds 
ludemix: folds 
*** FLOP *** [Ts Qs Kc]
dstrola: bets $1.78
Lemmi846: folds 
Uncalled bet ($1.78) returned to dstrola
dstrola collected $3.56 from pot
x_ROSH125_x leaves the table
*** SUMMARY ***
Total pot $3.75 | Rake $0.19 
Board [Ts Qs Kc]
Seat 2: dstrola collected ($3.56)
Seat 3: Lemmi846 (button) folded on the Flop
Seat 4: juwnas (small blind) folded before Flop
Seat 8: ludemix (big blind) folded before Flop
Seat 9: siskin vrach folded before Flop (didn't bet)



PokerStars Hand #228683242034:  Hold'em No Limit ($0.25/$0.50 USD) - 2021/07/30 13:07:10 ET
Table 'Aitne III' 9-max Seat #4 is the button
Seat 2: dstrola ($52.06 in chips) 
Seat 3: Lemmi846 ($66.27 in chips) 
Seat 4: juwnas ($97.46 in chips) 
Seat 8: ludemix ($94.29 in chips) 
Seat 9: siskin vrach ($102.44 in chips) 
ludemix: posts small blind $0.25
siskin vrach: posts big blind $0.50
*** HOLE CARDS ***
dstrola: folds 
Lemmi846: raises $0.50 to $1
juwnas: folds 
ludemix: folds 
siskin vrach: folds 
Uncalled bet ($0.50) returned to Lemmi846
Lemmi846 collected $1.25 from pot
Lemmi846: doesn't show hand 
*** SUMMARY ***
Total pot $1.25 | Rake $0 
Seat 2: dstrola folded before Flop (didn't bet)
Seat 3: Lemmi846 collected ($1.25)
Seat 4: juwnas (button) folded before Flop (didn't bet)
Seat 8: ludemix (small blind) folded before Flop
Seat 9: siskin vrach (big blind) folded before Flop



PokerStars Hand #228683245013:  Hold'em No Limit ($0.25/$0.50 USD) - 2021/07/30 13:07:18 ET
Table 'Aitne III' 9-max Seat #8 is the button
Seat 2: dstrola ($52.06 in chips) 
Seat 3: Lemmi846 ($67.02 in chips) 
Seat 4: juwnas ($97.46 in chips) 
Seat 8: ludemix ($94.04 in chips) 
Seat 9: siskin vrach ($101.94 in chips) 
siskin vrach: posts small blind $0.25
dstrola: posts big blind $0.50
*** HOLE CARDS ***
stone1000 joins the table at seat #6 
Lemmi846: folds 
juwnas: folds 
ludemix: folds 
siskin vrach: folds 
Uncalled bet ($0.25) returned to dstrola
dstrola collected $0.50 from pot
SpeeLy joins the table at seat #1 
*** SUMMARY ***
Total pot $0.50 | Rake $0 
Seat 2: dstrola (big blind) collected ($0.50)
Seat 3: Lemmi846 folded before Flop (didn't bet)
Seat 4: juwnas folded before Flop (didn't bet)
Seat 8: ludemix (button) folded before Flop (didn't bet)
Seat 9: siskin vrach (small blind) folded before Flop



PokerStars Hand #228683249754:  Hold'em No Limit ($0.25/$0.50 USD) - 2021/07/30 13:07:29 ET
Table 'Aitne III' 9-max Seat #9 is the button
Seat 2: dstrola ($52.31 in chips) 
Seat 3: Lemmi846 ($67.02 in chips) 
Seat 4: juwnas ($97.46 in chips) 
Seat 8: ludemix ($94.04 in chips) 
Seat 9: siskin vrach ($101.69 in chips) 
dstrola: posts small blind $0.25
Lemmi846: posts big blind $0.50
stone1000: sits out 
*** HOLE CARDS ***
Mmago24 joins the table at seat #5 
juwnas has timed out
juwnas: folds 
ludemix: folds 
siskin vrach: raises $1 to $1.50
dstrola: raises $3.50 to $5
Lemmi846: folds 
siskin vrach: calls $3.50
*** FLOP *** [8d 3d 9h]
dstrola: bets $2.99
siskin vrach: calls $2.99
*** TURN *** [8d 3d 9h] [Qc]
dstrola: bets $11
siskin vrach: folds 
Uncalled bet ($11) returned to dstrola
dstrola collected $15.66 from pot
*** SUMMARY ***
Total pot $16.48 | Rake $0.82 
Board [8d 3d 9h Qc]
Seat 2: dstrola (small blind) collected ($15.66)
Seat 3: Lemmi846 (big blind) folded before Flop
Seat 4: juwnas folded before Flop (didn't bet)
Seat 8: ludemix folded before Flop (didn't bet)
Seat 9: siskin vrach (button) folded on the Turn



PokerStars Hand #228683273424:  Hold'em No Limit ($0.25/$0.50 USD) - 2021/07/30 13:08:28 ET
Table 'Aitne III' 9-max Seat #2 is the button
Seat 2: dstrola ($59.98 in chips) 
Seat 3: Lemmi846 ($66.52 in chips) 
Seat 4: juwnas ($97.46 in chips) 
Seat 8: ludemix ($94.04 in chips) 
Seat 9: siskin vrach ($93.70 in chips) 
Lemmi846: posts small blind $0.25
juwnas: posts big blind $0.50
Mmago24: sits out 
stone1000: sits out 
SpeeLy: sits out 
*** HOLE CARDS ***
ludemix: raises $0.75 to $1.25
siskin vrach: raises $3.15 to $4.40
dstrola: folds 
dstrola leaves the table
Lemmi846: folds 
juwnas: folds 
pokerbrat344 joins the table at seat #2 
ludemix: folds 
Uncalled bet ($3.15) returned to siskin vrach
siskin vrach collected $3.25 from pot
*** SUMMARY ***
Total pot $3.25 | Rake $0 
Seat 2: dstrola (button) folded before Flop (didn't bet)
Seat 3: Lemmi846 (small blind) folded before Flop
Seat 4: juwnas (big blind) folded before Flop
Seat 8: ludemix folded before Flop
Seat 9: siskin vrach collected ($3.25)



PokerStars Hand #228683303247:  Hold'em No Limit ($0.25/$0.50 USD) - 2021/07/30 13:09:31 ET
Table 'Aitne III' 9-max Seat #5 is the button
Seat 2: pokerbrat344 ($49.50 in chips) 
Seat 3: Lemmi846 ($66.27 in chips) 
Seat 4: juwnas ($96.71 in chips) 
Seat 5: Mmago24 ($50 in chips) 
Seat 6: stone1000 ($49 in chips) 
Seat 8: ludemix ($94.04 in chips) 
Seat 9: siskin vrach ($95.70 in chips) 
stone1000: posts small blind $0.25
ludemix: posts big blind $0.50
*** HOLE CARDS ***
siskin vrach: folds 
pokerbrat344: folds 
Nightwoof joins the table at seat #1 
Lemmi846: folds 
juwnas: raises $1 to $1.50
Mmago24: folds 
stone1000: folds 
ludemix: calls $1
*** FLOP *** [5h 2h Td]
ludemix: checks 
juwnas: bets $1.54
ludemix: calls $1.54
*** TURN *** [5h 2h Td] [Qd]
ludemix: checks 
juwnas: checks 
*** RIVER *** [5h 2h Td Qd] [Ah]
ludemix: checks 
juwnas: checks 
*** SHOW DOWN ***
ludemix: shows [6s 5s] (a pair of Fives)
juwnas: shows [8h 8c] (a pair of Eights)
juwnas collected $6.01 from pot
*** SUMMARY ***
Total pot $6.33 | Rake $0.32 
Board [5h 2h Td Qd Ah]
Seat 2: pokerbrat344 folded before Flop (didn't bet)
Seat 3: Lemmi846 folded before Flop (didn't bet)
Seat 4: juwnas showed [8h 8c] and won ($6.01) with a pair of Eights
Seat 5: Mmago24 (button) folded before Flop (didn't bet)
Seat 6: stone1000 (small blind) folded before Flop
Seat 8: ludemix (big blind) showed [6s 5s] and lost with a pair of Fives
Seat 9: siskin vrach folded before Flop (didn't bet)



PokerStars Hand #228683321432:  Hold'em No Limit ($0.25/$0.50 USD) - 2021/07/30 13:10:17 ET
Table 'Aitne III' 9-max Seat #6 is the button
Seat 2: pokerbrat344 ($49.50 in chips) 
Seat 3: Lemmi846 ($66.27 in chips) 
Seat 4: juwnas ($99.68 in chips) 
Seat 5: Mmago24 ($50 in chips) 
Seat 6: stone1000 ($48.75 in chips) 
Seat 8: ludemix ($91 in chips) 
Seat 9: siskin vrach ($95.70 in chips) 
ludemix: posts small blind $0.25
siskin vrach: posts big blind $0.50
Nightwoof: sits out 
*** HOLE CARDS ***
pokerbrat344: folds 
Lemmi846: folds 
juwnas: folds 
Mmago24: folds 
stone1000: folds 
ludemix: folds 
Uncalled bet ($0.25) returned to siskin vrach
siskin vrach collected $0.50 from pot
*** SUMMARY ***
Total pot $0.50 | Rake $0 
Seat 2: pokerbrat344 folded before Flop (didn't bet)
Seat 3: Lemmi846 folded before Flop (didn't bet)
Seat 4: juwnas folded before Flop (didn't bet)
Seat 5: Mmago24 folded before Flop (didn't bet)
Seat 6: stone1000 (button) folded before Flop (didn't bet)
Seat 8: ludemix (small blind) folded before Flop
Seat 9: siskin vrach (big blind) collected ($0.50)



PokerStars Hand #228683327232:  Hold'em No Limit ($0.25/$0.50 USD) - 2021/07/30 13:10:31 ET
Table 'Aitne III' 9-max Seat #8 is the button
Seat 1: Nightwoof ($50 in chips) 
Seat 2: pokerbrat344 ($49.50 in chips) 
Seat 3: Lemmi846 ($66.27 in chips) 
Seat 4: juwnas ($99.68 in chips) 
Seat 5: Mmago24 ($50 in chips) 
Seat 6: stone1000 ($48.75 in chips) 
Seat 8: ludemix ($90.75 in chips) 
Seat 9: siskin vrach ($95.95 in chips) 
siskin vrach: posts small blind $0.25
Nightwoof: posts big blind $0.50
*** HOLE CARDS ***
pokerbrat344: folds 
Lemmi846: folds 
juwnas: raises $1 to $1.50
Mmago24: folds 
stone1000: folds 
ludemix: folds 
siskin vrach: folds 
Nightwoof: folds 
Uncalled bet ($1) returned to juwnas
juwnas collected $1.25 from pot
juwnas: doesn't show hand 
*** SUMMARY ***
Total pot $1.25 | Rake $0 
Seat 1: Nightwoof (big blind) folded before Flop
Seat 2: pokerbrat344 folded before Flop (didn't bet)
Seat 3: Lemmi846 folded before Flop (didn't bet)
Seat 4: juwnas collected ($1.25)
Seat 5: Mmago24 folded before Flop (didn't bet)
Seat 6: stone1000 folded before Flop (didn't bet)
Seat 8: ludemix (button) folded before Flop (didn't bet)
Seat 9: siskin vrach (small blind) folded before Flop



PokerStars Hand #228683334502:  Hold'em No Limit ($0.25/$0.50 USD) - 2021/07/30 13:10:50 ET
Table 'Aitne III' 9-max Seat #9 is the button
Seat 1: Nightwoof ($50 in chips) 
Seat 2: pokerbrat344 ($49.50 in chips) 
Seat 3: Lemmi846 ($66.27 in chips) 
Seat 4: juwnas ($100.43 in chips) 
Seat 5: Mmago24 ($50 in chips) 
Seat 6: stone1000 ($48.75 in chips) 
Seat 8: ludemix ($90.75 in chips) 
Seat 9: siskin vrach ($95.70 in chips) 
Nightwoof: posts small blind $0.25
pokerbrat344: posts big blind $0.50
*** HOLE CARDS ***
Lemmi846: folds 
juwnas: folds 
Mmago24: folds 
stone1000: folds 
ludemix: folds 
siskin vrach: folds 
Nightwoof: raises $1 to $1.50
pokerbrat344: calls $1
*** FLOP *** [Tc 5d Ks]
Nightwoof: bets $2.14
pokerbrat344: calls $2.14
*** TURN *** [Tc 5d Ks] [Jh]
Nightwoof: checks 
pokerbrat344: checks 
*** RIVER *** [Tc 5d Ks Jh] [8d]
Nightwoof: checks 
pokerbrat344: checks 
*** SHOW DOWN ***
Nightwoof: shows [Ts 9s] (a pair of Tens)
pokerbrat344: shows [9d Th] (a pair of Tens)
Nightwoof collected $3.46 from pot
pokerbrat344 collected $3.46 from pot
*** SUMMARY ***
Total pot $7.28 | Rake $0.36 
Board [Tc 5d Ks Jh 8d]
Seat 1: Nightwoof (small blind) showed [Ts 9s] and won ($3.46) with a pair of Tens
Seat 2: pokerbrat344 (big blind) showed [9d Th] and won ($3.46) with a pair of Tens
Seat 3: Lemmi846 folded before Flop (didn't bet)
Seat 4: juwnas folded before Flop (didn't bet)
Seat 5: Mmago24 folded before Flop (didn't bet)
Seat 6: stone1000 folded before Flop (didn't bet)
Seat 8: ludemix folded before Flop (didn't bet)
Seat 9: siskin vrach (button) folded before Flop (didn't bet)



PokerStars Hand #228683349867:  Hold'em No Limit ($0.25/$0.50 USD) - 2021/07/30 13:11:28 ET
Table 'Aitne III' 9-max Seat #1 is the button
Seat 1: Nightwoof ($50 in chips) 
Seat 2: pokerbrat344 ($49.32 in chips) 
Seat 3: Lemmi846 ($66.27 in chips) 
Seat 4: juwnas ($100.43 in chips) 
Seat 5: Mmago24 ($50 in chips) 
Seat 6: stone1000 ($48.75 in chips) 
Seat 8: ludemix ($90.75 in chips) 
Seat 9: siskin vrach ($95.70 in chips) 
pokerbrat344: posts small blind $0.25
Lemmi846: posts big blind $0.50
*** HOLE CARDS ***
juwnas: folds 
Mmago24: folds 
stone1000: folds 
ludemix: folds 
siskin vrach: folds 
Nightwoof: folds 
pokerbrat344: calls $0.25
Lemmi846: checks 
*** FLOP *** [Td Ac 9s]
pokerbrat344: bets $0.95
Lemmi846: folds 
Uncalled bet ($0.95) returned to pokerbrat344
pokerbrat344 collected $0.95 from pot
*** SUMMARY ***
Total pot $1 | Rake $0.05 
Board [Td Ac 9s]
Seat 1: Nightwoof (button) folded before Flop (didn't bet)
Seat 2: pokerbrat344 (small blind) collected ($0.95)
Seat 3: Lemmi846 (big blind) folded on the Flop
Seat 4: juwnas folded before Flop (didn't bet)
Seat 5: Mmago24 folded before Flop (didn't bet)
Seat 6: stone1000 folded before Flop (didn't bet)
Seat 8: ludemix folded before Flop (didn't bet)
Seat 9: siskin vrach folded before Flop (didn't bet)



PokerStars Hand #228683362727:  Hold'em No Limit ($0.25/$0.50 USD) - 2021/07/30 13:12:00 ET
Table 'Aitne III' 9-max Seat #2 is the button
Seat 1: Nightwoof ($50 in chips) 
Seat 2: pokerbrat344 ($49.77 in chips) 
Seat 3: Lemmi846 ($65.77 in chips) 
Seat 4: juwnas ($100.43 in chips) 
Seat 5: Mmago24 ($50 in chips) 
Seat 6: stone1000 ($48.75 in chips) 
Seat 8: ludemix ($90.75 in chips) 
Seat 9: siskin vrach ($95.70 in chips) 
Lemmi846: posts small blind $0.25
juwnas: posts big blind $0.50
*** HOLE CARDS ***
Mmago24: folds 
stone1000: folds 
ludemix: folds 
siskin vrach: folds 
Nightwoof: folds 
pokerbrat344: folds 
Lemmi846: folds 
Uncalled bet ($0.25) returned to juwnas
juwnas collected $0.50 from pot
juwnas: doesn't show hand 
*** SUMMARY ***
Total pot $0.50 | Rake $0 
Seat 1: Nightwoof folded before Flop (didn't bet)
Seat 2: pokerbrat344 (button) folded before Flop (didn't bet)
Seat 3: Lemmi846 (small blind) folded before Flop
Seat 4: juwnas (big blind) collected ($0.50)
Seat 5: Mmago24 folded before Flop (didn't bet)
Seat 6: stone1000 folded before Flop (didn't bet)
Seat 8: ludemix folded before Flop (didn't bet)
Seat 9: siskin vrach folded before Flop (didn't bet)



PokerStars Hand #228683367202:  Hold'em No Limit ($0.25/$0.50 USD) - 2021/07/30 13:12:11 ET
Table 'Aitne III' 9-max Seat #3 is the button
Seat 1: Nightwoof ($50 in chips) 
Seat 2: pokerbrat344 ($49.77 in chips) 
Seat 3: Lemmi846 ($65.52 in chips) 
Seat 4: juwnas ($100.68 in chips) 
Seat 5: Mmago24 ($50 in chips) 
Seat 6: stone1000 ($48.75 in chips) 
Seat 8: ludemix ($90.75 in chips) 
Seat 9: siskin vrach ($95.70 in chips) 
juwnas: posts small blind $0.25
Mmago24: posts big blind $0.50
*** HOLE CARDS ***
stone1000: folds 
ludemix: folds 
siskin vrach: folds 
Nightwoof: folds 
pokerbrat344: folds 
Lemmi846: folds 
juwnas: folds 
Uncalled bet ($0.25) returned to Mmago24
Mmago24 collected $0.50 from pot
Mmago24: doesn't show hand 
*** SUMMARY ***
Total pot $0.50 | Rake $0 
Seat 1: Nightwoof folded before Flop (didn't bet)
Seat 2: pokerbrat344 folded before Flop (didn't bet)
Seat 3: Lemmi846 (button) folded before Flop (didn't bet)
Seat 4: juwnas (small blind) folded before Flop
Seat 5: Mmago24 (big blind) collected ($0.50)
Seat 6: stone1000 folded before Flop (didn't bet)
Seat 8: ludemix folded before Flop (didn't bet)
Seat 9: siskin vrach folded before Flop (didn't bet)



PokerStars Hand #228683739273:  Hold'em No Limit ($0.25/$0.50 USD) - 2021/07/30 13:27:08 ET
Table 'Aitne III' 9-max Seat #8 is the button
Seat 1: Nightwoof ($51.53 in chips) 
Seat 2: YamaRyu9097 ($50 in chips) 
Seat 4: megaman1966 ($20.60 in chips) 
Seat 5: Mmago24 ($74.24 in chips) 
Seat 8: La Ghir ($50 in chips) 
Seat 9: siskin vrach ($87.29 in chips) 
siskin vrach: posts small blind $0.25
Nightwoof: posts big blind $0.50
megaman1966: posts big blind $0.50
dikanmax: sits out 
*** HOLE CARDS ***
YamaRyu9097: folds 
megaman1966: checks 
Mmago24: raises $1.50 to $2
La Ghir: folds 
siskin vrach: folds 
Nightwoof: calls $1.50
megaman1966: folds 
*** FLOP *** [9c 3d Kd]
Nightwoof: checks 
Mmago24: bets $2
Nightwoof: folds 
Uncalled bet ($2) returned to Mmago24
Mmago24 collected $4.51 from pot
Mmago24: doesn't show hand 
*** SUMMARY ***
Total pot $4.75 | Rake $0.24 
Board [9c 3d Kd]
Seat 1: Nightwoof (big blind) folded on the Flop
Seat 2: YamaRyu9097 folded before Flop (didn't bet)
Seat 4: megaman1966 folded before Flop (didn't bet)
Seat 5: Mmago24 collected ($4.51)
Seat 8: La Ghir (button) folded before Flop (didn't bet)
Seat 9: siskin vrach (small blind) folded before Flop



PokerStars Hand #228683749715:  Hold'em No Limit ($0.25/$0.50 USD) - 2021/07/30 13:27:33 ET
Table 'Aitne III' 9-max Seat #9 is the button
Seat 1: Nightwoof ($50 in chips) 
Seat 4: megaman1966 ($20.10 in chips) 
Seat 5: Mmago24 ($76.75 in chips) 
Seat 8: La Ghir ($50 in chips) 
Seat 9: siskin vrach ($87.04 in chips) 
Nightwoof: posts small blind $0.25
YamaRyu9097: is sitting out 
megaman1966: posts big blind $0.50
dikanmax: sits out 
*** HOLE CARDS ***
Mmago24: folds 
La Ghir: folds 
siskin vrach: folds 
Nightwoof: raises $1 to $1.50
megaman1966: folds 
Uncalled bet ($1) returned to Nightwoof
Nightwoof collected $1 from pot
Nightwoof: doesn't show hand 
*** SUMMARY ***
Total pot $1 | Rake $0 
Seat 1: Nightwoof (small blind) collected ($1)
Seat 4: megaman1966 (big blind) folded before Flop
Seat 5: Mmago24 folded before Flop (didn't bet)
Seat 8: La Ghir folded before Flop (didn't bet)
Seat 9: siskin vrach (button) folded before Flop (didn't bet)



PokerStars Hand #228683755883:  Hold'em No Limit ($0.25/$0.50 USD) - 2021/07/30 13:27:49 ET
Table 'Aitne III' 9-max Seat #1 is the button
Seat 1: Nightwoof ($50.50 in chips) 
Seat 4: megaman1966 ($19.60 in chips) 
Seat 5: Mmago24 ($76.75 in chips) 
Seat 8: La Ghir ($50 in chips) 
Seat 9: siskin vrach ($87.04 in chips) 
megaman1966: posts small blind $0.25
Mmago24: posts big blind $0.50
dikanmax: sits out 
*** HOLE CARDS ***
La Ghir: raises $1 to $1.50
YamaRyu9097 leaves the table
siskin vrach: folds 
Nightwoof: folds 
megaman1966: folds 
Mmago24: folds 
Uncalled bet ($1) returned to La Ghir
La Ghir collected $1.25 from pot
La Ghir: doesn't show hand 
*** SUMMARY ***
Total pot $1.25 | Rake $0 
Seat 1: Nightwoof (button) folded before Flop (didn't bet)
Seat 4: megaman1966 (small blind) folded before Flop
Seat 5: Mmago24 (big blind) folded before Flop
Seat 8: La Ghir collected ($1.25)
Seat 9: siskin vrach folded before Flop (didn't bet)



PokerStars Hand #228683925837:  Hold'em No Limit ($0.25/$0.50 USD) - 2021/07/30 13:34:37 ET
Table 'Aitne III' 9-max Seat #8 is the button
Seat 1: Nightwoof ($63.31 in chips) 
Seat 4: megaman1966 ($8.62 in chips) 
Seat 5: Mmago24 ($76.75 in chips) 
Seat 6: Kahmi3105 ($43.24 in chips) 
Seat 8: La Ghir ($58.98 in chips) 
Seat 9: siskin vrach ($89.30 in chips) 
siskin vrach: posts small blind $0.25
Nightwoof: posts big blind $0.50
Popokluev: sits out 
Dragonclawss: sits out 
*** HOLE CARDS ***
megaman1966: folds 
Mmago24: folds 
Kahmi3105: folds 
La Ghir: folds 
siskin vrach: raises $1.26 to $1.76
Nightwoof: folds 
Uncalled bet ($1.26) returned to siskin vrach
siskin vrach collected $1 from pot
*** SUMMARY ***
Total pot $1 | Rake $0 
Seat 1: Nightwoof (big blind) folded before Flop
Seat 4: megaman1966 folded before Flop (didn't bet)
Seat 5: Mmago24 folded before Flop (didn't bet)
Seat 6: Kahmi3105 folded before Flop (didn't bet)
Seat 8: La Ghir (button) folded before Flop (didn't bet)
Seat 9: siskin vrach (small blind) collected ($1)



PokerStars Hand #228683933216:  Hold'em No Limit ($0.25/$0.50 USD) - 2021/07/30 13:34:55 ET
Table 'Aitne III' 9-max Seat #9 is the button
Seat 1: Nightwoof ($62.81 in chips) 
Seat 3: Popokluev ($50 in chips) 
Seat 4: megaman1966 ($8.62 in chips) 
Seat 5: Mmago24 ($76.75 in chips) 
Seat 6: Kahmi3105 ($43.24 in chips) 
Seat 8: La Ghir ($58.98 in chips) 
Seat 9: siskin vrach ($89.80 in chips) 
Nightwoof: posts small blind $0.25
Popokluev: posts big blind $0.50
Dragonclawss: sits out 
*** HOLE CARDS ***
megaman1966 has timed out
megaman1966: folds 
Mmago24: folds 
Kahmi3105: folds 
La Ghir: raises $1 to $1.50
siskin vrach: raises $3 to $4.50
Nightwoof: folds 
Popokluev: folds 
La Ghir: folds 
Uncalled bet ($3) returned to siskin vrach
siskin vrach collected $3.75 from pot
*** SUMMARY ***
Total pot $3.75 | Rake $0 
Seat 1: Nightwoof (small blind) folded before Flop
Seat 3: Popokluev (big blind) folded before Flop
Seat 4: megaman1966 folded before Flop (didn't bet)
Seat 5: Mmago24 folded before Flop (didn't bet)
Seat 6: Kahmi3105 folded before Flop (didn't bet)
Seat 8: La Ghir folded before Flop
Seat 9: siskin vrach (button) collected ($3.75)



PokerStars Hand #228683957134:  Hold'em No Limit ($0.25/$0.50 USD) - 2021/07/30 13:35:37 ET
Table 'Aitne III' 9-max Seat #1 is the button
Seat 1: Nightwoof ($62.56 in chips) 
Seat 3: Popokluev ($50 in chips) 
Seat 4: megaman1966 ($8.62 in chips) 
Seat 5: Mmago24 ($76.75 in chips) 
Seat 6: Kahmi3105 ($43.24 in chips) 
Seat 8: La Ghir ($57.48 in chips) 
Seat 9: siskin vrach ($92.05 in chips) 
Popokluev: posts small blind $0.25
megaman1966: posts big blind $0.50
Dragonclawss: sits out 
*** HOLE CARDS ***
Mmago24: raises $0.72 to $1.22
Kahmi3105: calls $1.22
La Ghir: folds 
siskin vrach: calls $1.22
Nightwoof: folds 
Popokluev: folds 
megaman1966: folds 
*** FLOP *** [3d Jd 9h]
Mmago24: checks 
Kahmi3105: checks 
siskin vrach: bets $2.50
Mmago24: calls $2.50
Kahmi3105: folds 
*** TURN *** [3d Jd 9h] [3s]
Mmago24: checks 
siskin vrach: bets $3
Mmago24: calls $3
*** RIVER *** [3d Jd 9h 3s] [Qs]
Mmago24: checks 
siskin vrach: checks 
*** SHOW DOWN ***
Mmago24: shows [Qh Ac] (two pair, Queens and Threes)
siskin vrach: mucks hand 
Mmago24 collected $14.64 from pot
*** SUMMARY ***
Total pot $15.41 | Rake $0.77 
Board [3d Jd 9h 3s Qs]
Seat 1: Nightwoof (button) folded before Flop (didn't bet)
Seat 3: Popokluev (small blind) folded before Flop
Seat 4: megaman1966 (big blind) folded before Flop
Seat 5: Mmago24 showed [Qh Ac] and won ($14.64) with two pair, Queens and Threes
Seat 6: Kahmi3105 folded on the Flop
Seat 8: La Ghir folded before Flop (didn't bet)
Seat 9: siskin vrach mucked



PokerStars Hand #228683979703:  Hold'em No Limit ($0.25/$0.50 USD) - 2021/07/30 13:36:31 ET
Table 'Aitne III' 9-max Seat #3 is the button
Seat 1: Nightwoof ($62.56 in chips) 
Seat 3: Popokluev ($50 in chips) 
Seat 4: megaman1966 ($8.12 in chips) 
Seat 5: Mmago24 ($84.67 in chips) 
Seat 6: Kahmi3105 ($42.02 in chips) 
Seat 8: La Ghir ($57.48 in chips) 
Seat 9: siskin vrach ($85.33 in chips) 
megaman1966: posts small blind $0.25
Mmago24: posts big blind $0.50
Dragonclawss: sits out 
*** HOLE CARDS ***
Kahmi3105: folds 
La Ghir: folds 
siskin vrach: folds 
Nightwoof: folds 
Popokluev: raises $0.75 to $1.25
megaman1966: folds 
Mmago24: folds 
Uncalled bet ($0.75) returned to Popokluev
Popokluev collected $1.25 from pot
Popokluev: doesn't show hand 
*** SUMMARY ***
Total pot $1.25 | Rake $0 
Seat 1: Nightwoof folded before Flop (didn't bet)
Seat 3: Popokluev (button) collected ($1.25)
Seat 4: megaman1966 (small blind) folded before Flop
Seat 5: Mmago24 (big blind) folded before Flop
Seat 6: Kahmi3105 folded before Flop (didn't bet)
Seat 8: La Ghir folded before Flop (didn't bet)
Seat 9: siskin vrach folded before Flop (didn't bet)



PokerStars Hand #228683988526:  Hold'em No Limit ($0.25/$0.50 USD) - 2021/07/30 13:36:52 ET
Table 'Aitne III' 9-max Seat #4 is the button
Seat 1: Nightwoof ($62.56 in chips) 
Seat 3: Popokluev ($50.75 in chips) 
Seat 4: megaman1966 ($7.87 in chips) 
Seat 5: Mmago24 ($84.17 in chips) 
Seat 6: Kahmi3105 ($42.02 in chips) 
Seat 8: La Ghir ($57.48 in chips) 
Seat 9: siskin vrach ($85.33 in chips) 
Mmago24: posts small blind $0.25
Kahmi3105: posts big blind $0.50
Dragonclawss: sits out 
*** HOLE CARDS ***
La Ghir: raises $1 to $1.50
siskin vrach: folds 
Nightwoof: folds 
Popokluev: folds 
megaman1966: calls $1.50
Mmago24: folds 
VicinGER1 leaves the table
Kahmi3105: folds 
*** FLOP *** [2c 5c Js]
La Ghir: bets $8
megaman1966: calls $6.37 and is all-in
Uncalled bet ($1.63) returned to La Ghir
*** TURN *** [2c 5c Js] [Qc]
*** RIVER *** [2c 5c Js Qc] [2s]
*** SHOW DOWN ***
La Ghir: shows [6s 6h] (two pair, Sixes and Deuces)
megaman1966: shows [Qs Jc] (two pair, Queens and Jacks)
megaman1966 collected $15.47 from pot
*** SUMMARY ***
Total pot $16.49 | Rake $1.02 
Board [2c 5c Js Qc 2s]
Seat 1: Nightwoof folded before Flop (didn't bet)
Seat 3: Popokluev folded before Flop (didn't bet)
Seat 4: megaman1966 (button) showed [Qs Jc] and won ($15.47) with two pair, Queens and Jacks
Seat 5: Mmago24 (small blind) folded before Flop
Seat 6: Kahmi3105 (big blind) folded before Flop
Seat 8: La Ghir showed [6s 6h] and lost with two pair, Sixes and Deuces
Seat 9: siskin vrach folded before Flop (didn't bet)



PokerStars Hand #228684003077:  Hold'em No Limit ($0.25/$0.50 USD) - 2021/07/30 13:37:26 ET
Table 'Aitne III' 9-max Seat #5 is the button
Seat 1: Nightwoof ($62.56 in chips) 
Seat 3: Popokluev ($50.75 in chips) 
Seat 4: megaman1966 ($15.47 in chips) 
Seat 5: Mmago24 ($83.92 in chips) 
Seat 6: Kahmi3105 ($41.52 in chips) 
Seat 7: Dragonclawss ($51.36 in chips) 
Seat 8: La Ghir ($50 in chips) 
Seat 9: siskin vrach ($85.33 in chips) 
Kahmi3105: posts small blind $0.25
Dragonclawss: posts big blind $0.50
*** HOLE CARDS ***
La Ghir: folds 
siskin vrach: folds 
Nightwoof: folds 
AlexEliseev7 joins the table at seat #2 
Popokluev: folds 
megaman1966: folds 
Mmago24: raises $0.72 to $1.22
Kahmi3105: folds 
Dragonclawss: folds 
Uncalled bet ($0.72) returned to Mmago24
Mmago24 collected $1.25 from pot
Mmago24: doesn't show hand 
*** SUMMARY ***
Total pot $1.25 | Rake $0 
Seat 1: Nightwoof folded before Flop (didn't bet)
Seat 3: Popokluev folded before Flop (didn't bet)
Seat 4: megaman1966 folded before Flop (didn't bet)
Seat 5: Mmago24 (button) collected ($1.25)
Seat 6: Kahmi3105 (small blind) folded before Flop
Seat 7: Dragonclawss (big blind) folded before Flop
Seat 8: La Ghir folded before Flop (didn't bet)
Seat 9: siskin vrach folded before Flop (didn't bet)



PokerStars Hand #228684016446:  Hold'em No Limit ($0.25/$0.50 USD) - 2021/07/30 13:37:58 ET
Table 'Aitne III' 9-max Seat #6 is the button
Seat 1: Nightwoof ($62.56 in chips) 
Seat 3: Popokluev ($50.75 in chips) 
Seat 4: megaman1966 ($15.47 in chips) 
Seat 5: Mmago24 ($84.67 in chips) 
Seat 6: Kahmi3105 ($41.27 in chips) 
Seat 7: Dragonclawss ($50.86 in chips) 
Seat 8: La Ghir ($50 in chips) 
Seat 9: siskin vrach ($85.33 in chips) 
Dragonclawss: posts small blind $0.25
La Ghir: posts big blind $0.50
AlexEliseev7: sits out 
*** HOLE CARDS ***
siskin vrach: folds 
Nightwoof: folds 
Popokluev: raises $1 to $1.50
megaman1966: calls $1.50
Mmago24: raises $4 to $5.50
Kahmi3105: folds 
Dragonclawss: folds 
La Ghir: folds 
Popokluev: calls $4
megaman1966: folds 
*** FLOP *** [Kc As Ks]
Popokluev: checks 
Mmago24: checks 
*** TURN *** [Kc As Ks] [Tc]
Popokluev: bets $6.92
Mmago24: calls $6.92
*** RIVER *** [Kc As Ks Tc] [Ad]
Popokluev: checks 
Mmago24: bets $17.16
Popokluev: folds 
Uncalled bet ($17.16) returned to Mmago24
Mmago24 collected $25.74 from pot
Mmago24: doesn't show hand 
*** SUMMARY ***
Total pot $27.09 | Rake $1.35 
Board [Kc As Ks Tc Ad]
Seat 1: Nightwoof folded before Flop (didn't bet)
Seat 3: Popokluev folded on the River
Seat 4: megaman1966 folded before Flop
Seat 5: Mmago24 collected ($25.74)
Seat 6: Kahmi3105 (button) folded before Flop (didn't bet)
Seat 7: Dragonclawss (small blind) folded before Flop
Seat 8: La Ghir (big blind) folded before Flop
Seat 9: siskin vrach folded before Flop (didn't bet)



PokerStars Hand #228684043214:  Hold'em No Limit ($0.25/$0.50 USD) - 2021/07/30 13:39:01 ET
Table 'Aitne III' 9-max Seat #7 is the button
Seat 1: Nightwoof ($62.56 in chips) 
Seat 3: Popokluev ($50 in chips) 
Seat 4: megaman1966 ($13.97 in chips) 
Seat 5: Mmago24 ($97.99 in chips) 
Seat 6: Kahmi3105 ($41.27 in chips) 
Seat 7: Dragonclawss ($50.61 in chips) 
Seat 8: La Ghir ($50 in chips) 
Seat 9: siskin vrach ($85.33 in chips) 
La Ghir: posts small blind $0.25
siskin vrach: posts big blind $0.50
AlexEliseev7: sits out 
*** HOLE CARDS ***
Nightwoof: folds 
Popokluev: folds 
megaman1966: folds 
Mmago24: folds 
Kahmi3105: raises $1.25 to $1.75
Dragonclawss: folds 
La Ghir: folds 
siskin vrach: folds 
Uncalled bet ($1.25) returned to Kahmi3105
Kahmi3105 collected $1.25 from pot
Kahmi3105: doesn't show hand 
*** SUMMARY ***
Total pot $1.25 | Rake $0 
Seat 1: Nightwoof folded before Flop (didn't bet)
Seat 3: Popokluev folded before Flop (didn't bet)
Seat 4: megaman1966 folded before Flop (didn't bet)
Seat 5: Mmago24 folded before Flop (didn't bet)
Seat 6: Kahmi3105 collected ($1.25)
Seat 7: Dragonclawss (button) folded before Flop (didn't bet)
Seat 8: La Ghir (small blind) folded before Flop
Seat 9: siskin vrach (big blind) folded before Flop



PokerStars Hand #228684055441:  Hold'em No Limit ($0.25/$0.50 USD) - 2021/07/30 13:39:30 ET
Table 'Aitne III' 9-max Seat #8 is the button
Seat 1: Nightwoof ($62.56 in chips) 
Seat 3: Popokluev ($50 in chips) 
Seat 4: megaman1966 ($13.97 in chips) 
Seat 5: Mmago24 ($97.99 in chips) 
Seat 6: Kahmi3105 ($42.02 in chips) 
Seat 7: Dragonclawss ($50.61 in chips) 
Seat 8: La Ghir ($50 in chips) 
Seat 9: siskin vrach ($84.83 in chips) 
siskin vrach: posts small blind $0.25
Nightwoof: posts big blind $0.50
AlexEliseev7: sits out 
*** HOLE CARDS ***
Popokluev: folds 
megaman1966: calls $0.50
Mmago24: folds 
Kahmi3105: calls $0.50
Dragonclawss: calls $0.50
La Ghir: folds 
siskin vrach: calls $0.25
Nightwoof: checks 
*** FLOP *** [9d 6s 6h]
siskin vrach: bets $0.69
Nightwoof: folds 
megaman1966: calls $0.69
Kahmi3105: folds 
Dragonclawss: folds 
*** TURN *** [9d 6s 6h] [4d]
siskin vrach: bets $2
megaman1966: folds 
Uncalled bet ($2) returned to siskin vrach
siskin vrach collected $3.69 from pot
*** SUMMARY ***
Total pot $3.88 | Rake $0.19 
Board [9d 6s 6h 4d]
Seat 1: Nightwoof (big blind) folded on the Flop
Seat 3: Popokluev folded before Flop (didn't bet)
Seat 4: megaman1966 folded on the Turn
Seat 5: Mmago24 folded before Flop (didn't bet)
Seat 6: Kahmi3105 folded on the Flop
Seat 7: Dragonclawss folded on the Flop
Seat 8: La Ghir (button) folded before Flop (didn't bet)
Seat 9: siskin vrach (small blind) collected ($3.69)



PokerStars Hand #228684075078:  Hold'em No Limit ($0.25/$0.50 USD) - 2021/07/30 13:40:17 ET
Table 'Aitne III' 9-max Seat #9 is the button
Seat 1: Nightwoof ($62.06 in chips) 
Seat 2: AlexEliseev7 ($50 in chips) 
Seat 3: Popokluev ($50 in chips) 
Seat 4: megaman1966 ($12.78 in chips) 
Seat 5: Mmago24 ($97.99 in chips) 
Seat 6: Kahmi3105 ($41.52 in chips) 
Seat 7: Dragonclawss ($50.11 in chips) 
Seat 8: La Ghir ($50 in chips) 
Seat 9: siskin vrach ($87.33 in chips) 
Nightwoof: posts small blind $0.25
AlexEliseev7: posts big blind $0.50
*** HOLE CARDS ***
Popokluev: folds 
megaman1966: folds 
Popokluev leaves the table
Mmago24: folds 
Kahmi3105: folds 
Dragonclawss: folds 
La Ghir: folds 
siskin vrach: raises $1 to $1.50
Nightwoof: folds 
AlexEliseev7: folds 
Uncalled bet ($1) returned to siskin vrach
siskin vrach collected $1.25 from pot
*** SUMMARY ***
Total pot $1.25 | Rake $0 
Seat 1: Nightwoof (small blind) folded before Flop
Seat 2: AlexEliseev7 (big blind) folded before Flop
Seat 3: Popokluev folded before Flop (didn't bet)
Seat 4: megaman1966 folded before Flop (didn't bet)
Seat 5: Mmago24 folded before Flop (didn't bet)
Seat 6: Kahmi3105 folded before Flop (didn't bet)
Seat 7: Dragonclawss folded before Flop (didn't bet)
Seat 8: La Ghir folded before Flop (didn't bet)
Seat 9: siskin vrach (button) collected ($1.25)



PokerStars Hand #228684082955:  Hold'em No Limit ($0.25/$0.50 USD) - 2021/07/30 13:40:36 ET
Table 'Aitne III' 9-max Seat #1 is the button
Seat 1: Nightwoof ($61.81 in chips) 
Seat 2: AlexEliseev7 ($50 in chips) 
Seat 4: megaman1966 ($12.78 in chips) 
Seat 5: Mmago24 ($97.99 in chips) 
Seat 6: Kahmi3105 ($41.52 in chips) 
Seat 7: Dragonclawss ($50.11 in chips) 
Seat 8: La Ghir ($50 in chips) 
Seat 9: siskin vrach ($88.08 in chips) 
AlexEliseev7: posts small blind $0.25
megaman1966: posts big blind $0.50
*** HOLE CARDS ***
Mmago24: folds 
Kahmi3105: calls $0.50
Lemmi846 joins the table at seat #3 
Dragonclawss: folds 
La Ghir: folds 
siskin vrach: raises $1.50 to $2
Nightwoof: folds 
AlexEliseev7: folds 
megaman1966: calls $1.50
Kahmi3105: raises $6.25 to $8.25
siskin vrach: raises $79.83 to $88.08 and is all-in
megaman1966: folds 
Kahmi3105: calls $33.27 and is all-in
Uncalled bet ($46.56) returned to siskin vrach
*** FLOP *** [9d 2s 7h]
*** TURN *** [9d 2s 7h] [5s]
*** RIVER *** [9d 2s 7h 5s] [2h]
*** SHOW DOWN ***
Kahmi3105: shows [Kd Kh] (two pair, Kings and Deuces)
siskin vrach: shows [Qd As] (a pair of Deuces)
Kahmi3105 collected $82.79 from pot
*** SUMMARY ***
Total pot $85.29 | Rake $2.50 
Board [9d 2s 7h 5s 2h]
Seat 1: Nightwoof (button) folded before Flop (didn't bet)
Seat 2: AlexEliseev7 (small blind) folded before Flop
Seat 4: megaman1966 (big blind) folded before Flop
Seat 5: Mmago24 folded before Flop (didn't bet)
Seat 6: Kahmi3105 showed [Kd Kh] and won ($82.79) with two pair, Kings and Deuces
Seat 7: Dragonclawss folded before Flop (didn't bet)
Seat 8: La Ghir folded before Flop (didn't bet)
Seat 9: siskin vrach showed [Qd As] and lost with a pair of Deuces



PokerStars Hand #228684101863:  Hold'em No Limit ($0.25/$0.50 USD) - 2021/07/30 13:41:21 ET
Table 'Aitne III' 9-max Seat #2 is the button
Seat 1: Nightwoof ($61.81 in chips) 
Seat 2: AlexEliseev7 ($50 in chips) 
Seat 4: megaman1966 ($10.78 in chips) 
Seat 5: Mmago24 ($97.99 in chips) 
Seat 6: Kahmi3105 ($82.79 in chips) 
Seat 7: Dragonclawss ($50.11 in chips) 
Seat 8: La Ghir ($50 in chips) 
Seat 9: siskin vrach ($50 in chips) 
megaman1966: posts small blind $0.25
Mmago24: posts big blind $0.50
*** HOLE CARDS ***
Kahmi3105: calls $0.50
Dragonclawss: folds 
La Ghir: folds 
siskin vrach: raises $1 to $1.50
Nightwoof: calls $1.50
AlexEliseev7: raises $5 to $6.50
megaman1966: folds 
Mmago24: folds 
Kahmi3105: folds 
siskin vrach: calls $5
Nightwoof: calls $5
*** FLOP *** [6h 3c Td]
siskin vrach: checks 
Nightwoof: checks 
AlexEliseev7: bets $6.50
siskin vrach: calls $6.50
Nightwoof: folds 
*** TURN *** [6h 3c Td] [Th]
siskin vrach: checks 
AlexEliseev7: checks 
*** RIVER *** [6h 3c Td Th] [4c]
siskin vrach: checks 
AlexEliseev7: checks 
*** SHOW DOWN ***
siskin vrach: shows [3d Ad] (two pair, Tens and Threes)
AlexEliseev7: mucks hand 
siskin vrach collected $32.06 from pot
*** SUMMARY ***
Total pot $33.75 | Rake $1.69 
Board [6h 3c Td Th 4c]
Seat 1: Nightwoof folded on the Flop
Seat 2: AlexEliseev7 (button) mucked
Seat 4: megaman1966 (small blind) folded before Flop
Seat 5: Mmago24 (big blind) folded before Flop
Seat 6: Kahmi3105 folded before Flop
Seat 7: Dragonclawss folded before Flop (didn't bet)
Seat 8: La Ghir folded before Flop (didn't bet)
Seat 9: siskin vrach showed [3d Ad] and won ($32.06) with two pair, Tens and Threes



PokerStars Hand #228684141822:  Hold'em No Limit ($0.25/$0.50 USD) - 2021/07/30 13:42:55 ET
Table 'Aitne III' 9-max Seat #4 is the button
Seat 1: Nightwoof ($55.31 in chips) 
Seat 2: AlexEliseev7 ($50 in chips) 
Seat 4: megaman1966 ($10.53 in chips) 
Seat 5: Mmago24 ($97.49 in chips) 
Seat 6: Kahmi3105 ($82.29 in chips) 
Seat 7: Dragonclawss ($50.11 in chips) 
Seat 8: La Ghir ($50 in chips) 
Seat 9: siskin vrach ($69.06 in chips) 
Mmago24: posts small blind $0.25
Kahmi3105: posts big blind $0.50
Lemmi846: sits out 
*** HOLE CARDS ***
Dragonclawss: folds 
La Ghir: raises $1 to $1.50
siskin vrach: folds 
Nightwoof: folds 
AlexEliseev7: folds 
megaman1966: folds 
Mmago24: folds 
Kahmi3105: folds 
Uncalled bet ($1) returned to La Ghir
La Ghir collected $1.25 from pot
La Ghir: doesn't show hand 
*** SUMMARY ***
Total pot $1.25 | Rake $0 
Seat 1: Nightwoof folded before Flop (didn't bet)
Seat 2: AlexEliseev7 folded before Flop (didn't bet)
Seat 4: megaman1966 (button) folded before Flop (didn't bet)
Seat 5: Mmago24 (small blind) folded before Flop
Seat 6: Kahmi3105 (big blind) folded before Flop
Seat 7: Dragonclawss folded before Flop (didn't bet)
Seat 8: La Ghir collected ($1.25)
Seat 9: siskin vrach folded before Flop (didn't bet)



PokerStars Hand #228684147183:  Hold'em No Limit ($0.25/$0.50 USD) - 2021/07/30 13:43:08 ET
Table 'Aitne III' 9-max Seat #5 is the button
Seat 1: Nightwoof ($55.31 in chips) 
Seat 2: AlexEliseev7 ($50 in chips) 
Seat 4: megaman1966 ($10.53 in chips) 
Seat 5: Mmago24 ($97.24 in chips) 
Seat 6: Kahmi3105 ($81.79 in chips) 
Seat 8: La Ghir ($50.75 in chips) 
Seat 9: siskin vrach ($69.06 in chips) 
Kahmi3105: posts small blind $0.25
La Ghir: posts big blind $0.50
Lemmi846: sits out 
*** HOLE CARDS ***
siskin vrach: folds 
Nightwoof: raises $0.75 to $1.25
AlexEliseev7: folds 
megaman1966: folds 
Mmago24: folds 
Kahmi3105: folds 
La Ghir: folds 
Uncalled bet ($0.75) returned to Nightwoof
Nightwoof collected $1.25 from pot
Nightwoof: doesn't show hand 
*** SUMMARY ***
Total pot $1.25 | Rake $0 
Seat 1: Nightwoof collected ($1.25)
Seat 2: AlexEliseev7 folded before Flop (didn't bet)
Seat 4: megaman1966 folded before Flop (didn't bet)
Seat 5: Mmago24 (button) folded before Flop (didn't bet)
Seat 6: Kahmi3105 (small blind) folded before Flop
Seat 8: La Ghir (big blind) folded before Flop
Seat 9: siskin vrach folded before Flop (didn't bet)



PokerStars Hand #228684154830:  Hold'em No Limit ($0.25/$0.50 USD) - 2021/07/30 13:43:26 ET
Table 'Aitne III' 9-max Seat #6 is the button
Seat 1: Nightwoof ($56.06 in chips) 
Seat 2: AlexEliseev7 ($50 in chips) 
Seat 4: megaman1966 ($10.53 in chips) 
Seat 5: Mmago24 ($97.24 in chips) 
Seat 6: Kahmi3105 ($81.54 in chips) 
Seat 8: La Ghir ($50.25 in chips) 
Seat 9: siskin vrach ($69.06 in chips) 
La Ghir: posts small blind $0.25
siskin vrach: posts big blind $0.50
Lemmi846: sits out 
*** HOLE CARDS ***
Nightwoof: raises $0.75 to $1.25
AlexEliseev7: raises $2.50 to $3.75
megaman1966: folds 
Mmago24: folds 
Kahmi3105: folds 
La Ghir: folds 
siskin vrach: folds 
Nightwoof: folds 
Uncalled bet ($2.50) returned to AlexEliseev7
AlexEliseev7 collected $3.25 from pot
AlexEliseev7: doesn't show hand 
*** SUMMARY ***
Total pot $3.25 | Rake $0 
Seat 1: Nightwoof folded before Flop
Seat 2: AlexEliseev7 collected ($3.25)
Seat 4: megaman1966 folded before Flop (didn't bet)
Seat 5: Mmago24 folded before Flop (didn't bet)
Seat 6: Kahmi3105 (button) folded before Flop (didn't bet)
Seat 8: La Ghir (small blind) folded before Flop
Seat 9: siskin vrach (big blind) folded before Flop



PokerStars Hand #228684163582:  Hold'em No Limit ($0.25/$0.50 USD) - 2021/07/30 13:43:47 ET
Table 'Aitne III' 9-max Seat #8 is the button
Seat 1: Nightwoof ($54.81 in chips) 
Seat 2: AlexEliseev7 ($52 in chips) 
Seat 4: megaman1966 ($10.53 in chips) 
Seat 5: Mmago24 ($97.24 in chips) 
Seat 6: Kahmi3105 ($81.54 in chips) 
Seat 8: La Ghir ($50 in chips) 
Seat 9: siskin vrach ($68.56 in chips) 
siskin vrach: posts small blind $0.25
Nightwoof: posts big blind $0.50
Lemmi846: sits out 
*** HOLE CARDS ***
AlexEliseev7: folds 
megaman1966: calls $0.50
Mmago24: raises $1.20 to $1.70
Kahmi3105: folds 
La Ghir: folds 
siskin vrach: folds 
Nightwoof: folds 
megaman1966: calls $1.20
*** FLOP *** [Ac 8c 5s]
megaman1966: checks 
Mmago24: bets $2.63
megaman1966: folds 
Uncalled bet ($2.63) returned to Mmago24
Mmago24 collected $3.94 from pot
Mmago24: doesn't show hand 
*** SUMMARY ***
Total pot $4.15 | Rake $0.21 
Board [Ac 8c 5s]
Seat 1: Nightwoof (big blind) folded before Flop
Seat 2: AlexEliseev7 folded before Flop (didn't bet)
Seat 4: megaman1966 folded on the Flop
Seat 5: Mmago24 collected ($3.94)
Seat 6: Kahmi3105 folded before Flop (didn't bet)
Seat 8: La Ghir (button) folded before Flop (didn't bet)
Seat 9: siskin vrach (small blind) folded before Flop



PokerStars Hand #228684179338:  Hold'em No Limit ($0.25/$0.50 USD) - 2021/07/30 13:44:24 ET
Table 'Aitne III' 9-max Seat #9 is the button
Seat 1: Nightwoof ($54.31 in chips) 
Seat 2: AlexEliseev7 ($52 in chips) 
Seat 4: megaman1966 ($8.83 in chips) 
Seat 5: Mmago24 ($99.48 in chips) 
Seat 6: Kahmi3105 ($81.54 in chips) 
Seat 8: La Ghir ($50 in chips) 
Seat 9: siskin vrach ($68.31 in chips) 
Nightwoof: posts small blind $0.25
AlexEliseev7: posts big blind $0.50
Lemmi846: sits out 
*** HOLE CARDS ***
megaman1966: folds 
Mmago24: folds 
Kahmi3105: raises $1.25 to $1.75
La Ghir: folds 
siskin vrach: folds 
Nightwoof: folds 
AlexEliseev7: folds 
Uncalled bet ($1.25) returned to Kahmi3105
Kahmi3105 collected $1.25 from pot
*** SUMMARY ***
Total pot $1.25 | Rake $0 
Seat 1: Nightwoof (small blind) folded before Flop
Seat 2: AlexEliseev7 (big blind) folded before Flop
Seat 4: megaman1966 folded before Flop (didn't bet)
Seat 5: Mmago24 folded before Flop (didn't bet)
Seat 6: Kahmi3105 collected ($1.25)
Seat 8: La Ghir folded before Flop (didn't bet)
Seat 9: siskin vrach (button) folded before Flop (didn't bet)



PokerStars Hand #228684187382:  Hold'em No Limit ($0.25/$0.50 USD) - 2021/07/30 13:44:43 ET
Table 'Aitne III' 9-max Seat #1 is the button
Seat 1: Nightwoof ($54.06 in chips) 
Seat 2: AlexEliseev7 ($51.50 in chips) 
Seat 3: Lemmi846 ($63.27 in chips) 
Seat 4: megaman1966 ($8.83 in chips) 
Seat 5: Mmago24 ($99.48 in chips) 
Seat 6: Kahmi3105 ($82.29 in chips) 
Seat 8: La Ghir ($50 in chips) 
Seat 9: siskin vrach ($68.31 in chips) 
AlexEliseev7: posts small blind $0.25
Lemmi846: posts big blind $0.50
*** HOLE CARDS ***
megaman1966: calls $0.50
Mmago24: folds 
Kahmi3105: folds 
La Ghir: raises $1.50 to $2
siskin vrach: folds 
Nightwoof: folds 
AlexEliseev7: folds 
Lemmi846: calls $1.50
megaman1966: calls $1.50
*** FLOP *** [3s 3d 4s]
Lemmi846: checks 
megaman1966: checks 
La Ghir: bets $1.96
Lemmi846: calls $1.96
megaman1966: raises $4.87 to $6.83 and is all-in
La Ghir: folds 
Lemmi846: calls $4.87
Dragonclawss leaves the table
Lemmi846 has timed out
*** TURN *** [3s 3d 4s] [5h]
*** RIVER *** [3s 3d 4s 5h] [Js]
*** SHOW DOWN ***
Lemmi846: shows [Ac Ks] (a pair of Threes)
megaman1966: shows [Ah 4d] (two pair, Fours and Threes)
megaman1966 collected $20.51 from pot
Pachebrash joins the table at seat #7 
*** SUMMARY ***
Total pot $21.87 | Rake $1.36 
Board [3s 3d 4s 5h Js]
Seat 1: Nightwoof (button) folded before Flop (didn't bet)
Seat 2: AlexEliseev7 (small blind) folded before Flop
Seat 3: Lemmi846 (big blind) showed [Ac Ks] and lost with a pair of Threes
Seat 4: megaman1966 showed [Ah 4d] and won ($20.51) with two pair, Fours and Threes
Seat 5: Mmago24 folded before Flop (didn't bet)
Seat 6: Kahmi3105 folded before Flop (didn't bet)
Seat 8: La Ghir folded on the Flop
Seat 9: siskin vrach folded before Flop (didn't bet)



PokerStars Hand #228684216654:  Hold'em No Limit ($0.25/$0.50 USD) - 2021/07/30 13:45:52 ET
Table 'Aitne III' 9-max Seat #2 is the button
Seat 1: Nightwoof ($54.06 in chips) 
Seat 2: AlexEliseev7 ($51.25 in chips) 
Seat 3: Lemmi846 ($54.44 in chips) 
Seat 4: megaman1966 ($20.51 in chips) 
Seat 5: Mmago24 ($99.48 in chips) 
Seat 6: Kahmi3105 ($82.29 in chips) 
Seat 8: La Ghir ($50 in chips) 
Seat 9: siskin vrach ($68.31 in chips) 
Lemmi846: posts small blind $0.25
megaman1966: posts big blind $0.50
Pachebrash: sits out 
*** HOLE CARDS ***
Mmago24: folds 
Kahmi3105: folds 
La Ghir: folds 
siskin vrach: folds 
Nightwoof: raises $0.75 to $1.25
AlexEliseev7: calls $1.25
Lemmi846: folds 
megaman1966: calls $0.75
*** FLOP *** [7c 2d 7s]
megaman1966: checks 
Nightwoof: checks 
AlexEliseev7: checks 
*** TURN *** [7c 2d 7s] [Qc]
megaman1966: checks 
Nightwoof: checks 
AlexEliseev7: bets $3.04
megaman1966: calls $3.04
Nightwoof: folds 
*** RIVER *** [7c 2d 7s Qc] [Tc]
megaman1966: checks 
AlexEliseev7: bets $7.66
megaman1966: calls $7.66
*** SHOW DOWN ***
AlexEliseev7: shows [8c 9c] (a flush, Queen high)
megaman1966: mucks hand 
AlexEliseev7 collected $24.13 from pot
*** SUMMARY ***
Total pot $25.40 | Rake $1.27 
Board [7c 2d 7s Qc Tc]
Seat 1: Nightwoof folded on the Turn
Seat 2: AlexEliseev7 (button) showed [8c 9c] and won ($24.13) with a flush, Queen high
Seat 3: Lemmi846 (small blind) folded before Flop
Seat 4: megaman1966 (big blind) mucked
Seat 5: Mmago24 folded before Flop (didn't bet)
Seat 6: Kahmi3105 folded before Flop (didn't bet)
Seat 8: La Ghir folded before Flop (didn't bet)
Seat 9: siskin vrach folded before Flop (didn't bet)



PokerStars Hand #228684250071:  Hold'em No Limit ($0.25/$0.50 USD) - 2021/07/30 13:47:12 ET
Table 'Aitne III' 9-max Seat #3 is the button
Seat 1: Nightwoof ($52.81 in chips) 
Seat 2: AlexEliseev7 ($63.43 in chips) 
Seat 3: Lemmi846 ($54.19 in chips) 
Seat 4: megaman1966 ($8.56 in chips) 
Seat 5: Mmago24 ($99.48 in chips) 
Seat 6: Kahmi3105 ($82.29 in chips) 
Seat 8: La Ghir ($50 in chips) 
Seat 9: siskin vrach ($68.31 in chips) 
megaman1966: posts small blind $0.25
Mmago24: posts big blind $0.50
Pachebrash: sits out 
*** HOLE CARDS ***
Kahmi3105: folds 
La Ghir: folds 
siskin vrach: folds 
Nightwoof: raises $0.75 to $1.25
AlexEliseev7: folds 
Lemmi846: folds 
megaman1966: folds 
Mmago24: calls $0.75
*** FLOP *** [Ad Td 2h]
Mmago24: checks 
Nightwoof: bets $0.87
Mmago24: folds 
Uncalled bet ($0.87) returned to Nightwoof
Nightwoof collected $2.61 from pot
Nightwoof: doesn't show hand 
*** SUMMARY ***
Total pot $2.75 | Rake $0.14 
Board [Ad Td 2h]
Seat 1: Nightwoof collected ($2.61)
Seat 2: AlexEliseev7 folded before Flop (didn't bet)
Seat 3: Lemmi846 (button) folded before Flop (didn't bet)
Seat 4: megaman1966 (small blind) folded before Flop
Seat 5: Mmago24 (big blind) folded on the Flop
Seat 6: Kahmi3105 folded before Flop (didn't bet)
Seat 8: La Ghir folded before Flop (didn't bet)
Seat 9: siskin vrach folded before Flop (didn't bet)



PokerStars Hand #228684264934:  Hold'em No Limit ($0.25/$0.50 USD) - 2021/07/30 13:47:48 ET
Table 'Aitne III' 9-max Seat #4 is the button
Seat 1: Nightwoof ($54.17 in chips) 
Seat 2: AlexEliseev7 ($63.43 in chips) 
Seat 3: Lemmi846 ($54.19 in chips) 
Seat 4: megaman1966 ($8.31 in chips) 
Seat 5: Mmago24 ($98.23 in chips) 
Seat 6: Kahmi3105 ($82.29 in chips) 
Seat 8: La Ghir ($50 in chips) 
Seat 9: siskin vrach ($68.31 in chips) 
Mmago24: posts small blind $0.25
Kahmi3105: posts big blind $0.50
Pachebrash: sits out 
*** HOLE CARDS ***
La Ghir: folds 
siskin vrach: folds 
Nightwoof: folds 
AlexEliseev7: folds 
Lemmi846: folds 
megaman1966: calls $0.50
Mmago24: folds 
Kahmi3105: checks 
*** FLOP *** [Jc 2s 9d]
Kahmi3105: checks 
megaman1966: checks 
*** TURN *** [Jc 2s 9d] [6c]
Kahmi3105: checks 
megaman1966: checks 
*** RIVER *** [Jc 2s 9d 6c] [Kc]
Kahmi3105: checks 
megaman1966: checks 
*** SHOW DOWN ***
Kahmi3105: shows [8h Ad] (high card Ace)
megaman1966: mucks hand 
Kahmi3105 collected $1.17 from pot
*** SUMMARY ***
Total pot $1.25 | Rake $0.08 
Board [Jc 2s 9d 6c Kc]
Seat 1: Nightwoof folded before Flop (didn't bet)
Seat 2: AlexEliseev7 folded before Flop (didn't bet)
Seat 3: Lemmi846 folded before Flop (didn't bet)
Seat 4: megaman1966 (button) mucked
Seat 5: Mmago24 (small blind) folded before Flop
Seat 6: Kahmi3105 (big blind) showed [8h Ad] and won ($1.17) with high card Ace
Seat 8: La Ghir folded before Flop (didn't bet)
Seat 9: siskin vrach folded before Flop (didn't bet)



PokerStars Hand #228684274609:  Hold'em No Limit ($0.25/$0.50 USD) - 2021/07/30 13:48:11 ET
Table 'Aitne III' 9-max Seat #5 is the button
Seat 1: Nightwoof ($54.17 in chips) 
Seat 2: AlexEliseev7 ($63.43 in chips) 
Seat 3: Lemmi846 ($54.19 in chips) 
Seat 4: megaman1966 ($7.81 in chips) 
Seat 5: Mmago24 ($97.98 in chips) 
Seat 6: Kahmi3105 ($82.96 in chips) 
Seat 7: Pachebrash ($53.31 in chips) 
Seat 8: La Ghir ($50 in chips) 
Seat 9: siskin vrach ($68.31 in chips) 
Kahmi3105: posts small blind $0.25
Pachebrash: posts big blind $0.50
*** HOLE CARDS ***
La Ghir: folds 
siskin vrach: folds 
Nightwoof: folds 
AlexEliseev7: folds 
Lemmi846: raises $0.50 to $1
megaman1966: calls $1
Mmago24: calls $1
Kahmi3105: folds 
Pachebrash: folds 
*** FLOP *** [Js Kd 3c]
Lemmi846: checks 
megaman1966: bets $1.78
Mmago24: folds 
Lemmi846: folds 
Uncalled bet ($1.78) returned to megaman1966
megaman1966 collected $3.51 from pot
megaman1966: doesn't show hand 
*** SUMMARY ***
Total pot $3.75 | Rake $0.24 
Board [Js Kd 3c]
Seat 1: Nightwoof folded before Flop (didn't bet)
Seat 2: AlexEliseev7 folded before Flop (didn't bet)
Seat 3: Lemmi846 folded on the Flop
Seat 4: megaman1966 collected ($3.51)
Seat 5: Mmago24 (button) folded on the Flop
Seat 6: Kahmi3105 (small blind) folded before Flop
Seat 7: Pachebrash (big blind) folded before Flop
Seat 8: La Ghir folded before Flop (didn't bet)
Seat 9: siskin vrach folded before Flop (didn't bet)



PokerStars Hand #228684287820:  Hold'em No Limit ($0.25/$0.50 USD) - 2021/07/30 13:48:43 ET
Table 'Aitne III' 9-max Seat #6 is the button
Seat 1: Nightwoof ($54.17 in chips) 
Seat 2: AlexEliseev7 ($63.43 in chips) 
Seat 3: Lemmi846 ($53.19 in chips) 
Seat 4: megaman1966 ($10.32 in chips) 
Seat 5: Mmago24 ($96.98 in chips) 
Seat 6: Kahmi3105 ($82.71 in chips) 
Seat 7: Pachebrash ($52.81 in chips) 
Seat 8: La Ghir ($50 in chips) 
Seat 9: siskin vrach ($68.31 in chips) 
Pachebrash: posts small blind $0.25
La Ghir: posts big blind $0.50
*** HOLE CARDS ***
siskin vrach: folds 
Nightwoof: folds 
AlexEliseev7: folds 
Lemmi846: raises $0.50 to $1
megaman1966: calls $1
Mmago24: folds 
Kahmi3105: calls $1
Pachebrash: raises $6 to $7
La Ghir: folds 
Lemmi846: folds 
megaman1966: folds 
Kahmi3105: folds 
Uncalled bet ($6) returned to Pachebrash
Pachebrash collected $4.50 from pot
Pachebrash: doesn't show hand 
*** SUMMARY ***
Total pot $4.50 | Rake $0 
Seat 1: Nightwoof folded before Flop (didn't bet)
Seat 2: AlexEliseev7 folded before Flop (didn't bet)
Seat 3: Lemmi846 folded before Flop
Seat 4: megaman1966 folded before Flop
Seat 5: Mmago24 folded before Flop (didn't bet)
Seat 6: Kahmi3105 (button) folded before Flop
Seat 7: Pachebrash (small blind) collected ($4.50)
Seat 8: La Ghir (big blind) folded before Flop
Seat 9: siskin vrach folded before Flop (didn't bet)



PokerStars Hand #228684310944:  Hold'em No Limit ($0.25/$0.50 USD) - 2021/07/30 13:49:18 ET
Table 'Aitne III' 9-max Seat #7 is the button
Seat 1: Nightwoof ($54.17 in chips) 
Seat 2: AlexEliseev7 ($63.43 in chips) 
Seat 3: Lemmi846 ($52.19 in chips) 
Seat 4: megaman1966 ($9.32 in chips) 
Seat 5: Mmago24 ($96.98 in chips) 
Seat 6: Kahmi3105 ($81.71 in chips) 
Seat 7: Pachebrash ($56.31 in chips) 
Seat 8: La Ghir ($50 in chips) 
Seat 9: siskin vrach ($68.31 in chips) 
La Ghir: posts small blind $0.25
siskin vrach: posts big blind $0.50
*** HOLE CARDS ***
Nightwoof: folds 
AlexEliseev7: folds 
Lemmi846: folds 
megaman1966: calls $0.50
Mmago24: folds 
Kahmi3105: folds 
Pachebrash: folds 
La Ghir: folds 
siskin vrach: checks 
*** FLOP *** [Js Tc 6h]
siskin vrach: checks 
megaman1966: checks 
*** TURN *** [Js Tc 6h] [5s]
siskin vrach: checks 
megaman1966: checks 
*** RIVER *** [Js Tc 6h 5s] [As]
siskin vrach: checks 
megaman1966: bets $1
siskin vrach: folds 
Uncalled bet ($1) returned to megaman1966
megaman1966 collected $1.17 from pot
megaman1966: doesn't show hand 
*** SUMMARY ***
Total pot $1.25 | Rake $0.08 
Board [Js Tc 6h 5s As]
Seat 1: Nightwoof folded before Flop (didn't bet)
Seat 2: AlexEliseev7 folded before Flop (didn't bet)
Seat 3: Lemmi846 folded before Flop (didn't bet)
Seat 4: megaman1966 collected ($1.17)
Seat 5: Mmago24 folded before Flop (didn't bet)
Seat 6: Kahmi3105 folded before Flop (didn't bet)
Seat 7: Pachebrash (button) folded before Flop (didn't bet)
Seat 8: La Ghir (small blind) folded before Flop
Seat 9: siskin vrach (big blind) folded on the River



PokerStars Hand #228684335588:  Hold'em No Limit ($0.25/$0.50 USD) - 2021/07/30 13:50:17 ET
Table 'Aitne III' 9-max Seat #8 is the button
Seat 1: Nightwoof ($54.17 in chips) 
Seat 2: AlexEliseev7 ($63.43 in chips) 
Seat 3: Lemmi846 ($52.19 in chips) 
Seat 4: megaman1966 ($9.99 in chips) 
Seat 5: Mmago24 ($96.98 in chips) 
Seat 6: Kahmi3105 ($81.71 in chips) 
Seat 7: Pachebrash ($56.31 in chips) 
Seat 8: La Ghir ($50 in chips) 
Seat 9: siskin vrach ($67.81 in chips) 
siskin vrach: posts small blind $0.25
Nightwoof: posts big blind $0.50
*** HOLE CARDS ***
AlexEliseev7: folds 
Lemmi846: folds 
megaman1966: folds 
Mmago24: folds 
Kahmi3105: raises $1.25 to $1.75
Pachebrash: calls $1.75
La Ghir: folds 
siskin vrach: folds 
Nightwoof: calls $1.25
*** FLOP *** [6s Qd 5s]
Nightwoof: checks 
Kahmi3105: checks 
Pachebrash: bets $1.77
Nightwoof: folds 
Kahmi3105: folds 
Uncalled bet ($1.77) returned to Pachebrash
Pachebrash collected $5.22 from pot
Pachebrash: doesn't show hand 
*** SUMMARY ***
Total pot $5.50 | Rake $0.28 
Board [6s Qd 5s]
Seat 1: Nightwoof (big blind) folded on the Flop
Seat 2: AlexEliseev7 folded before Flop (didn't bet)
Seat 3: Lemmi846 folded before Flop (didn't bet)
Seat 4: megaman1966 folded before Flop (didn't bet)
Seat 5: Mmago24 folded before Flop (didn't bet)
Seat 6: Kahmi3105 folded on the Flop
Seat 7: Pachebrash collected ($5.22)
Seat 8: La Ghir (button) folded before Flop (didn't bet)
Seat 9: siskin vrach (small blind) folded before Flop



PokerStars Hand #228684346578:  Hold'em No Limit ($0.25/$0.50 USD) - 2021/07/30 13:50:43 ET
Table 'Aitne III' 9-max Seat #9 is the button
Seat 1: Nightwoof ($52.42 in chips) 
Seat 2: AlexEliseev7 ($63.43 in chips) 
Seat 3: Lemmi846 ($52.19 in chips) 
Seat 4: megaman1966 ($9.99 in chips) 
Seat 5: Mmago24 ($96.98 in chips) 
Seat 6: Kahmi3105 ($79.96 in chips) 
Seat 7: Pachebrash ($59.78 in chips) 
Seat 8: La Ghir ($50 in chips) 
Seat 9: siskin vrach ($67.56 in chips) 
Nightwoof: posts small blind $0.25
AlexEliseev7: posts big blind $0.50
*** HOLE CARDS ***
Lemmi846: folds 
megaman1966: calls $0.50
Mmago24: folds 
Kahmi3105: folds 
Pachebrash: folds 
La Ghir: folds 
siskin vrach: folds 
Nightwoof: folds 
AlexEliseev7: raises $2 to $2.50
megaman1966: calls $2
*** FLOP *** [3c 8c Jc]
AlexEliseev7: checks 
megaman1966: bets $2.50
AlexEliseev7: folds 
Uncalled bet ($2.50) returned to megaman1966
megaman1966 collected $4.93 from pot
megaman1966: doesn't show hand 
*** SUMMARY ***
Total pot $5.25 | Rake $0.32 
Board [3c 8c Jc]
Seat 1: Nightwoof (small blind) folded before Flop
Seat 2: AlexEliseev7 (big blind) folded on the Flop
Seat 3: Lemmi846 folded before Flop (didn't bet)
Seat 4: megaman1966 collected ($4.93)
Seat 5: Mmago24 folded before Flop (didn't bet)
Seat 6: Kahmi3105 folded before Flop (didn't bet)
Seat 7: Pachebrash folded before Flop (didn't bet)
Seat 8: La Ghir folded before Flop (didn't bet)
Seat 9: siskin vrach (button) folded before Flop (didn't bet)



PokerStars Hand #228684365136:  Hold'em No Limit ($0.25/$0.50 USD) - 2021/07/30 13:51:28 ET
Table 'Aitne III' 9-max Seat #1 is the button
Seat 1: Nightwoof ($52.17 in chips) 
Seat 2: AlexEliseev7 ($60.93 in chips) 
Seat 3: Lemmi846 ($52.19 in chips) 
Seat 4: megaman1966 ($12.42 in chips) 
Seat 5: Mmago24 ($96.98 in chips) 
Seat 6: Kahmi3105 ($79.96 in chips) 
Seat 7: Pachebrash ($59.78 in chips) 
Seat 8: La Ghir ($50 in chips) 
Seat 9: siskin vrach ($67.56 in chips) 
AlexEliseev7: posts small blind $0.25
Lemmi846: posts big blind $0.50
*** HOLE CARDS ***
megaman1966: calls $0.50
Mmago24: folds 
Kahmi3105: folds 
Pachebrash: folds 
La Ghir: folds 
siskin vrach: folds 
Nightwoof: folds 
AlexEliseev7: raises $2 to $2.50
Lemmi846: folds 
megaman1966: calls $2
*** FLOP *** [Qc 4c Kd]
AlexEliseev7: checks 
megaman1966: bets $2.61
AlexEliseev7: calls $2.61
*** TURN *** [Qc 4c Kd] [Ad]
AlexEliseev7: checks 
megaman1966: bets $5.09
AlexEliseev7: calls $5.09
*** RIVER *** [Qc 4c Kd Ad] [Ks]
AlexEliseev7: checks 
megaman1966: bets $2.22 and is all-in
AlexEliseev7: calls $2.22
*** SHOW DOWN ***
megaman1966: shows [Qd Kc] (a full house, Kings full of Queens)
AlexEliseev7: shows [Ah Qs] (two pair, Aces and Kings)
megaman1966 collected $23.75 from pot
*** SUMMARY ***
Total pot $25.34 | Rake $1.59 
Board [Qc 4c Kd Ad Ks]
Seat 1: Nightwoof (button) folded before Flop (didn't bet)
Seat 2: AlexEliseev7 (small blind) showed [Ah Qs] and lost with two pair, Aces and Kings
Seat 3: Lemmi846 (big blind) folded before Flop
Seat 4: megaman1966 showed [Qd Kc] and won ($23.75) with a full house, Kings full of Queens
Seat 5: Mmago24 folded before Flop (didn't bet)
Seat 6: Kahmi3105 folded before Flop (didn't bet)
Seat 7: Pachebrash folded before Flop (didn't bet)
Seat 8: La Ghir folded before Flop (didn't bet)
Seat 9: siskin vrach folded before Flop (didn't bet)



PokerStars Hand #228684405551:  Hold'em No Limit ($0.25/$0.50 USD) - 2021/07/30 13:53:06 ET
Table 'Aitne III' 9-max Seat #2 is the button
Seat 1: Nightwoof ($52.17 in chips) 
Seat 2: AlexEliseev7 ($50 in chips) 
Seat 3: Lemmi846 ($51.69 in chips) 
Seat 4: megaman1966 ($23.75 in chips) 
Seat 5: Mmago24 ($96.98 in chips) 
Seat 6: Kahmi3105 ($79.96 in chips) 
Seat 7: Pachebrash ($59.78 in chips) 
Seat 8: La Ghir ($50 in chips) 
Seat 9: siskin vrach ($67.56 in chips) 
Lemmi846: posts small blind $0.25
megaman1966: posts big blind $0.50
*** HOLE CARDS ***
Mmago24: raises $0.72 to $1.22
Kahmi3105: calls $1.22
Pachebrash: folds 
La Ghir: folds 
siskin vrach: folds 
Nightwoof: calls $1.22
AlexEliseev7: folds 
Lemmi846: folds 
megaman1966: calls $0.72
*** FLOP *** [3c 9c 6h]
megaman1966: checks 
Mmago24: checks 
Kahmi3105: checks 
Nightwoof: checks 
*** TURN *** [3c 9c 6h] [7c]
megaman1966: bets $0.50
Mmago24: calls $0.50
Kahmi3105: calls $0.50
Nightwoof: calls $0.50
*** RIVER *** [3c 9c 6h 7c] [Qs]
megaman1966: checks 
Mmago24: bets $3
Kahmi3105: folds 
Nightwoof: folds 
megaman1966: folds 
Uncalled bet ($3) returned to Mmago24
Mmago24 collected $6.77 from pot
Mmago24: doesn't show hand 
*** SUMMARY ***
Total pot $7.13 | Rake $0.36 
Board [3c 9c 6h 7c Qs]
Seat 1: Nightwoof folded on the River
Seat 2: AlexEliseev7 (button) folded before Flop (didn't bet)
Seat 3: Lemmi846 (small blind) folded before Flop
Seat 4: megaman1966 (big blind) folded on the River
Seat 5: Mmago24 collected ($6.77)
Seat 6: Kahmi3105 folded on the River
Seat 7: Pachebrash folded before Flop (didn't bet)
Seat 8: La Ghir folded before Flop (didn't bet)
Seat 9: siskin vrach folded before Flop (didn't bet)



PokerStars Hand #228684429499:  Hold'em No Limit ($0.25/$0.50 USD) - 2021/07/30 13:54:03 ET
Table 'Aitne III' 9-max Seat #3 is the button
Seat 1: Nightwoof ($50.45 in chips) 
Seat 2: AlexEliseev7 ($50 in chips) 
Seat 3: Lemmi846 ($51.44 in chips) 
Seat 4: megaman1966 ($22.03 in chips) 
Seat 5: Mmago24 ($102.03 in chips) 
Seat 6: Kahmi3105 ($78.24 in chips) 
Seat 7: Pachebrash ($59.78 in chips) 
Seat 8: La Ghir ($50 in chips) 
megaman1966: posts small blind $0.25
Mmago24: posts big blind $0.50
*** HOLE CARDS ***
Kahmi3105: folds 
Pachebrash: folds 
La Ghir: folds 
Nightwoof: folds 
AlexEliseev7: folds 
Lemmi846: folds 
megaman1966: calls $0.25
Mmago24: checks 
*** FLOP *** [Tc 4s Qs]
megaman1966: bets $0.50
Mmago24: calls $0.50
*** TURN *** [Tc 4s Qs] [Qh]
megaman1966: checks 
Mmago24: checks 
*** RIVER *** [Tc 4s Qs Qh] [As]
megaman1966: checks 
Mmago24: checks 
*** SHOW DOWN ***
megaman1966: shows [6c 7h] (a pair of Queens)
Mmago24: shows [2c 4h] (two pair, Queens and Fours)
Mmago24 collected $1.90 from pot
*** SUMMARY ***
Total pot $2 | Rake $0.10 
Board [Tc 4s Qs Qh As]
Seat 1: Nightwoof folded before Flop (didn't bet)
Seat 2: AlexEliseev7 folded before Flop (didn't bet)
Seat 3: Lemmi846 (button) folded before Flop (didn't bet)
Seat 4: megaman1966 (small blind) showed [6c 7h] and lost with a pair of Queens
Seat 5: Mmago24 (big blind) showed [2c 4h] and won ($1.90) with two pair, Queens and Fours
Seat 6: Kahmi3105 folded before Flop (didn't bet)
Seat 7: Pachebrash folded before Flop (didn't bet)
Seat 8: La Ghir folded before Flop (didn't bet)



PokerStars Hand #228684447851:  Hold'em No Limit ($0.25/$0.50 USD) - 2021/07/30 13:54:47 ET
Table 'Aitne III' 9-max Seat #4 is the button
Seat 1: Nightwoof ($50.45 in chips) 
Seat 2: AlexEliseev7 ($50 in chips) 
Seat 3: Lemmi846 ($51.44 in chips) 
Seat 4: megaman1966 ($21.03 in chips) 
Seat 5: Mmago24 ($102.93 in chips) 
Seat 6: Kahmi3105 ($78.24 in chips) 
Seat 7: Pachebrash ($59.78 in chips) 
Seat 8: La Ghir ($50 in chips) 
Mmago24: posts small blind $0.25
Kahmi3105: posts big blind $0.50
*** HOLE CARDS ***
Pachebrash: folds 
La Ghir: raises $1 to $1.50
Nightwoof: folds 
AlexEliseev7: folds 
Lemmi846: folds 
megaman1966: folds 
Mmago24: folds 
Kahmi3105: folds 
Uncalled bet ($1) returned to La Ghir
La Ghir collected $1.25 from pot
La Ghir: doesn't show hand 
*** SUMMARY ***
Total pot $1.25 | Rake $0 
Seat 1: Nightwoof folded before Flop (didn't bet)
Seat 2: AlexEliseev7 folded before Flop (didn't bet)
Seat 3: Lemmi846 folded before Flop (didn't bet)
Seat 4: megaman1966 (button) folded before Flop (didn't bet)
Seat 5: Mmago24 (small blind) folded before Flop
Seat 6: Kahmi3105 (big blind) folded before Flop
Seat 7: Pachebrash folded before Flop (didn't bet)
Seat 8: La Ghir collected ($1.25)



PokerStars Hand #228684457722:  Hold'em No Limit ($0.25/$0.50 USD) - 2021/07/30 13:55:12 ET
Table 'Aitne III' 9-max Seat #5 is the button
Seat 1: Nightwoof ($50.45 in chips) 
Seat 2: AlexEliseev7 ($50 in chips) 
Seat 3: Lemmi846 ($51.44 in chips) 
Seat 4: megaman1966 ($21.03 in chips) 
Seat 5: Mmago24 ($102.68 in chips) 
Seat 6: Kahmi3105 ($77.74 in chips) 
Seat 7: Pachebrash ($59.78 in chips) 
Seat 8: La Ghir ($50.75 in chips) 
Kahmi3105: posts small blind $0.25
Pachebrash: posts big blind $0.50
*** HOLE CARDS ***
La Ghir: folds 
Nightwoof: folds 
AlexEliseev7: folds 
Lemmi846: folds 
megaman1966: folds 
Mmago24: folds 
Kahmi3105: calls $0.25
Pachebrash: raises $1.50 to $2
Kahmi3105: calls $1.50
*** FLOP *** [Js 6d Td]
Kahmi3105: checks 
Pachebrash: checks 
*** TURN *** [Js 6d Td] [6c]
Kahmi3105: checks 
Pachebrash: checks 
*** RIVER *** [Js 6d Td 6c] [7d]
Kahmi3105: checks 
Pachebrash: checks 
*** SHOW DOWN ***
Kahmi3105: shows [9d 2d] (a flush, Ten high)
Pachebrash: mucks hand 
Kahmi3105 collected $3.75 from pot
*** SUMMARY ***
Total pot $4 | Rake $0.25 
Board [Js 6d Td 6c 7d]
Seat 1: Nightwoof folded before Flop (didn't bet)
Seat 2: AlexEliseev7 folded before Flop (didn't bet)
Seat 3: Lemmi846 folded before Flop (didn't bet)
Seat 4: megaman1966 folded before Flop (didn't bet)
Seat 5: Mmago24 (button) folded before Flop (didn't bet)
Seat 6: Kahmi3105 (small blind) showed [9d 2d] and won ($3.75) with a flush, Ten high
Seat 7: Pachebrash (big blind) mucked
Seat 8: La Ghir folded before Flop (didn't bet)



PokerStars Hand #228684469909:  Hold'em No Limit ($0.25/$0.50 USD) - 2021/07/30 13:55:53 ET
Table 'Aitne III' 9-max Seat #6 is the button
Seat 1: Nightwoof ($50.45 in chips) 
Seat 2: AlexEliseev7 ($50 in chips) 
Seat 3: Lemmi846 ($51.44 in chips) 
Seat 4: megaman1966 ($21.03 in chips) 
Seat 5: Mmago24 ($102.68 in chips) 
Seat 6: Kahmi3105 ($79.49 in chips) 
Seat 7: Pachebrash ($57.78 in chips) 
Seat 8: La Ghir ($50.75 in chips) 
Seat 9: siskin vrach ($67.56 in chips) 
Pachebrash: posts small blind $0.25
La Ghir: posts big blind $0.50
*** HOLE CARDS ***
siskin vrach: raises $1 to $1.50
Nightwoof: folds 
AlexEliseev7: folds 
Lemmi846: folds 
megaman1966: folds 
Mmago24: folds 
Kahmi3105: calls $1.50
Pachebrash: folds 
La Ghir: folds 
*** FLOP *** [9c 3s 7s]
siskin vrach: bets $1.78
Kahmi3105: calls $1.78
*** TURN *** [9c 3s 7s] [7c]
siskin vrach: checks 
Kahmi3105: checks 
*** RIVER *** [9c 3s 7s 7c] [Kc]
siskin vrach: checks 
Kahmi3105: checks 
*** SHOW DOWN ***
siskin vrach: shows [4s 4h] (two pair, Sevens and Fours)
Kahmi3105: shows [9d Ac] (two pair, Nines and Sevens)
Kahmi3105 collected $6.85 from pot
*** SUMMARY ***
Total pot $7.31 | Rake $0.46 
Board [9c 3s 7s 7c Kc]
Seat 1: Nightwoof folded before Flop (didn't bet)
Seat 2: AlexEliseev7 folded before Flop (didn't bet)
Seat 3: Lemmi846 folded before Flop (didn't bet)
Seat 4: megaman1966 folded before Flop (didn't bet)
Seat 5: Mmago24 folded before Flop (didn't bet)
Seat 6: Kahmi3105 (button) showed [9d Ac] and won ($6.85) with two pair, Nines and Sevens
Seat 7: Pachebrash (small blind) folded before Flop
Seat 8: La Ghir (big blind) folded before Flop
Seat 9: siskin vrach showed [4s 4h] and lost with two pair, Sevens and Fours



PokerStars Hand #228684481324:  Hold'em No Limit ($0.25/$0.50 USD) - 2021/07/30 13:56:33 ET
Table 'Aitne III' 9-max Seat #7 is the button
Seat 1: Nightwoof ($50.45 in chips) 
Seat 2: AlexEliseev7 ($50 in chips) 
Seat 3: Lemmi846 ($51.44 in chips) 
Seat 4: megaman1966 ($21.03 in chips) 
Seat 5: Mmago24 ($102.68 in chips) 
Seat 6: Kahmi3105 ($83.06 in chips) 
Seat 7: Pachebrash ($57.53 in chips) 
Seat 8: La Ghir ($50.25 in chips) 
Seat 9: siskin vrach ($64.28 in chips) 
La Ghir: posts small blind $0.25
siskin vrach: posts big blind $0.50
*** HOLE CARDS ***
Nightwoof: folds 
AlexEliseev7: folds 
Lemmi846: folds 
megaman1966: raises $0.50 to $1
Mmago24: raises $2.50 to $3.50
Kahmi3105: folds 
Pachebrash: folds 
La Ghir: folds 
siskin vrach: folds 
megaman1966: calls $2.50
*** FLOP *** [Ac 5c Qc]
megaman1966: checks 
Mmago24: checks 
*** TURN *** [Ac 5c Qc] [8d]
megaman1966: checks 
Mmago24: bets $3.50
megaman1966: calls $3.50
*** RIVER *** [Ac 5c Qc 8d] [4h]
megaman1966: checks 
Mmago24: checks 
*** SHOW DOWN ***
megaman1966: shows [6c 6d] (a pair of Sixes)
Mmago24: shows [Ks Qh] (a pair of Queens)
Mmago24 collected $14.01 from pot
*** SUMMARY ***
Total pot $14.75 | Rake $0.74 
Board [Ac 5c Qc 8d 4h]
Seat 1: Nightwoof folded before Flop (didn't bet)
Seat 2: AlexEliseev7 folded before Flop (didn't bet)
Seat 3: Lemmi846 folded before Flop (didn't bet)
Seat 4: megaman1966 showed [6c 6d] and lost with a pair of Sixes
Seat 5: Mmago24 showed [Ks Qh] and won ($14.01) with a pair of Queens
Seat 6: Kahmi3105 folded before Flop (didn't bet)
Seat 7: Pachebrash (button) folded before Flop (didn't bet)
Seat 8: La Ghir (small blind) folded before Flop
Seat 9: siskin vrach (big blind) folded before Flop



PokerStars Hand #228684495363:  Hold'em No Limit ($0.25/$0.50 USD) - 2021/07/30 13:57:19 ET
Table 'Aitne III' 9-max Seat #8 is the button
Seat 2: AlexEliseev7 ($50 in chips) 
Seat 3: Lemmi846 ($51.44 in chips) 
Seat 4: megaman1966 ($14.03 in chips) 
Seat 5: Mmago24 ($109.69 in chips) 
Seat 6: Kahmi3105 ($83.06 in chips) 
Seat 7: Pachebrash ($57.53 in chips) 
Seat 8: La Ghir ($50 in chips) 
Seat 9: siskin vrach ($63.78 in chips) 
siskin vrach: posts small blind $0.25
Nightwoof: is sitting out 
AlexEliseev7: posts big blind $0.50
*** HOLE CARDS ***
Lemmi846: folds 
megaman1966: folds 
Mmago24: folds 
Kahmi3105: calls $0.50
Pachebrash: folds 
La Ghir: raises $1.50 to $2
siskin vrach: calls $1.75
AlexEliseev7: folds 
Kahmi3105: calls $1.50
*** FLOP *** [Kd 6d 2d]
siskin vrach: checks 
Kahmi3105: checks 
La Ghir: checks 
*** TURN *** [Kd 6d 2d] [Ah]
siskin vrach: checks 
Kahmi3105: checks 
La Ghir: bets $4.33
Nightwoof leaves the table
siskin vrach: folds 
Kahmi3105: folds 
Uncalled bet ($4.33) returned to La Ghir
La Ghir collected $6.18 from pot
La Ghir: doesn't show hand 
*** SUMMARY ***
Total pot $6.50 | Rake $0.32 
Board [Kd 6d 2d Ah]
Seat 2: AlexEliseev7 (big blind) folded before Flop
Seat 3: Lemmi846 folded before Flop (didn't bet)
Seat 4: megaman1966 folded before Flop (didn't bet)
Seat 5: Mmago24 folded before Flop (didn't bet)
Seat 6: Kahmi3105 folded on the Turn
Seat 7: Pachebrash folded before Flop (didn't bet)
Seat 8: La Ghir (button) collected ($6.18)
Seat 9: siskin vrach (small blind) folded on the Turn



PokerStars Hand #228684506045:  Hold'em No Limit ($0.25/$0.50 USD) - 2021/07/30 13:57:55 ET
Table 'Aitne III' 9-max Seat #9 is the button
Seat 2: AlexEliseev7 ($50 in chips) 
Seat 3: Lemmi846 ($51.44 in chips) 
Seat 4: megaman1966 ($14.03 in chips) 
Seat 5: Mmago24 ($109.69 in chips) 
Seat 7: Pachebrash ($57.53 in chips) 
Seat 8: La Ghir ($54.18 in chips) 
Seat 9: siskin vrach ($61.78 in chips) 
AlexEliseev7: posts small blind $0.25
Lemmi846: posts big blind $0.50
*** HOLE CARDS ***
megaman1966: calls $0.50
Mmago24: folds 
Pachebrash: folds 
La Ghir: folds 
siskin vrach: folds 
whitecillar3 joins the table at seat #1 
AlexEliseev7: raises $2 to $2.50
Lemmi846: folds 
megaman1966: folds 
Uncalled bet ($2) returned to AlexEliseev7
AlexEliseev7 collected $1.50 from pot
AlexEliseev7: doesn't show hand 
*** SUMMARY ***
Total pot $1.50 | Rake $0 
Seat 2: AlexEliseev7 (small blind) collected ($1.50)
Seat 3: Lemmi846 (big blind) folded before Flop
Seat 4: megaman1966 folded before Flop
Seat 5: Mmago24 folded before Flop (didn't bet)
Seat 7: Pachebrash folded before Flop (didn't bet)
Seat 8: La Ghir folded before Flop (didn't bet)
Seat 9: siskin vrach (button) folded before Flop (didn't bet)



PokerStars Hand #228684512806:  Hold'em No Limit ($0.25/$0.50 USD) - 2021/07/30 13:58:18 ET
Table 'Aitne III' 9-max Seat #2 is the button
Seat 2: AlexEliseev7 ($51 in chips) 
Seat 3: Lemmi846 ($50.94 in chips) 
Seat 4: megaman1966 ($13.53 in chips) 
Seat 5: Mmago24 ($109.69 in chips) 
Seat 7: Pachebrash ($57.53 in chips) 
Seat 8: La Ghir ($54.18 in chips) 
Seat 9: siskin vrach ($61.78 in chips) 
Lemmi846: posts small blind $0.25
megaman1966: posts big blind $0.50
whitecillar3: sits out 
*** HOLE CARDS ***
Mmago24: folds 
Pachebrash: raises $1 to $1.50
La Ghir: folds 
siskin vrach: folds 
AlexEliseev7: folds 
Lemmi846: folds 
megaman1966: folds 
Uncalled bet ($1) returned to Pachebrash
Pachebrash collected $1.25 from pot
Pachebrash: doesn't show hand 
*** SUMMARY ***
Total pot $1.25 | Rake $0 
Seat 2: AlexEliseev7 (button) folded before Flop (didn't bet)
Seat 3: Lemmi846 (small blind) folded before Flop
Seat 4: megaman1966 (big blind) folded before Flop
Seat 5: Mmago24 folded before Flop (didn't bet)
Seat 7: Pachebrash collected ($1.25)
Seat 8: La Ghir folded before Flop (didn't bet)
Seat 9: siskin vrach folded before Flop (didn't bet)



PokerStars Hand #228684517044:  Hold'em No Limit ($0.25/$0.50 USD) - 2021/07/30 13:58:32 ET
Table 'Aitne III' 9-max Seat #3 is the button
Seat 2: AlexEliseev7 ($51 in chips) 
Seat 3: Lemmi846 ($50.69 in chips) 
Seat 4: megaman1966 ($13.03 in chips) 
Seat 5: Mmago24 ($109.69 in chips) 
Seat 7: Pachebrash ($58.28 in chips) 
Seat 8: La Ghir ($54.18 in chips) 
Seat 9: siskin vrach ($61.78 in chips) 
megaman1966: posts small blind $0.25
Mmago24: posts big blind $0.50
whitecillar3: sits out 
*** HOLE CARDS ***
Pachebrash: folds 
La Ghir: folds 
siskin vrach: folds 
AlexEliseev7: folds 
Lemmi846: folds 
megaman1966: calls $0.25
Mmago24: checks 
*** FLOP *** [3h 9c Js]
megaman1966: checks 
Mmago24: checks 
*** TURN *** [3h 9c Js] [4d]
megaman1966: checks 
Mmago24: checks 
*** RIVER *** [3h 9c Js 4d] [2s]
megaman1966: checks 
Mmago24: checks 
*** SHOW DOWN ***
megaman1966: shows [Kd 8h] (high card King)
Mmago24: shows [Ad 4s] (a pair of Fours)
Mmago24 collected $0.95 from pot
*** SUMMARY ***
Total pot $1 | Rake $0.05 
Board [3h 9c Js 4d 2s]
Seat 2: AlexEliseev7 folded before Flop (didn't bet)
Seat 3: Lemmi846 (button) folded before Flop (didn't bet)
Seat 4: megaman1966 (small blind) showed [Kd 8h] and lost with high card King
Seat 5: Mmago24 (big blind) showed [Ad 4s] and won ($0.95) with a pair of Fours
Seat 7: Pachebrash folded before Flop (didn't bet)
Seat 8: La Ghir folded before Flop (didn't bet)
Seat 9: siskin vrach folded before Flop (didn't bet)



PokerStars Hand #228684531736:  Hold'em No Limit ($0.25/$0.50 USD) - 2021/07/30 13:59:21 ET
Table 'Aitne III' 9-max Seat #4 is the button
Seat 2: AlexEliseev7 ($51 in chips) 
Seat 3: Lemmi846 ($50.69 in chips) 
Seat 4: megaman1966 ($12.53 in chips) 
Seat 5: Mmago24 ($110.14 in chips) 
Seat 7: Pachebrash ($58.28 in chips) 
Seat 8: La Ghir ($54.18 in chips) 
Seat 9: siskin vrach ($61.78 in chips) 
Mmago24: posts small blind $0.25
Pachebrash: posts big blind $0.50
whitecillar3: sits out 
*** HOLE CARDS ***
La Ghir: raises $1 to $1.50
siskin vrach: folds 
AlexEliseev7: folds 
Lemmi846: folds 
megaman1966: folds 
Mmago24: folds 
Pachebrash: folds 
Uncalled bet ($1) returned to La Ghir
La Ghir collected $1.25 from pot
La Ghir: doesn't show hand 
*** SUMMARY ***
Total pot $1.25 | Rake $0 
Seat 2: AlexEliseev7 folded before Flop (didn't bet)
Seat 3: Lemmi846 folded before Flop (didn't bet)
Seat 4: megaman1966 (button) folded before Flop (didn't bet)
Seat 5: Mmago24 (small blind) folded before Flop
Seat 7: Pachebrash (big blind) folded before Flop
Seat 8: La Ghir collected ($1.25)
Seat 9: siskin vrach folded before Flop (didn't bet)



PokerStars Hand #228684536990:  Hold'em No Limit ($0.25/$0.50 USD) - 2021/07/30 13:59:39 ET
Table 'Aitne III' 9-max Seat #5 is the button
Seat 2: AlexEliseev7 ($51 in chips) 
Seat 3: Lemmi846 ($50.69 in chips) 
Seat 4: megaman1966 ($12.53 in chips) 
Seat 5: Mmago24 ($109.89 in chips) 
Seat 7: Pachebrash ($57.78 in chips) 
Seat 8: La Ghir ($54.93 in chips) 
Seat 9: siskin vrach ($61.78 in chips) 
Pachebrash: posts small blind $0.25
La Ghir: posts big blind $0.50
whitecillar3: sits out 
*** HOLE CARDS ***
siskin vrach: folds 
AlexEliseev7: folds 
Lemmi846: raises $1 to $1.50
megaman1966: folds 
Mmago24: folds 
Pachebrash: folds 
La Ghir: folds 
Uncalled bet ($1) returned to Lemmi846
Lemmi846 collected $1.25 from pot
Lemmi846: doesn't show hand 
*** SUMMARY ***
Total pot $1.25 | Rake $0 
Seat 2: AlexEliseev7 folded before Flop (didn't bet)
Seat 3: Lemmi846 collected ($1.25)
Seat 4: megaman1966 folded before Flop (didn't bet)
Seat 5: Mmago24 (button) folded before Flop (didn't bet)
Seat 7: Pachebrash (small blind) folded before Flop
Seat 8: La Ghir (big blind) folded before Flop
Seat 9: siskin vrach folded before Flop (didn't bet)



PokerStars Hand #228684544561:  Hold'em No Limit ($0.25/$0.50 USD) - 2021/07/30 13:59:59 ET
Table 'Aitne III' 9-max Seat #7 is the button
Seat 2: AlexEliseev7 ($51 in chips) 
Seat 3: Lemmi846 ($51.44 in chips) 
Seat 4: megaman1966 ($12.53 in chips) 
Seat 5: Mmago24 ($109.89 in chips) 
Seat 6: Kahmi3105 ($81.06 in chips) 
Seat 7: Pachebrash ($57.53 in chips) 
Seat 8: La Ghir ($54.43 in chips) 
Seat 9: siskin vrach ($61.78 in chips) 
La Ghir: posts small blind $0.25
siskin vrach: posts big blind $0.50
whitecillar3: sits out 
Kahmi3105: posts small & big blinds $0.75
*** HOLE CARDS ***
AlexEliseev7: folds 
Lemmi846: folds 
megaman1966: raises $0.50 to $1
Mmago24: folds 
Kahmi3105: calls $0.50
Pachebrash: folds 
La Ghir: folds 
siskin vrach: calls $0.50
*** FLOP *** [2h 7h 4d]
siskin vrach: checks 
megaman1966: bets $1.66
Kahmi3105: folds 
siskin vrach: folds 
Uncalled bet ($1.66) returned to megaman1966
megaman1966 collected $3.28 from pot
megaman1966: doesn't show hand 
*** SUMMARY ***
Total pot $3.50 | Rake $0.22 
Board [2h 7h 4d]
Seat 2: AlexEliseev7 folded before Flop (didn't bet)
Seat 3: Lemmi846 folded before Flop (didn't bet)
Seat 4: megaman1966 collected ($3.28)
Seat 5: Mmago24 folded before Flop (didn't bet)
Seat 6: Kahmi3105 folded on the Flop
Seat 7: Pachebrash (button) folded before Flop (didn't bet)
Seat 8: La Ghir (small blind) folded before Flop
Seat 9: siskin vrach (big blind) folded on the Flop



PokerStars Hand #228684556346:  Hold'em No Limit ($0.25/$0.50 USD) - 2021/07/30 14:00:35 ET
Table 'Aitne III' 9-max Seat #8 is the button
Seat 1: whitecillar3 ($50 in chips) 
Seat 2: AlexEliseev7 ($51 in chips) 
Seat 3: Lemmi846 ($51.44 in chips) 
Seat 4: megaman1966 ($14.81 in chips) 
Seat 5: Mmago24 ($109.89 in chips) 
Seat 6: Kahmi3105 ($79.81 in chips) 
Seat 7: Pachebrash ($57.53 in chips) 
Seat 8: La Ghir ($54.18 in chips) 
Seat 9: siskin vrach ($60.78 in chips) 
siskin vrach: posts small blind $0.25
whitecillar3: posts big blind $0.50
*** HOLE CARDS ***
AlexEliseev7: folds 
Lemmi846: folds 
megaman1966: calls $0.50
Mmago24: folds 
Kahmi3105: folds 
Pachebrash: raises $1.50 to $2
La Ghir: folds 
siskin vrach: folds 
whitecillar3: calls $1.50
megaman1966: calls $1.50
*** FLOP *** [Qs 4d 2c]
whitecillar3: checks 
megaman1966: checks 
Pachebrash: bets $2.50
whitecillar3: folds 
megaman1966: folds 
Uncalled bet ($2.50) returned to Pachebrash
Pachebrash collected $5.94 from pot
Pachebrash: doesn't show hand 
*** SUMMARY ***
Total pot $6.25 | Rake $0.31 
Board [Qs 4d 2c]
Seat 1: whitecillar3 (big blind) folded on the Flop
Seat 2: AlexEliseev7 folded before Flop (didn't bet)
Seat 3: Lemmi846 folded before Flop (didn't bet)
Seat 4: megaman1966 folded on the Flop
Seat 5: Mmago24 folded before Flop (didn't bet)
Seat 6: Kahmi3105 folded before Flop (didn't bet)
Seat 7: Pachebrash collected ($5.94)
Seat 8: La Ghir (button) folded before Flop (didn't bet)
Seat 9: siskin vrach (small blind) folded before Flop



PokerStars Hand #228684570822:  Hold'em No Limit ($0.25/$0.50 USD) - 2021/07/30 14:01:16 ET
Table 'Aitne III' 9-max Seat #9 is the button
Seat 1: whitecillar3 ($48 in chips) 
Seat 3: Lemmi846 ($51.44 in chips) 
Seat 4: megaman1966 ($12.81 in chips) 
Seat 5: Mmago24 ($109.89 in chips) 
Seat 6: Kahmi3105 ($79.81 in chips) 
Seat 7: Pachebrash ($61.47 in chips) 
Seat 8: La Ghir ($54.18 in chips) 
Seat 9: siskin vrach ($60.53 in chips) 
whitecillar3: posts small blind $0.25
AlexEliseev7: is sitting out 
Lemmi846: posts big blind $0.50
*** HOLE CARDS ***
megaman1966: folds 
AlexEliseev7 leaves the table
Mmago24: folds 
Kahmi3105: calls $0.50
Pachebrash: folds 
La Ghir: raises $1.75 to $2.25
siskin vrach: folds 
whitecillar3: folds 
Lemmi846: folds 
Kahmi3105: calls $1.75
*** FLOP *** [9s 5c 7c]
Kahmi3105: checks 
La Ghir: bets $3.49
Kahmi3105: folds 
Uncalled bet ($3.49) returned to La Ghir
La Ghir collected $4.99 from pot
La Ghir: doesn't show hand 
*** SUMMARY ***
Total pot $5.25 | Rake $0.26 
Board [9s 5c 7c]
Seat 1: whitecillar3 (small blind) folded before Flop
Seat 3: Lemmi846 (big blind) folded before Flop
Seat 4: megaman1966 folded before Flop (didn't bet)
Seat 5: Mmago24 folded before Flop (didn't bet)
Seat 6: Kahmi3105 folded on the Flop
Seat 7: Pachebrash folded before Flop (didn't bet)
Seat 8: La Ghir collected ($4.99)
Seat 9: siskin vrach (button) folded before Flop (didn't bet)



PokerStars Hand #228684581939:  Hold'em No Limit ($0.25/$0.50 USD) - 2021/07/30 14:01:45 ET
Table 'Aitne III' 9-max Seat #1 is the button
Seat 1: whitecillar3 ($47.75 in chips) 
Seat 3: Lemmi846 ($50.94 in chips) 
Seat 4: megaman1966 ($12.81 in chips) 
Seat 5: Mmago24 ($109.89 in chips) 
Seat 6: Kahmi3105 ($77.56 in chips) 
Seat 7: Pachebrash ($61.47 in chips) 
Seat 8: La Ghir ($56.92 in chips) 
Seat 9: siskin vrach ($60.53 in chips) 
Lemmi846: posts small blind $0.25
megaman1966: posts big blind $0.50
*** HOLE CARDS ***
Mmago24: folds 
Kahmi3105: folds 
Pachebrash: folds 
La Ghir: folds 
siskin vrach: folds 
whitecillar3: folds 
Lemmi846: folds 
Uncalled bet ($0.25) returned to megaman1966
megaman1966 collected $0.50 from pot
megaman1966: doesn't show hand 
*** SUMMARY ***
Total pot $0.50 | Rake $0 
Seat 1: whitecillar3 (button) folded before Flop (didn't bet)
Seat 3: Lemmi846 (small blind) folded before Flop
Seat 4: megaman1966 (big blind) collected ($0.50)
Seat 5: Mmago24 folded before Flop (didn't bet)
Seat 6: Kahmi3105 folded before Flop (didn't bet)
Seat 7: Pachebrash folded before Flop (didn't bet)
Seat 8: La Ghir folded before Flop (didn't bet)
Seat 9: siskin vrach folded before Flop (didn't bet)



PokerStars Hand #228684586774:  Hold'em No Limit ($0.25/$0.50 USD) - 2021/07/30 14:01:57 ET
Table 'Aitne III' 9-max Seat #3 is the button
Seat 1: whitecillar3 ($47.75 in chips) 
Seat 3: Lemmi846 ($50.69 in chips) 
Seat 4: megaman1966 ($13.06 in chips) 
Seat 5: Mmago24 ($109.89 in chips) 
Seat 6: Kahmi3105 ($77.56 in chips) 
Seat 7: Pachebrash ($61.47 in chips) 
Seat 8: La Ghir ($56.92 in chips) 
Seat 9: siskin vrach ($60.53 in chips) 
megaman1966: posts small blind $0.25
Mmago24: posts big blind $0.50
*** HOLE CARDS ***
Kahmi3105 has timed out
Kahmi3105: folds 
Pachebrash: raises $1 to $1.50
La Ghir: folds 
siskin vrach: folds 
whitecillar3: folds 
Lemmi846: calls $1.50
megaman1966: folds 
Mmago24: folds 
*** FLOP *** [9s Ac Qc]
Pachebrash: bets $2.35
Kaban7502 joins the table at seat #2 
Lemmi846: folds 
Uncalled bet ($2.35) returned to Pachebrash
Pachebrash collected $3.56 from pot
Pachebrash: doesn't show hand 
*** SUMMARY ***
Total pot $3.75 | Rake $0.19 
Board [9s Ac Qc]
Seat 1: whitecillar3 folded before Flop (didn't bet)
Seat 3: Lemmi846 (button) folded on the Flop
Seat 4: megaman1966 (small blind) folded before Flop
Seat 5: Mmago24 (big blind) folded before Flop
Seat 6: Kahmi3105 folded before Flop (didn't bet)
Seat 7: Pachebrash collected ($3.56)
Seat 8: La Ghir folded before Flop (didn't bet)
Seat 9: siskin vrach folded before Flop (didn't bet)



PokerStars Hand #228684602749:  Hold'em No Limit ($0.25/$0.50 USD) - 2021/07/30 14:02:36 ET
Table 'Aitne III' 9-max Seat #4 is the button
Seat 1: whitecillar3 ($47.75 in chips) 
Seat 2: Kaban7502 ($50 in chips) 
Seat 3: Lemmi846 ($50 in chips) 
Seat 4: megaman1966 ($12.81 in chips) 
Seat 5: Mmago24 ($109.39 in chips) 
Seat 6: Kahmi3105 ($77.56 in chips) 
Seat 7: Pachebrash ($63.53 in chips) 
Seat 8: La Ghir ($56.92 in chips) 
Seat 9: siskin vrach ($60.53 in chips) 
Mmago24: posts small blind $0.25
Kahmi3105: posts big blind $0.50
Kaban7502: posts big blind $0.50
*** HOLE CARDS ***
Pachebrash: folds 
La Ghir: folds 
siskin vrach: raises $1.50 to $2
whitecillar3: folds 
Kaban7502: folds 
Lemmi846: folds 
megaman1966: folds 
Mmago24: folds 
Kahmi3105: calls $1.50
*** FLOP *** [8c Ks Jh]
Kahmi3105: checks 
siskin vrach: checks 
*** TURN *** [8c Ks Jh] [8d]
Kahmi3105: bets $3
siskin vrach: folds 
Uncalled bet ($3) returned to Kahmi3105
Kahmi3105 collected $4.45 from pot
*** SUMMARY ***
Total pot $4.75 | Rake $0.30 
Board [8c Ks Jh 8d]
Seat 1: whitecillar3 folded before Flop (didn't bet)
Seat 2: Kaban7502 folded before Flop (didn't bet)
Seat 3: Lemmi846 folded before Flop (didn't bet)
Seat 4: megaman1966 (button) folded before Flop (didn't bet)
Seat 5: Mmago24 (small blind) folded before Flop
Seat 6: Kahmi3105 (big blind) collected ($4.45)
Seat 7: Pachebrash folded before Flop (didn't bet)
Seat 8: La Ghir folded before Flop (didn't bet)
Seat 9: siskin vrach folded on the Turn



PokerStars Hand #228684617596:  Hold'em No Limit ($0.25/$0.50 USD) - 2021/07/30 14:03:11 ET
Table 'Aitne III' 9-max Seat #5 is the button
Seat 1: whitecillar3 ($47.75 in chips) 
Seat 2: Kaban7502 ($49.50 in chips) 
Seat 3: Lemmi846 ($50 in chips) 
Seat 4: megaman1966 ($12.81 in chips) 
Seat 5: Mmago24 ($109.14 in chips) 
Seat 6: Kahmi3105 ($80.01 in chips) 
Seat 7: Pachebrash ($63.53 in chips) 
Seat 8: La Ghir ($56.92 in chips) 
Seat 9: siskin vrach ($58.53 in chips) 
Kahmi3105: posts small blind $0.25
Pachebrash: posts big blind $0.50
*** HOLE CARDS ***
La Ghir: folds 
siskin vrach: folds 
whitecillar3: folds 
Kaban7502: folds 
Lemmi846: folds 
megaman1966: folds 
Mmago24: folds 
Kahmi3105: folds 
Uncalled bet ($0.25) returned to Pachebrash
Pachebrash collected $0.50 from pot
Pachebrash: doesn't show hand 
*** SUMMARY ***
Total pot $0.50 | Rake $0 
Seat 1: whitecillar3 folded before Flop (didn't bet)
Seat 2: Kaban7502 folded before Flop (didn't bet)
Seat 3: Lemmi846 folded before Flop (didn't bet)
Seat 4: megaman1966 folded before Flop (didn't bet)
Seat 5: Mmago24 (button) folded before Flop (didn't bet)
Seat 6: Kahmi3105 (small blind) folded before Flop
Seat 7: Pachebrash (big blind) collected ($0.50)
Seat 8: La Ghir folded before Flop (didn't bet)
Seat 9: siskin vrach folded before Flop (didn't bet)



PokerStars Hand #228684625888:  Hold'em No Limit ($0.25/$0.50 USD) - 2021/07/30 14:03:30 ET
Table 'Aitne III' 9-max Seat #6 is the button
Seat 1: whitecillar3 ($47.75 in chips) 
Seat 2: Kaban7502 ($49.50 in chips) 
Seat 3: Lemmi846 ($50 in chips) 
Seat 4: megaman1966 ($12.81 in chips) 
Seat 5: Mmago24 ($109.14 in chips) 
Seat 6: Kahmi3105 ($79.76 in chips) 
Seat 7: Pachebrash ($63.78 in chips) 
Seat 8: La Ghir ($56.92 in chips) 
Seat 9: siskin vrach ($58.53 in chips) 
Pachebrash: posts small blind $0.25
La Ghir: posts big blind $0.50
*** HOLE CARDS ***
siskin vrach: folds 
whitecillar3: folds 
Kaban7502: folds 
Lemmi846: folds 
megaman1966: raises $0.50 to $1
Mmago24: calls $1
Kahmi3105: calls $1
Pachebrash: folds 
La Ghir: calls $0.50
*** FLOP *** [Jh 4h Ac]
La Ghir: checks 
megaman1966: bets $2.02
Mmago24: calls $2.02
Kahmi3105: raises $5.05 to $7.07
La Ghir: folds 
megaman1966: calls $5.05
Mmago24: folds 
*** TURN *** [Jh 4h Ac] [4s]
megaman1966: checks 
Kahmi3105: bets $6
megaman1966: calls $4.74 and is all-in
Uncalled bet ($1.26) returned to Kahmi3105
*** RIVER *** [Jh 4h Ac 4s] [Tc]
*** SHOW DOWN ***
megaman1966: shows [Kh Kc] (two pair, Kings and Fours)
Kahmi3105: shows [4c As] (a full house, Fours full of Aces)
Kahmi3105 collected $28.03 from pot
*** SUMMARY ***
Total pot $29.89 | Rake $1.86 
Board [Jh 4h Ac 4s Tc]
Seat 1: whitecillar3 folded before Flop (didn't bet)
Seat 2: Kaban7502 folded before Flop (didn't bet)
Seat 3: Lemmi846 folded before Flop (didn't bet)
Seat 4: megaman1966 showed [Kh Kc] and lost with two pair, Kings and Fours
Seat 5: Mmago24 folded on the Flop
Seat 6: Kahmi3105 (button) showed [4c As] and won ($28.03) with a full house, Fours full of Aces
Seat 7: Pachebrash (small blind) folded before Flop
Seat 8: La Ghir (big blind) folded on the Flop
Seat 9: siskin vrach folded before Flop (didn't bet)



PokerStars Hand #228684646262:  Hold'em No Limit ($0.25/$0.50 USD) - 2021/07/30 14:04:19 ET
Table 'Aitne III' 9-max Seat #7 is the button
Seat 1: whitecillar3 ($47.75 in chips) 
Seat 2: Kaban7502 ($49.50 in chips) 
Seat 3: Lemmi846 ($50 in chips) 
Seat 5: Mmago24 ($106.12 in chips) 
Seat 6: Kahmi3105 ($94.98 in chips) 
Seat 7: Pachebrash ($63.53 in chips) 
Seat 8: La Ghir ($55.92 in chips) 
Seat 9: siskin vrach ($58.53 in chips) 
La Ghir: posts small blind $0.25
siskin vrach: posts big blind $0.50
*** HOLE CARDS ***
whitecillar3: folds 
Kaban7502: folds 
megaman1966 leaves the table
Lemmi846: raises $0.50 to $1
Mmago24: folds 
Kahmi3105: folds 
Pachebrash: folds 
La Ghir: folds 
siskin vrach: calls $0.50
*** FLOP *** [8h Jh 2s]
siskin vrach: checks 
Lemmi846: checks 
*** TURN *** [8h Jh 2s] [3d]
siskin vrach: checks 
Lemmi846: checks 
*** RIVER *** [8h Jh 2s 3d] [9d]
siskin vrach: checks 
Lemmi846: checks 
*** SHOW DOWN ***
siskin vrach: shows [As 5h] (high card Ace)
Lemmi846: shows [Ad Th] (high card Ace - Jack+Ten kicker)
Lemmi846 collected $2.11 from pot
*** SUMMARY ***
Total pot $2.25 | Rake $0.14 
Board [8h Jh 2s 3d 9d]
Seat 1: whitecillar3 folded before Flop (didn't bet)
Seat 2: Kaban7502 folded before Flop (didn't bet)
Seat 3: Lemmi846 showed [Ad Th] and won ($2.11) with high card Ace
Seat 5: Mmago24 folded before Flop (didn't bet)
Seat 6: Kahmi3105 folded before Flop (didn't bet)
Seat 7: Pachebrash (button) folded before Flop (didn't bet)
Seat 8: La Ghir (small blind) folded before Flop
Seat 9: siskin vrach (big blind) showed [As 5h] and lost with high card Ace



PokerStars Hand #228684667731:  Hold'em No Limit ($0.25/$0.50 USD) - 2021/07/30 14:05:10 ET
Table 'Aitne III' 9-max Seat #8 is the button
Seat 1: whitecillar3 ($47.75 in chips) 
Seat 2: Kaban7502 ($49.50 in chips) 
Seat 3: Lemmi846 ($51.11 in chips) 
Seat 5: Mmago24 ($106.12 in chips) 
Seat 6: Kahmi3105 ($94.98 in chips) 
Seat 7: Pachebrash ($63.53 in chips) 
Seat 8: La Ghir ($55.67 in chips) 
Seat 9: siskin vrach ($57.53 in chips) 
siskin vrach: posts small blind $0.25
whitecillar3: posts big blind $0.50
*** HOLE CARDS ***
Kaban7502: folds 
Lemmi846: calls $0.50
Mmago24: folds 
Kahmi3105: raises $1.75 to $2.25
Pachebrash: calls $2.25
La Ghir: folds 
Rulet345 joins the table at seat #4 
siskin vrach: folds 
whitecillar3: folds 
Lemmi846: folds 
*** FLOP *** [7c Js 7s]
Kahmi3105: checks 
Pachebrash: checks 
*** TURN *** [7c Js 7s] [8c]
Kahmi3105: checks 
Pachebrash: bets $1.86
Kahmi3105: calls $1.86
*** RIVER *** [7c Js 7s 8c] [9c]
Kahmi3105: checks 
Pachebrash: checks 
*** SHOW DOWN ***
Kahmi3105: shows [Kd Qc] (a pair of Sevens)
Pachebrash: shows [6s 6d] (two pair, Sevens and Sixes)
Pachebrash collected $9 from pot
*** SUMMARY ***
Total pot $9.47 | Rake $0.47 
Board [7c Js 7s 8c 9c]
Seat 1: whitecillar3 (big blind) folded before Flop
Seat 2: Kaban7502 folded before Flop (didn't bet)
Seat 3: Lemmi846 folded before Flop
Seat 5: Mmago24 folded before Flop (didn't bet)
Seat 6: Kahmi3105 showed [Kd Qc] and lost with a pair of Sevens
Seat 7: Pachebrash showed [6s 6d] and won ($9) with two pair, Sevens and Sixes
Seat 8: La Ghir (button) folded before Flop (didn't bet)
Seat 9: siskin vrach (small blind) folded before Flop



PokerStars Hand #228684689233:  Hold'em No Limit ($0.25/$0.50 USD) - 2021/07/30 14:06:00 ET
Table 'Aitne III' 9-max Seat #9 is the button
Seat 1: whitecillar3 ($47.25 in chips) 
Seat 2: Kaban7502 ($49.50 in chips) 
Seat 3: Lemmi846 ($50.61 in chips) 
Seat 5: Mmago24 ($106.12 in chips) 
Seat 6: Kahmi3105 ($90.87 in chips) 
Seat 7: Pachebrash ($68.42 in chips) 
Seat 8: La Ghir ($55.67 in chips) 
Seat 9: siskin vrach ($57.28 in chips) 
whitecillar3: posts small blind $0.25
Kaban7502: posts big blind $0.50
Rulet345: sits out 
*** HOLE CARDS ***
Lemmi846: folds 
Mmago24: folds 
Kahmi3105: folds 
Pachebrash: folds 
La Ghir: folds 
siskin vrach: folds 
whitecillar3: raises $0.75 to $1.25
Kaban7502: folds 
Uncalled bet ($0.75) returned to whitecillar3
whitecillar3 collected $1 from pot
*** SUMMARY ***
Total pot $1 | Rake $0 
Seat 1: whitecillar3 (small blind) collected ($1)
Seat 2: Kaban7502 (big blind) folded before Flop
Seat 3: Lemmi846 folded before Flop (didn't bet)
Seat 5: Mmago24 folded before Flop (didn't bet)
Seat 6: Kahmi3105 folded before Flop (didn't bet)
Seat 7: Pachebrash folded before Flop (didn't bet)
Seat 8: La Ghir folded before Flop (didn't bet)
Seat 9: siskin vrach (button) folded before Flop (didn't bet)



PokerStars Hand #228684699639:  Hold'em No Limit ($0.25/$0.50 USD) - 2021/07/30 14:06:24 ET
Table 'Aitne III' 9-max Seat #1 is the button
Seat 1: whitecillar3 ($47.75 in chips) 
Seat 2: Kaban7502 ($49 in chips) 
Seat 3: Lemmi846 ($50.61 in chips) 
Seat 5: Mmago24 ($106.12 in chips) 
Seat 6: Kahmi3105 ($90.87 in chips) 
Seat 7: Pachebrash ($68.42 in chips) 
Seat 8: La Ghir ($55.67 in chips) 
Seat 9: siskin vrach ($57.28 in chips) 
Kaban7502: posts small blind $0.25
Lemmi846: posts big blind $0.50
Rulet345: sits out 
*** HOLE CARDS ***
Mmago24: folds 
Kahmi3105: folds 
Pachebrash: folds 
La Ghir: folds 
siskin vrach: folds 
whitecillar3: raises $0.75 to $1.25
Kaban7502: folds 
Lemmi846: folds 
Uncalled bet ($0.75) returned to whitecillar3
whitecillar3 collected $1.25 from pot
*** SUMMARY ***
Total pot $1.25 | Rake $0 
Seat 1: whitecillar3 (button) collected ($1.25)
Seat 2: Kaban7502 (small blind) folded before Flop
Seat 3: Lemmi846 (big blind) folded before Flop
Seat 5: Mmago24 folded before Flop (didn't bet)
Seat 6: Kahmi3105 folded before Flop (didn't bet)
Seat 7: Pachebrash folded before Flop (didn't bet)
Seat 8: La Ghir folded before Flop (didn't bet)
Seat 9: siskin vrach folded before Flop (didn't bet)



PokerStars Hand #228684706371:  Hold'em No Limit ($0.25/$0.50 USD) - 2021/07/30 14:06:40 ET
Table 'Aitne III' 9-max Seat #2 is the button
Seat 1: whitecillar3 ($48.50 in chips) 
Seat 2: Kaban7502 ($48.75 in chips) 
Seat 3: Lemmi846 ($50.11 in chips) 
Seat 4: Rulet345 ($50 in chips) 
Seat 5: Mmago24 ($106.12 in chips) 
Seat 6: Kahmi3105 ($90.87 in chips) 
Seat 7: Pachebrash ($68.42 in chips) 
Seat 8: La Ghir ($55.67 in chips) 
Seat 9: siskin vrach ($57.28 in chips) 
Lemmi846: posts small blind $0.25
Rulet345: posts big blind $0.50
*** HOLE CARDS ***
Mmago24: folds 
Kahmi3105: calls $0.50
Pachebrash: folds 
La Ghir: folds 
siskin vrach: folds 
whitecillar3: raises $1.50 to $2
Kaban7502: folds 
Lemmi846: folds 
Rulet345: calls $1.50
Kahmi3105: calls $1.50
*** FLOP *** [7d 4c 2d]
Rulet345: checks 
Kahmi3105: checks 
whitecillar3: bets $4.51
Rulet345: calls $4.51
Kahmi3105: folds 
*** TURN *** [7d 4c 2d] [8d]
Rulet345: checks 
Mmago24 leaves the table
whitecillar3: checks 
*** RIVER *** [7d 4c 2d 8d] [Ks]
Rulet345: bets $10.88
whitecillar3: folds 
Uncalled bet ($10.88) returned to Rulet345
Rulet345 collected $14.51 from pot
Rulet345: doesn't show hand 
*** SUMMARY ***
Total pot $15.27 | Rake $0.76 
Board [7d 4c 2d 8d Ks]
Seat 1: whitecillar3 folded on the River
Seat 2: Kaban7502 (button) folded before Flop (didn't bet)
Seat 3: Lemmi846 (small blind) folded before Flop
Seat 4: Rulet345 (big blind) collected ($14.51)
Seat 5: Mmago24 folded before Flop (didn't bet)
Seat 6: Kahmi3105 folded on the Flop
Seat 7: Pachebrash folded before Flop (didn't bet)
Seat 8: La Ghir folded before Flop (didn't bet)
Seat 9: siskin vrach folded before Flop (didn't bet)



PokerStars Hand #228684755673:  Hold'em No Limit ($0.25/$0.50 USD) - 2021/07/30 14:08:36 ET
Table 'Aitne III' 9-max Seat #3 is the button
Seat 1: whitecillar3 ($41.99 in chips) 
Seat 2: Kaban7502 ($48.75 in chips) 
Seat 3: Lemmi846 ($50 in chips) 
Seat 4: Rulet345 ($58 in chips) 
Seat 6: Kahmi3105 ($88.87 in chips) 
Seat 7: Pachebrash ($68.42 in chips) 
Seat 8: La Ghir ($55.67 in chips) 
Seat 9: siskin vrach ($57.28 in chips) 
Rulet345: posts small blind $0.25
Kahmi3105: posts big blind $0.50
*** HOLE CARDS ***
Pachebrash: folds 
La Ghir: folds 
siskin vrach: raises $1 to $1.50
whitecillar3: folds 
Kaban7502: folds 
Lemmi846: folds 
Rulet345: folds 
Kahmi3105: calls $1
*** FLOP *** [Kd Th 9d]
Kahmi3105: checks 
DOA1980 joins the table at seat #5 
siskin vrach: checks 
*** TURN *** [Kd Th 9d] [8d]
Kahmi3105: checks 
siskin vrach: checks 
*** RIVER *** [Kd Th 9d 8d] [4h]
Kahmi3105: checks 
siskin vrach: bets $1
Kahmi3105: calls $1
*** SHOW DOWN ***
siskin vrach: shows [9c 7c] (a pair of Nines)
Kahmi3105: mucks hand 
siskin vrach collected $4.99 from pot
*** SUMMARY ***
Total pot $5.25 | Rake $0.26 
Board [Kd Th 9d 8d 4h]
Seat 1: whitecillar3 folded before Flop (didn't bet)
Seat 2: Kaban7502 folded before Flop (didn't bet)
Seat 3: Lemmi846 (button) folded before Flop (didn't bet)
Seat 4: Rulet345 (small blind) folded before Flop
Seat 6: Kahmi3105 (big blind) mucked
Seat 7: Pachebrash folded before Flop (didn't bet)
Seat 8: La Ghir folded before Flop (didn't bet)
Seat 9: siskin vrach showed [9c 7c] and won ($4.99) with a pair of Nines



PokerStars Hand #228684775818:  Hold'em No Limit ($0.25/$0.50 USD) - 2021/07/30 14:09:15 ET
Table 'Aitne III' 9-max Seat #4 is the button
Seat 1: whitecillar3 ($41.99 in chips) 
Seat 2: Kaban7502 ($48.75 in chips) 
Seat 3: Lemmi846 ($50 in chips) 
Seat 4: Rulet345 ($57.75 in chips) 
Seat 6: Kahmi3105 ($86.37 in chips) 
Seat 7: Pachebrash ($68.42 in chips) 
Seat 8: La Ghir ($55.67 in chips) 
Seat 9: siskin vrach ($59.77 in chips) 
Kahmi3105: posts small blind $0.25
Pachebrash: posts big blind $0.50
*** HOLE CARDS ***
La Ghir: folds 
siskin vrach: raises $1 to $1.50
whitecillar3: folds 
Kaban7502: folds 
Lemmi846: folds 
Rulet345: folds 
Kahmi3105: calls $1.25
Pachebrash: raises $5.50 to $7
siskin vrach: calls $5.50
Kahmi3105: folds 
*** FLOP *** [4h 3h 2s]
Pachebrash: bets $5
siskin vrach: calls $5
*** TURN *** [4h 3h 2s] [5c]
Pachebrash: checks 
siskin vrach: checks 
*** RIVER *** [4h 3h 2s 5c] [8c]
Pachebrash: checks 
siskin vrach: checks 
*** SHOW DOWN ***
Pachebrash: shows [As Ah] (a straight, Ace to Five)
siskin vrach: mucks hand 
Pachebrash collected $24.22 from pot
*** SUMMARY ***
Total pot $25.50 | Rake $1.28 
Board [4h 3h 2s 5c 8c]
Seat 1: whitecillar3 folded before Flop (didn't bet)
Seat 2: Kaban7502 folded before Flop (didn't bet)
Seat 3: Lemmi846 folded before Flop (didn't bet)
Seat 4: Rulet345 (button) folded before Flop (didn't bet)
Seat 6: Kahmi3105 (small blind) folded before Flop
Seat 7: Pachebrash (big blind) showed [As Ah] and won ($24.22) with a straight, Ace to Five
Seat 8: La Ghir folded before Flop (didn't bet)
Seat 9: siskin vrach mucked



PokerStars Hand #228684810654:  Hold'em No Limit ($0.25/$0.50 USD) - 2021/07/30 14:10:36 ET
Table 'Aitne III' 9-max Seat #6 is the button
Seat 1: whitecillar3 ($41.99 in chips) 
Seat 2: Kaban7502 ($48.75 in chips) 
Seat 3: Lemmi846 ($50 in chips) 
Seat 4: Rulet345 ($57.75 in chips) 
Seat 6: Kahmi3105 ($84.87 in chips) 
Seat 7: Pachebrash ($80.64 in chips) 
Seat 8: La Ghir ($55.67 in chips) 
Seat 9: siskin vrach ($50 in chips) 
Pachebrash: posts small blind $0.25
La Ghir: posts big blind $0.50
DOA1980: sits out 
*** HOLE CARDS ***
siskin vrach: folds 
whitecillar3: folds 
Kaban7502: raises $0.50 to $1
Lemmi846: folds 
Rulet345: folds 
Kahmi3105: calls $1
Pachebrash: folds 
La Ghir: calls $0.50
*** FLOP *** [Qs 7d As]
La Ghir: checks 
Kaban7502: checks 
Kahmi3105: checks 
*** TURN *** [Qs 7d As] [6d]
La Ghir: checks 
Kaban7502: checks 
Kahmi3105: bets $4
La Ghir: folds 
Kaban7502: folds 
Uncalled bet ($4) returned to Kahmi3105
Kahmi3105 collected $3.05 from pot
*** SUMMARY ***
Total pot $3.25 | Rake $0.20 
Board [Qs 7d As 6d]
Seat 1: whitecillar3 folded before Flop (didn't bet)
Seat 2: Kaban7502 folded on the Turn
Seat 3: Lemmi846 folded before Flop (didn't bet)
Seat 4: Rulet345 folded before Flop (didn't bet)
Seat 6: Kahmi3105 (button) collected ($3.05)
Seat 7: Pachebrash (small blind) folded before Flop
Seat 8: La Ghir (big blind) folded on the Turn
Seat 9: siskin vrach folded before Flop (didn't bet)



PokerStars Hand #228684840973:  Hold'em No Limit ($0.25/$0.50 USD) - 2021/07/30 14:11:47 ET
Table 'Aitne III' 9-max Seat #7 is the button
Seat 2: Kaban7502 ($47.75 in chips) 
Seat 3: Lemmi846 ($50 in chips) 
Seat 4: Rulet345 ($57.75 in chips) 
Seat 6: Kahmi3105 ($86.92 in chips) 
Seat 7: Pachebrash ($80.39 in chips) 
Seat 8: La Ghir ($54.67 in chips) 
Seat 9: siskin vrach ($50 in chips) 
La Ghir: posts small blind $0.25
siskin vrach: posts big blind $0.50
DOA1980: sits out 
*** HOLE CARDS ***
Kaban7502: raises $0.50 to $1
Lemmi846: folds 
Rulet345: raises $3 to $4
Kahmi3105: folds 
Pachebrash: folds 
La Ghir: folds 
siskin vrach: folds 
Kaban7502: calls $3
*** FLOP *** [8s Js Th]
Kaban7502: checks 
Rulet345: checks 
*** TURN *** [8s Js Th] [4c]
Kaban7502: bets $0.50
Rulet345: calls $0.50
*** RIVER *** [8s Js Th 4c] [3h]
Kaban7502: checks 
Rulet345: checks 
*** SHOW DOWN ***
Kaban7502: shows [9h 7h] (a straight, Seven to Jack)
Rulet345: mucks hand 
Kaban7502 collected $9.14 from pot
*** SUMMARY ***
Total pot $9.75 | Rake $0.61 
Board [8s Js Th 4c 3h]
Seat 2: Kaban7502 showed [9h 7h] and won ($9.14) with a straight, Seven to Jack
Seat 3: Lemmi846 folded before Flop (didn't bet)
Seat 4: Rulet345 mucked
Seat 6: Kahmi3105 folded before Flop (didn't bet)
Seat 7: Pachebrash (button) folded before Flop (didn't bet)
Seat 8: La Ghir (small blind) folded before Flop
Seat 9: siskin vrach (big blind) folded before Flop



PokerStars Hand #228684868122:  Hold'em No Limit ($0.25/$0.50 USD) - 2021/07/30 14:12:50 ET
Table 'Aitne III' 9-max Seat #8 is the button
Seat 1: whitecillar3 ($41.99 in chips) 
Seat 2: Kaban7502 ($52.39 in chips) 
Seat 3: Lemmi846 ($50 in chips) 
Seat 4: Rulet345 ($53.25 in chips) 
Seat 6: Kahmi3105 ($86.92 in chips) 
Seat 7: Pachebrash ($80.39 in chips) 
Seat 8: La Ghir ($54.42 in chips) 
Seat 9: siskin vrach ($50 in chips) 
siskin vrach: posts small blind $0.25
whitecillar3: posts big blind $0.50
DOA1980: sits out 
*** HOLE CARDS ***
Kaban7502: folds 
Lemmi846: folds 
Rulet345: folds 
Kahmi3105: folds 
Pachebrash: folds 
La Ghir: raises $0.50 to $1
siskin vrach: folds 
whitecillar3: calls $0.50
*** FLOP *** [Qd 5s Kh]
whitecillar3: checks 
La Ghir: bets $1.07
whitecillar3: raises $3.25 to $4.32
La Ghir: folds 
Uncalled bet ($3.25) returned to whitecillar3
whitecillar3 collected $4.17 from pot
*** SUMMARY ***
Total pot $4.39 | Rake $0.22 
Board [Qd 5s Kh]
Seat 1: whitecillar3 (big blind) collected ($4.17)
Seat 2: Kaban7502 folded before Flop (didn't bet)
Seat 3: Lemmi846 folded before Flop (didn't bet)
Seat 4: Rulet345 folded before Flop (didn't bet)
Seat 6: Kahmi3105 folded before Flop (didn't bet)
Seat 7: Pachebrash folded before Flop (didn't bet)
Seat 8: La Ghir (button) folded on the Flop
Seat 9: siskin vrach (small blind) folded before Flop



PokerStars Hand #228684893720:  Hold'em No Limit ($0.25/$0.50 USD) - 2021/07/30 14:13:30 ET
Table 'Aitne III' 9-max Seat #9 is the button
Seat 1: whitecillar3 ($44.09 in chips) 
Seat 2: Kaban7502 ($52.39 in chips) 
Seat 3: Lemmi846 ($50 in chips) 
Seat 4: Rulet345 ($53.25 in chips) 
Seat 6: Kahmi3105 ($86.92 in chips) 
Seat 7: Pachebrash ($80.39 in chips) 
Seat 8: La Ghir ($52.35 in chips) 
Seat 9: siskin vrach ($50 in chips) 
whitecillar3: posts small blind $0.25
Kaban7502: posts big blind $0.50
DOA1980: sits out 
*** HOLE CARDS ***
Lemmi846: folds 
Rulet345: folds 
Kahmi3105: raises $1.25 to $1.75
Pachebrash: folds 
La Ghir: folds 
siskin vrach: calls $1.75
whitecillar3: folds 
Kaban7502: folds 
*** FLOP *** [Jd Qs 6s]
Kahmi3105: bets $3
siskin vrach: calls $3
*** TURN *** [Jd Qs 6s] [Ad]
Kahmi3105: checks 
siskin vrach: bets $3.02
Kahmi3105: calls $3.02
*** RIVER *** [Jd Qs 6s Ad] [Kc]
Kahmi3105: bets $15.48
siskin vrach: calls $15.48
*** SHOW DOWN ***
Kahmi3105: shows [Qc Th] (a straight, Ten to Ace)
siskin vrach: mucks hand 
Kahmi3105 collected $44.75 from pot
*** SUMMARY ***
Total pot $47.25 | Rake $2.50 
Board [Jd Qs 6s Ad Kc]
Seat 1: whitecillar3 (small blind) folded before Flop
Seat 2: Kaban7502 (big blind) folded before Flop
Seat 3: Lemmi846 folded before Flop (didn't bet)
Seat 4: Rulet345 folded before Flop (didn't bet)
Seat 6: Kahmi3105 showed [Qc Th] and won ($44.75) with a straight, Ten to Ace
Seat 7: Pachebrash folded before Flop (didn't bet)
Seat 8: La Ghir folded before Flop (didn't bet)
Seat 9: siskin vrach (button) mucked



PokerStars Hand #228684911447:  Hold'em No Limit ($0.25/$0.50 USD) - 2021/07/30 14:14:12 ET
Table 'Aitne III' 9-max Seat #1 is the button
Seat 1: whitecillar3 ($43.84 in chips) 
Seat 2: Kaban7502 ($51.89 in chips) 
Seat 3: Lemmi846 ($50 in chips) 
Seat 4: Rulet345 ($53.25 in chips) 
Seat 6: Kahmi3105 ($108.42 in chips) 
Seat 7: Pachebrash ($80.39 in chips) 
Seat 8: La Ghir ($52.35 in chips) 
Seat 9: siskin vrach ($50 in chips) 
Kaban7502: posts small blind $0.25
Lemmi846: posts big blind $0.50
DOA1980: sits out 
*** HOLE CARDS ***
Rulet345: folds 
Kahmi3105: calls $0.50
Pachebrash: raises $1.50 to $2
La Ghir: folds 
siskin vrach: calls $2
whitecillar3: folds 
Kaban7502: folds 
Lemmi846: folds 
Kahmi3105: folds 
*** FLOP *** [8c Kh Ah]
Pachebrash: bets $2.54
siskin vrach: folds 
Uncalled bet ($2.54) returned to Pachebrash
Pachebrash collected $4.99 from pot
Pachebrash: doesn't show hand 
*** SUMMARY ***
Total pot $5.25 | Rake $0.26 
Board [8c Kh Ah]
Seat 1: whitecillar3 (button) folded before Flop (didn't bet)
Seat 2: Kaban7502 (small blind) folded before Flop
Seat 3: Lemmi846 (big blind) folded before Flop
Seat 4: Rulet345 folded before Flop (didn't bet)
Seat 6: Kahmi3105 folded before Flop
Seat 7: Pachebrash collected ($4.99)
Seat 8: La Ghir folded before Flop (didn't bet)
Seat 9: siskin vrach folded on the Flop



PokerStars Hand #228684930398:  Hold'em No Limit ($0.25/$0.50 USD) - 2021/07/30 14:14:57 ET
Table 'Aitne III' 9-max Seat #2 is the button
Seat 1: whitecillar3 ($43.84 in chips) 
Seat 2: Kaban7502 ($51.64 in chips) 
Seat 3: Lemmi846 ($50 in chips) 
Seat 5: DOA1980 ($50 in chips) 
Seat 6: Kahmi3105 ($107.92 in chips) 
Seat 7: Pachebrash ($83.38 in chips) 
Seat 8: La Ghir ($52.35 in chips) 
Seat 9: siskin vrach ($50 in chips) 
Lemmi846: posts small blind $0.25
Rulet345: is sitting out 
DOA1980: posts big blind $0.50
*** HOLE CARDS ***
Kahmi3105: folds 
Pachebrash: folds 
La Ghir: folds 
siskin vrach: folds 
whitecillar3: folds 
Kaban7502: folds 
Rulet345 leaves the table
Lemmi846: folds 
Uncalled bet ($0.25) returned to DOA1980
DOA1980 collected $0.50 from pot
DOA1980: doesn't show hand 
*** SUMMARY ***
Total pot $0.50 | Rake $0 
Seat 1: whitecillar3 folded before Flop (didn't bet)
Seat 2: Kaban7502 (button) folded before Flop (didn't bet)
Seat 3: Lemmi846 (small blind) folded before Flop
Seat 5: DOA1980 (big blind) collected ($0.50)
Seat 6: Kahmi3105 folded before Flop (didn't bet)
Seat 7: Pachebrash folded before Flop (didn't bet)
Seat 8: La Ghir folded before Flop (didn't bet)
Seat 9: siskin vrach folded before Flop (didn't bet)



PokerStars Hand #228684935677:  Hold'em No Limit ($0.25/$0.50 USD) - 2021/07/30 14:15:09 ET
Table 'Aitne III' 9-max Seat #3 is the button
Seat 1: whitecillar3 ($43.84 in chips) 
Seat 2: Kaban7502 ($51.64 in chips) 
Seat 3: Lemmi846 ($50 in chips) 
Seat 5: DOA1980 ($50.25 in chips) 
Seat 6: Kahmi3105 ($107.92 in chips) 
Seat 7: Pachebrash ($83.38 in chips) 
Seat 8: La Ghir ($52.35 in chips) 
Seat 9: siskin vrach ($50 in chips) 
DOA1980: posts small blind $0.25
Kahmi3105: posts big blind $0.50
*** HOLE CARDS ***
dikanmax joins the table at seat #4 
Pachebrash: raises $1 to $1.50
La Ghir: folds 
siskin vrach: folds 
whitecillar3: folds 
Kaban7502: folds 
Lemmi846: folds 
DOA1980: folds 
Kahmi3105: calls $1
*** FLOP *** [7c 2d 8s]
Kahmi3105: checks 
Pachebrash: checks 
*** TURN *** [7c 2d 8s] [6d]
Kahmi3105: checks 
Pachebrash: bets $1.05
Kahmi3105: calls $1.05
*** RIVER *** [7c 2d 8s 6d] [3s]
Kahmi3105: checks 
Pachebrash: checks 
*** SHOW DOWN ***
Kahmi3105: shows [9s Ac] (high card Ace)
Pachebrash: shows [Qs As] (high card Ace - Queen kicker)
Pachebrash collected $5.08 from pot
*** SUMMARY ***
Total pot $5.35 | Rake $0.27 
Board [7c 2d 8s 6d 3s]
Seat 1: whitecillar3 folded before Flop (didn't bet)
Seat 2: Kaban7502 folded before Flop (didn't bet)
Seat 3: Lemmi846 (button) folded before Flop (didn't bet)
Seat 5: DOA1980 (small blind) folded before Flop
Seat 6: Kahmi3105 (big blind) showed [9s Ac] and lost with high card Ace
Seat 7: Pachebrash showed [Qs As] and won ($5.08) with high card Ace
Seat 8: La Ghir folded before Flop (didn't bet)
Seat 9: siskin vrach folded before Flop (didn't bet)



PokerStars Hand #228684947461:  Hold'em No Limit ($0.25/$0.50 USD) - 2021/07/30 14:15:37 ET
Table 'Aitne III' 9-max Seat #5 is the button
Seat 1: whitecillar3 ($43.84 in chips) 
Seat 2: Kaban7502 ($51.64 in chips) 
Seat 3: Lemmi846 ($50 in chips) 
Seat 5: DOA1980 ($50 in chips) 
Seat 6: Kahmi3105 ($105.37 in chips) 
Seat 7: Pachebrash ($85.91 in chips) 
Seat 8: La Ghir ($52.35 in chips) 
Seat 9: siskin vrach ($50 in chips) 
Kahmi3105: posts small blind $0.25
Pachebrash: posts big blind $0.50
dikanmax: sits out 
*** HOLE CARDS ***
La Ghir: folds 
siskin vrach: folds 
whitecillar3: folds 
Kaban7502: folds 
Lemmi846: folds 
DOA1980: folds 
Kahmi3105: raises $1.50 to $2
Pachebrash: calls $1.50
*** FLOP *** [Tc 5d 7h]
Kahmi3105: bets $3.80
Pachebrash: folds 
Uncalled bet ($3.80) returned to Kahmi3105
Kahmi3105 collected $3.75 from pot
*** SUMMARY ***
Total pot $4 | Rake $0.25 
Board [Tc 5d 7h]
Seat 1: whitecillar3 folded before Flop (didn't bet)
Seat 2: Kaban7502 folded before Flop (didn't bet)
Seat 3: Lemmi846 folded before Flop (didn't bet)
Seat 5: DOA1980 (button) folded before Flop (didn't bet)
Seat 6: Kahmi3105 (small blind) collected ($3.75)
Seat 7: Pachebrash (big blind) folded on the Flop
Seat 8: La Ghir folded before Flop (didn't bet)
Seat 9: siskin vrach folded before Flop (didn't bet)



PokerStars Hand #228684959839:  Hold'em No Limit ($0.25/$0.50 USD) - 2021/07/30 14:16:06 ET
Table 'Aitne III' 9-max Seat #6 is the button
Seat 1: whitecillar3 ($43.84 in chips) 
Seat 2: Kaban7502 ($51.64 in chips) 
Seat 3: Lemmi846 ($50 in chips) 
Seat 5: DOA1980 ($50 in chips) 
Seat 6: Kahmi3105 ($107.12 in chips) 
Seat 7: Pachebrash ($83.91 in chips) 
Seat 8: La Ghir ($52.35 in chips) 
Seat 9: siskin vrach ($50 in chips) 
Pachebrash: posts small blind $0.25
La Ghir: posts big blind $0.50
dikanmax: sits out 
*** HOLE CARDS ***
siskin vrach: raises $1 to $1.50
whitecillar3: folds 
Kaban7502: folds 
Lemmi846: folds 
DOA1980: folds 
Kahmi3105: calls $1.50
Pachebrash: folds 
La Ghir: folds 
*** FLOP *** [4d Jd 3c]
siskin vrach: bets $2.85
Kahmi3105: folds 
Uncalled bet ($2.85) returned to siskin vrach
siskin vrach collected $3.56 from pot
*** SUMMARY ***
Total pot $3.75 | Rake $0.19 
Board [4d Jd 3c]
Seat 1: whitecillar3 folded before Flop (didn't bet)
Seat 2: Kaban7502 folded before Flop (didn't bet)
Seat 3: Lemmi846 folded before Flop (didn't bet)
Seat 5: DOA1980 folded before Flop (didn't bet)
Seat 6: Kahmi3105 (button) folded on the Flop
Seat 7: Pachebrash (small blind) folded before Flop
Seat 8: La Ghir (big blind) folded before Flop
Seat 9: siskin vrach collected ($3.56)



PokerStars Hand #228684974029:  Hold'em No Limit ($0.25/$0.50 USD) - 2021/07/30 14:16:39 ET
Table 'Aitne III' 9-max Seat #7 is the button
Seat 1: whitecillar3 ($43.84 in chips) 
Seat 2: Kaban7502 ($51.64 in chips) 
Seat 3: Lemmi846 ($50 in chips) 
Seat 5: DOA1980 ($50 in chips) 
Seat 6: Kahmi3105 ($105.62 in chips) 
Seat 7: Pachebrash ($83.66 in chips) 
Seat 8: La Ghir ($51.85 in chips) 
Seat 9: siskin vrach ($52.06 in chips) 
La Ghir: posts small blind $0.25
siskin vrach: posts big blind $0.50
dikanmax: sits out 
*** HOLE CARDS ***
whitecillar3: folds 
Kaban7502: raises $0.50 to $1
Lemmi846: folds 
DOA1980: folds 
Kahmi3105: calls $1
Pachebrash: folds 
La Ghir: calls $0.75
siskin vrach: calls $0.50
*** FLOP *** [Kc 3h Th]
La Ghir: checks 
siskin vrach: checks 
Kaban7502: checks 
Kahmi3105: bets $3.80
La Ghir: calls $3.80
siskin vrach: calls $3.80
Kaban7502: folds 
*** TURN *** [Kc 3h Th] [6s]
La Ghir: checks 
siskin vrach: checks 
Kahmi3105: bets $8.50
La Ghir: folds 
siskin vrach: calls $8.50
*** RIVER *** [Kc 3h Th 6s] [2c]
siskin vrach: checks 
Kahmi3105: bets $39
siskin vrach: folds 
Uncalled bet ($39) returned to Kahmi3105
Kahmi3105 collected $30.38 from pot
*** SUMMARY ***
Total pot $32.40 | Rake $2.02 
Board [Kc 3h Th 6s 2c]
Seat 1: whitecillar3 folded before Flop (didn't bet)
Seat 2: Kaban7502 folded on the Flop
Seat 3: Lemmi846 folded before Flop (didn't bet)
Seat 5: DOA1980 folded before Flop (didn't bet)
Seat 6: Kahmi3105 collected ($30.38)
Seat 7: Pachebrash (button) folded before Flop (didn't bet)
Seat 8: La Ghir (small blind) folded on the Turn
Seat 9: siskin vrach (big blind) folded on the River



PokerStars Hand #228685006104:  Hold'em No Limit ($0.25/$0.50 USD) - 2021/07/30 14:17:55 ET
Table 'Aitne III' 9-max Seat #8 is the button
Seat 1: whitecillar3 ($43.84 in chips) 
Seat 2: Kaban7502 ($50.64 in chips) 
Seat 3: Lemmi846 ($50 in chips) 
Seat 5: DOA1980 ($50 in chips) 
Seat 6: Kahmi3105 ($122.70 in chips) 
Seat 7: Pachebrash ($83.66 in chips) 
Seat 8: La Ghir ($50 in chips) 
Seat 9: siskin vrach ($50 in chips) 
siskin vrach: posts small blind $0.25
whitecillar3: posts big blind $0.50
dikanmax: sits out 
*** HOLE CARDS ***
Kaban7502: folds 
Lemmi846: folds 
DOA1980: folds 
Kahmi3105: folds 
Pachebrash: folds 
La Ghir: raises $0.50 to $1
siskin vrach: folds 
whitecillar3: folds 
Uncalled bet ($0.50) returned to La Ghir
La Ghir collected $1.25 from pot
La Ghir: doesn't show hand 
*** SUMMARY ***
Total pot $1.25 | Rake $0 
Seat 1: whitecillar3 (big blind) folded before Flop
Seat 2: Kaban7502 folded before Flop (didn't bet)
Seat 3: Lemmi846 folded before Flop (didn't bet)
Seat 5: DOA1980 folded before Flop (didn't bet)
Seat 6: Kahmi3105 folded before Flop (didn't bet)
Seat 7: Pachebrash folded before Flop (didn't bet)
Seat 8: La Ghir (button) collected ($1.25)
Seat 9: siskin vrach (small blind) folded before Flop



PokerStars Hand #228685012056:  Hold'em No Limit ($0.25/$0.50 USD) - 2021/07/30 14:18:09 ET
Table 'Aitne III' 9-max Seat #9 is the button
Seat 1: whitecillar3 ($43.34 in chips) 
Seat 2: Kaban7502 ($50.64 in chips) 
Seat 3: Lemmi846 ($50 in chips) 
Seat 5: DOA1980 ($50 in chips) 
Seat 6: Kahmi3105 ($122.70 in chips) 
Seat 7: Pachebrash ($83.66 in chips) 
Seat 8: La Ghir ($50.75 in chips) 
Seat 9: siskin vrach ($50 in chips) 
whitecillar3: posts small blind $0.25
Kaban7502: posts big blind $0.50
dikanmax: sits out 
*** HOLE CARDS ***
Lemmi846: folds 
DOA1980: folds 
Kahmi3105 has timed out
Kahmi3105: folds 
Pachebrash: folds 
La Ghir: folds 
siskin vrach: folds 
whitecillar3: raises $0.75 to $1.25
Kaban7502: calls $0.75
*** FLOP *** [4h 4s 6d]
whitecillar3: checks 
Kaban7502: checks 
*** TURN *** [4h 4s 6d] [3h]
whitecillar3: checks 
Kaban7502: checks 
*** RIVER *** [4h 4s 6d 3h] [Kc]
whitecillar3: checks 
Kaban7502: checks 
*** SHOW DOWN ***
whitecillar3: shows [Ac 5d] (a pair of Fours)
Kaban7502: mucks hand 
whitecillar3 collected $2.38 from pot
*** SUMMARY ***
Total pot $2.50 | Rake $0.12 
Board [4h 4s 6d 3h Kc]
Seat 1: whitecillar3 (small blind) showed [Ac 5d] and won ($2.38) with a pair of Fours
Seat 2: Kaban7502 (big blind) mucked
Seat 3: Lemmi846 folded before Flop (didn't bet)
Seat 5: DOA1980 folded before Flop (didn't bet)
Seat 6: Kahmi3105 folded before Flop (didn't bet)
Seat 7: Pachebrash folded before Flop (didn't bet)
Seat 8: La Ghir folded before Flop (didn't bet)
Seat 9: siskin vrach (button) folded before Flop (didn't bet)



PokerStars Hand #228685037944:  Hold'em No Limit ($0.25/$0.50 USD) - 2021/07/30 14:19:10 ET
Table 'Aitne III' 9-max Seat #1 is the button
Seat 1: whitecillar3 ($44.47 in chips) 
Seat 2: Kaban7502 ($49.39 in chips) 
Seat 3: Lemmi846 ($50 in chips) 
Seat 5: DOA1980 ($50 in chips) 
Seat 6: Kahmi3105 ($122.70 in chips) 
Seat 7: Pachebrash ($83.66 in chips) 
Seat 8: La Ghir ($50.75 in chips) 
Seat 9: siskin vrach ($50 in chips) 
Kaban7502: posts small blind $0.25
Lemmi846: posts big blind $0.50
dikanmax: sits out 
*** HOLE CARDS ***
DOA1980: folds 
Kahmi3105: folds 
Pachebrash: folds 
La Ghir: folds 
siskin vrach: folds 
whitecillar3: folds 
Kaban7502: folds 
Uncalled bet ($0.25) returned to Lemmi846
Lemmi846 collected $0.50 from pot
Lemmi846: doesn't show hand 
*** SUMMARY ***
Total pot $0.50 | Rake $0 
Seat 1: whitecillar3 (button) folded before Flop (didn't bet)
Seat 2: Kaban7502 (small blind) folded before Flop
Seat 3: Lemmi846 (big blind) collected ($0.50)
Seat 5: DOA1980 folded before Flop (didn't bet)
Seat 6: Kahmi3105 folded before Flop (didn't bet)
Seat 7: Pachebrash folded before Flop (didn't bet)
Seat 8: La Ghir folded before Flop (didn't bet)
Seat 9: siskin vrach folded before Flop (didn't bet)



PokerStars Hand #228685048214:  Hold'em No Limit ($0.25/$0.50 USD) - 2021/07/30 14:19:34 ET
Table 'Aitne III' 9-max Seat #2 is the button
Seat 1: whitecillar3 ($44.47 in chips) 
Seat 2: Kaban7502 ($49.14 in chips) 
Seat 3: Lemmi846 ($50.25 in chips) 
Seat 4: dikanmax ($50.75 in chips) 
Seat 5: DOA1980 ($50 in chips) 
Seat 6: Kahmi3105 ($122.70 in chips) 
Seat 7: Pachebrash ($83.66 in chips) 
Seat 8: La Ghir ($50.75 in chips) 
Seat 9: siskin vrach ($50 in chips) 
Lemmi846: posts small blind $0.25
dikanmax: posts big blind $0.50
*** HOLE CARDS ***
DOA1980: folds 
Kahmi3105: folds 
Pachebrash: raises $1 to $1.50
La Ghir: folds 
siskin vrach: folds 
whitecillar3: folds 
Kaban7502: folds 
Lemmi846: folds 
dikanmax: folds 
Uncalled bet ($1) returned to Pachebrash
Pachebrash collected $1.25 from pot
Pachebrash: doesn't show hand 
*** SUMMARY ***
Total pot $1.25 | Rake $0 
Seat 1: whitecillar3 folded before Flop (didn't bet)
Seat 2: Kaban7502 (button) folded before Flop (didn't bet)
Seat 3: Lemmi846 (small blind) folded before Flop
Seat 4: dikanmax (big blind) folded before Flop
Seat 5: DOA1980 folded before Flop (didn't bet)
Seat 6: Kahmi3105 folded before Flop (didn't bet)
Seat 7: Pachebrash collected ($1.25)
Seat 8: La Ghir folded before Flop (didn't bet)
Seat 9: siskin vrach folded before Flop (didn't bet)



PokerStars Hand #228685057151:  Hold'em No Limit ($0.25/$0.50 USD) - 2021/07/30 14:19:55 ET
Table 'Aitne III' 9-max Seat #3 is the button
Seat 1: whitecillar3 ($44.47 in chips) 
Seat 2: Kaban7502 ($49.14 in chips) 
Seat 3: Lemmi846 ($50 in chips) 
Seat 4: dikanmax ($50.25 in chips) 
Seat 5: DOA1980 ($50 in chips) 
Seat 6: Kahmi3105 ($122.70 in chips) 
Seat 7: Pachebrash ($84.41 in chips) 
Seat 8: La Ghir ($50.75 in chips) 
Seat 9: siskin vrach ($50 in chips) 
dikanmax: posts small blind $0.25
DOA1980: posts big blind $0.50
*** HOLE CARDS ***
Kahmi3105 has timed out
Kahmi3105: folds 
Pachebrash: raises $1 to $1.50
La Ghir: folds 
siskin vrach: folds 
whitecillar3: folds 
Kaban7502: folds 
Lemmi846: folds 
dikanmax: folds 
DOA1980: folds 
Uncalled bet ($1) returned to Pachebrash
Pachebrash collected $1.25 from pot
Pachebrash: doesn't show hand 
*** SUMMARY ***
Total pot $1.25 | Rake $0 
Seat 1: whitecillar3 folded before Flop (didn't bet)
Seat 2: Kaban7502 folded before Flop (didn't bet)
Seat 3: Lemmi846 (button) folded before Flop (didn't bet)
Seat 4: dikanmax (small blind) folded before Flop
Seat 5: DOA1980 (big blind) folded before Flop
Seat 6: Kahmi3105 folded before Flop (didn't bet)
Seat 7: Pachebrash collected ($1.25)
Seat 8: La Ghir folded before Flop (didn't bet)
Seat 9: siskin vrach folded before Flop (didn't bet)



PokerStars Hand #228685067967:  Hold'em No Limit ($0.25/$0.50 USD) - 2021/07/30 14:20:21 ET
Table 'Aitne III' 9-max Seat #4 is the button
Seat 1: whitecillar3 ($44.47 in chips) 
Seat 2: Kaban7502 ($49.14 in chips) 
Seat 3: Lemmi846 ($50 in chips) 
Seat 4: dikanmax ($50 in chips) 
Seat 5: DOA1980 ($50 in chips) 
Seat 6: Kahmi3105 ($122.70 in chips) 
Seat 7: Pachebrash ($85.16 in chips) 
Seat 8: La Ghir ($50.75 in chips) 
Seat 9: siskin vrach ($50 in chips) 
DOA1980: posts small blind $0.25
Kahmi3105: posts big blind $0.50
*** HOLE CARDS ***
Pachebrash: folds 
La Ghir: folds 
siskin vrach: folds 
whitecillar3: folds 
Kaban7502: calls $0.50
Lemmi846: calls $0.50
dikanmax: calls $0.50
DOA1980: folds 
Kahmi3105: checks 
*** FLOP *** [6c 5s 9d]
Kahmi3105: checks 
Kaban7502: bets $2.14
Lemmi846: folds 
dikanmax: folds 
Kahmi3105: folds 
Uncalled bet ($2.14) returned to Kaban7502
Kaban7502 collected $2.11 from pot
Kaban7502: doesn't show hand 
*** SUMMARY ***
Total pot $2.25 | Rake $0.14 
Board [6c 5s 9d]
Seat 1: whitecillar3 folded before Flop (didn't bet)
Seat 2: Kaban7502 collected ($2.11)
Seat 3: Lemmi846 folded on the Flop
Seat 4: dikanmax (button) folded on the Flop
Seat 5: DOA1980 (small blind) folded before Flop
Seat 6: Kahmi3105 (big blind) folded on the Flop
Seat 7: Pachebrash folded before Flop (didn't bet)
Seat 8: La Ghir folded before Flop (didn't bet)
Seat 9: siskin vrach folded before Flop (didn't bet)



PokerStars Hand #228682464203:  Hold'em No Limit ($0.25/$0.50 USD) - 2021/07/30 12:32:14 ET
Table 'Aitne III' 9-max Seat #9 is the button
Seat 1: alex_matsuka ($86.08 in chips) 
Seat 4: juwnas ($67.21 in chips) 
Seat 5: chiruha0523 ($19.77 in chips) 
Seat 6: RipZip ($50.01 in chips) 
Seat 7: any2cardsxx ($40.71 in chips) 
Seat 8: ludemix ($80.51 in chips) 
Seat 9: siskin vrach ($69.96 in chips) 
alex_matsuka: posts small blind $0.25
Dragonclawss: is sitting out 
Lemmi846: is sitting out 
Dragonclawss leaves the table
juwnas: posts big blind $0.50
*** HOLE CARDS ***
Mc57Arnold joins the table at seat #2 
chiruha0523: folds 
RipZip: folds 
any2cardsxx: folds 
ludemix: raises $0.75 to $1.25
siskin vrach: calls $1.25
alex_matsuka: folds 
juwnas: folds 
*** FLOP *** [Jc 3c 3s]
ludemix: bets $1.08
siskin vrach: calls $1.08
*** TURN *** [Jc 3c 3s] [Qc]
ludemix: checks 
siskin vrach: checks 
*** RIVER *** [Jc 3c 3s Qc] [2d]
ludemix: checks 
siskin vrach: bets $2.50
ludemix: folds 
Uncalled bet ($2.50) returned to siskin vrach
siskin vrach collected $5.14 from pot
*** SUMMARY ***
Total pot $5.41 | Rake $0.27 
Board [Jc 3c 3s Qc 2d]
Seat 1: alex_matsuka (small blind) folded before Flop
Seat 4: juwnas (big blind) folded before Flop
Seat 5: chiruha0523 folded before Flop (didn't bet)
Seat 6: RipZip folded before Flop (didn't bet)
Seat 7: any2cardsxx folded before Flop (didn't bet)
Seat 8: ludemix folded on the River
Seat 9: siskin vrach (button) collected ($5.14)



PokerStars Hand #228682491387:  Hold'em No Limit ($0.25/$0.50 USD) - 2021/07/30 12:33:07 ET
Table 'Aitne III' 9-max Seat #1 is the button
Seat 1: alex_matsuka ($85.83 in chips) 
Seat 4: juwnas ($66.71 in chips) 
Seat 5: chiruha0523 ($19.77 in chips) 
Seat 6: RipZip ($50.01 in chips) 
Seat 7: any2cardsxx ($40.71 in chips) 
Seat 8: ludemix ($78.18 in chips) 
Seat 9: siskin vrach ($72.77 in chips) 
juwnas: posts small blind $0.25
chiruha0523: posts big blind $0.50
*** HOLE CARDS ***
RipZip: folds 
any2cardsxx: folds 
ludemix: folds 
siskin vrach: folds 
alex_matsuka: folds 
juwnas: folds 
Uncalled bet ($0.25) returned to chiruha0523
chiruha0523 collected $0.50 from pot
chiruha0523: doesn't show hand 
*** SUMMARY ***
Total pot $0.50 | Rake $0 
Seat 1: alex_matsuka (button) folded before Flop (didn't bet)
Seat 4: juwnas (small blind) folded before Flop
Seat 5: chiruha0523 (big blind) collected ($0.50)
Seat 6: RipZip folded before Flop (didn't bet)
Seat 7: any2cardsxx folded before Flop (didn't bet)
Seat 8: ludemix folded before Flop (didn't bet)
Seat 9: siskin vrach folded before Flop (didn't bet)



PokerStars Hand #228682496536:  Hold'em No Limit ($0.25/$0.50 USD) - 2021/07/30 12:33:21 ET
Table 'Aitne III' 9-max Seat #4 is the button
Seat 1: alex_matsuka ($85.83 in chips) 
Seat 4: juwnas ($66.46 in chips) 
Seat 5: chiruha0523 ($20.02 in chips) 
Seat 6: RipZip ($50.01 in chips) 
Seat 7: any2cardsxx ($40.71 in chips) 
Seat 8: ludemix ($78.18 in chips) 
Seat 9: siskin vrach ($72.77 in chips) 
chiruha0523: posts small blind $0.25
RipZip: posts big blind $0.50
Mc57Arnold: sits out 
*** HOLE CARDS ***
any2cardsxx: folds 
ludemix: folds 
siskin vrach: raises $1 to $1.50
alex_matsuka: folds 
juwnas: folds 
chiruha0523: raises $1 to $2.50
RipZip: folds 
siskin vrach: calls $1
*** FLOP *** [3d Ts 8d]
chiruha0523: bets $5.22
siskin vrach: folds 
Uncalled bet ($5.22) returned to chiruha0523
chiruha0523 collected $5.22 from pot
chiruha0523: doesn't show hand 
*** SUMMARY ***
Total pot $5.50 | Rake $0.28 
Board [3d Ts 8d]
Seat 1: alex_matsuka folded before Flop (didn't bet)
Seat 4: juwnas (button) folded before Flop (didn't bet)
Seat 5: chiruha0523 (small blind) collected ($5.22)
Seat 6: RipZip (big blind) folded before Flop
Seat 7: any2cardsxx folded before Flop (didn't bet)
Seat 8: ludemix folded before Flop (didn't bet)
Seat 9: siskin vrach folded on the Flop



PokerStars Hand #228682514702:  Hold'em No Limit ($0.25/$0.50 USD) - 2021/07/30 12:34:10 ET
Table 'Aitne III' 9-max Seat #5 is the button
Seat 1: alex_matsuka ($85.83 in chips) 
Seat 4: juwnas ($66.46 in chips) 
Seat 5: chiruha0523 ($22.74 in chips) 
Seat 6: RipZip ($49.51 in chips) 
Seat 7: any2cardsxx ($40.71 in chips) 
Seat 8: ludemix ($78.18 in chips) 
Seat 9: siskin vrach ($70.27 in chips) 
RipZip: posts small blind $0.25
any2cardsxx: posts big blind $0.50
Mc57Arnold: sits out 
*** HOLE CARDS ***
ludemix: folds 
siskin vrach: folds 
alex_matsuka: folds 
juwnas: raises $1 to $1.50
chiruha0523: folds 
RipZip: folds 
any2cardsxx: calls $1
*** FLOP *** [Kc Jc Tc]
any2cardsxx: checks 
juwnas: checks 
*** TURN *** [Kc Jc Tc] [Ac]
any2cardsxx: checks 
juwnas: checks 
*** RIVER *** [Kc Jc Tc Ac] [2s]
any2cardsxx: bets $0.50
juwnas: calls $0.50
*** SHOW DOWN ***
any2cardsxx: shows [Qc Qs] (a Royal Flush)
juwnas: mucks hand 
any2cardsxx collected $4.04 from pot
*** SUMMARY ***
Total pot $4.25 | Rake $0.21 
Board [Kc Jc Tc Ac 2s]
Seat 1: alex_matsuka folded before Flop (didn't bet)
Seat 4: juwnas mucked
Seat 5: chiruha0523 (button) folded before Flop (didn't bet)
Seat 6: RipZip (small blind) folded before Flop
Seat 7: any2cardsxx (big blind) showed [Qc Qs] and won ($4.04) with a Royal Flush
Seat 8: ludemix folded before Flop (didn't bet)
Seat 9: siskin vrach folded before Flop (didn't bet)



PokerStars Hand #228682532157:  Hold'em No Limit ($0.25/$0.50 USD) - 2021/07/30 12:34:57 ET
Table 'Aitne III' 9-max Seat #6 is the button
Seat 1: alex_matsuka ($85.83 in chips) 
Seat 4: juwnas ($64.46 in chips) 
Seat 5: chiruha0523 ($22.74 in chips) 
Seat 6: RipZip ($49.26 in chips) 
Seat 7: any2cardsxx ($42.75 in chips) 
Seat 8: ludemix ($78.18 in chips) 
Seat 9: siskin vrach ($70.27 in chips) 
any2cardsxx: posts small blind $0.25
ludemix: posts big blind $0.50
Mc57Arnold: sits out 
*** HOLE CARDS ***
siskin vrach: folds 
alex_matsuka: folds 
juwnas: raises $1 to $1.50
chiruha0523: raises $1 to $2.50
RipZip: calls $2.50
any2cardsxx: folds 
ludemix: folds 
juwnas: calls $1
*** FLOP *** [Th 3h Kc]
juwnas: checks 
chiruha0523: bets $7.84
RipZip: calls $7.84
juwnas: calls $7.84
*** TURN *** [Th 3h Kc] [2c]
juwnas: checks 
chiruha0523: bets $12.40 and is all-in
RipZip: calls $12.40
juwnas: folds 
*** RIVER *** [Th 3h Kc 2c] [5s]
*** SHOW DOWN ***
chiruha0523: shows [Kd Ah] (a pair of Kings)
RipZip: shows [Kh Ad] (a pair of Kings)
chiruha0523 collected $27.29 from pot
RipZip collected $27.28 from pot
*** SUMMARY ***
Total pot $56.57 | Rake $2 
Board [Th 3h Kc 2c 5s]
Seat 1: alex_matsuka folded before Flop (didn't bet)
Seat 4: juwnas folded on the Turn
Seat 5: chiruha0523 showed [Kd Ah] and won ($27.29) with a pair of Kings
Seat 6: RipZip (button) showed [Kh Ad] and won ($27.28) with a pair of Kings
Seat 7: any2cardsxx (small blind) folded before Flop
Seat 8: ludemix (big blind) folded before Flop
Seat 9: siskin vrach folded before Flop (didn't bet)



PokerStars Hand #228682565589:  Hold'em No Limit ($0.25/$0.50 USD) - 2021/07/30 12:36:27 ET
Table 'Aitne III' 9-max Seat #7 is the button
Seat 1: alex_matsuka ($85.83 in chips) 
Seat 4: juwnas ($54.12 in chips) 
Seat 5: chiruha0523 ($27.29 in chips) 
Seat 6: RipZip ($53.80 in chips) 
Seat 7: any2cardsxx ($42.50 in chips) 
Seat 8: ludemix ($77.68 in chips) 
Seat 9: siskin vrach ($70.27 in chips) 
ludemix: posts small blind $0.25
siskin vrach: posts big blind $0.50
Mc57Arnold: sits out 
Lemmi846: sits out 
*** HOLE CARDS ***
alex_matsuka: folds 
juwnas: folds 
chiruha0523: folds 
RipZip: folds 
any2cardsxx: raises $1 to $1.50
ludemix: folds 
siskin vrach: raises $3.50 to $5
any2cardsxx: calls $3.50
*** FLOP *** [Qd 6c Kh]
siskin vrach: checks 
any2cardsxx: bets $2.50
siskin vrach: folds 
Uncalled bet ($2.50) returned to any2cardsxx
any2cardsxx collected $9.74 from pot
any2cardsxx: doesn't show hand 
*** SUMMARY ***
Total pot $10.25 | Rake $0.51 
Board [Qd 6c Kh]
Seat 1: alex_matsuka folded before Flop (didn't bet)
Seat 4: juwnas folded before Flop (didn't bet)
Seat 5: chiruha0523 folded before Flop (didn't bet)
Seat 6: RipZip folded before Flop (didn't bet)
Seat 7: any2cardsxx (button) collected ($9.74)
Seat 8: ludemix (small blind) folded before Flop
Seat 9: siskin vrach (big blind) folded on the Flop



PokerStars Hand #228682583289:  Hold'em No Limit ($0.25/$0.50 USD) - 2021/07/30 12:37:15 ET
Table 'Aitne III' 9-max Seat #8 is the button
Seat 1: alex_matsuka ($85.83 in chips) 
Seat 4: juwnas ($54.12 in chips) 
Seat 5: chiruha0523 ($27.29 in chips) 
Seat 6: RipZip ($53.80 in chips) 
Seat 7: any2cardsxx ($47.24 in chips) 
Seat 8: ludemix ($77.43 in chips) 
Seat 9: siskin vrach ($65.27 in chips) 
siskin vrach: posts small blind $0.25
alex_matsuka: posts big blind $0.50
Mc57Arnold: sits out 
Lemmi846: sits out 
*** HOLE CARDS ***
juwnas: folds 
chiruha0523: folds 
RipZip: raises $0.75 to $1.25
any2cardsxx: folds 
ludemix: folds 
siskin vrach: folds 
alex_matsuka: folds 
Uncalled bet ($0.75) returned to RipZip
RipZip collected $1.25 from pot
RipZip: doesn't show hand 
*** SUMMARY ***
Total pot $1.25 | Rake $0 
Seat 1: alex_matsuka (big blind) folded before Flop
Seat 4: juwnas folded before Flop (didn't bet)
Seat 5: chiruha0523 folded before Flop (didn't bet)
Seat 6: RipZip collected ($1.25)
Seat 7: any2cardsxx folded before Flop (didn't bet)
Seat 8: ludemix (button) folded before Flop (didn't bet)
Seat 9: siskin vrach (small blind) folded before Flop



PokerStars Hand #228682587871:  Hold'em No Limit ($0.25/$0.50 USD) - 2021/07/30 12:37:27 ET
Table 'Aitne III' 9-max Seat #9 is the button
Seat 1: alex_matsuka ($85.33 in chips) 
Seat 2: Mc57Arnold ($50 in chips) 
Seat 4: juwnas ($54.12 in chips) 
Seat 5: chiruha0523 ($27.29 in chips) 
Seat 6: RipZip ($54.55 in chips) 
Seat 8: ludemix ($77.43 in chips) 
Seat 9: siskin vrach ($65.02 in chips) 
alex_matsuka: posts small blind $0.25
Mc57Arnold: posts big blind $0.50
Lemmi846: sits out 
*** HOLE CARDS ***
juwnas: folds 
chiruha0523: folds 
RipZip: folds 
ludemix: folds 
siskin vrach: raises $0.50 to $1
alex_matsuka: folds 
Mc57Arnold: calls $0.50
*** FLOP *** [Ac 2h 7s]
Mc57Arnold: checks 
any2cardsxx is disconnected 
siskin vrach: bets $1.71
Mc57Arnold: folds 
Uncalled bet ($1.71) returned to siskin vrach
siskin vrach collected $2.14 from pot
*** SUMMARY ***
Total pot $2.25 | Rake $0.11 
Board [Ac 2h 7s]
Seat 1: alex_matsuka (small blind) folded before Flop
Seat 2: Mc57Arnold (big blind) folded on the Flop
Seat 4: juwnas folded before Flop (didn't bet)
Seat 5: chiruha0523 folded before Flop (didn't bet)
Seat 6: RipZip folded before Flop (didn't bet)
Seat 8: ludemix folded before Flop (didn't bet)
Seat 9: siskin vrach (button) collected ($2.14)



PokerStars Hand #228682597289:  Hold'em No Limit ($0.25/$0.50 USD) - 2021/07/30 12:37:52 ET
Table 'Aitne III' 9-max Seat #1 is the button
Seat 1: alex_matsuka ($85.08 in chips) 
Seat 2: Mc57Arnold ($50 in chips) 
Seat 3: Lemmi846 ($58.60 in chips) 
Seat 4: juwnas ($54.12 in chips) 
Seat 5: chiruha0523 ($27.29 in chips) 
Seat 6: RipZip ($54.55 in chips) 
Seat 8: ludemix ($77.43 in chips) 
Seat 9: siskin vrach ($66.16 in chips) 
Mc57Arnold: posts small blind $0.25
Lemmi846: posts big blind $0.50
*** HOLE CARDS ***
juwnas: folds 
chiruha0523: raises $1 to $1.50
RipZip: folds 
ludemix: folds 
siskin vrach: folds 
alex_matsuka: folds 
Mc57Arnold: folds 
Lemmi846: folds 
Uncalled bet ($1) returned to chiruha0523
chiruha0523 collected $1.25 from pot
chiruha0523: doesn't show hand 
*** SUMMARY ***
Total pot $1.25 | Rake $0 
Seat 1: alex_matsuka (button) folded before Flop (didn't bet)
Seat 2: Mc57Arnold (small blind) folded before Flop
Seat 3: Lemmi846 (big blind) folded before Flop
Seat 4: juwnas folded before Flop (didn't bet)
Seat 5: chiruha0523 collected ($1.25)
Seat 6: RipZip folded before Flop (didn't bet)
Seat 8: ludemix folded before Flop (didn't bet)
Seat 9: siskin vrach folded before Flop (didn't bet)



PokerStars Hand #228682603273:  Hold'em No Limit ($0.25/$0.50 USD) - 2021/07/30 12:38:08 ET
Table 'Aitne III' 9-max Seat #2 is the button
Seat 1: alex_matsuka ($85.08 in chips) 
Seat 2: Mc57Arnold ($50 in chips) 
Seat 3: Lemmi846 ($58.10 in chips) 
Seat 4: juwnas ($54.12 in chips) 
Seat 5: chiruha0523 ($28.04 in chips) 
Seat 6: RipZip ($54.55 in chips) 
Seat 8: ludemix ($77.43 in chips) 
Seat 9: siskin vrach ($66.16 in chips) 
Lemmi846: posts small blind $0.25
juwnas: posts big blind $0.50
*** HOLE CARDS ***
chiruha0523: folds 
RipZip: folds 
ludemix: folds 
siskin vrach: folds 
alex_matsuka: folds 
Mc57Arnold: folds 
Lemmi846: folds 
Uncalled bet ($0.25) returned to juwnas
juwnas collected $0.50 from pot
juwnas: doesn't show hand 
*** SUMMARY ***
Total pot $0.50 | Rake $0 
Seat 1: alex_matsuka folded before Flop (didn't bet)
Seat 2: Mc57Arnold (button) folded before Flop (didn't bet)
Seat 3: Lemmi846 (small blind) folded before Flop
Seat 4: juwnas (big blind) collected ($0.50)
Seat 5: chiruha0523 folded before Flop (didn't bet)
Seat 6: RipZip folded before Flop (didn't bet)
Seat 8: ludemix folded before Flop (didn't bet)
Seat 9: siskin vrach folded before Flop (didn't bet)



PokerStars Hand #228682609626:  Hold'em No Limit ($0.25/$0.50 USD) - 2021/07/30 12:38:25 ET
Table 'Aitne III' 9-max Seat #3 is the button
Seat 1: alex_matsuka ($85.08 in chips) 
Seat 2: Mc57Arnold ($50 in chips) 
Seat 3: Lemmi846 ($57.85 in chips) 
Seat 4: juwnas ($54.37 in chips) 
Seat 5: chiruha0523 ($28.04 in chips) 
Seat 6: RipZip ($54.55 in chips) 
Seat 8: ludemix ($77.43 in chips) 
Seat 9: siskin vrach ($66.16 in chips) 
juwnas: posts small blind $0.25
chiruha0523: posts big blind $0.50
*** HOLE CARDS ***
RipZip: folds 
ludemix: folds 
siskin vrach: folds 
alex_matsuka: folds 
Mc57Arnold: folds 
Lemmi846: folds 
juwnas: folds 
Uncalled bet ($0.25) returned to chiruha0523
chiruha0523 collected $0.50 from pot
chiruha0523: doesn't show hand 
*** SUMMARY ***
Total pot $0.50 | Rake $0 
Seat 1: alex_matsuka folded before Flop (didn't bet)
Seat 2: Mc57Arnold folded before Flop (didn't bet)
Seat 3: Lemmi846 (button) folded before Flop (didn't bet)
Seat 4: juwnas (small blind) folded before Flop
Seat 5: chiruha0523 (big blind) collected ($0.50)
Seat 6: RipZip folded before Flop (didn't bet)
Seat 8: ludemix folded before Flop (didn't bet)
Seat 9: siskin vrach folded before Flop (didn't bet)



PokerStars Hand #228682613090:  Hold'em No Limit ($0.25/$0.50 USD) - 2021/07/30 12:38:35 ET
Table 'Aitne III' 9-max Seat #4 is the button
Seat 1: alex_matsuka ($85.08 in chips) 
Seat 2: Mc57Arnold ($50 in chips) 
Seat 3: Lemmi846 ($57.85 in chips) 
Seat 4: juwnas ($54.12 in chips) 
Seat 5: chiruha0523 ($28.29 in chips) 
Seat 6: RipZip ($54.55 in chips) 
Seat 8: ludemix ($77.43 in chips) 
Seat 9: siskin vrach ($66.16 in chips) 
chiruha0523: posts small blind $0.25
RipZip: posts big blind $0.50
*** HOLE CARDS ***
ludemix: folds 
siskin vrach: folds 
alex_matsuka: raises $1 to $1.50
Mc57Arnold: folds 
Lemmi846: folds 
juwnas: folds 
chiruha0523: folds 
RipZip: folds 
Uncalled bet ($1) returned to alex_matsuka
alex_matsuka collected $1.25 from pot
alex_matsuka: doesn't show hand 
*** SUMMARY ***
Total pot $1.25 | Rake $0 
Seat 1: alex_matsuka collected ($1.25)
Seat 2: Mc57Arnold folded before Flop (didn't bet)
Seat 3: Lemmi846 folded before Flop (didn't bet)
Seat 4: juwnas (button) folded before Flop (didn't bet)
Seat 5: chiruha0523 (small blind) folded before Flop
Seat 6: RipZip (big blind) folded before Flop
Seat 8: ludemix folded before Flop (didn't bet)
Seat 9: siskin vrach folded before Flop (didn't bet)



PokerStars Hand #228682621763:  Hold'em No Limit ($0.25/$0.50 USD) - 2021/07/30 12:38:58 ET
Table 'Aitne III' 9-max Seat #5 is the button
Seat 1: alex_matsuka ($85.83 in chips) 
Seat 2: Mc57Arnold ($50 in chips) 
Seat 3: Lemmi846 ($57.85 in chips) 
Seat 4: juwnas ($54.12 in chips) 
Seat 5: chiruha0523 ($28.04 in chips) 
Seat 6: RipZip ($54.05 in chips) 
Seat 7: any2cardsxx ($47.24 in chips) 
Seat 8: ludemix ($77.43 in chips) 
Seat 9: siskin vrach ($66.16 in chips) 
RipZip: posts small blind $0.25
any2cardsxx: posts big blind $0.50
*** HOLE CARDS ***
ludemix: folds 
siskin vrach: raises $1 to $1.50
alex_matsuka: folds 
Mc57Arnold: folds 
Lemmi846: folds 
juwnas: folds 
chiruha0523: folds 
RipZip: folds 
any2cardsxx: folds 
Uncalled bet ($1) returned to siskin vrach
siskin vrach collected $1.25 from pot
*** SUMMARY ***
Total pot $1.25 | Rake $0 
Seat 1: alex_matsuka folded before Flop (didn't bet)
Seat 2: Mc57Arnold folded before Flop (didn't bet)
Seat 3: Lemmi846 folded before Flop (didn't bet)
Seat 4: juwnas folded before Flop (didn't bet)
Seat 5: chiruha0523 (button) folded before Flop (didn't bet)
Seat 6: RipZip (small blind) folded before Flop
Seat 7: any2cardsxx (big blind) folded before Flop
Seat 8: ludemix folded before Flop (didn't bet)
Seat 9: siskin vrach collected ($1.25)



PokerStars Hand #228682629650:  Hold'em No Limit ($0.25/$0.50 USD) - 2021/07/30 12:39:19 ET
Table 'Aitne III' 9-max Seat #6 is the button
Seat 1: alex_matsuka ($85.83 in chips) 
Seat 2: Mc57Arnold ($50 in chips) 
Seat 3: Lemmi846 ($57.85 in chips) 
Seat 4: juwnas ($54.12 in chips) 
Seat 5: chiruha0523 ($28.04 in chips) 
Seat 6: RipZip ($53.80 in chips) 
Seat 7: any2cardsxx ($46.74 in chips) 
Seat 8: ludemix ($77.43 in chips) 
Seat 9: siskin vrach ($66.91 in chips) 
any2cardsxx: posts small blind $0.25
ludemix: posts big blind $0.50
*** HOLE CARDS ***
siskin vrach: folds 
alex_matsuka: folds 
Mc57Arnold: raises $0.85 to $1.35
Lemmi846: folds 
juwnas: folds 
chiruha0523: folds 
RipZip: folds 
any2cardsxx: folds 
ludemix: folds 
Uncalled bet ($0.85) returned to Mc57Arnold
Mc57Arnold collected $1.25 from pot
Mc57Arnold: doesn't show hand 
*** SUMMARY ***
Total pot $1.25 | Rake $0 
Seat 1: alex_matsuka folded before Flop (didn't bet)
Seat 2: Mc57Arnold collected ($1.25)
Seat 3: Lemmi846 folded before Flop (didn't bet)
Seat 4: juwnas folded before Flop (didn't bet)
Seat 5: chiruha0523 folded before Flop (didn't bet)
Seat 6: RipZip (button) folded before Flop (didn't bet)
Seat 7: any2cardsxx (small blind) folded before Flop
Seat 8: ludemix (big blind) folded before Flop
Seat 9: siskin vrach folded before Flop (didn't bet)



PokerStars Hand #228682637454:  Hold'em No Limit ($0.25/$0.50 USD) - 2021/07/30 12:39:39 ET
Table 'Aitne III' 9-max Seat #7 is the button
Seat 1: alex_matsuka ($85.83 in chips) 
Seat 2: Mc57Arnold ($50.75 in chips) 
Seat 3: Lemmi846 ($57.85 in chips) 
Seat 4: juwnas ($54.12 in chips) 
Seat 5: chiruha0523 ($28.04 in chips) 
Seat 6: RipZip ($53.80 in chips) 
Seat 7: any2cardsxx ($46.49 in chips) 
Seat 8: ludemix ($76.93 in chips) 
Seat 9: siskin vrach ($66.91 in chips) 
ludemix: posts small blind $0.25
siskin vrach: posts big blind $0.50
*** HOLE CARDS ***
alex_matsuka: folds 
Mc57Arnold: folds 
Lemmi846: folds 
juwnas: folds 
chiruha0523: folds 
RipZip: folds 
any2cardsxx: raises $1 to $1.50
ludemix: folds 
siskin vrach: folds 
Uncalled bet ($1) returned to any2cardsxx
any2cardsxx collected $1.25 from pot
any2cardsxx: doesn't show hand 
*** SUMMARY ***
Total pot $1.25 | Rake $0 
Seat 1: alex_matsuka folded before Flop (didn't bet)
Seat 2: Mc57Arnold folded before Flop (didn't bet)
Seat 3: Lemmi846 folded before Flop (didn't bet)
Seat 4: juwnas folded before Flop (didn't bet)
Seat 5: chiruha0523 folded before Flop (didn't bet)
Seat 6: RipZip folded before Flop (didn't bet)
Seat 7: any2cardsxx (button) collected ($1.25)
Seat 8: ludemix (small blind) folded before Flop
Seat 9: siskin vrach (big blind) folded before Flop



PokerStars Hand #228682645512:  Hold'em No Limit ($0.25/$0.50 USD) - 2021/07/30 12:40:01 ET
Table 'Aitne III' 9-max Seat #8 is the button
Seat 1: alex_matsuka ($85.83 in chips) 
Seat 2: Mc57Arnold ($50.75 in chips) 
Seat 3: Lemmi846 ($57.85 in chips) 
Seat 4: juwnas ($54.12 in chips) 
Seat 5: chiruha0523 ($28.04 in chips) 
Seat 6: RipZip ($53.80 in chips) 
Seat 7: any2cardsxx ($47.24 in chips) 
Seat 8: ludemix ($76.68 in chips) 
Seat 9: siskin vrach ($66.41 in chips) 
siskin vrach: posts small blind $0.25
alex_matsuka: posts big blind $0.50
*** HOLE CARDS ***
Mc57Arnold: folds 
Lemmi846: folds 
juwnas: folds 
chiruha0523: folds 
RipZip: folds 
any2cardsxx: folds 
ludemix: folds 
siskin vrach: raises $1.26 to $1.76
alex_matsuka: folds 
Uncalled bet ($1.26) returned to siskin vrach
siskin vrach collected $1 from pot
*** SUMMARY ***
Total pot $1 | Rake $0 
Seat 1: alex_matsuka (big blind) folded before Flop
Seat 2: Mc57Arnold folded before Flop (didn't bet)
Seat 3: Lemmi846 folded before Flop (didn't bet)
Seat 4: juwnas folded before Flop (didn't bet)
Seat 5: chiruha0523 folded before Flop (didn't bet)
Seat 6: RipZip folded before Flop (didn't bet)
Seat 7: any2cardsxx folded before Flop (didn't bet)
Seat 8: ludemix (button) folded before Flop (didn't bet)
Seat 9: siskin vrach (small blind) collected ($1)



PokerStars Hand #228682656580:  Hold'em No Limit ($0.25/$0.50 USD) - 2021/07/30 12:40:30 ET
Table 'Aitne III' 9-max Seat #9 is the button
Seat 1: alex_matsuka ($85.33 in chips) 
Seat 2: Mc57Arnold ($50.75 in chips) 
Seat 3: Lemmi846 ($57.85 in chips) 
Seat 4: juwnas ($54.12 in chips) 
Seat 5: chiruha0523 ($28.04 in chips) 
Seat 6: RipZip ($53.80 in chips) 
Seat 7: any2cardsxx ($47.24 in chips) 
Seat 8: ludemix ($76.68 in chips) 
Seat 9: siskin vrach ($66.91 in chips) 
alex_matsuka: posts small blind $0.25
Mc57Arnold: posts big blind $0.50
*** HOLE CARDS ***
Lemmi846: folds 
juwnas: folds 
chiruha0523: folds 
RipZip: folds 
any2cardsxx: raises $1 to $1.50
ludemix: folds 
siskin vrach: folds 
alex_matsuka: folds 
Mc57Arnold: raises $4.50 to $6
any2cardsxx: calls $4.50
*** FLOP *** [Ts Tc 2s]
Mc57Arnold: checks 
any2cardsxx: checks 
*** TURN *** [Ts Tc 2s] [Qd]
Mc57Arnold: bets $7.80
any2cardsxx: folds 
Uncalled bet ($7.80) returned to Mc57Arnold
Mc57Arnold collected $11.64 from pot
Mc57Arnold: doesn't show hand 
*** SUMMARY ***
Total pot $12.25 | Rake $0.61 
Board [Ts Tc 2s Qd]
Seat 1: alex_matsuka (small blind) folded before Flop
Seat 2: Mc57Arnold (big blind) collected ($11.64)
Seat 3: Lemmi846 folded before Flop (didn't bet)
Seat 4: juwnas folded before Flop (didn't bet)
Seat 5: chiruha0523 folded before Flop (didn't bet)
Seat 6: RipZip folded before Flop (didn't bet)
Seat 7: any2cardsxx folded on the Turn
Seat 8: ludemix folded before Flop (didn't bet)
Seat 9: siskin vrach (button) folded before Flop (didn't bet)



PokerStars Hand #228682669466:  Hold'em No Limit ($0.25/$0.50 USD) - 2021/07/30 12:41:04 ET
Table 'Aitne III' 9-max Seat #1 is the button
Seat 1: alex_matsuka ($85.08 in chips) 
Seat 2: Mc57Arnold ($56.39 in chips) 
Seat 3: Lemmi846 ($57.85 in chips) 
Seat 4: juwnas ($54.12 in chips) 
Seat 5: chiruha0523 ($28.04 in chips) 
Seat 6: RipZip ($53.80 in chips) 
Seat 7: any2cardsxx ($41.24 in chips) 
Seat 8: ludemix ($76.68 in chips) 
Seat 9: siskin vrach ($66.91 in chips) 
Mc57Arnold: posts small blind $0.25
Lemmi846: posts big blind $0.50
*** HOLE CARDS ***
juwnas has timed out
juwnas: folds 
chiruha0523: folds 
RipZip: folds 
any2cardsxx: raises $1 to $1.50
ludemix: folds 
siskin vrach: raises $3 to $4.50
alex_matsuka: folds 
Mc57Arnold: folds 
Lemmi846: folds 
any2cardsxx: raises $13.75 to $18.25
siskin vrach: raises $48.66 to $66.91 and is all-in
any2cardsxx: calls $22.99 and is all-in
Uncalled bet ($25.67) returned to siskin vrach
*** FLOP *** [2s 5h Qc]
*** TURN *** [2s 5h Qc] [Ac]
*** RIVER *** [2s 5h Qc Ac] [8c]
*** SHOW DOWN ***
any2cardsxx: shows [Ts Th] (a pair of Tens)
siskin vrach: shows [Ks As] (a pair of Aces)
siskin vrach collected $81.23 from pot
any2cardsxx cashed out the hand for $43.62 | Cash Out Fee $0.44
*** SUMMARY ***
Total pot $83.23 | Rake $2 
Board [2s 5h Qc Ac 8c]
Seat 1: alex_matsuka (button) folded before Flop (didn't bet)
Seat 2: Mc57Arnold (small blind) folded before Flop
Seat 3: Lemmi846 (big blind) folded before Flop
Seat 4: juwnas folded before Flop (didn't bet)
Seat 5: chiruha0523 folded before Flop (didn't bet)
Seat 6: RipZip folded before Flop (didn't bet)
Seat 7: any2cardsxx showed [Ts Th] and lost with a pair of Tens (cashed out).
Seat 8: ludemix folded before Flop (didn't bet)
Seat 9: siskin vrach showed [Ks As] and won ($81.23) with a pair of Aces



PokerStars Hand #228682690291:  Hold'em No Limit ($0.25/$0.50 USD) - 2021/07/30 12:41:59 ET
Table 'Aitne III' 9-max Seat #2 is the button
Seat 1: alex_matsuka ($85.08 in chips) 
Seat 2: Mc57Arnold ($56.14 in chips) 
Seat 3: Lemmi846 ($57.35 in chips) 
Seat 4: juwnas ($54.12 in chips) 
Seat 5: chiruha0523 ($28.04 in chips) 
Seat 6: RipZip ($53.80 in chips) 
Seat 7: any2cardsxx ($43.62 in chips) 
Seat 8: ludemix ($76.68 in chips) 
Seat 9: siskin vrach ($106.90 in chips) 
Lemmi846: posts small blind $0.25
juwnas: posts big blind $0.50
*** HOLE CARDS ***
chiruha0523: folds 
RipZip: folds 
any2cardsxx: raises $1 to $1.50
ludemix: folds 
siskin vrach: folds 
alex_matsuka: raises $3 to $4.50
Mc57Arnold: folds 
Lemmi846: folds 
juwnas: folds 
any2cardsxx: calls $3
*** FLOP *** [5h 4h 9h]
any2cardsxx: checks 
alex_matsuka: bets $4.17
any2cardsxx: raises $17.60 to $21.77
alex_matsuka: raises $58.81 to $80.58 and is all-in
any2cardsxx: calls $17.35 and is all-in
Uncalled bet ($41.46) returned to alex_matsuka
*** TURN *** [5h 4h 9h] [5c]
*** RIVER *** [5h 4h 9h 5c] [As]
*** SHOW DOWN ***
any2cardsxx: shows [6h 5s] (three of a kind, Fives)
alex_matsuka: shows [Ah Ac] (a full house, Aces full of Fives)
alex_matsuka collected $85.99 from pot
*** SUMMARY ***
Total pot $87.99 | Rake $2 
Board [5h 4h 9h 5c As]
Seat 1: alex_matsuka showed [Ah Ac] and won ($85.99) with a full house, Aces full of Fives
Seat 2: Mc57Arnold (button) folded before Flop (didn't bet)
Seat 3: Lemmi846 (small blind) folded before Flop
Seat 4: juwnas (big blind) folded before Flop
Seat 5: chiruha0523 folded before Flop (didn't bet)
Seat 6: RipZip folded before Flop (didn't bet)
Seat 7: any2cardsxx showed [6h 5s] and lost with three of a kind, Fives
Seat 8: ludemix folded before Flop (didn't bet)
Seat 9: siskin vrach folded before Flop (didn't bet)



PokerStars Hand #228682710069:  Hold'em No Limit ($0.25/$0.50 USD) - 2021/07/30 12:42:52 ET
Table 'Aitne III' 9-max Seat #3 is the button
Seat 1: alex_matsuka ($127.45 in chips) 
Seat 2: Mc57Arnold ($56.14 in chips) 
Seat 3: Lemmi846 ($57.10 in chips) 
Seat 4: juwnas ($53.62 in chips) 
Seat 5: chiruha0523 ($28.04 in chips) 
Seat 6: RipZip ($53.80 in chips) 
Seat 8: ludemix ($76.68 in chips) 
Seat 9: siskin vrach ($106.90 in chips) 
juwnas: posts small blind $0.25
chiruha0523: posts big blind $0.50
*** HOLE CARDS ***
RipZip: folds 
ludemix: folds 
siskin vrach: folds 
alex_matsuka: folds 
Mc57Arnold: raises $0.85 to $1.35
Lemmi846: folds 
juwnas: folds 
chiruha0523: folds 
Uncalled bet ($0.85) returned to Mc57Arnold
Mc57Arnold collected $1.25 from pot
Mc57Arnold: doesn't show hand 
*** SUMMARY ***
Total pot $1.25 | Rake $0 
Seat 1: alex_matsuka folded before Flop (didn't bet)
Seat 2: Mc57Arnold collected ($1.25)
Seat 3: Lemmi846 (button) folded before Flop (didn't bet)
Seat 4: juwnas (small blind) folded before Flop
Seat 5: chiruha0523 (big blind) folded before Flop
Seat 6: RipZip folded before Flop (didn't bet)
Seat 8: ludemix folded before Flop (didn't bet)
Seat 9: siskin vrach folded before Flop (didn't bet)



PokerStars Hand #228682716074:  Hold'em No Limit ($0.25/$0.50 USD) - 2021/07/30 12:43:08 ET
Table 'Aitne III' 9-max Seat #4 is the button
Seat 1: alex_matsuka ($127.45 in chips) 
Seat 2: Mc57Arnold ($56.89 in chips) 
Seat 3: Lemmi846 ($57.10 in chips) 
Seat 4: juwnas ($53.37 in chips) 
Seat 5: chiruha0523 ($27.54 in chips) 
Seat 6: RipZip ($53.80 in chips) 
Seat 8: ludemix ($76.68 in chips) 
Seat 9: siskin vrach ($106.90 in chips) 
chiruha0523: posts small blind $0.25
RipZip: posts big blind $0.50
*** HOLE CARDS ***
ludemix: folds 
siskin vrach: folds 
alex_matsuka: folds 
Mc57Arnold: folds 
Lemmi846: folds 
juwnas: raises $1 to $1.50
chiruha0523: folds 
RipZip: calls $1
*** FLOP *** [As Ac 7c]
any2cardsxx is disconnected 
RipZip: checks 
juwnas: checks 
*** TURN *** [As Ac 7c] [5d]
RipZip: checks 
juwnas: bets $2.04
RipZip: calls $2.04
*** RIVER *** [As Ac 7c 5d] [5s]
RipZip: checks 
juwnas: bets $3.98
RipZip: calls $3.98
*** SHOW DOWN ***
juwnas: shows [Qc Ah] (a full house, Aces full of Fives)
RipZip: shows [Ad 3d] (a full house, Aces full of Fives)
RipZip collected $7.27 from pot
juwnas collected $7.26 from pot
*** SUMMARY ***
Total pot $15.29 | Rake $0.76 
Board [As Ac 7c 5d 5s]
Seat 1: alex_matsuka folded before Flop (didn't bet)
Seat 2: Mc57Arnold folded before Flop (didn't bet)
Seat 3: Lemmi846 folded before Flop (didn't bet)
Seat 4: juwnas (button) showed [Qc Ah] and won ($7.26) with a full house, Aces full of Fives
Seat 5: chiruha0523 (small blind) folded before Flop
Seat 6: RipZip (big blind) showed [Ad 3d] and won ($7.27) with a full house, Aces full of Fives
Seat 8: ludemix folded before Flop (didn't bet)
Seat 9: siskin vrach folded before Flop (didn't bet)



PokerStars Hand #228682735714:  Hold'em No Limit ($0.25/$0.50 USD) - 2021/07/30 12:44:01 ET
Table 'Aitne III' 9-max Seat #5 is the button
Seat 1: alex_matsuka ($127.45 in chips) 
Seat 2: Mc57Arnold ($56.89 in chips) 
Seat 3: Lemmi846 ($57.10 in chips) 
Seat 4: juwnas ($53.11 in chips) 
Seat 5: chiruha0523 ($27.29 in chips) 
Seat 6: RipZip ($53.55 in chips) 
Seat 8: ludemix ($76.68 in chips) 
Seat 9: siskin vrach ($106.90 in chips) 
RipZip: posts small blind $0.25
ludemix: posts big blind $0.50
*** HOLE CARDS ***
siskin vrach: folds 
alex_matsuka: raises $1 to $1.50
Mc57Arnold: folds 
Lemmi846: folds 
juwnas: folds 
chiruha0523: calls $1.50
RipZip: folds 
ludemix: folds 
*** FLOP *** [Kh 7h Ad]
alex_matsuka: checks 
chiruha0523: checks 
*** TURN *** [Kh 7h Ad] [Ah]
alex_matsuka: checks 
chiruha0523: bets $1.78
alex_matsuka: folds 
Uncalled bet ($1.78) returned to chiruha0523
chiruha0523 collected $3.56 from pot
chiruha0523: doesn't show hand 
*** SUMMARY ***
Total pot $3.75 | Rake $0.19 
Board [Kh 7h Ad Ah]
Seat 1: alex_matsuka folded on the Turn
Seat 2: Mc57Arnold folded before Flop (didn't bet)
Seat 3: Lemmi846 folded before Flop (didn't bet)
Seat 4: juwnas folded before Flop (didn't bet)
Seat 5: chiruha0523 (button) collected ($3.56)
Seat 6: RipZip (small blind) folded before Flop
Seat 8: ludemix (big blind) folded before Flop
Seat 9: siskin vrach folded before Flop (didn't bet)



PokerStars Hand #228682754604:  Hold'em No Limit ($0.25/$0.50 USD) - 2021/07/30 12:44:52 ET
Table 'Aitne III' 9-max Seat #6 is the button
Seat 1: alex_matsuka ($125.95 in chips) 
Seat 2: Mc57Arnold ($56.89 in chips) 
Seat 3: Lemmi846 ($57.10 in chips) 
Seat 4: juwnas ($53.11 in chips) 
Seat 5: chiruha0523 ($29.35 in chips) 
Seat 6: RipZip ($53.30 in chips) 
Seat 8: ludemix ($76.18 in chips) 
Seat 9: siskin vrach ($106.90 in chips) 
ludemix: posts small blind $0.25
siskin vrach: posts big blind $0.50
*** HOLE CARDS ***
alex_matsuka: raises $1 to $1.50
Mc57Arnold: folds 
Lemmi846: folds 
juwnas: folds 
chiruha0523: folds 
RipZip: folds 
ludemix: folds 
siskin vrach: calls $1
*** FLOP *** [Ac Ah 7c]
siskin vrach: checks 
alex_matsuka: bets $1.39
siskin vrach: calls $1.39
*** TURN *** [Ac Ah 7c] [2d]
siskin vrach: checks 
alex_matsuka: checks 
*** RIVER *** [Ac Ah 7c 2d] [4c]
siskin vrach: bets $2.50
alex_matsuka: folds 
Uncalled bet ($2.50) returned to siskin vrach
siskin vrach collected $5.73 from pot
*** SUMMARY ***
Total pot $6.03 | Rake $0.30 
Board [Ac Ah 7c 2d 4c]
Seat 1: alex_matsuka folded on the River
Seat 2: Mc57Arnold folded before Flop (didn't bet)
Seat 3: Lemmi846 folded before Flop (didn't bet)
Seat 4: juwnas folded before Flop (didn't bet)
Seat 5: chiruha0523 folded before Flop (didn't bet)
Seat 6: RipZip (button) folded before Flop (didn't bet)
Seat 8: ludemix (small blind) folded before Flop
Seat 9: siskin vrach (big blind) collected ($5.73)



PokerStars Hand #228682773510:  Hold'em No Limit ($0.25/$0.50 USD) - 2021/07/30 12:45:42 ET
Table 'Aitne III' 9-max Seat #8 is the button
Seat 1: alex_matsuka ($123.06 in chips) 
Seat 2: Mc57Arnold ($56.89 in chips) 
Seat 3: Lemmi846 ($57.10 in chips) 
Seat 4: juwnas ($53.11 in chips) 
Seat 5: chiruha0523 ($29.35 in chips) 
Seat 6: RipZip ($53.30 in chips) 
Seat 8: ludemix ($75.93 in chips) 
Seat 9: siskin vrach ($109.74 in chips) 
siskin vrach: posts small blind $0.25
alex_matsuka: posts big blind $0.50
*** HOLE CARDS ***
Mc57Arnold: raises $0.85 to $1.35
Lemmi846: folds 
juwnas: folds 
chiruha0523: folds 
RipZip: calls $1.35
ludemix: folds 
siskin vrach: calls $1.10
alex_matsuka: folds 
*** FLOP *** [Tc 5h 9d]
siskin vrach: bets $1.25
Mc57Arnold: calls $1.25
RipZip: folds 
*** TURN *** [Tc 5h 9d] [Kh]
siskin vrach: checks 
Mc57Arnold: bets $4.49
siskin vrach: folds 
Uncalled bet ($4.49) returned to Mc57Arnold
Mc57Arnold collected $6.70 from pot
Mc57Arnold: doesn't show hand 
*** SUMMARY ***
Total pot $7.05 | Rake $0.35 
Board [Tc 5h 9d Kh]
Seat 1: alex_matsuka (big blind) folded before Flop
Seat 2: Mc57Arnold collected ($6.70)
Seat 3: Lemmi846 folded before Flop (didn't bet)
Seat 4: juwnas folded before Flop (didn't bet)
Seat 5: chiruha0523 folded before Flop (didn't bet)
Seat 6: RipZip folded on the Flop
Seat 8: ludemix (button) folded before Flop (didn't bet)
Seat 9: siskin vrach (small blind) folded on the Turn



PokerStars Hand #228682794156:  Hold'em No Limit ($0.25/$0.50 USD) - 2021/07/30 12:46:30 ET
Table 'Aitne III' 9-max Seat #9 is the button
Seat 1: alex_matsuka ($122.56 in chips) 
Seat 3: Lemmi846 ($57.10 in chips) 
Seat 4: juwnas ($53.11 in chips) 
Seat 5: chiruha0523 ($29.35 in chips) 
Seat 6: RipZip ($51.95 in chips) 
Seat 8: ludemix ($75.93 in chips) 
Seat 9: siskin vrach ($107.14 in chips) 
alex_matsuka: posts small blind $0.25
Mc57Arnold: is sitting out 
Lemmi846: posts big blind $0.50
*** HOLE CARDS ***
Mc57Arnold leaves the table
juwnas: raises $1 to $1.50
chiruha0523: folds 
RipZip: folds 
ludemix: folds 
siskin vrach: calls $1.50
alex_matsuka: folds 
Lemmi846: folds 
*** FLOP *** [Jd 6s 3s]
juwnas: checks 
siskin vrach: checks 
*** TURN *** [Jd 6s 3s] [5d]
juwnas: checks 
siskin vrach: bets $2
juwnas: folds 
Uncalled bet ($2) returned to siskin vrach
dstrola joins the table at seat #2 
siskin vrach collected $3.56 from pot
*** SUMMARY ***
Total pot $3.75 | Rake $0.19 
Board [Jd 6s 3s 5d]
Seat 1: alex_matsuka (small blind) folded before Flop
Seat 3: Lemmi846 (big blind) folded before Flop
Seat 4: juwnas folded on the Turn
Seat 5: chiruha0523 folded before Flop (didn't bet)
Seat 6: RipZip folded before Flop (didn't bet)
Seat 8: ludemix folded before Flop (didn't bet)
Seat 9: siskin vrach (button) collected ($3.56)



PokerStars Hand #228682804847:  Hold'em No Limit ($0.25/$0.50 USD) - 2021/07/30 12:46:59 ET
Table 'Aitne III' 9-max Seat #1 is the button
Seat 1: alex_matsuka ($122.31 in chips) 
Seat 3: Lemmi846 ($56.60 in chips) 
Seat 4: juwnas ($51.61 in chips) 
Seat 5: chiruha0523 ($29.35 in chips) 
Seat 6: RipZip ($51.95 in chips) 
Seat 8: ludemix ($75.93 in chips) 
Seat 9: siskin vrach ($109.20 in chips) 
Lemmi846: posts small blind $0.25
juwnas: posts big blind $0.50
*** HOLE CARDS ***
chiruha0523: folds 
RipZip: folds 
ludemix: folds 
siskin vrach: folds 
alex_matsuka: raises $1 to $1.50
Lemmi846: folds 
juwnas: raises $3 to $4.50
alex_matsuka: raises $6 to $10.50
juwnas: calls $6
*** FLOP *** [Ad 8c Ts]
juwnas: checks 
alex_matsuka: bets $9.09
juwnas: calls $9.09
*** TURN *** [Ad 8c Ts] [6s]
juwnas: checks 
alex_matsuka: bets $35
juwnas: calls $32.02 and is all-in
Uncalled bet ($2.98) returned to alex_matsuka
*** RIVER *** [Ad 8c Ts 6s] [Qh]
*** SHOW DOWN ***
juwnas: shows [Ac Qc] (two pair, Aces and Queens)
alex_matsuka: shows [As Kc] (a pair of Aces)
juwnas collected $101.47 from pot
*** SUMMARY ***
Total pot $103.47 | Rake $2 
Board [Ad 8c Ts 6s Qh]
Seat 1: alex_matsuka (button) showed [As Kc] and lost with a pair of Aces
Seat 3: Lemmi846 (small blind) folded before Flop
Seat 4: juwnas (big blind) showed [Ac Qc] and won ($101.47) with two pair, Aces and Queens
Seat 5: chiruha0523 folded before Flop (didn't bet)
Seat 6: RipZip folded before Flop (didn't bet)
Seat 8: ludemix folded before Flop (didn't bet)
Seat 9: siskin vrach folded before Flop (didn't bet)



PokerStars Hand #228682838729:  Hold'em No Limit ($0.25/$0.50 USD) - 2021/07/30 12:48:28 ET
Table 'Aitne III' 9-max Seat #3 is the button
Seat 1: alex_matsuka ($70.70 in chips) 
Seat 2: dstrola ($51.72 in chips) 
Seat 3: Lemmi846 ($56.35 in chips) 
Seat 5: chiruha0523 ($29.35 in chips) 
Seat 6: RipZip ($51.95 in chips) 
Seat 8: ludemix ($75.93 in chips) 
Seat 9: siskin vrach ($109.20 in chips) 
chiruha0523: posts small blind $0.25
RipZip: posts big blind $0.50
dstrola: posts big blind $0.50
*** HOLE CARDS ***
ludemix: folds 
siskin vrach: folds 
alex_matsuka has timed out
alex_matsuka: folds 
dstrola: raises $1 to $1.50
Lemmi846: folds 
chiruha0523: folds 
RipZip: calls $1
*** FLOP *** [Qd Qc Qs]
RipZip: checks 
dstrola: bets $1.50
RipZip: folds 
Uncalled bet ($1.50) returned to dstrola
dstrola collected $3.09 from pot
*** SUMMARY ***
Total pot $3.25 | Rake $0.16 
Board [Qd Qc Qs]
Seat 1: alex_matsuka folded before Flop (didn't bet)
Seat 2: dstrola collected ($3.09)
Seat 3: Lemmi846 (button) folded before Flop (didn't bet)
Seat 5: chiruha0523 (small blind) folded before Flop
Seat 6: RipZip (big blind) folded on the Flop
Seat 8: ludemix folded before Flop (didn't bet)
Seat 9: siskin vrach folded before Flop (didn't bet)



PokerStars Hand #228682855292:  Hold'em No Limit ($0.25/$0.50 USD) - 2021/07/30 12:49:12 ET
Table 'Aitne III' 9-max Seat #5 is the button
Seat 1: alex_matsuka ($70.70 in chips) 
Seat 2: dstrola ($53.31 in chips) 
Seat 3: Lemmi846 ($56.35 in chips) 
Seat 4: juwnas ($101.47 in chips) 
Seat 5: chiruha0523 ($29.10 in chips) 
Seat 6: RipZip ($50.45 in chips) 
Seat 8: ludemix ($75.93 in chips) 
Seat 9: siskin vrach ($109.20 in chips) 
RipZip: posts small blind $0.25
ludemix: posts big blind $0.50
juwnas: posts small blind $0.25
*** HOLE CARDS ***
siskin vrach: folds 
alex_matsuka: folds 
dstrola: folds 
Lemmi846: folds 
juwnas: folds 
chiruha0523: folds 
RipZip: folds 
Uncalled bet ($0.25) returned to ludemix
ludemix collected $0.75 from pot
ludemix: doesn't show hand 
*** SUMMARY ***
Total pot $0.75 | Rake $0 
Seat 1: alex_matsuka folded before Flop (didn't bet)
Seat 2: dstrola folded before Flop (didn't bet)
Seat 3: Lemmi846 folded before Flop (didn't bet)
Seat 4: juwnas folded before Flop (didn't bet)
Seat 5: chiruha0523 (button) folded before Flop (didn't bet)
Seat 6: RipZip (small blind) folded before Flop
Seat 8: ludemix (big blind) collected ($0.75)
Seat 9: siskin vrach folded before Flop (didn't bet)



PokerStars Hand #228682864083:  Hold'em No Limit ($0.25/$0.50 USD) - 2021/07/30 12:49:35 ET
Table 'Aitne III' 9-max Seat #6 is the button
Seat 1: alex_matsuka ($70.70 in chips) 
Seat 3: Lemmi846 ($56.35 in chips) 
Seat 4: juwnas ($101.22 in chips) 
Seat 5: chiruha0523 ($29.10 in chips) 
Seat 6: RipZip ($50.20 in chips) 
Seat 8: ludemix ($76.43 in chips) 
Seat 9: siskin vrach ($109.20 in chips) 
ludemix: posts small blind $0.25
siskin vrach: posts big blind $0.50
*** HOLE CARDS ***
alex_matsuka: folds 
Lemmi846: folds 
juwnas: folds 
chiruha0523: folds 
chiruha0523 leaves the table
RipZip: raises $0.75 to $1.25
ludemix: folds 
siskin vrach: calls $0.75
*** FLOP *** [Td 7s 6d]
siskin vrach: checks 
RipZip: bets $1.31
siskin vrach: calls $1.31
*** TURN *** [Td 7s 6d] [Tc]
BARBURIA joins the table at seat #5 
juwnas is disconnected 
siskin vrach: checks 
RipZip: bets $3.83
siskin vrach: calls $3.83
*** RIVER *** [Td 7s 6d Tc] [5s]
siskin vrach has timed out
siskin vrach: checks 
RipZip: checks 
*** SHOW DOWN ***
siskin vrach: shows [8c 9d] (a straight, Six to Ten)
RipZip: mucks hand 
siskin vrach collected $12.38 from pot
*** SUMMARY ***
Total pot $13.03 | Rake $0.65 
Board [Td 7s 6d Tc 5s]
Seat 1: alex_matsuka folded before Flop (didn't bet)
Seat 3: Lemmi846 folded before Flop (didn't bet)
Seat 4: juwnas folded before Flop (didn't bet)
Seat 5: chiruha0523 folded before Flop (didn't bet)
Seat 6: RipZip (button) mucked
Seat 8: ludemix (small blind) folded before Flop
Seat 9: siskin vrach (big blind) showed [8c 9d] and won ($12.38) with a straight, Six to Ten



PokerStars Hand #228682910216:  Hold'em No Limit ($0.25/$0.50 USD) - 2021/07/30 12:51:37 ET
Table 'Aitne III' 9-max Seat #8 is the button
Seat 1: alex_matsuka ($70.70 in chips) 
Seat 3: Lemmi846 ($56.35 in chips) 
Seat 4: juwnas ($101.22 in chips) 
Seat 6: RipZip ($50 in chips) 
Seat 8: ludemix ($76.18 in chips) 
Seat 9: siskin vrach ($115.19 in chips) 
siskin vrach: posts small blind $0.25
alex_matsuka: posts big blind $0.50
BARBURIA: sits out 
*** HOLE CARDS ***
Lemmi846: folds 
juwnas: raises $1 to $1.50
RipZip: folds 
ludemix: folds 
siskin vrach: folds 
alex_matsuka: folds 
Uncalled bet ($1) returned to juwnas
juwnas collected $1.25 from pot
juwnas: doesn't show hand 
*** SUMMARY ***
Total pot $1.25 | Rake $0 
Seat 1: alex_matsuka (big blind) folded before Flop
Seat 3: Lemmi846 folded before Flop (didn't bet)
Seat 4: juwnas collected ($1.25)
Seat 6: RipZip folded before Flop (didn't bet)
Seat 8: ludemix (button) folded before Flop (didn't bet)
Seat 9: siskin vrach (small blind) folded before Flop



PokerStars Hand #228682919542:  Hold'em No Limit ($0.25/$0.50 USD) - 2021/07/30 12:52:01 ET
Table 'Aitne III' 9-max Seat #9 is the button
Seat 1: alex_matsuka ($70.20 in chips) 
Seat 3: Lemmi846 ($56.35 in chips) 
Seat 4: juwnas ($101.97 in chips) 
Seat 6: RipZip ($50 in chips) 
Seat 8: ludemix ($76.18 in chips) 
Seat 9: siskin vrach ($114.94 in chips) 
alex_matsuka: posts small blind $0.25
Lemmi846: posts big blind $0.50
BARBURIA: sits out 
*** HOLE CARDS ***
juwnas: folds 
RipZip: folds 
ludemix: raises $0.75 to $1.25
siskin vrach: folds 
alex_matsuka: folds 
Lemmi846: folds 
Uncalled bet ($0.75) returned to ludemix
ludemix collected $1.25 from pot
ludemix: doesn't show hand 
*** SUMMARY ***
Total pot $1.25 | Rake $0 
Seat 1: alex_matsuka (small blind) folded before Flop
Seat 3: Lemmi846 (big blind) folded before Flop
Seat 4: juwnas folded before Flop (didn't bet)
Seat 6: RipZip folded before Flop (didn't bet)
Seat 8: ludemix collected ($1.25)
Seat 9: siskin vrach (button) folded before Flop (didn't bet)



PokerStars Hand #228682929078:  Hold'em No Limit ($0.25/$0.50 USD) - 2021/07/30 12:52:26 ET
Table 'Aitne III' 9-max Seat #1 is the button
Seat 1: alex_matsuka ($69.95 in chips) 
Seat 3: Lemmi846 ($55.85 in chips) 
Seat 4: juwnas ($101.97 in chips) 
Seat 6: RipZip ($50 in chips) 
Seat 8: ludemix ($76.93 in chips) 
Seat 9: siskin vrach ($114.94 in chips) 
Lemmi846: posts small blind $0.25
juwnas: posts big blind $0.50
BARBURIA: sits out 
*** HOLE CARDS ***
RipZip: folds 
ludemix: folds 
siskin vrach: folds 
alex_matsuka: raises $1 to $1.50
Lemmi846: folds 
juwnas: folds 
Uncalled bet ($1) returned to alex_matsuka
alex_matsuka collected $1.25 from pot
alex_matsuka: doesn't show hand 
*** SUMMARY ***
Total pot $1.25 | Rake $0 
Seat 1: alex_matsuka (button) collected ($1.25)
Seat 3: Lemmi846 (small blind) folded before Flop
Seat 4: juwnas (big blind) folded before Flop
Seat 6: RipZip folded before Flop (didn't bet)
Seat 8: ludemix folded before Flop (didn't bet)
Seat 9: siskin vrach folded before Flop (didn't bet)



PokerStars Hand #228682937966:  Hold'em No Limit ($0.25/$0.50 USD) - 2021/07/30 12:52:50 ET
Table 'Aitne III' 9-max Seat #3 is the button
Seat 1: alex_matsuka ($70.70 in chips) 
Seat 3: Lemmi846 ($55.60 in chips) 
Seat 4: juwnas ($101.47 in chips) 
Seat 5: BARBURIA ($20 in chips) 
Seat 6: RipZip ($50 in chips) 
Seat 8: ludemix ($76.93 in chips) 
Seat 9: siskin vrach ($114.94 in chips) 
juwnas: posts small blind $0.25
BARBURIA: posts big blind $0.50
*** HOLE CARDS ***
RipZip: folds 
ludemix: folds 
siskin vrach: folds 
alex_matsuka: folds 
Lemmi846: folds 
juwnas: calls $0.25
BARBURIA: checks 
*** FLOP *** [5d 9d 5s]
juwnas: checks 
BARBURIA: bets $0.95
juwnas: folds 
Uncalled bet ($0.95) returned to BARBURIA
BARBURIA collected $0.95 from pot
BARBURIA: doesn't show hand 
*** SUMMARY ***
Total pot $1 | Rake $0.05 
Board [5d 9d 5s]
Seat 1: alex_matsuka folded before Flop (didn't bet)
Seat 3: Lemmi846 (button) folded before Flop (didn't bet)
Seat 4: juwnas (small blind) folded on the Flop
Seat 5: BARBURIA (big blind) collected ($0.95)
Seat 6: RipZip folded before Flop (didn't bet)
Seat 8: ludemix folded before Flop (didn't bet)
Seat 9: siskin vrach folded before Flop (didn't bet)



PokerStars Hand #228682953022:  Hold'em No Limit ($0.25/$0.50 USD) - 2021/07/30 12:53:30 ET
Table 'Aitne III' 9-max Seat #4 is the button
Seat 1: alex_matsuka ($70.70 in chips) 
Seat 3: Lemmi846 ($55.60 in chips) 
Seat 4: juwnas ($100.97 in chips) 
Seat 5: BARBURIA ($20.45 in chips) 
Seat 6: RipZip ($50 in chips) 
Seat 8: ludemix ($76.93 in chips) 
Seat 9: siskin vrach ($114.94 in chips) 
BARBURIA: posts small blind $0.25
RipZip: posts big blind $0.50
*** HOLE CARDS ***
any2cardsxx was removed from the table for failing to post
any2cardsxx leaves the table
ludemix: folds 
siskin vrach: folds 
alex_matsuka: folds 
Lemmi846: folds 
juwnas: folds 
BARBURIA: folds 
Uncalled bet ($0.25) returned to RipZip
RipZip collected $0.50 from pot
RipZip: doesn't show hand 
*** SUMMARY ***
Total pot $0.50 | Rake $0 
Seat 1: alex_matsuka folded before Flop (didn't bet)
Seat 3: Lemmi846 folded before Flop (didn't bet)
Seat 4: juwnas (button) folded before Flop (didn't bet)
Seat 5: BARBURIA (small blind) folded before Flop
Seat 6: RipZip (big blind) collected ($0.50)
Seat 8: ludemix folded before Flop (didn't bet)
Seat 9: siskin vrach folded before Flop (didn't bet)



PokerStars Hand #228682960009:  Hold'em No Limit ($0.25/$0.50 USD) - 2021/07/30 12:53:48 ET
Table 'Aitne III' 9-max Seat #5 is the button
Seat 1: alex_matsuka ($70.70 in chips) 
Seat 3: Lemmi846 ($55.60 in chips) 
Seat 4: juwnas ($100.97 in chips) 
Seat 5: BARBURIA ($20.20 in chips) 
Seat 6: RipZip ($50.25 in chips) 
Seat 8: ludemix ($76.93 in chips) 
Seat 9: siskin vrach ($114.94 in chips) 
RipZip: posts small blind $0.25
ludemix: posts big blind $0.50
*** HOLE CARDS ***
siskin vrach: folds 
alex_matsuka: folds 
Lemmi846: raises $0.50 to $1
juwnas: folds 
BARBURIA: folds 
RipZip: folds 
ludemix: folds 
Uncalled bet ($0.50) returned to Lemmi846
Lemmi846 collected $1.25 from pot
Lemmi846: doesn't show hand 
*** SUMMARY ***
Total pot $1.25 | Rake $0 
Seat 1: alex_matsuka folded before Flop (didn't bet)
Seat 3: Lemmi846 collected ($1.25)
Seat 4: juwnas folded before Flop (didn't bet)
Seat 5: BARBURIA (button) folded before Flop (didn't bet)
Seat 6: RipZip (small blind) folded before Flop
Seat 8: ludemix (big blind) folded before Flop
Seat 9: siskin vrach folded before Flop (didn't bet)



PokerStars Hand #228682968446:  Hold'em No Limit ($0.25/$0.50 USD) - 2021/07/30 12:54:11 ET
Table 'Aitne III' 9-max Seat #6 is the button
Seat 1: alex_matsuka ($70.70 in chips) 
Seat 3: Lemmi846 ($56.35 in chips) 
Seat 4: juwnas ($100.97 in chips) 
Seat 5: BARBURIA ($20.20 in chips) 
Seat 6: RipZip ($50 in chips) 
Seat 8: ludemix ($76.43 in chips) 
Seat 9: siskin vrach ($114.94 in chips) 
ludemix: posts small blind $0.25
siskin vrach: posts big blind $0.50
*** HOLE CARDS ***
alex_matsuka: folds 
$imo422 joins the table at seat #7 
Lemmi846: raises $1 to $1.50
juwnas: folds 
BARBURIA: calls $1.50
RipZip: calls $1.50
ludemix: folds 
siskin vrach: calls $1
*** FLOP *** [7s 5c Qd]
siskin vrach: checks 
Lemmi846: bets $3
BARBURIA: folds 
RipZip: folds 
siskin vrach: calls $3
*** TURN *** [7s 5c Qd] [6s]
siskin vrach: checks 
Lemmi846: bets $6.50
siskin vrach: calls $6.50
*** RIVER *** [7s 5c Qd 6s] [Tc]
siskin vrach: checks 
Lemmi846: checks 
*** SHOW DOWN ***
siskin vrach: shows [Qs Ks] (a pair of Queens)
Lemmi846: shows [As Qh] (a pair of Queens - Ace kicker)
Lemmi846 collected $23.67 from pot
*** SUMMARY ***
Total pot $25.25 | Rake $1.58 
Board [7s 5c Qd 6s Tc]
Seat 1: alex_matsuka folded before Flop (didn't bet)
Seat 3: Lemmi846 showed [As Qh] and won ($23.67) with a pair of Queens
Seat 4: juwnas folded before Flop (didn't bet)
Seat 5: BARBURIA folded on the Flop
Seat 6: RipZip (button) folded on the Flop
Seat 8: ludemix (small blind) folded before Flop
Seat 9: siskin vrach (big blind) showed [Qs Ks] and lost with a pair of Queens



PokerStars Hand #228682994837:  Hold'em No Limit ($0.25/$0.50 USD) - 2021/07/30 12:55:24 ET
Table 'Aitne III' 9-max Seat #8 is the button
Seat 1: alex_matsuka ($70.70 in chips) 
Seat 3: Lemmi846 ($69.02 in chips) 
Seat 4: juwnas ($100.97 in chips) 
Seat 5: BARBURIA ($18.70 in chips) 
Seat 6: RipZip ($48.50 in chips) 
Seat 7: $imo422 ($50 in chips) 
Seat 8: ludemix ($76.18 in chips) 
Seat 9: siskin vrach ($103.94 in chips) 
siskin vrach: posts small blind $0.25
alex_matsuka: posts big blind $0.50
$imo422: posts big blind $0.50
*** HOLE CARDS ***
Lemmi846: calls $0.50
juwnas: folds 
BARBURIA: raises $1.25 to $1.75
RipZip: folds 
$imo422: calls $1.25
ludemix: folds 
siskin vrach: folds 
alex_matsuka: folds 
Lemmi846: folds 
*** FLOP *** [3d 4s Qc]
BARBURIA: checks 
$imo422: bets $2.26
BARBURIA: calls $2.26
*** TURN *** [3d 4s Qc] [Jc]
BARBURIA: checks 
$imo422: checks 
*** RIVER *** [3d 4s Qc Jc] [Kh]
BARBURIA: bets $3.90
$imo422: folds 
Uncalled bet ($3.90) returned to BARBURIA
BARBURIA collected $8.81 from pot
BARBURIA: doesn't show hand 
*** SUMMARY ***
Total pot $9.27 | Rake $0.46 
Board [3d 4s Qc Jc Kh]
Seat 1: alex_matsuka (big blind) folded before Flop
Seat 3: Lemmi846 folded before Flop
Seat 4: juwnas folded before Flop (didn't bet)
Seat 5: BARBURIA collected ($8.81)
Seat 6: RipZip folded before Flop (didn't bet)
Seat 7: $imo422 folded on the River
Seat 8: ludemix (button) folded before Flop (didn't bet)
Seat 9: siskin vrach (small blind) folded before Flop



PokerStars Hand #228683015396:  Hold'em No Limit ($0.25/$0.50 USD) - 2021/07/30 12:56:36 ET
Table 'Aitne III' 9-max Seat #9 is the button
Seat 1: alex_matsuka ($70.20 in chips) 
Seat 3: Lemmi846 ($68.52 in chips) 
Seat 4: juwnas ($100.97 in chips) 
Seat 5: BARBURIA ($23.50 in chips) 
Seat 6: RipZip ($50 in chips) 
Seat 7: $imo422 ($45.99 in chips) 
Seat 8: ludemix ($76.18 in chips) 
Seat 9: siskin vrach ($103.69 in chips) 
alex_matsuka: posts small blind $0.25
Lemmi846: posts big blind $0.50
*** HOLE CARDS ***
juwnas: folds 
BARBURIA: folds 
RipZip: raises $0.75 to $1.25
$imo422: folds 
ludemix: folds 
siskin vrach: folds 
alex_matsuka: calls $1
Lemmi846: folds 
*** FLOP *** [Th 2h 9s]
alex_matsuka: checks 
RipZip: bets $1.43
alex_matsuka: raises $4 to $5.43
RipZip: calls $4
*** TURN *** [Th 2h 9s] [Kh]
alex_matsuka: bets $9.22
RipZip: folds 
Uncalled bet ($9.22) returned to alex_matsuka
alex_matsuka collected $13.17 from pot
alex_matsuka: doesn't show hand 
*** SUMMARY ***
Total pot $13.86 | Rake $0.69 
Board [Th 2h 9s Kh]
Seat 1: alex_matsuka (small blind) collected ($13.17)
Seat 3: Lemmi846 (big blind) folded before Flop
Seat 4: juwnas folded before Flop (didn't bet)
Seat 5: BARBURIA folded before Flop (didn't bet)
Seat 6: RipZip folded on the Turn
Seat 7: $imo422 folded before Flop (didn't bet)
Seat 8: ludemix folded before Flop (didn't bet)
Seat 9: siskin vrach (button) folded before Flop (didn't bet)



PokerStars Hand #228683034871:  Hold'em No Limit ($0.25/$0.50 USD) - 2021/07/30 12:57:44 ET
Table 'Aitne III' 9-max Seat #1 is the button
Seat 1: alex_matsuka ($76.69 in chips) 
Seat 3: Lemmi846 ($68.02 in chips) 
Seat 4: juwnas ($100.97 in chips) 
Seat 5: BARBURIA ($23.50 in chips) 
Seat 6: RipZip ($50 in chips) 
Seat 7: $imo422 ($45.99 in chips) 
Seat 8: ludemix ($76.18 in chips) 
Seat 9: siskin vrach ($103.69 in chips) 
Lemmi846: posts small blind $0.25
juwnas: posts big blind $0.50
*** HOLE CARDS ***
BARBURIA: folds 
RipZip: folds 
$imo422: folds 
ludemix: folds 
siskin vrach: folds 
alex_matsuka: folds 
BARBURIA leaves the table
x_ROSH125_x joins the table at seat #5 
Lemmi846: folds 
Uncalled bet ($0.25) returned to juwnas
juwnas collected $0.50 from pot
juwnas: doesn't show hand 
*** SUMMARY ***
Total pot $0.50 | Rake $0 
Seat 1: alex_matsuka (button) folded before Flop (didn't bet)
Seat 3: Lemmi846 (small blind) folded before Flop
Seat 4: juwnas (big blind) collected ($0.50)
Seat 5: BARBURIA folded before Flop (didn't bet)
Seat 6: RipZip folded before Flop (didn't bet)
Seat 7: $imo422 folded before Flop (didn't bet)
Seat 8: ludemix folded before Flop (didn't bet)
Seat 9: siskin vrach folded before Flop (didn't bet)



PokerStars Hand #228683039150:  Hold'em No Limit ($0.25/$0.50 USD) - 2021/07/30 12:57:59 ET
Table 'Aitne III' 9-max Seat #3 is the button
Seat 1: alex_matsuka ($76.69 in chips) 
Seat 3: Lemmi846 ($67.77 in chips) 
Seat 4: juwnas ($101.22 in chips) 
Seat 5: x_ROSH125_x ($50 in chips) 
Seat 6: RipZip ($50 in chips) 
Seat 7: $imo422 ($45.99 in chips) 
Seat 8: ludemix ($76.18 in chips) 
Seat 9: siskin vrach ($103.69 in chips) 
juwnas: posts small blind $0.25
x_ROSH125_x: posts big blind $0.50
*** HOLE CARDS ***
RipZip: folds 
$imo422: folds 
ludemix: folds 
siskin vrach: folds 
alex_matsuka: folds 
Lemmi846: folds 
juwnas: raises $1 to $1.50
x_ROSH125_x: calls $1
*** FLOP *** [7h 4h 6s]
juwnas: bets $1.42
x_ROSH125_x: raises $4.10 to $5.52
juwnas: folds 
Uncalled bet ($4.10) returned to x_ROSH125_x
x_ROSH125_x collected $5.55 from pot
x_ROSH125_x: doesn't show hand 
*** SUMMARY ***
Total pot $5.84 | Rake $0.29 
Board [7h 4h 6s]
Seat 1: alex_matsuka folded before Flop (didn't bet)
Seat 3: Lemmi846 (button) folded before Flop (didn't bet)
Seat 4: juwnas (small blind) folded on the Flop
Seat 5: x_ROSH125_x (big blind) collected ($5.55)
Seat 6: RipZip folded before Flop (didn't bet)
Seat 7: $imo422 folded before Flop (didn't bet)
Seat 8: ludemix folded before Flop (didn't bet)
Seat 9: siskin vrach folded before Flop (didn't bet)



PokerStars Hand #228683050431:  Hold'em No Limit ($0.25/$0.50 USD) - 2021/07/30 12:58:37 ET
Table 'Aitne III' 9-max Seat #4 is the button
Seat 1: alex_matsuka ($76.69 in chips) 
Seat 3: Lemmi846 ($67.77 in chips) 
Seat 4: juwnas ($98.30 in chips) 
Seat 5: x_ROSH125_x ($52.63 in chips) 
Seat 6: RipZip ($50 in chips) 
Seat 7: $imo422 ($45.99 in chips) 
Seat 8: ludemix ($76.18 in chips) 
Seat 9: siskin vrach ($103.69 in chips) 
x_ROSH125_x: posts small blind $0.25
RipZip: posts big blind $0.50
*** HOLE CARDS ***
$imo422: folds 
ludemix: folds 
siskin vrach: folds 
alex_matsuka: folds 
Lemmi846: folds 
juwnas: raises $1 to $1.50
x_ROSH125_x: folds 
RipZip: raises $3.25 to $4.75
juwnas: calls $3.25
*** FLOP *** [8h 2c 8d]
RipZip: bets $4.63
juwnas: folds 
Uncalled bet ($4.63) returned to RipZip
RipZip collected $9.26 from pot
RipZip: doesn't show hand 
*** SUMMARY ***
Total pot $9.75 | Rake $0.49 
Board [8h 2c 8d]
Seat 1: alex_matsuka folded before Flop (didn't bet)
Seat 3: Lemmi846 folded before Flop (didn't bet)
Seat 4: juwnas (button) folded on the Flop
Seat 5: x_ROSH125_x (small blind) folded before Flop
Seat 6: RipZip (big blind) collected ($9.26)
Seat 7: $imo422 folded before Flop (didn't bet)
Seat 8: ludemix folded before Flop (didn't bet)
Seat 9: siskin vrach folded before Flop (didn't bet)



PokerStars Hand #228683058624:  Hold'em No Limit ($0.25/$0.50 USD) - 2021/07/30 12:59:05 ET
Table 'Aitne III' 9-max Seat #5 is the button
Seat 1: alex_matsuka ($76.69 in chips) 
Seat 3: Lemmi846 ($67.77 in chips) 
Seat 4: juwnas ($93.55 in chips) 
Seat 5: x_ROSH125_x ($52.38 in chips) 
Seat 6: RipZip ($54.51 in chips) 
Seat 7: $imo422 ($45.99 in chips) 
Seat 8: ludemix ($76.18 in chips) 
Seat 9: siskin vrach ($103.69 in chips) 
RipZip: posts small blind $0.25
$imo422: posts big blind $0.50
*** HOLE CARDS ***
ludemix: folds 
siskin vrach: folds 
alex_matsuka: folds 
Lemmi846: folds 
juwnas: folds 
x_ROSH125_x: raises $0.50 to $1
RipZip: folds 
$imo422: folds 
Uncalled bet ($0.50) returned to x_ROSH125_x
x_ROSH125_x collected $1.25 from pot
x_ROSH125_x: doesn't show hand 
*** SUMMARY ***
Total pot $1.25 | Rake $0 
Seat 1: alex_matsuka folded before Flop (didn't bet)
Seat 3: Lemmi846 folded before Flop (didn't bet)
Seat 4: juwnas folded before Flop (didn't bet)
Seat 5: x_ROSH125_x (button) collected ($1.25)
Seat 6: RipZip (small blind) folded before Flop
Seat 7: $imo422 (big blind) folded before Flop
Seat 8: ludemix folded before Flop (didn't bet)
Seat 9: siskin vrach folded before Flop (didn't bet)



PokerStars Hand #228683062957:  Hold'em No Limit ($0.25/$0.50 USD) - 2021/07/30 12:59:20 ET
Table 'Aitne III' 9-max Seat #6 is the button
Seat 1: alex_matsuka ($76.69 in chips) 
Seat 3: Lemmi846 ($67.77 in chips) 
Seat 4: juwnas ($93.55 in chips) 
Seat 5: x_ROSH125_x ($53.13 in chips) 
Seat 6: RipZip ($54.26 in chips) 
Seat 7: $imo422 ($45.49 in chips) 
Seat 8: ludemix ($76.18 in chips) 
Seat 9: siskin vrach ($103.69 in chips) 
$imo422: posts small blind $0.25
ludemix: posts big blind $0.50
*** HOLE CARDS ***
siskin vrach: folds 
alex_matsuka: folds 
Lemmi846: folds 
juwnas: folds 
x_ROSH125_x: folds 
RipZip: raises $0.75 to $1.25
$imo422: folds 
ludemix: calls $0.75
*** FLOP *** [4s 7h 2h]
ludemix: checks 
RipZip: checks 
*** TURN *** [4s 7h 2h] [7d]
ludemix: bets $1.96
RipZip: folds 
Uncalled bet ($1.96) returned to ludemix
ludemix collected $2.61 from pot
ludemix: doesn't show hand 
*** SUMMARY ***
Total pot $2.75 | Rake $0.14 
Board [4s 7h 2h 7d]
Seat 1: alex_matsuka folded before Flop (didn't bet)
Seat 3: Lemmi846 folded before Flop (didn't bet)
Seat 4: juwnas folded before Flop (didn't bet)
Seat 5: x_ROSH125_x folded before Flop (didn't bet)
Seat 6: RipZip (button) folded on the Turn
Seat 7: $imo422 (small blind) folded before Flop
Seat 8: ludemix (big blind) collected ($2.61)
Seat 9: siskin vrach folded before Flop (didn't bet)



PokerStars Hand #228683074833:  Hold'em No Limit ($0.25/$0.50 USD) - 2021/07/30 13:00:01 ET
Table 'Aitne III' 9-max Seat #7 is the button
Seat 1: alex_matsuka ($76.69 in chips) 
Seat 3: Lemmi846 ($67.77 in chips) 
Seat 4: juwnas ($93.55 in chips) 
Seat 5: x_ROSH125_x ($53.13 in chips) 
Seat 6: RipZip ($53.01 in chips) 
Seat 7: $imo422 ($45.24 in chips) 
Seat 8: ludemix ($77.54 in chips) 
Seat 9: siskin vrach ($103.69 in chips) 
ludemix: posts small blind $0.25
siskin vrach: posts big blind $0.50
*** HOLE CARDS ***
alex_matsuka: folds 
Lemmi846: folds 
juwnas: folds 
x_ROSH125_x: raises $1 to $1.50
RipZip: folds 
$imo422: calls $1.50
ludemix: folds 
siskin vrach: calls $1
*** FLOP *** [2d 2c Qs]
siskin vrach: checks 
x_ROSH125_x: bets $2.30
$imo422: folds 
siskin vrach: folds 
Uncalled bet ($2.30) returned to x_ROSH125_x
x_ROSH125_x collected $4.51 from pot
x_ROSH125_x: doesn't show hand 
*** SUMMARY ***
Total pot $4.75 | Rake $0.24 
Board [2d 2c Qs]
Seat 1: alex_matsuka folded before Flop (didn't bet)
Seat 3: Lemmi846 folded before Flop (didn't bet)
Seat 4: juwnas folded before Flop (didn't bet)
Seat 5: x_ROSH125_x collected ($4.51)
Seat 6: RipZip folded before Flop (didn't bet)
Seat 7: $imo422 (button) folded on the Flop
Seat 8: ludemix (small blind) folded before Flop
Seat 9: siskin vrach (big blind) folded on the Flop



PokerStars Hand #228683089841:  Hold'em No Limit ($0.25/$0.50 USD) - 2021/07/30 13:00:48 ET
Table 'Aitne III' 9-max Seat #8 is the button
Seat 1: alex_matsuka ($76.69 in chips) 
Seat 3: Lemmi846 ($67.77 in chips) 
Seat 4: juwnas ($93.55 in chips) 
Seat 5: x_ROSH125_x ($56.14 in chips) 
Seat 6: RipZip ($53.01 in chips) 
Seat 7: $imo422 ($43.74 in chips) 
Seat 8: ludemix ($77.29 in chips) 
Seat 9: siskin vrach ($102.19 in chips) 
siskin vrach: posts small blind $0.25
alex_matsuka: posts big blind $0.50
dstrola: sits out 
*** HOLE CARDS ***
Lemmi846: folds 
juwnas has timed out
juwnas: folds 
x_ROSH125_x: folds 
RipZip: folds 
$imo422: folds 
ludemix: folds 
siskin vrach: folds 
Uncalled bet ($0.25) returned to alex_matsuka
alex_matsuka collected $0.50 from pot
alex_matsuka: doesn't show hand 
*** SUMMARY ***
Total pot $0.50 | Rake $0 
Seat 1: alex_matsuka (big blind) collected ($0.50)
Seat 3: Lemmi846 folded before Flop (didn't bet)
Seat 4: juwnas folded before Flop (didn't bet)
Seat 5: x_ROSH125_x folded before Flop (didn't bet)
Seat 6: RipZip folded before Flop (didn't bet)
Seat 7: $imo422 folded before Flop (didn't bet)
Seat 8: ludemix (button) folded before Flop (didn't bet)
Seat 9: siskin vrach (small blind) folded before Flop



PokerStars Hand #228683096678:  Hold'em No Limit ($0.25/$0.50 USD) - 2021/07/30 13:01:09 ET
Table 'Aitne III' 9-max Seat #9 is the button
Seat 1: alex_matsuka ($76.94 in chips) 
Seat 2: dstrola ($53.31 in chips) 
Seat 3: Lemmi846 ($67.77 in chips) 
Seat 4: juwnas ($93.55 in chips) 
Seat 5: x_ROSH125_x ($56.14 in chips) 
Seat 6: RipZip ($53.01 in chips) 
Seat 7: $imo422 ($43.74 in chips) 
Seat 8: ludemix ($77.29 in chips) 
Seat 9: siskin vrach ($101.94 in chips) 
alex_matsuka: posts small blind $0.25
dstrola: posts big blind $0.50
*** HOLE CARDS ***
Lemmi846: folds 
juwnas: folds 
x_ROSH125_x: folds 
RipZip: folds 
$imo422: folds 
ludemix: raises $0.75 to $1.25
siskin vrach: folds 
alex_matsuka: folds 
dstrola: raises $2.75 to $4
ludemix: calls $2.75
*** FLOP *** [9s Qc 6c]
dstrola: checks 
ludemix: bets $2.74
dstrola: calls $2.74
*** TURN *** [9s Qc 6c] [2h]
dstrola: checks 
ludemix: bets $4.56
dstrola: calls $4.56
*** RIVER *** [9s Qc 6c 2h] [5h]
dstrola: checks 
ludemix: bets $7.60
dstrola: calls $7.60
*** SHOW DOWN ***
ludemix: shows [Qs Ad] (a pair of Queens)
dstrola: mucks hand 
ludemix collected $36.15 from pot
*** SUMMARY ***
Total pot $38.05 | Rake $1.90 
Board [9s Qc 6c 2h 5h]
Seat 1: alex_matsuka (small blind) folded before Flop
Seat 2: dstrola (big blind) mucked
Seat 3: Lemmi846 folded before Flop (didn't bet)
Seat 4: juwnas folded before Flop (didn't bet)
Seat 5: x_ROSH125_x folded before Flop (didn't bet)
Seat 6: RipZip folded before Flop (didn't bet)
Seat 7: $imo422 folded before Flop (didn't bet)
Seat 8: ludemix showed [Qs Ad] and won ($36.15) with a pair of Queens
Seat 9: siskin vrach (button) folded before Flop (didn't bet)



PokerStars Hand #228683121555:  Hold'em No Limit ($0.25/$0.50 USD) - 2021/07/30 13:02:18 ET
Table 'Aitne III' 9-max Seat #1 is the button
Seat 1: alex_matsuka ($76.69 in chips) 
Seat 2: dstrola ($50 in chips) 
Seat 3: Lemmi846 ($67.77 in chips) 
Seat 4: juwnas ($93.55 in chips) 
Seat 5: x_ROSH125_x ($56.14 in chips) 
Seat 6: RipZip ($53.01 in chips) 
Seat 7: $imo422 ($43.74 in chips) 
Seat 8: ludemix ($94.54 in chips) 
Seat 9: siskin vrach ($101.94 in chips) 
dstrola: posts small blind $0.25
Lemmi846: posts big blind $0.50
*** HOLE CARDS ***
juwnas: folds 
x_ROSH125_x: folds 
RipZip: folds 
$imo422: folds 
ludemix: folds 
siskin vrach: folds 
alex_matsuka: folds 
dstrola: folds 
Uncalled bet ($0.25) returned to Lemmi846
Lemmi846 collected $0.50 from pot
Lemmi846: doesn't show hand 
*** SUMMARY ***
Total pot $0.50 | Rake $0 
Seat 1: alex_matsuka (button) folded before Flop (didn't bet)
Seat 2: dstrola (small blind) folded before Flop
Seat 3: Lemmi846 (big blind) collected ($0.50)
Seat 4: juwnas folded before Flop (didn't bet)
Seat 5: x_ROSH125_x folded before Flop (didn't bet)
Seat 6: RipZip folded before Flop (didn't bet)
Seat 7: $imo422 folded before Flop (didn't bet)
Seat 8: ludemix folded before Flop (didn't bet)
Seat 9: siskin vrach folded before Flop (didn't bet)



PokerStars Hand #228683127907:  Hold'em No Limit ($0.25/$0.50 USD) - 2021/07/30 13:02:34 ET
Table 'Aitne III' 9-max Seat #2 is the button
Seat 1: alex_matsuka ($76.69 in chips) 
Seat 2: dstrola ($50 in chips) 
Seat 3: Lemmi846 ($68.02 in chips) 
Seat 4: juwnas ($93.55 in chips) 
Seat 5: x_ROSH125_x ($56.14 in chips) 
Seat 6: RipZip ($53.01 in chips) 
Seat 7: $imo422 ($43.74 in chips) 
Seat 8: ludemix ($94.54 in chips) 
Seat 9: siskin vrach ($101.94 in chips) 
Lemmi846: posts small blind $0.25
juwnas: posts big blind $0.50
*** HOLE CARDS ***
x_ROSH125_x: folds 
RipZip: folds 
$imo422: folds 
ludemix: folds 
siskin vrach: folds 
alex_matsuka: raises $1 to $1.50
dstrola: folds 
Lemmi846: folds 
juwnas: calls $1
*** FLOP *** [2c 9h 5s]
juwnas: checks 
alex_matsuka: bets $1.39
juwnas: calls $1.39
*** TURN *** [2c 9h 5s] [7c]
juwnas: checks 
alex_matsuka: checks 
*** RIVER *** [2c 9h 5s 7c] [Qh]
juwnas: bets $2.86
alex_matsuka: folds 
Uncalled bet ($2.86) returned to juwnas
juwnas collected $5.73 from pot
juwnas: doesn't show hand 
*** SUMMARY ***
Total pot $6.03 | Rake $0.30 
Board [2c 9h 5s 7c Qh]
Seat 1: alex_matsuka folded on the River
Seat 2: dstrola (button) folded before Flop (didn't bet)
Seat 3: Lemmi846 (small blind) folded before Flop
Seat 4: juwnas (big blind) collected ($5.73)
Seat 5: x_ROSH125_x folded before Flop (didn't bet)
Seat 6: RipZip folded before Flop (didn't bet)
Seat 7: $imo422 folded before Flop (didn't bet)
Seat 8: ludemix folded before Flop (didn't bet)
Seat 9: siskin vrach folded before Flop (didn't bet)



PokerStars Hand #228683142913:  Hold'em No Limit ($0.25/$0.50 USD) - 2021/07/30 13:03:13 ET
Table 'Aitne III' 9-max Seat #3 is the button
Seat 1: alex_matsuka ($73.80 in chips) 
Seat 2: dstrola ($50 in chips) 
Seat 3: Lemmi846 ($67.77 in chips) 
Seat 4: juwnas ($96.39 in chips) 
Seat 5: x_ROSH125_x ($56.14 in chips) 
Seat 6: RipZip ($53.01 in chips) 
Seat 7: $imo422 ($43.74 in chips) 
Seat 8: ludemix ($94.54 in chips) 
Seat 9: siskin vrach ($101.94 in chips) 
juwnas: posts small blind $0.25
x_ROSH125_x: posts big blind $0.50
*** HOLE CARDS ***
RipZip: folds 
$imo422: folds 
ludemix: folds 
siskin vrach: folds 
alex_matsuka: raises $1 to $1.50
dstrola: folds 
Lemmi846: folds 
juwnas: calls $1.25
RipZip leaves the table
x_ROSH125_x: folds 
*** FLOP *** [Qs 4h 4s]
juwnas: checks 
alex_matsuka: checks 
*** TURN *** [Qs 4h 4s] [9d]
juwnas: checks 
alex_matsuka: checks 
*** RIVER *** [Qs 4h 4s 9d] [3s]
juwnas: checks 
alex_matsuka: checks 
*** SHOW DOWN ***
juwnas: shows [2h 2c] (two pair, Fours and Deuces)
alex_matsuka: mucks hand 
juwnas collected $3.32 from pot
*** SUMMARY ***
Total pot $3.50 | Rake $0.18 
Board [Qs 4h 4s 9d 3s]
Seat 1: alex_matsuka mucked
Seat 2: dstrola folded before Flop (didn't bet)
Seat 3: Lemmi846 (button) folded before Flop (didn't bet)
Seat 4: juwnas (small blind) showed [2h 2c] and won ($3.32) with two pair, Fours and Deuces
Seat 5: x_ROSH125_x (big blind) folded before Flop
Seat 6: RipZip folded before Flop (didn't bet)
Seat 7: $imo422 folded before Flop (didn't bet)
Seat 8: ludemix folded before Flop (didn't bet)
Seat 9: siskin vrach folded before Flop (didn't bet)



PokerStars Hand #228683162904:  Hold'em No Limit ($0.25/$0.50 USD) - 2021/07/30 13:04:03 ET
Table 'Aitne III' 9-max Seat #4 is the button
Seat 1: alex_matsuka ($72.30 in chips) 
Seat 2: dstrola ($50 in chips) 
Seat 3: Lemmi846 ($67.77 in chips) 
Seat 4: juwnas ($98.21 in chips) 
Seat 5: x_ROSH125_x ($55.64 in chips) 
Seat 7: $imo422 ($43.74 in chips) 
Seat 8: ludemix ($94.54 in chips) 
Seat 9: siskin vrach ($101.94 in chips) 
x_ROSH125_x: posts small blind $0.25
$imo422: posts big blind $0.50
*** HOLE CARDS ***
ludemix: folds 
siskin vrach: folds 
alex_matsuka: folds 
dstrola: folds 
Lemmi846: folds 
juwnas: folds 
x_ROSH125_x: raises $1 to $1.50
$imo422: calls $1
*** FLOP *** [8d 5d 4h]
x_ROSH125_x: bets $1.45
$imo422: calls $1.45
*** TURN *** [8d 5d 4h] [3s]
x_ROSH125_x: checks 
$imo422: bets $4
x_ROSH125_x: calls $4
*** RIVER *** [8d 5d 4h 3s] [Th]
x_ROSH125_x: checks 
$imo422: checks 
*** SHOW DOWN ***
x_ROSH125_x: shows [Kc 8h] (a pair of Eights)
$imo422: mucks hand 
x_ROSH125_x collected $13.20 from pot
*** SUMMARY ***
Total pot $13.90 | Rake $0.70 
Board [8d 5d 4h 3s Th]
Seat 1: alex_matsuka folded before Flop (didn't bet)
Seat 2: dstrola folded before Flop (didn't bet)
Seat 3: Lemmi846 folded before Flop (didn't bet)
Seat 4: juwnas (button) folded before Flop (didn't bet)
Seat 5: x_ROSH125_x (small blind) showed [Kc 8h] and won ($13.20) with a pair of Eights
Seat 7: $imo422 (big blind) mucked
Seat 8: ludemix folded before Flop (didn't bet)
Seat 9: siskin vrach folded before Flop (didn't bet)



PokerStars Hand #228683181072:  Hold'em No Limit ($0.25/$0.50 USD) - 2021/07/30 13:04:48 ET
Table 'Aitne III' 9-max Seat #5 is the button
Seat 1: alex_matsuka ($72.30 in chips) 
Seat 2: dstrola ($50 in chips) 
Seat 3: Lemmi846 ($67.77 in chips) 
Seat 4: juwnas ($98.21 in chips) 
Seat 5: x_ROSH125_x ($61.89 in chips) 
Seat 7: $imo422 ($36.79 in chips) 
Seat 8: ludemix ($94.54 in chips) 
Seat 9: siskin vrach ($101.94 in chips) 
$imo422: posts small blind $0.25
ludemix: posts big blind $0.50
*** HOLE CARDS ***
siskin vrach has timed out
siskin vrach: folds 
alex_matsuka: raises $1 to $1.50
dstrola: folds 
Lemmi846: folds 
juwnas: folds 
x_ROSH125_x: calls $1.50
$imo422: folds 
ludemix: folds 
*** FLOP *** [8d Ac Js]
$imo422 leaves the table
alex_matsuka: bets $1.60
x_ROSH125_x: folds 
Uncalled bet ($1.60) returned to alex_matsuka
alex_matsuka collected $3.56 from pot
alex_matsuka: doesn't show hand 
*** SUMMARY ***
Total pot $3.75 | Rake $0.19 
Board [8d Ac Js]
Seat 1: alex_matsuka collected ($3.56)
Seat 2: dstrola folded before Flop (didn't bet)
Seat 3: Lemmi846 folded before Flop (didn't bet)
Seat 4: juwnas folded before Flop (didn't bet)
Seat 5: x_ROSH125_x (button) folded on the Flop
Seat 7: $imo422 (small blind) folded before Flop
Seat 8: ludemix (big blind) folded before Flop
Seat 9: siskin vrach folded before Flop (didn't bet)



PokerStars Hand #228683284049:  Hold'em No Limit ($0.25/$0.50 USD) - 2021/07/30 13:08:55 ET
Table 'Aitne III' 9-max Seat #3 is the button
Seat 2: pokerbrat344 ($50 in chips) 
Seat 3: Lemmi846 ($66.27 in chips) 
Seat 4: juwnas ($96.96 in chips) 
Seat 5: Mmago24 ($50 in chips) 
Seat 8: ludemix ($92.79 in chips) 
Seat 9: siskin vrach ($95.70 in chips) 
juwnas: posts small blind $0.25
Mmago24: posts big blind $0.50
stone1000: sits out 
SpeeLy: sits out 
pokerbrat344: posts big blind $0.50
*** HOLE CARDS ***
ludemix: raises $1.50 to $2
siskin vrach: folds 
pokerbrat344: folds 
Lemmi846: folds 
juwnas: folds 
Mmago24: folds 
Uncalled bet ($1.50) returned to ludemix
SpeeLy leaves the table
ludemix collected $1.75 from pot
ludemix: doesn't show hand 
*** SUMMARY ***
Total pot $1.75 | Rake $0 
Seat 2: pokerbrat344 folded before Flop (didn't bet)
Seat 3: Lemmi846 (button) folded before Flop (didn't bet)
Seat 4: juwnas (small blind) folded before Flop
Seat 5: Mmago24 (big blind) folded before Flop
Seat 8: ludemix collected ($1.75)
Seat 9: siskin vrach folded before Flop (didn't bet)



PokerStars Hand #228683292646:  Hold'em No Limit ($0.25/$0.50 USD) - 2021/07/30 13:09:16 ET
Table 'Aitne III' 9-max Seat #4 is the button
Seat 2: pokerbrat344 ($49.50 in chips) 
Seat 3: Lemmi846 ($66.27 in chips) 
Seat 4: juwnas ($96.71 in chips) 
Seat 5: Mmago24 ($50 in chips) 
Seat 6: stone1000 ($48.75 in chips) 
Seat 8: ludemix ($94.04 in chips) 
Seat 9: siskin vrach ($95.70 in chips) 
Mmago24: posts small blind $0.25
stone1000: posts big blind $0.50
*** HOLE CARDS ***
ludemix: folds 
siskin vrach: folds 
pokerbrat344: folds 
Lemmi846: folds 
juwnas: folds 
Mmago24: folds 
Uncalled bet ($0.25) returned to stone1000
stone1000 collected $0.50 from pot
stone1000: doesn't show hand 
*** SUMMARY ***
Total pot $0.50 | Rake $0 
Seat 2: pokerbrat344 folded before Flop (didn't bet)
Seat 3: Lemmi846 folded before Flop (didn't bet)
Seat 4: juwnas (button) folded before Flop (didn't bet)
Seat 5: Mmago24 (small blind) folded before Flop
Seat 6: stone1000 (big blind) collected ($0.50)
Seat 8: ludemix folded before Flop (didn't bet)
Seat 9: siskin vrach folded before Flop (didn't bet)



PokerStars Hand #228683370907:  Hold'em No Limit ($0.25/$0.50 USD) - 2021/07/30 13:12:20 ET
Table 'Aitne III' 9-max Seat #4 is the button
Seat 1: Nightwoof ($50 in chips) 
Seat 2: pokerbrat344 ($49.77 in chips) 
Seat 3: Lemmi846 ($65.52 in chips) 
Seat 4: juwnas ($100.43 in chips) 
Seat 5: Mmago24 ($50.25 in chips) 
Seat 6: stone1000 ($48.75 in chips) 
Seat 8: ludemix ($90.75 in chips) 
Seat 9: siskin vrach ($95.70 in chips) 
Mmago24: posts small blind $0.25
stone1000: posts big blind $0.50
*** HOLE CARDS ***
ludemix: folds 
siskin vrach: folds 
Nightwoof: folds 
pokerbrat344: calls $0.50
Lemmi846: calls $0.50
juwnas: raises $1 to $1.50
Mmago24: folds 
stone1000: folds 
pokerbrat344: calls $1
Lemmi846: calls $1
*** FLOP *** [2s Ac 8c]
pokerbrat344: bets $2.50
Lemmi846: folds 
juwnas: folds 
Uncalled bet ($2.50) returned to pokerbrat344
pokerbrat344 collected $4.99 from pot
*** SUMMARY ***
Total pot $5.25 | Rake $0.26 
Board [2s Ac 8c]
Seat 1: Nightwoof folded before Flop (didn't bet)
Seat 2: pokerbrat344 collected ($4.99)
Seat 3: Lemmi846 folded on the Flop
Seat 4: juwnas (button) folded on the Flop
Seat 5: Mmago24 (small blind) folded before Flop
Seat 6: stone1000 (big blind) folded before Flop
Seat 8: ludemix folded before Flop (didn't bet)
Seat 9: siskin vrach folded before Flop (didn't bet)



PokerStars Hand #228683394972:  Hold'em No Limit ($0.25/$0.50 USD) - 2021/07/30 13:13:21 ET
Table 'Aitne III' 9-max Seat #5 is the button
Seat 1: Nightwoof ($50 in chips) 
Seat 2: pokerbrat344 ($53.26 in chips) 
Seat 3: Lemmi846 ($64.02 in chips) 
Seat 4: juwnas ($98.93 in chips) 
Seat 5: Mmago24 ($50 in chips) 
Seat 6: stone1000 ($48.25 in chips) 
Seat 7: dikanmax ($50 in chips) 
Seat 8: ludemix ($90.75 in chips) 
Seat 9: siskin vrach ($95.70 in chips) 
stone1000: posts small blind $0.25
dikanmax: posts big blind $0.50
*** HOLE CARDS ***
ludemix: raises $0.75 to $1.25
siskin vrach: folds 
Nightwoof: folds 
pokerbrat344: calls $1.25
Lemmi846: folds 
juwnas: folds 
juwnas leaves the table
Mmago24: folds 
stone1000: folds 
dikanmax: folds 
*** FLOP *** [Jh 9d 4d]
ludemix: bets $1.70
pokerbrat344: calls $1.70
*** TURN *** [Jh 9d 4d] [Qs]
ludemix: bets $4.74
pokerbrat344: calls $4.74
*** RIVER *** [Jh 9d 4d Qs] [Jc]
ludemix: checks 
Pachebrash joins the table at seat #4 
pokerbrat344: checks 
*** SHOW DOWN ***
ludemix: shows [Qd Jd] (a full house, Jacks full of Queens)
pokerbrat344: mucks hand 
ludemix collected $15.32 from pot
*** SUMMARY ***
Total pot $16.13 | Rake $0.81 
Board [Jh 9d 4d Qs Jc]
Seat 1: Nightwoof folded before Flop (didn't bet)
Seat 2: pokerbrat344 mucked
Seat 3: Lemmi846 folded before Flop (didn't bet)
Seat 4: juwnas folded before Flop (didn't bet)
Seat 5: Mmago24 (button) folded before Flop (didn't bet)
Seat 6: stone1000 (small blind) folded before Flop
Seat 7: dikanmax (big blind) folded before Flop
Seat 8: ludemix showed [Qd Jd] and won ($15.32) with a full house, Jacks full of Queens
Seat 9: siskin vrach folded before Flop (didn't bet)



PokerStars Hand #228683418115:  Hold'em No Limit ($0.25/$0.50 USD) - 2021/07/30 13:14:19 ET
Table 'Aitne III' 9-max Seat #6 is the button
Seat 1: Nightwoof ($50 in chips) 
Seat 2: pokerbrat344 ($45.57 in chips) 
Seat 3: Lemmi846 ($64.02 in chips) 
Seat 5: Mmago24 ($50 in chips) 
Seat 6: stone1000 ($48 in chips) 
Seat 7: dikanmax ($50 in chips) 
Seat 8: ludemix ($98.38 in chips) 
Seat 9: siskin vrach ($95.70 in chips) 
dikanmax: posts small blind $0.25
ludemix: posts big blind $0.50
Pachebrash: sits out 
*** HOLE CARDS ***
siskin vrach: raises $1 to $1.50
Nightwoof: folds 
pokerbrat344: folds 
Lemmi846: folds 
Mmago24: folds 
stone1000: folds 
dikanmax: folds 
ludemix: calls $1
*** FLOP *** [9s 4h 9h]
ludemix: checks 
siskin vrach: checks 
*** TURN *** [9s 4h 9h] [3h]
ludemix: bets $2.32
siskin vrach: calls $2.32
*** RIVER *** [9s 4h 9h 3h] [8d]
ludemix: bets $5.63
siskin vrach: calls $5.63
*** SHOW DOWN ***
ludemix: shows [Qc Qh] (two pair, Queens and Nines)
siskin vrach: mucks hand 
ludemix collected $18.19 from pot
*** SUMMARY ***
Total pot $19.15 | Rake $0.96 
Board [9s 4h 9h 3h 8d]
Seat 1: Nightwoof folded before Flop (didn't bet)
Seat 2: pokerbrat344 folded before Flop (didn't bet)
Seat 3: Lemmi846 folded before Flop (didn't bet)
Seat 5: Mmago24 folded before Flop (didn't bet)
Seat 6: stone1000 (button) folded before Flop (didn't bet)
Seat 7: dikanmax (small blind) folded before Flop
Seat 8: ludemix (big blind) showed [Qc Qh] and won ($18.19) with two pair, Queens and Nines
Seat 9: siskin vrach mucked



PokerStars Hand #228683445843:  Hold'em No Limit ($0.25/$0.50 USD) - 2021/07/30 13:15:27 ET
Table 'Aitne III' 9-max Seat #7 is the button
Seat 1: Nightwoof ($50 in chips) 
Seat 2: pokerbrat344 ($45.57 in chips) 
Seat 3: Lemmi846 ($64.02 in chips) 
Seat 5: Mmago24 ($50 in chips) 
Seat 6: stone1000 ($48 in chips) 
Seat 7: dikanmax ($50 in chips) 
Seat 8: ludemix ($107.12 in chips) 
Seat 9: siskin vrach ($86.25 in chips) 
ludemix: posts small blind $0.25
siskin vrach: posts big blind $0.50
Pachebrash: sits out 
*** HOLE CARDS ***
Nightwoof: folds 
pokerbrat344: folds 
Lemmi846: folds 
Mmago24: raises $0.72 to $1.22
stone1000: folds 
dikanmax: folds 
ludemix: folds 
siskin vrach: calls $0.72
*** FLOP *** [7c 6h 6c]
siskin vrach: checks 
Mmago24: checks 
*** TURN *** [7c 6h 6c] [Ah]
siskin vrach: checks 
Mmago24: bets $1.71
siskin vrach: folds 
Uncalled bet ($1.71) returned to Mmago24
Mmago24 collected $2.56 from pot
Mmago24: doesn't show hand 
*** SUMMARY ***
Total pot $2.69 | Rake $0.13 
Board [7c 6h 6c Ah]
Seat 1: Nightwoof folded before Flop (didn't bet)
Seat 2: pokerbrat344 folded before Flop (didn't bet)
Seat 3: Lemmi846 folded before Flop (didn't bet)
Seat 5: Mmago24 collected ($2.56)
Seat 6: stone1000 folded before Flop (didn't bet)
Seat 7: dikanmax (button) folded before Flop (didn't bet)
Seat 8: ludemix (small blind) folded before Flop
Seat 9: siskin vrach (big blind) folded on the Turn



PokerStars Hand #228683467836:  Hold'em No Limit ($0.25/$0.50 USD) - 2021/07/30 13:16:21 ET
Table 'Aitne III' 9-max Seat #8 is the button
Seat 1: Nightwoof ($50 in chips) 
Seat 2: pokerbrat344 ($45.57 in chips) 
Seat 3: Lemmi846 ($64.02 in chips) 
Seat 5: Mmago24 ($51.34 in chips) 
Seat 6: stone1000 ($48 in chips) 
Seat 7: dikanmax ($50 in chips) 
Seat 8: ludemix ($106.87 in chips) 
Seat 9: siskin vrach ($85.03 in chips) 
siskin vrach: posts small blind $0.25
Nightwoof: posts big blind $0.50
Pachebrash: sits out 
*** HOLE CARDS ***
pokerbrat344: calls $0.50
Lemmi846: folds 
Mmago24: folds 
stone1000: folds 
dikanmax: raises $1.75 to $2.25
ludemix: folds 
siskin vrach: folds 
Nightwoof: folds 
pokerbrat344: raises $1.75 to $4
dikanmax: calls $1.75
*** FLOP *** [Jh Ah 3h]
pokerbrat344: checks 
dikanmax: checks 
*** TURN *** [Jh Ah 3h] [6h]
pokerbrat344: bets $8.31
dikanmax: folds 
Uncalled bet ($8.31) returned to pokerbrat344
pokerbrat344 collected $8.31 from pot
*** SUMMARY ***
Total pot $8.75 | Rake $0.44 
Board [Jh Ah 3h 6h]
Seat 1: Nightwoof (big blind) folded before Flop
Seat 2: pokerbrat344 collected ($8.31)
Seat 3: Lemmi846 folded before Flop (didn't bet)
Seat 5: Mmago24 folded before Flop (didn't bet)
Seat 6: stone1000 folded before Flop (didn't bet)
Seat 7: dikanmax folded on the Turn
Seat 8: ludemix (button) folded before Flop (didn't bet)
Seat 9: siskin vrach (small blind) folded before Flop



PokerStars Hand #228683499092:  Hold'em No Limit ($0.25/$0.50 USD) - 2021/07/30 13:17:37 ET
Table 'Aitne III' 9-max Seat #9 is the button
Seat 1: Nightwoof ($50 in chips) 
Seat 2: pokerbrat344 ($49.88 in chips) 
Seat 3: Lemmi846 ($64.02 in chips) 
Seat 5: Mmago24 ($51.34 in chips) 
Seat 6: stone1000 ($48 in chips) 
Seat 7: dikanmax ($50 in chips) 
Seat 8: ludemix ($106.87 in chips) 
Seat 9: siskin vrach ($84.78 in chips) 
Nightwoof: posts small blind $0.25
pokerbrat344: posts big blind $0.50
Pachebrash: sits out 
*** HOLE CARDS ***
Lemmi846: folds 
Mmago24: folds 
stone1000: folds 
dikanmax: folds 
ludemix: folds 
siskin vrach: folds 
Nightwoof: folds 
Uncalled bet ($0.25) returned to pokerbrat344
pokerbrat344 collected $0.50 from pot
*** SUMMARY ***
Total pot $0.50 | Rake $0 
Seat 1: Nightwoof (small blind) folded before Flop
Seat 2: pokerbrat344 (big blind) collected ($0.50)
Seat 3: Lemmi846 folded before Flop (didn't bet)
Seat 5: Mmago24 folded before Flop (didn't bet)
Seat 6: stone1000 folded before Flop (didn't bet)
Seat 7: dikanmax folded before Flop (didn't bet)
Seat 8: ludemix folded before Flop (didn't bet)
Seat 9: siskin vrach (button) folded before Flop (didn't bet)



PokerStars Hand #228683513047:  Hold'em No Limit ($0.25/$0.50 USD) - 2021/07/30 13:18:12 ET
Table 'Aitne III' 9-max Seat #1 is the button
Seat 1: Nightwoof ($50 in chips) 
Seat 2: pokerbrat344 ($50.13 in chips) 
Seat 3: Lemmi846 ($64.02 in chips) 
Seat 5: Mmago24 ($51.34 in chips) 
Seat 6: stone1000 ($48 in chips) 
Seat 7: dikanmax ($50 in chips) 
Seat 8: ludemix ($106.87 in chips) 
Seat 9: siskin vrach ($84.78 in chips) 
pokerbrat344: posts small blind $0.25
Lemmi846: posts big blind $0.50
Pachebrash: sits out 
*** HOLE CARDS ***
Mmago24: folds 
stone1000: folds 
dikanmax: folds 
ludemix: raises $0.75 to $1.25
siskin vrach: folds 
Nightwoof: folds 
pokerbrat344: calls $1
Lemmi846: folds 
*** FLOP *** [Ah 7c 5d]
pokerbrat344: bets $2.85
ludemix: calls $2.85
*** TURN *** [Ah 7c 5d] [Td]
pokerbrat344: bets $4.13
ludemix: raises $9.09 to $13.22
pokerbrat344: folds 
Uncalled bet ($9.09) returned to ludemix
ludemix collected $16.11 from pot
ludemix: doesn't show hand 
*** SUMMARY ***
Total pot $16.96 | Rake $0.85 
Board [Ah 7c 5d Td]
Seat 1: Nightwoof (button) folded before Flop (didn't bet)
Seat 2: pokerbrat344 (small blind) folded on the Turn
Seat 3: Lemmi846 (big blind) folded before Flop
Seat 5: Mmago24 folded before Flop (didn't bet)
Seat 6: stone1000 folded before Flop (didn't bet)
Seat 7: dikanmax folded before Flop (didn't bet)
Seat 8: ludemix collected ($16.11)
Seat 9: siskin vrach folded before Flop (didn't bet)



PokerStars Hand #228683534600:  Hold'em No Limit ($0.25/$0.50 USD) - 2021/07/30 13:19:05 ET
Table 'Aitne III' 9-max Seat #2 is the button
Seat 1: Nightwoof ($50 in chips) 
Seat 2: pokerbrat344 ($41.90 in chips) 
Seat 3: Lemmi846 ($63.52 in chips) 
Seat 4: Pachebrash ($50 in chips) 
Seat 5: Mmago24 ($51.34 in chips) 
Seat 6: stone1000 ($48 in chips) 
Seat 7: dikanmax ($50 in chips) 
Seat 8: ludemix ($114.75 in chips) 
Seat 9: siskin vrach ($84.78 in chips) 
Lemmi846: posts small blind $0.25
Pachebrash: posts big blind $0.50
*** HOLE CARDS ***
Mmago24: folds 
stone1000: folds 
dikanmax: folds 
ludemix: folds 
siskin vrach: raises $1 to $1.50
Nightwoof: folds 
pokerbrat344: calls $1.50
Lemmi846: folds 
Pachebrash: calls $1
*** FLOP *** [7s Ts Ks]
Pachebrash: checks 
siskin vrach: bets $2.26
pokerbrat344: folds 
Pachebrash: folds 
Uncalled bet ($2.26) returned to siskin vrach
siskin vrach collected $4.51 from pot
*** SUMMARY ***
Total pot $4.75 | Rake $0.24 
Board [7s Ts Ks]
Seat 1: Nightwoof folded before Flop (didn't bet)
Seat 2: pokerbrat344 (button) folded on the Flop
Seat 3: Lemmi846 (small blind) folded before Flop
Seat 4: Pachebrash (big blind) folded on the Flop
Seat 5: Mmago24 folded before Flop (didn't bet)
Seat 6: stone1000 folded before Flop (didn't bet)
Seat 7: dikanmax folded before Flop (didn't bet)
Seat 8: ludemix folded before Flop (didn't bet)
Seat 9: siskin vrach collected ($4.51)



PokerStars Hand #228683555812:  Hold'em No Limit ($0.25/$0.50 USD) - 2021/07/30 13:19:58 ET
Table 'Aitne III' 9-max Seat #3 is the button
Seat 1: Nightwoof ($50 in chips) 
Seat 3: Lemmi846 ($63.27 in chips) 
Seat 4: Pachebrash ($50 in chips) 
Seat 5: Mmago24 ($51.34 in chips) 
Seat 6: stone1000 ($48 in chips) 
Seat 7: dikanmax ($50 in chips) 
Seat 8: ludemix ($114.75 in chips) 
Seat 9: siskin vrach ($87.79 in chips) 
Pachebrash: posts small blind $0.25
Mmago24: posts big blind $0.50
*** HOLE CARDS ***
stone1000: folds 
dikanmax: folds 
ludemix: folds 
siskin vrach: folds 
Nightwoof: folds 
Lemmi846: folds 
Pachebrash: raises $1 to $1.50
Mmago24: folds 
Uncalled bet ($1) returned to Pachebrash
Pachebrash collected $1 from pot
Pachebrash: doesn't show hand 
*** SUMMARY ***
Total pot $1 | Rake $0 
Seat 1: Nightwoof folded before Flop (didn't bet)
Seat 3: Lemmi846 (button) folded before Flop (didn't bet)
Seat 4: Pachebrash (small blind) collected ($1)
Seat 5: Mmago24 (big blind) folded before Flop
Seat 6: stone1000 folded before Flop (didn't bet)
Seat 7: dikanmax folded before Flop (didn't bet)
Seat 8: ludemix folded before Flop (didn't bet)
Seat 9: siskin vrach folded before Flop (didn't bet)



PokerStars Hand #228683564432:  Hold'em No Limit ($0.25/$0.50 USD) - 2021/07/30 13:20:19 ET
Table 'Aitne III' 9-max Seat #4 is the button
Seat 1: Nightwoof ($50 in chips) 
Seat 3: Lemmi846 ($63.27 in chips) 
Seat 4: Pachebrash ($50.50 in chips) 
Seat 5: Mmago24 ($50.84 in chips) 
Seat 6: stone1000 ($48 in chips) 
Seat 7: dikanmax ($50 in chips) 
Seat 8: ludemix ($114.75 in chips) 
Seat 9: siskin vrach ($87.79 in chips) 
Mmago24: posts small blind $0.25
stone1000: posts big blind $0.50
*** HOLE CARDS ***
dikanmax: folds 
ludemix: folds 
siskin vrach: folds 
Nightwoof: folds 
Lemmi846: folds 
Pachebrash: raises $0.70 to $1.20
Mmago24: folds 
stone1000 has timed out
stone1000: folds 
Uncalled bet ($0.70) returned to Pachebrash
Pachebrash collected $1.25 from pot
Pachebrash: doesn't show hand 
*** SUMMARY ***
Total pot $1.25 | Rake $0 
Seat 1: Nightwoof folded before Flop (didn't bet)
Seat 3: Lemmi846 folded before Flop (didn't bet)
Seat 4: Pachebrash (button) collected ($1.25)
Seat 5: Mmago24 (small blind) folded before Flop
Seat 6: stone1000 (big blind) folded before Flop
Seat 7: dikanmax folded before Flop (didn't bet)
Seat 8: ludemix folded before Flop (didn't bet)
Seat 9: siskin vrach folded before Flop (didn't bet)



PokerStars Hand #228683586883:  Hold'em No Limit ($0.25/$0.50 USD) - 2021/07/30 13:21:14 ET
Table 'Aitne III' 9-max Seat #5 is the button
Seat 1: Nightwoof ($50 in chips) 
Seat 3: Lemmi846 ($63.27 in chips) 
Seat 4: Pachebrash ($51.25 in chips) 
Seat 5: Mmago24 ($50.59 in chips) 
Seat 7: dikanmax ($50 in chips) 
Seat 8: ludemix ($114.75 in chips) 
Seat 9: siskin vrach ($87.79 in chips) 
dikanmax: posts small blind $0.25
ludemix: posts big blind $0.50
*** HOLE CARDS ***
stone1000 is disconnected 
siskin vrach: folds 
Nightwoof: folds 
Lemmi846: folds 
Pachebrash: folds 
Mmago24: raises $0.72 to $1.22
dikanmax: folds 
ludemix: folds 
Uncalled bet ($0.72) returned to Mmago24
Mmago24 collected $1.25 from pot
Mmago24: doesn't show hand 
*** SUMMARY ***
Total pot $1.25 | Rake $0 
Seat 1: Nightwoof folded before Flop (didn't bet)
Seat 3: Lemmi846 folded before Flop (didn't bet)
Seat 4: Pachebrash folded before Flop (didn't bet)
Seat 5: Mmago24 (button) collected ($1.25)
Seat 7: dikanmax (small blind) folded before Flop
Seat 8: ludemix (big blind) folded before Flop
Seat 9: siskin vrach folded before Flop (didn't bet)



PokerStars Hand #228683596222:  Hold'em No Limit ($0.25/$0.50 USD) - 2021/07/30 13:21:37 ET
Table 'Aitne III' 9-max Seat #7 is the button
Seat 1: Nightwoof ($50 in chips) 
Seat 3: Lemmi846 ($63.27 in chips) 
Seat 4: Pachebrash ($51.25 in chips) 
Seat 5: Mmago24 ($51.34 in chips) 
Seat 7: dikanmax ($50 in chips) 
Seat 8: ludemix ($114.25 in chips) 
Seat 9: siskin vrach ($87.79 in chips) 
ludemix: posts small blind $0.25
siskin vrach: posts big blind $0.50
*** HOLE CARDS ***
Nightwoof: folds 
Lemmi846: folds 
Pachebrash: folds 
Mmago24: folds 
dikanmax: raises $1 to $1.50
ludemix: folds 
siskin vrach: folds 
Uncalled bet ($1) returned to dikanmax
dikanmax collected $1.25 from pot
dikanmax: doesn't show hand 
*** SUMMARY ***
Total pot $1.25 | Rake $0 
Seat 1: Nightwoof folded before Flop (didn't bet)
Seat 3: Lemmi846 folded before Flop (didn't bet)
Seat 4: Pachebrash folded before Flop (didn't bet)
Seat 5: Mmago24 folded before Flop (didn't bet)
Seat 7: dikanmax (button) collected ($1.25)
Seat 8: ludemix (small blind) folded before Flop
Seat 9: siskin vrach (big blind) folded before Flop



PokerStars Hand #228683601758:  Hold'em No Limit ($0.25/$0.50 USD) - 2021/07/30 13:21:51 ET
Table 'Aitne III' 9-max Seat #8 is the button
Seat 1: Nightwoof ($50 in chips) 
Seat 3: Lemmi846 ($63.27 in chips) 
Seat 4: Pachebrash ($51.25 in chips) 
Seat 5: Mmago24 ($51.34 in chips) 
Seat 7: dikanmax ($50.75 in chips) 
Seat 8: ludemix ($114 in chips) 
Seat 9: siskin vrach ($87.29 in chips) 
siskin vrach: posts small blind $0.25
Nightwoof: posts big blind $0.50
*** HOLE CARDS ***
Lemmi846: folds 
Pachebrash: folds 
Mmago24 has timed out
Mmago24: folds 
dikanmax: folds 
ludemix: folds 
siskin vrach: folds 
Uncalled bet ($0.25) returned to Nightwoof
Nightwoof collected $0.50 from pot
Nightwoof: doesn't show hand 
*** SUMMARY ***
Total pot $0.50 | Rake $0 
Seat 1: Nightwoof (big blind) collected ($0.50)
Seat 3: Lemmi846 folded before Flop (didn't bet)
Seat 4: Pachebrash folded before Flop (didn't bet)
Seat 5: Mmago24 folded before Flop (didn't bet)
Seat 7: dikanmax folded before Flop (didn't bet)
Seat 8: ludemix (button) folded before Flop (didn't bet)
Seat 9: siskin vrach (small blind) folded before Flop



PokerStars Hand #228683610366:  Hold'em No Limit ($0.25/$0.50 USD) - 2021/07/30 13:22:11 ET
Table 'Aitne III' 9-max Seat #9 is the button
Seat 1: Nightwoof ($50.25 in chips) 
Seat 4: Pachebrash ($51.25 in chips) 
Seat 7: dikanmax ($50.75 in chips) 
Seat 8: ludemix ($114 in chips) 
Seat 9: siskin vrach ($87.04 in chips) 
Nightwoof: posts small blind $0.25
Lemmi846: is sitting out 
Pachebrash: posts big blind $0.50
*** HOLE CARDS ***
dikanmax: folds 
ludemix: folds 
siskin vrach: folds 
Nightwoof: folds 
Uncalled bet ($0.25) returned to Pachebrash
Pachebrash collected $0.50 from pot
Pachebrash: doesn't show hand 
*** SUMMARY ***
Total pot $0.50 | Rake $0 
Seat 1: Nightwoof (small blind) folded before Flop
Seat 4: Pachebrash (big blind) collected ($0.50)
Seat 7: dikanmax folded before Flop (didn't bet)
Seat 8: ludemix folded before Flop (didn't bet)
Seat 9: siskin vrach (button) folded before Flop (didn't bet)



PokerStars Hand #228683614627:  Hold'em No Limit ($0.25/$0.50 USD) - 2021/07/30 13:22:22 ET
Table 'Aitne III' 9-max Seat #1 is the button
Seat 1: Nightwoof ($50 in chips) 
Seat 4: Pachebrash ($51.50 in chips) 
Seat 5: Mmago24 ($51.34 in chips) 
Seat 7: dikanmax ($50.75 in chips) 
Seat 8: ludemix ($114 in chips) 
Seat 9: siskin vrach ($87.04 in chips) 
Pachebrash: posts small blind $0.25
Mmago24: posts big blind $0.50
*** HOLE CARDS ***
dikanmax: folds 
ludemix: raises $0.75 to $1.25
siskin vrach: folds 
Nightwoof: folds 
Pachebrash: folds 
Mmago24: folds 
Uncalled bet ($0.75) returned to ludemix
ludemix collected $1.25 from pot
ludemix: doesn't show hand 
*** SUMMARY ***
Total pot $1.25 | Rake $0 
Seat 1: Nightwoof (button) folded before Flop (didn't bet)
Seat 4: Pachebrash (small blind) folded before Flop
Seat 5: Mmago24 (big blind) folded before Flop
Seat 7: dikanmax folded before Flop (didn't bet)
Seat 8: ludemix collected ($1.25)
Seat 9: siskin vrach folded before Flop (didn't bet)



PokerStars Hand #228683622131:  Hold'em No Limit ($0.25/$0.50 USD) - 2021/07/30 13:22:41 ET
Table 'Aitne III' 9-max Seat #4 is the button
Seat 1: Nightwoof ($50 in chips) 
Seat 4: Pachebrash ($51.25 in chips) 
Seat 5: Mmago24 ($50.84 in chips) 
Seat 7: dikanmax ($50.75 in chips) 
Seat 8: ludemix ($114.75 in chips) 
Seat 9: siskin vrach ($87.04 in chips) 
Mmago24: posts small blind $0.25
dikanmax: posts big blind $0.50
*** HOLE CARDS ***
ludemix: folds 
siskin vrach: raises $1 to $1.50
ludemix leaves the table
Nightwoof: folds 
Pachebrash: folds 
Mmago24: folds 
La Ghir joins the table at seat #8 
dikanmax: folds 
Uncalled bet ($1) returned to siskin vrach
siskin vrach collected $1.25 from pot
*** SUMMARY ***
Total pot $1.25 | Rake $0 
Seat 1: Nightwoof folded before Flop (didn't bet)
Seat 4: Pachebrash (button) folded before Flop (didn't bet)
Seat 5: Mmago24 (small blind) folded before Flop
Seat 7: dikanmax (big blind) folded before Flop
Seat 8: ludemix folded before Flop (didn't bet)
Seat 9: siskin vrach collected ($1.25)



PokerStars Hand #228683633122:  Hold'em No Limit ($0.25/$0.50 USD) - 2021/07/30 13:23:03 ET
Table 'Aitne III' 9-max Seat #5 is the button
Seat 1: Nightwoof ($50 in chips) 
Seat 4: Pachebrash ($51.25 in chips) 
Seat 5: Mmago24 ($50.59 in chips) 
Seat 7: dikanmax ($50.25 in chips) 
Seat 8: La Ghir ($50 in chips) 
Seat 9: siskin vrach ($87.79 in chips) 
dikanmax: posts small blind $0.25
La Ghir: posts big blind $0.50
*** HOLE CARDS ***
siskin vrach: folds 
Nightwoof: folds 
Pachebrash: folds 
Mmago24: folds 
dikanmax: folds 
Uncalled bet ($0.25) returned to La Ghir
La Ghir collected $0.50 from pot
La Ghir: doesn't show hand 
*** SUMMARY ***
Total pot $0.50 | Rake $0 
Seat 1: Nightwoof folded before Flop (didn't bet)
Seat 4: Pachebrash folded before Flop (didn't bet)
Seat 5: Mmago24 (button) folded before Flop (didn't bet)
Seat 7: dikanmax (small blind) folded before Flop
Seat 8: La Ghir (big blind) collected ($0.50)
Seat 9: siskin vrach folded before Flop (didn't bet)



PokerStars Hand #228683639119:  Hold'em No Limit ($0.25/$0.50 USD) - 2021/07/30 13:23:17 ET
Table 'Aitne III' 9-max Seat #7 is the button
Seat 1: Nightwoof ($50 in chips) 
Seat 2: pokerbrat344 ($40.40 in chips) 
Seat 4: Pachebrash ($51.25 in chips) 
Seat 5: Mmago24 ($50.59 in chips) 
Seat 7: dikanmax ($50 in chips) 
Seat 8: La Ghir ($50.25 in chips) 
Seat 9: siskin vrach ($87.79 in chips) 
La Ghir: posts small blind $0.25
siskin vrach: posts big blind $0.50
pokerbrat344: posts small & big blinds $0.75
*** HOLE CARDS ***
Nightwoof: folds 
pokerbrat344: checks 
Pachebrash: folds 
Mmago24: raises $1.25 to $1.75
dikanmax: folds 
La Ghir: folds 
siskin vrach: folds 
pokerbrat344: calls $1.25
*** FLOP *** [8d 9s Qc]
pokerbrat344: checks 
Mmago24: checks 
*** TURN *** [8d 9s Qc] [6c]
pokerbrat344: bets $4.28
Mmago24: calls $4.28
*** RIVER *** [8d 9s Qc 6c] [9h]
pokerbrat344: bets $6.21
Mmago24: raises $13.16 to $19.37
pokerbrat344: calls $13.16
*** SHOW DOWN ***
Mmago24: shows [Tc 9c] (three of a kind, Nines)
pokerbrat344: mucks hand 
Mmago24 collected $49.80 from pot
*** SUMMARY ***
Total pot $51.80 | Rake $2 
Board [8d 9s Qc 6c 9h]
Seat 1: Nightwoof folded before Flop (didn't bet)
Seat 2: pokerbrat344 mucked
Seat 4: Pachebrash folded before Flop (didn't bet)
Seat 5: Mmago24 showed [Tc 9c] and won ($49.80) with three of a kind, Nines
Seat 7: dikanmax (button) folded before Flop (didn't bet)
Seat 8: La Ghir (small blind) folded before Flop
Seat 9: siskin vrach (big blind) folded before Flop



PokerStars Hand #228683667004:  Hold'em No Limit ($0.25/$0.50 USD) - 2021/07/30 13:24:27 ET
Table 'Aitne III' 9-max Seat #8 is the button
Seat 1: Nightwoof ($50 in chips) 
Seat 2: pokerbrat344 ($14.75 in chips) 
Seat 4: Pachebrash ($51.25 in chips) 
Seat 5: Mmago24 ($74.99 in chips) 
Seat 7: dikanmax ($50 in chips) 
Seat 8: La Ghir ($50 in chips) 
Seat 9: siskin vrach ($87.29 in chips) 
siskin vrach: posts small blind $0.25
Nightwoof: posts big blind $0.50
*** HOLE CARDS ***
pokerbrat344: folds 
pokerbrat344 leaves the table
Pachebrash: folds 
Mmago24: folds 
dikanmax: folds 
La Ghir: raises $0.50 to $1
siskin vrach: folds 
YamaRyu9097 joins the table at seat #2 
Nightwoof: calls $0.50
*** FLOP *** [5d 6d 9d]
Nightwoof: checks 
La Ghir: checks 
*** TURN *** [5d 6d 9d] [Jc]
Nightwoof: bets $0.71
La Ghir: calls $0.71
*** RIVER *** [5d 6d 9d Jc] [Ad]
Nightwoof: checks 
La Ghir: checks 
*** SHOW DOWN ***
Nightwoof: shows [Td 4d] (a flush, Ace high)
La Ghir: mucks hand 
Nightwoof collected $3.49 from pot
*** SUMMARY ***
Total pot $3.67 | Rake $0.18 
Board [5d 6d 9d Jc Ad]
Seat 1: Nightwoof (big blind) showed [Td 4d] and won ($3.49) with a flush, Ace high
Seat 2: pokerbrat344 folded before Flop (didn't bet)
Seat 4: Pachebrash folded before Flop (didn't bet)
Seat 5: Mmago24 folded before Flop (didn't bet)
Seat 7: dikanmax folded before Flop (didn't bet)
Seat 8: La Ghir (button) mucked
Seat 9: siskin vrach (small blind) folded before Flop



PokerStars Hand #228683694063:  Hold'em No Limit ($0.25/$0.50 USD) - 2021/07/30 13:25:16 ET
Table 'Aitne III' 9-max Seat #9 is the button
Seat 1: Nightwoof ($51.78 in chips) 
Seat 2: YamaRyu9097 ($50 in chips) 
Seat 4: Pachebrash ($51.25 in chips) 
Seat 5: Mmago24 ($74.99 in chips) 
Seat 7: dikanmax ($50 in chips) 
Seat 8: La Ghir ($50 in chips) 
Seat 9: siskin vrach ($87.04 in chips) 
Nightwoof: posts small blind $0.25
YamaRyu9097: posts big blind $0.50
*** HOLE CARDS ***
Pachebrash: raises $1 to $1.50
Mmago24: calls $1.50
dikanmax: folds 
La Ghir: folds 
siskin vrach: folds 
Nightwoof: folds 
YamaRyu9097: folds 
*** FLOP *** [Ad 4d Kh]
Pachebrash: checks 
Mmago24: checks 
*** TURN *** [Ad 4d Kh] [8d]
Pachebrash: bets $2.35
Mmago24: folds 
Uncalled bet ($2.35) returned to Pachebrash
Pachebrash collected $3.56 from pot
Pachebrash: doesn't show hand 
*** SUMMARY ***
Total pot $3.75 | Rake $0.19 
Board [Ad 4d Kh 8d]
Seat 1: Nightwoof (small blind) folded before Flop
Seat 2: YamaRyu9097 (big blind) folded before Flop
Seat 4: Pachebrash collected ($3.56)
Seat 5: Mmago24 folded on the Turn
Seat 7: dikanmax folded before Flop (didn't bet)
Seat 8: La Ghir folded before Flop (didn't bet)
Seat 9: siskin vrach (button) folded before Flop (didn't bet)



PokerStars Hand #228683720897:  Hold'em No Limit ($0.25/$0.50 USD) - 2021/07/30 13:26:23 ET
Table 'Aitne III' 9-max Seat #1 is the button
Seat 1: Nightwoof ($51.53 in chips) 
Seat 2: YamaRyu9097 ($50 in chips) 
Seat 5: Mmago24 ($73.49 in chips) 
Seat 7: dikanmax ($50 in chips) 
Seat 8: La Ghir ($50 in chips) 
Seat 9: siskin vrach ($87.04 in chips) 
YamaRyu9097: posts small blind $0.25
Pachebrash: is sitting out 
Mmago24: posts big blind $0.50
*** HOLE CARDS ***
dikanmax: folds 
La Ghir: folds 
siskin vrach: raises $1 to $1.50
Pachebrash leaves the table
Nightwoof: folds 
YamaRyu9097: folds 
Mmago24: folds 
Uncalled bet ($1) returned to siskin vrach
siskin vrach collected $1.25 from pot
*** SUMMARY ***
Total pot $1.25 | Rake $0 
Seat 1: Nightwoof (button) folded before Flop (didn't bet)
Seat 2: YamaRyu9097 (small blind) folded before Flop
Seat 5: Mmago24 (big blind) folded before Flop
Seat 7: dikanmax folded before Flop (didn't bet)
Seat 8: La Ghir folded before Flop (didn't bet)
Seat 9: siskin vrach collected ($1.25)



PokerStars Hand #228683727005:  Hold'em No Limit ($0.25/$0.50 USD) - 2021/07/30 13:26:38 ET
Table 'Aitne III' 9-max Seat #2 is the button
Seat 1: Nightwoof ($51.53 in chips) 
Seat 2: YamaRyu9097 ($50 in chips) 
Seat 5: Mmago24 ($72.99 in chips) 
Seat 8: La Ghir ($50 in chips) 
Seat 9: siskin vrach ($87.79 in chips) 
Mmago24: posts small blind $0.25
dikanmax: is sitting out 
La Ghir: posts big blind $0.50
*** HOLE CARDS ***
siskin vrach: folds 
Nightwoof: folds 
YamaRyu9097: folds 
Mmago24: raises $1 to $1.50
La Ghir: folds 
Uncalled bet ($1) returned to Mmago24
Mmago24 collected $1 from pot
Mmago24: doesn't show hand 
*** SUMMARY ***
Total pot $1 | Rake $0 
Seat 1: Nightwoof folded before Flop (didn't bet)
Seat 2: YamaRyu9097 (button) folded before Flop (didn't bet)
Seat 5: Mmago24 (small blind) collected ($1)
Seat 8: La Ghir (big blind) folded before Flop
Seat 9: siskin vrach folded before Flop (didn't bet)



PokerStars Hand #228683730180:  Hold'em No Limit ($0.25/$0.50 USD) - 2021/07/30 13:26:46 ET
Table 'Aitne III' 9-max Seat #5 is the button
Seat 1: Nightwoof ($51.53 in chips) 
Seat 2: YamaRyu9097 ($50 in chips) 
Seat 5: Mmago24 ($73.49 in chips) 
Seat 8: La Ghir ($50 in chips) 
Seat 9: siskin vrach ($87.79 in chips) 
La Ghir: posts small blind $0.25
siskin vrach: posts big blind $0.50
*** HOLE CARDS ***
megaman1966 joins the table at seat #4 
Nightwoof: folds 
YamaRyu9097: folds 
Mmago24: raises $0.72 to $1.22
La Ghir: folds 
siskin vrach: folds 
Uncalled bet ($0.72) returned to Mmago24
Mmago24 collected $1.25 from pot
Mmago24: doesn't show hand 
*** SUMMARY ***
Total pot $1.25 | Rake $0 
Seat 1: Nightwoof folded before Flop (didn't bet)
Seat 2: YamaRyu9097 folded before Flop (didn't bet)
Seat 5: Mmago24 (button) collected ($1.25)
Seat 8: La Ghir (small blind) folded before Flop
Seat 9: siskin vrach (big blind) folded before Flop



PokerStars Hand #228685087278:  Hold'em No Limit ($0.25/$0.50 USD) - 2021/07/30 14:21:07 ET
Table 'Aitne III' 9-max Seat #5 is the button
Seat 1: whitecillar3 ($44.47 in chips) 
Seat 2: Kaban7502 ($50.75 in chips) 
Seat 3: Lemmi846 ($50 in chips) 
Seat 4: dikanmax ($50 in chips) 
Seat 5: DOA1980 ($50 in chips) 
Seat 6: Kahmi3105 ($122.20 in chips) 
Seat 7: Pachebrash ($85.16 in chips) 
Seat 8: La Ghir ($50.75 in chips) 
Seat 9: siskin vrach ($50 in chips) 
Kahmi3105: posts small blind $0.25
Pachebrash: posts big blind $0.50
*** HOLE CARDS ***
La Ghir: folds 
siskin vrach: folds 
whitecillar3: folds 
Kaban7502: folds 
Lemmi846: folds 
dikanmax: folds 
DOA1980: folds 
Kahmi3105: calls $0.25
Pachebrash: checks 
*** FLOP *** [9s 5d Kd]
Kahmi3105: checks 
Pachebrash: checks 
*** TURN *** [9s 5d Kd] [3c]
Kahmi3105: checks 
Pachebrash: bets $0.50
Kahmi3105: folds 
Uncalled bet ($0.50) returned to Pachebrash
Pachebrash collected $0.95 from pot
Pachebrash: doesn't show hand 
*** SUMMARY ***
Total pot $1 | Rake $0.05 
Board [9s 5d Kd 3c]
Seat 1: whitecillar3 folded before Flop (didn't bet)
Seat 2: Kaban7502 folded before Flop (didn't bet)
Seat 3: Lemmi846 folded before Flop (didn't bet)
Seat 4: dikanmax folded before Flop (didn't bet)
Seat 5: DOA1980 (button) folded before Flop (didn't bet)
Seat 6: Kahmi3105 (small blind) folded on the Turn
Seat 7: Pachebrash (big blind) collected ($0.95)
Seat 8: La Ghir folded before Flop (didn't bet)
Seat 9: siskin vrach folded before Flop (didn't bet)



PokerStars Hand #228685107613:  Hold'em No Limit ($0.25/$0.50 USD) - 2021/07/30 14:21:55 ET
Table 'Aitne III' 9-max Seat #6 is the button
Seat 1: whitecillar3 ($44.47 in chips) 
Seat 2: Kaban7502 ($50.75 in chips) 
Seat 3: Lemmi846 ($50 in chips) 
Seat 4: dikanmax ($50 in chips) 
Seat 5: DOA1980 ($50 in chips) 
Seat 6: Kahmi3105 ($121.70 in chips) 
Seat 7: Pachebrash ($85.61 in chips) 
Seat 8: La Ghir ($50.75 in chips) 
Seat 9: siskin vrach ($50 in chips) 
Pachebrash: posts small blind $0.25
La Ghir: posts big blind $0.50
*** HOLE CARDS ***
siskin vrach: folds 
whitecillar3: folds 
Kaban7502: folds 
Lemmi846: folds 
dikanmax: folds 
DOA1980: folds 
Kahmi3105: raises $1.25 to $1.75
Pachebrash: folds 
La Ghir: folds 
Uncalled bet ($1.25) returned to Kahmi3105
Kahmi3105 collected $1.25 from pot
*** SUMMARY ***
Total pot $1.25 | Rake $0 
Seat 1: whitecillar3 folded before Flop (didn't bet)
Seat 2: Kaban7502 folded before Flop (didn't bet)
Seat 3: Lemmi846 folded before Flop (didn't bet)
Seat 4: dikanmax folded before Flop (didn't bet)
Seat 5: DOA1980 folded before Flop (didn't bet)
Seat 6: Kahmi3105 (button) collected ($1.25)
Seat 7: Pachebrash (small blind) folded before Flop
Seat 8: La Ghir (big blind) folded before Flop
Seat 9: siskin vrach folded before Flop (didn't bet)



PokerStars Hand #228685117010:  Hold'em No Limit ($0.25/$0.50 USD) - 2021/07/30 14:22:17 ET
Table 'Aitne III' 9-max Seat #7 is the button
Seat 1: whitecillar3 ($44.47 in chips) 
Seat 2: Kaban7502 ($50.75 in chips) 
Seat 3: Lemmi846 ($50 in chips) 
Seat 4: dikanmax ($50 in chips) 
Seat 5: DOA1980 ($50 in chips) 
Seat 6: Kahmi3105 ($122.45 in chips) 
Seat 7: Pachebrash ($85.36 in chips) 
Seat 8: La Ghir ($50.25 in chips) 
Seat 9: siskin vrach ($50 in chips) 
La Ghir: posts small blind $0.25
siskin vrach: posts big blind $0.50
*** HOLE CARDS ***
whitecillar3: raises $0.75 to $1.25
Kaban7502: folds 
Lemmi846: folds 
dikanmax: folds 
DOA1980: folds 
Kahmi3105: folds 
Pachebrash: folds 
La Ghir: calls $1
siskin vrach: folds 
*** FLOP *** [8s 8h 9s]
La Ghir: checks 
whitecillar3: bets $0.88
La Ghir: folds 
Uncalled bet ($0.88) returned to whitecillar3
whitecillar3 collected $2.85 from pot
*** SUMMARY ***
Total pot $3 | Rake $0.15 
Board [8s 8h 9s]
Seat 1: whitecillar3 collected ($2.85)
Seat 2: Kaban7502 folded before Flop (didn't bet)
Seat 3: Lemmi846 folded before Flop (didn't bet)
Seat 4: dikanmax folded before Flop (didn't bet)
Seat 5: DOA1980 folded before Flop (didn't bet)
Seat 6: Kahmi3105 folded before Flop (didn't bet)
Seat 7: Pachebrash (button) folded before Flop (didn't bet)
Seat 8: La Ghir (small blind) folded on the Flop
Seat 9: siskin vrach (big blind) folded before Flop



PokerStars Hand #228685138674:  Hold'em No Limit ($0.25/$0.50 USD) - 2021/07/30 14:23:08 ET
Table 'Aitne III' 9-max Seat #8 is the button
Seat 1: whitecillar3 ($46.07 in chips) 
Seat 2: Kaban7502 ($50.75 in chips) 
Seat 3: Lemmi846 ($50 in chips) 
Seat 4: dikanmax ($50 in chips) 
Seat 5: DOA1980 ($50 in chips) 
Seat 6: Kahmi3105 ($122.45 in chips) 
Seat 7: Pachebrash ($85.36 in chips) 
Seat 8: La Ghir ($50 in chips) 
Seat 9: siskin vrach ($50 in chips) 
siskin vrach: posts small blind $0.25
whitecillar3: posts big blind $0.50
*** HOLE CARDS ***
Kaban7502: folds 
Lemmi846: folds 
dikanmax: folds 
DOA1980: folds 
Kahmi3105: folds 
Pachebrash: folds 
La Ghir: folds 
siskin vrach: folds 
Uncalled bet ($0.25) returned to whitecillar3
whitecillar3 collected $0.50 from pot
*** SUMMARY ***
Total pot $0.50 | Rake $0 
Seat 1: whitecillar3 (big blind) collected ($0.50)
Seat 2: Kaban7502 folded before Flop (didn't bet)
Seat 3: Lemmi846 folded before Flop (didn't bet)
Seat 4: dikanmax folded before Flop (didn't bet)
Seat 5: DOA1980 folded before Flop (didn't bet)
Seat 6: Kahmi3105 folded before Flop (didn't bet)
Seat 7: Pachebrash folded before Flop (didn't bet)
Seat 8: La Ghir (button) folded before Flop (didn't bet)
Seat 9: siskin vrach (small blind) folded before Flop



PokerStars Hand #228685145441:  Hold'em No Limit ($0.25/$0.50 USD) - 2021/07/30 14:23:24 ET
Table 'Aitne III' 9-max Seat #9 is the button
Seat 1: whitecillar3 ($46.32 in chips) 
Seat 2: Kaban7502 ($50.75 in chips) 
Seat 3: Lemmi846 ($50 in chips) 
Seat 4: dikanmax ($50 in chips) 
Seat 5: DOA1980 ($50 in chips) 
Seat 6: Kahmi3105 ($122.45 in chips) 
Seat 7: Pachebrash ($85.36 in chips) 
Seat 8: La Ghir ($50 in chips) 
Seat 9: siskin vrach ($50 in chips) 
whitecillar3: posts small blind $0.25
Kaban7502: posts big blind $0.50
*** HOLE CARDS ***
Lemmi846: folds 
dikanmax: folds 
DOA1980: folds 
Kahmi3105: folds 
Pachebrash: folds 
La Ghir: raises $1 to $1.50
siskin vrach: folds 
whitecillar3: folds 
Kaban7502: calls $1
*** FLOP *** [5s Jd 6s]
Kaban7502: bets $3.09
La Ghir: folds 
Uncalled bet ($3.09) returned to Kaban7502
Kaban7502 collected $3.05 from pot
Kaban7502: doesn't show hand 
*** SUMMARY ***
Total pot $3.25 | Rake $0.20 
Board [5s Jd 6s]
Seat 1: whitecillar3 (small blind) folded before Flop
Seat 2: Kaban7502 (big blind) collected ($3.05)
Seat 3: Lemmi846 folded before Flop (didn't bet)
Seat 4: dikanmax folded before Flop (didn't bet)
Seat 5: DOA1980 folded before Flop (didn't bet)
Seat 6: Kahmi3105 folded before Flop (didn't bet)
Seat 7: Pachebrash folded before Flop (didn't bet)
Seat 8: La Ghir folded on the Flop
Seat 9: siskin vrach (button) folded before Flop (didn't bet)



PokerStars Hand #228685156308:  Hold'em No Limit ($0.25/$0.50 USD) - 2021/07/30 14:23:50 ET
Table 'Aitne III' 9-max Seat #1 is the button
Seat 1: whitecillar3 ($46.07 in chips) 
Seat 2: Kaban7502 ($52.30 in chips) 
Seat 3: Lemmi846 ($50 in chips) 
Seat 4: dikanmax ($50 in chips) 
Seat 5: DOA1980 ($50 in chips) 
Seat 6: Kahmi3105 ($122.45 in chips) 
Seat 7: Pachebrash ($85.36 in chips) 
Seat 8: La Ghir ($50 in chips) 
Seat 9: siskin vrach ($50 in chips) 
Kaban7502: posts small blind $0.25
Lemmi846: posts big blind $0.50
*** HOLE CARDS ***
dikanmax: folds 
DOA1980: folds 
Kahmi3105: folds 
Pachebrash: folds 
La Ghir: raises $1 to $1.50
siskin vrach: calls $1.50
whitecillar3: folds 
Kaban7502: calls $1.25
Lemmi846: calls $1
*** FLOP *** [5d 5s 7c]
Kaban7502: checks 
Lemmi846: checks 
La Ghir: checks 
siskin vrach: checks 
*** TURN *** [5d 5s 7c] [Ac]
Kaban7502: bets $0.50
Lemmi846: folds 
La Ghir: calls $0.50
siskin vrach: folds 
*** RIVER *** [5d 5s 7c Ac] [5c]
Kaban7502: bets $6.65
La Ghir: calls $6.65
*** SHOW DOWN ***
Kaban7502: shows [4s As] (a full house, Fives full of Aces)
La Ghir: shows [Ah 6h] (a full house, Fives full of Aces)
Kaban7502 collected $9.51 from pot
La Ghir collected $9.64 from pot
*** SUMMARY ***
Total pot $20.30 | Rake $1.15 
Board [5d 5s 7c Ac 5c]
Seat 1: whitecillar3 (button) folded before Flop (didn't bet)
Seat 2: Kaban7502 (small blind) showed [4s As] and won ($9.51) with a full house, Fives full of Aces
Seat 3: Lemmi846 (big blind) folded on the Turn
Seat 4: dikanmax folded before Flop (didn't bet)
Seat 5: DOA1980 folded before Flop (didn't bet)
Seat 6: Kahmi3105 folded before Flop (didn't bet)
Seat 7: Pachebrash folded before Flop (didn't bet)
Seat 8: La Ghir showed [Ah 6h] and won ($9.64) with a full house, Fives full of Aces
Seat 9: siskin vrach folded on the Turn



PokerStars Hand #228685183473:  Hold'em No Limit ($0.25/$0.50 USD) - 2021/07/30 14:24:55 ET
Table 'Aitne III' 9-max Seat #2 is the button
Seat 1: whitecillar3 ($46.07 in chips) 
Seat 2: Kaban7502 ($53.16 in chips) 
Seat 3: Lemmi846 ($50 in chips) 
Seat 4: dikanmax ($50 in chips) 
Seat 5: DOA1980 ($50 in chips) 
Seat 6: Kahmi3105 ($122.45 in chips) 
Seat 7: Pachebrash ($85.36 in chips) 
Seat 8: La Ghir ($50.99 in chips) 
Seat 9: siskin vrach ($50 in chips) 
Lemmi846: posts small blind $0.25
dikanmax: posts big blind $0.50
*** HOLE CARDS ***
DOA1980: folds 
Kahmi3105: calls $0.50
Pachebrash: folds 
La Ghir: raises $1.50 to $2
siskin vrach: folds 
whitecillar3: folds 
Kaban7502: folds 
Lemmi846: folds 
dikanmax: folds 
Kahmi3105: calls $1.50
*** FLOP *** [Kh 5s Qc]
Kahmi3105: checks 
La Ghir: checks 
*** TURN *** [Kh 5s Qc] [8d]
Kahmi3105: checks 
La Ghir: bets $2.26
Kahmi3105: folds 
Uncalled bet ($2.26) returned to La Ghir
La Ghir collected $4.51 from pot
La Ghir: doesn't show hand 
*** SUMMARY ***
Total pot $4.75 | Rake $0.24 
Board [Kh 5s Qc 8d]
Seat 1: whitecillar3 folded before Flop (didn't bet)
Seat 2: Kaban7502 (button) folded before Flop (didn't bet)
Seat 3: Lemmi846 (small blind) folded before Flop
Seat 4: dikanmax (big blind) folded before Flop
Seat 5: DOA1980 folded before Flop (didn't bet)
Seat 6: Kahmi3105 folded on the Turn
Seat 7: Pachebrash folded before Flop (didn't bet)
Seat 8: La Ghir collected ($4.51)
Seat 9: siskin vrach folded before Flop (didn't bet)



PokerStars Hand #228685196787:  Hold'em No Limit ($0.25/$0.50 USD) - 2021/07/30 14:25:26 ET
Table 'Aitne III' 9-max Seat #3 is the button
Seat 1: whitecillar3 ($46.07 in chips) 
Seat 2: Kaban7502 ($53.16 in chips) 
Seat 3: Lemmi846 ($50 in chips) 
Seat 4: dikanmax ($50 in chips) 
Seat 5: DOA1980 ($50 in chips) 
Seat 6: Kahmi3105 ($120.45 in chips) 
Seat 7: Pachebrash ($85.36 in chips) 
Seat 8: La Ghir ($53.50 in chips) 
Seat 9: siskin vrach ($50 in chips) 
dikanmax: posts small blind $0.25
DOA1980: posts big blind $0.50
*** HOLE CARDS ***
Kahmi3105: raises $1.25 to $1.75
Pachebrash: folds 
La Ghir: folds 
siskin vrach: folds 
whitecillar3: folds 
Kaban7502: folds 
Lemmi846: folds 
dikanmax: folds 
DOA1980: folds 
Uncalled bet ($1.25) returned to Kahmi3105
Kahmi3105 collected $1.25 from pot
*** SUMMARY ***
Total pot $1.25 | Rake $0 
Seat 1: whitecillar3 folded before Flop (didn't bet)
Seat 2: Kaban7502 folded before Flop (didn't bet)
Seat 3: Lemmi846 (button) folded before Flop (didn't bet)
Seat 4: dikanmax (small blind) folded before Flop
Seat 5: DOA1980 (big blind) folded before Flop
Seat 6: Kahmi3105 collected ($1.25)
Seat 7: Pachebrash folded before Flop (didn't bet)
Seat 8: La Ghir folded before Flop (didn't bet)
Seat 9: siskin vrach folded before Flop (didn't bet)



PokerStars Hand #228685205751:  Hold'em No Limit ($0.25/$0.50 USD) - 2021/07/30 14:25:48 ET
Table 'Aitne III' 9-max Seat #4 is the button
Seat 1: whitecillar3 ($46.07 in chips) 
Seat 2: Kaban7502 ($53.16 in chips) 
Seat 3: Lemmi846 ($50 in chips) 
Seat 4: dikanmax ($50 in chips) 
Seat 5: DOA1980 ($50 in chips) 
Seat 6: Kahmi3105 ($121.20 in chips) 
Seat 7: Pachebrash ($85.36 in chips) 
Seat 8: La Ghir ($53.50 in chips) 
Seat 9: siskin vrach ($50 in chips) 
DOA1980: posts small blind $0.25
Kahmi3105: posts big blind $0.50
*** HOLE CARDS ***
Pachebrash: folds 
La Ghir: folds 
siskin vrach: folds 
whitecillar3: raises $0.75 to $1.25
Kaban7502: folds 
Lemmi846: folds 
dikanmax: folds 
DOA1980: folds 
Kahmi3105: folds 
Uncalled bet ($0.75) returned to whitecillar3
whitecillar3 collected $1.25 from pot
*** SUMMARY ***
Total pot $1.25 | Rake $0 
Seat 1: whitecillar3 collected ($1.25)
Seat 2: Kaban7502 folded before Flop (didn't bet)
Seat 3: Lemmi846 folded before Flop (didn't bet)
Seat 4: dikanmax (button) folded before Flop (didn't bet)
Seat 5: DOA1980 (small blind) folded before Flop
Seat 6: Kahmi3105 (big blind) folded before Flop
Seat 7: Pachebrash folded before Flop (didn't bet)
Seat 8: La Ghir folded before Flop (didn't bet)
Seat 9: siskin vrach folded before Flop (didn't bet)



PokerStars Hand #228685213566:  Hold'em No Limit ($0.25/$0.50 USD) - 2021/07/30 14:26:06 ET
Table 'Aitne III' 9-max Seat #5 is the button
Seat 1: whitecillar3 ($46.82 in chips) 
Seat 2: Kaban7502 ($53.16 in chips) 
Seat 3: Lemmi846 ($50 in chips) 
Seat 4: dikanmax ($50 in chips) 
Seat 5: DOA1980 ($50 in chips) 
Seat 6: Kahmi3105 ($120.70 in chips) 
Seat 7: Pachebrash ($85.36 in chips) 
Seat 8: La Ghir ($53.50 in chips) 
Seat 9: siskin vrach ($50 in chips) 
Kahmi3105: posts small blind $0.25
Pachebrash: posts big blind $0.50
*** HOLE CARDS ***
La Ghir: folds 
siskin vrach: folds 
whitecillar3: folds 
Kaban7502: folds 
Lemmi846: folds 
dikanmax: raises $1 to $1.50
DOA1980: folds 
Kahmi3105: folds 
Pachebrash: folds 
Uncalled bet ($1) returned to dikanmax
dikanmax collected $1.25 from pot
dikanmax: doesn't show hand 
*** SUMMARY ***
Total pot $1.25 | Rake $0 
Seat 1: whitecillar3 folded before Flop (didn't bet)
Seat 2: Kaban7502 folded before Flop (didn't bet)
Seat 3: Lemmi846 folded before Flop (didn't bet)
Seat 4: dikanmax collected ($1.25)
Seat 5: DOA1980 (button) folded before Flop (didn't bet)
Seat 6: Kahmi3105 (small blind) folded before Flop
Seat 7: Pachebrash (big blind) folded before Flop
Seat 8: La Ghir folded before Flop (didn't bet)
Seat 9: siskin vrach folded before Flop (didn't bet)



PokerStars Hand #228685223057:  Hold'em No Limit ($0.25/$0.50 USD) - 2021/07/30 14:26:29 ET
Table 'Aitne III' 9-max Seat #6 is the button
Seat 1: whitecillar3 ($46.82 in chips) 
Seat 2: Kaban7502 ($53.16 in chips) 
Seat 3: Lemmi846 ($50 in chips) 
Seat 4: dikanmax ($50.75 in chips) 
Seat 5: DOA1980 ($50 in chips) 
Seat 6: Kahmi3105 ($120.45 in chips) 
Seat 7: Pachebrash ($84.86 in chips) 
Seat 8: La Ghir ($53.50 in chips) 
Seat 9: siskin vrach ($50 in chips) 
Pachebrash: posts small blind $0.25
La Ghir: posts big blind $0.50
*** HOLE CARDS ***
siskin vrach: folds 
whitecillar3: folds 
Kaban7502: folds 
Lemmi846: folds 
dikanmax: folds 
DOA1980: folds 
Kahmi3105: raises $1.25 to $1.75
Pachebrash: folds 
La Ghir: folds 
Uncalled bet ($1.25) returned to Kahmi3105
Kahmi3105 collected $1.25 from pot
*** SUMMARY ***
Total pot $1.25 | Rake $0 
Seat 1: whitecillar3 folded before Flop (didn't bet)
Seat 2: Kaban7502 folded before Flop (didn't bet)
Seat 3: Lemmi846 folded before Flop (didn't bet)
Seat 4: dikanmax folded before Flop (didn't bet)
Seat 5: DOA1980 folded before Flop (didn't bet)
Seat 6: Kahmi3105 (button) collected ($1.25)
Seat 7: Pachebrash (small blind) folded before Flop
Seat 8: La Ghir (big blind) folded before Flop
Seat 9: siskin vrach folded before Flop (didn't bet)



PokerStars Hand #228685237197:  Hold'em No Limit ($0.25/$0.50 USD) - 2021/07/30 14:27:03 ET
Table 'Aitne III' 9-max Seat #7 is the button
Seat 1: whitecillar3 ($46.82 in chips) 
Seat 2: Kaban7502 ($53.16 in chips) 
Seat 3: Lemmi846 ($50 in chips) 
Seat 4: dikanmax ($50.75 in chips) 
Seat 5: DOA1980 ($50 in chips) 
Seat 6: Kahmi3105 ($121.20 in chips) 
Seat 7: Pachebrash ($84.61 in chips) 
Seat 8: La Ghir ($53 in chips) 
Seat 9: siskin vrach ($50 in chips) 
La Ghir: posts small blind $0.25
siskin vrach: posts big blind $0.50
*** HOLE CARDS ***
whitecillar3: raises $0.75 to $1.25
Kaban7502: folds 
Lemmi846: folds 
dikanmax: folds 
DOA1980: folds 
Kahmi3105: calls $1.25
Pachebrash: folds 
La Ghir: folds 
siskin vrach: folds 
*** FLOP *** [Kh 4c Ac]
whitecillar3: bets $1.58
Kahmi3105: calls $1.58
*** TURN *** [Kh 4c Ac] [8s]
whitecillar3: bets $4.63
Kahmi3105: folds 
Uncalled bet ($4.63) returned to whitecillar3
whitecillar3 collected $6.09 from pot
*** SUMMARY ***
Total pot $6.41 | Rake $0.32 
Board [Kh 4c Ac 8s]
Seat 1: whitecillar3 collected ($6.09)
Seat 2: Kaban7502 folded before Flop (didn't bet)
Seat 3: Lemmi846 folded before Flop (didn't bet)
Seat 4: dikanmax folded before Flop (didn't bet)
Seat 5: DOA1980 folded before Flop (didn't bet)
Seat 6: Kahmi3105 folded on the Turn
Seat 7: Pachebrash (button) folded before Flop (didn't bet)
Seat 8: La Ghir (small blind) folded before Flop
Seat 9: siskin vrach (big blind) folded before Flop



PokerStars Hand #228685259428:  Hold'em No Limit ($0.25/$0.50 USD) - 2021/07/30 14:27:46 ET
Table 'Aitne III' 9-max Seat #8 is the button
Seat 1: whitecillar3 ($50.08 in chips) 
Seat 2: Kaban7502 ($53.16 in chips) 
Seat 3: Lemmi846 ($50 in chips) 
Seat 4: dikanmax ($50.75 in chips) 
Seat 5: DOA1980 ($50 in chips) 
Seat 6: Kahmi3105 ($118.37 in chips) 
Seat 7: Pachebrash ($84.61 in chips) 
Seat 8: La Ghir ($52.75 in chips) 
Seat 9: siskin vrach ($50 in chips) 
siskin vrach: posts small blind $0.25
whitecillar3: posts big blind $0.50
*** HOLE CARDS ***
Kaban7502: folds 
Lemmi846: folds 
dikanmax: folds 
DOA1980: raises $0.75 to $1.25
Kahmi3105: calls $1.25
Pachebrash: folds 
La Ghir: calls $1.25
siskin vrach: folds 
whitecillar3: folds 
*** FLOP *** [7d 3h 6d]
DOA1980: checks 
Kahmi3105: checks 
La Ghir: checks 
*** TURN *** [7d 3h 6d] [9h]
DOA1980: bets $5.78
Kahmi3105: folds 
La Ghir: calls $5.78
*** RIVER *** [7d 3h 6d 9h] [Qc]
DOA1980: bets $5
La Ghir: folds 
Uncalled bet ($5) returned to DOA1980
DOA1980 collected $15.26 from pot
DOA1980: doesn't show hand 
*** SUMMARY ***
Total pot $16.06 | Rake $0.80 
Board [7d 3h 6d 9h Qc]
Seat 1: whitecillar3 (big blind) folded before Flop
Seat 2: Kaban7502 folded before Flop (didn't bet)
Seat 3: Lemmi846 folded before Flop (didn't bet)
Seat 4: dikanmax folded before Flop (didn't bet)
Seat 5: DOA1980 collected ($15.26)
Seat 6: Kahmi3105 folded on the Turn
Seat 7: Pachebrash folded before Flop (didn't bet)
Seat 8: La Ghir (button) folded on the River
Seat 9: siskin vrach (small blind) folded before Flop



PokerStars Hand #228685301499:  Hold'em No Limit ($0.25/$0.50 USD) - 2021/07/30 14:29:26 ET
Table 'Aitne III' 9-max Seat #9 is the button
Seat 1: whitecillar3 ($49.58 in chips) 
Seat 2: Kaban7502 ($53.16 in chips) 
Seat 3: Lemmi846 ($50 in chips) 
Seat 4: dikanmax ($50.75 in chips) 
Seat 6: Kahmi3105 ($117.12 in chips) 
Seat 7: Pachebrash ($84.61 in chips) 
Seat 8: La Ghir ($50 in chips) 
Seat 9: siskin vrach ($50 in chips) 
whitecillar3: posts small blind $0.25
Kaban7502: posts big blind $0.50
*** HOLE CARDS ***
Lemmi846: folds 
dikanmax: folds 
Kahmi3105: folds 
Pachebrash: folds 
La Ghir: folds 
DOA1980 leaves the table
siskin vrach: folds 
whitecillar3: folds 
Uncalled bet ($0.25) returned to Kaban7502
Kaban7502 collected $0.50 from pot
Kaban7502: doesn't show hand 
*** SUMMARY ***
Total pot $0.50 | Rake $0 
Seat 1: whitecillar3 (small blind) folded before Flop
Seat 2: Kaban7502 (big blind) collected ($0.50)
Seat 3: Lemmi846 folded before Flop (didn't bet)
Seat 4: dikanmax folded before Flop (didn't bet)
Seat 6: Kahmi3105 folded before Flop (didn't bet)
Seat 7: Pachebrash folded before Flop (didn't bet)
Seat 8: La Ghir folded before Flop (didn't bet)
Seat 9: siskin vrach (button) folded before Flop (didn't bet)



PokerStars Hand #228685308841:  Hold'em No Limit ($0.25/$0.50 USD) - 2021/07/30 14:29:43 ET
Table 'Aitne III' 9-max Seat #1 is the button
Seat 1: whitecillar3 ($49.33 in chips) 
Seat 2: Kaban7502 ($53.41 in chips) 
Seat 3: Lemmi846 ($50 in chips) 
Seat 4: dikanmax ($50.75 in chips) 
Seat 6: Kahmi3105 ($117.12 in chips) 
Seat 7: Pachebrash ($84.61 in chips) 
Seat 8: La Ghir ($50 in chips) 
Seat 9: siskin vrach ($50 in chips) 
Kaban7502: posts small blind $0.25
Lemmi846: posts big blind $0.50
*** HOLE CARDS ***
dikanmax: raises $1 to $1.50
Kahmi3105: folds 
Pachebrash: folds 
La Ghir: folds 
siskin vrach: folds 
whitecillar3: folds 
Kaban7502: folds 
Lemmi846: folds 
Uncalled bet ($1) returned to dikanmax
dikanmax collected $1.25 from pot
dikanmax: doesn't show hand 
*** SUMMARY ***
Total pot $1.25 | Rake $0 
Seat 1: whitecillar3 (button) folded before Flop (didn't bet)
Seat 2: Kaban7502 (small blind) folded before Flop
Seat 3: Lemmi846 (big blind) folded before Flop
Seat 4: dikanmax collected ($1.25)
Seat 6: Kahmi3105 folded before Flop (didn't bet)
Seat 7: Pachebrash folded before Flop (didn't bet)
Seat 8: La Ghir folded before Flop (didn't bet)
Seat 9: siskin vrach folded before Flop (didn't bet)



PokerStars Hand #228685319104:  Hold'em No Limit ($0.25/$0.50 USD) - 2021/07/30 14:30:07 ET
Table 'Aitne III' 9-max Seat #2 is the button
Seat 1: whitecillar3 ($49.33 in chips) 
Seat 2: Kaban7502 ($53.16 in chips) 
Seat 3: Lemmi846 ($50 in chips) 
Seat 6: Kahmi3105 ($117.12 in chips) 
Seat 7: Pachebrash ($84.61 in chips) 
Seat 8: La Ghir ($50 in chips) 
Seat 9: siskin vrach ($50 in chips) 
Lemmi846: posts small blind $0.25
dikanmax: is sitting out 
Kahmi3105: posts big blind $0.50
*** HOLE CARDS ***
Pachebrash: folds 
La Ghir: folds 
siskin vrach: folds 
whitecillar3: folds 
Kaban7502: raises $0.50 to $1
Lemmi846: folds 
Kahmi3105: calls $0.50
*** FLOP *** [8d 2h 9d]
Kahmi3105: checks 
Kaban7502: bets $2.14
Kahmi3105: calls $2.14
*** TURN *** [8d 2h 9d] [4h]
Kahmi3105: checks 
Kaban7502: bets $6.20
Kahmi3105: folds 
Uncalled bet ($6.20) returned to Kaban7502
Kaban7502 collected $6.12 from pot
Kaban7502: doesn't show hand 
*** SUMMARY ***
Total pot $6.53 | Rake $0.41 
Board [8d 2h 9d 4h]
Seat 1: whitecillar3 folded before Flop (didn't bet)
Seat 2: Kaban7502 (button) collected ($6.12)
Seat 3: Lemmi846 (small blind) folded before Flop
Seat 6: Kahmi3105 (big blind) folded on the Turn
Seat 7: Pachebrash folded before Flop (didn't bet)
Seat 8: La Ghir folded before Flop (didn't bet)
Seat 9: siskin vrach folded before Flop (didn't bet)



PokerStars Hand #228685332949:  Hold'em No Limit ($0.25/$0.50 USD) - 2021/07/30 14:30:40 ET
Table 'Aitne III' 9-max Seat #3 is the button
Seat 1: whitecillar3 ($49.33 in chips) 
Seat 2: Kaban7502 ($56.14 in chips) 
Seat 3: Lemmi846 ($50 in chips) 
Seat 6: Kahmi3105 ($113.98 in chips) 
Seat 7: Pachebrash ($84.61 in chips) 
Seat 8: La Ghir ($50 in chips) 
Seat 9: siskin vrach ($50 in chips) 
Kahmi3105: posts small blind $0.25
Pachebrash: posts big blind $0.50
*** HOLE CARDS ***
FoodPRO2012 joins the table at seat #5 
La Ghir: raises $1 to $1.50
siskin vrach: folds 
whitecillar3: folds 
Kaban7502: folds 
Lemmi846: folds 
Kahmi3105: folds 
Pachebrash: folds 
Uncalled bet ($1) returned to La Ghir
La Ghir collected $1.25 from pot
La Ghir: doesn't show hand 
*** SUMMARY ***
Total pot $1.25 | Rake $0 
Seat 1: whitecillar3 folded before Flop (didn't bet)
Seat 2: Kaban7502 folded before Flop (didn't bet)
Seat 3: Lemmi846 (button) folded before Flop (didn't bet)
Seat 6: Kahmi3105 (small blind) folded before Flop
Seat 7: Pachebrash (big blind) folded before Flop
Seat 8: La Ghir collected ($1.25)
Seat 9: siskin vrach folded before Flop (didn't bet)



PokerStars Hand #228685342059:  Hold'em No Limit ($0.25/$0.50 USD) - 2021/07/30 14:31:01 ET
Table 'Aitne III' 9-max Seat #6 is the button
Seat 1: whitecillar3 ($49.33 in chips) 
Seat 2: Kaban7502 ($56.14 in chips) 
Seat 3: Lemmi846 ($50 in chips) 
Seat 5: FoodPRO2012 ($40 in chips) 
Seat 6: Kahmi3105 ($113.73 in chips) 
Seat 7: Pachebrash ($84.11 in chips) 
Seat 8: La Ghir ($50.75 in chips) 
Seat 9: siskin vrach ($50 in chips) 
Pachebrash: posts small blind $0.25
La Ghir: posts big blind $0.50
FoodPRO2012: posts big blind $0.50
*** HOLE CARDS ***
siskin vrach: folds 
whitecillar3: folds 
Kaban7502: folds 
Lemmi846: folds 
FoodPRO2012: checks 
Kahmi3105: folds 
Pachebrash: calls $0.25
La Ghir: checks 
*** FLOP *** [6s Qh 4c]
Pachebrash: checks 
La Ghir: checks 
FoodPRO2012: checks 
*** TURN *** [6s Qh 4c] [8s]
Pachebrash: bets $0.72
La Ghir: folds 
FoodPRO2012: folds 
Uncalled bet ($0.72) returned to Pachebrash
Pachebrash collected $1.42 from pot
Pachebrash: doesn't show hand 
*** SUMMARY ***
Total pot $1.50 | Rake $0.08 
Board [6s Qh 4c 8s]
Seat 1: whitecillar3 folded before Flop (didn't bet)
Seat 2: Kaban7502 folded before Flop (didn't bet)
Seat 3: Lemmi846 folded before Flop (didn't bet)
Seat 5: FoodPRO2012 folded on the Turn (didn't bet)
Seat 6: Kahmi3105 (button) folded before Flop (didn't bet)
Seat 7: Pachebrash (small blind) collected ($1.42)
Seat 8: La Ghir (big blind) folded on the Turn
Seat 9: siskin vrach folded before Flop (didn't bet)



PokerStars Hand #228685357384:  Hold'em No Limit ($0.25/$0.50 USD) - 2021/07/30 14:31:37 ET
Table 'Aitne III' 9-max Seat #7 is the button
Seat 1: whitecillar3 ($49.33 in chips) 
Seat 2: Kaban7502 ($56.14 in chips) 
Seat 3: Lemmi846 ($50 in chips) 
Seat 5: FoodPRO2012 ($39.50 in chips) 
Seat 6: Kahmi3105 ($113.73 in chips) 
Seat 7: Pachebrash ($85.03 in chips) 
Seat 8: La Ghir ($50.25 in chips) 
Seat 9: siskin vrach ($50 in chips) 
La Ghir: posts small blind $0.25
siskin vrach: posts big blind $0.50
*** HOLE CARDS ***
whitecillar3: folds 
Kaban7502: raises $0.50 to $1
Lemmi846: calls $1
FoodPRO2012: folds 
Kahmi3105 has timed out
Kahmi3105: folds 
Pachebrash: folds 
La Ghir: folds 
siskin vrach: calls $0.50
*** FLOP *** [5c Jh Kc]
siskin vrach: checks 
Kaban7502: checks 
Lemmi846: bets $2
siskin vrach: calls $2
Kaban7502: calls $2
*** TURN *** [5c Jh Kc] [Qd]
siskin vrach: checks 
Kaban7502: checks 
Lemmi846: bets $5.50
siskin vrach: folds 
Kaban7502: raises $5.50 to $11
Lemmi846: calls $5.50
*** RIVER *** [5c Jh Kc Qd] [7c]
Kaban7502: bets $42.14 and is all-in
Lemmi846: calls $36 and is all-in
Uncalled bet ($6.14) returned to Kaban7502
*** SHOW DOWN ***
Kaban7502: shows [Th Ac] (a straight, Ten to Ace)
Lemmi846: shows [9c Tc] (a flush, King high)
Lemmi846 collected $100.75 from pot
*** SUMMARY ***
Total pot $103.25 | Rake $2.50 
Board [5c Jh Kc Qd 7c]
Seat 1: whitecillar3 folded before Flop (didn't bet)
Seat 2: Kaban7502 showed [Th Ac] and lost with a straight, Ten to Ace
Seat 3: Lemmi846 showed [9c Tc] and won ($100.75) with a flush, King high
Seat 5: FoodPRO2012 folded before Flop (didn't bet)
Seat 6: Kahmi3105 folded before Flop (didn't bet)
Seat 7: Pachebrash (button) folded before Flop (didn't bet)
Seat 8: La Ghir (small blind) folded before Flop
Seat 9: siskin vrach (big blind) folded on the Turn



PokerStars Hand #228685398840:  Hold'em No Limit ($0.25/$0.50 USD) - 2021/07/30 14:33:14 ET
Table 'Aitne III' 9-max Seat #8 is the button
Seat 1: whitecillar3 ($49.33 in chips) 
Seat 2: Kaban7502 ($6.14 in chips) 
Seat 3: Lemmi846 ($100.75 in chips) 
Seat 5: FoodPRO2012 ($39.50 in chips) 
Seat 6: Kahmi3105 ($113.73 in chips) 
Seat 7: Pachebrash ($85.03 in chips) 
Seat 8: La Ghir ($50 in chips) 
Seat 9: siskin vrach ($50 in chips) 
siskin vrach: posts small blind $0.25
whitecillar3: posts big blind $0.50
*** HOLE CARDS ***
Kaban7502: folds 
Lemmi846: folds 
FoodPRO2012: calls $0.50
Kahmi3105: calls $0.50
Pachebrash: folds 
La Ghir: folds 
siskin vrach: folds 
whitecillar3: checks 
*** FLOP *** [6d Ts 6c]
whitecillar3: checks 
FoodPRO2012: bets $0.50
Kahmi3105: calls $0.50
whitecillar3: folds 
*** TURN *** [6d Ts 6c] [As]
FoodPRO2012: bets $0.50
Kahmi3105: calls $0.50
*** RIVER *** [6d Ts 6c As] [3c]
FoodPRO2012: bets $0.50
Kahmi3105: calls $0.50
*** SHOW DOWN ***
FoodPRO2012: shows [Ah 7d] (two pair, Aces and Sixes)
Kahmi3105: mucks hand 
FoodPRO2012 collected $4.51 from pot
*** SUMMARY ***
Total pot $4.75 | Rake $0.24 
Board [6d Ts 6c As 3c]
Seat 1: whitecillar3 (big blind) folded on the Flop
Seat 2: Kaban7502 folded before Flop (didn't bet)
Seat 3: Lemmi846 folded before Flop (didn't bet)
Seat 5: FoodPRO2012 showed [Ah 7d] and won ($4.51) with two pair, Aces and Sixes
Seat 6: Kahmi3105 mucked
Seat 7: Pachebrash folded before Flop (didn't bet)
Seat 8: La Ghir (button) folded before Flop (didn't bet)
Seat 9: siskin vrach (small blind) folded before Flop



PokerStars Hand #228685417467:  Hold'em No Limit ($0.25/$0.50 USD) - 2021/07/30 14:33:58 ET
Table 'Aitne III' 9-max Seat #9 is the button
Seat 1: whitecillar3 ($48.83 in chips) 
Seat 2: Kaban7502 ($50 in chips) 
Seat 3: Lemmi846 ($100.75 in chips) 
Seat 5: FoodPRO2012 ($42.01 in chips) 
Seat 6: Kahmi3105 ($111.73 in chips) 
Seat 7: Pachebrash ($85.03 in chips) 
Seat 8: La Ghir ($50 in chips) 
Seat 9: siskin vrach ($50 in chips) 
whitecillar3: posts small blind $0.25
Kaban7502: posts big blind $0.50
*** HOLE CARDS ***
Lemmi846: folds 
FoodPRO2012: folds 
Kahmi3105: calls $0.50
Pachebrash: folds 
La Ghir: folds 
siskin vrach: raises $1.50 to $2
whitecillar3: folds 
Kaban7502: calls $1.50
Kahmi3105: calls $1.50
*** FLOP *** [Kd Ac Qc]
Kaban7502: checks 
Kahmi3105: checks 
siskin vrach: checks 
*** TURN *** [Kd Ac Qc] [Ks]
Kaban7502: bets $0.50
Kahmi3105: calls $0.50
siskin vrach: folds 
*** RIVER *** [Kd Ac Qc Ks] [2h]
Kaban7502: checks 
Kahmi3105: checks 
*** SHOW DOWN ***
Kaban7502: shows [Qd Jc] (two pair, Kings and Queens)
Kahmi3105: shows [Ah 6s] (two pair, Aces and Kings)
Kahmi3105 collected $6.80 from pot
*** SUMMARY ***
Total pot $7.25 | Rake $0.45 
Board [Kd Ac Qc Ks 2h]
Seat 1: whitecillar3 (small blind) folded before Flop
Seat 2: Kaban7502 (big blind) showed [Qd Jc] and lost with two pair, Kings and Queens
Seat 3: Lemmi846 folded before Flop (didn't bet)
Seat 5: FoodPRO2012 folded before Flop (didn't bet)
Seat 6: Kahmi3105 showed [Ah 6s] and won ($6.80) with two pair, Aces and Kings
Seat 7: Pachebrash folded before Flop (didn't bet)
Seat 8: La Ghir folded before Flop (didn't bet)
Seat 9: siskin vrach (button) folded on the Turn



PokerStars Hand #228685432820:  Hold'em No Limit ($0.25/$0.50 USD) - 2021/07/30 14:34:34 ET
Table 'Aitne III' 9-max Seat #1 is the button
Seat 1: whitecillar3 ($48.58 in chips) 
Seat 2: Kaban7502 ($47.50 in chips) 
Seat 3: Lemmi846 ($100.75 in chips) 
Seat 5: FoodPRO2012 ($42.01 in chips) 
Seat 6: Kahmi3105 ($116.03 in chips) 
Seat 7: Pachebrash ($85.03 in chips) 
Seat 8: La Ghir ($50 in chips) 
Seat 9: siskin vrach ($50 in chips) 
Kaban7502: posts small blind $0.25
Lemmi846: posts big blind $0.50
*** HOLE CARDS ***
FoodPRO2012: folds 
Kahmi3105: folds 
Pachebrash: folds 
La Ghir: folds 
siskin vrach: raises $1 to $1.50
whitecillar3: raises $3.25 to $4.75
Kaban7502: folds 
Lemmi846: folds 
siskin vrach: folds 
Uncalled bet ($3.25) returned to whitecillar3
whitecillar3 collected $3.75 from pot
*** SUMMARY ***
Total pot $3.75 | Rake $0 
Seat 1: whitecillar3 (button) collected ($3.75)
Seat 2: Kaban7502 (small blind) folded before Flop
Seat 3: Lemmi846 (big blind) folded before Flop
Seat 5: FoodPRO2012 folded before Flop (didn't bet)
Seat 6: Kahmi3105 folded before Flop (didn't bet)
Seat 7: Pachebrash folded before Flop (didn't bet)
Seat 8: La Ghir folded before Flop (didn't bet)
Seat 9: siskin vrach folded before Flop



PokerStars Hand #228685451697:  Hold'em No Limit ($0.25/$0.50 USD) - 2021/07/30 14:35:19 ET
Table 'Aitne III' 9-max Seat #2 is the button
Seat 1: whitecillar3 ($50.83 in chips) 
Seat 2: Kaban7502 ($47.25 in chips) 
Seat 3: Lemmi846 ($100.25 in chips) 
Seat 4: dikanmax ($51.50 in chips) 
Seat 5: FoodPRO2012 ($42.01 in chips) 
Seat 6: Kahmi3105 ($116.03 in chips) 
Seat 7: Pachebrash ($85.03 in chips) 
Seat 8: La Ghir ($50 in chips) 
Seat 9: siskin vrach ($50 in chips) 
Lemmi846: posts small blind $0.25
dikanmax: posts big blind $0.50
*** HOLE CARDS ***
FoodPRO2012: calls $0.50
Kahmi3105: folds 
Pachebrash: raises $1.50 to $2
La Ghir: folds 
siskin vrach: folds 
whitecillar3: folds 
Kaban7502: calls $2
Lemmi846: folds 
dikanmax: folds 
FoodPRO2012: calls $1.50
*** FLOP *** [2d Jc 9h]
FoodPRO2012: checks 
Pachebrash: bets $3.50
Kaban7502: calls $3.50
FoodPRO2012: folds 
*** TURN *** [2d Jc 9h] [Qd]
Pachebrash: bets $7.25
Kaban7502: calls $7.25
*** RIVER *** [2d Jc 9h Qd] [4d]
Pachebrash: bets $12.25
Kaban7502: calls $12.25
*** SHOW DOWN ***
Pachebrash: shows [Kh Ks] (a pair of Kings)
Kaban7502: mucks hand 
Pachebrash collected $50.75 from pot
*** SUMMARY ***
Total pot $52.75 | Rake $2 
Board [2d Jc 9h Qd 4d]
Seat 1: whitecillar3 folded before Flop (didn't bet)
Seat 2: Kaban7502 (button) mucked
Seat 3: Lemmi846 (small blind) folded before Flop
Seat 4: dikanmax (big blind) folded before Flop
Seat 5: FoodPRO2012 folded on the Flop
Seat 6: Kahmi3105 folded before Flop (didn't bet)
Seat 7: Pachebrash showed [Kh Ks] and won ($50.75) with a pair of Kings
Seat 8: La Ghir folded before Flop (didn't bet)
Seat 9: siskin vrach folded before Flop (didn't bet)



PokerStars Hand #228685477477:  Hold'em No Limit ($0.25/$0.50 USD) - 2021/07/30 14:36:20 ET
Table 'Aitne III' 9-max Seat #3 is the button
Seat 1: whitecillar3 ($50.83 in chips) 
Seat 2: Kaban7502 ($22.25 in chips) 
Seat 3: Lemmi846 ($100 in chips) 
Seat 4: dikanmax ($51 in chips) 
Seat 5: FoodPRO2012 ($40.01 in chips) 
Seat 6: Kahmi3105 ($116.03 in chips) 
Seat 7: Pachebrash ($110.78 in chips) 
Seat 8: La Ghir ($50 in chips) 
Seat 9: siskin vrach ($50 in chips) 
dikanmax: posts small blind $0.25
FoodPRO2012: posts big blind $0.50
*** HOLE CARDS ***
Kahmi3105: folds 
Pachebrash: folds 
La Ghir: folds 
siskin vrach: folds 
whitecillar3: raises $0.75 to $1.25
Kaban7502: folds 
Lemmi846: folds 
dikanmax: folds 
FoodPRO2012: folds 
Uncalled bet ($0.75) returned to whitecillar3
whitecillar3 collected $1.25 from pot
*** SUMMARY ***
Total pot $1.25 | Rake $0 
Seat 1: whitecillar3 collected ($1.25)
Seat 2: Kaban7502 folded before Flop (didn't bet)
Seat 3: Lemmi846 (button) folded before Flop (didn't bet)
Seat 4: dikanmax (small blind) folded before Flop
Seat 5: FoodPRO2012 (big blind) folded before Flop
Seat 6: Kahmi3105 folded before Flop (didn't bet)
Seat 7: Pachebrash folded before Flop (didn't bet)
Seat 8: La Ghir folded before Flop (didn't bet)
Seat 9: siskin vrach folded before Flop (didn't bet)



PokerStars Hand #228685490543:  Hold'em No Limit ($0.25/$0.50 USD) - 2021/07/30 14:36:51 ET
Table 'Aitne III' 9-max Seat #4 is the button
Seat 1: whitecillar3 ($51.58 in chips) 
Seat 2: Kaban7502 ($22.25 in chips) 
Seat 3: Lemmi846 ($100 in chips) 
Seat 4: dikanmax ($50.75 in chips) 
Seat 5: FoodPRO2012 ($39.51 in chips) 
Seat 6: Kahmi3105 ($116.03 in chips) 
Seat 7: Pachebrash ($110.78 in chips) 
Seat 8: La Ghir ($50 in chips) 
Seat 9: siskin vrach ($50 in chips) 
FoodPRO2012: posts small blind $0.25
Kahmi3105: posts big blind $0.50
*** HOLE CARDS ***
Pachebrash: folds 
La Ghir: folds 
siskin vrach: folds 
whitecillar3: folds 
Kaban7502: folds 
Lemmi846: folds 
dikanmax: folds 
FoodPRO2012: folds 
Uncalled bet ($0.25) returned to Kahmi3105
Kahmi3105 collected $0.50 from pot
*** SUMMARY ***
Total pot $0.50 | Rake $0 
Seat 1: whitecillar3 folded before Flop (didn't bet)
Seat 2: Kaban7502 folded before Flop (didn't bet)
Seat 3: Lemmi846 folded before Flop (didn't bet)
Seat 4: dikanmax (button) folded before Flop (didn't bet)
Seat 5: FoodPRO2012 (small blind) folded before Flop
Seat 6: Kahmi3105 (big blind) collected ($0.50)
Seat 7: Pachebrash folded before Flop (didn't bet)
Seat 8: La Ghir folded before Flop (didn't bet)
Seat 9: siskin vrach folded before Flop (didn't bet)



PokerStars Hand #228685497387:  Hold'em No Limit ($0.25/$0.50 USD) - 2021/07/30 14:37:07 ET
Table 'Aitne III' 9-max Seat #5 is the button
Seat 1: whitecillar3 ($51.58 in chips) 
Seat 2: Kaban7502 ($22.25 in chips) 
Seat 3: Lemmi846 ($100 in chips) 
Seat 4: dikanmax ($50.75 in chips) 
Seat 5: FoodPRO2012 ($39.26 in chips) 
Seat 6: Kahmi3105 ($116.28 in chips) 
Seat 7: Pachebrash ($110.78 in chips) 
Seat 8: La Ghir ($50 in chips) 
Seat 9: siskin vrach ($50 in chips) 
Kahmi3105: posts small blind $0.25
Pachebrash: posts big blind $0.50
*** HOLE CARDS ***
La Ghir: folds 
siskin vrach: folds 
whitecillar3: folds 
Kaban7502: folds 
Lemmi846: folds 
dikanmax: raises $1 to $1.50
FoodPRO2012: folds 
Kahmi3105: folds 
Pachebrash: folds 
Uncalled bet ($1) returned to dikanmax
dikanmax collected $1.25 from pot
dikanmax: doesn't show hand 
*** SUMMARY ***
Total pot $1.25 | Rake $0 
Seat 1: whitecillar3 folded before Flop (didn't bet)
Seat 2: Kaban7502 folded before Flop (didn't bet)
Seat 3: Lemmi846 folded before Flop (didn't bet)
Seat 4: dikanmax collected ($1.25)
Seat 5: FoodPRO2012 (button) folded before Flop (didn't bet)
Seat 6: Kahmi3105 (small blind) folded before Flop
Seat 7: Pachebrash (big blind) folded before Flop
Seat 8: La Ghir folded before Flop (didn't bet)
Seat 9: siskin vrach folded before Flop (didn't bet)



PokerStars Hand #228685504720:  Hold'em No Limit ($0.25/$0.50 USD) - 2021/07/30 14:37:25 ET
Table 'Aitne III' 9-max Seat #6 is the button
Seat 1: whitecillar3 ($51.58 in chips) 
Seat 2: Kaban7502 ($22.25 in chips) 
Seat 3: Lemmi846 ($100 in chips) 
Seat 4: dikanmax ($51.50 in chips) 
Seat 5: FoodPRO2012 ($39.26 in chips) 
Seat 6: Kahmi3105 ($116.03 in chips) 
Seat 7: Pachebrash ($110.28 in chips) 
Seat 8: La Ghir ($50 in chips) 
Seat 9: siskin vrach ($50 in chips) 
Pachebrash: posts small blind $0.25
La Ghir: posts big blind $0.50
*** HOLE CARDS ***
siskin vrach: folds 
whitecillar3: folds 
Kaban7502: folds 
Lemmi846: folds 
dikanmax: folds 
FoodPRO2012: folds 
Kahmi3105: raises $1.25 to $1.75
Pachebrash: folds 
La Ghir: folds 
Uncalled bet ($1.25) returned to Kahmi3105
Kahmi3105 collected $1.25 from pot
*** SUMMARY ***
Total pot $1.25 | Rake $0 
Seat 1: whitecillar3 folded before Flop (didn't bet)
Seat 2: Kaban7502 folded before Flop (didn't bet)
Seat 3: Lemmi846 folded before Flop (didn't bet)
Seat 4: dikanmax folded before Flop (didn't bet)
Seat 5: FoodPRO2012 folded before Flop (didn't bet)
Seat 6: Kahmi3105 (button) collected ($1.25)
Seat 7: Pachebrash (small blind) folded before Flop
Seat 8: La Ghir (big blind) folded before Flop
Seat 9: siskin vrach folded before Flop (didn't bet)



PokerStars Hand #228685514742:  Hold'em No Limit ($0.25/$0.50 USD) - 2021/07/30 14:37:48 ET
Table 'Aitne III' 9-max Seat #7 is the button
Seat 1: whitecillar3 ($51.58 in chips) 
Seat 2: Kaban7502 ($22.25 in chips) 
Seat 3: Lemmi846 ($100 in chips) 
Seat 4: dikanmax ($51.50 in chips) 
Seat 5: FoodPRO2012 ($39.26 in chips) 
Seat 6: Kahmi3105 ($116.78 in chips) 
Seat 7: Pachebrash ($110.03 in chips) 
Seat 8: La Ghir ($50 in chips) 
Seat 9: siskin vrach ($50 in chips) 
La Ghir: posts small blind $0.25
siskin vrach: posts big blind $0.50
*** HOLE CARDS ***
whitecillar3: folds 
Kaban7502: calls $0.50
Lemmi846: calls $0.50
dikanmax: folds 
FoodPRO2012: folds 
Kahmi3105: folds 
Pachebrash: folds 
La Ghir: folds 
siskin vrach: checks 
*** FLOP *** [4s 7c 4c]
siskin vrach: checks 
Kaban7502: bets $21.75 and is all-in
Lemmi846: folds 
siskin vrach: calls $21.75
*** TURN *** [4s 7c 4c] [Th]
*** RIVER *** [4s 7c 4c Th] [8d]
*** SHOW DOWN ***
siskin vrach: shows [4h 2c] (three of a kind, Fours)
Kaban7502: shows [Ks Ac] (a pair of Fours)
siskin vrach collected $43.25 from pot
Kaban7502 cashed out the hand for $1.88 | Cash Out Fee $0.02
*** SUMMARY ***
Total pot $45.25 | Rake $2 
Board [4s 7c 4c Th 8d]
Seat 1: whitecillar3 folded before Flop (didn't bet)
Seat 2: Kaban7502 showed [Ks Ac] and lost with a pair of Fours (cashed out).
Seat 3: Lemmi846 folded on the Flop
Seat 4: dikanmax folded before Flop (didn't bet)
Seat 5: FoodPRO2012 folded before Flop (didn't bet)
Seat 6: Kahmi3105 folded before Flop (didn't bet)
Seat 7: Pachebrash (button) folded before Flop (didn't bet)
Seat 8: La Ghir (small blind) folded before Flop
Seat 9: siskin vrach (big blind) showed [4h 2c] and won ($43.25) with three of a kind, Fours



PokerStars Hand #228685532128:  Hold'em No Limit ($0.25/$0.50 USD) - 2021/07/30 14:38:28 ET
Table 'Aitne III' 9-max Seat #8 is the button
Seat 1: whitecillar3 ($51.58 in chips) 
Seat 2: Kaban7502 ($1.88 in chips) 
Seat 3: Lemmi846 ($99.50 in chips) 
Seat 4: dikanmax ($51.50 in chips) 
Seat 5: FoodPRO2012 ($39.26 in chips) 
Seat 6: Kahmi3105 ($116.78 in chips) 
Seat 7: Pachebrash ($110.03 in chips) 
Seat 8: La Ghir ($50 in chips) 
Seat 9: siskin vrach ($71 in chips) 
siskin vrach: posts small blind $0.25
whitecillar3: posts big blind $0.50
*** HOLE CARDS ***
Kaban7502: folds 
Kaban7502 leaves the table
Lemmi846: folds 
dikanmax: folds 
FoodPRO2012: folds 
Kahmi3105: raises $1.25 to $1.75
Pachebrash: folds 
La Ghir: folds 
siskin vrach: calls $1.50
whitecillar3: folds 
*** FLOP *** [Ts 6c 2s]
siskin vrach: checks 
Dragonclawss joins the table at seat #2 
Kahmi3105: bets $2.50
siskin vrach: calls $2.50
*** TURN *** [Ts 6c 2s] [9d]
siskin vrach: checks 
Kahmi3105: bets $5.50
siskin vrach: calls $5.50
*** RIVER *** [Ts 6c 2s 9d] [9s]
siskin vrach: bets $15.96
Kahmi3105: folds 
Uncalled bet ($15.96) returned to siskin vrach
siskin vrach collected $19 from pot
*** SUMMARY ***
Total pot $20 | Rake $1 
Board [Ts 6c 2s 9d 9s]
Seat 1: whitecillar3 (big blind) folded before Flop
Seat 2: Kaban7502 folded before Flop (didn't bet)
Seat 3: Lemmi846 folded before Flop (didn't bet)
Seat 4: dikanmax folded before Flop (didn't bet)
Seat 5: FoodPRO2012 folded before Flop (didn't bet)
Seat 6: Kahmi3105 folded on the River
Seat 7: Pachebrash folded before Flop (didn't bet)
Seat 8: La Ghir (button) folded before Flop (didn't bet)
Seat 9: siskin vrach (small blind) collected ($19)



PokerStars Hand #228685551817:  Hold'em No Limit ($0.25/$0.50 USD) - 2021/07/30 14:39:14 ET
Table 'Aitne III' 9-max Seat #9 is the button
Seat 1: whitecillar3 ($51.08 in chips) 
Seat 2: Dragonclawss ($50.11 in chips) 
Seat 3: Lemmi846 ($99.50 in chips) 
Seat 4: dikanmax ($51.50 in chips) 
Seat 5: FoodPRO2012 ($39.26 in chips) 
Seat 6: Kahmi3105 ($107.03 in chips) 
Seat 7: Pachebrash ($110.03 in chips) 
Seat 8: La Ghir ($50 in chips) 
Seat 9: siskin vrach ($80.25 in chips) 
whitecillar3: posts small blind $0.25
Dragonclawss: posts big blind $0.50
*** HOLE CARDS ***
Lemmi846: folds 
dikanmax: folds 
FoodPRO2012: folds 
Kahmi3105: folds 
Pachebrash: folds 
La Ghir: folds 
siskin vrach: raises $1 to $1.50
whitecillar3: folds 
Dragonclawss: folds 
Uncalled bet ($1) returned to siskin vrach
siskin vrach collected $1.25 from pot
*** SUMMARY ***
Total pot $1.25 | Rake $0 
Seat 1: whitecillar3 (small blind) folded before Flop
Seat 2: Dragonclawss (big blind) folded before Flop
Seat 3: Lemmi846 folded before Flop (didn't bet)
Seat 4: dikanmax folded before Flop (didn't bet)
Seat 5: FoodPRO2012 folded before Flop (didn't bet)
Seat 6: Kahmi3105 folded before Flop (didn't bet)
Seat 7: Pachebrash folded before Flop (didn't bet)
Seat 8: La Ghir folded before Flop (didn't bet)
Seat 9: siskin vrach (button) collected ($1.25)



PokerStars Hand #228685558534:  Hold'em No Limit ($0.25/$0.50 USD) - 2021/07/30 14:39:30 ET
Table 'Aitne III' 9-max Seat #1 is the button
Seat 1: whitecillar3 ($50.83 in chips) 
Seat 2: Dragonclawss ($50 in chips) 
Seat 3: Lemmi846 ($99.50 in chips) 
Seat 4: dikanmax ($51.50 in chips) 
Seat 5: FoodPRO2012 ($39.26 in chips) 
Seat 6: Kahmi3105 ($107.03 in chips) 
Seat 7: Pachebrash ($110.03 in chips) 
Seat 8: La Ghir ($50 in chips) 
Seat 9: siskin vrach ($81 in chips) 
Dragonclawss: posts small blind $0.25
Lemmi846: posts big blind $0.50
*** HOLE CARDS ***
dikanmax: folds 
FoodPRO2012: folds 
Kahmi3105: calls $0.50
Pachebrash: folds 
La Ghir: folds 
siskin vrach: folds 
whitecillar3: folds 
Dragonclawss: folds 
Lemmi846: checks 
*** FLOP *** [Qd 4s Ah]
Lemmi846: checks 
Kahmi3105: bets $1.50
Lemmi846: folds 
Uncalled bet ($1.50) returned to Kahmi3105
Kahmi3105 collected $1.17 from pot
*** SUMMARY ***
Total pot $1.25 | Rake $0.08 
Board [Qd 4s Ah]
Seat 1: whitecillar3 (button) folded before Flop (didn't bet)
Seat 2: Dragonclawss (small blind) folded before Flop
Seat 3: Lemmi846 (big blind) folded on the Flop
Seat 4: dikanmax folded before Flop (didn't bet)
Seat 5: FoodPRO2012 folded before Flop (didn't bet)
Seat 6: Kahmi3105 collected ($1.17)
Seat 7: Pachebrash folded before Flop (didn't bet)
Seat 8: La Ghir folded before Flop (didn't bet)
Seat 9: siskin vrach folded before Flop (didn't bet)



PokerStars Hand #228685572076:  Hold'em No Limit ($0.25/$0.50 USD) - 2021/07/30 14:40:01 ET
Table 'Aitne III' 9-max Seat #2 is the button
Seat 1: whitecillar3 ($50.83 in chips) 
Seat 2: Dragonclawss ($50 in chips) 
Seat 3: Lemmi846 ($99 in chips) 
Seat 5: FoodPRO2012 ($39.26 in chips) 
Seat 6: Kahmi3105 ($107.70 in chips) 
Seat 7: Pachebrash ($110.03 in chips) 
Seat 8: La Ghir ($50 in chips) 
Seat 9: siskin vrach ($81 in chips) 
Lemmi846: posts small blind $0.25
dikanmax: is sitting out 
FoodPRO2012: posts big blind $0.50
*** HOLE CARDS ***
Kahmi3105: calls $0.50
Pachebrash: folds 
La Ghir: folds 
siskin vrach: folds 
whitecillar3: folds 
Dragonclawss: folds 
Lemmi846: calls $0.25
FoodPRO2012: checks 
*** FLOP *** [4h 4c Qh]
Lemmi846: checks 
FoodPRO2012: bets $0.50
Kahmi3105: folds 
Lemmi846: calls $0.50
*** TURN *** [4h 4c Qh] [3h]
Lemmi846: checks 
FoodPRO2012: bets $0.50
Lemmi846: raises $1 to $1.50
FoodPRO2012: calls $1
*** RIVER *** [4h 4c Qh 3h] [6h]
Lemmi846: checks 
FoodPRO2012: checks 
*** SHOW DOWN ***
Lemmi846: shows [Jh 2h] (a flush, Queen high)
FoodPRO2012: mucks hand 
Lemmi846 collected $5.15 from pot
*** SUMMARY ***
Total pot $5.50 | Rake $0.35 
Board [4h 4c Qh 3h 6h]
Seat 1: whitecillar3 folded before Flop (didn't bet)
Seat 2: Dragonclawss (button) folded before Flop (didn't bet)
Seat 3: Lemmi846 (small blind) showed [Jh 2h] and won ($5.15) with a flush, Queen high
Seat 5: FoodPRO2012 (big blind) mucked
Seat 6: Kahmi3105 folded on the Flop
Seat 7: Pachebrash folded before Flop (didn't bet)
Seat 8: La Ghir folded before Flop (didn't bet)
Seat 9: siskin vrach folded before Flop (didn't bet)



PokerStars Hand #228685596344:  Hold'em No Limit ($0.25/$0.50 USD) - 2021/07/30 14:40:58 ET
Table 'Aitne III' 9-max Seat #3 is the button
Seat 1: whitecillar3 ($50.83 in chips) 
Seat 2: Dragonclawss ($50 in chips) 
Seat 3: Lemmi846 ($101.65 in chips) 
Seat 5: FoodPRO2012 ($36.76 in chips) 
Seat 6: Kahmi3105 ($107.20 in chips) 
Seat 7: Pachebrash ($110.03 in chips) 
Seat 8: La Ghir ($50 in chips) 
Seat 9: siskin vrach ($81 in chips) 
FoodPRO2012: posts small blind $0.25
Kahmi3105: posts big blind $0.50
*** HOLE CARDS ***
Pachebrash: folds 
La Ghir: folds 
siskin vrach: raises $1 to $1.50
whitecillar3: folds 
Dragonclawss: folds 
Lemmi846: folds 
FoodPRO2012: folds 
Kahmi3105: calls $1
*** FLOP *** [7s 2h 3h]
Kahmi3105: checks 
siskin vrach: bets $1.55
Kahmi3105: raises $1.55 to $3.10
siskin vrach: calls $1.55
*** TURN *** [7s 2h 3h] [Qd]
Kahmi3105: bets $5
siskin vrach: calls $5
*** RIVER *** [7s 2h 3h Qd] [Jc]
dikanmax leaves the table
Kahmi3105: bets $11.50
siskin vrach: calls $11.50
*** SHOW DOWN ***
Kahmi3105: shows [Td Th] (a pair of Tens)
siskin vrach: mucks hand 
Kahmi3105 collected $39.95 from pot
*** SUMMARY ***
Total pot $42.45 | Rake $2.50 
Board [7s 2h 3h Qd Jc]
Seat 1: whitecillar3 folded before Flop (didn't bet)
Seat 2: Dragonclawss folded before Flop (didn't bet)
Seat 3: Lemmi846 (button) folded before Flop (didn't bet)
Seat 5: FoodPRO2012 (small blind) folded before Flop
Seat 6: Kahmi3105 (big blind) showed [Td Th] and won ($39.95) with a pair of Tens
Seat 7: Pachebrash folded before Flop (didn't bet)
Seat 8: La Ghir folded before Flop (didn't bet)
Seat 9: siskin vrach mucked



PokerStars Hand #228685617928:  Hold'em No Limit ($0.25/$0.50 USD) - 2021/07/30 14:41:49 ET
Table 'Aitne III' 9-max Seat #5 is the button
Seat 1: whitecillar3 ($50.83 in chips) 
Seat 2: Dragonclawss ($50 in chips) 
Seat 3: Lemmi846 ($101.65 in chips) 
Seat 5: FoodPRO2012 ($36.51 in chips) 
Seat 6: Kahmi3105 ($126.05 in chips) 
Seat 7: Pachebrash ($110.03 in chips) 
Seat 8: La Ghir ($50 in chips) 
Seat 9: siskin vrach ($59.90 in chips) 
Kahmi3105: posts small blind $0.25
Pachebrash: posts big blind $0.50
*** HOLE CARDS ***
La Ghir: folds 
siskin vrach: folds 
whitecillar3: folds 
Dragonclawss: folds 
Lemmi846: raises $0.50 to $1
FoodPRO2012: calls $1
Kahmi3105: folds 
Pachebrash: calls $0.50
*** FLOP *** [Qs 2d 9d]
Pachebrash: checks 
J0hnDee joins the table at seat #4 
Lemmi846: checks 
FoodPRO2012: bets $1
Pachebrash: folds 
Lemmi846: folds 
Uncalled bet ($1) returned to FoodPRO2012
FoodPRO2012 collected $3.09 from pot
FoodPRO2012: doesn't show hand 
*** SUMMARY ***
Total pot $3.25 | Rake $0.16 
Board [Qs 2d 9d]
Seat 1: whitecillar3 folded before Flop (didn't bet)
Seat 2: Dragonclawss folded before Flop (didn't bet)
Seat 3: Lemmi846 folded on the Flop
Seat 5: FoodPRO2012 (button) collected ($3.09)
Seat 6: Kahmi3105 (small blind) folded before Flop
Seat 7: Pachebrash (big blind) folded on the Flop
Seat 8: La Ghir folded before Flop (didn't bet)
Seat 9: siskin vrach folded before Flop (didn't bet)



PokerStars Hand #228685633983:  Hold'em No Limit ($0.25/$0.50 USD) - 2021/07/30 14:42:26 ET
Table 'Aitne III' 9-max Seat #6 is the button
Seat 1: whitecillar3 ($50.83 in chips) 
Seat 2: Dragonclawss ($50 in chips) 
Seat 3: Lemmi846 ($100.65 in chips) 
Seat 4: J0hnDee ($50 in chips) 
Seat 5: FoodPRO2012 ($38.60 in chips) 
Seat 6: Kahmi3105 ($125.80 in chips) 
Seat 7: Pachebrash ($109.03 in chips) 
Seat 8: La Ghir ($50 in chips) 
Seat 9: siskin vrach ($59.90 in chips) 
Pachebrash: posts small blind $0.25
La Ghir: posts big blind $0.50
J0hnDee: posts big blind $0.50
*** HOLE CARDS ***
siskin vrach: folds 
whitecillar3: folds 
Dragonclawss: folds 
Lemmi846: folds 
J0hnDee: checks 
FoodPRO2012: folds 
Kahmi3105: calls $0.50
Pachebrash: folds 
La Ghir: checks 
*** FLOP *** [5d 4c Jh]
La Ghir: checks 
J0hnDee: checks 
Kahmi3105: bets $2
La Ghir: folds 
J0hnDee: folds 
Uncalled bet ($2) returned to Kahmi3105
Kahmi3105 collected $1.64 from pot
*** SUMMARY ***
Total pot $1.75 | Rake $0.11 
Board [5d 4c Jh]
Seat 1: whitecillar3 folded before Flop (didn't bet)
Seat 2: Dragonclawss folded before Flop (didn't bet)
Seat 3: Lemmi846 folded before Flop (didn't bet)
Seat 4: J0hnDee folded on the Flop (didn't bet)
Seat 5: FoodPRO2012 folded before Flop (didn't bet)
Seat 6: Kahmi3105 (button) collected ($1.64)
Seat 7: Pachebrash (small blind) folded before Flop
Seat 8: La Ghir (big blind) folded on the Flop
Seat 9: siskin vrach folded before Flop (didn't bet)



PokerStars Hand #228685645742:  Hold'em No Limit ($0.25/$0.50 USD) - 2021/07/30 14:42:54 ET
Table 'Aitne III' 9-max Seat #7 is the button
Seat 1: whitecillar3 ($50.83 in chips) 
Seat 2: Dragonclawss ($50 in chips) 
Seat 3: Lemmi846 ($100.65 in chips) 
Seat 4: J0hnDee ($49.50 in chips) 
Seat 5: FoodPRO2012 ($38.60 in chips) 
Seat 6: Kahmi3105 ($126.94 in chips) 
Seat 7: Pachebrash ($108.78 in chips) 
Seat 8: La Ghir ($50 in chips) 
Seat 9: siskin vrach ($59.90 in chips) 
La Ghir: posts small blind $0.25
siskin vrach: posts big blind $0.50
*** HOLE CARDS ***
whitecillar3: folds 
Dragonclawss: folds 
Lemmi846: folds 
J0hnDee: raises $0.75 to $1.25
FoodPRO2012: folds 
Kahmi3105: folds 
Pachebrash: folds 
La Ghir: raises $4.25 to $5.50
siskin vrach: raises $7.50 to $13
J0hnDee: raises $36.50 to $49.50 and is all-in
La Ghir: folds 
siskin vrach: calls $36.50
*** FLOP *** [Qs 4d 2h]
*** TURN *** [Qs 4d 2h] [8s]
*** RIVER *** [Qs 4d 2h 8s] [8c]
*** SHOW DOWN ***
siskin vrach: shows [Kc Ah] (a pair of Eights)
J0hnDee: shows [Qc Qh] (a full house, Queens full of Eights)
J0hnDee collected $102.50 from pot
*** SUMMARY ***
Total pot $104.50 | Rake $2 
Board [Qs 4d 2h 8s 8c]
Seat 1: whitecillar3 folded before Flop (didn't bet)
Seat 2: Dragonclawss folded before Flop (didn't bet)
Seat 3: Lemmi846 folded before Flop (didn't bet)
Seat 4: J0hnDee showed [Qc Qh] and won ($102.50) with a full house, Queens full of Eights
Seat 5: FoodPRO2012 folded before Flop (didn't bet)
Seat 6: Kahmi3105 folded before Flop (didn't bet)
Seat 7: Pachebrash (button) folded before Flop (didn't bet)
Seat 8: La Ghir (small blind) folded before Flop
Seat 9: siskin vrach (big blind) showed [Kc Ah] and lost with a pair of Eights



PokerStars Hand #228685670267:  Hold'em No Limit ($0.25/$0.50 USD) - 2021/07/30 14:43:50 ET
Table 'Aitne III' 9-max Seat #8 is the button
Seat 1: whitecillar3 ($50.83 in chips) 
Seat 2: Dragonclawss ($50 in chips) 
Seat 3: Lemmi846 ($100.65 in chips) 
Seat 4: J0hnDee ($102.50 in chips) 
Seat 5: FoodPRO2012 ($38.60 in chips) 
Seat 6: Kahmi3105 ($126.94 in chips) 
Seat 7: Pachebrash ($108.78 in chips) 
Seat 8: La Ghir ($50 in chips) 
Seat 9: siskin vrach ($50 in chips) 
siskin vrach: posts small blind $0.25
whitecillar3: posts big blind $0.50
*** HOLE CARDS ***
Dragonclawss: folds 
Lemmi846: folds 
J0hnDee: folds 
FoodPRO2012: folds 
Kahmi3105: calls $0.50
Pachebrash: raises $1.50 to $2
La Ghir: calls $2
siskin vrach: calls $1.75
whitecillar3: folds 
Kahmi3105: calls $1.50
*** FLOP *** [As Kd 2s]
siskin vrach: checks 
Kahmi3105: checks 
Pachebrash: checks 
La Ghir: checks 
*** TURN *** [As Kd 2s] [6c]
siskin vrach: checks 
Kahmi3105: checks 
Pachebrash: checks 
La Ghir: checks 
*** RIVER *** [As Kd 2s 6c] [4s]
siskin vrach: checks 
Kahmi3105: bets $4.04
Pachebrash: folds 
La Ghir: folds 
siskin vrach: folds 
Uncalled bet ($4.04) returned to Kahmi3105
Kahmi3105 collected $7.98 from pot
*** SUMMARY ***
Total pot $8.50 | Rake $0.52 
Board [As Kd 2s 6c 4s]
Seat 1: whitecillar3 (big blind) folded before Flop
Seat 2: Dragonclawss folded before Flop (didn't bet)
Seat 3: Lemmi846 folded before Flop (didn't bet)
Seat 4: J0hnDee folded before Flop (didn't bet)
Seat 5: FoodPRO2012 folded before Flop (didn't bet)
Seat 6: Kahmi3105 collected ($7.98)
Seat 7: Pachebrash folded on the River
Seat 8: La Ghir (button) folded on the River
Seat 9: siskin vrach (small blind) folded on the River



PokerStars Hand #228685693945:  Hold'em No Limit ($0.25/$0.50 USD) - 2021/07/30 14:44:45 ET
Table 'Aitne III' 9-max Seat #9 is the button
Seat 1: whitecillar3 ($50.33 in chips) 
Seat 2: Dragonclawss ($50 in chips) 
Seat 3: Lemmi846 ($100.65 in chips) 
Seat 4: J0hnDee ($102.50 in chips) 
Seat 5: FoodPRO2012 ($38.60 in chips) 
Seat 6: Kahmi3105 ($132.92 in chips) 
Seat 7: Pachebrash ($106.78 in chips) 
Seat 8: La Ghir ($50 in chips) 
Seat 9: siskin vrach ($50 in chips) 
whitecillar3: posts small blind $0.25
Dragonclawss: posts big blind $0.50
*** HOLE CARDS ***
Lemmi846: folds 
J0hnDee: folds 
FoodPRO2012: folds 
Lemmi846 leaves the table
Kahmi3105: raises $1.25 to $1.75
Pachebrash: folds 
La Ghir: folds 
siskin vrach: folds 
whitecillar3: folds 
Dragonclawss: folds 
Uncalled bet ($1.25) returned to Kahmi3105
Kahmi3105 collected $1.25 from pot
*** SUMMARY ***
Total pot $1.25 | Rake $0 
Seat 1: whitecillar3 (small blind) folded before Flop
Seat 2: Dragonclawss (big blind) folded before Flop
Seat 3: Lemmi846 folded before Flop (didn't bet)
Seat 4: J0hnDee folded before Flop (didn't bet)
Seat 5: FoodPRO2012 folded before Flop (didn't bet)
Seat 6: Kahmi3105 collected ($1.25)
Seat 7: Pachebrash folded before Flop (didn't bet)
Seat 8: La Ghir folded before Flop (didn't bet)
Seat 9: siskin vrach (button) folded before Flop (didn't bet)



PokerStars Hand #228685701831:  Hold'em No Limit ($0.25/$0.50 USD) - 2021/07/30 14:45:03 ET
Table 'Aitne III' 9-max Seat #1 is the button
Seat 1: whitecillar3 ($50.08 in chips) 
Seat 2: Dragonclawss ($50 in chips) 
Seat 4: J0hnDee ($102.50 in chips) 
Seat 5: FoodPRO2012 ($38.60 in chips) 
Seat 6: Kahmi3105 ($133.67 in chips) 
Seat 7: Pachebrash ($106.78 in chips) 
Seat 8: La Ghir ($50 in chips) 
Seat 9: siskin vrach ($50 in chips) 
Dragonclawss: posts small blind $0.25
J0hnDee: posts big blind $0.50
*** HOLE CARDS ***
FoodPRO2012: calls $0.50
Kahmi3105: folds 
Pachebrash: folds 
La Ghir: folds 
siskin vrach: folds 
whitecillar3: folds 
Dragonclawss: calls $0.25
J0hnDee: raises $2 to $2.50
FoodPRO2012: calls $2
Dragonclawss: calls $2
*** FLOP *** [Kc 8h 5d]
Dragonclawss: checks 
J0hnDee: bets $3
FoodPRO2012: folds 
Dragonclawss: raises $7.50 to $10.50
J0hnDee: calls $7.50
*** TURN *** [Kc 8h 5d] [Qc]
Dragonclawss: bets $37 and is all-in
J0hnDee: calls $37
*** RIVER *** [Kc 8h 5d Qc] [7s]
*** SHOW DOWN ***
Dragonclawss: shows [8c 8d] (three of a kind, Eights)
J0hnDee: shows [Ah As] (a pair of Aces)
Dragonclawss cashed out the hand for $94.98 | Cash Out Fee $0.96
*** SUMMARY ***
Total pot $102.50 | Rake $2 
Board [Kc 8h 5d Qc 7s]
Seat 1: whitecillar3 (button) folded before Flop (didn't bet)
Seat 2: Dragonclawss (small blind) showed [8c 8d] and won ($100.50) with three of a kind, Eights (pot not awarded as player cashed out)
Seat 4: J0hnDee (big blind) showed [Ah As] and lost with a pair of Aces
Seat 5: FoodPRO2012 folded on the Flop
Seat 6: Kahmi3105 folded before Flop (didn't bet)
Seat 7: Pachebrash folded before Flop (didn't bet)
Seat 8: La Ghir folded before Flop (didn't bet)
Seat 9: siskin vrach folded before Flop (didn't bet)



PokerStars Hand #228685735412:  Hold'em No Limit ($0.25/$0.50 USD) - 2021/07/30 14:46:06 ET
Table 'Aitne III' 9-max Seat #2 is the button
Seat 1: whitecillar3 ($50.08 in chips) 
Seat 2: Dragonclawss ($94.98 in chips) 
Seat 4: J0hnDee ($52.50 in chips) 
Seat 5: FoodPRO2012 ($36.10 in chips) 
Seat 6: Kahmi3105 ($133.67 in chips) 
Seat 7: Pachebrash ($106.78 in chips) 
Seat 8: La Ghir ($50 in chips) 
Seat 9: siskin vrach ($50 in chips) 
J0hnDee: posts small blind $0.25
FoodPRO2012: posts big blind $0.50
*** HOLE CARDS ***
Kahmi3105: folds 
Pachebrash: folds 
La Ghir: folds 
siskin vrach: raises $1 to $1.50
whitecillar3: folds 
Dragonclawss: folds 
J0hnDee: calls $1.25
FoodPRO2012: folds 
*** FLOP *** [6s 9s 3d]
J0hnDee: checks 
siskin vrach: checks 
*** TURN *** [6s 9s 3d] [6d]
LeXuSSS201 joins the table at seat #3 
J0hnDee: bets $1.66
siskin vrach: folds 
Uncalled bet ($1.66) returned to J0hnDee
J0hnDee collected $3.32 from pot
*** SUMMARY ***
Total pot $3.50 | Rake $0.18 
Board [6s 9s 3d 6d]
Seat 1: whitecillar3 folded before Flop (didn't bet)
Seat 2: Dragonclawss (button) folded before Flop (didn't bet)
Seat 4: J0hnDee (small blind) collected ($3.32)
Seat 5: FoodPRO2012 (big blind) folded before Flop
Seat 6: Kahmi3105 folded before Flop (didn't bet)
Seat 7: Pachebrash folded before Flop (didn't bet)
Seat 8: La Ghir folded before Flop (didn't bet)
Seat 9: siskin vrach folded on the Turn



PokerStars Hand #228685747693:  Hold'em No Limit ($0.25/$0.50 USD) - 2021/07/30 14:46:35 ET
Table 'Aitne III' 9-max Seat #4 is the button
Seat 1: whitecillar3 ($50.08 in chips) 
Seat 2: Dragonclawss ($94.98 in chips) 
Seat 4: J0hnDee ($54.32 in chips) 
Seat 5: FoodPRO2012 ($35.60 in chips) 
Seat 6: Kahmi3105 ($133.67 in chips) 
Seat 7: Pachebrash ($106.78 in chips) 
Seat 8: La Ghir ($50 in chips) 
Seat 9: siskin vrach ($50 in chips) 
FoodPRO2012: posts small blind $0.25
Kahmi3105: posts big blind $0.50
LeXuSSS201: sits out 
*** HOLE CARDS ***
Pachebrash: folds 
La Ghir: folds 
siskin vrach: folds 
whitecillar3: folds 
Dragonclawss: folds 
J0hnDee: folds 
FoodPRO2012: calls $0.25
Kahmi3105: checks 
*** FLOP *** [4h Kc Ad]
FoodPRO2012: bets $0.50
Kahmi3105: folds 
Uncalled bet ($0.50) returned to FoodPRO2012
FoodPRO2012 collected $0.95 from pot
FoodPRO2012: doesn't show hand 
*** SUMMARY ***
Total pot $1 | Rake $0.05 
Board [4h Kc Ad]
Seat 1: whitecillar3 folded before Flop (didn't bet)
Seat 2: Dragonclawss folded before Flop (didn't bet)
Seat 4: J0hnDee (button) folded before Flop (didn't bet)
Seat 5: FoodPRO2012 (small blind) collected ($0.95)
Seat 6: Kahmi3105 (big blind) folded on the Flop
Seat 7: Pachebrash folded before Flop (didn't bet)
Seat 8: La Ghir folded before Flop (didn't bet)
Seat 9: siskin vrach folded before Flop (didn't bet)



PokerStars Hand #228685754240:  Hold'em No Limit ($0.25/$0.50 USD) - 2021/07/30 14:46:50 ET
Table 'Aitne III' 9-max Seat #5 is the button
Seat 1: whitecillar3 ($50.08 in chips) 
Seat 2: Dragonclawss ($94.98 in chips) 
Seat 4: J0hnDee ($54.32 in chips) 
Seat 5: FoodPRO2012 ($36.05 in chips) 
Seat 6: Kahmi3105 ($133.17 in chips) 
Seat 7: Pachebrash ($106.78 in chips) 
Seat 8: La Ghir ($50 in chips) 
Seat 9: siskin vrach ($50 in chips) 
Kahmi3105: posts small blind $0.25
Pachebrash: posts big blind $0.50
LeXuSSS201: sits out 
*** HOLE CARDS ***
La Ghir: raises $1 to $1.50
siskin vrach: calls $1.50
whitecillar3: folds 
Dragonclawss: folds 
J0hnDee: folds 
FoodPRO2012: folds 
Kahmi3105: folds 
Pachebrash: calls $1
*** FLOP *** [As 2c Tc]
Pachebrash: checks 
La Ghir: checks 
siskin vrach: bets $1.31
Pachebrash: folds 
La Ghir: folds 
Uncalled bet ($1.31) returned to siskin vrach
siskin vrach collected $4.51 from pot
*** SUMMARY ***
Total pot $4.75 | Rake $0.24 
Board [As 2c Tc]
Seat 1: whitecillar3 folded before Flop (didn't bet)
Seat 2: Dragonclawss folded before Flop (didn't bet)
Seat 4: J0hnDee folded before Flop (didn't bet)
Seat 5: FoodPRO2012 (button) folded before Flop (didn't bet)
Seat 6: Kahmi3105 (small blind) folded before Flop
Seat 7: Pachebrash (big blind) folded on the Flop
Seat 8: La Ghir folded on the Flop
Seat 9: siskin vrach collected ($4.51)



PokerStars Hand #228685769208:  Hold'em No Limit ($0.25/$0.50 USD) - 2021/07/30 14:47:24 ET
Table 'Aitne III' 9-max Seat #6 is the button
Seat 1: whitecillar3 ($50.08 in chips) 
Seat 2: Dragonclawss ($94.98 in chips) 
Seat 4: J0hnDee ($54.32 in chips) 
Seat 5: FoodPRO2012 ($36.05 in chips) 
Seat 6: Kahmi3105 ($132.92 in chips) 
Seat 7: Pachebrash ($105.28 in chips) 
Seat 8: La Ghir ($50 in chips) 
Seat 9: siskin vrach ($53.01 in chips) 
Pachebrash: posts small blind $0.25
La Ghir: posts big blind $0.50
LeXuSSS201: sits out 
*** HOLE CARDS ***
siskin vrach: folds 
whitecillar3: folds 
Dragonclawss: folds 
J0hnDee: folds 
FoodPRO2012: calls $0.50
Kahmi3105: folds 
Pachebrash: calls $0.25
La Ghir: checks 
*** FLOP *** [2c 3c Qh]
Pachebrash: checks 
La Ghir: checks 
FoodPRO2012: bets $0.50
Pachebrash: folds 
La Ghir: folds 
Uncalled bet ($0.50) returned to FoodPRO2012
FoodPRO2012 collected $1.42 from pot
FoodPRO2012: doesn't show hand 
*** SUMMARY ***
Total pot $1.50 | Rake $0.08 
Board [2c 3c Qh]
Seat 1: whitecillar3 folded before Flop (didn't bet)
Seat 2: Dragonclawss folded before Flop (didn't bet)
Seat 4: J0hnDee folded before Flop (didn't bet)
Seat 5: FoodPRO2012 collected ($1.42)
Seat 6: Kahmi3105 (button) folded before Flop (didn't bet)
Seat 7: Pachebrash (small blind) folded on the Flop
Seat 8: La Ghir (big blind) folded on the Flop
Seat 9: siskin vrach folded before Flop (didn't bet)



PokerStars Hand #228685785484:  Hold'em No Limit ($0.25/$0.50 USD) - 2021/07/30 14:48:02 ET
Table 'Aitne III' 9-max Seat #7 is the button
Seat 1: whitecillar3 ($50.08 in chips) 
Seat 2: Dragonclawss ($94.98 in chips) 
Seat 4: J0hnDee ($54.32 in chips) 
Seat 5: FoodPRO2012 ($36.97 in chips) 
Seat 6: Kahmi3105 ($132.92 in chips) 
Seat 7: Pachebrash ($104.78 in chips) 
Seat 8: La Ghir ($50 in chips) 
Seat 9: siskin vrach ($53.01 in chips) 
La Ghir: posts small blind $0.25
siskin vrach: posts big blind $0.50
LeXuSSS201: sits out 
*** HOLE CARDS ***
whitecillar3: folds 
Dragonclawss: folds 
J0hnDee: folds 
FoodPRO2012: folds 
Kahmi3105: folds 
Pachebrash: raises $0.70 to $1.20
La Ghir: folds 
siskin vrach: folds 
Uncalled bet ($0.70) returned to Pachebrash
Pachebrash collected $1.25 from pot
Pachebrash: doesn't show hand 
*** SUMMARY ***
Total pot $1.25 | Rake $0 
Seat 1: whitecillar3 folded before Flop (didn't bet)
Seat 2: Dragonclawss folded before Flop (didn't bet)
Seat 4: J0hnDee folded before Flop (didn't bet)
Seat 5: FoodPRO2012 folded before Flop (didn't bet)
Seat 6: Kahmi3105 folded before Flop (didn't bet)
Seat 7: Pachebrash (button) collected ($1.25)
Seat 8: La Ghir (small blind) folded before Flop
Seat 9: siskin vrach (big blind) folded before Flop



PokerStars Hand #228685790047:  Hold'em No Limit ($0.25/$0.50 USD) - 2021/07/30 14:48:12 ET
Table 'Aitne III' 9-max Seat #8 is the button
Seat 1: whitecillar3 ($50.08 in chips) 
Seat 2: Dragonclawss ($94.98 in chips) 
Seat 4: J0hnDee ($54.32 in chips) 
Seat 5: FoodPRO2012 ($36.97 in chips) 
Seat 6: Kahmi3105 ($132.92 in chips) 
Seat 7: Pachebrash ($105.53 in chips) 
Seat 8: La Ghir ($50 in chips) 
Seat 9: siskin vrach ($52.51 in chips) 
siskin vrach: posts small blind $0.25
whitecillar3: posts big blind $0.50
LeXuSSS201: sits out 
*** HOLE CARDS ***
Dragonclawss: folds 
J0hnDee: raises $0.75 to $1.25
FoodPRO2012: folds 
Kahmi3105: folds 
Pachebrash: folds 
La Ghir: folds 
siskin vrach: folds 
whitecillar3: calls $0.75
*** FLOP *** [Jd 3c 5c]
whitecillar3: checks 
J0hnDee: bets $1.75
whitecillar3: calls $1.75
*** TURN *** [Jd 3c 5c] [9s]
whitecillar3: checks 
J0hnDee: bets $5.94
LeXuSSS201 is disconnected 
whitecillar3: calls $5.94
*** RIVER *** [Jd 3c 5c 9s] [Qs]
whitecillar3: checks 
J0hnDee: bets $10
whitecillar3: calls $10
*** SHOW DOWN ***
J0hnDee: shows [Qc 8c] (a pair of Queens)
whitecillar3: mucks hand 
J0hnDee collected $36.22 from pot
*** SUMMARY ***
Total pot $38.13 | Rake $1.91 
Board [Jd 3c 5c 9s Qs]
Seat 1: whitecillar3 (big blind) mucked
Seat 2: Dragonclawss folded before Flop (didn't bet)
Seat 4: J0hnDee showed [Qc 8c] and won ($36.22) with a pair of Queens
Seat 5: FoodPRO2012 folded before Flop (didn't bet)
Seat 6: Kahmi3105 folded before Flop (didn't bet)
Seat 7: Pachebrash folded before Flop (didn't bet)
Seat 8: La Ghir (button) folded before Flop (didn't bet)
Seat 9: siskin vrach (small blind) folded before Flop



PokerStars Hand #228685828899:  Hold'em No Limit ($0.25/$0.50 USD) - 2021/07/30 14:49:42 ET
Table 'Aitne III' 9-max Seat #9 is the button
Seat 1: whitecillar3 ($31.14 in chips) 
Seat 3: LeXuSSS201 ($50 in chips) 
Seat 4: J0hnDee ($71.60 in chips) 
Seat 5: FoodPRO2012 ($36.97 in chips) 
Seat 6: Kahmi3105 ($132.92 in chips) 
Seat 7: Pachebrash ($105.53 in chips) 
Seat 8: La Ghir ($50 in chips) 
Seat 9: siskin vrach ($52.26 in chips) 
whitecillar3: posts small blind $0.25
Dragonclawss: is sitting out 
Dragonclawss leaves the table
LeXuSSS201: posts big blind $0.50
*** HOLE CARDS ***
J0hnDee: folds 
FoodPRO2012: folds 
Kahmi3105: folds 
Pachebrash: folds 
La Ghir: raises $1 to $1.50
siskin vrach: folds 
whitecillar3: folds 
artemxxl joins the table at seat #2 
LeXuSSS201: folds 
Uncalled bet ($1) returned to La Ghir
La Ghir collected $1.25 from pot
La Ghir: doesn't show hand 
*** SUMMARY ***
Total pot $1.25 | Rake $0 
Seat 1: whitecillar3 (small blind) folded before Flop
Seat 3: LeXuSSS201 (big blind) folded before Flop
Seat 4: J0hnDee folded before Flop (didn't bet)
Seat 5: FoodPRO2012 folded before Flop (didn't bet)
Seat 6: Kahmi3105 folded before Flop (didn't bet)
Seat 7: Pachebrash folded before Flop (didn't bet)
Seat 8: La Ghir collected ($1.25)
Seat 9: siskin vrach (button) folded before Flop (didn't bet)



PokerStars Hand #228685838931:  Hold'em No Limit ($0.25/$0.50 USD) - 2021/07/30 14:50:06 ET
Table 'Aitne III' 9-max Seat #1 is the button
Seat 1: whitecillar3 ($50 in chips) 
Seat 3: LeXuSSS201 ($50 in chips) 
Seat 4: J0hnDee ($71.60 in chips) 
Seat 5: FoodPRO2012 ($36.97 in chips) 
Seat 6: Kahmi3105 ($132.92 in chips) 
Seat 7: Pachebrash ($105.53 in chips) 
Seat 8: La Ghir ($50.75 in chips) 
Seat 9: siskin vrach ($52.26 in chips) 
LeXuSSS201: posts small blind $0.25
J0hnDee: posts big blind $0.50
*** HOLE CARDS ***
FoodPRO2012: calls $0.50
Kahmi3105: raises $2 to $2.50
Pachebrash: folds 
La Ghir: folds 
siskin vrach: folds 
whitecillar3: folds 
LeXuSSS201: folds 
J0hnDee: folds 
FoodPRO2012: calls $2
*** FLOP *** [Kc Jd 3c]
FoodPRO2012: checks 
Kahmi3105: bets $4
FoodPRO2012: folds 
Uncalled bet ($4) returned to Kahmi3105
Kahmi3105 collected $5.39 from pot
*** SUMMARY ***
Total pot $5.75 | Rake $0.36 
Board [Kc Jd 3c]
Seat 1: whitecillar3 (button) folded before Flop (didn't bet)
Seat 3: LeXuSSS201 (small blind) folded before Flop
Seat 4: J0hnDee (big blind) folded before Flop
Seat 5: FoodPRO2012 folded on the Flop
Seat 6: Kahmi3105 collected ($5.39)
Seat 7: Pachebrash folded before Flop (didn't bet)
Seat 8: La Ghir folded before Flop (didn't bet)
Seat 9: siskin vrach folded before Flop (didn't bet)



PokerStars Hand #228685853149:  Hold'em No Limit ($0.25/$0.50 USD) - 2021/07/30 14:50:39 ET
Table 'Aitne III' 9-max Seat #3 is the button
Seat 1: whitecillar3 ($50 in chips) 
Seat 3: LeXuSSS201 ($50 in chips) 
Seat 4: J0hnDee ($71.10 in chips) 
Seat 5: FoodPRO2012 ($34.47 in chips) 
Seat 6: Kahmi3105 ($135.81 in chips) 
Seat 7: Pachebrash ($105.53 in chips) 
Seat 8: La Ghir ($50.75 in chips) 
Seat 9: siskin vrach ($52.26 in chips) 
J0hnDee: posts small blind $0.25
FoodPRO2012: posts big blind $0.50
artemxxl: sits out 
*** HOLE CARDS ***
Kahmi3105: folds 
Pachebrash: folds 
La Ghir: folds 
siskin vrach: folds 
whitecillar3: folds 
LeXuSSS201: folds 
J0hnDee: raises $1 to $1.50
FoodPRO2012: calls $1
*** FLOP *** [2d Td 9h]
J0hnDee: bets $1.75
FoodPRO2012: calls $1.75
*** TURN *** [2d Td 9h] [6s]
J0hnDee: bets $3.50
FoodPRO2012: calls $3.50
*** RIVER *** [2d Td 9h 6s] [4c]
J0hnDee: bets $10
FoodPRO2012: raises $17.72 to $27.72 and is all-in
J0hnDee: folds 
Uncalled bet ($17.72) returned to FoodPRO2012
FoodPRO2012 collected $31.82 from pot
FoodPRO2012: doesn't show hand 
*** SUMMARY ***
Total pot $33.50 | Rake $1.68 
Board [2d Td 9h 6s 4c]
Seat 1: whitecillar3 folded before Flop (didn't bet)
Seat 3: LeXuSSS201 (button) folded before Flop (didn't bet)
Seat 4: J0hnDee (small blind) folded on the River
Seat 5: FoodPRO2012 (big blind) collected ($31.82)
Seat 6: Kahmi3105 folded before Flop (didn't bet)
Seat 7: Pachebrash folded before Flop (didn't bet)
Seat 8: La Ghir folded before Flop (didn't bet)
Seat 9: siskin vrach folded before Flop (didn't bet)



PokerStars Hand #228685879584:  Hold'em No Limit ($0.25/$0.50 USD) - 2021/07/30 14:51:40 ET
Table 'Aitne III' 9-max Seat #4 is the button
Seat 1: whitecillar3 ($50 in chips) 
Seat 3: LeXuSSS201 ($50 in chips) 
Seat 4: J0hnDee ($54.35 in chips) 
Seat 5: FoodPRO2012 ($49.54 in chips) 
Seat 6: Kahmi3105 ($135.81 in chips) 
Seat 7: Pachebrash ($105.53 in chips) 
Seat 8: La Ghir ($50.75 in chips) 
Seat 9: siskin vrach ($52.26 in chips) 
FoodPRO2012: posts small blind $0.25
Kahmi3105: posts big blind $0.50
artemxxl: sits out 
*** HOLE CARDS ***
Pachebrash: folds 
La Ghir: folds 
siskin vrach: folds 
whitecillar3: folds 
LeXuSSS201: folds 
J0hnDee: folds 
FoodPRO2012: calls $0.25
Kahmi3105: checks 
*** FLOP *** [Ad Tc Kd]
FoodPRO2012: checks 
Kahmi3105: checks 
*** TURN *** [Ad Tc Kd] [2d]
FoodPRO2012: bets $0.50
Kahmi3105: folds 
Uncalled bet ($0.50) returned to FoodPRO2012
FoodPRO2012 collected $0.95 from pot
FoodPRO2012: doesn't show hand 
*** SUMMARY ***
Total pot $1 | Rake $0.05 
Board [Ad Tc Kd 2d]
Seat 1: whitecillar3 folded before Flop (didn't bet)
Seat 3: LeXuSSS201 folded before Flop (didn't bet)
Seat 4: J0hnDee (button) folded before Flop (didn't bet)
Seat 5: FoodPRO2012 (small blind) collected ($0.95)
Seat 6: Kahmi3105 (big blind) folded on the Turn
Seat 7: Pachebrash folded before Flop (didn't bet)
Seat 8: La Ghir folded before Flop (didn't bet)
Seat 9: siskin vrach folded before Flop (didn't bet)



PokerStars Hand #228685896637:  Hold'em No Limit ($0.25/$0.50 USD) - 2021/07/30 14:52:19 ET
Table 'Aitne III' 9-max Seat #5 is the button
Seat 1: whitecillar3 ($50 in chips) 
Seat 3: LeXuSSS201 ($50 in chips) 
Seat 4: J0hnDee ($54.35 in chips) 
Seat 5: FoodPRO2012 ($49.99 in chips) 
Seat 6: Kahmi3105 ($135.31 in chips) 
Seat 7: Pachebrash ($105.53 in chips) 
Seat 8: La Ghir ($50.75 in chips) 
Seat 9: siskin vrach ($52.26 in chips) 
Kahmi3105: posts small blind $0.25
Pachebrash: posts big blind $0.50
artemxxl: sits out 
*** HOLE CARDS ***
La Ghir: folds 
siskin vrach: folds 
whitecillar3: folds 
LeXuSSS201: folds 
J0hnDee: folds 
FoodPRO2012: folds 
Kahmi3105: calls $0.25
Pachebrash: raises $1.50 to $2
Kahmi3105: folds 
Uncalled bet ($1.50) returned to Pachebrash
Pachebrash collected $1 from pot
Pachebrash: doesn't show hand 
*** SUMMARY ***
Total pot $1 | Rake $0 
Seat 1: whitecillar3 folded before Flop (didn't bet)
Seat 3: LeXuSSS201 folded before Flop (didn't bet)
Seat 4: J0hnDee folded before Flop (didn't bet)
Seat 5: FoodPRO2012 (button) folded before Flop (didn't bet)
Seat 6: Kahmi3105 (small blind) folded before Flop
Seat 7: Pachebrash (big blind) collected ($1)
Seat 8: La Ghir folded before Flop (didn't bet)
Seat 9: siskin vrach folded before Flop (didn't bet)



PokerStars Hand #228685905755:  Hold'em No Limit ($0.25/$0.50 USD) - 2021/07/30 14:52:41 ET
Table 'Aitne III' 9-max Seat #6 is the button
Seat 1: whitecillar3 ($50 in chips) 
Seat 3: LeXuSSS201 ($50 in chips) 
Seat 4: J0hnDee ($54.35 in chips) 
Seat 5: FoodPRO2012 ($49.99 in chips) 
Seat 6: Kahmi3105 ($134.81 in chips) 
Seat 7: Pachebrash ($106.03 in chips) 
Seat 8: La Ghir ($50.75 in chips) 
Seat 9: siskin vrach ($52.26 in chips) 
Pachebrash: posts small blind $0.25
La Ghir: posts big blind $0.50
artemxxl: sits out 
*** HOLE CARDS ***
siskin vrach: folds 
siskin vrach leaves the table
whitecillar3: raises $0.75 to $1.25
LeXuSSS201: folds 
J0hnDee: folds 
FoodPRO2012: folds 
Kahmi3105: folds 
Pachebrash: folds 
La Ghir: folds 
Uncalled bet ($0.75) returned to whitecillar3
Mmago24 joins the table at seat #9 
whitecillar3 collected $1.25 from pot
*** SUMMARY ***
Total pot $1.25 | Rake $0 
Seat 1: whitecillar3 collected ($1.25)
Seat 3: LeXuSSS201 folded before Flop (didn't bet)
Seat 4: J0hnDee folded before Flop (didn't bet)
Seat 5: FoodPRO2012 folded before Flop (didn't bet)
Seat 6: Kahmi3105 (button) folded before Flop (didn't bet)
Seat 7: Pachebrash (small blind) folded before Flop
Seat 8: La Ghir (big blind) folded before Flop
Seat 9: siskin vrach folded before Flop (didn't bet)



PokerStars Hand #228685916326:  Hold'em No Limit ($0.25/$0.50 USD) - 2021/07/30 14:53:05 ET
Table 'Aitne III' 9-max Seat #7 is the button
Seat 1: whitecillar3 ($50.75 in chips) 
Seat 3: LeXuSSS201 ($50 in chips) 
Seat 4: J0hnDee ($54.35 in chips) 
Seat 5: FoodPRO2012 ($49.99 in chips) 
Seat 6: Kahmi3105 ($134.81 in chips) 
Seat 7: Pachebrash ($105.78 in chips) 
Seat 8: La Ghir ($50.25 in chips) 
Seat 9: Mmago24 ($106.12 in chips) 
La Ghir: posts small blind $0.25
Mmago24: posts big blind $0.50
artemxxl: sits out 
*** HOLE CARDS ***
whitecillar3: folds 
LeXuSSS201: raises $1 to $1.50
J0hnDee: folds 
FoodPRO2012: folds 
Kahmi3105: folds 
Pachebrash: folds 
La Ghir: folds 
Mmago24: folds 
Uncalled bet ($1) returned to LeXuSSS201
LeXuSSS201 collected $1.25 from pot
LeXuSSS201: doesn't show hand 
*** SUMMARY ***
Total pot $1.25 | Rake $0 
Seat 1: whitecillar3 folded before Flop (didn't bet)
Seat 3: LeXuSSS201 collected ($1.25)
Seat 4: J0hnDee folded before Flop (didn't bet)
Seat 5: FoodPRO2012 folded before Flop (didn't bet)
Seat 6: Kahmi3105 folded before Flop (didn't bet)
Seat 7: Pachebrash (button) folded before Flop (didn't bet)
Seat 8: La Ghir (small blind) folded before Flop
Seat 9: Mmago24 (big blind) folded before Flop



PokerStars Hand #228685929806:  Hold'em No Limit ($0.25/$0.50 USD) - 2021/07/30 14:53:37 ET
Table 'Aitne III' 9-max Seat #8 is the button
Seat 1: whitecillar3 ($50.75 in chips) 
Seat 3: LeXuSSS201 ($50.75 in chips) 
Seat 4: J0hnDee ($54.35 in chips) 
Seat 5: FoodPRO2012 ($49.99 in chips) 
Seat 6: Kahmi3105 ($134.81 in chips) 
Seat 7: Pachebrash ($105.78 in chips) 
Seat 8: La Ghir ($50 in chips) 
Seat 9: Mmago24 ($105.62 in chips) 
Mmago24: posts small blind $0.25
whitecillar3: posts big blind $0.50
artemxxl: sits out 
*** HOLE CARDS ***
LeXuSSS201: raises $1 to $1.50
J0hnDee: folds 
FoodPRO2012: folds 
Kahmi3105: folds 
Pachebrash: folds 
La Ghir: folds 
Mmago24: folds 
whitecillar3: folds 
Uncalled bet ($1) returned to LeXuSSS201
LeXuSSS201 collected $1.25 from pot
LeXuSSS201: doesn't show hand 
*** SUMMARY ***
Total pot $1.25 | Rake $0 
Seat 1: whitecillar3 (big blind) folded before Flop
Seat 3: LeXuSSS201 collected ($1.25)
Seat 4: J0hnDee folded before Flop (didn't bet)
Seat 5: FoodPRO2012 folded before Flop (didn't bet)
Seat 6: Kahmi3105 folded before Flop (didn't bet)
Seat 7: Pachebrash folded before Flop (didn't bet)
Seat 8: La Ghir (button) folded before Flop (didn't bet)
Seat 9: Mmago24 (small blind) folded before Flop



PokerStars Hand #228685938572:  Hold'em No Limit ($0.25/$0.50 USD) - 2021/07/30 14:53:57 ET
Table 'Aitne III' 9-max Seat #9 is the button
Seat 1: whitecillar3 ($50.25 in chips) 
Seat 2: artemxxl ($50 in chips) 
Seat 3: LeXuSSS201 ($51.50 in chips) 
Seat 4: J0hnDee ($54.35 in chips) 
Seat 5: FoodPRO2012 ($49.99 in chips) 
Seat 6: Kahmi3105 ($134.81 in chips) 
Seat 7: Pachebrash ($105.78 in chips) 
Seat 8: La Ghir ($50 in chips) 
Seat 9: Mmago24 ($105.37 in chips) 
whitecillar3: posts small blind $0.25
artemxxl: posts big blind $0.50
*** HOLE CARDS ***
LeXuSSS201: folds 
J0hnDee: folds 
FoodPRO2012: folds 
Kahmi3105: raises $1.25 to $1.75
Pachebrash: folds 
La Ghir: calls $1.75
Mmago24: calls $1.75
whitecillar3: folds 
artemxxl: folds 
*** FLOP *** [5d 4s 2s]
Kahmi3105: checks 
La Ghir: checks 
Mmago24: checks 
*** TURN *** [5d 4s 2s] [3d]
Kahmi3105: checks 
La Ghir: checks 
Mmago24: bets $2.50
Kahmi3105: calls $2.50
La Ghir: calls $2.50
*** RIVER *** [5d 4s 2s 3d] [4d]
Kahmi3105: checks 
La Ghir: checks 
Mmago24: bets $6.79
Kahmi3105: raises $6.79 to $13.58
La Ghir: folds 
Mmago24: calls $6.79
*** SHOW DOWN ***
Kahmi3105: shows [Jd Ad] (a flush, Ace high)
Mmago24: mucks hand 
Kahmi3105 collected $38.16 from pot
*** SUMMARY ***
Total pot $40.66 | Rake $2.50 
Board [5d 4s 2s 3d 4d]
Seat 1: whitecillar3 (small blind) folded before Flop
Seat 2: artemxxl (big blind) folded before Flop
Seat 3: LeXuSSS201 folded before Flop (didn't bet)
Seat 4: J0hnDee folded before Flop (didn't bet)
Seat 5: FoodPRO2012 folded before Flop (didn't bet)
Seat 6: Kahmi3105 showed [Jd Ad] and won ($38.16) with a flush, Ace high
Seat 7: Pachebrash folded before Flop (didn't bet)
Seat 8: La Ghir folded on the River
Seat 9: Mmago24 (button) mucked



PokerStars Hand #228685965842:  Hold'em No Limit ($0.25/$0.50 USD) - 2021/07/30 14:55:01 ET
Table 'Aitne III' 9-max Seat #1 is the button
Seat 1: whitecillar3 ($50 in chips) 
Seat 2: artemxxl ($50 in chips) 
Seat 3: LeXuSSS201 ($51.50 in chips) 
Seat 4: J0hnDee ($54.35 in chips) 
Seat 5: FoodPRO2012 ($49.99 in chips) 
Seat 6: Kahmi3105 ($155.14 in chips) 
Seat 7: Pachebrash ($105.78 in chips) 
Seat 8: La Ghir ($50 in chips) 
Seat 9: Mmago24 ($87.54 in chips) 
artemxxl: posts small blind $0.25
LeXuSSS201: posts big blind $0.50
*** HOLE CARDS ***
J0hnDee: raises $0.75 to $1.25
FoodPRO2012: folds 
Kahmi3105: calls $1.25
Pachebrash: folds 
Pachebrash leaves the table
La Ghir: folds 
Mmago24: calls $1.25
whitecillar3: folds 
artemxxl: folds 
Lisenok110 joins the table at seat #7 
LeXuSSS201: raises $5.25 to $6.50
J0hnDee: folds 
Kahmi3105: folds 
Mmago24: folds 
Uncalled bet ($5.25) returned to LeXuSSS201
LeXuSSS201 collected $5.25 from pot
LeXuSSS201: doesn't show hand 
*** SUMMARY ***
Total pot $5.25 | Rake $0 
Seat 1: whitecillar3 (button) folded before Flop (didn't bet)
Seat 2: artemxxl (small blind) folded before Flop
Seat 3: LeXuSSS201 (big blind) collected ($5.25)
Seat 4: J0hnDee folded before Flop
Seat 5: FoodPRO2012 folded before Flop (didn't bet)
Seat 6: Kahmi3105 folded before Flop
Seat 7: Pachebrash folded before Flop (didn't bet)
Seat 8: La Ghir folded before Flop (didn't bet)
Seat 9: Mmago24 folded before Flop



PokerStars Hand #228685975971:  Hold'em No Limit ($0.25/$0.50 USD) - 2021/07/30 14:55:30 ET
Table 'Aitne III' 9-max Seat #2 is the button
Seat 1: whitecillar3 ($50 in chips) 
Seat 2: artemxxl ($50 in chips) 
Seat 3: LeXuSSS201 ($55.50 in chips) 
Seat 4: J0hnDee ($53.10 in chips) 
Seat 5: FoodPRO2012 ($49.99 in chips) 
Seat 6: Kahmi3105 ($153.89 in chips) 
Seat 8: La Ghir ($50 in chips) 
Seat 9: Mmago24 ($86.29 in chips) 
LeXuSSS201: posts small blind $0.25
J0hnDee: posts big blind $0.50
Lisenok110: sits out 
*** HOLE CARDS ***
FoodPRO2012: folds 
Kahmi3105: calls $0.50
La Ghir: folds 
Mmago24: folds 
whitecillar3: folds 
artemxxl: raises $2 to $2.50
LeXuSSS201: folds 
J0hnDee: folds 
Kahmi3105: calls $2
*** FLOP *** [9d Kd 8h]
Kahmi3105: checks 
artemxxl: bets $3.50
Kahmi3105: calls $3.50
*** TURN *** [9d Kd 8h] [9c]
Kahmi3105: checks 
artemxxl: bets $7.75
Kahmi3105: folds 
Uncalled bet ($7.75) returned to artemxxl
artemxxl collected $12.11 from pot
artemxxl: doesn't show hand 
*** SUMMARY ***
Total pot $12.75 | Rake $0.64 
Board [9d Kd 8h 9c]
Seat 1: whitecillar3 folded before Flop (didn't bet)
Seat 2: artemxxl (button) collected ($12.11)
Seat 3: LeXuSSS201 (small blind) folded before Flop
Seat 4: J0hnDee (big blind) folded before Flop
Seat 5: FoodPRO2012 folded before Flop (didn't bet)
Seat 6: Kahmi3105 folded on the Turn
Seat 8: La Ghir folded before Flop (didn't bet)
Seat 9: Mmago24 folded before Flop (didn't bet)



PokerStars Hand #228685986882:  Hold'em No Limit ($0.25/$0.50 USD) - 2021/07/30 14:56:04 ET
Table 'Aitne III' 9-max Seat #3 is the button
Seat 1: whitecillar3 ($50 in chips) 
Seat 2: artemxxl ($56.11 in chips) 
Seat 3: LeXuSSS201 ($55.25 in chips) 
Seat 4: J0hnDee ($52.60 in chips) 
Seat 5: FoodPRO2012 ($49.99 in chips) 
Seat 6: Kahmi3105 ($147.89 in chips) 
Seat 8: La Ghir ($50 in chips) 
Seat 9: Mmago24 ($86.29 in chips) 
J0hnDee: posts small blind $0.25
FoodPRO2012: posts big blind $0.50
Lisenok110: sits out 
*** HOLE CARDS ***
Kahmi3105: folds 
La Ghir: folds 
Mmago24: raises $0.72 to $1.22
whitecillar3: folds 
artemxxl: folds 
LeXuSSS201: folds 
J0hnDee: folds 
FoodPRO2012: calls $0.72
*** FLOP *** [8h 2s 5c]
FoodPRO2012: checks 
Mmago24: checks 
*** TURN *** [8h 2s 5c] [7d]
FoodPRO2012: bets $0.50
Mmago24: calls $0.50
*** RIVER *** [8h 2s 5c 7d] [7h]
FoodPRO2012: bets $0.50
Mmago24: calls $0.50
*** SHOW DOWN ***
FoodPRO2012: shows [Qh 8c] (two pair, Eights and Sevens)
Mmago24: mucks hand 
FoodPRO2012 collected $4.46 from pot
*** SUMMARY ***
Total pot $4.69 | Rake $0.23 
Board [8h 2s 5c 7d 7h]
Seat 1: whitecillar3 folded before Flop (didn't bet)
Seat 2: artemxxl folded before Flop (didn't bet)
Seat 3: LeXuSSS201 (button) folded before Flop (didn't bet)
Seat 4: J0hnDee (small blind) folded before Flop
Seat 5: FoodPRO2012 (big blind) showed [Qh 8c] and won ($4.46) with two pair, Eights and Sevens
Seat 6: Kahmi3105 folded before Flop (didn't bet)
Seat 8: La Ghir folded before Flop (didn't bet)
Seat 9: Mmago24 mucked



PokerStars Hand #228686000697:  Hold'em No Limit ($0.25/$0.50 USD) - 2021/07/30 14:56:48 ET
Table 'Aitne III' 9-max Seat #4 is the button
Seat 1: whitecillar3 ($50 in chips) 
Seat 2: artemxxl ($56.11 in chips) 
Seat 3: LeXuSSS201 ($55.25 in chips) 
Seat 4: J0hnDee ($52.35 in chips) 
Seat 5: FoodPRO2012 ($52.23 in chips) 
Seat 6: Kahmi3105 ($147.89 in chips) 
Seat 8: La Ghir ($50 in chips) 
Seat 9: Mmago24 ($84.07 in chips) 
FoodPRO2012: posts small blind $0.25
Kahmi3105: posts big blind $0.50
Lisenok110: sits out 
*** HOLE CARDS ***
La Ghir: folds 
Mmago24: folds 
whitecillar3: folds 
artemxxl: folds 
LeXuSSS201: raises $0.55 to $1.05
J0hnDee: folds 
FoodPRO2012: calls $0.80
Kahmi3105: folds 
*** FLOP *** [6c 6d 5h]
FoodPRO2012: checks 
LeXuSSS201: bets $0.79
FoodPRO2012: folds 
Uncalled bet ($0.79) returned to LeXuSSS201
LeXuSSS201 collected $2.47 from pot
LeXuSSS201: doesn't show hand 
*** SUMMARY ***
Total pot $2.60 | Rake $0.13 
Board [6c 6d 5h]
Seat 1: whitecillar3 folded before Flop (didn't bet)
Seat 2: artemxxl folded before Flop (didn't bet)
Seat 3: LeXuSSS201 collected ($2.47)
Seat 4: J0hnDee (button) folded before Flop (didn't bet)
Seat 5: FoodPRO2012 (small blind) folded on the Flop
Seat 6: Kahmi3105 (big blind) folded before Flop
Seat 8: La Ghir folded before Flop (didn't bet)
Seat 9: Mmago24 folded before Flop (didn't bet)



PokerStars Hand #228686009036:  Hold'em No Limit ($0.25/$0.50 USD) - 2021/07/30 14:57:14 ET
Table 'Aitne III' 9-max Seat #5 is the button
Seat 1: whitecillar3 ($50 in chips) 
Seat 2: artemxxl ($56.11 in chips) 
Seat 3: LeXuSSS201 ($56.67 in chips) 
Seat 4: J0hnDee ($52.35 in chips) 
Seat 5: FoodPRO2012 ($51.18 in chips) 
Seat 6: Kahmi3105 ($147.39 in chips) 
Seat 7: Lisenok110 ($50 in chips) 
Seat 8: La Ghir ($50 in chips) 
Seat 9: Mmago24 ($84.07 in chips) 
Kahmi3105: posts small blind $0.25
Lisenok110: posts big blind $0.50
*** HOLE CARDS ***
La Ghir: folds 
Mmago24: raises $0.72 to $1.22
whitecillar3: folds 
artemxxl: folds 
LeXuSSS201: folds 
J0hnDee: folds 
FoodPRO2012: folds 
Kahmi3105: calls $0.97
Lisenok110: folds 
*** FLOP *** [Ah Kd 5d]
Kahmi3105: checks 
Mmago24: bets $1.48
Kahmi3105: calls $1.48
*** TURN *** [Ah Kd 5d] [Js]
Kahmi3105: checks 
Mmago24: checks 
*** RIVER *** [Ah Kd 5d Js] [8h]
Kahmi3105: checks 
Mmago24: checks 
*** SHOW DOWN ***
Kahmi3105: shows [5h Ad] (two pair, Aces and Fives)
Mmago24: mucks hand 
Kahmi3105 collected $5.52 from pot
*** SUMMARY ***
Total pot $5.90 | Rake $0.38 
Board [Ah Kd 5d Js 8h]
Seat 1: whitecillar3 folded before Flop (didn't bet)
Seat 2: artemxxl folded before Flop (didn't bet)
Seat 3: LeXuSSS201 folded before Flop (didn't bet)
Seat 4: J0hnDee folded before Flop (didn't bet)
Seat 5: FoodPRO2012 (button) folded before Flop (didn't bet)
Seat 6: Kahmi3105 (small blind) showed [5h Ad] and won ($5.52) with two pair, Aces and Fives
Seat 7: Lisenok110 (big blind) folded before Flop
Seat 8: La Ghir folded before Flop (didn't bet)
Seat 9: Mmago24 mucked



PokerStars Hand #228686019759:  Hold'em No Limit ($0.25/$0.50 USD) - 2021/07/30 14:57:48 ET
Table 'Aitne III' 9-max Seat #6 is the button
Seat 1: whitecillar3 ($50 in chips) 
Seat 2: artemxxl ($56.11 in chips) 
Seat 3: LeXuSSS201 ($56.67 in chips) 
Seat 4: J0hnDee ($52.35 in chips) 
Seat 5: FoodPRO2012 ($51.18 in chips) 
Seat 6: Kahmi3105 ($150.21 in chips) 
Seat 7: Lisenok110 ($50 in chips) 
Seat 8: La Ghir ($50 in chips) 
Seat 9: Mmago24 ($81.37 in chips) 
Lisenok110: posts small blind $0.25
La Ghir: posts big blind $0.50
*** HOLE CARDS ***
Mmago24: folds 
whitecillar3: raises $0.75 to $1.25
artemxxl: folds 
LeXuSSS201: folds 
J0hnDee: folds 
FoodPRO2012: folds 
Kahmi3105: folds 
Lisenok110: folds 
La Ghir: folds 
Uncalled bet ($0.75) returned to whitecillar3
whitecillar3 collected $1.25 from pot
*** SUMMARY ***
Total pot $1.25 | Rake $0 
Seat 1: whitecillar3 collected ($1.25)
Seat 2: artemxxl folded before Flop (didn't bet)
Seat 3: LeXuSSS201 folded before Flop (didn't bet)
Seat 4: J0hnDee folded before Flop (didn't bet)
Seat 5: FoodPRO2012 folded before Flop (didn't bet)
Seat 6: Kahmi3105 (button) folded before Flop (didn't bet)
Seat 7: Lisenok110 (small blind) folded before Flop
Seat 8: La Ghir (big blind) folded before Flop
Seat 9: Mmago24 folded before Flop (didn't bet)



PokerStars Hand #228686027028:  Hold'em No Limit ($0.25/$0.50 USD) - 2021/07/30 14:58:11 ET
Table 'Aitne III' 9-max Seat #7 is the button
Seat 1: whitecillar3 ($50.75 in chips) 
Seat 2: artemxxl ($56.11 in chips) 
Seat 3: LeXuSSS201 ($56.67 in chips) 
Seat 4: J0hnDee ($52.35 in chips) 
Seat 5: FoodPRO2012 ($51.18 in chips) 
Seat 7: Lisenok110 ($50 in chips) 
Seat 8: La Ghir ($50 in chips) 
Seat 9: Mmago24 ($81.37 in chips) 
La Ghir: posts small blind $0.25
Mmago24: posts big blind $0.50
*** HOLE CARDS ***
whitecillar3: folds 
artemxxl: folds 
LeXuSSS201: folds 
J0hnDee: raises $0.75 to $1.25
FoodPRO2012: folds 
Lisenok110: folds 
La Ghir: folds 
Mmago24: calls $0.75
*** FLOP *** [7s 3h 6c]
Mmago24: checks 
J0hnDee: checks 
*** TURN *** [7s 3h 6c] [Td]
Mmago24: bets $1.38
J0hnDee: calls $1.38
*** RIVER *** [7s 3h 6c Td] [Tc]
Mmago24: bets $3.49
J0hnDee: folds 
Uncalled bet ($3.49) returned to Mmago24
Mmago24 collected $5.23 from pot
Mmago24: doesn't show hand 
*** SUMMARY ***
Total pot $5.51 | Rake $0.28 
Board [7s 3h 6c Td Tc]
Seat 1: whitecillar3 folded before Flop (didn't bet)
Seat 2: artemxxl folded before Flop (didn't bet)
Seat 3: LeXuSSS201 folded before Flop (didn't bet)
Seat 4: J0hnDee folded on the River
Seat 5: FoodPRO2012 folded before Flop (didn't bet)
Seat 7: Lisenok110 (button) folded before Flop (didn't bet)
Seat 8: La Ghir (small blind) folded before Flop
Seat 9: Mmago24 (big blind) collected ($5.23)



PokerStars Hand #228686043309:  Hold'em No Limit ($0.25/$0.50 USD) - 2021/07/30 14:59:01 ET
Table 'Aitne III' 9-max Seat #8 is the button
Seat 1: whitecillar3 ($50.75 in chips) 
Seat 2: artemxxl ($56.11 in chips) 
Seat 3: LeXuSSS201 ($56.67 in chips) 
Seat 4: J0hnDee ($49.72 in chips) 
Seat 5: FoodPRO2012 ($51.18 in chips) 
Seat 7: Lisenok110 ($50 in chips) 
Seat 8: La Ghir ($50 in chips) 
Seat 9: Mmago24 ($83.97 in chips) 
Mmago24: posts small blind $0.25
whitecillar3: posts big blind $0.50
*** HOLE CARDS ***
artemxxl: folds 
LeXuSSS201: folds 
J0hnDee: folds 
FoodPRO2012: folds 
Lisenok110: folds 
La Ghir: folds 
Mmago24: raises $0.72 to $1.22
whitecillar3: calls $0.72
*** FLOP *** [Ah 3d Ks]
Mmago24: checks 
whitecillar3: checks 
*** TURN *** [Ah 3d Ks] [Tc]
Mmago24: checks 
whitecillar3: bets $1.18
Mmago24: folds 
Uncalled bet ($1.18) returned to whitecillar3
whitecillar3 collected $2.32 from pot
*** SUMMARY ***
Total pot $2.44 | Rake $0.12 
Board [Ah 3d Ks Tc]
Seat 1: whitecillar3 (big blind) collected ($2.32)
Seat 2: artemxxl folded before Flop (didn't bet)
Seat 3: LeXuSSS201 folded before Flop (didn't bet)
Seat 4: J0hnDee folded before Flop (didn't bet)
Seat 5: FoodPRO2012 folded before Flop (didn't bet)
Seat 7: Lisenok110 folded before Flop (didn't bet)
Seat 8: La Ghir (button) folded before Flop (didn't bet)
Seat 9: Mmago24 (small blind) folded on the Turn



PokerStars Hand #228686060830:  Hold'em No Limit ($0.25/$0.50 USD) - 2021/07/30 14:59:56 ET
Table 'Aitne III' 9-max Seat #9 is the button
Seat 1: whitecillar3 ($51.85 in chips) 
Seat 2: artemxxl ($56.11 in chips) 
Seat 3: LeXuSSS201 ($56.67 in chips) 
Seat 4: J0hnDee ($49.72 in chips) 
Seat 5: FoodPRO2012 ($51.18 in chips) 
Seat 7: Lisenok110 ($50 in chips) 
Seat 8: La Ghir ($50 in chips) 
Seat 9: Mmago24 ($82.75 in chips) 
whitecillar3: posts small blind $0.25
artemxxl: posts big blind $0.50
*** HOLE CARDS ***
LeXuSSS201: folds 
J0hnDee: folds 
FoodPRO2012: folds 
Lisenok110: raises $0.75 to $1.25
La Ghir: folds 
Mmago24: calls $1.25
whitecillar3: folds 
artemxxl: folds 
*** FLOP *** [8s Qd Td]
Lisenok110: bets $0.99
Mmago24: raises $2.51 to $3.50
Lisenok110: calls $2.51
*** TURN *** [8s Qd Td] [Kh]
LeXuSSS201 is disconnected 
Lisenok110: checks 
Mmago24: bets $6.49
Lisenok110: folds 
Uncalled bet ($6.49) returned to Mmago24
Mmago24 collected $9.74 from pot
Mmago24: doesn't show hand 
*** SUMMARY ***
Total pot $10.25 | Rake $0.51 
Board [8s Qd Td Kh]
Seat 1: whitecillar3 (small blind) folded before Flop
Seat 2: artemxxl (big blind) folded before Flop
Seat 3: LeXuSSS201 folded before Flop (didn't bet)
Seat 4: J0hnDee folded before Flop (didn't bet)
Seat 5: FoodPRO2012 folded before Flop (didn't bet)
Seat 7: Lisenok110 folded on the Turn
Seat 8: La Ghir folded before Flop (didn't bet)
Seat 9: Mmago24 (button) collected ($9.74)



PokerStars Hand #228686082792:  Hold'em No Limit ($0.25/$0.50 USD) - 2021/07/30 15:01:00 ET
Table 'Aitne III' 9-max Seat #1 is the button
Seat 1: whitecillar3 ($51.60 in chips) 
Seat 2: artemxxl ($55.61 in chips) 
Seat 3: LeXuSSS201 ($56.67 in chips) 
Seat 4: J0hnDee ($49.72 in chips) 
Seat 5: FoodPRO2012 ($51.18 in chips) 
Seat 7: Lisenok110 ($50 in chips) 
Seat 8: La Ghir ($50 in chips) 
Seat 9: Mmago24 ($87.74 in chips) 
artemxxl: posts small blind $0.25
LeXuSSS201: posts big blind $0.50
*** HOLE CARDS ***
J0hnDee: raises $0.75 to $1.25
FoodPRO2012: calls $1.25
Lisenok110: folds 
La Ghir: folds 
Mmago24: calls $1.25
whitecillar3: folds 
artemxxl: folds 
LeXuSSS201: folds 
*** FLOP *** [6c 6h Th]
J0hnDee: checks 
FoodPRO2012: bets $0.50
Mmago24: calls $0.50
J0hnDee: calls $0.50
*** TURN *** [6c 6h Th] [Kd]
J0hnDee: checks 
FoodPRO2012: bets $1
Mmago24: calls $1
J0hnDee: folds 
*** RIVER *** [6c 6h Th Kd] [2c]
FoodPRO2012: bets $2
Mmago24: folds 
Uncalled bet ($2) returned to FoodPRO2012
FoodPRO2012 collected $7.60 from pot
FoodPRO2012: doesn't show hand 
*** SUMMARY ***
Total pot $8 | Rake $0.40 
Board [6c 6h Th Kd 2c]
Seat 1: whitecillar3 (button) folded before Flop (didn't bet)
Seat 2: artemxxl (small blind) folded before Flop
Seat 3: LeXuSSS201 (big blind) folded before Flop
Seat 4: J0hnDee folded on the Turn
Seat 5: FoodPRO2012 collected ($7.60)
Seat 7: Lisenok110 folded before Flop (didn't bet)
Seat 8: La Ghir folded before Flop (didn't bet)
Seat 9: Mmago24 folded on the River



PokerStars Hand #228686112992:  Hold'em No Limit ($0.25/$0.50 USD) - 2021/07/30 15:02:09 ET
Table 'Aitne III' 9-max Seat #2 is the button
Seat 1: whitecillar3 ($51.60 in chips) 
Seat 2: artemxxl ($55.36 in chips) 
Seat 3: LeXuSSS201 ($56.17 in chips) 
Seat 4: J0hnDee ($47.97 in chips) 
Seat 5: FoodPRO2012 ($56.03 in chips) 
Seat 7: Lisenok110 ($50 in chips) 
Seat 8: La Ghir ($50 in chips) 
Seat 9: Mmago24 ($84.99 in chips) 
LeXuSSS201: posts small blind $0.25
J0hnDee: posts big blind $0.50
*** HOLE CARDS ***
FoodPRO2012: folds 
Lisenok110: raises $0.75 to $1.25
La Ghir: folds 
Mmago24: raises $3.25 to $4.50
whitecillar3: folds 
artemxxl: folds 
LeXuSSS201: folds 
J0hnDee: folds 
Lisenok110: raises $9.75 to $14.25
Mmago24: folds 
Uncalled bet ($9.75) returned to Lisenok110
Lisenok110 collected $9.75 from pot
Lisenok110: doesn't show hand 
*** SUMMARY ***
Total pot $9.75 | Rake $0 
Seat 1: whitecillar3 folded before Flop (didn't bet)
Seat 2: artemxxl (button) folded before Flop (didn't bet)
Seat 3: LeXuSSS201 (small blind) folded before Flop
Seat 4: J0hnDee (big blind) folded before Flop
Seat 5: FoodPRO2012 folded before Flop (didn't bet)
Seat 7: Lisenok110 collected ($9.75)
Seat 8: La Ghir folded before Flop (didn't bet)
Seat 9: Mmago24 folded before Flop



PokerStars Hand #228686129324:  Hold'em No Limit ($0.25/$0.50 USD) - 2021/07/30 15:02:48 ET
Table 'Aitne III' 9-max Seat #3 is the button
Seat 1: whitecillar3 ($51.60 in chips) 
Seat 2: artemxxl ($55.36 in chips) 
Seat 3: LeXuSSS201 ($55.92 in chips) 
Seat 4: J0hnDee ($47.47 in chips) 
Seat 5: FoodPRO2012 ($56.03 in chips) 
Seat 6: Kahmi3105 ($150.21 in chips) 
Seat 7: Lisenok110 ($55.25 in chips) 
Seat 8: La Ghir ($50 in chips) 
Seat 9: Mmago24 ($80.49 in chips) 
J0hnDee: posts small blind $0.25
FoodPRO2012: posts big blind $0.50
*** HOLE CARDS ***
Kahmi3105: calls $0.50
Lisenok110: folds 
La Ghir: folds 
Mmago24: folds 
Mmago24 leaves the table
whitecillar3: folds 
artemxxl: folds 
LeXuSSS201: folds 
J0hnDee: folds 
FoodPRO2012: checks 
*** FLOP *** [Ts 8s Th]
FoodPRO2012: checks 
Kahmi3105: bets $1.19
Mc57Arnold joins the table at seat #9 
FoodPRO2012: folds 
Uncalled bet ($1.19) returned to Kahmi3105
Kahmi3105 collected $1.17 from pot
*** SUMMARY ***
Total pot $1.25 | Rake $0.08 
Board [Ts 8s Th]
Seat 1: whitecillar3 folded before Flop (didn't bet)
Seat 2: artemxxl folded before Flop (didn't bet)
Seat 3: LeXuSSS201 (button) folded before Flop (didn't bet)
Seat 4: J0hnDee (small blind) folded before Flop
Seat 5: FoodPRO2012 (big blind) folded on the Flop
Seat 6: Kahmi3105 collected ($1.17)
Seat 7: Lisenok110 folded before Flop (didn't bet)
Seat 8: La Ghir folded before Flop (didn't bet)
Seat 9: Mmago24 folded before Flop (didn't bet)



PokerStars Hand #228686141629:  Hold'em No Limit ($0.25/$0.50 USD) - 2021/07/30 15:03:16 ET
Table 'Aitne III' 9-max Seat #4 is the button
Seat 1: whitecillar3 ($51.60 in chips) 
Seat 2: artemxxl ($55.36 in chips) 
Seat 3: LeXuSSS201 ($55.92 in chips) 
Seat 4: J0hnDee ($47.22 in chips) 
Seat 5: FoodPRO2012 ($55.53 in chips) 
Seat 6: Kahmi3105 ($150.88 in chips) 
Seat 7: Lisenok110 ($55.25 in chips) 
Seat 8: La Ghir ($50 in chips) 
FoodPRO2012: posts small blind $0.25
Kahmi3105: posts big blind $0.50
Mc57Arnold: sits out 
*** HOLE CARDS ***
Lisenok110: folds 
La Ghir: folds 
whitecillar3: folds 
artemxxl: folds 
LeXuSSS201: folds 
J0hnDee: raises $0.75 to $1.25
FoodPRO2012: folds 
Kahmi3105: calls $0.75
*** FLOP *** [6d 3d 7c]
Kahmi3105: checks 
J0hnDee: checks 
*** TURN *** [6d 3d 7c] [Ts]
Kahmi3105: checks 
J0hnDee: bets $1.50
Kahmi3105: calls $1.50
*** RIVER *** [6d 3d 7c Ts] [4s]
Kahmi3105: checks 
J0hnDee: checks 
*** SHOW DOWN ***
Kahmi3105: shows [Ac 6h] (a pair of Sixes)
J0hnDee: shows [7d 9d] (a pair of Sevens)
J0hnDee collected $5.46 from pot
*** SUMMARY ***
Total pot $5.75 | Rake $0.29 
Board [6d 3d 7c Ts 4s]
Seat 1: whitecillar3 folded before Flop (didn't bet)
Seat 2: artemxxl folded before Flop (didn't bet)
Seat 3: LeXuSSS201 folded before Flop (didn't bet)
Seat 4: J0hnDee (button) showed [7d 9d] and won ($5.46) with a pair of Sevens
Seat 5: FoodPRO2012 (small blind) folded before Flop
Seat 6: Kahmi3105 (big blind) showed [Ac 6h] and lost with a pair of Sixes
Seat 7: Lisenok110 folded before Flop (didn't bet)
Seat 8: La Ghir folded before Flop (didn't bet)



PokerStars Hand #228686157230:  Hold'em No Limit ($0.25/$0.50 USD) - 2021/07/30 15:03:52 ET
Table 'Aitne III' 9-max Seat #5 is the button
Seat 1: whitecillar3 ($51.60 in chips) 
Seat 2: artemxxl ($55.36 in chips) 
Seat 3: LeXuSSS201 ($55.92 in chips) 
Seat 4: J0hnDee ($49.93 in chips) 
Seat 5: FoodPRO2012 ($55.28 in chips) 
Seat 6: Kahmi3105 ($148.13 in chips) 
Seat 7: Lisenok110 ($55.25 in chips) 
Seat 8: La Ghir ($50 in chips) 
Kahmi3105: posts small blind $0.25
Lisenok110: posts big blind $0.50
Mc57Arnold: sits out 
*** HOLE CARDS ***
La Ghir: folds 
whitecillar3: folds 
artemxxl: raises $1 to $1.50
LeXuSSS201: folds 
J0hnDee: folds 
FoodPRO2012: calls $1.50
Kahmi3105: folds 
Lisenok110: calls $1
*** FLOP *** [Jh 4h 2d]
Lisenok110: checks 
artemxxl: checks 
FoodPRO2012: bets $1
Lisenok110: calls $1
artemxxl: calls $1
*** TURN *** [Jh 4h 2d] [Kd]
Lisenok110: checks 
artemxxl: bets $5.75
FoodPRO2012: calls $5.75
Lisenok110: calls $5.75
*** RIVER *** [Jh 4h 2d Kd] [4s]
Lisenok110: checks 
artemxxl: bets $13.75
FoodPRO2012: calls $13.75
Lisenok110: folds 
*** SHOW DOWN ***
artemxxl: shows [Ks Qc] (two pair, Kings and Fours)
FoodPRO2012: shows [Ad Kh] (two pair, Kings and Fours - Ace kicker)
FoodPRO2012 collected $50.50 from pot
*** SUMMARY ***
Total pot $52.50 | Rake $2 
Board [Jh 4h 2d Kd 4s]
Seat 1: whitecillar3 folded before Flop (didn't bet)
Seat 2: artemxxl showed [Ks Qc] and lost with two pair, Kings and Fours
Seat 3: LeXuSSS201 folded before Flop (didn't bet)
Seat 4: J0hnDee folded before Flop (didn't bet)
Seat 5: FoodPRO2012 (button) showed [Ad Kh] and won ($50.50) with two pair, Kings and Fours
Seat 6: Kahmi3105 (small blind) folded before Flop
Seat 7: Lisenok110 (big blind) folded on the River
Seat 8: La Ghir folded before Flop (didn't bet)



PokerStars Hand #228686179168:  Hold'em No Limit ($0.25/$0.50 USD) - 2021/07/30 15:04:41 ET
Table 'Aitne III' 9-max Seat #6 is the button
Seat 1: whitecillar3 ($51.60 in chips) 
Seat 2: artemxxl ($50 in chips) 
Seat 3: LeXuSSS201 ($55.92 in chips) 
Seat 4: J0hnDee ($49.93 in chips) 
Seat 5: FoodPRO2012 ($83.78 in chips) 
Seat 6: Kahmi3105 ($147.88 in chips) 
Seat 7: Lisenok110 ($50 in chips) 
Seat 8: La Ghir ($50 in chips) 
Lisenok110: posts small blind $0.25
La Ghir: posts big blind $0.50
Mc57Arnold: sits out 
*** HOLE CARDS ***
whitecillar3: folds 
artemxxl: raises $1 to $1.50
LeXuSSS201: folds 
J0hnDee: folds 
FoodPRO2012: folds 
Kahmi3105: calls $1.50
Lisenok110: folds 
La Ghir: raises $6 to $7.50
artemxxl: folds 
Kahmi3105: folds 
Uncalled bet ($6) returned to La Ghir
La Ghir collected $4.75 from pot
La Ghir: doesn't show hand 
*** SUMMARY ***
Total pot $4.75 | Rake $0 
Seat 1: whitecillar3 folded before Flop (didn't bet)
Seat 2: artemxxl folded before Flop
Seat 3: LeXuSSS201 folded before Flop (didn't bet)
Seat 4: J0hnDee folded before Flop (didn't bet)
Seat 5: FoodPRO2012 folded before Flop (didn't bet)
Seat 6: Kahmi3105 (button) folded before Flop
Seat 7: Lisenok110 (small blind) folded before Flop
Seat 8: La Ghir (big blind) collected ($4.75)



PokerStars Hand #228686187622:  Hold'em No Limit ($0.25/$0.50 USD) - 2021/07/30 15:05:00 ET
Table 'Aitne III' 9-max Seat #7 is the button
Seat 1: whitecillar3 ($51.60 in chips) 
Seat 2: artemxxl ($50 in chips) 
Seat 3: LeXuSSS201 ($55.92 in chips) 
Seat 4: J0hnDee ($49.93 in chips) 
Seat 5: FoodPRO2012 ($83.78 in chips) 
Seat 6: Kahmi3105 ($146.38 in chips) 
Seat 7: Lisenok110 ($50 in chips) 
Seat 8: La Ghir ($53.25 in chips) 
Seat 9: Mc57Arnold ($50 in chips) 
La Ghir: posts small blind $0.25
Mc57Arnold: posts big blind $0.50
*** HOLE CARDS ***
whitecillar3: folds 
artemxxl: folds 
LeXuSSS201: folds 
J0hnDee: raises $0.75 to $1.25
FoodPRO2012: folds 
Kahmi3105: folds 
Lisenok110: folds 
La Ghir: raises $4.25 to $5.50
Mc57Arnold: folds 
J0hnDee: folds 
Uncalled bet ($4.25) returned to La Ghir
La Ghir collected $3 from pot
La Ghir: doesn't show hand 
*** SUMMARY ***
Total pot $3 | Rake $0 
Seat 1: whitecillar3 folded before Flop (didn't bet)
Seat 2: artemxxl folded before Flop (didn't bet)
Seat 3: LeXuSSS201 folded before Flop (didn't bet)
Seat 4: J0hnDee folded before Flop
Seat 5: FoodPRO2012 folded before Flop (didn't bet)
Seat 6: Kahmi3105 folded before Flop (didn't bet)
Seat 7: Lisenok110 (button) folded before Flop (didn't bet)
Seat 8: La Ghir (small blind) collected ($3)
Seat 9: Mc57Arnold (big blind) folded before Flop



PokerStars Hand #228686202754:  Hold'em No Limit ($0.25/$0.50 USD) - 2021/07/30 15:05:24 ET
Table 'Aitne III' 9-max Seat #8 is the button
Seat 1: whitecillar3 ($51.60 in chips) 
Seat 2: artemxxl ($50 in chips) 
Seat 3: LeXuSSS201 ($55.92 in chips) 
Seat 4: J0hnDee ($48.68 in chips) 
Seat 5: FoodPRO2012 ($83.78 in chips) 
Seat 6: Kahmi3105 ($146.38 in chips) 
Seat 7: Lisenok110 ($50 in chips) 
Seat 8: La Ghir ($55 in chips) 
Seat 9: Mc57Arnold ($50 in chips) 
Mc57Arnold: posts small blind $0.25
whitecillar3: posts big blind $0.50
*** HOLE CARDS ***
artemxxl: folds 
LeXuSSS201: folds 
J0hnDee: folds 
FoodPRO2012: folds 
Kahmi3105: folds 
Lisenok110: raises $0.75 to $1.25
La Ghir: folds 
Mc57Arnold: raises $3.75 to $5
whitecillar3: folds 
Lisenok110: folds 
Uncalled bet ($3.75) returned to Mc57Arnold
Mc57Arnold collected $3 from pot
Mc57Arnold: doesn't show hand 
*** SUMMARY ***
Total pot $3 | Rake $0 
Seat 1: whitecillar3 (big blind) folded before Flop
Seat 2: artemxxl folded before Flop (didn't bet)
Seat 3: LeXuSSS201 folded before Flop (didn't bet)
Seat 4: J0hnDee folded before Flop (didn't bet)
Seat 5: FoodPRO2012 folded before Flop (didn't bet)
Seat 6: Kahmi3105 folded before Flop (didn't bet)
Seat 7: Lisenok110 folded before Flop
Seat 8: La Ghir (button) folded before Flop (didn't bet)
Seat 9: Mc57Arnold (small blind) collected ($3)



PokerStars Hand #228686215253:  Hold'em No Limit ($0.25/$0.50 USD) - 2021/07/30 15:05:51 ET
Table 'Aitne III' 9-max Seat #9 is the button
Seat 1: whitecillar3 ($51.10 in chips) 
Seat 2: artemxxl ($50 in chips) 
Seat 3: LeXuSSS201 ($55.92 in chips) 
Seat 4: J0hnDee ($48.68 in chips) 
Seat 5: FoodPRO2012 ($83.78 in chips) 
Seat 6: Kahmi3105 ($146.38 in chips) 
Seat 7: Lisenok110 ($50 in chips) 
Seat 8: La Ghir ($55 in chips) 
Seat 9: Mc57Arnold ($51.75 in chips) 
whitecillar3: posts small blind $0.25
artemxxl: posts big blind $0.50
*** HOLE CARDS ***
LeXuSSS201: folds 
J0hnDee: folds 
FoodPRO2012: folds 
Kahmi3105: folds 
Lisenok110: folds 
La Ghir: folds 
Mc57Arnold: folds 
whitecillar3: folds 
Uncalled bet ($0.25) returned to artemxxl
artemxxl collected $0.50 from pot
*** SUMMARY ***
Total pot $0.50 | Rake $0 
Seat 1: whitecillar3 (small blind) folded before Flop
Seat 2: artemxxl (big blind) collected ($0.50)
Seat 3: LeXuSSS201 folded before Flop (didn't bet)
Seat 4: J0hnDee folded before Flop (didn't bet)
Seat 5: FoodPRO2012 folded before Flop (didn't bet)
Seat 6: Kahmi3105 folded before Flop (didn't bet)
Seat 7: Lisenok110 folded before Flop (didn't bet)
Seat 8: La Ghir folded before Flop (didn't bet)
Seat 9: Mc57Arnold (button) folded before Flop (didn't bet)



PokerStars Hand #228686224563:  Hold'em No Limit ($0.25/$0.50 USD) - 2021/07/30 15:06:12 ET
Table 'Aitne III' 9-max Seat #1 is the button
Seat 1: whitecillar3 ($50.85 in chips) 
Seat 2: artemxxl ($50.25 in chips) 
Seat 3: LeXuSSS201 ($55.92 in chips) 
Seat 4: J0hnDee ($48.68 in chips) 
Seat 5: FoodPRO2012 ($83.78 in chips) 
Seat 6: Kahmi3105 ($146.38 in chips) 
Seat 7: Lisenok110 ($50 in chips) 
Seat 8: La Ghir ($55 in chips) 
Seat 9: Mc57Arnold ($51.75 in chips) 
artemxxl: posts small blind $0.25
LeXuSSS201: posts big blind $0.50
*** HOLE CARDS ***
J0hnDee: folds 
FoodPRO2012: folds 
Kahmi3105: calls $0.50
Lisenok110: folds 
La Ghir: folds 
Mc57Arnold: folds 
whitecillar3: folds 
artemxxl: calls $0.25
LeXuSSS201: checks 
*** FLOP *** [5d Kd Ad]
artemxxl: checks 
LeXuSSS201: checks 
Kahmi3105: bets $1.50
artemxxl: folds 
LeXuSSS201: folds 
Uncalled bet ($1.50) returned to Kahmi3105
Kahmi3105 collected $1.40 from pot
*** SUMMARY ***
Total pot $1.50 | Rake $0.10 
Board [5d Kd Ad]
Seat 1: whitecillar3 (button) folded before Flop (didn't bet)
Seat 2: artemxxl (small blind) folded on the Flop
Seat 3: LeXuSSS201 (big blind) folded on the Flop
Seat 4: J0hnDee folded before Flop (didn't bet)
Seat 5: FoodPRO2012 folded before Flop (didn't bet)
Seat 6: Kahmi3105 collected ($1.40)
Seat 7: Lisenok110 folded before Flop (didn't bet)
Seat 8: La Ghir folded before Flop (didn't bet)
Seat 9: Mc57Arnold folded before Flop (didn't bet)



PokerStars Hand #228686242736:  Hold'em No Limit ($0.25/$0.50 USD) - 2021/07/30 15:06:51 ET
Table 'Aitne III' 9-max Seat #2 is the button
Seat 1: whitecillar3 ($50.85 in chips) 
Seat 2: artemxxl ($50 in chips) 
Seat 3: LeXuSSS201 ($55.42 in chips) 
Seat 4: J0hnDee ($48.68 in chips) 
Seat 5: FoodPRO2012 ($83.78 in chips) 
Seat 6: Kahmi3105 ($147.28 in chips) 
Seat 7: Lisenok110 ($50 in chips) 
Seat 8: La Ghir ($55 in chips) 
Seat 9: Mc57Arnold ($51.75 in chips) 
LeXuSSS201: posts small blind $0.25
J0hnDee: posts big blind $0.50
*** HOLE CARDS ***
FoodPRO2012: folds 
Kahmi3105: calls $0.50
Lisenok110: raises $1 to $1.50
La Ghir: folds 
Mc57Arnold: folds 
whitecillar3: folds 
artemxxl: folds 
LeXuSSS201: folds 
J0hnDee: calls $1
Kahmi3105: calls $1
*** FLOP *** [As 5d 6s]
J0hnDee: checks 
Kahmi3105: checks 
Lisenok110: bets $1.44
J0hnDee: calls $1.44
Kahmi3105: folds 
*** TURN *** [As 5d 6s] [5h]
J0hnDee: checks 
Lisenok110: checks 
*** RIVER *** [As 5d 6s 5h] [Kd]
J0hnDee: checks 
Lisenok110: checks 
*** SHOW DOWN ***
J0hnDee: shows [7h 6h] (two pair, Sixes and Fives)
Lisenok110: mucks hand 
J0hnDee collected $7.25 from pot
*** SUMMARY ***
Total pot $7.63 | Rake $0.38 
Board [As 5d 6s 5h Kd]
Seat 1: whitecillar3 folded before Flop (didn't bet)
Seat 2: artemxxl (button) folded before Flop (didn't bet)
Seat 3: LeXuSSS201 (small blind) folded before Flop
Seat 4: J0hnDee (big blind) showed [7h 6h] and won ($7.25) with two pair, Sixes and Fives
Seat 5: FoodPRO2012 folded before Flop (didn't bet)
Seat 6: Kahmi3105 folded on the Flop
Seat 7: Lisenok110 mucked
Seat 8: La Ghir folded before Flop (didn't bet)
Seat 9: Mc57Arnold folded before Flop (didn't bet)



PokerStars Hand #228686264054:  Hold'em No Limit ($0.25/$0.50 USD) - 2021/07/30 15:07:38 ET
Table 'Aitne III' 9-max Seat #3 is the button
Seat 1: whitecillar3 ($50.85 in chips) 
Seat 2: artemxxl ($50 in chips) 
Seat 3: LeXuSSS201 ($55.17 in chips) 
Seat 4: J0hnDee ($52.99 in chips) 
Seat 5: FoodPRO2012 ($83.78 in chips) 
Seat 6: Kahmi3105 ($145.78 in chips) 
Seat 7: Lisenok110 ($50 in chips) 
Seat 8: La Ghir ($55 in chips) 
Seat 9: Mc57Arnold ($51.75 in chips) 
J0hnDee: posts small blind $0.25
FoodPRO2012: posts big blind $0.50
*** HOLE CARDS ***
Kahmi3105: folds 
Lisenok110: folds 
La Ghir: folds 
Mc57Arnold: folds 
whitecillar3: folds 
artemxxl: folds 
LeXuSSS201: folds 
J0hnDee: folds 
Uncalled bet ($0.25) returned to FoodPRO2012
FoodPRO2012 collected $0.50 from pot
FoodPRO2012: doesn't show hand 
*** SUMMARY ***
Total pot $0.50 | Rake $0 
Seat 1: whitecillar3 folded before Flop (didn't bet)
Seat 2: artemxxl folded before Flop (didn't bet)
Seat 3: LeXuSSS201 (button) folded before Flop (didn't bet)
Seat 4: J0hnDee (small blind) folded before Flop
Seat 5: FoodPRO2012 (big blind) collected ($0.50)
Seat 6: Kahmi3105 folded before Flop (didn't bet)
Seat 7: Lisenok110 folded before Flop (didn't bet)
Seat 8: La Ghir folded before Flop (didn't bet)
Seat 9: Mc57Arnold folded before Flop (didn't bet)



PokerStars Hand #228686270868:  Hold'em No Limit ($0.25/$0.50 USD) - 2021/07/30 15:07:53 ET
Table 'Aitne III' 9-max Seat #4 is the button
Seat 1: whitecillar3 ($50.85 in chips) 
Seat 2: artemxxl ($50 in chips) 
Seat 3: LeXuSSS201 ($55.17 in chips) 
Seat 4: J0hnDee ($52.74 in chips) 
Seat 5: FoodPRO2012 ($84.03 in chips) 
Seat 6: Kahmi3105 ($145.78 in chips) 
Seat 7: Lisenok110 ($50 in chips) 
Seat 8: La Ghir ($55 in chips) 
Seat 9: Mc57Arnold ($51.75 in chips) 
FoodPRO2012: posts small blind $0.25
Kahmi3105: posts big blind $0.50
*** HOLE CARDS ***
Lisenok110: folds 
La Ghir: folds 
Mc57Arnold: folds 
whitecillar3: raises $0.75 to $1.25
artemxxl: folds 
LeXuSSS201: folds 
J0hnDee: folds 
FoodPRO2012: folds 
Kahmi3105: calls $0.75
*** FLOP *** [Jh Kc 6s]
Kahmi3105: checks 
whitecillar3: checks 
*** TURN *** [Jh Kc 6s] [As]
Kahmi3105: checks 
whitecillar3: bets $1.98
Kahmi3105: folds 
Uncalled bet ($1.98) returned to whitecillar3
whitecillar3 collected $2.61 from pot
*** SUMMARY ***
Total pot $2.75 | Rake $0.14 
Board [Jh Kc 6s As]
Seat 1: whitecillar3 collected ($2.61)
Seat 2: artemxxl folded before Flop (didn't bet)
Seat 3: LeXuSSS201 folded before Flop (didn't bet)
Seat 4: J0hnDee (button) folded before Flop (didn't bet)
Seat 5: FoodPRO2012 (small blind) folded before Flop
Seat 6: Kahmi3105 (big blind) folded on the Turn
Seat 7: Lisenok110 folded before Flop (didn't bet)
Seat 8: La Ghir folded before Flop (didn't bet)
Seat 9: Mc57Arnold folded before Flop (didn't bet)



PokerStars Hand #228686286406:  Hold'em No Limit ($0.25/$0.50 USD) - 2021/07/30 15:08:26 ET
Table 'Aitne III' 9-max Seat #5 is the button
Seat 1: whitecillar3 ($52.21 in chips) 
Seat 2: artemxxl ($50 in chips) 
Seat 3: LeXuSSS201 ($55.17 in chips) 
Seat 4: J0hnDee ($52.74 in chips) 
Seat 5: FoodPRO2012 ($83.78 in chips) 
Seat 6: Kahmi3105 ($144.53 in chips) 
Seat 7: Lisenok110 ($50 in chips) 
Seat 8: La Ghir ($55 in chips) 
Seat 9: Mc57Arnold ($51.75 in chips) 
Kahmi3105: posts small blind $0.25
Lisenok110: posts big blind $0.50
*** HOLE CARDS ***
La Ghir: folds 
Mc57Arnold: folds 
whitecillar3: raises $0.75 to $1.25
artemxxl: calls $1.25
LeXuSSS201: folds 
J0hnDee: folds 
FoodPRO2012: folds 
Kahmi3105: folds 
Lisenok110: calls $0.75
*** FLOP *** [3s 4c 5d]
Lisenok110: checks 
LeXuSSS201 was removed from the table for failing to post
LeXuSSS201 leaves the table
whitecillar3: bets $1.94
artemxxl: folds 
Lisenok110: calls $1.94
*** TURN *** [3s 4c 5d] [2s]
Lisenok110: checks 
whitecillar3: checks 
*** RIVER *** [3s 4c 5d 2s] [8h]
Lisenok110: checks 
whitecillar3: bets $2.50
Lisenok110: calls $2.50
*** SHOW DOWN ***
whitecillar3: shows [Jh Th] (high card Jack)
Lisenok110: shows [Ad 7d] (a straight, Ace to Five)
Lisenok110 collected $12.24 from pot
*** SUMMARY ***
Total pot $12.88 | Rake $0.64 
Board [3s 4c 5d 2s 8h]
Seat 1: whitecillar3 showed [Jh Th] and lost with high card Jack
Seat 2: artemxxl folded on the Flop
Seat 3: LeXuSSS201 folded before Flop (didn't bet)
Seat 4: J0hnDee folded before Flop (didn't bet)
Seat 5: FoodPRO2012 (button) folded before Flop (didn't bet)
Seat 6: Kahmi3105 (small blind) folded before Flop
Seat 7: Lisenok110 (big blind) showed [Ad 7d] and won ($12.24) with a straight, Ace to Five
Seat 8: La Ghir folded before Flop (didn't bet)
Seat 9: Mc57Arnold folded before Flop (didn't bet)



PokerStars Hand #228686314635:  Hold'em No Limit ($0.25/$0.50 USD) - 2021/07/30 15:09:27 ET
Table 'Aitne III' 9-max Seat #6 is the button
Seat 1: whitecillar3 ($46.52 in chips) 
Seat 2: artemxxl ($50 in chips) 
Seat 4: J0hnDee ($52.74 in chips) 
Seat 5: FoodPRO2012 ($83.78 in chips) 
Seat 6: Kahmi3105 ($144.28 in chips) 
Seat 7: Lisenok110 ($56.55 in chips) 
Seat 8: La Ghir ($55 in chips) 
Seat 9: Mc57Arnold ($51.75 in chips) 
Lisenok110: posts small blind $0.25
La Ghir: posts big blind $0.50
*** HOLE CARDS ***
Mc57Arnold: folds 
whitecillar3: folds 
artemxxl: folds 
J0hnDee: folds 
FoodPRO2012: folds 
Kahmi3105: raises $1.25 to $1.75
Lisenok110: folds 
La Ghir: folds 
Uncalled bet ($1.25) returned to Kahmi3105
Kahmi3105 collected $1.25 from pot
*** SUMMARY ***
Total pot $1.25 | Rake $0 
Seat 1: whitecillar3 folded before Flop (didn't bet)
Seat 2: artemxxl folded before Flop (didn't bet)
Seat 4: J0hnDee folded before Flop (didn't bet)
Seat 5: FoodPRO2012 folded before Flop (didn't bet)
Seat 6: Kahmi3105 (button) collected ($1.25)
Seat 7: Lisenok110 (small blind) folded before Flop
Seat 8: La Ghir (big blind) folded before Flop
Seat 9: Mc57Arnold folded before Flop (didn't bet)



PokerStars Hand #228686320767:  Hold'em No Limit ($0.25/$0.50 USD) - 2021/07/30 15:09:41 ET
Table 'Aitne III' 9-max Seat #7 is the button
Seat 1: whitecillar3 ($46.52 in chips) 
Seat 2: artemxxl ($50 in chips) 
Seat 4: J0hnDee ($52.74 in chips) 
Seat 5: FoodPRO2012 ($83.78 in chips) 
Seat 6: Kahmi3105 ($145.03 in chips) 
Seat 7: Lisenok110 ($56.30 in chips) 
Seat 8: La Ghir ($54.50 in chips) 
Seat 9: Mc57Arnold ($51.75 in chips) 
La Ghir: posts small blind $0.25
Mc57Arnold: posts big blind $0.50
*** HOLE CARDS ***
whitecillar3: folds 
artemxxl: folds 
J0hnDee: folds 
FoodPRO2012: folds 
Kahmi3105: folds 
Lisenok110: raises $0.75 to $1.25
La Ghir: folds 
Mc57Arnold: folds 
Uncalled bet ($0.75) returned to Lisenok110
Lisenok110 collected $1.25 from pot
Lisenok110: doesn't show hand 
*** SUMMARY ***
Total pot $1.25 | Rake $0 
Seat 1: whitecillar3 folded before Flop (didn't bet)
Seat 2: artemxxl folded before Flop (didn't bet)
Seat 4: J0hnDee folded before Flop (didn't bet)
Seat 5: FoodPRO2012 folded before Flop (didn't bet)
Seat 6: Kahmi3105 folded before Flop (didn't bet)
Seat 7: Lisenok110 (button) collected ($1.25)
Seat 8: La Ghir (small blind) folded before Flop
Seat 9: Mc57Arnold (big blind) folded before Flop



PokerStars Hand #228686327956:  Hold'em No Limit ($0.25/$0.50 USD) - 2021/07/30 15:09:57 ET
Table 'Aitne III' 9-max Seat #8 is the button
Seat 1: whitecillar3 ($46.52 in chips) 
Seat 2: artemxxl ($50 in chips) 
Seat 4: J0hnDee ($52.74 in chips) 
Seat 5: FoodPRO2012 ($83.78 in chips) 
Seat 6: Kahmi3105 ($145.03 in chips) 
Seat 7: Lisenok110 ($57.05 in chips) 
Seat 8: La Ghir ($54.25 in chips) 
Seat 9: Mc57Arnold ($51.25 in chips) 
Mc57Arnold: posts small blind $0.25
whitecillar3: posts big blind $0.50
*** HOLE CARDS ***
artemxxl: raises $1 to $1.50
J0hnDee: folds 
FoodPRO2012: folds 
Kahmi3105: calls $1.50
Lisenok110: folds 
La Ghir: folds 
Mc57Arnold: folds 
whitecillar3: folds 
*** FLOP *** [4d As 9s]
pafell joins the table at seat #3 
artemxxl: bets $1.75
Kahmi3105: folds 
Uncalled bet ($1.75) returned to artemxxl
artemxxl collected $3.56 from pot
artemxxl: doesn't show hand 
*** SUMMARY ***
Total pot $3.75 | Rake $0.19 
Board [4d As 9s]
Seat 1: whitecillar3 (big blind) folded before Flop
Seat 2: artemxxl collected ($3.56)
Seat 4: J0hnDee folded before Flop (didn't bet)
Seat 5: FoodPRO2012 folded before Flop (didn't bet)
Seat 6: Kahmi3105 folded on the Flop
Seat 7: Lisenok110 folded before Flop (didn't bet)
Seat 8: La Ghir (button) folded before Flop (didn't bet)
Seat 9: Mc57Arnold (small blind) folded before Flop



PokerStars Hand #228686335171:  Hold'em No Limit ($0.25/$0.50 USD) - 2021/07/30 15:10:12 ET
Table 'Aitne III' 9-max Seat #9 is the button
Seat 1: whitecillar3 ($46.02 in chips) 
Seat 2: artemxxl ($52.06 in chips) 
Seat 4: J0hnDee ($52.74 in chips) 
Seat 5: FoodPRO2012 ($83.78 in chips) 
Seat 6: Kahmi3105 ($143.53 in chips) 
Seat 7: Lisenok110 ($57.05 in chips) 
Seat 8: La Ghir ($54.25 in chips) 
Seat 9: Mc57Arnold ($51 in chips) 
whitecillar3: posts small blind $0.25
artemxxl: posts big blind $0.50
pafell: sits out 
*** HOLE CARDS ***
J0hnDee: folds 
FoodPRO2012: folds 
Kahmi3105: raises $1.25 to $1.75
Lisenok110: folds 
La Ghir: folds 
Mc57Arnold: folds 
whitecillar3: folds 
artemxxl: folds 
Uncalled bet ($1.25) returned to Kahmi3105
Kahmi3105 collected $1.25 from pot
*** SUMMARY ***
Total pot $1.25 | Rake $0 
Seat 1: whitecillar3 (small blind) folded before Flop
Seat 2: artemxxl (big blind) folded before Flop
Seat 4: J0hnDee folded before Flop (didn't bet)
Seat 5: FoodPRO2012 folded before Flop (didn't bet)
Seat 6: Kahmi3105 collected ($1.25)
Seat 7: Lisenok110 folded before Flop (didn't bet)
Seat 8: La Ghir folded before Flop (didn't bet)
Seat 9: Mc57Arnold (button) folded before Flop (didn't bet)



PokerStars Hand #228686343967:  Hold'em No Limit ($0.25/$0.50 USD) - 2021/07/30 15:10:31 ET
Table 'Aitne III' 9-max Seat #1 is the button
Seat 1: whitecillar3 ($45.77 in chips) 
Seat 2: artemxxl ($51.56 in chips) 
Seat 3: pafell ($50 in chips) 
Seat 4: J0hnDee ($52.74 in chips) 
Seat 5: FoodPRO2012 ($83.78 in chips) 
Seat 6: Kahmi3105 ($144.28 in chips) 
Seat 7: Lisenok110 ($57.05 in chips) 
Seat 8: La Ghir ($54.25 in chips) 
Seat 9: Mc57Arnold ($51 in chips) 
artemxxl: posts small blind $0.25
pafell: posts big blind $0.50
*** HOLE CARDS ***
J0hnDee: raises $0.50 to $1
FoodPRO2012: folds 
Kahmi3105: calls $1
Lisenok110: folds 
La Ghir: folds 
Mc57Arnold: folds 
whitecillar3: folds 
artemxxl: folds 
pafell: calls $0.50
*** FLOP *** [Qh Ks 2s]
pafell: checks 
J0hnDee: bets $2
Kahmi3105: folds 
pafell: folds 
Uncalled bet ($2) returned to J0hnDee
J0hnDee collected $3.09 from pot
*** SUMMARY ***
Total pot $3.25 | Rake $0.16 
Board [Qh Ks 2s]
Seat 1: whitecillar3 (button) folded before Flop (didn't bet)
Seat 2: artemxxl (small blind) folded before Flop
Seat 3: pafell (big blind) folded on the Flop
Seat 4: J0hnDee collected ($3.09)
Seat 5: FoodPRO2012 folded before Flop (didn't bet)
Seat 6: Kahmi3105 folded on the Flop
Seat 7: Lisenok110 folded before Flop (didn't bet)
Seat 8: La Ghir folded before Flop (didn't bet)
Seat 9: Mc57Arnold folded before Flop (didn't bet)



PokerStars Hand #228686359467:  Hold'em No Limit ($0.25/$0.50 USD) - 2021/07/30 15:11:05 ET
Table 'Aitne III' 9-max Seat #2 is the button
Seat 1: whitecillar3 ($45.77 in chips) 
Seat 2: artemxxl ($51.31 in chips) 
Seat 3: pafell ($49 in chips) 
Seat 4: J0hnDee ($54.83 in chips) 
Seat 5: FoodPRO2012 ($83.78 in chips) 
Seat 6: Kahmi3105 ($143.28 in chips) 
Seat 7: Lisenok110 ($57.05 in chips) 
Seat 8: La Ghir ($54.25 in chips) 
Seat 9: Mc57Arnold ($51 in chips) 
pafell: posts small blind $0.25
J0hnDee: posts big blind $0.50
*** HOLE CARDS ***
FoodPRO2012: folds 
Kahmi3105: calls $0.50
Lisenok110: folds 
La Ghir: folds 
Mc57Arnold: folds 
whitecillar3: raises $1.50 to $2
artemxxl: raises $3.25 to $5.25
pafell: folds 
J0hnDee: folds 
Kahmi3105: folds 
whitecillar3: calls $3.25
*** FLOP *** [9s 8c 2s]
whitecillar3: checks 
artemxxl: checks 
*** TURN *** [9s 8c 2s] [3h]
whitecillar3: checks 
artemxxl: bets $7.37
whitecillar3: folds 
Uncalled bet ($7.37) returned to artemxxl
artemxxl collected $11.16 from pot
*** SUMMARY ***
Total pot $11.75 | Rake $0.59 
Board [9s 8c 2s 3h]
Seat 1: whitecillar3 folded on the Turn
Seat 2: artemxxl (button) collected ($11.16)
Seat 3: pafell (small blind) folded before Flop
Seat 4: J0hnDee (big blind) folded before Flop
Seat 5: FoodPRO2012 folded before Flop (didn't bet)
Seat 6: Kahmi3105 folded before Flop
Seat 7: Lisenok110 folded before Flop (didn't bet)
Seat 8: La Ghir folded before Flop (didn't bet)
Seat 9: Mc57Arnold folded before Flop (didn't bet)



PokerStars Hand #228686390363:  Hold'em No Limit ($0.25/$0.50 USD) - 2021/07/30 15:12:12 ET
Table 'Aitne III' 9-max Seat #3 is the button
Seat 1: whitecillar3 ($40.52 in chips) 
Seat 2: artemxxl ($57.22 in chips) 
Seat 3: pafell ($48.75 in chips) 
Seat 4: J0hnDee ($54.33 in chips) 
Seat 5: FoodPRO2012 ($83.78 in chips) 
Seat 6: Kahmi3105 ($142.78 in chips) 
Seat 7: Lisenok110 ($57.05 in chips) 
Seat 8: La Ghir ($54.25 in chips) 
Seat 9: Mc57Arnold ($51 in chips) 
J0hnDee: posts small blind $0.25
FoodPRO2012: posts big blind $0.50
*** HOLE CARDS ***
Kahmi3105: folds 
Lisenok110: folds 
La Ghir: folds 
Mc57Arnold: raises $0.85 to $1.35
whitecillar3: folds 
artemxxl: folds 
pafell: folds 
J0hnDee: folds 
FoodPRO2012: calls $0.85
*** FLOP *** [As 2h 5s]
FoodPRO2012: checks 
Mc57Arnold: bets $0.84
FoodPRO2012: folds 
Uncalled bet ($0.84) returned to Mc57Arnold
Mc57Arnold collected $2.80 from pot
Mc57Arnold: doesn't show hand 
*** SUMMARY ***
Total pot $2.95 | Rake $0.15 
Board [As 2h 5s]
Seat 1: whitecillar3 folded before Flop (didn't bet)
Seat 2: artemxxl folded before Flop (didn't bet)
Seat 3: pafell (button) folded before Flop (didn't bet)
Seat 4: J0hnDee (small blind) folded before Flop
Seat 5: FoodPRO2012 (big blind) folded on the Flop
Seat 6: Kahmi3105 folded before Flop (didn't bet)
Seat 7: Lisenok110 folded before Flop (didn't bet)
Seat 8: La Ghir folded before Flop (didn't bet)
Seat 9: Mc57Arnold collected ($2.80)



PokerStars Hand #228686402557:  Hold'em No Limit ($0.25/$0.50 USD) - 2021/07/30 15:12:38 ET
Table 'Aitne III' 9-max Seat #4 is the button
Seat 1: whitecillar3 ($40.52 in chips) 
Seat 2: artemxxl ($57.22 in chips) 
Seat 3: pafell ($48.75 in chips) 
Seat 4: J0hnDee ($54.08 in chips) 
Seat 5: FoodPRO2012 ($82.43 in chips) 
Seat 6: Kahmi3105 ($142.78 in chips) 
Seat 7: Lisenok110 ($57.05 in chips) 
Seat 8: La Ghir ($54.25 in chips) 
Seat 9: Mc57Arnold ($52.45 in chips) 
FoodPRO2012: posts small blind $0.25
Kahmi3105: posts big blind $0.50
*** HOLE CARDS ***
Lisenok110: folds 
La Ghir: folds 
Mc57Arnold: folds 
whitecillar3: folds 
artemxxl: raises $0.75 to $1.25
pafell: folds 
J0hnDee: folds 
FoodPRO2012: folds 
Kahmi3105: folds 
Uncalled bet ($0.75) returned to artemxxl
artemxxl collected $1.25 from pot
*** SUMMARY ***
Total pot $1.25 | Rake $0 
Seat 1: whitecillar3 folded before Flop (didn't bet)
Seat 2: artemxxl collected ($1.25)
Seat 3: pafell folded before Flop (didn't bet)
Seat 4: J0hnDee (button) folded before Flop (didn't bet)
Seat 5: FoodPRO2012 (small blind) folded before Flop
Seat 6: Kahmi3105 (big blind) folded before Flop
Seat 7: Lisenok110 folded before Flop (didn't bet)
Seat 8: La Ghir folded before Flop (didn't bet)
Seat 9: Mc57Arnold folded before Flop (didn't bet)



PokerStars Hand #228686409579:  Hold'em No Limit ($0.25/$0.50 USD) - 2021/07/30 15:12:53 ET
Table 'Aitne III' 9-max Seat #5 is the button
Seat 1: whitecillar3 ($50 in chips) 
Seat 2: artemxxl ($57.97 in chips) 
Seat 3: pafell ($48.75 in chips) 
Seat 4: J0hnDee ($54.08 in chips) 
Seat 5: FoodPRO2012 ($82.18 in chips) 
Seat 6: Kahmi3105 ($142.28 in chips) 
Seat 7: Lisenok110 ($57.05 in chips) 
Seat 8: La Ghir ($54.25 in chips) 
Seat 9: Mc57Arnold ($52.45 in chips) 
Kahmi3105: posts small blind $0.25
Lisenok110: posts big blind $0.50
*** HOLE CARDS ***
La Ghir: folds 
Mc57Arnold: folds 
whitecillar3: folds 
artemxxl: folds 
pafell: calls $0.50
J0hnDee: folds 
FoodPRO2012: folds 
Kahmi3105: calls $0.25
Lisenok110: checks 
*** FLOP *** [Tc Qd Jc]
Kahmi3105: checks 
Lisenok110: checks 
pafell: bets $0.71
Kahmi3105: folds 
Lisenok110: folds 
Uncalled bet ($0.71) returned to pafell
pafell collected $1.42 from pot
pafell: doesn't show hand 
*** SUMMARY ***
Total pot $1.50 | Rake $0.08 
Board [Tc Qd Jc]
Seat 1: whitecillar3 folded before Flop (didn't bet)
Seat 2: artemxxl folded before Flop (didn't bet)
Seat 3: pafell collected ($1.42)
Seat 4: J0hnDee folded before Flop (didn't bet)
Seat 5: FoodPRO2012 (button) folded before Flop (didn't bet)
Seat 6: Kahmi3105 (small blind) folded on the Flop
Seat 7: Lisenok110 (big blind) folded on the Flop
Seat 8: La Ghir folded before Flop (didn't bet)
Seat 9: Mc57Arnold folded before Flop (didn't bet)



PokerStars Hand #228686427369:  Hold'em No Limit ($0.25/$0.50 USD) - 2021/07/30 15:13:32 ET
Table 'Aitne III' 9-max Seat #6 is the button
Seat 1: whitecillar3 ($50 in chips) 
Seat 2: artemxxl ($57.97 in chips) 
Seat 3: pafell ($49.67 in chips) 
Seat 4: J0hnDee ($54.08 in chips) 
Seat 5: FoodPRO2012 ($82.18 in chips) 
Seat 6: Kahmi3105 ($141.78 in chips) 
Seat 7: Lisenok110 ($56.55 in chips) 
Seat 8: La Ghir ($54.25 in chips) 
Seat 9: Mc57Arnold ($52.45 in chips) 
Lisenok110: posts small blind $0.25
La Ghir: posts big blind $0.50
*** HOLE CARDS ***
Mc57Arnold: folds 
whitecillar3: folds 
artemxxl: folds 
pafell: folds 
J0hnDee: folds 
FoodPRO2012: calls $0.50
Kahmi3105: folds 
Lisenok110: calls $0.25
La Ghir: checks 
*** FLOP *** [As Jh Ac]
Lisenok110: checks 
La Ghir: checks 
FoodPRO2012: bets $1
Lisenok110: folds 
La Ghir: folds 
Uncalled bet ($1) returned to FoodPRO2012
FoodPRO2012 collected $1.42 from pot
FoodPRO2012: doesn't show hand 
*** SUMMARY ***
Total pot $1.50 | Rake $0.08 
Board [As Jh Ac]
Seat 1: whitecillar3 folded before Flop (didn't bet)
Seat 2: artemxxl folded before Flop (didn't bet)
Seat 3: pafell folded before Flop (didn't bet)
Seat 4: J0hnDee folded before Flop (didn't bet)
Seat 5: FoodPRO2012 collected ($1.42)
Seat 6: Kahmi3105 (button) folded before Flop (didn't bet)
Seat 7: Lisenok110 (small blind) folded on the Flop
Seat 8: La Ghir (big blind) folded on the Flop
Seat 9: Mc57Arnold folded before Flop (didn't bet)



PokerStars Hand #228686440450:  Hold'em No Limit ($0.25/$0.50 USD) - 2021/07/30 15:14:00 ET
Table 'Aitne III' 9-max Seat #7 is the button
Seat 1: whitecillar3 ($50 in chips) 
Seat 2: artemxxl ($57.97 in chips) 
Seat 3: pafell ($49.67 in chips) 
Seat 4: J0hnDee ($54.08 in chips) 
Seat 5: FoodPRO2012 ($83.10 in chips) 
Seat 6: Kahmi3105 ($141.78 in chips) 
Seat 7: Lisenok110 ($56.05 in chips) 
Seat 8: La Ghir ($53.75 in chips) 
Seat 9: Mc57Arnold ($52.45 in chips) 
La Ghir: posts small blind $0.25
Mc57Arnold: posts big blind $0.50
*** HOLE CARDS ***
whitecillar3: folds 
artemxxl: folds 
pafell: folds 
J0hnDee: folds 
FoodPRO2012: folds 
Kahmi3105: raises $1.25 to $1.75
Lisenok110: folds 
La Ghir: folds 
Mc57Arnold: folds 
Uncalled bet ($1.25) returned to Kahmi3105
Kahmi3105 collected $1.25 from pot
*** SUMMARY ***
Total pot $1.25 | Rake $0 
Seat 1: whitecillar3 folded before Flop (didn't bet)
Seat 2: artemxxl folded before Flop (didn't bet)
Seat 3: pafell folded before Flop (didn't bet)
Seat 4: J0hnDee folded before Flop (didn't bet)
Seat 5: FoodPRO2012 folded before Flop (didn't bet)
Seat 6: Kahmi3105 collected ($1.25)
Seat 7: Lisenok110 (button) folded before Flop (didn't bet)
Seat 8: La Ghir (small blind) folded before Flop
Seat 9: Mc57Arnold (big blind) folded before Flop



PokerStars Hand #228686458885:  Hold'em No Limit ($0.25/$0.50 USD) - 2021/07/30 15:14:22 ET
Table 'Aitne III' 9-max Seat #8 is the button
Seat 1: whitecillar3 ($50 in chips) 
Seat 2: artemxxl ($57.97 in chips) 
Seat 3: pafell ($49.67 in chips) 
Seat 4: J0hnDee ($54.08 in chips) 
Seat 5: FoodPRO2012 ($83.10 in chips) 
Seat 6: Kahmi3105 ($142.53 in chips) 
Seat 7: Lisenok110 ($56.05 in chips) 
Seat 8: La Ghir ($53.50 in chips) 
Seat 9: Mc57Arnold ($51.95 in chips) 
Mc57Arnold: posts small blind $0.25
whitecillar3: posts big blind $0.50
*** HOLE CARDS ***
artemxxl: folds 
pafell: calls $0.50
J0hnDee: folds 
FoodPRO2012: folds 
Kahmi3105: folds 
Lisenok110: folds 
La Ghir: folds 
Mc57Arnold: folds 
whitecillar3: checks 
*** FLOP *** [Jc Kd 6s]
whitecillar3: checks 
pafell: bets $1.19
whitecillar3: folds 
Uncalled bet ($1.19) returned to pafell
pafell collected $1.19 from pot
pafell: doesn't show hand 
*** SUMMARY ***
Total pot $1.25 | Rake $0.06 
Board [Jc Kd 6s]
Seat 1: whitecillar3 (big blind) folded on the Flop
Seat 2: artemxxl folded before Flop (didn't bet)
Seat 3: pafell collected ($1.19)
Seat 4: J0hnDee folded before Flop (didn't bet)
Seat 5: FoodPRO2012 folded before Flop (didn't bet)
Seat 6: Kahmi3105 folded before Flop (didn't bet)
Seat 7: Lisenok110 folded before Flop (didn't bet)
Seat 8: La Ghir (button) folded before Flop (didn't bet)
Seat 9: Mc57Arnold (small blind) folded before Flop



PokerStars Hand #228686472813:  Hold'em No Limit ($0.25/$0.50 USD) - 2021/07/30 15:14:52 ET
Table 'Aitne III' 9-max Seat #9 is the button
Seat 1: whitecillar3 ($49.50 in chips) 
Seat 2: artemxxl ($57.97 in chips) 
Seat 3: pafell ($50.36 in chips) 
Seat 4: J0hnDee ($54.08 in chips) 
Seat 5: FoodPRO2012 ($83.10 in chips) 
Seat 6: Kahmi3105 ($142.53 in chips) 
Seat 7: Lisenok110 ($56.05 in chips) 
Seat 8: La Ghir ($53.50 in chips) 
Seat 9: Mc57Arnold ($51.70 in chips) 
whitecillar3: posts small blind $0.25
artemxxl: posts big blind $0.50
*** HOLE CARDS ***
pafell: folds 
J0hnDee: folds 
FoodPRO2012: folds 
Kahmi3105: folds 
Lisenok110: folds 
La Ghir: folds 
Mc57Arnold: raises $0.65 to $1.15
whitecillar3: folds 
artemxxl: folds 
Uncalled bet ($0.65) returned to Mc57Arnold
Mc57Arnold collected $1.25 from pot
Mc57Arnold: doesn't show hand 
*** SUMMARY ***
Total pot $1.25 | Rake $0 
Seat 1: whitecillar3 (small blind) folded before Flop
Seat 2: artemxxl (big blind) folded before Flop
Seat 3: pafell folded before Flop (didn't bet)
Seat 4: J0hnDee folded before Flop (didn't bet)
Seat 5: FoodPRO2012 folded before Flop (didn't bet)
Seat 6: Kahmi3105 folded before Flop (didn't bet)
Seat 7: Lisenok110 folded before Flop (didn't bet)
Seat 8: La Ghir folded before Flop (didn't bet)
Seat 9: Mc57Arnold (button) collected ($1.25)



PokerStars Hand #228686480534:  Hold'em No Limit ($0.25/$0.50 USD) - 2021/07/30 15:15:08 ET
Table 'Aitne III' 9-max Seat #1 is the button
Seat 1: whitecillar3 ($49.25 in chips) 
Seat 2: artemxxl ($57.47 in chips) 
Seat 3: pafell ($50.36 in chips) 
Seat 4: J0hnDee ($54.08 in chips) 
Seat 5: FoodPRO2012 ($83.10 in chips) 
Seat 6: Kahmi3105 ($142.53 in chips) 
Seat 7: Lisenok110 ($56.05 in chips) 
Seat 8: La Ghir ($53.50 in chips) 
Seat 9: Mc57Arnold ($52.45 in chips) 
artemxxl: posts small blind $0.25
pafell: posts big blind $0.50
*** HOLE CARDS ***
J0hnDee: folds 
FoodPRO2012: folds 
Kahmi3105: folds 
Lisenok110: folds 
La Ghir: folds 
Mc57Arnold: folds 
whitecillar3: folds 
artemxxl: raises $1 to $1.50
pafell: calls $1
*** FLOP *** [7s Qs 5s]
artemxxl: bets $1.50
pafell: calls $1.50
*** TURN *** [7s Qs 5s] [4d]
artemxxl: bets $3.76
pafell: folds 
Uncalled bet ($3.76) returned to artemxxl
artemxxl collected $5.70 from pot
*** SUMMARY ***
Total pot $6 | Rake $0.30 
Board [7s Qs 5s 4d]
Seat 1: whitecillar3 (button) folded before Flop (didn't bet)
Seat 2: artemxxl (small blind) collected ($5.70)
Seat 3: pafell (big blind) folded on the Turn
Seat 4: J0hnDee folded before Flop (didn't bet)
Seat 5: FoodPRO2012 folded before Flop (didn't bet)
Seat 6: Kahmi3105 folded before Flop (didn't bet)
Seat 7: Lisenok110 folded before Flop (didn't bet)
Seat 8: La Ghir folded before Flop (didn't bet)
Seat 9: Mc57Arnold folded before Flop (didn't bet)



PokerStars Hand #228686498090:  Hold'em No Limit ($0.25/$0.50 USD) - 2021/07/30 15:15:46 ET
Table 'Aitne III' 9-max Seat #2 is the button
Seat 1: whitecillar3 ($49.25 in chips) 
Seat 2: artemxxl ($60.17 in chips) 
Seat 3: pafell ($47.36 in chips) 
Seat 4: J0hnDee ($54.08 in chips) 
Seat 5: FoodPRO2012 ($83.10 in chips) 
Seat 6: Kahmi3105 ($142.53 in chips) 
Seat 7: Lisenok110 ($56.05 in chips) 
Seat 8: La Ghir ($53.50 in chips) 
Seat 9: Mc57Arnold ($52.45 in chips) 
pafell: posts small blind $0.25
J0hnDee: posts big blind $0.50
*** HOLE CARDS ***
FoodPRO2012: folds 
Kahmi3105: folds 
Lisenok110: folds 
La Ghir: folds 
Mc57Arnold: raises $0.85 to $1.35
whitecillar3: folds 
artemxxl: calls $1.35
pafell: calls $1.10
J0hnDee: folds 
*** FLOP *** [5s 5d 4s]
pafell: checks 
Mc57Arnold: checks 
artemxxl: bets $3.24
pafell: folds 
Mc57Arnold: calls $3.24
*** TURN *** [5s 5d 4s] [4d]
Mc57Arnold: checks 
artemxxl: checks 
*** RIVER *** [5s 5d 4s 4d] [8s]
Mc57Arnold: bets $3
artemxxl: folds 
Uncalled bet ($3) returned to Mc57Arnold
Mc57Arnold collected $10.48 from pot
Mc57Arnold: doesn't show hand 
*** SUMMARY ***
Total pot $11.03 | Rake $0.55 
Board [5s 5d 4s 4d 8s]
Seat 1: whitecillar3 folded before Flop (didn't bet)
Seat 2: artemxxl (button) folded on the River
Seat 3: pafell (small blind) folded on the Flop
Seat 4: J0hnDee (big blind) folded before Flop
Seat 5: FoodPRO2012 folded before Flop (didn't bet)
Seat 6: Kahmi3105 folded before Flop (didn't bet)
Seat 7: Lisenok110 folded before Flop (didn't bet)
Seat 8: La Ghir folded before Flop (didn't bet)
Seat 9: Mc57Arnold collected ($10.48)



PokerStars Hand #228686526901:  Hold'em No Limit ($0.25/$0.50 USD) - 2021/07/30 15:16:48 ET
Table 'Aitne III' 9-max Seat #3 is the button
Seat 1: whitecillar3 ($49.25 in chips) 
Seat 2: artemxxl ($55.58 in chips) 
Seat 3: pafell ($46.01 in chips) 
Seat 4: J0hnDee ($53.58 in chips) 
Seat 5: FoodPRO2012 ($83.10 in chips) 
Seat 6: Kahmi3105 ($142.53 in chips) 
Seat 7: Lisenok110 ($56.05 in chips) 
Seat 8: La Ghir ($53.50 in chips) 
Seat 9: Mc57Arnold ($58.34 in chips) 
J0hnDee: posts small blind $0.25
FoodPRO2012: posts big blind $0.50
*** HOLE CARDS ***
Kahmi3105: raises $1.25 to $1.75
Lisenok110: folds 
La Ghir: folds 
Mc57Arnold: raises $3.75 to $5.50
whitecillar3: folds 
artemxxl: folds 
pafell: folds 
J0hnDee: folds 
FoodPRO2012: folds 
Kahmi3105: calls $3.75
*** FLOP *** [Ts 7s Qd]
Kahmi3105: checks 
Mc57Arnold: bets $7.48
Kahmi3105: calls $7.48
*** TURN *** [Ts 7s Qd] [9h]
Kahmi3105: checks 
Mc57Arnold: bets $45.36 and is all-in
Kahmi3105: calls $45.36
*** RIVER *** [Ts 7s Qd 9h] [Qc]
*** SHOW DOWN ***
Kahmi3105: shows [As Qs] (three of a kind, Queens)
Mc57Arnold: shows [Kd Kh] (two pair, Kings and Queens)
Kahmi3105 collected $114.93 from pot
Mc57Arnold cashed out the hand for $77.91 | Cash Out Fee $0.79
*** SUMMARY ***
Total pot $117.43 | Rake $2.50 
Board [Ts 7s Qd 9h Qc]
Seat 1: whitecillar3 folded before Flop (didn't bet)
Seat 2: artemxxl folded before Flop (didn't bet)
Seat 3: pafell (button) folded before Flop (didn't bet)
Seat 4: J0hnDee (small blind) folded before Flop
Seat 5: FoodPRO2012 (big blind) folded before Flop
Seat 6: Kahmi3105 showed [As Qs] and won ($114.93) with three of a kind, Queens
Seat 7: Lisenok110 folded before Flop (didn't bet)
Seat 8: La Ghir folded before Flop (didn't bet)
Seat 9: Mc57Arnold showed [Kd Kh] and lost with two pair, Kings and Queens (cashed out).



PokerStars Hand #228686546568:  Hold'em No Limit ($0.25/$0.50 USD) - 2021/07/30 15:17:31 ET
Table 'Aitne III' 9-max Seat #4 is the button
Seat 1: whitecillar3 ($49.25 in chips) 
Seat 2: artemxxl ($55.58 in chips) 
Seat 3: pafell ($46.01 in chips) 
Seat 4: J0hnDee ($53.33 in chips) 
Seat 5: FoodPRO2012 ($82.60 in chips) 
Seat 6: Kahmi3105 ($199.12 in chips) 
Seat 7: Lisenok110 ($56.05 in chips) 
Seat 8: La Ghir ($53.50 in chips) 
Seat 9: Mc57Arnold ($77.91 in chips) 
FoodPRO2012: posts small blind $0.25
Kahmi3105: posts big blind $0.50
*** HOLE CARDS ***
Lisenok110: folds 
La Ghir: folds 
Mc57Arnold: folds 
whitecillar3: folds 
artemxxl: folds 
pafell: calls $0.50
J0hnDee: raises $1.12 to $1.62
FoodPRO2012: folds 
Kahmi3105: folds 
pafell: calls $1.12
*** FLOP *** [7c Jc As]
pafell: checks 
J0hnDee: bets $1.25
pafell: calls $1.25
*** TURN *** [7c Jc As] [Tc]
pafell: checks 
J0hnDee: checks 
*** RIVER *** [7c Jc As Tc] [Qs]
pafell: checks 
J0hnDee: bets $4.50
pafell: folds 
Uncalled bet ($4.50) returned to J0hnDee
J0hnDee collected $6.17 from pot
*** SUMMARY ***
Total pot $6.49 | Rake $0.32 
Board [7c Jc As Tc Qs]
Seat 1: whitecillar3 folded before Flop (didn't bet)
Seat 2: artemxxl folded before Flop (didn't bet)
Seat 3: pafell folded on the River
Seat 4: J0hnDee (button) collected ($6.17)
Seat 5: FoodPRO2012 (small blind) folded before Flop
Seat 6: Kahmi3105 (big blind) folded before Flop
Seat 7: Lisenok110 folded before Flop (didn't bet)
Seat 8: La Ghir folded before Flop (didn't bet)
Seat 9: Mc57Arnold folded before Flop (didn't bet)



PokerStars Hand #228686588676:  Hold'em No Limit ($0.25/$0.50 USD) - 2021/07/30 15:18:40 ET
Table 'Aitne III' 9-max Seat #5 is the button
Seat 1: whitecillar3 ($49.25 in chips) 
Seat 2: artemxxl ($55.58 in chips) 
Seat 3: pafell ($43.14 in chips) 
Seat 4: J0hnDee ($56.63 in chips) 
Seat 5: FoodPRO2012 ($82.35 in chips) 
Seat 6: Kahmi3105 ($198.62 in chips) 
Seat 7: Lisenok110 ($56.05 in chips) 
Seat 8: La Ghir ($53.50 in chips) 
Seat 9: Mc57Arnold ($77.91 in chips) 
Kahmi3105: posts small blind $0.25
Lisenok110: posts big blind $0.50
*** HOLE CARDS ***
La Ghir: folds 
Mc57Arnold: folds 
whitecillar3: folds 
artemxxl: folds 
pafell: calls $0.50
J0hnDee: folds 
FoodPRO2012: folds 
Kahmi3105: raises $2 to $2.50
Lisenok110: folds 
pafell: calls $2
*** FLOP *** [4c 5s 2d]
Kahmi3105: bets $4
pafell: calls $4
*** TURN *** [4c 5s 2d] [5d]
Kahmi3105: checks 
pafell: bets $6.41
Kahmi3105: folds 
Uncalled bet ($6.41) returned to pafell
pafell collected $12.82 from pot
pafell: doesn't show hand 
*** SUMMARY ***
Total pot $13.50 | Rake $0.68 
Board [4c 5s 2d 5d]
Seat 1: whitecillar3 folded before Flop (didn't bet)
Seat 2: artemxxl folded before Flop (didn't bet)
Seat 3: pafell collected ($12.82)
Seat 4: J0hnDee folded before Flop (didn't bet)
Seat 5: FoodPRO2012 (button) folded before Flop (didn't bet)
Seat 6: Kahmi3105 (small blind) folded on the Turn
Seat 7: Lisenok110 (big blind) folded before Flop
Seat 8: La Ghir folded before Flop (didn't bet)
Seat 9: Mc57Arnold folded before Flop (didn't bet)



PokerStars Hand #228686604705:  Hold'em No Limit ($0.25/$0.50 USD) - 2021/07/30 15:19:14 ET
Table 'Aitne III' 9-max Seat #6 is the button
Seat 1: whitecillar3 ($49.25 in chips) 
Seat 2: artemxxl ($55.58 in chips) 
Seat 3: pafell ($49.46 in chips) 
Seat 4: J0hnDee ($56.63 in chips) 
Seat 5: FoodPRO2012 ($82.35 in chips) 
Seat 6: Kahmi3105 ($192.12 in chips) 
Seat 7: Lisenok110 ($55.55 in chips) 
Seat 8: La Ghir ($53.50 in chips) 
Seat 9: Mc57Arnold ($77.91 in chips) 
Lisenok110: posts small blind $0.25
La Ghir: posts big blind $0.50
*** HOLE CARDS ***
Mc57Arnold: folds 
whitecillar3: raises $0.75 to $1.25
artemxxl: folds 
pafell: folds 
J0hnDee: folds 
FoodPRO2012: folds 
Kahmi3105: folds 
Lisenok110: folds 
La Ghir: folds 
Uncalled bet ($0.75) returned to whitecillar3
whitecillar3 collected $1.25 from pot
*** SUMMARY ***
Total pot $1.25 | Rake $0 
Seat 1: whitecillar3 collected ($1.25)
Seat 2: artemxxl folded before Flop (didn't bet)
Seat 3: pafell folded before Flop (didn't bet)
Seat 4: J0hnDee folded before Flop (didn't bet)
Seat 5: FoodPRO2012 folded before Flop (didn't bet)
Seat 6: Kahmi3105 (button) folded before Flop (didn't bet)
Seat 7: Lisenok110 (small blind) folded before Flop
Seat 8: La Ghir (big blind) folded before Flop
Seat 9: Mc57Arnold folded before Flop (didn't bet)



PokerStars Hand #228686610908:  Hold'em No Limit ($0.25/$0.50 USD) - 2021/07/30 15:19:28 ET
Table 'Aitne III' 9-max Seat #7 is the button
Seat 1: whitecillar3 ($50 in chips) 
Seat 2: artemxxl ($55.58 in chips) 
Seat 3: pafell ($49.46 in chips) 
Seat 4: J0hnDee ($56.63 in chips) 
Seat 5: FoodPRO2012 ($82.35 in chips) 
Seat 6: Kahmi3105 ($192.12 in chips) 
Seat 7: Lisenok110 ($55.30 in chips) 
Seat 8: La Ghir ($53 in chips) 
Seat 9: Mc57Arnold ($77.91 in chips) 
La Ghir: posts small blind $0.25
Mc57Arnold: posts big blind $0.50
*** HOLE CARDS ***
whitecillar3: folds 
artemxxl: folds 
pafell: folds 
J0hnDee: folds 
FoodPRO2012: folds 
Kahmi3105: folds 
Lisenok110: folds 
La Ghir: folds 
Uncalled bet ($0.25) returned to Mc57Arnold
Mc57Arnold collected $0.50 from pot
Mc57Arnold: doesn't show hand 
*** SUMMARY ***
Total pot $0.50 | Rake $0 
Seat 1: whitecillar3 folded before Flop (didn't bet)
Seat 2: artemxxl folded before Flop (didn't bet)
Seat 3: pafell folded before Flop (didn't bet)
Seat 4: J0hnDee folded before Flop (didn't bet)
Seat 5: FoodPRO2012 folded before Flop (didn't bet)
Seat 6: Kahmi3105 folded before Flop (didn't bet)
Seat 7: Lisenok110 (button) folded before Flop (didn't bet)
Seat 8: La Ghir (small blind) folded before Flop
Seat 9: Mc57Arnold (big blind) collected ($0.50)



PokerStars Hand #228686619390:  Hold'em No Limit ($0.25/$0.50 USD) - 2021/07/30 15:19:45 ET
Table 'Aitne III' 9-max Seat #8 is the button
Seat 1: whitecillar3 ($50 in chips) 
Seat 2: artemxxl ($55.58 in chips) 
Seat 3: pafell ($49.46 in chips) 
Seat 4: J0hnDee ($56.63 in chips) 
Seat 5: FoodPRO2012 ($82.35 in chips) 
Seat 6: Kahmi3105 ($192.12 in chips) 
Seat 7: Lisenok110 ($55.30 in chips) 
Seat 8: La Ghir ($52.75 in chips) 
Seat 9: Mc57Arnold ($78.16 in chips) 
Mc57Arnold: posts small blind $0.25
whitecillar3: posts big blind $0.50
*** HOLE CARDS ***
artemxxl: folds 
pafell: calls $0.50
J0hnDee: folds 
FoodPRO2012: calls $0.50
Kahmi3105: raises $3 to $3.50
Lisenok110: folds 
La Ghir: folds 
Mc57Arnold: folds 
whitecillar3: folds 
pafell: calls $3
FoodPRO2012: folds 
*** FLOP *** [Kc 7h 2s]
pafell: checks 
Kahmi3105: bets $7.84
J0hnDee leaves the table
pafell: folds 
Uncalled bet ($7.84) returned to Kahmi3105
Kahmi3105 collected $7.74 from pot
*** SUMMARY ***
Total pot $8.25 | Rake $0.51 
Board [Kc 7h 2s]
Seat 1: whitecillar3 (big blind) folded before Flop
Seat 2: artemxxl folded before Flop (didn't bet)
Seat 3: pafell folded on the Flop
Seat 4: J0hnDee folded before Flop (didn't bet)
Seat 5: FoodPRO2012 folded before Flop
Seat 6: Kahmi3105 collected ($7.74)
Seat 7: Lisenok110 folded before Flop (didn't bet)
Seat 8: La Ghir (button) folded before Flop (didn't bet)
Seat 9: Mc57Arnold (small blind) folded before Flop



PokerStars Hand #228686634811:  Hold'em No Limit ($0.25/$0.50 USD) - 2021/07/30 15:20:18 ET
Table 'Aitne III' 9-max Seat #9 is the button
Seat 1: whitecillar3 ($49.50 in chips) 
Seat 2: artemxxl ($55.58 in chips) 
Seat 3: pafell ($45.96 in chips) 
Seat 5: FoodPRO2012 ($81.85 in chips) 
Seat 6: Kahmi3105 ($196.36 in chips) 
Seat 7: Lisenok110 ($55.30 in chips) 
Seat 8: La Ghir ($52.75 in chips) 
Seat 9: Mc57Arnold ($77.91 in chips) 
whitecillar3: posts small blind $0.25
artemxxl: posts big blind $0.50
*** HOLE CARDS ***
pafell: folds 
FoodPRO2012: calls $0.50
Kahmi3105: folds 
Lisenok110: folds 
La Ghir: folds 
Mc57Arnold: folds 
whitecillar3: folds 
artemxxl: checks 
*** FLOP *** [Td Ac Jh]
Pachebrash joins the table at seat #4 
artemxxl: checks 
FoodPRO2012: checks 
*** TURN *** [Td Ac Jh] [5c]
artemxxl: checks 
FoodPRO2012: bets $0.50
artemxxl: folds 
Uncalled bet ($0.50) returned to FoodPRO2012
FoodPRO2012 collected $1.19 from pot
FoodPRO2012: doesn't show hand 
*** SUMMARY ***
Total pot $1.25 | Rake $0.06 
Board [Td Ac Jh 5c]
Seat 1: whitecillar3 (small blind) folded before Flop
Seat 2: artemxxl (big blind) folded on the Turn
Seat 3: pafell folded before Flop (didn't bet)
Seat 5: FoodPRO2012 collected ($1.19)
Seat 6: Kahmi3105 folded before Flop (didn't bet)
Seat 7: Lisenok110 folded before Flop (didn't bet)
Seat 8: La Ghir folded before Flop (didn't bet)
Seat 9: Mc57Arnold (button) folded before Flop (didn't bet)



PokerStars Hand #228686645909:  Hold'em No Limit ($0.25/$0.50 USD) - 2021/07/30 15:20:42 ET
Table 'Aitne III' 9-max Seat #1 is the button
Seat 1: whitecillar3 ($49.25 in chips) 
Seat 2: artemxxl ($55.08 in chips) 
Seat 3: pafell ($45.96 in chips) 
Seat 5: FoodPRO2012 ($82.54 in chips) 
Seat 6: Kahmi3105 ($196.36 in chips) 
Seat 7: Lisenok110 ($55.30 in chips) 
Seat 8: La Ghir ($52.75 in chips) 
Seat 9: Mc57Arnold ($77.91 in chips) 
artemxxl: posts small blind $0.25
pafell: posts big blind $0.50
Pachebrash: sits out 
*** HOLE CARDS ***
FoodPRO2012: folds 
Kahmi3105: folds 
Lisenok110: folds 
La Ghir: folds 
Mc57Arnold: folds 
whitecillar3: folds 
artemxxl: folds 
Uncalled bet ($0.25) returned to pafell
pafell collected $0.50 from pot
pafell: doesn't show hand 
*** SUMMARY ***
Total pot $0.50 | Rake $0 
Seat 1: whitecillar3 (button) folded before Flop (didn't bet)
Seat 2: artemxxl (small blind) folded before Flop
Seat 3: pafell (big blind) collected ($0.50)
Seat 5: FoodPRO2012 folded before Flop (didn't bet)
Seat 6: Kahmi3105 folded before Flop (didn't bet)
Seat 7: Lisenok110 folded before Flop (didn't bet)
Seat 8: La Ghir folded before Flop (didn't bet)
Seat 9: Mc57Arnold folded before Flop (didn't bet)



PokerStars Hand #228687546020:  Hold'em No Limit ($0.25/$0.50 USD) - 2021/07/30 15:52:36 ET
Table 'Aitne III' 9-max Seat #4 is the button
Seat 2: artemxxl ($76.20 in chips) 
Seat 3: pafell ($49.84 in chips) 
Seat 4: Pachebrash ($102.89 in chips) 
Seat 5: Nestle170 ($95.36 in chips) 
Seat 6: Kahmi3105 ($223.36 in chips) 
Seat 7: Lisenok110 ($51.64 in chips) 
Seat 8: Gluck35 ($59.04 in chips) 
Seat 9: Mc57Arnold ($76.36 in chips) 
Nestle170: posts small blind $0.25
Kahmi3105: posts big blind $0.50
*** HOLE CARDS ***
Lisenok110: folds 
Gluck35: folds 
Mc57Arnold: raises $0.85 to $1.35
artemxxl: folds 
pafell: folds 
Pachebrash: folds 
Nestle170: folds 
Kahmi3105: calls $0.85
*** FLOP *** [Ks 5s 6d]
Kahmi3105: checks 
Mc57Arnold: bets $0.84
Kahmi3105: calls $0.84
*** TURN *** [Ks 5s 6d] [9s]
Kahmi3105: checks 
Mc57Arnold: checks 
*** RIVER *** [Ks 5s 6d 9s] [8h]
Kahmi3105: checks 
Mc57Arnold: checks 
*** SHOW DOWN ***
Kahmi3105: shows [3c 5h] (a pair of Fives)
Mc57Arnold: mucks hand 
Kahmi3105 collected $4.34 from pot
*** SUMMARY ***
Total pot $4.63 | Rake $0.29 
Board [Ks 5s 6d 9s 8h]
Seat 2: artemxxl folded before Flop (didn't bet)
Seat 3: pafell folded before Flop (didn't bet)
Seat 4: Pachebrash (button) folded before Flop (didn't bet)
Seat 5: Nestle170 (small blind) folded before Flop
Seat 6: Kahmi3105 (big blind) showed [3c 5h] and won ($4.34) with a pair of Fives
Seat 7: Lisenok110 folded before Flop (didn't bet)
Seat 8: Gluck35 folded before Flop (didn't bet)
Seat 9: Mc57Arnold mucked



PokerStars Hand #228686651073:  Hold'em No Limit ($0.25/$0.50 USD) - 2021/07/30 15:20:53 ET
Table 'Aitne III' 9-max Seat #2 is the button
Seat 1: whitecillar3 ($49.25 in chips) 
Seat 2: artemxxl ($54.83 in chips) 
Seat 3: pafell ($46.21 in chips) 
Seat 4: Pachebrash ($105.78 in chips) 
Seat 5: FoodPRO2012 ($82.54 in chips) 
Seat 6: Kahmi3105 ($196.36 in chips) 
Seat 7: Lisenok110 ($55.30 in chips) 
Seat 8: La Ghir ($52.75 in chips) 
Seat 9: Mc57Arnold ($77.91 in chips) 
pafell: posts small blind $0.25
Pachebrash: posts big blind $0.50
*** HOLE CARDS ***
FoodPRO2012: folds 
Kahmi3105: folds 
Lisenok110: folds 
La Ghir: folds 
Mc57Arnold: folds 
whitecillar3: folds 
artemxxl: raises $0.75 to $1.25
pafell: calls $1
Pachebrash: folds 
*** FLOP *** [6c 5h Kd]
pafell: checks 
artemxxl: bets $1
pafell: folds 
Uncalled bet ($1) returned to artemxxl
artemxxl collected $2.85 from pot
*** SUMMARY ***
Total pot $3 | Rake $0.15 
Board [6c 5h Kd]
Seat 1: whitecillar3 folded before Flop (didn't bet)
Seat 2: artemxxl (button) collected ($2.85)
Seat 3: pafell (small blind) folded on the Flop
Seat 4: Pachebrash (big blind) folded before Flop
Seat 5: FoodPRO2012 folded before Flop (didn't bet)
Seat 6: Kahmi3105 folded before Flop (didn't bet)
Seat 7: Lisenok110 folded before Flop (didn't bet)
Seat 8: La Ghir folded before Flop (didn't bet)
Seat 9: Mc57Arnold folded before Flop (didn't bet)



PokerStars Hand #228686663270:  Hold'em No Limit ($0.25/$0.50 USD) - 2021/07/30 15:21:19 ET
Table 'Aitne III' 9-max Seat #3 is the button
Seat 1: whitecillar3 ($49.25 in chips) 
Seat 2: artemxxl ($56.43 in chips) 
Seat 3: pafell ($44.96 in chips) 
Seat 4: Pachebrash ($105.28 in chips) 
Seat 5: FoodPRO2012 ($82.54 in chips) 
Seat 6: Kahmi3105 ($196.36 in chips) 
Seat 7: Lisenok110 ($55.30 in chips) 
Seat 8: La Ghir ($52.75 in chips) 
Seat 9: Mc57Arnold ($77.91 in chips) 
Pachebrash: posts small blind $0.25
FoodPRO2012: posts big blind $0.50
*** HOLE CARDS ***
Kahmi3105: folds 
Lisenok110: folds 
La Ghir: folds 
Mc57Arnold: folds 
whitecillar3: folds 
artemxxl: folds 
pafell: raises $1 to $1.50
Pachebrash: folds 
FoodPRO2012: folds 
Uncalled bet ($1) returned to pafell
pafell collected $1.25 from pot
pafell: doesn't show hand 
*** SUMMARY ***
Total pot $1.25 | Rake $0 
Seat 1: whitecillar3 folded before Flop (didn't bet)
Seat 2: artemxxl folded before Flop (didn't bet)
Seat 3: pafell (button) collected ($1.25)
Seat 4: Pachebrash (small blind) folded before Flop
Seat 5: FoodPRO2012 (big blind) folded before Flop
Seat 6: Kahmi3105 folded before Flop (didn't bet)
Seat 7: Lisenok110 folded before Flop (didn't bet)
Seat 8: La Ghir folded before Flop (didn't bet)
Seat 9: Mc57Arnold folded before Flop (didn't bet)



PokerStars Hand #228686672410:  Hold'em No Limit ($0.25/$0.50 USD) - 2021/07/30 15:21:39 ET
Table 'Aitne III' 9-max Seat #4 is the button
Seat 1: whitecillar3 ($49.25 in chips) 
Seat 2: artemxxl ($56.43 in chips) 
Seat 3: pafell ($45.71 in chips) 
Seat 4: Pachebrash ($105.03 in chips) 
Seat 5: FoodPRO2012 ($82.04 in chips) 
Seat 6: Kahmi3105 ($196.36 in chips) 
Seat 7: Lisenok110 ($55.30 in chips) 
Seat 8: La Ghir ($52.75 in chips) 
Seat 9: Mc57Arnold ($77.91 in chips) 
FoodPRO2012: posts small blind $0.25
Kahmi3105: posts big blind $0.50
*** HOLE CARDS ***
Lisenok110: raises $0.75 to $1.25
La Ghir: folds 
Mc57Arnold: folds 
whitecillar3: folds 
artemxxl: folds 
pafell: folds 
Pachebrash: folds 
FoodPRO2012: folds 
Kahmi3105: calls $0.75
*** FLOP *** [6s 7c Jh]
Kahmi3105: checks 
Lisenok110: bets $0.84
Kahmi3105: calls $0.84
*** TURN *** [6s 7c Jh] [Jd]
Kahmi3105: checks 
Lisenok110: checks 
*** RIVER *** [6s 7c Jh Jd] [Kd]
Kahmi3105: checks 
Lisenok110: checks 
*** SHOW DOWN ***
Kahmi3105: shows [Ad Kc] (two pair, Kings and Jacks)
Lisenok110: mucks hand 
Kahmi3105 collected $4.15 from pot
*** SUMMARY ***
Total pot $4.43 | Rake $0.28 
Board [6s 7c Jh Jd Kd]
Seat 1: whitecillar3 folded before Flop (didn't bet)
Seat 2: artemxxl folded before Flop (didn't bet)
Seat 3: pafell folded before Flop (didn't bet)
Seat 4: Pachebrash (button) folded before Flop (didn't bet)
Seat 5: FoodPRO2012 (small blind) folded before Flop
Seat 6: Kahmi3105 (big blind) showed [Ad Kc] and won ($4.15) with two pair, Kings and Jacks
Seat 7: Lisenok110 mucked
Seat 8: La Ghir folded before Flop (didn't bet)
Seat 9: Mc57Arnold folded before Flop (didn't bet)



PokerStars Hand #228686685752:  Hold'em No Limit ($0.25/$0.50 USD) - 2021/07/30 15:22:08 ET
Table 'Aitne III' 9-max Seat #5 is the button
Seat 1: whitecillar3 ($49.25 in chips) 
Seat 2: artemxxl ($56.43 in chips) 
Seat 3: pafell ($45.71 in chips) 
Seat 4: Pachebrash ($105.03 in chips) 
Seat 5: FoodPRO2012 ($81.79 in chips) 
Seat 6: Kahmi3105 ($198.42 in chips) 
Seat 7: Lisenok110 ($53.21 in chips) 
Seat 8: La Ghir ($52.75 in chips) 
Seat 9: Mc57Arnold ($77.91 in chips) 
Kahmi3105: posts small blind $0.25
Lisenok110: posts big blind $0.50
*** HOLE CARDS ***
La Ghir: folds 
Mc57Arnold: folds 
La Ghir leaves the table
whitecillar3: folds 
artemxxl: folds 
pafell: calls $0.50
Pachebrash: folds 
FoodPRO2012: folds 
Kahmi3105: calls $0.25
Lisenok110: checks 
*** FLOP *** [4c 7c 5h]
Kahmi3105: bets $1.42
Lisenok110: calls $1.42
pafell: folds 
*** TURN *** [4c 7c 5h] [6s]
Kahmi3105: checks 
Lisenok110: bets $2.75
Kahmi3105: calls $2.75
*** RIVER *** [4c 7c 5h 6s] [Ks]
Kahmi3105: checks 
Lisenok110: checks 
*** SHOW DOWN ***
Kahmi3105: shows [6c 7h] (two pair, Sevens and Sixes)
Lisenok110: shows [2s 3s] (a straight, Three to Seven)
Lisenok110 collected $9.35 from pot
*** SUMMARY ***
Total pot $9.84 | Rake $0.49 
Board [4c 7c 5h 6s Ks]
Seat 1: whitecillar3 folded before Flop (didn't bet)
Seat 2: artemxxl folded before Flop (didn't bet)
Seat 3: pafell folded on the Flop
Seat 4: Pachebrash folded before Flop (didn't bet)
Seat 5: FoodPRO2012 (button) folded before Flop (didn't bet)
Seat 6: Kahmi3105 (small blind) showed [6c 7h] and lost with two pair, Sevens and Sixes
Seat 7: Lisenok110 (big blind) showed [2s 3s] and won ($9.35) with a straight, Three to Seven
Seat 8: La Ghir folded before Flop (didn't bet)
Seat 9: Mc57Arnold folded before Flop (didn't bet)



PokerStars Hand #228686703803:  Hold'em No Limit ($0.25/$0.50 USD) - 2021/07/30 15:22:46 ET
Table 'Aitne III' 9-max Seat #6 is the button
Seat 1: whitecillar3 ($49.25 in chips) 
Seat 2: artemxxl ($56.43 in chips) 
Seat 3: pafell ($45.21 in chips) 
Seat 4: Pachebrash ($105.03 in chips) 
Seat 5: FoodPRO2012 ($81.79 in chips) 
Seat 6: Kahmi3105 ($193.75 in chips) 
Seat 7: Lisenok110 ($57.89 in chips) 
Seat 9: Mc57Arnold ($77.91 in chips) 
Lisenok110: posts small blind $0.25
Mc57Arnold: posts big blind $0.50
*** HOLE CARDS ***
whitecillar3: folds 
artemxxl has timed out
artemxxl: folds 
pafell: folds 
Pachebrash: folds 
Gluck35 joins the table at seat #8 
FoodPRO2012: raises $0.50 to $1
Kahmi3105: raises $2.75 to $3.75
Lisenok110: folds 
Mc57Arnold: folds 
FoodPRO2012: calls $2.75
*** FLOP *** [4d Kc 8h]
FoodPRO2012: checks 
Kahmi3105: bets $4.50
FoodPRO2012: folds 
Uncalled bet ($4.50) returned to Kahmi3105
Kahmi3105 collected $7.74 from pot
*** SUMMARY ***
Total pot $8.25 | Rake $0.51 
Board [4d Kc 8h]
Seat 1: whitecillar3 folded before Flop (didn't bet)
Seat 2: artemxxl folded before Flop (didn't bet)
Seat 3: pafell folded before Flop (didn't bet)
Seat 4: Pachebrash folded before Flop (didn't bet)
Seat 5: FoodPRO2012 folded on the Flop
Seat 6: Kahmi3105 (button) collected ($7.74)
Seat 7: Lisenok110 (small blind) folded before Flop
Seat 9: Mc57Arnold (big blind) folded before Flop



PokerStars Hand #228686720686:  Hold'em No Limit ($0.25/$0.50 USD) - 2021/07/30 15:23:23 ET
Table 'Aitne III' 9-max Seat #7 is the button
Seat 1: whitecillar3 ($49.25 in chips) 
Seat 2: artemxxl ($56.43 in chips) 
Seat 3: pafell ($45.21 in chips) 
Seat 4: Pachebrash ($105.03 in chips) 
Seat 5: FoodPRO2012 ($78.04 in chips) 
Seat 6: Kahmi3105 ($197.74 in chips) 
Seat 7: Lisenok110 ($57.64 in chips) 
Seat 9: Mc57Arnold ($77.41 in chips) 
Mc57Arnold: posts small blind $0.25
whitecillar3: posts big blind $0.50
*** HOLE CARDS ***
artemxxl: folds 
pafell: calls $0.50
Pachebrash: folds 
FoodPRO2012: calls $0.50
Kahmi3105: calls $0.50
Lisenok110: folds 
Mc57Arnold: folds 
whitecillar3: checks 
*** FLOP *** [9c Ks 8s]
whitecillar3: checks 
pafell: checks 
FoodPRO2012: checks 
Kahmi3105: bets $2.14
whitecillar3: folds 
pafell: folds 
FoodPRO2012: folds 
Uncalled bet ($2.14) returned to Kahmi3105
Kahmi3105 collected $2.11 from pot
*** SUMMARY ***
Total pot $2.25 | Rake $0.14 
Board [9c Ks 8s]
Seat 1: whitecillar3 (big blind) folded on the Flop
Seat 2: artemxxl folded before Flop (didn't bet)
Seat 3: pafell folded on the Flop
Seat 4: Pachebrash folded before Flop (didn't bet)
Seat 5: FoodPRO2012 folded on the Flop
Seat 6: Kahmi3105 collected ($2.11)
Seat 7: Lisenok110 (button) folded before Flop (didn't bet)
Seat 9: Mc57Arnold (small blind) folded before Flop



PokerStars Hand #228686740489:  Hold'em No Limit ($0.25/$0.50 USD) - 2021/07/30 15:24:06 ET
Table 'Aitne III' 9-max Seat #9 is the button
Seat 1: whitecillar3 ($48.75 in chips) 
Seat 2: artemxxl ($56.43 in chips) 
Seat 3: pafell ($44.71 in chips) 
Seat 4: Pachebrash ($105.03 in chips) 
Seat 5: FoodPRO2012 ($77.54 in chips) 
Seat 6: Kahmi3105 ($199.35 in chips) 
Seat 7: Lisenok110 ($57.64 in chips) 
Seat 9: Mc57Arnold ($77.16 in chips) 
whitecillar3: posts small blind $0.25
artemxxl: posts big blind $0.50
Gluck35: sits out 
*** HOLE CARDS ***
pafell: calls $0.50
Pachebrash: folds 
FoodPRO2012: calls $0.50
Kahmi3105: calls $0.50
Lisenok110: folds 
Mc57Arnold: folds 
whitecillar3: calls $0.25
artemxxl: checks 
*** FLOP *** [Qh 3d Jh]
whitecillar3: checks 
artemxxl: checks 
pafell: checks 
FoodPRO2012: checks 
Kahmi3105: checks 
*** TURN *** [Qh 3d Jh] [Ah]
whitecillar3: checks 
artemxxl: checks 
pafell: bets $1.19
FoodPRO2012: folds 
Kahmi3105: calls $1.19
whitecillar3: folds 
artemxxl: folds 
*** RIVER *** [Qh 3d Jh Ah] [Js]
pafell: bets $2.32
Kahmi3105: calls $2.32
*** SHOW DOWN ***
pafell: shows [4d Ad] (two pair, Aces and Jacks)
Kahmi3105: shows [Td Ks] (a straight, Ten to Ace)
Kahmi3105 collected $8.92 from pot
*** SUMMARY ***
Total pot $9.52 | Rake $0.60 
Board [Qh 3d Jh Ah Js]
Seat 1: whitecillar3 (small blind) folded on the Turn
Seat 2: artemxxl (big blind) folded on the Turn
Seat 3: pafell showed [4d Ad] and lost with two pair, Aces and Jacks
Seat 4: Pachebrash folded before Flop (didn't bet)
Seat 5: FoodPRO2012 folded on the Turn
Seat 6: Kahmi3105 showed [Td Ks] and won ($8.92) with a straight, Ten to Ace
Seat 7: Lisenok110 folded before Flop (didn't bet)
Seat 9: Mc57Arnold (button) folded before Flop (didn't bet)



PokerStars Hand #228686767727:  Hold'em No Limit ($0.25/$0.50 USD) - 2021/07/30 15:25:05 ET
Table 'Aitne III' 9-max Seat #1 is the button
Seat 1: whitecillar3 ($48.25 in chips) 
Seat 2: artemxxl ($55.93 in chips) 
Seat 3: pafell ($40.70 in chips) 
Seat 4: Pachebrash ($105.03 in chips) 
Seat 5: FoodPRO2012 ($77.04 in chips) 
Seat 6: Kahmi3105 ($204.26 in chips) 
Seat 7: Lisenok110 ($57.64 in chips) 
Seat 9: Mc57Arnold ($77.16 in chips) 
artemxxl: posts small blind $0.25
pafell: posts big blind $0.50
Gluck35: sits out 
*** HOLE CARDS ***
Pachebrash: folds 
FoodPRO2012: folds 
Kahmi3105: folds 
Lisenok110: folds 
Mc57Arnold: raises $0.85 to $1.35
whitecillar3: folds 
artemxxl: folds 
pafell: calls $0.85
*** FLOP *** [Js 5c Kc]
pafell: checks 
Mc57Arnold: bets $1.88
pafell: folds 
Uncalled bet ($1.88) returned to Mc57Arnold
Mc57Arnold collected $2.80 from pot
Mc57Arnold: doesn't show hand 
*** SUMMARY ***
Total pot $2.95 | Rake $0.15 
Board [Js 5c Kc]
Seat 1: whitecillar3 (button) folded before Flop (didn't bet)
Seat 2: artemxxl (small blind) folded before Flop
Seat 3: pafell (big blind) folded on the Flop
Seat 4: Pachebrash folded before Flop (didn't bet)
Seat 5: FoodPRO2012 folded before Flop (didn't bet)
Seat 6: Kahmi3105 folded before Flop (didn't bet)
Seat 7: Lisenok110 folded before Flop (didn't bet)
Seat 9: Mc57Arnold collected ($2.80)



PokerStars Hand #228686781169:  Hold'em No Limit ($0.25/$0.50 USD) - 2021/07/30 15:25:34 ET
Table 'Aitne III' 9-max Seat #2 is the button
Seat 1: whitecillar3 ($48.25 in chips) 
Seat 2: artemxxl ($55.68 in chips) 
Seat 3: pafell ($39.35 in chips) 
Seat 4: Pachebrash ($105.03 in chips) 
Seat 5: FoodPRO2012 ($77.04 in chips) 
Seat 6: Kahmi3105 ($204.26 in chips) 
Seat 7: Lisenok110 ($57.64 in chips) 
Seat 9: Mc57Arnold ($78.61 in chips) 
pafell: posts small blind $0.25
Pachebrash: posts big blind $0.50
Gluck35: sits out 
*** HOLE CARDS ***
FoodPRO2012: calls $0.50
Kahmi3105: calls $0.50
Lisenok110: folds 
Mc57Arnold: folds 
whitecillar3: folds 
artemxxl: raises $2.75 to $3.25
pafell: folds 
Pachebrash: folds 
FoodPRO2012: calls $2.75
Kahmi3105: folds 
*** FLOP *** [Kd 8s 7d]
FoodPRO2012: checks 
artemxxl: checks 
*** TURN *** [Kd 8s 7d] [5c]
FoodPRO2012: bets $4
artemxxl: calls $4
*** RIVER *** [Kd 8s 7d 5c] [Kh]
FoodPRO2012: bets $14.96
artemxxl: calls $14.96
*** SHOW DOWN ***
FoodPRO2012: shows [Ks Ad] (three of a kind, Kings)
artemxxl: mucks hand 
FoodPRO2012 collected $43.67 from pot
*** SUMMARY ***
Total pot $45.67 | Rake $2 
Board [Kd 8s 7d 5c Kh]
Seat 1: whitecillar3 folded before Flop (didn't bet)
Seat 2: artemxxl (button) mucked
Seat 3: pafell (small blind) folded before Flop
Seat 4: Pachebrash (big blind) folded before Flop
Seat 5: FoodPRO2012 showed [Ks Ad] and won ($43.67) with three of a kind, Kings
Seat 6: Kahmi3105 folded before Flop
Seat 7: Lisenok110 folded before Flop (didn't bet)
Seat 9: Mc57Arnold folded before Flop (didn't bet)



PokerStars Hand #228686806398:  Hold'em No Limit ($0.25/$0.50 USD) - 2021/07/30 15:26:28 ET
Table 'Aitne III' 9-max Seat #3 is the button
Seat 1: whitecillar3 ($48.25 in chips) 
Seat 2: artemxxl ($50 in chips) 
Seat 3: pafell ($39.10 in chips) 
Seat 4: Pachebrash ($104.53 in chips) 
Seat 5: FoodPRO2012 ($98.50 in chips) 
Seat 6: Kahmi3105 ($203.76 in chips) 
Seat 7: Lisenok110 ($57.64 in chips) 
Seat 9: Mc57Arnold ($78.61 in chips) 
Pachebrash: posts small blind $0.25
FoodPRO2012: posts big blind $0.50
Gluck35: sits out 
*** HOLE CARDS ***
Kahmi3105: calls $0.50
Lisenok110: folds 
Mc57Arnold: raises $1.50 to $2
whitecillar3: folds 
artemxxl: folds 
pafell: calls $2
Pachebrash: folds 
FoodPRO2012: folds 
Kahmi3105: calls $1.50
*** FLOP *** [8d 7h 4h]
Kahmi3105: checks 
Mc57Arnold: bets $1.92
pafell: calls $1.92
Kahmi3105: raises $6.09 to $8.01
Mc57Arnold: folds 
pafell: folds 
Uncalled bet ($6.09) returned to Kahmi3105
Kahmi3105 collected $11.72 from pot
*** SUMMARY ***
Total pot $12.51 | Rake $0.79 
Board [8d 7h 4h]
Seat 1: whitecillar3 folded before Flop (didn't bet)
Seat 2: artemxxl folded before Flop (didn't bet)
Seat 3: pafell (button) folded on the Flop
Seat 4: Pachebrash (small blind) folded before Flop
Seat 5: FoodPRO2012 (big blind) folded before Flop
Seat 6: Kahmi3105 collected ($11.72)
Seat 7: Lisenok110 folded before Flop (didn't bet)
Seat 9: Mc57Arnold folded on the Flop



PokerStars Hand #228686826514:  Hold'em No Limit ($0.25/$0.50 USD) - 2021/07/30 15:27:12 ET
Table 'Aitne III' 9-max Seat #4 is the button
Seat 1: whitecillar3 ($48.25 in chips) 
Seat 2: artemxxl ($50 in chips) 
Seat 3: pafell ($35.18 in chips) 
Seat 4: Pachebrash ($104.28 in chips) 
Seat 5: FoodPRO2012 ($98 in chips) 
Seat 6: Kahmi3105 ($211.56 in chips) 
Seat 7: Lisenok110 ($57.64 in chips) 
Seat 9: Mc57Arnold ($74.69 in chips) 
FoodPRO2012: posts small blind $0.25
Kahmi3105: posts big blind $0.50
Gluck35: sits out 
*** HOLE CARDS ***
Lisenok110: folds 
Mc57Arnold: folds 
whitecillar3: folds 
artemxxl: folds 
pafell: folds 
Pachebrash: raises $0.70 to $1.20
FoodPRO2012: folds 
Kahmi3105: calls $0.70
*** FLOP *** [9d Jc Tc]
Kahmi3105: checks 
Pachebrash: checks 
*** TURN *** [9d Jc Tc] [4h]
Kahmi3105: checks 
Pachebrash: checks 
*** RIVER *** [9d Jc Tc 4h] [5s]
Kahmi3105: checks 
Pachebrash: checks 
*** SHOW DOWN ***
Kahmi3105: shows [As 9s] (a pair of Nines)
Pachebrash: mucks hand 
Kahmi3105 collected $2.49 from pot
*** SUMMARY ***
Total pot $2.65 | Rake $0.16 
Board [9d Jc Tc 4h 5s]
Seat 1: whitecillar3 folded before Flop (didn't bet)
Seat 2: artemxxl folded before Flop (didn't bet)
Seat 3: pafell folded before Flop (didn't bet)
Seat 4: Pachebrash (button) mucked
Seat 5: FoodPRO2012 (small blind) folded before Flop
Seat 6: Kahmi3105 (big blind) showed [As 9s] and won ($2.49) with a pair of Nines
Seat 7: Lisenok110 folded before Flop (didn't bet)
Seat 9: Mc57Arnold folded before Flop (didn't bet)



PokerStars Hand #228686841240:  Hold'em No Limit ($0.25/$0.50 USD) - 2021/07/30 15:27:44 ET
Table 'Aitne III' 9-max Seat #5 is the button
Seat 1: whitecillar3 ($48.25 in chips) 
Seat 2: artemxxl ($50 in chips) 
Seat 3: pafell ($35.18 in chips) 
Seat 4: Pachebrash ($103.08 in chips) 
Seat 5: FoodPRO2012 ($97.75 in chips) 
Seat 6: Kahmi3105 ($212.85 in chips) 
Seat 7: Lisenok110 ($57.64 in chips) 
Seat 9: Mc57Arnold ($74.69 in chips) 
Kahmi3105: posts small blind $0.25
Lisenok110: posts big blind $0.50
Gluck35: sits out 
*** HOLE CARDS ***
Mc57Arnold: raises $0.85 to $1.35
whitecillar3: folds 
artemxxl: folds 
pafell: folds 
Pachebrash: folds 
FoodPRO2012: folds 
Kahmi3105: calls $1.10
Lisenok110: folds 
*** FLOP *** [2h 3s 3c]
Kahmi3105: checks 
Mc57Arnold: bets $2.04
Kahmi3105: calls $2.04
*** TURN *** [2h 3s 3c] [9c]
Kahmi3105: checks 
Mc57Arnold: bets $4.64
Kahmi3105: folds 
Uncalled bet ($4.64) returned to Mc57Arnold
Mc57Arnold collected $6.92 from pot
Mc57Arnold: doesn't show hand 
*** SUMMARY ***
Total pot $7.28 | Rake $0.36 
Board [2h 3s 3c 9c]
Seat 1: whitecillar3 folded before Flop (didn't bet)
Seat 2: artemxxl folded before Flop (didn't bet)
Seat 3: pafell folded before Flop (didn't bet)
Seat 4: Pachebrash folded before Flop (didn't bet)
Seat 5: FoodPRO2012 (button) folded before Flop (didn't bet)
Seat 6: Kahmi3105 (small blind) folded on the Turn
Seat 7: Lisenok110 (big blind) folded before Flop
Seat 9: Mc57Arnold collected ($6.92)



PokerStars Hand #228686857715:  Hold'em No Limit ($0.25/$0.50 USD) - 2021/07/30 15:28:20 ET
Table 'Aitne III' 9-max Seat #6 is the button
Seat 1: whitecillar3 ($48.25 in chips) 
Seat 2: artemxxl ($50 in chips) 
Seat 3: pafell ($45.40 in chips) 
Seat 4: Pachebrash ($103.08 in chips) 
Seat 5: FoodPRO2012 ($97.75 in chips) 
Seat 6: Kahmi3105 ($209.46 in chips) 
Seat 7: Lisenok110 ($57.14 in chips) 
Seat 8: Gluck35 ($50 in chips) 
Seat 9: Mc57Arnold ($78.22 in chips) 
Lisenok110: posts small blind $0.25
Gluck35: posts big blind $0.50
*** HOLE CARDS ***
Mc57Arnold: raises $0.85 to $1.35
whitecillar3: folds 
artemxxl: folds 
pafell: folds 
Pachebrash: folds 
FoodPRO2012: folds 
Kahmi3105: folds 
Lisenok110: calls $1.10
Gluck35: calls $0.85
*** FLOP *** [5d 8d 6h]
Lisenok110: checks 
Gluck35: checks 
Mc57Arnold: checks 
*** TURN *** [5d 8d 6h] [Jh]
Lisenok110: bets $2.57
Gluck35: folds 
Mc57Arnold: folds 
Uncalled bet ($2.57) returned to Lisenok110
Lisenok110 collected $3.85 from pot
Lisenok110: doesn't show hand 
*** SUMMARY ***
Total pot $4.05 | Rake $0.20 
Board [5d 8d 6h Jh]
Seat 1: whitecillar3 folded before Flop (didn't bet)
Seat 2: artemxxl folded before Flop (didn't bet)
Seat 3: pafell folded before Flop (didn't bet)
Seat 4: Pachebrash folded before Flop (didn't bet)
Seat 5: FoodPRO2012 folded before Flop (didn't bet)
Seat 6: Kahmi3105 (button) folded before Flop (didn't bet)
Seat 7: Lisenok110 (small blind) collected ($3.85)
Seat 8: Gluck35 (big blind) folded on the Turn
Seat 9: Mc57Arnold folded on the Turn



PokerStars Hand #228686871016:  Hold'em No Limit ($0.25/$0.50 USD) - 2021/07/30 15:28:49 ET
Table 'Aitne III' 9-max Seat #7 is the button
Seat 1: whitecillar3 ($48.25 in chips) 
Seat 2: artemxxl ($50 in chips) 
Seat 3: pafell ($45.40 in chips) 
Seat 4: Pachebrash ($103.08 in chips) 
Seat 5: FoodPRO2012 ($97.75 in chips) 
Seat 6: Kahmi3105 ($209.46 in chips) 
Seat 7: Lisenok110 ($59.64 in chips) 
Seat 8: Gluck35 ($50 in chips) 
Seat 9: Mc57Arnold ($76.87 in chips) 
Gluck35: posts small blind $0.25
Mc57Arnold: posts big blind $0.50
*** HOLE CARDS ***
whitecillar3: folds 
artemxxl: folds 
pafell: folds 
Pachebrash: folds 
FoodPRO2012: folds 
FoodPRO2012 leaves the table
Kahmi3105: raises $1.25 to $1.75
Lisenok110: folds 
Gluck35: folds 
Mc57Arnold: folds 
Uncalled bet ($1.25) returned to Kahmi3105
Kahmi3105 collected $1.25 from pot
*** SUMMARY ***
Total pot $1.25 | Rake $0 
Seat 1: whitecillar3 folded before Flop (didn't bet)
Seat 2: artemxxl folded before Flop (didn't bet)
Seat 3: pafell folded before Flop (didn't bet)
Seat 4: Pachebrash folded before Flop (didn't bet)
Seat 5: FoodPRO2012 folded before Flop (didn't bet)
Seat 6: Kahmi3105 collected ($1.25)
Seat 7: Lisenok110 (button) folded before Flop (didn't bet)
Seat 8: Gluck35 (small blind) folded before Flop
Seat 9: Mc57Arnold (big blind) folded before Flop



PokerStars Hand #228686881287:  Hold'em No Limit ($0.25/$0.50 USD) - 2021/07/30 15:29:11 ET
Table 'Aitne III' 9-max Seat #8 is the button
Seat 1: whitecillar3 ($48.25 in chips) 
Seat 2: artemxxl ($50 in chips) 
Seat 3: pafell ($45.40 in chips) 
Seat 4: Pachebrash ($103.08 in chips) 
Seat 6: Kahmi3105 ($210.21 in chips) 
Seat 7: Lisenok110 ($59.64 in chips) 
Seat 8: Gluck35 ($50 in chips) 
Seat 9: Mc57Arnold ($76.37 in chips) 
Mc57Arnold: posts small blind $0.25
whitecillar3: posts big blind $0.50
*** HOLE CARDS ***
artemxxl: folds 
pafell: folds 
Pachebrash: folds 
Kahmi3105: raises $1 to $1.50
Lisenok110: folds 
Nestle170 joins the table at seat #5 
Gluck35: folds 
Mc57Arnold: folds 
whitecillar3: folds 
Uncalled bet ($1) returned to Kahmi3105
Kahmi3105 collected $1.25 from pot
*** SUMMARY ***
Total pot $1.25 | Rake $0 
Seat 1: whitecillar3 (big blind) folded before Flop
Seat 2: artemxxl folded before Flop (didn't bet)
Seat 3: pafell folded before Flop (didn't bet)
Seat 4: Pachebrash folded before Flop (didn't bet)
Seat 6: Kahmi3105 collected ($1.25)
Seat 7: Lisenok110 folded before Flop (didn't bet)
Seat 8: Gluck35 (button) folded before Flop (didn't bet)
Seat 9: Mc57Arnold (small blind) folded before Flop



PokerStars Hand #228686888189:  Hold'em No Limit ($0.25/$0.50 USD) - 2021/07/30 15:29:26 ET
Table 'Aitne III' 9-max Seat #9 is the button
Seat 1: whitecillar3 ($47.75 in chips) 
Seat 2: artemxxl ($50 in chips) 
Seat 3: pafell ($45.40 in chips) 
Seat 4: Pachebrash ($103.08 in chips) 
Seat 6: Kahmi3105 ($210.96 in chips) 
Seat 7: Lisenok110 ($59.64 in chips) 
Seat 8: Gluck35 ($50 in chips) 
Seat 9: Mc57Arnold ($76.12 in chips) 
whitecillar3: posts small blind $0.25
artemxxl: posts big blind $0.50
Nestle170: sits out 
*** HOLE CARDS ***
pafell: folds 
Pachebrash: folds 
Kahmi3105: folds 
Lisenok110: folds 
Gluck35: folds 
Mc57Arnold: folds 
whitecillar3: folds 
Uncalled bet ($0.25) returned to artemxxl
artemxxl collected $0.50 from pot
*** SUMMARY ***
Total pot $0.50 | Rake $0 
Seat 1: whitecillar3 (small blind) folded before Flop
Seat 2: artemxxl (big blind) collected ($0.50)
Seat 3: pafell folded before Flop (didn't bet)
Seat 4: Pachebrash folded before Flop (didn't bet)
Seat 6: Kahmi3105 folded before Flop (didn't bet)
Seat 7: Lisenok110 folded before Flop (didn't bet)
Seat 8: Gluck35 folded before Flop (didn't bet)
Seat 9: Mc57Arnold (button) folded before Flop (didn't bet)



PokerStars Hand #228686893688:  Hold'em No Limit ($0.25/$0.50 USD) - 2021/07/30 15:29:38 ET
Table 'Aitne III' 9-max Seat #1 is the button
Seat 1: whitecillar3 ($47.50 in chips) 
Seat 2: artemxxl ($50.25 in chips) 
Seat 3: pafell ($45.40 in chips) 
Seat 4: Pachebrash ($103.08 in chips) 
Seat 6: Kahmi3105 ($210.96 in chips) 
Seat 7: Lisenok110 ($59.64 in chips) 
Seat 8: Gluck35 ($50 in chips) 
Seat 9: Mc57Arnold ($76.12 in chips) 
artemxxl: posts small blind $0.25
pafell: posts big blind $0.50
Nestle170: sits out 
*** HOLE CARDS ***
Pachebrash: folds 
Kahmi3105: folds 
Lisenok110: folds 
Gluck35: folds 
Mc57Arnold: folds 
whitecillar3: folds 
artemxxl: raises $1 to $1.50
pafell: calls $1
*** FLOP *** [As 9c 7d]
artemxxl: bets $1.88
pafell: folds 
Uncalled bet ($1.88) returned to artemxxl
artemxxl collected $2.85 from pot
*** SUMMARY ***
Total pot $3 | Rake $0.15 
Board [As 9c 7d]
Seat 1: whitecillar3 (button) folded before Flop (didn't bet)
Seat 2: artemxxl (small blind) collected ($2.85)
Seat 3: pafell (big blind) folded on the Flop
Seat 4: Pachebrash folded before Flop (didn't bet)
Seat 6: Kahmi3105 folded before Flop (didn't bet)
Seat 7: Lisenok110 folded before Flop (didn't bet)
Seat 8: Gluck35 folded before Flop (didn't bet)
Seat 9: Mc57Arnold folded before Flop (didn't bet)



PokerStars Hand #228686906923:  Hold'em No Limit ($0.25/$0.50 USD) - 2021/07/30 15:30:07 ET
Table 'Aitne III' 9-max Seat #2 is the button
Seat 1: whitecillar3 ($47.50 in chips) 
Seat 2: artemxxl ($51.60 in chips) 
Seat 3: pafell ($43.90 in chips) 
Seat 4: Pachebrash ($103.08 in chips) 
Seat 6: Kahmi3105 ($210.96 in chips) 
Seat 7: Lisenok110 ($59.64 in chips) 
Seat 8: Gluck35 ($50 in chips) 
Seat 9: Mc57Arnold ($76.12 in chips) 
pafell: posts small blind $0.25
Pachebrash: posts big blind $0.50
Nestle170: sits out 
*** HOLE CARDS ***
Kahmi3105: folds 
Lisenok110: folds 
Gluck35: folds 
Mc57Arnold: folds 
whitecillar3: folds 
artemxxl: raises $0.75 to $1.25
pafell: calls $1
Pachebrash: calls $0.75
*** FLOP *** [Jc 8s Tc]
pafell: checks 
Pachebrash: checks 
artemxxl: checks 
*** TURN *** [Jc 8s Tc] [Td]
pafell: bets $1.78
Pachebrash: folds 
artemxxl: folds 
Uncalled bet ($1.78) returned to pafell
pafell collected $3.56 from pot
pafell: doesn't show hand 
*** SUMMARY ***
Total pot $3.75 | Rake $0.19 
Board [Jc 8s Tc Td]
Seat 1: whitecillar3 folded before Flop (didn't bet)
Seat 2: artemxxl (button) folded on the Turn
Seat 3: pafell (small blind) collected ($3.56)
Seat 4: Pachebrash (big blind) folded on the Turn
Seat 6: Kahmi3105 folded before Flop (didn't bet)
Seat 7: Lisenok110 folded before Flop (didn't bet)
Seat 8: Gluck35 folded before Flop (didn't bet)
Seat 9: Mc57Arnold folded before Flop (didn't bet)



PokerStars Hand #228686926737:  Hold'em No Limit ($0.25/$0.50 USD) - 2021/07/30 15:30:50 ET
Table 'Aitne III' 9-max Seat #3 is the button
Seat 1: whitecillar3 ($47.50 in chips) 
Seat 2: artemxxl ($50.35 in chips) 
Seat 3: pafell ($46.21 in chips) 
Seat 4: Pachebrash ($101.83 in chips) 
Seat 5: Nestle170 ($50 in chips) 
Seat 6: Kahmi3105 ($210.96 in chips) 
Seat 7: Lisenok110 ($59.64 in chips) 
Seat 8: Gluck35 ($50 in chips) 
Seat 9: Mc57Arnold ($76.12 in chips) 
Pachebrash: posts small blind $0.25
Nestle170: posts big blind $0.50
*** HOLE CARDS ***
Kahmi3105: folds 
Lisenok110: folds 
Gluck35: raises $0.75 to $1.25
Mc57Arnold: folds 
whitecillar3: folds 
artemxxl: folds 
pafell: calls $1.25
Pachebrash: folds 
Nestle170: raises $4.75 to $6
Gluck35: folds 
pafell: calls $4.75
*** FLOP *** [6h Qh 6d]
Nestle170: checks 
pafell: bets $12.82
Nestle170: raises $31.18 to $44 and is all-in
pafell: calls $27.39 and is all-in
Uncalled bet ($3.79) returned to Nestle170
*** TURN *** [6h Qh 6d] [8d]
*** RIVER *** [6h Qh 6d 8d] [5c]
*** SHOW DOWN ***
Nestle170: shows [Jh Jd] (two pair, Jacks and Sixes)
pafell: shows [Kh Qs] (two pair, Queens and Sixes)
pafell collected $91.92 from pot
*** SUMMARY ***
Total pot $93.92 | Rake $2 
Board [6h Qh 6d 8d 5c]
Seat 1: whitecillar3 folded before Flop (didn't bet)
Seat 2: artemxxl folded before Flop (didn't bet)
Seat 3: pafell (button) showed [Kh Qs] and won ($91.92) with two pair, Queens and Sixes
Seat 4: Pachebrash (small blind) folded before Flop
Seat 5: Nestle170 (big blind) showed [Jh Jd] and lost with two pair, Jacks and Sixes
Seat 6: Kahmi3105 folded before Flop (didn't bet)
Seat 7: Lisenok110 folded before Flop (didn't bet)
Seat 8: Gluck35 folded before Flop
Seat 9: Mc57Arnold folded before Flop (didn't bet)



PokerStars Hand #228686960342:  Hold'em No Limit ($0.25/$0.50 USD) - 2021/07/30 15:32:02 ET
Table 'Aitne III' 9-max Seat #4 is the button
Seat 1: whitecillar3 ($47.50 in chips) 
Seat 2: artemxxl ($50.35 in chips) 
Seat 3: pafell ($91.92 in chips) 
Seat 4: Pachebrash ($101.58 in chips) 
Seat 5: Nestle170 ($50 in chips) 
Seat 6: Kahmi3105 ($210.96 in chips) 
Seat 7: Lisenok110 ($59.64 in chips) 
Seat 8: Gluck35 ($50 in chips) 
Seat 9: Mc57Arnold ($76.12 in chips) 
Nestle170: posts small blind $0.25
Kahmi3105: posts big blind $0.50
*** HOLE CARDS ***
Lisenok110: folds 
Gluck35: folds 
Mc57Arnold: folds 
whitecillar3: folds 
artemxxl: folds 
pafell: folds 
Pachebrash: folds 
Nestle170: folds 
Uncalled bet ($0.25) returned to Kahmi3105
Kahmi3105 collected $0.50 from pot
*** SUMMARY ***
Total pot $0.50 | Rake $0 
Seat 1: whitecillar3 folded before Flop (didn't bet)
Seat 2: artemxxl folded before Flop (didn't bet)
Seat 3: pafell folded before Flop (didn't bet)
Seat 4: Pachebrash (button) folded before Flop (didn't bet)
Seat 5: Nestle170 (small blind) folded before Flop
Seat 6: Kahmi3105 (big blind) collected ($0.50)
Seat 7: Lisenok110 folded before Flop (didn't bet)
Seat 8: Gluck35 folded before Flop (didn't bet)
Seat 9: Mc57Arnold folded before Flop (didn't bet)



PokerStars Hand #228686966953:  Hold'em No Limit ($0.25/$0.50 USD) - 2021/07/30 15:32:16 ET
Table 'Aitne III' 9-max Seat #5 is the button
Seat 1: whitecillar3 ($47.50 in chips) 
Seat 2: artemxxl ($50.35 in chips) 
Seat 3: pafell ($91.92 in chips) 
Seat 4: Pachebrash ($101.58 in chips) 
Seat 5: Nestle170 ($50 in chips) 
Seat 6: Kahmi3105 ($211.21 in chips) 
Seat 7: Lisenok110 ($59.64 in chips) 
Seat 8: Gluck35 ($50 in chips) 
Seat 9: Mc57Arnold ($76.12 in chips) 
Kahmi3105: posts small blind $0.25
Lisenok110: posts big blind $0.50
*** HOLE CARDS ***
Gluck35: folds 
Mc57Arnold: folds 
whitecillar3: folds 
artemxxl: folds 
pafell: folds 
Pachebrash: folds 
Nestle170: raises $0.60 to $1.10
Kahmi3105: folds 
Lisenok110: folds 
Uncalled bet ($0.60) returned to Nestle170
Nestle170 collected $1.25 from pot
Nestle170: doesn't show hand 
*** SUMMARY ***
Total pot $1.25 | Rake $0 
Seat 1: whitecillar3 folded before Flop (didn't bet)
Seat 2: artemxxl folded before Flop (didn't bet)
Seat 3: pafell folded before Flop (didn't bet)
Seat 4: Pachebrash folded before Flop (didn't bet)
Seat 5: Nestle170 (button) collected ($1.25)
Seat 6: Kahmi3105 (small blind) folded before Flop
Seat 7: Lisenok110 (big blind) folded before Flop
Seat 8: Gluck35 folded before Flop (didn't bet)
Seat 9: Mc57Arnold folded before Flop (didn't bet)



PokerStars Hand #228686977234:  Hold'em No Limit ($0.25/$0.50 USD) - 2021/07/30 15:32:38 ET
Table 'Aitne III' 9-max Seat #6 is the button
Seat 2: artemxxl ($50.35 in chips) 
Seat 3: pafell ($91.92 in chips) 
Seat 4: Pachebrash ($101.58 in chips) 
Seat 5: Nestle170 ($50.75 in chips) 
Seat 6: Kahmi3105 ($210.96 in chips) 
Seat 7: Lisenok110 ($59.14 in chips) 
Seat 8: Gluck35 ($50 in chips) 
Seat 9: Mc57Arnold ($76.12 in chips) 
Lisenok110: posts small blind $0.25
Gluck35: posts big blind $0.50
*** HOLE CARDS ***
Mc57Arnold: folds 
artemxxl: raises $1 to $1.50
pafell: folds 
Pachebrash: folds 
Nestle170: raises $3 to $4.50
Kahmi3105: folds 
Lisenok110: folds 
Gluck35: folds 
artemxxl: calls $3
*** FLOP *** [4h 3c As]
artemxxl: checks 
Nestle170: checks 
*** TURN *** [4h 3c As] [2c]
artemxxl: bets $6.11
Nestle170: raises $7.09 to $13.20
artemxxl: calls $7.09
*** RIVER *** [4h 3c As 2c] [Ac]
artemxxl: bets $19
Nestle170: raises $14.05 to $33.05 and is all-in
artemxxl: calls $13.65 and is all-in
Uncalled bet ($0.40) returned to Nestle170
*** SHOW DOWN ***
Nestle170: shows [5h Ah] (a straight, Ace to Five)
artemxxl: shows [Qc Kc] (a flush, Ace high)
artemxxl collected $99.45 from pot
*** SUMMARY ***
Total pot $101.45 | Rake $2 
Board [4h 3c As 2c Ac]
Seat 2: artemxxl showed [Qc Kc] and won ($99.45) with a flush, Ace high
Seat 3: pafell folded before Flop (didn't bet)
Seat 4: Pachebrash folded before Flop (didn't bet)
Seat 5: Nestle170 showed [5h Ah] and lost with a straight, Ace to Five
Seat 6: Kahmi3105 (button) folded before Flop (didn't bet)
Seat 7: Lisenok110 (small blind) folded before Flop
Seat 8: Gluck35 (big blind) folded before Flop
Seat 9: Mc57Arnold folded before Flop (didn't bet)



PokerStars Hand #228687004262:  Hold'em No Limit ($0.25/$0.50 USD) - 2021/07/30 15:33:36 ET
Table 'Aitne III' 9-max Seat #7 is the button
Seat 2: artemxxl ($99.45 in chips) 
Seat 3: pafell ($91.92 in chips) 
Seat 4: Pachebrash ($101.58 in chips) 
Seat 5: Nestle170 ($50 in chips) 
Seat 6: Kahmi3105 ($210.96 in chips) 
Seat 7: Lisenok110 ($58.89 in chips) 
Seat 8: Gluck35 ($50 in chips) 
Seat 9: Mc57Arnold ($76.12 in chips) 
Gluck35: posts small blind $0.25
Mc57Arnold: posts big blind $0.50
*** HOLE CARDS ***
artemxxl: folds 
pafell: folds 
Pachebrash: folds 
Nestle170: folds 
Kahmi3105: raises $1.25 to $1.75
Lisenok110: raises $4.25 to $6
Gluck35: folds 
Mc57Arnold: folds 
Kahmi3105: folds 
Uncalled bet ($4.25) returned to Lisenok110
Lisenok110 collected $4.25 from pot
Lisenok110: doesn't show hand 
*** SUMMARY ***
Total pot $4.25 | Rake $0 
Seat 2: artemxxl folded before Flop (didn't bet)
Seat 3: pafell folded before Flop (didn't bet)
Seat 4: Pachebrash folded before Flop (didn't bet)
Seat 5: Nestle170 folded before Flop (didn't bet)
Seat 6: Kahmi3105 folded before Flop
Seat 7: Lisenok110 (button) collected ($4.25)
Seat 8: Gluck35 (small blind) folded before Flop
Seat 9: Mc57Arnold (big blind) folded before Flop



PokerStars Hand #228687013109:  Hold'em No Limit ($0.25/$0.50 USD) - 2021/07/30 15:33:55 ET
Table 'Aitne III' 9-max Seat #8 is the button
Seat 2: artemxxl ($99.45 in chips) 
Seat 3: pafell ($91.92 in chips) 
Seat 4: Pachebrash ($101.58 in chips) 
Seat 5: Nestle170 ($50 in chips) 
Seat 6: Kahmi3105 ($209.21 in chips) 
Seat 7: Lisenok110 ($61.39 in chips) 
Seat 8: Gluck35 ($50 in chips) 
Seat 9: Mc57Arnold ($75.62 in chips) 
Mc57Arnold: posts small blind $0.25
artemxxl: posts big blind $0.50
*** HOLE CARDS ***
pafell: folds 
Pachebrash: folds 
Nestle170: folds 
Kahmi3105: raises $1.25 to $1.75
Lisenok110: calls $1.75
Gluck35: folds 
Mc57Arnold: folds 
artemxxl: folds 
*** FLOP *** [4c Kd Ad]
Kahmi3105: bets $3
Lisenok110: folds 
Uncalled bet ($3) returned to Kahmi3105
Kahmi3105 collected $3.99 from pot
*** SUMMARY ***
Total pot $4.25 | Rake $0.26 
Board [4c Kd Ad]
Seat 2: artemxxl (big blind) folded before Flop
Seat 3: pafell folded before Flop (didn't bet)
Seat 4: Pachebrash folded before Flop (didn't bet)
Seat 5: Nestle170 folded before Flop (didn't bet)
Seat 6: Kahmi3105 collected ($3.99)
Seat 7: Lisenok110 folded on the Flop
Seat 8: Gluck35 (button) folded before Flop (didn't bet)
Seat 9: Mc57Arnold (small blind) folded before Flop



PokerStars Hand #228687022281:  Hold'em No Limit ($0.25/$0.50 USD) - 2021/07/30 15:34:15 ET
Table 'Aitne III' 9-max Seat #9 is the button
Seat 2: artemxxl ($98.95 in chips) 
Seat 3: pafell ($91.92 in chips) 
Seat 4: Pachebrash ($101.58 in chips) 
Seat 5: Nestle170 ($50 in chips) 
Seat 6: Kahmi3105 ($211.45 in chips) 
Seat 7: Lisenok110 ($59.64 in chips) 
Seat 8: Gluck35 ($50 in chips) 
Seat 9: Mc57Arnold ($75.37 in chips) 
artemxxl: posts small blind $0.25
pafell: posts big blind $0.50
*** HOLE CARDS ***
Pachebrash: folds 
Nestle170: folds 
Kahmi3105: calls $0.50
Lisenok110: calls $0.50
Gluck35: folds 
Mc57Arnold: raises $2 to $2.50
artemxxl: folds 
pafell: calls $2
Kahmi3105: calls $2
Lisenok110: calls $2
*** FLOP *** [4h 3h 7h]
whitecillar3 leaves the table
pafell: checks 
Kahmi3105: bets $9.74
Lisenok110: folds 
Mc57Arnold: folds 
pafell: folds 
Uncalled bet ($9.74) returned to Kahmi3105
Kahmi3105 collected $9.61 from pot
*** SUMMARY ***
Total pot $10.25 | Rake $0.64 
Board [4h 3h 7h]
Seat 2: artemxxl (small blind) folded before Flop
Seat 3: pafell (big blind) folded on the Flop
Seat 4: Pachebrash folded before Flop (didn't bet)
Seat 5: Nestle170 folded before Flop (didn't bet)
Seat 6: Kahmi3105 collected ($9.61)
Seat 7: Lisenok110 folded on the Flop
Seat 8: Gluck35 folded before Flop (didn't bet)
Seat 9: Mc57Arnold (button) folded on the Flop



PokerStars Hand #228687041662:  Hold'em No Limit ($0.25/$0.50 USD) - 2021/07/30 15:34:56 ET
Table 'Aitne III' 9-max Seat #2 is the button
Seat 2: artemxxl ($98.70 in chips) 
Seat 3: pafell ($89.42 in chips) 
Seat 4: Pachebrash ($101.58 in chips) 
Seat 5: Nestle170 ($50 in chips) 
Seat 6: Kahmi3105 ($218.56 in chips) 
Seat 7: Lisenok110 ($57.14 in chips) 
Seat 8: Gluck35 ($50 in chips) 
Seat 9: Mc57Arnold ($72.87 in chips) 
pafell: posts small blind $0.25
Pachebrash: posts big blind $0.50
*** HOLE CARDS ***
Nestle170: folds 
Kahmi3105: calls $0.50
Lisenok110: folds 
Gluck35: folds 
Mc57Arnold: folds 
artemxxl: raises $1 to $1.50
pafell: calls $1.25
Pachebrash: calls $1
Kahmi3105: calls $1
*** FLOP *** [4d 3s Qs]
pafell: checks 
Pachebrash: checks 
Kahmi3105: checks 
artemxxl: checks 
*** TURN *** [4d 3s Qs] [6h]
pafell: checks 
Pachebrash: checks 
Kahmi3105: bets $5.70
artemxxl: folds 
pafell: calls $5.70
Pachebrash: folds 
*** RIVER *** [4d 3s Qs 6h] [Jh]
pafell: checks 
Kahmi3105: checks 
*** SHOW DOWN ***
pafell: shows [7s Ts] (high card Queen)
Kahmi3105: shows [4h 5h] (a pair of Fours)
Kahmi3105 collected $16.31 from pot
*** SUMMARY ***
Total pot $17.40 | Rake $1.09 
Board [4d 3s Qs 6h Jh]
Seat 2: artemxxl (button) folded on the Turn
Seat 3: pafell (small blind) showed [7s Ts] and lost with high card Queen
Seat 4: Pachebrash (big blind) folded on the Turn
Seat 5: Nestle170 folded before Flop (didn't bet)
Seat 6: Kahmi3105 showed [4h 5h] and won ($16.31) with a pair of Fours
Seat 7: Lisenok110 folded before Flop (didn't bet)
Seat 8: Gluck35 folded before Flop (didn't bet)
Seat 9: Mc57Arnold folded before Flop (didn't bet)



PokerStars Hand #228687064201:  Hold'em No Limit ($0.25/$0.50 USD) - 2021/07/30 15:35:45 ET
Table 'Aitne III' 9-max Seat #3 is the button
Seat 2: artemxxl ($97.20 in chips) 
Seat 3: pafell ($82.22 in chips) 
Seat 4: Pachebrash ($100.08 in chips) 
Seat 5: Nestle170 ($50 in chips) 
Seat 6: Kahmi3105 ($227.67 in chips) 
Seat 7: Lisenok110 ($57.14 in chips) 
Seat 8: Gluck35 ($50 in chips) 
Seat 9: Mc57Arnold ($72.87 in chips) 
Pachebrash: posts small blind $0.25
Nestle170: posts big blind $0.50
*** HOLE CARDS ***
Kahmi3105: folds 
Lisenok110: folds 
Gluck35: folds 
Mc57Arnold: raises $0.85 to $1.35
artemxxl: calls $1.35
pafell: calls $1.35
Pachebrash: folds 
Nestle170: folds 
*** FLOP *** [9h 7s Ah]
Mc57Arnold: bets $1.37
artemxxl: folds 
pafell: folds 
Uncalled bet ($1.37) returned to Mc57Arnold
Mc57Arnold collected $4.56 from pot
Mc57Arnold: doesn't show hand 
*** SUMMARY ***
Total pot $4.80 | Rake $0.24 
Board [9h 7s Ah]
Seat 2: artemxxl folded on the Flop
Seat 3: pafell (button) folded on the Flop
Seat 4: Pachebrash (small blind) folded before Flop
Seat 5: Nestle170 (big blind) folded before Flop
Seat 6: Kahmi3105 folded before Flop (didn't bet)
Seat 7: Lisenok110 folded before Flop (didn't bet)
Seat 8: Gluck35 folded before Flop (didn't bet)
Seat 9: Mc57Arnold collected ($4.56)



PokerStars Hand #228687074012:  Hold'em No Limit ($0.25/$0.50 USD) - 2021/07/30 15:36:06 ET
Table 'Aitne III' 9-max Seat #4 is the button
Seat 2: artemxxl ($95.85 in chips) 
Seat 3: pafell ($80.87 in chips) 
Seat 4: Pachebrash ($99.83 in chips) 
Seat 5: Nestle170 ($50 in chips) 
Seat 6: Kahmi3105 ($227.67 in chips) 
Seat 7: Lisenok110 ($57.14 in chips) 
Seat 8: Gluck35 ($50 in chips) 
Seat 9: Mc57Arnold ($76.08 in chips) 
Nestle170: posts small blind $0.25
Kahmi3105: posts big blind $0.50
*** HOLE CARDS ***
Lisenok110: folds 
Gluck35: folds 
Mc57Arnold: raises $0.85 to $1.35
artemxxl: folds 
xandr67 joins the table at seat #1 
pafell: folds 
Pachebrash: folds 
Nestle170: folds 
Kahmi3105: folds 
Uncalled bet ($0.85) returned to Mc57Arnold
Mc57Arnold collected $1.25 from pot
Mc57Arnold: doesn't show hand 
*** SUMMARY ***
Total pot $1.25 | Rake $0 
Seat 2: artemxxl folded before Flop (didn't bet)
Seat 3: pafell folded before Flop (didn't bet)
Seat 4: Pachebrash (button) folded before Flop (didn't bet)
Seat 5: Nestle170 (small blind) folded before Flop
Seat 6: Kahmi3105 (big blind) folded before Flop
Seat 7: Lisenok110 folded before Flop (didn't bet)
Seat 8: Gluck35 folded before Flop (didn't bet)
Seat 9: Mc57Arnold collected ($1.25)



PokerStars Hand #228687080838:  Hold'em No Limit ($0.25/$0.50 USD) - 2021/07/30 15:36:20 ET
Table 'Aitne III' 9-max Seat #5 is the button
Seat 2: artemxxl ($95.85 in chips) 
Seat 3: pafell ($80.87 in chips) 
Seat 4: Pachebrash ($99.83 in chips) 
Seat 5: Nestle170 ($50 in chips) 
Seat 6: Kahmi3105 ($227.17 in chips) 
Seat 7: Lisenok110 ($57.14 in chips) 
Seat 8: Gluck35 ($50 in chips) 
Seat 9: Mc57Arnold ($76.83 in chips) 
Kahmi3105: posts small blind $0.25
Lisenok110: posts big blind $0.50
xandr67: sits out 
*** HOLE CARDS ***
Gluck35: folds 
Mc57Arnold: folds 
artemxxl: folds 
pafell: folds 
Pachebrash: folds 
Nestle170: folds 
Kahmi3105: raises $1 to $1.50
Lisenok110: calls $1
*** FLOP *** [9c 6h 4s]
Kahmi3105: checks 
Lisenok110: checks 
*** TURN *** [9c 6h 4s] [2d]
Kahmi3105: bets $2.50
Lisenok110: folds 
Uncalled bet ($2.50) returned to Kahmi3105
Kahmi3105 collected $2.81 from pot
*** SUMMARY ***
Total pot $3 | Rake $0.19 
Board [9c 6h 4s 2d]
Seat 2: artemxxl folded before Flop (didn't bet)
Seat 3: pafell folded before Flop (didn't bet)
Seat 4: Pachebrash folded before Flop (didn't bet)
Seat 5: Nestle170 (button) folded before Flop (didn't bet)
Seat 6: Kahmi3105 (small blind) collected ($2.81)
Seat 7: Lisenok110 (big blind) folded on the Turn
Seat 8: Gluck35 folded before Flop (didn't bet)
Seat 9: Mc57Arnold folded before Flop (didn't bet)



PokerStars Hand #228687092781:  Hold'em No Limit ($0.25/$0.50 USD) - 2021/07/30 15:36:46 ET
Table 'Aitne III' 9-max Seat #6 is the button
Seat 2: artemxxl ($95.85 in chips) 
Seat 3: pafell ($80.87 in chips) 
Seat 4: Pachebrash ($99.83 in chips) 
Seat 5: Nestle170 ($50 in chips) 
Seat 6: Kahmi3105 ($228.48 in chips) 
Seat 7: Lisenok110 ($55.64 in chips) 
Seat 8: Gluck35 ($50 in chips) 
Seat 9: Mc57Arnold ($76.83 in chips) 
Lisenok110: posts small blind $0.25
Gluck35: posts big blind $0.50
xandr67: sits out 
*** HOLE CARDS ***
Mc57Arnold: raises $0.85 to $1.35
artemxxl: folds 
pafell: calls $1.35
Pachebrash: folds 
Nestle170: raises $5.50 to $6.85
Kahmi3105: folds 
Lisenok110: folds 
Gluck35: folds 
Mc57Arnold: folds 
pafell: calls $5.50
*** FLOP *** [Kh Jd 8h]
pafell: checks 
Nestle170: bets $9.75
pafell: raises $34.51 to $44.26
Nestle170: calls $33.40 and is all-in
Uncalled bet ($1.11) returned to pafell
*** TURN *** [Kh Jd 8h] [3s]
*** RIVER *** [Kh Jd 8h 3s] [6s]
*** SHOW DOWN ***
pafell: shows [Jh Qh] (a pair of Jacks)
Nestle170: shows [Ac Ah] (a pair of Aces)
Nestle170 collected $100.10 from pot
*** SUMMARY ***
Total pot $102.10 | Rake $2 
Board [Kh Jd 8h 3s 6s]
Seat 2: artemxxl folded before Flop (didn't bet)
Seat 3: pafell showed [Jh Qh] and lost with a pair of Jacks
Seat 4: Pachebrash folded before Flop (didn't bet)
Seat 5: Nestle170 showed [Ac Ah] and won ($100.10) with a pair of Aces
Seat 6: Kahmi3105 (button) folded before Flop (didn't bet)
Seat 7: Lisenok110 (small blind) folded before Flop
Seat 8: Gluck35 (big blind) folded before Flop
Seat 9: Mc57Arnold folded before Flop



PokerStars Hand #228687124077:  Hold'em No Limit ($0.25/$0.50 USD) - 2021/07/30 15:37:53 ET
Table 'Aitne III' 9-max Seat #7 is the button
Seat 2: artemxxl ($95.85 in chips) 
Seat 3: pafell ($30.87 in chips) 
Seat 4: Pachebrash ($99.83 in chips) 
Seat 5: Nestle170 ($100.10 in chips) 
Seat 6: Kahmi3105 ($228.48 in chips) 
Seat 7: Lisenok110 ($55.39 in chips) 
Seat 8: Gluck35 ($50 in chips) 
Seat 9: Mc57Arnold ($75.48 in chips) 
Gluck35: posts small blind $0.25
Mc57Arnold: posts big blind $0.50
xandr67: sits out 
*** HOLE CARDS ***
artemxxl: raises $1 to $1.50
pafell: calls $1.50
Pachebrash: folds 
Nestle170: folds 
Kahmi3105: calls $1.50
Lisenok110: folds 
Gluck35: folds 
Mc57Arnold: calls $1
*** FLOP *** [3s Jd 4h]
Mc57Arnold: checks 
artemxxl: checks 
pafell: checks 
Kahmi3105: checks 
*** TURN *** [3s Jd 4h] [Ks]
Mc57Arnold: checks 
artemxxl: checks 
pafell: bets $5.94
Kahmi3105: folds 
Mc57Arnold: folds 
artemxxl: folds 
Uncalled bet ($5.94) returned to pafell
pafell collected $5.94 from pot
pafell: doesn't show hand 
*** SUMMARY ***
Total pot $6.25 | Rake $0.31 
Board [3s Jd 4h Ks]
Seat 2: artemxxl folded on the Turn
Seat 3: pafell collected ($5.94)
Seat 4: Pachebrash folded before Flop (didn't bet)
Seat 5: Nestle170 folded before Flop (didn't bet)
Seat 6: Kahmi3105 folded on the Turn
Seat 7: Lisenok110 (button) folded before Flop (didn't bet)
Seat 8: Gluck35 (small blind) folded before Flop
Seat 9: Mc57Arnold (big blind) folded on the Turn



PokerStars Hand #228687139514:  Hold'em No Limit ($0.25/$0.50 USD) - 2021/07/30 15:38:27 ET
Table 'Aitne III' 9-max Seat #8 is the button
Seat 1: xandr67 ($50 in chips) 
Seat 2: artemxxl ($94.35 in chips) 
Seat 3: pafell ($35.31 in chips) 
Seat 4: Pachebrash ($99.83 in chips) 
Seat 5: Nestle170 ($100.10 in chips) 
Seat 6: Kahmi3105 ($226.98 in chips) 
Seat 7: Lisenok110 ($55.39 in chips) 
Seat 8: Gluck35 ($50 in chips) 
Seat 9: Mc57Arnold ($73.98 in chips) 
Mc57Arnold: posts small blind $0.25
xandr67: posts big blind $0.50
*** HOLE CARDS ***
artemxxl: folds 
pafell: calls $0.50
Pachebrash: folds 
Nestle170: folds 
Kahmi3105: folds 
Lisenok110: raises $1 to $1.50
Gluck35: folds 
Mc57Arnold: folds 
xandr67: folds 
pafell: raises $5.50 to $7
Lisenok110: folds 
Uncalled bet ($5.50) returned to pafell
pafell collected $3.75 from pot
pafell: doesn't show hand 
*** SUMMARY ***
Total pot $3.75 | Rake $0 
Seat 1: xandr67 (big blind) folded before Flop
Seat 2: artemxxl folded before Flop (didn't bet)
Seat 3: pafell collected ($3.75)
Seat 4: Pachebrash folded before Flop (didn't bet)
Seat 5: Nestle170 folded before Flop (didn't bet)
Seat 6: Kahmi3105 folded before Flop (didn't bet)
Seat 7: Lisenok110 folded before Flop
Seat 8: Gluck35 (button) folded before Flop (didn't bet)
Seat 9: Mc57Arnold (small blind) folded before Flop



PokerStars Hand #228687160390:  Hold'em No Limit ($0.25/$0.50 USD) - 2021/07/30 15:39:11 ET
Table 'Aitne III' 9-max Seat #9 is the button
Seat 1: xandr67 ($50 in chips) 
Seat 2: artemxxl ($94.35 in chips) 
Seat 3: pafell ($37.56 in chips) 
Seat 4: Pachebrash ($99.83 in chips) 
Seat 5: Nestle170 ($100.10 in chips) 
Seat 6: Kahmi3105 ($226.98 in chips) 
Seat 7: Lisenok110 ($53.89 in chips) 
Seat 8: Gluck35 ($50 in chips) 
Seat 9: Mc57Arnold ($73.73 in chips) 
xandr67: posts small blind $0.25
artemxxl: posts big blind $0.50
*** HOLE CARDS ***
pafell: calls $0.50
Pachebrash: folds 
Nestle170: raises $1.50 to $2
Kahmi3105: folds 
Lisenok110: folds 
Gluck35: folds 
Mc57Arnold: folds 
xandr67: folds 
artemxxl: folds 
pafell: calls $1.50
*** FLOP *** [3h 7h 2d]
pafell: checks 
Nestle170: bets $1.50
pafell: folds 
Uncalled bet ($1.50) returned to Nestle170
Nestle170 collected $4.51 from pot
Nestle170: doesn't show hand 
*** SUMMARY ***
Total pot $4.75 | Rake $0.24 
Board [3h 7h 2d]
Seat 1: xandr67 (small blind) folded before Flop
Seat 2: artemxxl (big blind) folded before Flop
Seat 3: pafell folded on the Flop
Seat 4: Pachebrash folded before Flop (didn't bet)
Seat 5: Nestle170 collected ($4.51)
Seat 6: Kahmi3105 folded before Flop (didn't bet)
Seat 7: Lisenok110 folded before Flop (didn't bet)
Seat 8: Gluck35 folded before Flop (didn't bet)
Seat 9: Mc57Arnold (button) folded before Flop (didn't bet)



PokerStars Hand #228687178680:  Hold'em No Limit ($0.25/$0.50 USD) - 2021/07/30 15:39:51 ET
Table 'Aitne III' 9-max Seat #1 is the button
Seat 1: xandr67 ($50 in chips) 
Seat 2: artemxxl ($93.85 in chips) 
Seat 3: pafell ($35.56 in chips) 
Seat 4: Pachebrash ($99.83 in chips) 
Seat 5: Nestle170 ($102.61 in chips) 
Seat 6: Kahmi3105 ($226.98 in chips) 
Seat 7: Lisenok110 ($53.89 in chips) 
Seat 8: Gluck35 ($50 in chips) 
Seat 9: Mc57Arnold ($73.73 in chips) 
artemxxl: posts small blind $0.25
pafell: posts big blind $0.50
*** HOLE CARDS ***
Pachebrash: folds 
Nestle170: folds 
Kahmi3105: raises $1.25 to $1.75
Lisenok110: folds 
Gluck35: folds 
Mc57Arnold: folds 
xandr67: folds 
artemxxl: raises $3.50 to $5.25
pafell: folds 
Kahmi3105: calls $3.50
*** FLOP *** [Ad Kh 4s]
artemxxl: bets $3.25
Kahmi3105: calls $3.25
*** TURN *** [Ad Kh 4s] [4d]
artemxxl: checks 
Kahmi3105: checks 
*** RIVER *** [Ad Kh 4s 4d] [4c]
artemxxl: checks 
Kahmi3105: bets $16.62
artemxxl: folds 
Uncalled bet ($16.62) returned to Kahmi3105
Kahmi3105 collected $16.40 from pot
*** SUMMARY ***
Total pot $17.50 | Rake $1.10 
Board [Ad Kh 4s 4d 4c]
Seat 1: xandr67 (button) folded before Flop (didn't bet)
Seat 2: artemxxl (small blind) folded on the River
Seat 3: pafell (big blind) folded before Flop
Seat 4: Pachebrash folded before Flop (didn't bet)
Seat 5: Nestle170 folded before Flop (didn't bet)
Seat 6: Kahmi3105 collected ($16.40)
Seat 7: Lisenok110 folded before Flop (didn't bet)
Seat 8: Gluck35 folded before Flop (didn't bet)
Seat 9: Mc57Arnold folded before Flop (didn't bet)



PokerStars Hand #228687206921:  Hold'em No Limit ($0.25/$0.50 USD) - 2021/07/30 15:40:31 ET
Table 'Aitne III' 9-max Seat #2 is the button
Seat 1: xandr67 ($50 in chips) 
Seat 2: artemxxl ($85.35 in chips) 
Seat 3: pafell ($35.06 in chips) 
Seat 4: Pachebrash ($99.83 in chips) 
Seat 5: Nestle170 ($102.61 in chips) 
Seat 6: Kahmi3105 ($234.88 in chips) 
Seat 7: Lisenok110 ($53.89 in chips) 
Seat 8: Gluck35 ($50 in chips) 
Seat 9: Mc57Arnold ($73.73 in chips) 
pafell: posts small blind $0.25
Pachebrash: posts big blind $0.50
*** HOLE CARDS ***
Nestle170: folds 
Kahmi3105: folds 
Lisenok110: folds 
Gluck35: folds 
Mc57Arnold: raises $0.85 to $1.35
xandr67: folds 
artemxxl: folds 
pafell: calls $1.10
Pachebrash: folds 
*** FLOP *** [Kc 4c Ac]
pafell: checks 
Mc57Arnold: bets $2.04
pafell: folds 
Uncalled bet ($2.04) returned to Mc57Arnold
Mc57Arnold collected $3.04 from pot
Mc57Arnold: doesn't show hand 
*** SUMMARY ***
Total pot $3.20 | Rake $0.16 
Board [Kc 4c Ac]
Seat 1: xandr67 folded before Flop (didn't bet)
Seat 2: artemxxl (button) folded before Flop (didn't bet)
Seat 3: pafell (small blind) folded on the Flop
Seat 4: Pachebrash (big blind) folded before Flop
Seat 5: Nestle170 folded before Flop (didn't bet)
Seat 6: Kahmi3105 folded before Flop (didn't bet)
Seat 7: Lisenok110 folded before Flop (didn't bet)
Seat 8: Gluck35 folded before Flop (didn't bet)
Seat 9: Mc57Arnold collected ($3.04)



PokerStars Hand #228687222840:  Hold'em No Limit ($0.25/$0.50 USD) - 2021/07/30 15:41:05 ET
Table 'Aitne III' 9-max Seat #3 is the button
Seat 1: xandr67 ($50 in chips) 
Seat 2: artemxxl ($85.35 in chips) 
Seat 3: pafell ($33.71 in chips) 
Seat 4: Pachebrash ($99.33 in chips) 
Seat 5: Nestle170 ($102.61 in chips) 
Seat 6: Kahmi3105 ($234.88 in chips) 
Seat 7: Lisenok110 ($53.89 in chips) 
Seat 8: Gluck35 ($50 in chips) 
Seat 9: Mc57Arnold ($75.42 in chips) 
Pachebrash: posts small blind $0.25
Nestle170: posts big blind $0.50
*** HOLE CARDS ***
Kahmi3105: calls $0.50
Lisenok110: folds 
Gluck35: folds 
Mc57Arnold: folds 
xandr67: folds 
artemxxl: folds 
pafell: calls $0.50
Pachebrash: calls $0.25
Nestle170: checks 
*** FLOP *** [5d 3h 4d]
Pachebrash: checks 
Nestle170: bets $1.05
Kahmi3105: folds 
pafell: calls $1.05
Pachebrash: folds 
*** TURN *** [5d 3h 4d] [Qh]
Nestle170: checks 
pafell: bets $2
Nestle170: calls $2
*** RIVER *** [5d 3h 4d Qh] [Kc]
Nestle170: checks 
pafell: bets $3.85
Nestle170: folds 
Uncalled bet ($3.85) returned to pafell
pafell collected $7.70 from pot
pafell: doesn't show hand 
*** SUMMARY ***
Total pot $8.10 | Rake $0.40 
Board [5d 3h 4d Qh Kc]
Seat 1: xandr67 folded before Flop (didn't bet)
Seat 2: artemxxl folded before Flop (didn't bet)
Seat 3: pafell (button) collected ($7.70)
Seat 4: Pachebrash (small blind) folded on the Flop
Seat 5: Nestle170 (big blind) folded on the River
Seat 6: Kahmi3105 folded on the Flop
Seat 7: Lisenok110 folded before Flop (didn't bet)
Seat 8: Gluck35 folded before Flop (didn't bet)
Seat 9: Mc57Arnold folded before Flop (didn't bet)



PokerStars Hand #228687247036:  Hold'em No Limit ($0.25/$0.50 USD) - 2021/07/30 15:41:58 ET
Table 'Aitne III' 9-max Seat #4 is the button
Seat 1: xandr67 ($50 in chips) 
Seat 2: artemxxl ($85.35 in chips) 
Seat 3: pafell ($37.86 in chips) 
Seat 4: Pachebrash ($98.83 in chips) 
Seat 5: Nestle170 ($99.06 in chips) 
Seat 6: Kahmi3105 ($234.38 in chips) 
Seat 7: Lisenok110 ($53.89 in chips) 
Seat 8: Gluck35 ($50 in chips) 
Seat 9: Mc57Arnold ($75.42 in chips) 
Nestle170: posts small blind $0.25
Kahmi3105: posts big blind $0.50
*** HOLE CARDS ***
Lisenok110: folds 
Gluck35: folds 
Mc57Arnold: folds 
xandr67: raises $0.75 to $1.25
artemxxl: folds 
pafell: folds 
Pachebrash: folds 
Nestle170: folds 
Kahmi3105: calls $0.75
*** FLOP *** [6h Kc 2d]
Kahmi3105: checks 
xandr67: bets $0.86
Kahmi3105: calls $0.86
*** TURN *** [6h Kc 2d] [3c]
Kahmi3105: checks 
xandr67: checks 
*** RIVER *** [6h Kc 2d 3c] [6s]
Kahmi3105: checks 
xandr67: checks 
*** SHOW DOWN ***
Kahmi3105: shows [Kd Jd] (two pair, Kings and Sixes)
xandr67: mucks hand 
Kahmi3105 collected $4.19 from pot
*** SUMMARY ***
Total pot $4.47 | Rake $0.28 
Board [6h Kc 2d 3c 6s]
Seat 1: xandr67 mucked
Seat 2: artemxxl folded before Flop (didn't bet)
Seat 3: pafell folded before Flop (didn't bet)
Seat 4: Pachebrash (button) folded before Flop (didn't bet)
Seat 5: Nestle170 (small blind) folded before Flop
Seat 6: Kahmi3105 (big blind) showed [Kd Jd] and won ($4.19) with two pair, Kings and Sixes
Seat 7: Lisenok110 folded before Flop (didn't bet)
Seat 8: Gluck35 folded before Flop (didn't bet)
Seat 9: Mc57Arnold folded before Flop (didn't bet)



PokerStars Hand #228687276692:  Hold'em No Limit ($0.25/$0.50 USD) - 2021/07/30 15:43:02 ET
Table 'Aitne III' 9-max Seat #5 is the button
Seat 1: xandr67 ($50 in chips) 
Seat 2: artemxxl ($85.35 in chips) 
Seat 3: pafell ($37.86 in chips) 
Seat 4: Pachebrash ($98.83 in chips) 
Seat 5: Nestle170 ($98.81 in chips) 
Seat 6: Kahmi3105 ($236.46 in chips) 
Seat 7: Lisenok110 ($53.89 in chips) 
Seat 8: Gluck35 ($50 in chips) 
Seat 9: Mc57Arnold ($75.42 in chips) 
Kahmi3105: posts small blind $0.25
Lisenok110: posts big blind $0.50
*** HOLE CARDS ***
Gluck35: folds 
Mc57Arnold: folds 
xandr67: folds 
artemxxl: folds 
pafell: folds 
Pachebrash: raises $0.75 to $1.25
Nestle170: folds 
Kahmi3105: calls $1
Lisenok110: calls $0.75
*** FLOP *** [Ad 9s 3h]
Kahmi3105: checks 
Lisenok110: checks 
Pachebrash: bets $1.82
Kahmi3105: folds 
Lisenok110: folds 
Uncalled bet ($1.82) returned to Pachebrash
Pachebrash collected $3.56 from pot
Pachebrash: doesn't show hand 
*** SUMMARY ***
Total pot $3.75 | Rake $0.19 
Board [Ad 9s 3h]
Seat 1: xandr67 folded before Flop (didn't bet)
Seat 2: artemxxl folded before Flop (didn't bet)
Seat 3: pafell folded before Flop (didn't bet)
Seat 4: Pachebrash collected ($3.56)
Seat 5: Nestle170 (button) folded before Flop (didn't bet)
Seat 6: Kahmi3105 (small blind) folded on the Flop
Seat 7: Lisenok110 (big blind) folded on the Flop
Seat 8: Gluck35 folded before Flop (didn't bet)
Seat 9: Mc57Arnold folded before Flop (didn't bet)



PokerStars Hand #228687289743:  Hold'em No Limit ($0.25/$0.50 USD) - 2021/07/30 15:43:31 ET
Table 'Aitne III' 9-max Seat #6 is the button
Seat 1: xandr67 ($50 in chips) 
Seat 2: artemxxl ($85.35 in chips) 
Seat 3: pafell ($37.86 in chips) 
Seat 4: Pachebrash ($101.14 in chips) 
Seat 5: Nestle170 ($98.81 in chips) 
Seat 6: Kahmi3105 ($235.21 in chips) 
Seat 7: Lisenok110 ($52.64 in chips) 
Seat 8: Gluck35 ($50 in chips) 
Seat 9: Mc57Arnold ($75.42 in chips) 
Lisenok110: posts small blind $0.25
Gluck35: posts big blind $0.50
*** HOLE CARDS ***
Mc57Arnold: folds 
xandr67: folds 
artemxxl: folds 
pafell: folds 
Pachebrash: folds 
Nestle170: folds 
Kahmi3105: raises $1.25 to $1.75
Lisenok110: folds 
Gluck35: folds 
Uncalled bet ($1.25) returned to Kahmi3105
Kahmi3105 collected $1.25 from pot
*** SUMMARY ***
Total pot $1.25 | Rake $0 
Seat 1: xandr67 folded before Flop (didn't bet)
Seat 2: artemxxl folded before Flop (didn't bet)
Seat 3: pafell folded before Flop (didn't bet)
Seat 4: Pachebrash folded before Flop (didn't bet)
Seat 5: Nestle170 folded before Flop (didn't bet)
Seat 6: Kahmi3105 (button) collected ($1.25)
Seat 7: Lisenok110 (small blind) folded before Flop
Seat 8: Gluck35 (big blind) folded before Flop
Seat 9: Mc57Arnold folded before Flop (didn't bet)



PokerStars Hand #228687304807:  Hold'em No Limit ($0.25/$0.50 USD) - 2021/07/30 15:44:04 ET
Table 'Aitne III' 9-max Seat #7 is the button
Seat 1: xandr67 ($50 in chips) 
Seat 2: artemxxl ($85.35 in chips) 
Seat 3: pafell ($37.86 in chips) 
Seat 4: Pachebrash ($101.14 in chips) 
Seat 5: Nestle170 ($98.81 in chips) 
Seat 6: Kahmi3105 ($235.96 in chips) 
Seat 7: Lisenok110 ($52.39 in chips) 
Seat 8: Gluck35 ($50 in chips) 
Seat 9: Mc57Arnold ($75.42 in chips) 
Gluck35: posts small blind $0.25
Mc57Arnold: posts big blind $0.50
*** HOLE CARDS ***
xandr67: folds 
artemxxl: folds 
pafell: calls $0.50
Pachebrash: raises $1.50 to $2
Nestle170: folds 
Kahmi3105: folds 
Lisenok110: folds 
Gluck35: folds 
Mc57Arnold: folds 
pafell: calls $1.50
*** FLOP *** [2s 6d 8c]
pafell: checks 
Pachebrash: bets $1.53
pafell: calls $1.53
*** TURN *** [2s 6d 8c] [Ks]
pafell: checks 
Pachebrash: bets $3.78
pafell: folds 
Uncalled bet ($3.78) returned to Pachebrash
Pachebrash collected $7.42 from pot
Pachebrash: doesn't show hand 
*** SUMMARY ***
Total pot $7.81 | Rake $0.39 
Board [2s 6d 8c Ks]
Seat 1: xandr67 folded before Flop (didn't bet)
Seat 2: artemxxl folded before Flop (didn't bet)
Seat 3: pafell folded on the Turn
Seat 4: Pachebrash collected ($7.42)
Seat 5: Nestle170 folded before Flop (didn't bet)
Seat 6: Kahmi3105 folded before Flop (didn't bet)
Seat 7: Lisenok110 (button) folded before Flop (didn't bet)
Seat 8: Gluck35 (small blind) folded before Flop
Seat 9: Mc57Arnold (big blind) folded before Flop



PokerStars Hand #228687323547:  Hold'em No Limit ($0.25/$0.50 USD) - 2021/07/30 15:44:45 ET
Table 'Aitne III' 9-max Seat #8 is the button
Seat 1: xandr67 ($50 in chips) 
Seat 2: artemxxl ($85.35 in chips) 
Seat 3: pafell ($34.33 in chips) 
Seat 4: Pachebrash ($105.03 in chips) 
Seat 5: Nestle170 ($98.81 in chips) 
Seat 6: Kahmi3105 ($235.96 in chips) 
Seat 7: Lisenok110 ($52.39 in chips) 
Seat 8: Gluck35 ($50 in chips) 
Seat 9: Mc57Arnold ($74.92 in chips) 
Mc57Arnold: posts small blind $0.25
xandr67: posts big blind $0.50
*** HOLE CARDS ***
artemxxl: folds 
pafell: calls $0.50
Pachebrash: folds 
Nestle170: folds 
Kahmi3105: folds 
Lisenok110: folds 
Gluck35: folds 
Mc57Arnold: folds 
xandr67: checks 
*** FLOP *** [7h 9s 2c]
xandr67: checks 
pafell: checks 
*** TURN *** [7h 9s 2c] [Ts]
xandr67: bets $0.65
pafell: calls $0.65
*** RIVER *** [7h 9s 2c Ts] [9d]
xandr67: checks 
pafell: checks 
*** SHOW DOWN ***
xandr67: shows [Kd 7d] (two pair, Nines and Sevens)
pafell: mucks hand 
xandr67 collected $2.42 from pot
*** SUMMARY ***
Total pot $2.55 | Rake $0.13 
Board [7h 9s 2c Ts 9d]
Seat 1: xandr67 (big blind) showed [Kd 7d] and won ($2.42) with two pair, Nines and Sevens
Seat 2: artemxxl folded before Flop (didn't bet)
Seat 3: pafell mucked
Seat 4: Pachebrash folded before Flop (didn't bet)
Seat 5: Nestle170 folded before Flop (didn't bet)
Seat 6: Kahmi3105 folded before Flop (didn't bet)
Seat 7: Lisenok110 folded before Flop (didn't bet)
Seat 8: Gluck35 (button) folded before Flop (didn't bet)
Seat 9: Mc57Arnold (small blind) folded before Flop



PokerStars Hand #228687343386:  Hold'em No Limit ($0.25/$0.50 USD) - 2021/07/30 15:45:28 ET
Table 'Aitne III' 9-max Seat #9 is the button
Seat 1: xandr67 ($51.27 in chips) 
Seat 2: artemxxl ($85.35 in chips) 
Seat 3: pafell ($33.18 in chips) 
Seat 4: Pachebrash ($105.03 in chips) 
Seat 5: Nestle170 ($98.81 in chips) 
Seat 6: Kahmi3105 ($235.96 in chips) 
Seat 7: Lisenok110 ($52.39 in chips) 
Seat 8: Gluck35 ($50 in chips) 
Seat 9: Mc57Arnold ($74.67 in chips) 
xandr67: posts small blind $0.25
artemxxl: posts big blind $0.50
*** HOLE CARDS ***
pafell: calls $0.50
Pachebrash: raises $1.50 to $2
Nestle170: folds 
Kahmi3105: raises $5.25 to $7.25
Lisenok110: folds 
Gluck35: folds 
Mc57Arnold: folds 
xandr67: folds 
artemxxl: folds 
pafell: calls $6.75
Pachebrash: folds 
*** FLOP *** [6h 9h 8d]
pafell: checks 
Kahmi3105: checks 
*** TURN *** [6h 9h 8d] [7c]
pafell: bets $8.19
Kahmi3105: folds 
Uncalled bet ($8.19) returned to pafell
pafell collected $16.39 from pot
pafell: doesn't show hand 
*** SUMMARY ***
Total pot $17.25 | Rake $0.86 
Board [6h 9h 8d 7c]
Seat 1: xandr67 (small blind) folded before Flop
Seat 2: artemxxl (big blind) folded before Flop
Seat 3: pafell collected ($16.39)
Seat 4: Pachebrash folded before Flop
Seat 5: Nestle170 folded before Flop (didn't bet)
Seat 6: Kahmi3105 folded on the Turn
Seat 7: Lisenok110 folded before Flop (didn't bet)
Seat 8: Gluck35 folded before Flop (didn't bet)
Seat 9: Mc57Arnold (button) folded before Flop (didn't bet)



PokerStars Hand #228687372116:  Hold'em No Limit ($0.25/$0.50 USD) - 2021/07/30 15:46:17 ET
Table 'Aitne III' 9-max Seat #1 is the button
Seat 1: xandr67 ($51.02 in chips) 
Seat 2: artemxxl ($84.85 in chips) 
Seat 3: pafell ($42.32 in chips) 
Seat 4: Pachebrash ($103.03 in chips) 
Seat 5: Nestle170 ($98.81 in chips) 
Seat 6: Kahmi3105 ($228.71 in chips) 
Seat 7: Lisenok110 ($52.39 in chips) 
Seat 8: Gluck35 ($50 in chips) 
Seat 9: Mc57Arnold ($74.67 in chips) 
artemxxl: posts small blind $0.25
pafell: posts big blind $0.50
*** HOLE CARDS ***
Pachebrash: folds 
Nestle170: folds 
Kahmi3105: raises $1.25 to $1.75
Lisenok110: folds 
Gluck35: folds 
Mc57Arnold: folds 
xandr67: folds 
artemxxl: folds 
pafell: calls $1.25
*** FLOP *** [Tc As 9d]
pafell: checks 
Kahmi3105: bets $3.56
pafell: calls $3.56
*** TURN *** [Tc As 9d] [4h]
pafell: checks 
Kahmi3105: bets $6.50
pafell: calls $6.50
*** RIVER *** [Tc As 9d 4h] [Kd]
pafell: checks 
Kahmi3105: checks 
*** SHOW DOWN ***
pafell: shows [Ah 6d] (a pair of Aces)
Kahmi3105: mucks hand 
pafell collected $22.68 from pot
*** SUMMARY ***
Total pot $23.87 | Rake $1.19 
Board [Tc As 9d 4h Kd]
Seat 1: xandr67 (button) folded before Flop (didn't bet)
Seat 2: artemxxl (small blind) folded before Flop
Seat 3: pafell (big blind) showed [Ah 6d] and won ($22.68) with a pair of Aces
Seat 4: Pachebrash folded before Flop (didn't bet)
Seat 5: Nestle170 folded before Flop (didn't bet)
Seat 6: Kahmi3105 mucked
Seat 7: Lisenok110 folded before Flop (didn't bet)
Seat 8: Gluck35 folded before Flop (didn't bet)
Seat 9: Mc57Arnold folded before Flop (didn't bet)



PokerStars Hand #228687391430:  Hold'em No Limit ($0.25/$0.50 USD) - 2021/07/30 15:46:59 ET
Table 'Aitne III' 9-max Seat #2 is the button
Seat 1: xandr67 ($51.02 in chips) 
Seat 2: artemxxl ($84.60 in chips) 
Seat 3: pafell ($53.19 in chips) 
Seat 4: Pachebrash ($103.03 in chips) 
Seat 5: Nestle170 ($98.81 in chips) 
Seat 6: Kahmi3105 ($216.90 in chips) 
Seat 7: Lisenok110 ($52.39 in chips) 
Seat 8: Gluck35 ($50 in chips) 
Seat 9: Mc57Arnold ($74.67 in chips) 
pafell: posts small blind $0.25
Pachebrash: posts big blind $0.50
*** HOLE CARDS ***
Nestle170: folds 
Kahmi3105: folds 
Lisenok110: folds 
Gluck35: folds 
Mc57Arnold: raises $0.85 to $1.35
xandr67: folds 
artemxxl: folds 
pafell: calls $1.10
Pachebrash: folds 
*** FLOP *** [Qd 4h Tc]
pafell: checks 
Mc57Arnold: bets $1.52
pafell: folds 
Uncalled bet ($1.52) returned to Mc57Arnold
Mc57Arnold collected $3.04 from pot
Mc57Arnold: doesn't show hand 
*** SUMMARY ***
Total pot $3.20 | Rake $0.16 
Board [Qd 4h Tc]
Seat 1: xandr67 folded before Flop (didn't bet)
Seat 2: artemxxl (button) folded before Flop (didn't bet)
Seat 3: pafell (small blind) folded on the Flop
Seat 4: Pachebrash (big blind) folded before Flop
Seat 5: Nestle170 folded before Flop (didn't bet)
Seat 6: Kahmi3105 folded before Flop (didn't bet)
Seat 7: Lisenok110 folded before Flop (didn't bet)
Seat 8: Gluck35 folded before Flop (didn't bet)
Seat 9: Mc57Arnold collected ($3.04)



PokerStars Hand #228687406437:  Hold'em No Limit ($0.25/$0.50 USD) - 2021/07/30 15:47:31 ET
Table 'Aitne III' 9-max Seat #3 is the button
Seat 1: xandr67 ($51.02 in chips) 
Seat 2: artemxxl ($84.60 in chips) 
Seat 3: pafell ($51.84 in chips) 
Seat 4: Pachebrash ($102.53 in chips) 
Seat 5: Nestle170 ($98.81 in chips) 
Seat 6: Kahmi3105 ($216.90 in chips) 
Seat 7: Lisenok110 ($52.39 in chips) 
Seat 8: Gluck35 ($50 in chips) 
Seat 9: Mc57Arnold ($76.36 in chips) 
Pachebrash: posts small blind $0.25
Nestle170: posts big blind $0.50
*** HOLE CARDS ***
Kahmi3105: folds 
Lisenok110: raises $0.75 to $1.25
Gluck35: folds 
Mc57Arnold: folds 
xandr67: folds 
artemxxl: folds 
pafell: folds 
Pachebrash: folds 
Nestle170: folds 
Uncalled bet ($0.75) returned to Lisenok110
Lisenok110 collected $1.25 from pot
Lisenok110: doesn't show hand 
*** SUMMARY ***
Total pot $1.25 | Rake $0 
Seat 1: xandr67 folded before Flop (didn't bet)
Seat 2: artemxxl folded before Flop (didn't bet)
Seat 3: pafell (button) folded before Flop (didn't bet)
Seat 4: Pachebrash (small blind) folded before Flop
Seat 5: Nestle170 (big blind) folded before Flop
Seat 6: Kahmi3105 folded before Flop (didn't bet)
Seat 7: Lisenok110 collected ($1.25)
Seat 8: Gluck35 folded before Flop (didn't bet)
Seat 9: Mc57Arnold folded before Flop (didn't bet)



PokerStars Hand #228687417028:  Hold'em No Limit ($0.25/$0.50 USD) - 2021/07/30 15:47:54 ET
Table 'Aitne III' 9-max Seat #4 is the button
Seat 1: xandr67 ($51.02 in chips) 
Seat 2: artemxxl ($84.60 in chips) 
Seat 3: pafell ($51.84 in chips) 
Seat 4: Pachebrash ($102.28 in chips) 
Seat 5: Nestle170 ($98.31 in chips) 
Seat 6: Kahmi3105 ($216.90 in chips) 
Seat 7: Lisenok110 ($53.14 in chips) 
Seat 8: Gluck35 ($50 in chips) 
Seat 9: Mc57Arnold ($76.36 in chips) 
Nestle170: posts small blind $0.25
Kahmi3105: posts big blind $0.50
*** HOLE CARDS ***
Lisenok110: folds 
Gluck35: folds 
Mc57Arnold: folds 
xandr67: raises $0.75 to $1.25
artemxxl: calls $1.25
pafell: folds 
Pachebrash: folds 
Nestle170: folds 
Kahmi3105: calls $0.75
*** FLOP *** [5d 5h 6c]
Kahmi3105: checks 
xandr67: checks 
artemxxl: bets $1.90
Kahmi3105: calls $1.90
xandr67: folds 
*** TURN *** [5d 5h 6c] [3d]
Kahmi3105: checks 
artemxxl: checks 
*** RIVER *** [5d 5h 6c 3d] [4c]
Kahmi3105: checks 
artemxxl: checks 
*** SHOW DOWN ***
Kahmi3105: shows [Qc 5c] (three of a kind, Fives)
artemxxl: mucks hand 
Kahmi3105 collected $7.31 from pot
*** SUMMARY ***
Total pot $7.80 | Rake $0.49 
Board [5d 5h 6c 3d 4c]
Seat 1: xandr67 folded on the Flop
Seat 2: artemxxl mucked
Seat 3: pafell folded before Flop (didn't bet)
Seat 4: Pachebrash (button) folded before Flop (didn't bet)
Seat 5: Nestle170 (small blind) folded before Flop
Seat 6: Kahmi3105 (big blind) showed [Qc 5c] and won ($7.31) with three of a kind, Fives
Seat 7: Lisenok110 folded before Flop (didn't bet)
Seat 8: Gluck35 folded before Flop (didn't bet)
Seat 9: Mc57Arnold folded before Flop (didn't bet)



PokerStars Hand #228687439263:  Hold'em No Limit ($0.25/$0.50 USD) - 2021/07/30 15:48:43 ET
Table 'Aitne III' 9-max Seat #5 is the button
Seat 1: xandr67 ($50 in chips) 
Seat 2: artemxxl ($81.45 in chips) 
Seat 3: pafell ($51.84 in chips) 
Seat 4: Pachebrash ($102.28 in chips) 
Seat 5: Nestle170 ($98.06 in chips) 
Seat 6: Kahmi3105 ($221.06 in chips) 
Seat 7: Lisenok110 ($53.14 in chips) 
Seat 8: Gluck35 ($50 in chips) 
Seat 9: Mc57Arnold ($76.36 in chips) 
Kahmi3105: posts small blind $0.25
Lisenok110: posts big blind $0.50
*** HOLE CARDS ***
Gluck35: folds 
Mc57Arnold: folds 
xandr67: folds 
artemxxl: folds 
pafell: folds 
Pachebrash: raises $0.75 to $1.25
Nestle170: folds 
Kahmi3105: folds 
Lisenok110: calls $0.75
*** FLOP *** [As Qh Ah]
Lisenok110: checks 
Pachebrash: bets $0.89
Lisenok110: folds 
Uncalled bet ($0.89) returned to Pachebrash
Pachebrash collected $2.61 from pot
Pachebrash: doesn't show hand 
*** SUMMARY ***
Total pot $2.75 | Rake $0.14 
Board [As Qh Ah]
Seat 1: xandr67 folded before Flop (didn't bet)
Seat 2: artemxxl folded before Flop (didn't bet)
Seat 3: pafell folded before Flop (didn't bet)
Seat 4: Pachebrash collected ($2.61)
Seat 5: Nestle170 (button) folded before Flop (didn't bet)
Seat 6: Kahmi3105 (small blind) folded before Flop
Seat 7: Lisenok110 (big blind) folded on the Flop
Seat 8: Gluck35 folded before Flop (didn't bet)
Seat 9: Mc57Arnold folded before Flop (didn't bet)



PokerStars Hand #228687450109:  Hold'em No Limit ($0.25/$0.50 USD) - 2021/07/30 15:49:06 ET
Table 'Aitne III' 9-max Seat #6 is the button
Seat 1: xandr67 ($50 in chips) 
Seat 2: artemxxl ($81.45 in chips) 
Seat 3: pafell ($51.84 in chips) 
Seat 4: Pachebrash ($103.64 in chips) 
Seat 5: Nestle170 ($98.06 in chips) 
Seat 6: Kahmi3105 ($220.81 in chips) 
Seat 7: Lisenok110 ($51.89 in chips) 
Seat 8: Gluck35 ($50 in chips) 
Seat 9: Mc57Arnold ($76.36 in chips) 
Lisenok110: posts small blind $0.25
Gluck35: posts big blind $0.50
*** HOLE CARDS ***
Mc57Arnold: folds 
xandr67: raises $0.75 to $1.25
artemxxl: folds 
pafell: folds 
Pachebrash: folds 
Nestle170: folds 
Kahmi3105: raises $4.25 to $5.50
Lisenok110: folds 
Gluck35: folds 
xandr67: folds 
Uncalled bet ($4.25) returned to Kahmi3105
Kahmi3105 collected $3.25 from pot
*** SUMMARY ***
Total pot $3.25 | Rake $0 
Seat 1: xandr67 folded before Flop
Seat 2: artemxxl folded before Flop (didn't bet)
Seat 3: pafell folded before Flop (didn't bet)
Seat 4: Pachebrash folded before Flop (didn't bet)
Seat 5: Nestle170 folded before Flop (didn't bet)
Seat 6: Kahmi3105 (button) collected ($3.25)
Seat 7: Lisenok110 (small blind) folded before Flop
Seat 8: Gluck35 (big blind) folded before Flop
Seat 9: Mc57Arnold folded before Flop (didn't bet)



PokerStars Hand #228687458440:  Hold'em No Limit ($0.25/$0.50 USD) - 2021/07/30 15:49:24 ET
Table 'Aitne III' 9-max Seat #7 is the button
Seat 1: xandr67 ($50 in chips) 
Seat 2: artemxxl ($81.45 in chips) 
Seat 3: pafell ($51.84 in chips) 
Seat 4: Pachebrash ($103.64 in chips) 
Seat 5: Nestle170 ($98.06 in chips) 
Seat 6: Kahmi3105 ($222.81 in chips) 
Seat 7: Lisenok110 ($51.64 in chips) 
Seat 8: Gluck35 ($50 in chips) 
Seat 9: Mc57Arnold ($76.36 in chips) 
Gluck35: posts small blind $0.25
Mc57Arnold: posts big blind $0.50
*** HOLE CARDS ***
xandr67: folds 
artemxxl: folds 
pafell: folds 
Pachebrash: folds 
Nestle170: raises $0.75 to $1.25
xandr67 leaves the table
Kahmi3105: calls $1.25
Lisenok110: folds 
Unsimple joins the table at seat #1 
Gluck35: folds 
Mc57Arnold: folds 
*** FLOP *** [9c 2c 5s]
Nestle170: bets $1.70
Kahmi3105: calls $1.70
*** TURN *** [9c 2c 5s] [2h]
Nestle170: checks 
Kahmi3105: checks 
*** RIVER *** [9c 2c 5s 2h] [Kd]
Nestle170: checks 
Kahmi3105: bets $6.32
Nestle170: folds 
Uncalled bet ($6.32) returned to Kahmi3105
Kahmi3105 collected $6.24 from pot
*** SUMMARY ***
Total pot $6.65 | Rake $0.41 
Board [9c 2c 5s 2h Kd]
Seat 1: xandr67 folded before Flop (didn't bet)
Seat 2: artemxxl folded before Flop (didn't bet)
Seat 3: pafell folded before Flop (didn't bet)
Seat 4: Pachebrash folded before Flop (didn't bet)
Seat 5: Nestle170 folded on the River
Seat 6: Kahmi3105 collected ($6.24)
Seat 7: Lisenok110 (button) folded before Flop (didn't bet)
Seat 8: Gluck35 (small blind) folded before Flop
Seat 9: Mc57Arnold (big blind) folded before Flop



PokerStars Hand #228687491025:  Hold'em No Limit ($0.25/$0.50 USD) - 2021/07/30 15:50:36 ET
Table 'Aitne III' 9-max Seat #8 is the button
Seat 2: artemxxl ($81.45 in chips) 
Seat 3: pafell ($51.84 in chips) 
Seat 4: Pachebrash ($103.64 in chips) 
Seat 5: Nestle170 ($95.11 in chips) 
Seat 6: Kahmi3105 ($226.10 in chips) 
Seat 7: Lisenok110 ($51.64 in chips) 
Seat 8: Gluck35 ($50 in chips) 
Seat 9: Mc57Arnold ($75.86 in chips) 
Mc57Arnold: posts small blind $0.25
artemxxl: posts big blind $0.50
*** HOLE CARDS ***
pafell: folds 
Pachebrash: folds 
Nestle170: folds 
Kahmi3105: folds 
Lisenok110: folds 
Gluck35: folds 
Mc57Arnold: raises $1 to $1.50
artemxxl: folds 
Uncalled bet ($1) returned to Mc57Arnold
Mc57Arnold collected $1 from pot
Mc57Arnold: doesn't show hand 
*** SUMMARY ***
Total pot $1 | Rake $0 
Seat 2: artemxxl (big blind) folded before Flop
Seat 3: pafell folded before Flop (didn't bet)
Seat 4: Pachebrash folded before Flop (didn't bet)
Seat 5: Nestle170 folded before Flop (didn't bet)
Seat 6: Kahmi3105 folded before Flop (didn't bet)
Seat 7: Lisenok110 folded before Flop (didn't bet)
Seat 8: Gluck35 (button) folded before Flop (didn't bet)
Seat 9: Mc57Arnold (small blind) collected ($1)



PokerStars Hand #228687498018:  Hold'em No Limit ($0.25/$0.50 USD) - 2021/07/30 15:50:51 ET
Table 'Aitne III' 9-max Seat #9 is the button
Seat 2: artemxxl ($80.95 in chips) 
Seat 3: pafell ($51.84 in chips) 
Seat 4: Pachebrash ($103.64 in chips) 
Seat 5: Nestle170 ($95.11 in chips) 
Seat 6: Kahmi3105 ($226.10 in chips) 
Seat 7: Lisenok110 ($51.64 in chips) 
Seat 8: Gluck35 ($50 in chips) 
Seat 9: Mc57Arnold ($76.36 in chips) 
artemxxl: posts small blind $0.25
pafell: posts big blind $0.50
*** HOLE CARDS ***
Pachebrash: folds 
Nestle170: folds 
Kahmi3105: raises $1.25 to $1.75
Lisenok110: folds 
Gluck35: folds 
Mc57Arnold: folds 
artemxxl: folds 
pafell: calls $1.25
*** FLOP *** [Td 7s 4c]
pafell: checks 
Kahmi3105: checks 
*** TURN *** [Td 7s 4c] [6c]
pafell: checks 
Kahmi3105: checks 
*** RIVER *** [Td 7s 4c 6c] [Ts]
pafell: checks 
Kahmi3105: checks 
*** SHOW DOWN ***
pafell: shows [Kh 5d] (a pair of Tens)
Kahmi3105: shows [Kc Qc] (a pair of Tens - King+Queen kicker)
Kahmi3105 collected $3.51 from pot
*** SUMMARY ***
Total pot $3.75 | Rake $0.24 
Board [Td 7s 4c 6c Ts]
Seat 2: artemxxl (small blind) folded before Flop
Seat 3: pafell (big blind) showed [Kh 5d] and lost with a pair of Tens
Seat 4: Pachebrash folded before Flop (didn't bet)
Seat 5: Nestle170 folded before Flop (didn't bet)
Seat 6: Kahmi3105 showed [Kc Qc] and won ($3.51) with a pair of Tens
Seat 7: Lisenok110 folded before Flop (didn't bet)
Seat 8: Gluck35 folded before Flop (didn't bet)
Seat 9: Mc57Arnold (button) folded before Flop (didn't bet)



PokerStars Hand #228687515361:  Hold'em No Limit ($0.25/$0.50 USD) - 2021/07/30 15:51:29 ET
Table 'Aitne III' 9-max Seat #2 is the button
Seat 2: artemxxl ($80.70 in chips) 
Seat 3: pafell ($50.09 in chips) 
Seat 4: Pachebrash ($103.64 in chips) 
Seat 5: Nestle170 ($95.11 in chips) 
Seat 6: Kahmi3105 ($227.86 in chips) 
Seat 7: Lisenok110 ($51.64 in chips) 
Seat 8: Gluck35 ($50 in chips) 
Seat 9: Mc57Arnold ($76.36 in chips) 
pafell: posts small blind $0.25
Pachebrash: posts big blind $0.50
*** HOLE CARDS ***
Nestle170: folds 
Kahmi3105: raises $1.25 to $1.75
Lisenok110: folds 
Gluck35: raises $2.75 to $4.50
Mc57Arnold: folds 
artemxxl: calls $4.50
pafell: folds 
Pachebrash: folds 
Kahmi3105: calls $2.75
*** FLOP *** [2h Qs Td]
Kahmi3105: checks 
Gluck35: bets $4.47
artemxxl: folds 
Kahmi3105: folds 
Uncalled bet ($4.47) returned to Gluck35
Gluck35 collected $13.54 from pot
Gluck35: doesn't show hand 
*** SUMMARY ***
Total pot $14.25 | Rake $0.71 
Board [2h Qs Td]
Seat 2: artemxxl (button) folded on the Flop
Seat 3: pafell (small blind) folded before Flop
Seat 4: Pachebrash (big blind) folded before Flop
Seat 5: Nestle170 folded before Flop (didn't bet)
Seat 6: Kahmi3105 folded on the Flop
Seat 7: Lisenok110 folded before Flop (didn't bet)
Seat 8: Gluck35 collected ($13.54)
Seat 9: Mc57Arnold folded before Flop (didn't bet)



PokerStars Hand #228687538047:  Hold'em No Limit ($0.25/$0.50 USD) - 2021/07/30 15:52:18 ET
Table 'Aitne III' 9-max Seat #3 is the button
Seat 2: artemxxl ($76.20 in chips) 
Seat 3: pafell ($49.84 in chips) 
Seat 4: Pachebrash ($103.14 in chips) 
Seat 5: Nestle170 ($95.11 in chips) 
Seat 6: Kahmi3105 ($223.36 in chips) 
Seat 7: Lisenok110 ($51.64 in chips) 
Seat 8: Gluck35 ($59.04 in chips) 
Seat 9: Mc57Arnold ($76.36 in chips) 
Pachebrash: posts small blind $0.25
Nestle170: posts big blind $0.50
*** HOLE CARDS ***
Kahmi3105: folds 
Lisenok110: folds 
Gluck35: folds 
Mc57Arnold: folds 
artemxxl: folds 
pafell: folds 
Pachebrash: folds 
Uncalled bet ($0.25) returned to Nestle170
Nestle170 collected $0.50 from pot
Nestle170: doesn't show hand 
*** SUMMARY ***
Total pot $0.50 | Rake $0 
Seat 2: artemxxl folded before Flop (didn't bet)
Seat 3: pafell (button) folded before Flop (didn't bet)
Seat 4: Pachebrash (small blind) folded before Flop
Seat 5: Nestle170 (big blind) collected ($0.50)
Seat 6: Kahmi3105 folded before Flop (didn't bet)
Seat 7: Lisenok110 folded before Flop (didn't bet)
Seat 8: Gluck35 folded before Flop (didn't bet)
Seat 9: Mc57Arnold folded before Flop (didn't bet)



PokerStars Hand #228687560664:  Hold'em No Limit ($0.25/$0.50 USD) - 2021/07/30 15:53:08 ET
Table 'Aitne III' 9-max Seat #5 is the button
Seat 2: artemxxl ($76.20 in chips) 
Seat 3: pafell ($49.84 in chips) 
Seat 4: Pachebrash ($102.89 in chips) 
Seat 5: Nestle170 ($95.11 in chips) 
Seat 6: Kahmi3105 ($225.51 in chips) 
Seat 7: Lisenok110 ($51.64 in chips) 
Seat 8: Gluck35 ($59.04 in chips) 
Seat 9: Mc57Arnold ($74.17 in chips) 
Kahmi3105: posts small blind $0.25
Lisenok110: posts big blind $0.50
*** HOLE CARDS ***
Gluck35: folds 
Mc57Arnold: folds 
artemxxl: folds 
pafell: folds 
Pachebrash: raises $0.75 to $1.25
Nestle170: folds 
Kahmi3105: folds 
Lisenok110: calls $0.75
*** FLOP *** [7h 4h As]
Lisenok110: checks 
Pachebrash: bets $1.72
Lisenok110: folds 
Uncalled bet ($1.72) returned to Pachebrash
Pachebrash collected $2.61 from pot
Pachebrash: doesn't show hand 
*** SUMMARY ***
Total pot $2.75 | Rake $0.14 
Board [7h 4h As]
Seat 2: artemxxl folded before Flop (didn't bet)
Seat 3: pafell folded before Flop (didn't bet)
Seat 4: Pachebrash collected ($2.61)
Seat 5: Nestle170 (button) folded before Flop (didn't bet)
Seat 6: Kahmi3105 (small blind) folded before Flop
Seat 7: Lisenok110 (big blind) folded on the Flop
Seat 8: Gluck35 folded before Flop (didn't bet)
Seat 9: Mc57Arnold folded before Flop (didn't bet)



PokerStars Hand #228687571284:  Hold'em No Limit ($0.25/$0.50 USD) - 2021/07/30 15:53:31 ET
Table 'Aitne III' 9-max Seat #6 is the button
Seat 2: artemxxl ($76.20 in chips) 
Seat 3: pafell ($49.84 in chips) 
Seat 4: Pachebrash ($104.25 in chips) 
Seat 5: Nestle170 ($95.11 in chips) 
Seat 6: Kahmi3105 ($225.26 in chips) 
Seat 7: Lisenok110 ($50.39 in chips) 
Seat 8: Gluck35 ($59.04 in chips) 
Seat 9: Mc57Arnold ($74.17 in chips) 
Lisenok110: posts small blind $0.25
Gluck35: posts big blind $0.50
*** HOLE CARDS ***
Mc57Arnold: folds 
artemxxl: folds 
pafell: folds 
Pachebrash: raises $1 to $1.50
Nestle170: folds 
Kahmi3105: folds 
Lisenok110: folds 
Gluck35: folds 
Uncalled bet ($1) returned to Pachebrash
Pachebrash collected $1.25 from pot
Pachebrash: doesn't show hand 
*** SUMMARY ***
Total pot $1.25 | Rake $0 
Seat 2: artemxxl folded before Flop (didn't bet)
Seat 3: pafell folded before Flop (didn't bet)
Seat 4: Pachebrash collected ($1.25)
Seat 5: Nestle170 folded before Flop (didn't bet)
Seat 6: Kahmi3105 (button) folded before Flop (didn't bet)
Seat 7: Lisenok110 (small blind) folded before Flop
Seat 8: Gluck35 (big blind) folded before Flop
Seat 9: Mc57Arnold folded before Flop (didn't bet)



PokerStars Hand #228687580460:  Hold'em No Limit ($0.25/$0.50 USD) - 2021/07/30 15:53:51 ET
Table 'Aitne III' 9-max Seat #7 is the button
Seat 2: artemxxl ($76.20 in chips) 
Seat 3: pafell ($49.84 in chips) 
Seat 4: Pachebrash ($105 in chips) 
Seat 5: Nestle170 ($95.11 in chips) 
Seat 6: Kahmi3105 ($225.26 in chips) 
Seat 7: Lisenok110 ($50.14 in chips) 
Seat 8: Gluck35 ($58.54 in chips) 
Gluck35: posts small blind $0.25
Mc57Arnold: is sitting out 
artemxxl: posts big blind $0.50
*** HOLE CARDS ***
Mc57Arnold leaves the table
pafell: folds 
Pachebrash: folds 
korrastaja joins the table at seat #9 
Nestle170: raises $1 to $1.50
Kahmi3105: calls $1.50
Lisenok110: folds 
Gluck35: folds 
artemxxl: folds 
*** FLOP *** [Qs 2d 9h]
Nestle170: bets $1.17
Kahmi3105: calls $1.17
*** TURN *** [Qs 2d 9h] [Td]
Nestle170: bets $4.34
Kahmi3105: calls $4.34
*** RIVER *** [Qs 2d 9h Td] [8d]
Nestle170: checks 
Kahmi3105: checks 
*** SHOW DOWN ***
Nestle170: shows [Js Ad] (a straight, Eight to Queen)
Kahmi3105: mucks hand 
Nestle170 collected $14.03 from pot
*** SUMMARY ***
Total pot $14.77 | Rake $0.74 
Board [Qs 2d 9h Td 8d]
Seat 2: artemxxl (big blind) folded before Flop
Seat 3: pafell folded before Flop (didn't bet)
Seat 4: Pachebrash folded before Flop (didn't bet)
Seat 5: Nestle170 showed [Js Ad] and won ($14.03) with a straight, Eight to Queen
Seat 6: Kahmi3105 mucked
Seat 7: Lisenok110 (button) folded before Flop (didn't bet)
Seat 8: Gluck35 (small blind) folded before Flop



PokerStars Hand #228687599248:  Hold'em No Limit ($0.25/$0.50 USD) - 2021/07/30 15:54:33 ET
Table 'Aitne III' 9-max Seat #8 is the button
Seat 2: artemxxl ($75.70 in chips) 
Seat 3: pafell ($49.84 in chips) 
Seat 4: Pachebrash ($105 in chips) 
Seat 5: Nestle170 ($102.13 in chips) 
Seat 6: Kahmi3105 ($218.25 in chips) 
Seat 7: Lisenok110 ($50.14 in chips) 
Seat 8: Gluck35 ($58.29 in chips) 
artemxxl: posts small blind $0.25
pafell: posts big blind $0.50
*** HOLE CARDS ***
Pachebrash: folds 
Nestle170: folds 
Kahmi3105: folds 
Lisenok110: folds 
Gluck35: folds 
artemxxl: folds 
Uncalled bet ($0.25) returned to pafell
pafell collected $0.50 from pot
pafell: doesn't show hand 
*** SUMMARY ***
Total pot $0.50 | Rake $0 
Seat 2: artemxxl (small blind) folded before Flop
Seat 3: pafell (big blind) collected ($0.50)
Seat 4: Pachebrash folded before Flop (didn't bet)
Seat 5: Nestle170 folded before Flop (didn't bet)
Seat 6: Kahmi3105 folded before Flop (didn't bet)
Seat 7: Lisenok110 folded before Flop (didn't bet)
Seat 8: Gluck35 (button) folded before Flop (didn't bet)



PokerStars Hand #228687606904:  Hold'em No Limit ($0.25/$0.50 USD) - 2021/07/30 15:54:50 ET
Table 'Aitne III' 9-max Seat #2 is the button
Seat 2: artemxxl ($75.45 in chips) 
Seat 3: pafell ($50.09 in chips) 
Seat 4: Pachebrash ($105 in chips) 
Seat 5: Nestle170 ($102.13 in chips) 
Seat 6: Kahmi3105 ($218.25 in chips) 
Seat 7: Lisenok110 ($50.14 in chips) 
Seat 8: Gluck35 ($58.29 in chips) 
pafell: posts small blind $0.25
Pachebrash: posts big blind $0.50
korrastaja: sits out 
*** HOLE CARDS ***
Nestle170: folds 
Kahmi3105: raises $1.25 to $1.75
Lisenok110: folds 
Gluck35: folds 
artemxxl: folds 
pafell: calls $1.50
Pachebrash: folds 
*** FLOP *** [7c 3s Ad]
pafell: checks 
Kahmi3105: bets $3.80
pafell: folds 
Uncalled bet ($3.80) returned to Kahmi3105
Kahmi3105 collected $3.75 from pot
*** SUMMARY ***
Total pot $4 | Rake $0.25 
Board [7c 3s Ad]
Seat 2: artemxxl (button) folded before Flop (didn't bet)
Seat 3: pafell (small blind) folded on the Flop
Seat 4: Pachebrash (big blind) folded before Flop
Seat 5: Nestle170 folded before Flop (didn't bet)
Seat 6: Kahmi3105 collected ($3.75)
Seat 7: Lisenok110 folded before Flop (didn't bet)
Seat 8: Gluck35 folded before Flop (didn't bet)



PokerStars Hand #228687619923:  Hold'em No Limit ($0.25/$0.50 USD) - 2021/07/30 15:55:22 ET
Table 'Aitne III' 9-max Seat #3 is the button
Seat 2: artemxxl ($75.45 in chips) 
Seat 3: pafell ($48.34 in chips) 
Seat 4: Pachebrash ($104.50 in chips) 
Seat 5: Nestle170 ($102.13 in chips) 
Seat 6: Kahmi3105 ($220.25 in chips) 
Seat 7: Lisenok110 ($50.14 in chips) 
Seat 8: Gluck35 ($58.29 in chips) 
Pachebrash: posts small blind $0.25
Nestle170: posts big blind $0.50
korrastaja: sits out 
*** HOLE CARDS ***
Kahmi3105: folds 
Lisenok110: folds 
Gluck35: folds 
artemxxl: raises $0.75 to $1.25
pafell: folds 
Pachebrash: folds 
Nestle170: folds 
Uncalled bet ($0.75) returned to artemxxl
artemxxl collected $1.25 from pot
*** SUMMARY ***
Total pot $1.25 | Rake $0 
Seat 2: artemxxl collected ($1.25)
Seat 3: pafell (button) folded before Flop (didn't bet)
Seat 4: Pachebrash (small blind) folded before Flop
Seat 5: Nestle170 (big blind) folded before Flop
Seat 6: Kahmi3105 folded before Flop (didn't bet)
Seat 7: Lisenok110 folded before Flop (didn't bet)
Seat 8: Gluck35 folded before Flop (didn't bet)



PokerStars Hand #228687624350:  Hold'em No Limit ($0.25/$0.50 USD) - 2021/07/30 15:55:36 ET
Table 'Aitne III' 9-max Seat #4 is the button
Seat 2: artemxxl ($76.20 in chips) 
Seat 3: pafell ($48.34 in chips) 
Seat 4: Pachebrash ($104.25 in chips) 
Seat 5: Nestle170 ($101.63 in chips) 
Seat 6: Kahmi3105 ($220.25 in chips) 
Seat 7: Lisenok110 ($50.14 in chips) 
Seat 8: Gluck35 ($58.29 in chips) 
Nestle170: posts small blind $0.25
Kahmi3105: posts big blind $0.50
korrastaja: sits out 
*** HOLE CARDS ***
Lisenok110: folds 
Gluck35: folds 
artemxxl: raises $1 to $1.50
pafell: folds 
Pachebrash: folds 
Nestle170: folds 
Kahmi3105: folds 
Uncalled bet ($1) returned to artemxxl
artemxxl collected $1.25 from pot
*** SUMMARY ***
Total pot $1.25 | Rake $0 
Seat 2: artemxxl collected ($1.25)
Seat 3: pafell folded before Flop (didn't bet)
Seat 4: Pachebrash (button) folded before Flop (didn't bet)
Seat 5: Nestle170 (small blind) folded before Flop
Seat 6: Kahmi3105 (big blind) folded before Flop
Seat 7: Lisenok110 folded before Flop (didn't bet)
Seat 8: Gluck35 folded before Flop (didn't bet)



PokerStars Hand #228687630689:  Hold'em No Limit ($0.25/$0.50 USD) - 2021/07/30 15:55:55 ET
Table 'Aitne III' 9-max Seat #5 is the button
Seat 2: artemxxl ($76.95 in chips) 
Seat 3: pafell ($48.34 in chips) 
Seat 4: Pachebrash ($104.25 in chips) 
Seat 5: Nestle170 ($101.38 in chips) 
Seat 6: Kahmi3105 ($219.75 in chips) 
Seat 7: Lisenok110 ($50.14 in chips) 
Seat 8: Gluck35 ($58.29 in chips) 
Kahmi3105: posts small blind $0.25
Lisenok110: posts big blind $0.50
korrastaja: sits out 
*** HOLE CARDS ***
Gluck35: folds 
artemxxl: folds 
pafell: folds 
Pachebrash: raises $0.75 to $1.25
Nestle170: folds 
Kahmi3105: calls $1
Lisenok110: folds 
*** FLOP *** [Qc Kd Ad]
Kahmi3105: checks 
Pachebrash: bets $1.88
Kahmi3105: folds 
Uncalled bet ($1.88) returned to Pachebrash
Pachebrash collected $2.85 from pot
Pachebrash: doesn't show hand 
*** SUMMARY ***
Total pot $3 | Rake $0.15 
Board [Qc Kd Ad]
Seat 2: artemxxl folded before Flop (didn't bet)
Seat 3: pafell folded before Flop (didn't bet)
Seat 4: Pachebrash collected ($2.85)
Seat 5: Nestle170 (button) folded before Flop (didn't bet)
Seat 6: Kahmi3105 (small blind) folded on the Flop
Seat 7: Lisenok110 (big blind) folded before Flop
Seat 8: Gluck35 folded before Flop (didn't bet)



PokerStars Hand #228687638105:  Hold'em No Limit ($0.25/$0.50 USD) - 2021/07/30 15:56:18 ET
Table 'Aitne III' 9-max Seat #6 is the button
Seat 2: artemxxl ($76.95 in chips) 
Seat 3: pafell ($48.34 in chips) 
Seat 4: Pachebrash ($105.85 in chips) 
Seat 5: Nestle170 ($101.38 in chips) 
Seat 6: Kahmi3105 ($218.50 in chips) 
Seat 7: Lisenok110 ($50 in chips) 
Seat 8: Gluck35 ($58.29 in chips) 
Lisenok110: posts small blind $0.25
Gluck35: posts big blind $0.50
korrastaja: sits out 
*** HOLE CARDS ***
artemxxl: folds 
pafell: folds 
Pachebrash: folds 
Nestle170: folds 
Kahmi3105: folds 
Lisenok110: folds 
Uncalled bet ($0.25) returned to Gluck35
Gluck35 collected $0.50 from pot
Gluck35: doesn't show hand 
*** SUMMARY ***
Total pot $0.50 | Rake $0 
Seat 2: artemxxl folded before Flop (didn't bet)
Seat 3: pafell folded before Flop (didn't bet)
Seat 4: Pachebrash folded before Flop (didn't bet)
Seat 5: Nestle170 folded before Flop (didn't bet)
Seat 6: Kahmi3105 (button) folded before Flop (didn't bet)
Seat 7: Lisenok110 (small blind) folded before Flop
Seat 8: Gluck35 (big blind) collected ($0.50)



PokerStars Hand #228687641502:  Hold'em No Limit ($0.25/$0.50 USD) - 2021/07/30 15:56:28 ET
Table 'Aitne III' 9-max Seat #7 is the button
Seat 2: artemxxl ($76.95 in chips) 
Seat 3: pafell ($48.34 in chips) 
Seat 4: Pachebrash ($105.85 in chips) 
Seat 5: Nestle170 ($101.38 in chips) 
Seat 7: Lisenok110 ($50 in chips) 
Seat 8: Gluck35 ($58.54 in chips) 
Seat 9: korrastaja ($50 in chips) 
Gluck35: posts small blind $0.25
korrastaja: posts big blind $0.50
*** HOLE CARDS ***
artemxxl: folds 
pafell: folds 
Pachebrash: folds 
Nestle170: folds 
Lisenok110: raises $0.75 to $1.25
Gluck35: folds 
korrastaja: folds 
Uncalled bet ($0.75) returned to Lisenok110
Lisenok110 collected $1.25 from pot
Lisenok110: doesn't show hand 
*** SUMMARY ***
Total pot $1.25 | Rake $0 
Seat 2: artemxxl folded before Flop (didn't bet)
Seat 3: pafell folded before Flop (didn't bet)
Seat 4: Pachebrash folded before Flop (didn't bet)
Seat 5: Nestle170 folded before Flop (didn't bet)
Seat 7: Lisenok110 (button) collected ($1.25)
Seat 8: Gluck35 (small blind) folded before Flop
Seat 9: korrastaja (big blind) folded before Flop



PokerStars Hand #228687646984:  Hold'em No Limit ($0.25/$0.50 USD) - 2021/07/30 15:56:45 ET
Table 'Aitne III' 9-max Seat #8 is the button
Seat 2: artemxxl ($76.95 in chips) 
Seat 3: pafell ($48.34 in chips) 
Seat 4: Pachebrash ($105.85 in chips) 
Seat 5: Nestle170 ($101.38 in chips) 
Seat 7: Lisenok110 ($50.75 in chips) 
Seat 8: Gluck35 ($58.29 in chips) 
Seat 9: korrastaja ($50 in chips) 
korrastaja: posts small blind $0.25
artemxxl: posts big blind $0.50
*** HOLE CARDS ***
pafell: folds 
Pachebrash: folds 
Nestle170: folds 
Lisenok110: raises $0.75 to $1.25
Gluck35: folds 
korrastaja: folds 
artemxxl: folds 
Uncalled bet ($0.75) returned to Lisenok110
Lisenok110 collected $1.25 from pot
Lisenok110: doesn't show hand 
*** SUMMARY ***
Total pot $1.25 | Rake $0 
Seat 2: artemxxl (big blind) folded before Flop
Seat 3: pafell folded before Flop (didn't bet)
Seat 4: Pachebrash folded before Flop (didn't bet)
Seat 5: Nestle170 folded before Flop (didn't bet)
Seat 7: Lisenok110 collected ($1.25)
Seat 8: Gluck35 (button) folded before Flop (didn't bet)
Seat 9: korrastaja (small blind) folded before Flop



PokerStars Hand #228687652304:  Hold'em No Limit ($0.25/$0.50 USD) - 2021/07/30 15:57:01 ET
Table 'Aitne III' 9-max Seat #9 is the button
Seat 2: artemxxl ($76.45 in chips) 
Seat 3: pafell ($48.34 in chips) 
Seat 4: Pachebrash ($105.85 in chips) 
Seat 5: Nestle170 ($101.38 in chips) 
Seat 7: Lisenok110 ($51.50 in chips) 
Seat 8: Gluck35 ($58.29 in chips) 
Seat 9: korrastaja ($50 in chips) 
artemxxl: posts small blind $0.25
pafell: posts big blind $0.50
*** HOLE CARDS ***
Pachebrash: folds 
Nestle170: folds 
Lisenok110: folds 
Gluck35: folds 
korrastaja: raises $1 to $1.50
artemxxl: folds 
pafell: calls $1
*** FLOP *** [5c 9s 6s]
pafell: checks 
korrastaja: bets $1.70
pafell: folds 
Uncalled bet ($1.70) returned to korrastaja
korrastaja collected $3.09 from pot
korrastaja: doesn't show hand 
*** SUMMARY ***
Total pot $3.25 | Rake $0.16 
Board [5c 9s 6s]
Seat 2: artemxxl (small blind) folded before Flop
Seat 3: pafell (big blind) folded on the Flop
Seat 4: Pachebrash folded before Flop (didn't bet)
Seat 5: Nestle170 folded before Flop (didn't bet)
Seat 7: Lisenok110 folded before Flop (didn't bet)
Seat 8: Gluck35 folded before Flop (didn't bet)
Seat 9: korrastaja (button) collected ($3.09)



PokerStars Hand #228687665783:  Hold'em No Limit ($0.25/$0.50 USD) - 2021/07/30 15:57:42 ET
Table 'Aitne III' 9-max Seat #2 is the button
Seat 2: artemxxl ($76.20 in chips) 
Seat 3: pafell ($46.84 in chips) 
Seat 5: Nestle170 ($101.38 in chips) 
Seat 7: Lisenok110 ($51.50 in chips) 
Seat 8: Gluck35 ($58.29 in chips) 
Seat 9: korrastaja ($51.59 in chips) 
pafell: posts small blind $0.25
Pachebrash: is sitting out 
Nestle170: posts big blind $0.50
*** HOLE CARDS ***
Pachebrash leaves the table
Lisenok110: folds 
Gluck35: folds 
korrastaja: folds 
artemxxl: folds 
pafell: raises $1 to $1.50
Nestle170: folds 
Uncalled bet ($1) returned to pafell
pafell collected $1 from pot
pafell: doesn't show hand 
*** SUMMARY ***
Total pot $1 | Rake $0 
Seat 2: artemxxl (button) folded before Flop (didn't bet)
Seat 3: pafell (small blind) collected ($1)
Seat 5: Nestle170 (big blind) folded before Flop
Seat 7: Lisenok110 folded before Flop (didn't bet)
Seat 8: Gluck35 folded before Flop (didn't bet)
Seat 9: korrastaja folded before Flop (didn't bet)



PokerStars Hand #228687669724:  Hold'em No Limit ($0.25/$0.50 USD) - 2021/07/30 15:57:54 ET
Table 'Aitne III' 9-max Seat #3 is the button
Seat 2: artemxxl ($76.20 in chips) 
Seat 3: pafell ($47.34 in chips) 
Seat 5: Nestle170 ($100.88 in chips) 
Seat 8: Gluck35 ($58.29 in chips) 
Seat 9: korrastaja ($51.59 in chips) 
Nestle170: posts small blind $0.25
Lisenok110: is sitting out 
Gluck35: posts big blind $0.50
*** HOLE CARDS ***
korrastaja: folds 
artemxxl: folds 
pafell: folds 
Nestle170: raises $1 to $1.50
Gluck35: calls $1
*** FLOP *** [6s 4c Kc]
Nestle170: bets $0.94
Gluck35: raises $2.37 to $3.31
Nestle170: folds 
Uncalled bet ($2.37) returned to Gluck35
Gluck35 collected $4.64 from pot
Gluck35: doesn't show hand 
*** SUMMARY ***
Total pot $4.88 | Rake $0.24 
Board [6s 4c Kc]
Seat 2: artemxxl folded before Flop (didn't bet)
Seat 3: pafell (button) folded before Flop (didn't bet)
Seat 5: Nestle170 (small blind) folded on the Flop
Seat 8: Gluck35 (big blind) collected ($4.64)
Seat 9: korrastaja folded before Flop (didn't bet)



PokerStars Hand #228687682901:  Hold'em No Limit ($0.25/$0.50 USD) - 2021/07/30 15:58:33 ET
Table 'Aitne III' 9-max Seat #5 is the button
Seat 2: artemxxl ($76.20 in chips) 
Seat 3: pafell ($47.34 in chips) 
Seat 5: Nestle170 ($98.44 in chips) 
Seat 8: Gluck35 ($60.49 in chips) 
Seat 9: korrastaja ($51.59 in chips) 
Gluck35: posts small blind $0.25
korrastaja: posts big blind $0.50
*** HOLE CARDS ***
artemxxl: folds 
pafell: calls $0.50
Nestle170: folds 
Gluck35: calls $0.25
korrastaja: checks 
*** FLOP *** [Ts Qc 4h]
Gluck35: checks 
korrastaja: checks 
pafell: bets $1.42
v.sting joins the table at seat #4 
Gluck35: folds 
korrastaja: folds 
Uncalled bet ($1.42) returned to pafell
pafell collected $1.42 from pot
pafell: doesn't show hand 
Lisenok110 leaves the table
*** SUMMARY ***
Total pot $1.50 | Rake $0.08 
Board [Ts Qc 4h]
Seat 2: artemxxl folded before Flop (didn't bet)
Seat 3: pafell collected ($1.42)
Seat 5: Nestle170 (button) folded before Flop (didn't bet)
Seat 8: Gluck35 (small blind) folded on the Flop
Seat 9: korrastaja (big blind) folded on the Flop



PokerStars Hand #228687690424:  Hold'em No Limit ($0.25/$0.50 USD) - 2021/07/30 15:58:56 ET
Table 'Aitne III' 9-max Seat #8 is the button
Seat 2: artemxxl ($76.20 in chips) 
Seat 3: pafell ($48.26 in chips) 
Seat 5: Nestle170 ($98.44 in chips) 
Seat 8: Gluck35 ($59.99 in chips) 
Seat 9: korrastaja ($51.09 in chips) 
korrastaja: posts small blind $0.25
artemxxl: posts big blind $0.50
v.sting: sits out 
*** HOLE CARDS ***
pafell: folds 
Nestle170: raises $0.75 to $1.25
Gluck35: folds 
An1an1 joins the table at seat #7 
korrastaja: folds 
artemxxl: folds 
Uncalled bet ($0.75) returned to Nestle170
Nestle170 collected $1.25 from pot
Unsimple was removed from the table for failing to post
Unsimple leaves the table
Nestle170: doesn't show hand 
*** SUMMARY ***
Total pot $1.25 | Rake $0 
Seat 2: artemxxl (big blind) folded before Flop
Seat 3: pafell folded before Flop (didn't bet)
Seat 5: Nestle170 collected ($1.25)
Seat 8: Gluck35 (button) folded before Flop (didn't bet)
Seat 9: korrastaja (small blind) folded before Flop



PokerStars Hand #228687696150:  Hold'em No Limit ($0.25/$0.50 USD) - 2021/07/30 15:59:13 ET
Table 'Aitne III' 9-max Seat #9 is the button
Seat 2: artemxxl ($75.70 in chips) 
Seat 3: pafell ($48.26 in chips) 
Seat 5: Nestle170 ($99.19 in chips) 
Seat 8: Gluck35 ($59.99 in chips) 
Seat 9: korrastaja ($50.84 in chips) 
artemxxl: posts small blind $0.25
pafell: posts big blind $0.50
v.sting: sits out 
An1an1: sits out 
*** HOLE CARDS ***
Unsimple joins the table at seat #1 
Nestle170: raises $1 to $1.50
Gluck35: folds 
korrastaja: folds 
artemxxl: folds 
pafell: calls $1
*** FLOP *** [Qh 5d 2h]
pafell: checks 
Nestle170: checks 
*** TURN *** [Qh 5d 2h] [Td]
pafell: bets $1.54
Nestle170: folds 
Uncalled bet ($1.54) returned to pafell
pafell collected $3.09 from pot
pafell: doesn't show hand 
*** SUMMARY ***
Total pot $3.25 | Rake $0.16 
Board [Qh 5d 2h Td]
Seat 2: artemxxl (small blind) folded before Flop
Seat 3: pafell (big blind) collected ($3.09)
Seat 5: Nestle170 folded on the Turn
Seat 8: Gluck35 folded before Flop (didn't bet)
Seat 9: korrastaja (button) folded before Flop (didn't bet)



PokerStars Hand #228687711527:  Hold'em No Limit ($0.25/$0.50 USD) - 2021/07/30 15:59:59 ET
Table 'Aitne III' 9-max Seat #2 is the button
Seat 2: artemxxl ($75.45 in chips) 
Seat 3: pafell ($49.85 in chips) 
Seat 4: v.sting ($50 in chips) 
Seat 5: Nestle170 ($97.69 in chips) 
Seat 8: Gluck35 ($59.99 in chips) 
Seat 9: korrastaja ($50.84 in chips) 
pafell: posts small blind $0.25
v.sting: posts big blind $0.50
An1an1: sits out 
Unsimple: sits out 
*** HOLE CARDS ***
Nestle170: folds 
Gluck35: folds 
korrastaja: folds 
artemxxl: folds 
pafell: calls $0.25
Unsimple leaves the table
v.sting: checks 
*** FLOP *** [5s Ah Jh]
pafell: checks 
v.sting: checks 
*** TURN *** [5s Ah Jh] [6h]
pafell: bets $0.50
v.sting: folds 
Uncalled bet ($0.50) returned to pafell
pafell collected $0.95 from pot
pafell: doesn't show hand 
*** SUMMARY ***
Total pot $1 | Rake $0.05 
Board [5s Ah Jh 6h]
Seat 2: artemxxl (button) folded before Flop (didn't bet)
Seat 3: pafell (small blind) collected ($0.95)
Seat 4: v.sting (big blind) folded on the Turn
Seat 5: Nestle170 folded before Flop (didn't bet)
Seat 8: Gluck35 folded before Flop (didn't bet)
Seat 9: korrastaja folded before Flop (didn't bet)



PokerStars Hand #228687722398:  Hold'em No Limit ($0.25/$0.50 USD) - 2021/07/30 16:00:29 ET
Table 'Aitne III' 9-max Seat #3 is the button
Seat 2: artemxxl ($75.45 in chips) 
Seat 3: pafell ($50.30 in chips) 
Seat 4: v.sting ($50 in chips) 
Seat 5: Nestle170 ($97.69 in chips) 
Seat 6: Kahmi3105 ($218.50 in chips) 
Seat 8: Gluck35 ($59.99 in chips) 
Seat 9: korrastaja ($50.84 in chips) 
v.sting: posts small blind $0.25
Nestle170: posts big blind $0.50
Kahmi3105: posts small & big blinds $0.75
An1an1: sits out 
*** HOLE CARDS ***
Kahmi3105: checks 
Gluck35: raises $1.50 to $2
korrastaja: folds 
artemxxl: folds 
pafell: folds 
v.sting: folds 
Nestle170: folds 
Kahmi3105: calls $1.50
*** FLOP *** [Ah Qd Kh]
Kahmi3105: checks 
Gluck35: checks 
*** TURN *** [Ah Qd Kh] [Ts]
Kahmi3105: checks 
Gluck35: bets $1.57
Kahmi3105: folds 
Uncalled bet ($1.57) returned to Gluck35
Gluck35 collected $4.75 from pot
Gluck35: doesn't show hand 
*** SUMMARY ***
Total pot $5 | Rake $0.25 
Board [Ah Qd Kh Ts]
Seat 2: artemxxl folded before Flop (didn't bet)
Seat 3: pafell (button) folded before Flop (didn't bet)
Seat 4: v.sting (small blind) folded before Flop
Seat 5: Nestle170 (big blind) folded before Flop
Seat 6: Kahmi3105 folded on the Turn
Seat 8: Gluck35 collected ($4.75)
Seat 9: korrastaja folded before Flop (didn't bet)



PokerStars Hand #228687738481:  Hold'em No Limit ($0.25/$0.50 USD) - 2021/07/30 16:01:10 ET
Table 'Aitne III' 9-max Seat #4 is the button
Seat 2: artemxxl ($75.45 in chips) 
Seat 3: pafell ($50.30 in chips) 
Seat 4: v.sting ($50 in chips) 
Seat 5: Nestle170 ($97.19 in chips) 
Seat 6: Kahmi3105 ($216.25 in chips) 
Seat 8: Gluck35 ($62.74 in chips) 
Seat 9: korrastaja ($50.84 in chips) 
Nestle170: posts small blind $0.25
Kahmi3105: posts big blind $0.50
An1an1: sits out 
*** HOLE CARDS ***
Gluck35: folds 
korrastaja: folds 
artemxxl: folds 
pafell: folds 
v.sting: folds 
Nestle170: folds 
Uncalled bet ($0.25) returned to Kahmi3105
Kahmi3105 collected $0.50 from pot
*** SUMMARY ***
Total pot $0.50 | Rake $0 
Seat 2: artemxxl folded before Flop (didn't bet)
Seat 3: pafell folded before Flop (didn't bet)
Seat 4: v.sting (button) folded before Flop (didn't bet)
Seat 5: Nestle170 (small blind) folded before Flop
Seat 6: Kahmi3105 (big blind) collected ($0.50)
Seat 8: Gluck35 folded before Flop (didn't bet)
Seat 9: korrastaja folded before Flop (didn't bet)



PokerStars Hand #228687742354:  Hold'em No Limit ($0.25/$0.50 USD) - 2021/07/30 16:01:20 ET
Table 'Aitne III' 9-max Seat #5 is the button
Seat 2: artemxxl ($75.45 in chips) 
Seat 3: pafell ($50.30 in chips) 
Seat 4: v.sting ($50 in chips) 
Seat 5: Nestle170 ($96.94 in chips) 
Seat 6: Kahmi3105 ($216.50 in chips) 
Seat 7: An1an1 ($50 in chips) 
Seat 8: Gluck35 ($62.74 in chips) 
Seat 9: korrastaja ($50.84 in chips) 
Kahmi3105: posts small blind $0.25
An1an1: posts big blind $0.50
*** HOLE CARDS ***
Gluck35: raises $0.75 to $1.25
korrastaja: folds 
artemxxl: calls $1.25
pafell: folds 
Corlogiro joins the table at seat #1 
v.sting: raises $5 to $6.25
Nestle170: folds 
Kahmi3105: folds 
An1an1: folds 
Gluck35: folds 
artemxxl: calls $5
*** FLOP *** [Jd 8h 2s]
artemxxl: checks 
v.sting: bets $4.55
artemxxl: calls $4.55
*** TURN *** [Jd 8h 2s] [Td]
artemxxl: checks 
v.sting: checks 
*** RIVER *** [Jd 8h 2s Td] [2h]
artemxxl: checks 
v.sting: checks 
*** SHOW DOWN ***
artemxxl: shows [9s 9h] (two pair, Nines and Deuces)
v.sting: mucks hand 
artemxxl collected $22.42 from pot
*** SUMMARY ***
Total pot $23.60 | Rake $1.18 
Board [Jd 8h 2s Td 2h]
Seat 2: artemxxl showed [9s 9h] and won ($22.42) with two pair, Nines and Deuces
Seat 3: pafell folded before Flop (didn't bet)
Seat 4: v.sting mucked
Seat 5: Nestle170 (button) folded before Flop (didn't bet)
Seat 6: Kahmi3105 (small blind) folded before Flop
Seat 7: An1an1 (big blind) folded before Flop
Seat 8: Gluck35 folded before Flop
Seat 9: korrastaja folded before Flop (didn't bet)



PokerStars Hand #228687770249:  Hold'em No Limit ($0.25/$0.50 USD) - 2021/07/30 16:02:23 ET
Table 'Aitne III' 9-max Seat #6 is the button
Seat 2: artemxxl ($87.07 in chips) 
Seat 3: pafell ($50.30 in chips) 
Seat 4: v.sting ($50 in chips) 
Seat 5: Nestle170 ($96.94 in chips) 
Seat 6: Kahmi3105 ($216.25 in chips) 
Seat 7: An1an1 ($50 in chips) 
Seat 8: Gluck35 ($61.49 in chips) 
Seat 9: korrastaja ($50.84 in chips) 
An1an1: posts small blind $0.25
Gluck35: posts big blind $0.50
Corlogiro: sits out 
*** HOLE CARDS ***
korrastaja: folds 
artemxxl: folds 
pafell: folds 
v.sting: raises $0.75 to $1.25
Nestle170: folds 
Kahmi3105: calls $1.25
An1an1: folds 
Gluck35: folds 
*** FLOP *** [2d 7s 8c]
v.sting: bets $1.02
Kahmi3105: calls $1.02
*** TURN *** [2d 7s 8c] [Js]
v.sting: checks 
Kahmi3105: checks 
*** RIVER *** [2d 7s 8c Js] [7h]
v.sting: checks 
Kahmi3105: bets $3
v.sting: folds 
Uncalled bet ($3) returned to Kahmi3105
Kahmi3105 collected $4.97 from pot
*** SUMMARY ***
Total pot $5.29 | Rake $0.32 
Board [2d 7s 8c Js 7h]
Seat 2: artemxxl folded before Flop (didn't bet)
Seat 3: pafell folded before Flop (didn't bet)
Seat 4: v.sting folded on the River
Seat 5: Nestle170 folded before Flop (didn't bet)
Seat 6: Kahmi3105 (button) collected ($4.97)
Seat 7: An1an1 (small blind) folded before Flop
Seat 8: Gluck35 (big blind) folded before Flop
Seat 9: korrastaja folded before Flop (didn't bet)



PokerStars Hand #228687807747:  Hold'em No Limit ($0.25/$0.50 USD) - 2021/07/30 16:03:45 ET
Table 'Aitne III' 9-max Seat #7 is the button
Seat 2: artemxxl ($87.07 in chips) 
Seat 3: pafell ($50.30 in chips) 
Seat 4: v.sting ($50 in chips) 
Seat 5: Nestle170 ($96.94 in chips) 
Seat 6: Kahmi3105 ($218.95 in chips) 
Seat 7: An1an1 ($50 in chips) 
Seat 8: Gluck35 ($60.99 in chips) 
Seat 9: korrastaja ($50.84 in chips) 
Gluck35: posts small blind $0.25
korrastaja: posts big blind $0.50
Corlogiro: sits out 
*** HOLE CARDS ***
artemxxl: folds 
pafell: calls $0.50
v.sting: folds 
Nestle170: folds 
Kahmi3105: folds 
An1an1: folds 
Gluck35: folds 
korrastaja: checks 
*** FLOP *** [Ac Qc 4h]
korrastaja: checks 
pafell: bets $0.50
korrastaja: calls $0.50
*** TURN *** [Ac Qc 4h] [8s]
korrastaja: checks 
pafell: bets $1
korrastaja: calls $1
*** RIVER *** [Ac Qc 4h 8s] [3c]
korrastaja: checks 
pafell: checks 
*** SHOW DOWN ***
korrastaja: shows [Ad 5h] (a pair of Aces)
pafell: mucks hand 
korrastaja collected $4.04 from pot
*** SUMMARY ***
Total pot $4.25 | Rake $0.21 
Board [Ac Qc 4h 8s 3c]
Seat 2: artemxxl folded before Flop (didn't bet)
Seat 3: pafell mucked
Seat 4: v.sting folded before Flop (didn't bet)
Seat 5: Nestle170 folded before Flop (didn't bet)
Seat 6: Kahmi3105 folded before Flop (didn't bet)
Seat 7: An1an1 (button) folded before Flop (didn't bet)
Seat 8: Gluck35 (small blind) folded before Flop
Seat 9: korrastaja (big blind) showed [Ad 5h] and won ($4.04) with a pair of Aces



PokerStars Hand #228687826069:  Hold'em No Limit ($0.25/$0.50 USD) - 2021/07/30 16:04:25 ET
Table 'Aitne III' 9-max Seat #8 is the button
Seat 1: Corlogiro ($50 in chips) 
Seat 2: artemxxl ($87.07 in chips) 
Seat 3: pafell ($48.30 in chips) 
Seat 4: v.sting ($50 in chips) 
Seat 5: Nestle170 ($96.94 in chips) 
Seat 6: Kahmi3105 ($218.95 in chips) 
Seat 7: An1an1 ($50 in chips) 
Seat 8: Gluck35 ($60.74 in chips) 
Seat 9: korrastaja ($52.88 in chips) 
korrastaja: posts small blind $0.25
Corlogiro: posts big blind $0.50
*** HOLE CARDS ***
artemxxl: folds 
pafell: calls $0.50
v.sting: folds 
Nestle170: folds 
Kahmi3105: folds 
An1an1: folds 
Gluck35: folds 
korrastaja: folds 
Corlogiro: checks 
*** FLOP *** [5d Qh 2d]
Corlogiro: checks 
pafell: bets $1
Corlogiro: calls $1
*** TURN *** [5d Qh 2d] [5h]
Corlogiro: checks 
pafell: bets $1.50
Corlogiro: calls $1.50
*** RIVER *** [5d Qh 2d 5h] [9s]
Corlogiro: checks 
pafell: bets $5.94
Corlogiro: folds 
Uncalled bet ($5.94) returned to pafell
pafell collected $5.94 from pot
pafell: doesn't show hand 
*** SUMMARY ***
Total pot $6.25 | Rake $0.31 
Board [5d Qh 2d 5h 9s]
Seat 1: Corlogiro (big blind) folded on the River
Seat 2: artemxxl folded before Flop (didn't bet)
Seat 3: pafell collected ($5.94)
Seat 4: v.sting folded before Flop (didn't bet)
Seat 5: Nestle170 folded before Flop (didn't bet)
Seat 6: Kahmi3105 folded before Flop (didn't bet)
Seat 7: An1an1 folded before Flop (didn't bet)
Seat 8: Gluck35 (button) folded before Flop (didn't bet)
Seat 9: korrastaja (small blind) folded before Flop



PokerStars Hand #228687854831:  Hold'em No Limit ($0.25/$0.50 USD) - 2021/07/30 16:05:27 ET
Table 'Aitne III' 9-max Seat #9 is the button
Seat 1: Corlogiro ($50 in chips) 
Seat 2: artemxxl ($87.07 in chips) 
Seat 3: pafell ($51.24 in chips) 
Seat 4: v.sting ($50 in chips) 
Seat 5: Nestle170 ($96.94 in chips) 
Seat 6: Kahmi3105 ($218.95 in chips) 
Seat 7: An1an1 ($50 in chips) 
Seat 8: Gluck35 ($60.74 in chips) 
Seat 9: korrastaja ($52.63 in chips) 
Corlogiro: posts small blind $0.25
artemxxl: posts big blind $0.50
*** HOLE CARDS ***
pafell: folds 
v.sting: folds 
Nestle170: folds 
Kahmi3105: folds 
An1an1: folds 
Gluck35: raises $0.75 to $1.25
korrastaja: raises $2.75 to $4
Corlogiro: folds 
artemxxl: folds 
An1an1 was removed from the table for failing to post
An1an1 leaves the table
Gluck35: raises $7 to $11
bigned1975 joins the table at seat #7 
korrastaja: folds 
Uncalled bet ($7) returned to Gluck35
Gluck35 collected $8.75 from pot
Gluck35: doesn't show hand 
*** SUMMARY ***
Total pot $8.75 | Rake $0 
Seat 1: Corlogiro (small blind) folded before Flop
Seat 2: artemxxl (big blind) folded before Flop
Seat 3: pafell folded before Flop (didn't bet)
Seat 4: v.sting folded before Flop (didn't bet)
Seat 5: Nestle170 folded before Flop (didn't bet)
Seat 6: Kahmi3105 folded before Flop (didn't bet)
Seat 7: An1an1 folded before Flop (didn't bet)
Seat 8: Gluck35 collected ($8.75)
Seat 9: korrastaja (button) folded before Flop



PokerStars Hand #228687878665:  Hold'em No Limit ($0.25/$0.50 USD) - 2021/07/30 16:06:18 ET
Table 'Aitne III' 9-max Seat #1 is the button
Seat 1: Corlogiro ($50 in chips) 
Seat 2: artemxxl ($86.57 in chips) 
Seat 4: v.sting ($50 in chips) 
Seat 5: Nestle170 ($96.94 in chips) 
Seat 6: Kahmi3105 ($218.95 in chips) 
Seat 7: bigned1975 ($50 in chips) 
Seat 8: Gluck35 ($65.49 in chips) 
Seat 9: korrastaja ($50 in chips) 
artemxxl: posts small blind $0.25
v.sting: posts big blind $0.50
bigned1975: posts big blind $0.50
*** HOLE CARDS ***
Nestle170: folds 
Kahmi3105: calls $0.50
bigned1975: checks 
Gluck35: folds 
korrastaja: folds 
Corlogiro: folds 
artemxxl: folds 
v.sting: checks 
*** FLOP *** [Qc 5s 4d]
v.sting has timed out
v.sting: checks 
Kahmi3105: bets $1.66
bigned1975: calls $1.66
v.sting: folds 
*** TURN *** [Qc 5s 4d] [4s]
Kahmi3105: checks 
bigned1975: bets $3
Kahmi3105: calls $3
*** RIVER *** [Qc 5s 4d 4s] [8d]
Kahmi3105: checks 
bigned1975: checks 
*** SHOW DOWN ***
Kahmi3105: shows [6h 4h] (three of a kind, Fours)
bigned1975: mucks hand 
Kahmi3105 collected $10.38 from pot
*** SUMMARY ***
Total pot $11.07 | Rake $0.69 
Board [Qc 5s 4d 4s 8d]
Seat 1: Corlogiro (button) folded before Flop (didn't bet)
Seat 2: artemxxl (small blind) folded before Flop
Seat 4: v.sting (big blind) folded on the Flop
Seat 5: Nestle170 folded before Flop (didn't bet)
Seat 6: Kahmi3105 showed [6h 4h] and won ($10.38) with three of a kind, Fours
Seat 7: bigned1975 mucked
Seat 8: Gluck35 folded before Flop (didn't bet)
Seat 9: korrastaja folded before Flop (didn't bet)



PokerStars Hand #228687916418:  Hold'em No Limit ($0.25/$0.50 USD) - 2021/07/30 16:07:22 ET
Table 'Aitne III' 9-max Seat #2 is the button
Seat 1: Corlogiro ($50 in chips) 
Seat 2: artemxxl ($86.32 in chips) 
Seat 4: v.sting ($50 in chips) 
Seat 5: Nestle170 ($96.94 in chips) 
Seat 6: Kahmi3105 ($224.17 in chips) 
Seat 7: bigned1975 ($44.84 in chips) 
Seat 8: Gluck35 ($65.49 in chips) 
Seat 9: korrastaja ($50 in chips) 
v.sting: posts small blind $0.25
Nestle170: posts big blind $0.50
*** HOLE CARDS ***
Kahmi3105: calls $0.50
bigned1975: folds 
Gluck35: folds 
korrastaja: folds 
Corlogiro: folds 
artemxxl: folds 
v.sting: folds 
Nestle170: checks 
*** FLOP *** [5h 6s 3s]
Nestle170: bets $0.65
Kahmi3105: calls $0.65
*** TURN *** [5h 6s 3s] [Qh]
Nestle170: checks 
Kahmi3105: checks 
*** RIVER *** [5h 6s 3s Qh] [3d]
Nestle170: checks 
Kahmi3105: checks 
*** SHOW DOWN ***
Nestle170: shows [Js 6c] (two pair, Sixes and Threes)
Kahmi3105: mucks hand 
Nestle170 collected $2.42 from pot
*** SUMMARY ***
Total pot $2.55 | Rake $0.13 
Board [5h 6s 3s Qh 3d]
Seat 1: Corlogiro folded before Flop (didn't bet)
Seat 2: artemxxl (button) folded before Flop (didn't bet)
Seat 4: v.sting (small blind) folded before Flop
Seat 5: Nestle170 (big blind) showed [Js 6c] and won ($2.42) with two pair, Sixes and Threes
Seat 6: Kahmi3105 mucked
Seat 7: bigned1975 folded before Flop (didn't bet)
Seat 8: Gluck35 folded before Flop (didn't bet)
Seat 9: korrastaja folded before Flop (didn't bet)



PokerStars Hand #228687931619:  Hold'em No Limit ($0.25/$0.50 USD) - 2021/07/30 16:07:54 ET
Table 'Aitne III' 9-max Seat #4 is the button
Seat 1: Corlogiro ($50 in chips) 
Seat 2: artemxxl ($86.32 in chips) 
Seat 4: v.sting ($50 in chips) 
Seat 5: Nestle170 ($98.21 in chips) 
Seat 6: Kahmi3105 ($223.02 in chips) 
Seat 7: bigned1975 ($50 in chips) 
Seat 8: Gluck35 ($65.49 in chips) 
Seat 9: korrastaja ($50 in chips) 
Nestle170: posts small blind $0.25
Kahmi3105: posts big blind $0.50
*** HOLE CARDS ***
bigned1975: raises $0.50 to $1
Gluck35: folds 
korrastaja: folds 
Corlogiro: folds 
artemxxl: folds 
v.sting: folds 
Nestle170: raises $3.50 to $4.50
Kahmi3105: folds 
bigned1975: calls $3.50
*** FLOP *** [Td 9h Qd]
Nestle170: bets $6.77
bigned1975: folds 
Uncalled bet ($6.77) returned to Nestle170
Nestle170 collected $9.02 from pot
Nestle170: doesn't show hand 
*** SUMMARY ***
Total pot $9.50 | Rake $0.48 
Board [Td 9h Qd]
Seat 1: Corlogiro folded before Flop (didn't bet)
Seat 2: artemxxl folded before Flop (didn't bet)
Seat 4: v.sting (button) folded before Flop (didn't bet)
Seat 5: Nestle170 (small blind) collected ($9.02)
Seat 6: Kahmi3105 (big blind) folded before Flop
Seat 7: bigned1975 folded on the Flop
Seat 8: Gluck35 folded before Flop (didn't bet)
Seat 9: korrastaja folded before Flop (didn't bet)



PokerStars Hand #228687961535:  Hold'em No Limit ($0.25/$0.50 USD) - 2021/07/30 16:08:58 ET
Table 'Aitne III' 9-max Seat #5 is the button
Seat 1: Corlogiro ($50 in chips) 
Seat 2: artemxxl ($86.32 in chips) 
Seat 3: pafell ($51.24 in chips) 
Seat 4: v.sting ($50 in chips) 
Seat 5: Nestle170 ($102.73 in chips) 
Seat 6: Kahmi3105 ($222.52 in chips) 
Seat 7: bigned1975 ($45.50 in chips) 
Seat 8: Gluck35 ($65.49 in chips) 
Seat 9: korrastaja ($50 in chips) 
Kahmi3105: posts small blind $0.25
bigned1975: posts big blind $0.50
pafell: posts small & big blinds $0.75
*** HOLE CARDS ***
Gluck35: folds 
korrastaja: raises $1 to $1.50
Corlogiro: folds 
artemxxl: calls $1.50
pafell: calls $1
v.sting: folds 
Nestle170: folds 
Kahmi3105: calls $1.25
bigned1975: calls $1
*** FLOP *** [9h Tc 5h]
Kahmi3105: checks 
bigned1975: checks 
korrastaja: checks 
artemxxl: checks 
pafell: checks 
*** TURN *** [9h Tc 5h] [7h]
Kahmi3105: checks 
bigned1975: checks 
korrastaja: checks 
artemxxl: checks 
pafell: bets $2
Kahmi3105: folds 
bigned1975: folds 
korrastaja: folds 
artemxxl: folds 
Uncalled bet ($2) returned to pafell
pafell collected $7.36 from pot
pafell: doesn't show hand 
*** SUMMARY ***
Total pot $7.75 | Rake $0.39 
Board [9h Tc 5h 7h]
Seat 1: Corlogiro folded before Flop (didn't bet)
Seat 2: artemxxl folded on the Turn
Seat 3: pafell collected ($7.36)
Seat 4: v.sting folded before Flop (didn't bet)
Seat 5: Nestle170 (button) folded before Flop (didn't bet)
Seat 6: Kahmi3105 (small blind) folded on the Turn
Seat 7: bigned1975 (big blind) folded on the Turn
Seat 8: Gluck35 folded before Flop (didn't bet)
Seat 9: korrastaja folded on the Turn



PokerStars Hand #228687990892:  Hold'em No Limit ($0.25/$0.50 USD) - 2021/07/30 16:10:01 ET
Table 'Aitne III' 9-max Seat #6 is the button
Seat 1: Corlogiro ($50 in chips) 
Seat 2: artemxxl ($84.82 in chips) 
Seat 3: pafell ($56.85 in chips) 
Seat 4: v.sting ($50 in chips) 
Seat 5: Nestle170 ($102.73 in chips) 
Seat 6: Kahmi3105 ($221.02 in chips) 
Seat 7: bigned1975 ($44 in chips) 
Seat 8: Gluck35 ($65.49 in chips) 
Seat 9: korrastaja ($50 in chips) 
bigned1975: posts small blind $0.25
Gluck35: posts big blind $0.50
*** HOLE CARDS ***
korrastaja: folds 
Corlogiro: folds 
artemxxl: folds 
pafell: calls $0.50
v.sting: folds 
Nestle170: folds 
Kahmi3105: calls $0.50
bigned1975: calls $0.25
Gluck35: checks 
*** FLOP *** [9s 5c Kh]
bigned1975: checks 
Gluck35: checks 
pafell: checks 
Kahmi3105: checks 
*** TURN *** [9s 5c Kh] [5s]
bigned1975: checks 
Gluck35: checks 
pafell: checks 
Kahmi3105: bets $1.90
bigned1975: folds 
Gluck35: folds 
pafell: folds 
Uncalled bet ($1.90) returned to Kahmi3105
Kahmi3105 collected $1.88 from pot
*** SUMMARY ***
Total pot $2 | Rake $0.12 
Board [9s 5c Kh 5s]
Seat 1: Corlogiro folded before Flop (didn't bet)
Seat 2: artemxxl folded before Flop (didn't bet)
Seat 3: pafell folded on the Turn
Seat 4: v.sting folded before Flop (didn't bet)
Seat 5: Nestle170 folded before Flop (didn't bet)
Seat 6: Kahmi3105 (button) collected ($1.88)
Seat 7: bigned1975 (small blind) folded on the Turn
Seat 8: Gluck35 (big blind) folded on the Turn
Seat 9: korrastaja folded before Flop (didn't bet)



PokerStars Hand #228688023054:  Hold'em No Limit ($0.25/$0.50 USD) - 2021/07/30 16:11:08 ET
Table 'Aitne III' 9-max Seat #7 is the button
Seat 1: Corlogiro ($50 in chips) 
Seat 2: artemxxl ($84.82 in chips) 
Seat 3: pafell ($56.35 in chips) 
Seat 4: v.sting ($50 in chips) 
Seat 5: Nestle170 ($102.73 in chips) 
Seat 6: Kahmi3105 ($222.40 in chips) 
Seat 7: bigned1975 ($49.50 in chips) 
Seat 8: Gluck35 ($64.99 in chips) 
Seat 9: korrastaja ($50 in chips) 
Gluck35: posts small blind $0.25
korrastaja: posts big blind $0.50
*** HOLE CARDS ***
Corlogiro: folds 
artemxxl: raises $1 to $1.50
pafell: folds 
v.sting: folds 
Nestle170: folds 
Kahmi3105: folds 
bigned1975: folds 
Gluck35: folds 
korrastaja: folds 
Uncalled bet ($1) returned to artemxxl
artemxxl collected $1.25 from pot
*** SUMMARY ***
Total pot $1.25 | Rake $0 
Seat 1: Corlogiro folded before Flop (didn't bet)
Seat 2: artemxxl collected ($1.25)
Seat 3: pafell folded before Flop (didn't bet)
Seat 4: v.sting folded before Flop (didn't bet)
Seat 5: Nestle170 folded before Flop (didn't bet)
Seat 6: Kahmi3105 folded before Flop (didn't bet)
Seat 7: bigned1975 (button) folded before Flop (didn't bet)
Seat 8: Gluck35 (small blind) folded before Flop
Seat 9: korrastaja (big blind) folded before Flop



PokerStars Hand #228688032161:  Hold'em No Limit ($0.25/$0.50 USD) - 2021/07/30 16:11:28 ET
Table 'Aitne III' 9-max Seat #8 is the button
Seat 1: Corlogiro ($50 in chips) 
Seat 2: artemxxl ($85.57 in chips) 
Seat 3: pafell ($56.35 in chips) 
Seat 4: v.sting ($50 in chips) 
Seat 5: Nestle170 ($102.73 in chips) 
Seat 6: Kahmi3105 ($222.40 in chips) 
Seat 7: bigned1975 ($49.50 in chips) 
Seat 8: Gluck35 ($64.74 in chips) 
Seat 9: korrastaja ($50 in chips) 
korrastaja: posts small blind $0.25
Corlogiro: posts big blind $0.50
*** HOLE CARDS ***
artemxxl: folds 
pafell: folds 
v.sting: folds 
Nestle170: folds 
Kahmi3105: raises $1.25 to $1.75
bigned1975: folds 
Gluck35: folds 
korrastaja: folds 
Corlogiro: folds 
Uncalled bet ($1.25) returned to Kahmi3105
Kahmi3105 collected $1.25 from pot
*** SUMMARY ***
Total pot $1.25 | Rake $0 
Seat 1: Corlogiro (big blind) folded before Flop
Seat 2: artemxxl folded before Flop (didn't bet)
Seat 3: pafell folded before Flop (didn't bet)
Seat 4: v.sting folded before Flop (didn't bet)
Seat 5: Nestle170 folded before Flop (didn't bet)
Seat 6: Kahmi3105 collected ($1.25)
Seat 7: bigned1975 folded before Flop (didn't bet)
Seat 8: Gluck35 (button) folded before Flop (didn't bet)
Seat 9: korrastaja (small blind) folded before Flop



PokerStars Hand #228688040699:  Hold'em No Limit ($0.25/$0.50 USD) - 2021/07/30 16:11:46 ET
Table 'Aitne III' 9-max Seat #9 is the button
Seat 1: Corlogiro ($50 in chips) 
Seat 2: artemxxl ($85.57 in chips) 
Seat 3: pafell ($56.35 in chips) 
Seat 4: v.sting ($50 in chips) 
Seat 5: Nestle170 ($102.73 in chips) 
Seat 6: Kahmi3105 ($223.15 in chips) 
Seat 7: bigned1975 ($49.50 in chips) 
Seat 8: Gluck35 ($64.74 in chips) 
Seat 9: korrastaja ($50 in chips) 
Corlogiro: posts small blind $0.25
artemxxl: posts big blind $0.50
*** HOLE CARDS ***
pafell: folds 
v.sting: folds 
Nestle170: folds 
Kahmi3105: calls $0.50
bigned1975: raises $2 to $2.50
Gluck35: folds 
korrastaja: folds 
Corlogiro: folds 
artemxxl: folds 
Kahmi3105: calls $2
*** FLOP *** [6s Qd 5d]
Kahmi3105: checks 
bigned1975: bets $3.50
Kahmi3105: folds 
Uncalled bet ($3.50) returned to bigned1975
bigned1975 collected $5.46 from pot
bigned1975: doesn't show hand 
*** SUMMARY ***
Total pot $5.75 | Rake $0.29 
Board [6s Qd 5d]
Seat 1: Corlogiro (small blind) folded before Flop
Seat 2: artemxxl (big blind) folded before Flop
Seat 3: pafell folded before Flop (didn't bet)
Seat 4: v.sting folded before Flop (didn't bet)
Seat 5: Nestle170 folded before Flop (didn't bet)
Seat 6: Kahmi3105 folded on the Flop
Seat 7: bigned1975 collected ($5.46)
Seat 8: Gluck35 folded before Flop (didn't bet)
Seat 9: korrastaja (button) folded before Flop (didn't bet)



PokerStars Hand #228688057375:  Hold'em No Limit ($0.25/$0.50 USD) - 2021/07/30 16:12:23 ET
Table 'Aitne III' 9-max Seat #1 is the button
Seat 1: Corlogiro ($50 in chips) 
Seat 2: artemxxl ($85.07 in chips) 
Seat 3: pafell ($56.35 in chips) 
Seat 4: v.sting ($50 in chips) 
Seat 5: Nestle170 ($102.73 in chips) 
Seat 6: Kahmi3105 ($220.65 in chips) 
Seat 7: bigned1975 ($52.46 in chips) 
Seat 8: Gluck35 ($64.74 in chips) 
Seat 9: korrastaja ($50 in chips) 
artemxxl: posts small blind $0.25
pafell: posts big blind $0.50
*** HOLE CARDS ***
v.sting: folds 
Nestle170: folds 
Kahmi3105: folds 
bigned1975: raises $1 to $1.50
Gluck35: raises $3 to $4.50
korrastaja: folds 
Corlogiro: folds 
artemxxl: folds 
pafell: folds 
bigned1975: calls $3
*** FLOP *** [Jh 8h Kc]
bigned1975: checks 
Gluck35: bets $3.06
bigned1975: calls $3.06
*** TURN *** [Jh 8h Kc] [3d]
bigned1975: checks 
Gluck35: checks 
*** RIVER *** [Jh 8h Kc 3d] [Kh]
bigned1975: bets $11.75
Gluck35: folds 
Uncalled bet ($11.75) returned to bigned1975
bigned1975 collected $15.08 from pot
bigned1975: doesn't show hand 
*** SUMMARY ***
Total pot $15.87 | Rake $0.79 
Board [Jh 8h Kc 3d Kh]
Seat 1: Corlogiro (button) folded before Flop (didn't bet)
Seat 2: artemxxl (small blind) folded before Flop
Seat 3: pafell (big blind) folded before Flop
Seat 4: v.sting folded before Flop (didn't bet)
Seat 5: Nestle170 folded before Flop (didn't bet)
Seat 6: Kahmi3105 folded before Flop (didn't bet)
Seat 7: bigned1975 collected ($15.08)
Seat 8: Gluck35 folded on the River
Seat 9: korrastaja folded before Flop (didn't bet)



PokerStars Hand #228688101700:  Hold'em No Limit ($0.25/$0.50 USD) - 2021/07/30 16:13:58 ET
Table 'Aitne III' 9-max Seat #2 is the button
Seat 1: Corlogiro ($50 in chips) 
Seat 2: artemxxl ($84.82 in chips) 
Seat 3: pafell ($55.85 in chips) 
Seat 4: v.sting ($50 in chips) 
Seat 5: Nestle170 ($102.73 in chips) 
Seat 6: Kahmi3105 ($220.65 in chips) 
Seat 7: bigned1975 ($59.98 in chips) 
Seat 8: Gluck35 ($57.18 in chips) 
Seat 9: korrastaja ($50 in chips) 
pafell: posts small blind $0.25
v.sting: posts big blind $0.50
*** HOLE CARDS ***
Nestle170: folds 
Kahmi3105: folds 
bigned1975: folds 
Gluck35: folds 
korrastaja: folds 
Corlogiro: raises $0.75 to $1.25
artemxxl: folds 
pafell: calls $1
v.sting: folds 
*** FLOP *** [Js 7c Qd]
pafell: checks 
Corlogiro: bets $1.45
pafell: folds 
Uncalled bet ($1.45) returned to Corlogiro
Corlogiro collected $2.81 from pot
Corlogiro: doesn't show hand 
*** SUMMARY ***
Total pot $3 | Rake $0.19 
Board [Js 7c Qd]
Seat 1: Corlogiro collected ($2.81)
Seat 2: artemxxl (button) folded before Flop (didn't bet)
Seat 3: pafell (small blind) folded on the Flop
Seat 4: v.sting (big blind) folded before Flop
Seat 5: Nestle170 folded before Flop (didn't bet)
Seat 6: Kahmi3105 folded before Flop (didn't bet)
Seat 7: bigned1975 folded before Flop (didn't bet)
Seat 8: Gluck35 folded before Flop (didn't bet)
Seat 9: korrastaja folded before Flop (didn't bet)



PokerStars Hand #228688118193:  Hold'em No Limit ($0.25/$0.50 USD) - 2021/07/30 16:14:33 ET
Table 'Aitne III' 9-max Seat #3 is the button
Seat 1: Corlogiro ($51.56 in chips) 
Seat 2: artemxxl ($84.82 in chips) 
Seat 3: pafell ($54.60 in chips) 
Seat 4: v.sting ($50 in chips) 
Seat 5: Nestle170 ($102.73 in chips) 
Seat 6: Kahmi3105 ($220.65 in chips) 
Seat 7: bigned1975 ($59.98 in chips) 
Seat 8: Gluck35 ($57.18 in chips) 
Seat 9: korrastaja ($50 in chips) 
v.sting: posts small blind $0.25
Nestle170: posts big blind $0.50
*** HOLE CARDS ***
Kahmi3105: folds 
bigned1975: folds 
Gluck35: folds 
korrastaja: raises $0.50 to $1
Corlogiro: folds 
artemxxl: folds 
pafell: calls $1
v.sting: folds 
Nestle170: folds 
*** FLOP *** [Qh Qd 9s]
korrastaja: bets $1.44
pafell: calls $1.44
*** TURN *** [Qh Qd 9s] [5h]
korrastaja: bets $2.94
pafell: folds 
Uncalled bet ($2.94) returned to korrastaja
korrastaja collected $5.35 from pot
korrastaja: doesn't show hand 
*** SUMMARY ***
Total pot $5.63 | Rake $0.28 
Board [Qh Qd 9s 5h]
Seat 1: Corlogiro folded before Flop (didn't bet)
Seat 2: artemxxl folded before Flop (didn't bet)
Seat 3: pafell (button) folded on the Turn
Seat 4: v.sting (small blind) folded before Flop
Seat 5: Nestle170 (big blind) folded before Flop
Seat 6: Kahmi3105 folded before Flop (didn't bet)
Seat 7: bigned1975 folded before Flop (didn't bet)
Seat 8: Gluck35 folded before Flop (didn't bet)
Seat 9: korrastaja collected ($5.35)



PokerStars Hand #228688131448:  Hold'em No Limit ($0.25/$0.50 USD) - 2021/07/30 16:15:02 ET
Table 'Aitne III' 9-max Seat #4 is the button
Seat 1: Corlogiro ($51.56 in chips) 
Seat 2: artemxxl ($84.82 in chips) 
Seat 3: pafell ($52.16 in chips) 
Seat 4: v.sting ($50 in chips) 
Seat 5: Nestle170 ($102.23 in chips) 
Seat 6: Kahmi3105 ($220.65 in chips) 
Seat 7: bigned1975 ($59.98 in chips) 
Seat 8: Gluck35 ($57.18 in chips) 
Seat 9: korrastaja ($52.91 in chips) 
Nestle170: posts small blind $0.25
Kahmi3105: posts big blind $0.50
*** HOLE CARDS ***
bigned1975: folds 
Gluck35: folds 
korrastaja: folds 
Corlogiro: folds 
artemxxl: folds 
pafell: calls $0.50
v.sting: raises $2 to $2.50
Nestle170: folds 
Kahmi3105: folds 
pafell: calls $2
*** FLOP *** [8d 6s 6c]
pafell: checks 
v.sting: bets $1.80
pafell: calls $1.80
*** TURN *** [8d 6s 6c] [3s]
pafell: checks 
v.sting: checks 
*** RIVER *** [8d 6s 6c 3s] [Kc]
pafell: checks 
v.sting: checks 
*** SHOW DOWN ***
pafell: shows [Th Ks] (two pair, Kings and Sixes)
v.sting: mucks hand 
pafell collected $8.88 from pot
*** SUMMARY ***
Total pot $9.35 | Rake $0.47 
Board [8d 6s 6c 3s Kc]
Seat 1: Corlogiro folded before Flop (didn't bet)
Seat 2: artemxxl folded before Flop (didn't bet)
Seat 3: pafell showed [Th Ks] and won ($8.88) with two pair, Kings and Sixes
Seat 4: v.sting (button) mucked
Seat 5: Nestle170 (small blind) folded before Flop
Seat 6: Kahmi3105 (big blind) folded before Flop
Seat 7: bigned1975 folded before Flop (didn't bet)
Seat 8: Gluck35 folded before Flop (didn't bet)
Seat 9: korrastaja folded before Flop (didn't bet)



PokerStars Hand #228688164140:  Hold'em No Limit ($0.25/$0.50 USD) - 2021/07/30 16:15:59 ET
Table 'Aitne III' 9-max Seat #5 is the button
Seat 1: Corlogiro ($51.56 in chips) 
Seat 2: artemxxl ($84.82 in chips) 
Seat 3: pafell ($56.74 in chips) 
Seat 4: v.sting ($50 in chips) 
Seat 5: Nestle170 ($101.98 in chips) 
Seat 6: Kahmi3105 ($220.15 in chips) 
Seat 7: bigned1975 ($59.98 in chips) 
Seat 8: Gluck35 ($57.18 in chips) 
Seat 9: korrastaja ($52.91 in chips) 
Kahmi3105: posts small blind $0.25
bigned1975: posts big blind $0.50
*** HOLE CARDS ***
Gluck35: folds 
korrastaja: folds 
Corlogiro: folds 
artemxxl: folds 
pafell: folds 
v.sting: folds 
Nestle170: folds 
Kahmi3105: calls $0.25
bigned1975: checks 
*** FLOP *** [Ad 8s 4h]
Kahmi3105: checks 
bigned1975: bets $0.50
Kahmi3105: folds 
Uncalled bet ($0.50) returned to bigned1975
bigned1975 collected $0.95 from pot
bigned1975: doesn't show hand 
*** SUMMARY ***
Total pot $1 | Rake $0.05 
Board [Ad 8s 4h]
Seat 1: Corlogiro folded before Flop (didn't bet)
Seat 2: artemxxl folded before Flop (didn't bet)
Seat 3: pafell folded before Flop (didn't bet)
Seat 4: v.sting folded before Flop (didn't bet)
Seat 5: Nestle170 (button) folded before Flop (didn't bet)
Seat 6: Kahmi3105 (small blind) folded on the Flop
Seat 7: bigned1975 (big blind) collected ($0.95)
Seat 8: Gluck35 folded before Flop (didn't bet)
Seat 9: korrastaja folded before Flop (didn't bet)



PokerStars Hand #228688178165:  Hold'em No Limit ($0.25/$0.50 USD) - 2021/07/30 16:16:28 ET
Table 'Aitne III' 9-max Seat #6 is the button
Seat 1: Corlogiro ($51.56 in chips) 
Seat 2: artemxxl ($84.82 in chips) 
Seat 3: pafell ($56.74 in chips) 
Seat 4: v.sting ($50 in chips) 
Seat 5: Nestle170 ($101.98 in chips) 
Seat 6: Kahmi3105 ($219.65 in chips) 
Seat 7: bigned1975 ($60.43 in chips) 
Seat 8: Gluck35 ($57.18 in chips) 
Seat 9: korrastaja ($52.91 in chips) 
bigned1975: posts small blind $0.25
Gluck35: posts big blind $0.50
*** HOLE CARDS ***
korrastaja: raises $0.50 to $1
Corlogiro: folds 
artemxxl: folds 
pafell: folds 
v.sting: folds 
Nestle170: folds 
Kahmi3105: raises $3.50 to $4.50
bigned1975: folds 
Gluck35: folds 
korrastaja: calls $3.50
*** FLOP *** [4s 8s 7h]
korrastaja: checks 
Kahmi3105: checks 
*** TURN *** [4s 8s 7h] [Js]
korrastaja: bets $5.09
Kahmi3105: folds 
Uncalled bet ($5.09) returned to korrastaja
korrastaja collected $9.26 from pot
korrastaja: doesn't show hand 
*** SUMMARY ***
Total pot $9.75 | Rake $0.49 
Board [4s 8s 7h Js]
Seat 1: Corlogiro folded before Flop (didn't bet)
Seat 2: artemxxl folded before Flop (didn't bet)
Seat 3: pafell folded before Flop (didn't bet)
Seat 4: v.sting folded before Flop (didn't bet)
Seat 5: Nestle170 folded before Flop (didn't bet)
Seat 6: Kahmi3105 (button) folded on the Turn
Seat 7: bigned1975 (small blind) folded before Flop
Seat 8: Gluck35 (big blind) folded before Flop
Seat 9: korrastaja collected ($9.26)



PokerStars Hand #228688194675:  Hold'em No Limit ($0.25/$0.50 USD) - 2021/07/30 16:17:02 ET
Table 'Aitne III' 9-max Seat #7 is the button
Seat 1: Corlogiro ($51.56 in chips) 
Seat 2: artemxxl ($84.82 in chips) 
Seat 3: pafell ($56.74 in chips) 
Seat 4: v.sting ($50 in chips) 
Seat 5: Nestle170 ($101.98 in chips) 
Seat 6: Kahmi3105 ($215.15 in chips) 
Seat 7: bigned1975 ($60.18 in chips) 
Seat 8: Gluck35 ($56.68 in chips) 
Seat 9: korrastaja ($57.67 in chips) 
Gluck35: posts small blind $0.25
korrastaja: posts big blind $0.50
*** HOLE CARDS ***
Corlogiro: folds 
artemxxl: folds 
pafell: folds 
v.sting: folds 
Nestle170: folds 
Kahmi3105: folds 
bigned1975: folds 
Gluck35: raises $1 to $1.50
korrastaja: folds 
Uncalled bet ($1) returned to Gluck35
Gluck35 collected $1 from pot
Gluck35: doesn't show hand 
*** SUMMARY ***
Total pot $1 | Rake $0 
Seat 1: Corlogiro folded before Flop (didn't bet)
Seat 2: artemxxl folded before Flop (didn't bet)
Seat 3: pafell folded before Flop (didn't bet)
Seat 4: v.sting folded before Flop (didn't bet)
Seat 5: Nestle170 folded before Flop (didn't bet)
Seat 6: Kahmi3105 folded before Flop (didn't bet)
Seat 7: bigned1975 (button) folded before Flop (didn't bet)
Seat 8: Gluck35 (small blind) collected ($1)
Seat 9: korrastaja (big blind) folded before Flop



PokerStars Hand #228688213014:  Hold'em No Limit ($0.25/$0.50 USD) - 2021/07/30 16:17:40 ET
Table 'Aitne III' 9-max Seat #8 is the button
Seat 1: Corlogiro ($51.56 in chips) 
Seat 2: artemxxl ($84.82 in chips) 
Seat 3: pafell ($56.74 in chips) 
Seat 4: v.sting ($50 in chips) 
Seat 5: Nestle170 ($101.98 in chips) 
Seat 6: Kahmi3105 ($215.15 in chips) 
Seat 7: bigned1975 ($60.18 in chips) 
Seat 8: Gluck35 ($57.18 in chips) 
Seat 9: korrastaja ($57.17 in chips) 
korrastaja: posts small blind $0.25
Corlogiro: posts big blind $0.50
*** HOLE CARDS ***
artemxxl: folds 
pafell: calls $0.50
v.sting: folds 
Nestle170: folds 
Kahmi3105: folds 
bigned1975: folds 
Gluck35: raises $1.50 to $2
korrastaja: folds 
Corlogiro: folds 
pafell: calls $1.50
*** FLOP *** [4s Qs Kh]
pafell: checks 
Gluck35: bets $2.50
pafell: raises $6.50 to $9
Gluck35: calls $6.50
*** TURN *** [4s Qs Kh] [As]
pafell: bets $10.80
Gluck35: calls $10.80
*** RIVER *** [4s Qs Kh As] [Jc]
pafell: bets $21.17
Gluck35: calls $21.17
*** SHOW DOWN ***
pafell: shows [Qh Kc] (two pair, Kings and Queens)
Gluck35: shows [Td Jd] (a straight, Ten to Ace)
Gluck35 collected $84.69 from pot
*** SUMMARY ***
Total pot $86.69 | Rake $2 
Board [4s Qs Kh As Jc]
Seat 1: Corlogiro (big blind) folded before Flop
Seat 2: artemxxl folded before Flop (didn't bet)
Seat 3: pafell showed [Qh Kc] and lost with two pair, Kings and Queens
Seat 4: v.sting folded before Flop (didn't bet)
Seat 5: Nestle170 folded before Flop (didn't bet)
Seat 6: Kahmi3105 folded before Flop (didn't bet)
Seat 7: bigned1975 folded before Flop (didn't bet)
Seat 8: Gluck35 (button) showed [Td Jd] and won ($84.69) with a straight, Ten to Ace
Seat 9: korrastaja (small blind) folded before Flop



PokerStars Hand #228688250272:  Hold'em No Limit ($0.25/$0.50 USD) - 2021/07/30 16:18:56 ET
Table 'Aitne III' 9-max Seat #9 is the button
Seat 1: Corlogiro ($51.06 in chips) 
Seat 2: artemxxl ($84.82 in chips) 
Seat 3: pafell ($13.77 in chips) 
Seat 4: v.sting ($50 in chips) 
Seat 5: Nestle170 ($101.98 in chips) 
Seat 6: Kahmi3105 ($215.15 in chips) 
Seat 7: bigned1975 ($60.18 in chips) 
Seat 8: Gluck35 ($98.90 in chips) 
Seat 9: korrastaja ($56.92 in chips) 
Corlogiro: posts small blind $0.25
artemxxl: posts big blind $0.50
*** HOLE CARDS ***
pafell: calls $0.50
v.sting: folds 
Nestle170: folds 
Kahmi3105: folds 
bigned1975: folds 
Gluck35: folds 
korrastaja: folds 
Corlogiro: folds 
artemxxl: raises $1.25 to $1.75
pafell: calls $1.25
*** FLOP *** [4h 5s Kc]
artemxxl: bets $1.78
pafell: raises $10.24 to $12.02 and is all-in
artemxxl: calls $10.24
*** TURN *** [4h 5s Kc] [8h]
*** RIVER *** [4h 5s Kc 8h] [8d]
*** SHOW DOWN ***
artemxxl: shows [Ac 5c] (two pair, Eights and Fives)
pafell: shows [9h Kh] (two pair, Kings and Eights)
pafell collected $26.40 from pot
*** SUMMARY ***
Total pot $27.79 | Rake $1.39 
Board [4h 5s Kc 8h 8d]
Seat 1: Corlogiro (small blind) folded before Flop
Seat 2: artemxxl (big blind) showed [Ac 5c] and lost with two pair, Eights and Fives
Seat 3: pafell showed [9h Kh] and won ($26.40) with two pair, Kings and Eights
Seat 4: v.sting folded before Flop (didn't bet)
Seat 5: Nestle170 folded before Flop (didn't bet)
Seat 6: Kahmi3105 folded before Flop (didn't bet)
Seat 7: bigned1975 folded before Flop (didn't bet)
Seat 8: Gluck35 folded before Flop (didn't bet)
Seat 9: korrastaja (button) folded before Flop (didn't bet)



PokerStars Hand #228688268885:  Hold'em No Limit ($0.25/$0.50 USD) - 2021/07/30 16:19:34 ET
Table 'Aitne III' 9-max Seat #1 is the button
Seat 1: Corlogiro ($50.81 in chips) 
Seat 2: artemxxl ($71.05 in chips) 
Seat 3: pafell ($26.40 in chips) 
Seat 4: v.sting ($50 in chips) 
Seat 5: Nestle170 ($101.98 in chips) 
Seat 6: Kahmi3105 ($215.15 in chips) 
Seat 7: bigned1975 ($60.18 in chips) 
Seat 8: Gluck35 ($98.90 in chips) 
Seat 9: korrastaja ($56.92 in chips) 
artemxxl: posts small blind $0.25
pafell: posts big blind $0.50
*** HOLE CARDS ***
v.sting: folds 
Nestle170: raises $1 to $1.50
Kahmi3105: folds 
bigned1975: folds 
Gluck35: folds 
korrastaja: folds 
Corlogiro: folds 
artemxxl: folds 
pafell: calls $1
*** FLOP *** [Jd 4s 6d]
pafell: checks 
Nestle170: bets $2.32
pafell: raises $22.58 to $24.90 and is all-in
Nestle170: calls $22.58
*** TURN *** [Jd 4s 6d] [9s]
*** RIVER *** [Jd 4s 6d 9s] [Ks]
*** SHOW DOWN ***
pafell: shows [6c 5h] (a pair of Sixes)
Nestle170: shows [Qs Qd] (a pair of Queens)
Nestle170 collected $51.05 from pot
*** SUMMARY ***
Total pot $53.05 | Rake $2 
Board [Jd 4s 6d 9s Ks]
Seat 1: Corlogiro (button) folded before Flop (didn't bet)
Seat 2: artemxxl (small blind) folded before Flop
Seat 3: pafell (big blind) showed [6c 5h] and lost with a pair of Sixes
Seat 4: v.sting folded before Flop (didn't bet)
Seat 5: Nestle170 showed [Qs Qd] and won ($51.05) with a pair of Queens
Seat 6: Kahmi3105 folded before Flop (didn't bet)
Seat 7: bigned1975 folded before Flop (didn't bet)
Seat 8: Gluck35 folded before Flop (didn't bet)
Seat 9: korrastaja folded before Flop (didn't bet)



PokerStars Hand #228688291745:  Hold'em No Limit ($0.25/$0.50 USD) - 2021/07/30 16:20:21 ET
Table 'Aitne III' 9-max Seat #2 is the button
Seat 1: Corlogiro ($50.81 in chips) 
Seat 2: artemxxl ($70.80 in chips) 
Seat 4: v.sting ($50 in chips) 
Seat 5: Nestle170 ($126.63 in chips) 
Seat 6: Kahmi3105 ($215.15 in chips) 
Seat 7: bigned1975 ($60.18 in chips) 
Seat 8: Gluck35 ($98.90 in chips) 
Seat 9: korrastaja ($56.92 in chips) 
v.sting: posts small blind $0.25
Nestle170: posts big blind $0.50
*** HOLE CARDS ***
Kahmi3105: raises $1.25 to $1.75
bigned1975: folds 
Gluck35: folds 
korrastaja: folds 
pafell is disconnected 
Corlogiro: folds 
artemxxl: folds 
v.sting: folds 
Nestle170: folds 
Uncalled bet ($1.25) returned to Kahmi3105
Kahmi3105 collected $1.25 from pot
*** SUMMARY ***
Total pot $1.25 | Rake $0 
Seat 1: Corlogiro folded before Flop (didn't bet)
Seat 2: artemxxl (button) folded before Flop (didn't bet)
Seat 4: v.sting (small blind) folded before Flop
Seat 5: Nestle170 (big blind) folded before Flop
Seat 6: Kahmi3105 collected ($1.25)
Seat 7: bigned1975 folded before Flop (didn't bet)
Seat 8: Gluck35 folded before Flop (didn't bet)
Seat 9: korrastaja folded before Flop (didn't bet)



PokerStars Hand #228688299771:  Hold'em No Limit ($0.25/$0.50 USD) - 2021/07/30 16:20:38 ET
Table 'Aitne III' 9-max Seat #4 is the button
Seat 1: Corlogiro ($50.81 in chips) 
Seat 2: artemxxl ($70.80 in chips) 
Seat 4: v.sting ($50 in chips) 
Seat 5: Nestle170 ($126.13 in chips) 
Seat 6: Kahmi3105 ($215.90 in chips) 
Seat 7: bigned1975 ($60.18 in chips) 
Seat 8: Gluck35 ($98.90 in chips) 
Seat 9: korrastaja ($56.92 in chips) 
Nestle170: posts small blind $0.25
Kahmi3105: posts big blind $0.50
*** HOLE CARDS ***
bigned1975: folds 
Gluck35: folds 
korrastaja: raises $0.50 to $1
Corlogiro: calls $1
artemxxl: folds 
v.sting: folds 
Nestle170: folds 
Kahmi3105: calls $0.50
*** FLOP *** [Kh 5d 9d]
Kahmi3105: checks 
korrastaja: checks 
Corlogiro: checks 
*** TURN *** [Kh 5d 9d] [6d]
Kahmi3105: bets $3.09
korrastaja: folds 
Corlogiro: folds 
Uncalled bet ($3.09) returned to Kahmi3105
Kahmi3105 collected $3.05 from pot
*** SUMMARY ***
Total pot $3.25 | Rake $0.20 
Board [Kh 5d 9d 6d]
Seat 1: Corlogiro folded on the Turn
Seat 2: artemxxl folded before Flop (didn't bet)
Seat 4: v.sting (button) folded before Flop (didn't bet)
Seat 5: Nestle170 (small blind) folded before Flop
Seat 6: Kahmi3105 (big blind) collected ($3.05)
Seat 7: bigned1975 folded before Flop (didn't bet)
Seat 8: Gluck35 folded before Flop (didn't bet)
Seat 9: korrastaja folded on the Turn



PokerStars Hand #228688321450:  Hold'em No Limit ($0.25/$0.50 USD) - 2021/07/30 16:21:22 ET
Table 'Aitne III' 9-max Seat #5 is the button
Seat 1: Corlogiro ($50 in chips) 
Seat 2: artemxxl ($70.80 in chips) 
Seat 4: v.sting ($50 in chips) 
Seat 5: Nestle170 ($125.88 in chips) 
Seat 6: Kahmi3105 ($217.95 in chips) 
Seat 7: bigned1975 ($60.18 in chips) 
Seat 8: Gluck35 ($98.90 in chips) 
Seat 9: korrastaja ($55.92 in chips) 
Kahmi3105: posts small blind $0.25
bigned1975: posts big blind $0.50
*** HOLE CARDS ***
Gluck35: folds 
korrastaja: folds 
Corlogiro: folds 
artemxxl: folds 
v.sting: raises $0.75 to $1.25
Nestle170: folds 
Kahmi3105: calls $1
bigned1975: calls $0.75
*** FLOP *** [Ts Ks 4h]
Kahmi3105: checks 
bigned1975: checks 
v.sting: bets $1.17
Kahmi3105: folds 
bigned1975: folds 
Uncalled bet ($1.17) returned to v.sting
v.sting collected $3.56 from pot
v.sting: doesn't show hand 
*** SUMMARY ***
Total pot $3.75 | Rake $0.19 
Board [Ts Ks 4h]
Seat 1: Corlogiro folded before Flop (didn't bet)
Seat 2: artemxxl folded before Flop (didn't bet)
Seat 4: v.sting collected ($3.56)
Seat 5: Nestle170 (button) folded before Flop (didn't bet)
Seat 6: Kahmi3105 (small blind) folded on the Flop
Seat 7: bigned1975 (big blind) folded on the Flop
Seat 8: Gluck35 folded before Flop (didn't bet)
Seat 9: korrastaja folded before Flop (didn't bet)



PokerStars Hand #228688339056:  Hold'em No Limit ($0.25/$0.50 USD) - 2021/07/30 16:21:59 ET
Table 'Aitne III' 9-max Seat #6 is the button
Seat 1: Corlogiro ($50 in chips) 
Seat 2: artemxxl ($70.80 in chips) 
Seat 4: v.sting ($52.31 in chips) 
Seat 5: Nestle170 ($125.88 in chips) 
Seat 6: Kahmi3105 ($216.70 in chips) 
Seat 7: bigned1975 ($58.93 in chips) 
Seat 8: Gluck35 ($98.90 in chips) 
Seat 9: korrastaja ($55.92 in chips) 
bigned1975: posts small blind $0.25
Gluck35: posts big blind $0.50
*** HOLE CARDS ***
korrastaja: folds 
Corlogiro: folds 
artemxxl: folds 
v.sting: raises $0.75 to $1.25
Nestle170: raises $3.25 to $4.50
Kahmi3105: folds 
bigned1975: folds 
Gluck35: folds 
v.sting: calls $3.25
*** FLOP *** [7c 4h 3s]
v.sting: checks 
Nestle170: bets $3.06
v.sting: folds 
Uncalled bet ($3.06) returned to Nestle170
Nestle170 collected $9.26 from pot
Nestle170: doesn't show hand 
*** SUMMARY ***
Total pot $9.75 | Rake $0.49 
Board [7c 4h 3s]
Seat 1: Corlogiro folded before Flop (didn't bet)
Seat 2: artemxxl folded before Flop (didn't bet)
Seat 4: v.sting folded on the Flop
Seat 5: Nestle170 collected ($9.26)
Seat 6: Kahmi3105 (button) folded before Flop (didn't bet)
Seat 7: bigned1975 (small blind) folded before Flop
Seat 8: Gluck35 (big blind) folded before Flop
Seat 9: korrastaja folded before Flop (didn't bet)



PokerStars Hand #228688370347:  Hold'em No Limit ($0.25/$0.50 USD) - 2021/07/30 16:23:03 ET
Table 'Aitne III' 9-max Seat #7 is the button
Seat 1: Corlogiro ($50 in chips) 
Seat 2: artemxxl ($70.80 in chips) 
Seat 4: v.sting ($50 in chips) 
Seat 5: Nestle170 ($130.64 in chips) 
Seat 6: Kahmi3105 ($216.70 in chips) 
Seat 7: bigned1975 ($58.68 in chips) 
Seat 8: Gluck35 ($98.40 in chips) 
Seat 9: korrastaja ($55.92 in chips) 
Gluck35: posts small blind $0.25
korrastaja: posts big blind $0.50
*** HOLE CARDS ***
Corlogiro: folds 
artemxxl: folds 
v.sting: folds 
Nestle170: folds 
Kahmi3105: raises $1.25 to $1.75
bigned1975: folds 
Gluck35: folds 
korrastaja: calls $1.25
*** FLOP *** [Qs 9c 3c]
korrastaja: checks 
Kahmi3105: bets $2.50
korrastaja: folds 
Uncalled bet ($2.50) returned to Kahmi3105
Kahmi3105 collected $3.51 from pot
*** SUMMARY ***
Total pot $3.75 | Rake $0.24 
Board [Qs 9c 3c]
Seat 1: Corlogiro folded before Flop (didn't bet)
Seat 2: artemxxl folded before Flop (didn't bet)
Seat 4: v.sting folded before Flop (didn't bet)
Seat 5: Nestle170 folded before Flop (didn't bet)
Seat 6: Kahmi3105 collected ($3.51)
Seat 7: bigned1975 (button) folded before Flop (didn't bet)
Seat 8: Gluck35 (small blind) folded before Flop
Seat 9: korrastaja (big blind) folded on the Flop



PokerStars Hand #228688427997:  Hold'em No Limit ($0.25/$0.50 USD) - 2021/07/30 16:25:01 ET
Table 'Aitne III' 9-max Seat #1 is the button
Seat 1: Corlogiro ($50 in chips) 
Seat 2: artemxxl ($76.80 in chips) 
Seat 4: v.sting ($51.59 in chips) 
Seat 5: Nestle170 ($130.64 in chips) 
Seat 6: Kahmi3105 ($218.46 in chips) 
Seat 7: bigned1975 ($58.68 in chips) 
Seat 8: Gluck35 ($98.15 in chips) 
Seat 9: korrastaja ($52.42 in chips) 
artemxxl: posts small blind $0.25
v.sting: posts big blind $0.50
*** HOLE CARDS ***
Nestle170: raises $1 to $1.50
Kahmi3105: raises $3.75 to $5.25
bigned1975: folds 
Gluck35: folds 
korrastaja: folds 
Corlogiro: folds 
artemxxl: folds 
v.sting: folds 
Nestle170: calls $3.75
*** FLOP *** [8c 6s 9h]
Nestle170: checks 
Gluck35 was removed from the table for failing to post
Gluck35 leaves the table
Kahmi3105: bets $6.50
Nestle170: folds 
Uncalled bet ($6.50) returned to Kahmi3105
Kahmi3105 collected $10.55 from pot
*** SUMMARY ***
Total pot $11.25 | Rake $0.70 
Board [8c 6s 9h]
Seat 1: Corlogiro (button) folded before Flop (didn't bet)
Seat 2: artemxxl (small blind) folded before Flop
Seat 4: v.sting (big blind) folded before Flop
Seat 5: Nestle170 folded on the Flop
Seat 6: Kahmi3105 collected ($10.55)
Seat 7: bigned1975 folded before Flop (didn't bet)
Seat 8: Gluck35 folded before Flop (didn't bet)
Seat 9: korrastaja folded before Flop (didn't bet)



PokerStars Hand #228688444517:  Hold'em No Limit ($0.25/$0.50 USD) - 2021/07/30 16:25:35 ET
Table 'Aitne III' 9-max Seat #2 is the button
Seat 1: Corlogiro ($50 in chips) 
Seat 2: artemxxl ($76.55 in chips) 
Seat 4: v.sting ($51.09 in chips) 
Seat 6: Kahmi3105 ($223.76 in chips) 
Seat 7: bigned1975 ($58.68 in chips) 
Seat 9: korrastaja ($52.42 in chips) 
v.sting: posts small blind $0.25
Nestle170: is sitting out 
Kahmi3105: posts big blind $0.50
*** HOLE CARDS ***
Nestle170 leaves the table
bigned1975: folds 
korrastaja: raises $0.50 to $1
Corlogiro: folds 
artemxxl: folds 
v.sting: folds 
sonova joins the table at seat #8 
Kahmi3105: folds 
Uncalled bet ($0.50) returned to korrastaja
korrastaja collected $1.25 from pot
korrastaja: doesn't show hand 
*** SUMMARY ***
Total pot $1.25 | Rake $0 
Seat 1: Corlogiro folded before Flop (didn't bet)
Seat 2: artemxxl (button) folded before Flop (didn't bet)
Seat 4: v.sting (small blind) folded before Flop
Seat 6: Kahmi3105 (big blind) folded before Flop
Seat 7: bigned1975 folded before Flop (didn't bet)
Seat 9: korrastaja collected ($1.25)



PokerStars Hand #228688454246:  Hold'em No Limit ($0.25/$0.50 USD) - 2021/07/30 16:25:55 ET
Table 'Aitne III' 9-max Seat #4 is the button
Seat 1: Corlogiro ($50 in chips) 
Seat 2: artemxxl ($76.55 in chips) 
Seat 4: v.sting ($50.84 in chips) 
Seat 6: Kahmi3105 ($223.26 in chips) 
Seat 7: bigned1975 ($58.68 in chips) 
Seat 9: korrastaja ($53.17 in chips) 
Kahmi3105: posts small blind $0.25
bigned1975: posts big blind $0.50
sonova: sits out 
*** HOLE CARDS ***
korrastaja: folds 
pafell leaves the table
Corlogiro: folds 
artemxxl: raises $0.75 to $1.25
v.sting: folds 
Kahmi3105: folds 
bigned1975: calls $0.75
*** FLOP *** [4c 9c 9d]
bigned1975: checks 
artemxxl: checks 
*** TURN *** [4c 9c 9d] [8c]
bigned1975: checks 
artemxxl: checks 
*** RIVER *** [4c 9c 9d 8c] [5c]
bigned1975: checks 
Cressy21 joins the table at seat #3 
artemxxl: checks 
*** SHOW DOWN ***
bigned1975: shows [5h 7h] (two pair, Nines and Fives)
lulu19911991 joins the table at seat #5 
artemxxl: mucks hand 
bigned1975 collected $2.61 from pot
*** SUMMARY ***
Total pot $2.75 | Rake $0.14 
Board [4c 9c 9d 8c 5c]
Seat 1: Corlogiro folded before Flop (didn't bet)
Seat 2: artemxxl mucked
Seat 4: v.sting (button) folded before Flop (didn't bet)
Seat 6: Kahmi3105 (small blind) folded before Flop
Seat 7: bigned1975 (big blind) showed [5h 7h] and won ($2.61) with two pair, Nines and Fives
Seat 9: korrastaja folded before Flop (didn't bet)



PokerStars Hand #228688477939:  Hold'em No Limit ($0.25/$0.50 USD) - 2021/07/30 16:26:44 ET
Table 'Aitne III' 9-max Seat #6 is the button
Seat 1: Corlogiro ($50 in chips) 
Seat 2: artemxxl ($75.30 in chips) 
Seat 4: v.sting ($50.84 in chips) 
Seat 6: Kahmi3105 ($223.01 in chips) 
Seat 7: bigned1975 ($60.04 in chips) 
Seat 8: sonova ($50 in chips) 
Seat 9: korrastaja ($53.17 in chips) 
bigned1975: posts small blind $0.25
sonova: posts big blind $0.50
Cressy21: sits out 
lulu19911991: sits out 
*** HOLE CARDS ***
korrastaja: folds 
Corlogiro: folds 
artemxxl: folds 
v.sting: folds 
Kahmi3105: folds 
bigned1975: folds 
Uncalled bet ($0.25) returned to sonova
sonova collected $0.50 from pot
sonova: doesn't show hand 
*** SUMMARY ***
Total pot $0.50 | Rake $0 
Seat 1: Corlogiro folded before Flop (didn't bet)
Seat 2: artemxxl folded before Flop (didn't bet)
Seat 4: v.sting folded before Flop (didn't bet)
Seat 6: Kahmi3105 (button) folded before Flop (didn't bet)
Seat 7: bigned1975 (small blind) folded before Flop
Seat 8: sonova (big blind) collected ($0.50)
Seat 9: korrastaja folded before Flop (didn't bet)



PokerStars Hand #228688486251:  Hold'em No Limit ($0.25/$0.50 USD) - 2021/07/30 16:27:01 ET
Table 'Aitne III' 9-max Seat #7 is the button
Seat 1: Corlogiro ($50 in chips) 
Seat 2: artemxxl ($75.30 in chips) 
Seat 4: v.sting ($50.84 in chips) 
Seat 6: Kahmi3105 ($223.01 in chips) 
Seat 7: bigned1975 ($59.79 in chips) 
Seat 8: sonova ($50.25 in chips) 
Seat 9: korrastaja ($53.17 in chips) 
sonova: posts small blind $0.25
korrastaja: posts big blind $0.50
Cressy21: sits out 
lulu19911991: sits out 
*** HOLE CARDS ***
Corlogiro: folds 
artemxxl has timed out
artemxxl: folds 
v.sting: folds 
Kahmi3105: folds 
bigned1975: folds 
sonova: folds 
Uncalled bet ($0.25) returned to korrastaja
korrastaja collected $0.50 from pot
korrastaja: doesn't show hand 
*** SUMMARY ***
Total pot $0.50 | Rake $0 
Seat 1: Corlogiro folded before Flop (didn't bet)
Seat 2: artemxxl folded before Flop (didn't bet)
Seat 4: v.sting folded before Flop (didn't bet)
Seat 6: Kahmi3105 folded before Flop (didn't bet)
Seat 7: bigned1975 (button) folded before Flop (didn't bet)
Seat 8: sonova (small blind) folded before Flop
Seat 9: korrastaja (big blind) collected ($0.50)



PokerStars Hand #228688498772:  Hold'em No Limit ($0.25/$0.50 USD) - 2021/07/30 16:27:28 ET
Table 'Aitne III' 9-max Seat #8 is the button
Seat 1: Corlogiro ($50 in chips) 
Seat 3: Cressy21 ($40 in chips) 
Seat 4: v.sting ($50.84 in chips) 
Seat 6: Kahmi3105 ($223.01 in chips) 
Seat 7: bigned1975 ($59.79 in chips) 
Seat 8: sonova ($50 in chips) 
Seat 9: korrastaja ($53.42 in chips) 
korrastaja: posts small blind $0.25
Corlogiro: posts big blind $0.50
Cressy21: posts big blind $0.50
lulu19911991: sits out 
*** HOLE CARDS ***
Cressy21: checks 
v.sting: folds 
Kahmi3105: folds 
bigned1975: folds 
lulu19911991 leaves the table
sonova: raises $1.75 to $2.25
korrastaja: folds 
Corlogiro: folds 
Cressy21: folds 
Uncalled bet ($1.75) returned to sonova
sonova collected $1.75 from pot
sonova: doesn't show hand 
*** SUMMARY ***
Total pot $1.75 | Rake $0 
Seat 1: Corlogiro (big blind) folded before Flop
Seat 3: Cressy21 folded before Flop (didn't bet)
Seat 4: v.sting folded before Flop (didn't bet)
Seat 6: Kahmi3105 folded before Flop (didn't bet)
Seat 7: bigned1975 folded before Flop (didn't bet)
Seat 8: sonova (button) collected ($1.75)
Seat 9: korrastaja (small blind) folded before Flop



PokerStars Hand #228688512965:  Hold'em No Limit ($0.25/$0.50 USD) - 2021/07/30 16:27:57 ET
Table 'Aitne III' 9-max Seat #9 is the button
Seat 1: Corlogiro ($50 in chips) 
Seat 3: Cressy21 ($39.50 in chips) 
Seat 4: v.sting ($50.84 in chips) 
Seat 6: Kahmi3105 ($223.01 in chips) 
Seat 7: bigned1975 ($59.79 in chips) 
Seat 8: sonova ($51.25 in chips) 
Seat 9: korrastaja ($53.17 in chips) 
Corlogiro: posts small blind $0.25
Cressy21: posts big blind $0.50
*** HOLE CARDS ***
lonely fire joins the table at seat #5 
v.sting: folds 
Kahmi3105: folds 
bigned1975: folds 
sonova: folds 
korrastaja: raises $1 to $1.50
Corlogiro: folds 
Cressy21: folds 
Uncalled bet ($1) returned to korrastaja
korrastaja collected $1.25 from pot
korrastaja: doesn't show hand 
*** SUMMARY ***
Total pot $1.25 | Rake $0 
Seat 1: Corlogiro (small blind) folded before Flop
Seat 3: Cressy21 (big blind) folded before Flop
Seat 4: v.sting folded before Flop (didn't bet)
Seat 6: Kahmi3105 folded before Flop (didn't bet)
Seat 7: bigned1975 folded before Flop (didn't bet)
Seat 8: sonova folded before Flop (didn't bet)
Seat 9: korrastaja (button) collected ($1.25)



PokerStars Hand #228688520459:  Hold'em No Limit ($0.25/$0.50 USD) - 2021/07/30 16:28:13 ET
Table 'Aitne III' 9-max Seat #1 is the button
Seat 1: Corlogiro ($50 in chips) 
Seat 3: Cressy21 ($39 in chips) 
Seat 4: v.sting ($50.84 in chips) 
Seat 6: Kahmi3105 ($223.01 in chips) 
Seat 7: bigned1975 ($59.79 in chips) 
Seat 8: sonova ($51.25 in chips) 
Seat 9: korrastaja ($53.92 in chips) 
Cressy21: posts small blind $0.25
v.sting: posts big blind $0.50
lonely fire: sits out 
*** HOLE CARDS ***
Kahmi3105: folds 
bigned1975: folds 
sonova: raises $0.75 to $1.25
korrastaja: folds 
Corlogiro: calls $1.25
Cressy21: folds 
v.sting: folds 
*** FLOP *** [6c Ac 3h]
sonova: bets $2.16
Corlogiro: calls $2.16
*** TURN *** [6c Ac 3h] [2s]
sonova: checks 
Corlogiro: bets $3.50
sonova: folds 
Uncalled bet ($3.50) returned to Corlogiro
Corlogiro collected $7.09 from pot
Corlogiro: doesn't show hand 
*** SUMMARY ***
Total pot $7.57 | Rake $0.48 
Board [6c Ac 3h 2s]
Seat 1: Corlogiro (button) collected ($7.09)
Seat 3: Cressy21 (small blind) folded before Flop
Seat 4: v.sting (big blind) folded before Flop
Seat 6: Kahmi3105 folded before Flop (didn't bet)
Seat 7: bigned1975 folded before Flop (didn't bet)
Seat 8: sonova folded on the Turn
Seat 9: korrastaja folded before Flop (didn't bet)



PokerStars Hand #228688551046:  Hold'em No Limit ($0.25/$0.50 USD) - 2021/07/30 16:29:16 ET
Table 'Aitne III' 9-max Seat #3 is the button
Seat 1: Corlogiro ($53.68 in chips) 
Seat 3: Cressy21 ($38.75 in chips) 
Seat 4: v.sting ($50.34 in chips) 
Seat 5: lonely fire ($50 in chips) 
Seat 6: Kahmi3105 ($223.01 in chips) 
Seat 7: bigned1975 ($59.79 in chips) 
Seat 8: sonova ($50 in chips) 
Seat 9: korrastaja ($53.92 in chips) 
v.sting: posts small blind $0.25
lonely fire: posts big blind $0.50
*** HOLE CARDS ***
Kahmi3105: folds 
bigned1975: folds 
sonova: raises $0.75 to $1.25
korrastaja: folds 
Corlogiro: folds 
Cressy21: folds 
v.sting: folds 
lonely fire: folds 
Uncalled bet ($0.75) returned to sonova
sonova collected $1.25 from pot
sonova: doesn't show hand 
*** SUMMARY ***
Total pot $1.25 | Rake $0 
Seat 1: Corlogiro folded before Flop (didn't bet)
Seat 3: Cressy21 (button) folded before Flop (didn't bet)
Seat 4: v.sting (small blind) folded before Flop
Seat 5: lonely fire (big blind) folded before Flop
Seat 6: Kahmi3105 folded before Flop (didn't bet)
Seat 7: bigned1975 folded before Flop (didn't bet)
Seat 8: sonova collected ($1.25)
Seat 9: korrastaja folded before Flop (didn't bet)



PokerStars Hand #228688557375:  Hold'em No Limit ($0.25/$0.50 USD) - 2021/07/30 16:29:30 ET
Table 'Aitne III' 9-max Seat #4 is the button
Seat 1: Corlogiro ($53.68 in chips) 
Seat 3: Cressy21 ($38.75 in chips) 
Seat 4: v.sting ($50.09 in chips) 
Seat 5: lonely fire ($50 in chips) 
Seat 6: Kahmi3105 ($223.01 in chips) 
Seat 7: bigned1975 ($59.79 in chips) 
Seat 8: sonova ($50.75 in chips) 
Seat 9: korrastaja ($53.92 in chips) 
lonely fire: posts small blind $0.25
Kahmi3105: posts big blind $0.50
*** HOLE CARDS ***
bigned1975: folds 
sonova: folds 
korrastaja: folds 
Corlogiro: folds 
Cressy21: folds 
v.sting: folds 
lonely fire: folds 
Uncalled bet ($0.25) returned to Kahmi3105
Kahmi3105 collected $0.50 from pot
*** SUMMARY ***
Total pot $0.50 | Rake $0 
Seat 1: Corlogiro folded before Flop (didn't bet)
Seat 3: Cressy21 folded before Flop (didn't bet)
Seat 4: v.sting (button) folded before Flop (didn't bet)
Seat 5: lonely fire (small blind) folded before Flop
Seat 6: Kahmi3105 (big blind) collected ($0.50)
Seat 7: bigned1975 folded before Flop (didn't bet)
Seat 8: sonova folded before Flop (didn't bet)
Seat 9: korrastaja folded before Flop (didn't bet)



PokerStars Hand #228688564164:  Hold'em No Limit ($0.25/$0.50 USD) - 2021/07/30 16:29:44 ET
Table 'Aitne III' 9-max Seat #5 is the button
Seat 1: Corlogiro ($53.68 in chips) 
Seat 3: Cressy21 ($38.75 in chips) 
Seat 4: v.sting ($50.09 in chips) 
Seat 5: lonely fire ($50 in chips) 
Seat 6: Kahmi3105 ($223.26 in chips) 
Seat 7: bigned1975 ($59.79 in chips) 
Seat 8: sonova ($50.75 in chips) 
Seat 9: korrastaja ($53.92 in chips) 
Kahmi3105: posts small blind $0.25
bigned1975: posts big blind $0.50
*** HOLE CARDS ***
sonova: folds 
korrastaja: raises $0.50 to $1
Corlogiro: folds 
Cressy21: folds 
v.sting: folds 
lonely fire: folds 
Kahmi3105: folds 
bigned1975: calls $0.50
*** FLOP *** [4d 2s Qh]
bigned1975: checks 
korrastaja: bets $1.18
bigned1975: folds 
Uncalled bet ($1.18) returned to korrastaja
korrastaja collected $2.14 from pot
korrastaja: doesn't show hand 
*** SUMMARY ***
Total pot $2.25 | Rake $0.11 
Board [4d 2s Qh]
Seat 1: Corlogiro folded before Flop (didn't bet)
Seat 3: Cressy21 folded before Flop (didn't bet)
Seat 4: v.sting folded before Flop (didn't bet)
Seat 5: lonely fire (button) folded before Flop (didn't bet)
Seat 6: Kahmi3105 (small blind) folded before Flop
Seat 7: bigned1975 (big blind) folded on the Flop
Seat 8: sonova folded before Flop (didn't bet)
Seat 9: korrastaja collected ($2.14)



PokerStars Hand #228688645618:  Hold'em No Limit ($0.25/$0.50 USD) - 2021/07/30 16:32:28 ET
Table 'Aitne III' 9-max Seat #3 is the button
Seat 1: Corlogiro ($52.93 in chips) 
Seat 3: Cressy21 ($40.20 in chips) 
Seat 5: lonely fire ($50 in chips) 
Seat 6: Kahmi3105 ($210.51 in chips) 
Seat 7: bigned1975 ($58.54 in chips) 
Seat 8: sonova ($50 in chips) 
Seat 9: korrastaja ($66.27 in chips) 
lonely fire: posts small blind $0.25
Kahmi3105: posts big blind $0.50
*** HOLE CARDS ***
bigned1975: folds 
sonova: folds 
korrastaja: folds 
Corlogiro: folds 
Cressy21: folds 
lonely fire: folds 
Uncalled bet ($0.25) returned to Kahmi3105
Kahmi3105 collected $0.50 from pot
*** SUMMARY ***
Total pot $0.50 | Rake $0 
Seat 1: Corlogiro folded before Flop (didn't bet)
Seat 3: Cressy21 (button) folded before Flop (didn't bet)
Seat 5: lonely fire (small blind) folded before Flop
Seat 6: Kahmi3105 (big blind) collected ($0.50)
Seat 7: bigned1975 folded before Flop (didn't bet)
Seat 8: sonova folded before Flop (didn't bet)
Seat 9: korrastaja folded before Flop (didn't bet)



PokerStars Hand #228688649776:  Hold'em No Limit ($0.25/$0.50 USD) - 2021/07/30 16:32:36 ET
Table 'Aitne III' 9-max Seat #5 is the button
Seat 1: Corlogiro ($52.93 in chips) 
Seat 3: Cressy21 ($40.20 in chips) 
Seat 5: lonely fire ($50 in chips) 
Seat 6: Kahmi3105 ($210.76 in chips) 
Seat 7: bigned1975 ($58.54 in chips) 
Seat 8: sonova ($50 in chips) 
Seat 9: korrastaja ($66.27 in chips) 
Kahmi3105: posts small blind $0.25
bigned1975: posts big blind $0.50
TATAP85: sits out 
*** HOLE CARDS ***
sonova: folds 
korrastaja: folds 
Corlogiro: folds 
Cressy21: folds 
sonova leaves the table
lonely fire: raises $0.75 to $1.25
Kahmi3105: calls $1
An1an1 joins the table at seat #8 
bigned1975: calls $0.75
*** FLOP *** [Kc Ah Qd]
Kahmi3105: checks 
bigned1975: checks 
lonely fire: bets $1.25
Kahmi3105: calls $1.25
bigned1975: folds 
*** TURN *** [Kc Ah Qd] [7s]
Kahmi3105: checks 
lonely fire: bets $5.50
Kahmi3105: folds 
Uncalled bet ($5.50) returned to lonely fire
lonely fire collected $5.94 from pot
lonely fire: doesn't show hand 
*** SUMMARY ***
Total pot $6.25 | Rake $0.31 
Board [Kc Ah Qd 7s]
Seat 1: Corlogiro folded before Flop (didn't bet)
Seat 3: Cressy21 folded before Flop (didn't bet)
Seat 5: lonely fire (button) collected ($5.94)
Seat 6: Kahmi3105 (small blind) folded on the Turn
Seat 7: bigned1975 (big blind) folded on the Flop
Seat 8: sonova folded before Flop (didn't bet)
Seat 9: korrastaja folded before Flop (didn't bet)



PokerStars Hand #228688676503:  Hold'em No Limit ($0.25/$0.50 USD) - 2021/07/30 16:33:31 ET
Table 'Aitne III' 9-max Seat #6 is the button
Seat 1: Corlogiro ($52.93 in chips) 
Seat 3: Cressy21 ($40.20 in chips) 
Seat 5: lonely fire ($53.44 in chips) 
Seat 6: Kahmi3105 ($208.26 in chips) 
Seat 7: bigned1975 ($57.29 in chips) 
Seat 8: An1an1 ($50 in chips) 
Seat 9: korrastaja ($66.27 in chips) 
bigned1975: posts small blind $0.25
An1an1: posts big blind $0.50
artemxxl: sits out 
TATAP85: sits out 
*** HOLE CARDS ***
korrastaja: folds 
Corlogiro: folds 
Cressy21: calls $0.50
lonely fire: raises $1.50 to $2
Kahmi3105: folds 
bigned1975: folds 
An1an1: folds 
Cressy21: calls $1.50
*** FLOP *** [4s Ac 8s]
Cressy21: checks 
lonely fire: bets $1.49
Cressy21: calls $1.49
*** TURN *** [4s Ac 8s] [Ad]
Cressy21: checks 
lonely fire: checks 
*** RIVER *** [4s Ac 8s Ad] [Td]
Cressy21: bets $2.50
lonely fire: calls $2.50
*** SHOW DOWN ***
Cressy21: shows [Ks 5s] (a pair of Aces)
lonely fire: shows [Tc Jc] (two pair, Aces and Tens)
lonely fire collected $12.09 from pot
*** SUMMARY ***
Total pot $12.73 | Rake $0.64 
Board [4s Ac 8s Ad Td]
Seat 1: Corlogiro folded before Flop (didn't bet)
Seat 3: Cressy21 showed [Ks 5s] and lost with a pair of Aces
Seat 5: lonely fire showed [Tc Jc] and won ($12.09) with two pair, Aces and Tens
Seat 6: Kahmi3105 (button) folded before Flop (didn't bet)
Seat 7: bigned1975 (small blind) folded before Flop
Seat 8: An1an1 (big blind) folded before Flop
Seat 9: korrastaja folded before Flop (didn't bet)



PokerStars Hand #228688704798:  Hold'em No Limit ($0.25/$0.50 USD) - 2021/07/30 16:34:30 ET
Table 'Aitne III' 9-max Seat #7 is the button
Seat 1: Corlogiro ($52.93 in chips) 
Seat 3: Cressy21 ($34.21 in chips) 
Seat 5: lonely fire ($59.54 in chips) 
Seat 6: Kahmi3105 ($208.26 in chips) 
Seat 7: bigned1975 ($57.04 in chips) 
Seat 9: korrastaja ($66.27 in chips) 
korrastaja: posts small blind $0.25
Corlogiro: posts big blind $0.50
artemxxl: sits out 
TATAP85: sits out 
*** HOLE CARDS ***
An1an1 leaves the table
Cressy21: folds 
lonely fire: raises $1 to $1.50
Kahmi3105: calls $1.50
bigned1975: folds 
korrastaja: folds 
wildermorph joins the table at seat #8 
Corlogiro: calls $1
*** FLOP *** [9h Ks 5h]
Corlogiro: checks 
lonely fire: bets $1.49
Kahmi3105: folds 
Corlogiro: folds 
Uncalled bet ($1.49) returned to lonely fire
lonely fire collected $4.51 from pot
lonely fire: doesn't show hand 
*** SUMMARY ***
Total pot $4.75 | Rake $0.24 
Board [9h Ks 5h]
Seat 1: Corlogiro (big blind) folded on the Flop
Seat 3: Cressy21 folded before Flop (didn't bet)
Seat 5: lonely fire collected ($4.51)
Seat 6: Kahmi3105 folded on the Flop
Seat 7: bigned1975 (button) folded before Flop (didn't bet)
Seat 9: korrastaja (small blind) folded before Flop



PokerStars Hand #228688722737:  Hold'em No Limit ($0.25/$0.50 USD) - 2021/07/30 16:35:07 ET
Table 'Aitne III' 9-max Seat #9 is the button
Seat 1: Corlogiro ($51.43 in chips) 
Seat 2: artemxxl ($75.30 in chips) 
Seat 3: Cressy21 ($34.21 in chips) 
Seat 5: lonely fire ($62.55 in chips) 
Seat 6: Kahmi3105 ($206.76 in chips) 
Seat 7: bigned1975 ($57.04 in chips) 
Seat 9: korrastaja ($66.02 in chips) 
Corlogiro: posts small blind $0.25
artemxxl: posts big blind $0.50
TATAP85: sits out 
wildermorph: sits out 
*** HOLE CARDS ***
Cressy21: folds 
lonely fire: folds 
Kahmi3105: raises $1.25 to $1.75
bigned1975: folds 
korrastaja: folds 
Corlogiro: folds 
artemxxl: folds 
Uncalled bet ($1.25) returned to Kahmi3105
Kahmi3105 collected $1.25 from pot
*** SUMMARY ***
Total pot $1.25 | Rake $0 
Seat 1: Corlogiro (small blind) folded before Flop
Seat 2: artemxxl (big blind) folded before Flop
Seat 3: Cressy21 folded before Flop (didn't bet)
Seat 5: lonely fire folded before Flop (didn't bet)
Seat 6: Kahmi3105 collected ($1.25)
Seat 7: bigned1975 folded before Flop (didn't bet)
Seat 9: korrastaja (button) folded before Flop (didn't bet)



PokerStars Hand #228688733136:  Hold'em No Limit ($0.25/$0.50 USD) - 2021/07/30 16:35:29 ET
Table 'Aitne III' 9-max Seat #1 is the button
Seat 1: Corlogiro ($51.18 in chips) 
Seat 2: artemxxl ($74.80 in chips) 
Seat 3: Cressy21 ($34.21 in chips) 
Seat 5: lonely fire ($62.55 in chips) 
Seat 6: Kahmi3105 ($207.51 in chips) 
Seat 7: bigned1975 ($57.04 in chips) 
Seat 9: korrastaja ($66.02 in chips) 
artemxxl: posts small blind $0.25
Cressy21: posts big blind $0.50
TATAP85: sits out 
wildermorph: sits out 
*** HOLE CARDS ***
lonely fire: folds 
Kahmi3105: folds 
bigned1975: folds 
korrastaja: folds 
Corlogiro: raises $0.75 to $1.25
artemxxl: calls $1
Cressy21: calls $0.75
*** FLOP *** [Jh 4c 3s]
artemxxl: checks 
Cressy21: checks 
Corlogiro: bets $1.50
artemxxl: folds 
Cressy21: folds 
Uncalled bet ($1.50) returned to Corlogiro
Corlogiro collected $3.51 from pot
Corlogiro: doesn't show hand 
*** SUMMARY ***
Total pot $3.75 | Rake $0.24 
Board [Jh 4c 3s]
Seat 1: Corlogiro (button) collected ($3.51)
Seat 2: artemxxl (small blind) folded on the Flop
Seat 3: Cressy21 (big blind) folded on the Flop
Seat 5: lonely fire folded before Flop (didn't bet)
Seat 6: Kahmi3105 folded before Flop (didn't bet)
Seat 7: bigned1975 folded before Flop (didn't bet)
Seat 9: korrastaja folded before Flop (didn't bet)



PokerStars Hand #228688752147:  Hold'em No Limit ($0.25/$0.50 USD) - 2021/07/30 16:36:09 ET
Table 'Aitne III' 9-max Seat #2 is the button
Seat 1: Corlogiro ($53.44 in chips) 
Seat 2: artemxxl ($73.55 in chips) 
Seat 3: Cressy21 ($32.96 in chips) 
Seat 4: TATAP85 ($50 in chips) 
Seat 5: lonely fire ($62.55 in chips) 
Seat 6: Kahmi3105 ($207.51 in chips) 
Seat 7: bigned1975 ($57.04 in chips) 
Seat 9: korrastaja ($66.02 in chips) 
Cressy21: posts small blind $0.25
TATAP85: posts big blind $0.50
wildermorph: sits out 
*** HOLE CARDS ***
lonely fire: folds 
Kahmi3105: folds 
bigned1975: raises $1 to $1.50
korrastaja: folds 
Corlogiro: folds 
artemxxl: folds 
Cressy21: calls $1.25
TATAP85: folds 
*** FLOP *** [Qs 6h Qd]
Cressy21: bets $2.50
bigned1975: folds 
Uncalled bet ($2.50) returned to Cressy21
Cressy21 collected $3.32 from pot
Cressy21: doesn't show hand 
*** SUMMARY ***
Total pot $3.50 | Rake $0.18 
Board [Qs 6h Qd]
Seat 1: Corlogiro folded before Flop (didn't bet)
Seat 2: artemxxl (button) folded before Flop (didn't bet)
Seat 3: Cressy21 (small blind) collected ($3.32)
Seat 4: TATAP85 (big blind) folded before Flop
Seat 5: lonely fire folded before Flop (didn't bet)
Seat 6: Kahmi3105 folded before Flop (didn't bet)
Seat 7: bigned1975 folded on the Flop
Seat 9: korrastaja folded before Flop (didn't bet)



PokerStars Hand #228688772045:  Hold'em No Limit ($0.25/$0.50 USD) - 2021/07/30 16:36:51 ET
Table 'Aitne III' 9-max Seat #3 is the button
Seat 1: Corlogiro ($53.44 in chips) 
Seat 2: artemxxl ($73.55 in chips) 
Seat 3: Cressy21 ($34.78 in chips) 
Seat 4: TATAP85 ($50 in chips) 
Seat 5: lonely fire ($62.55 in chips) 
Seat 6: Kahmi3105 ($207.51 in chips) 
Seat 7: bigned1975 ($55.54 in chips) 
Seat 9: korrastaja ($66.02 in chips) 
TATAP85: posts small blind $0.25
lonely fire: posts big blind $0.50
wildermorph: sits out 
*** HOLE CARDS ***
Kahmi3105: raises $1.25 to $1.75
bigned1975: folds 
korrastaja: folds 
Corlogiro: folds 
artemxxl: folds 
Cressy21: folds 
TATAP85: folds 
lonely fire: folds 
Uncalled bet ($1.25) returned to Kahmi3105
Kahmi3105 collected $1.25 from pot
*** SUMMARY ***
Total pot $1.25 | Rake $0 
Seat 1: Corlogiro folded before Flop (didn't bet)
Seat 2: artemxxl folded before Flop (didn't bet)
Seat 3: Cressy21 (button) folded before Flop (didn't bet)
Seat 4: TATAP85 (small blind) folded before Flop
Seat 5: lonely fire (big blind) folded before Flop
Seat 6: Kahmi3105 collected ($1.25)
Seat 7: bigned1975 folded before Flop (didn't bet)
Seat 9: korrastaja folded before Flop (didn't bet)



PokerStars Hand #228688786080:  Hold'em No Limit ($0.25/$0.50 USD) - 2021/07/30 16:37:21 ET
Table 'Aitne III' 9-max Seat #4 is the button
Seat 1: Corlogiro ($53.44 in chips) 
Seat 2: artemxxl ($73.55 in chips) 
Seat 3: Cressy21 ($34.78 in chips) 
Seat 4: TATAP85 ($50 in chips) 
Seat 5: lonely fire ($62.05 in chips) 
Seat 6: Kahmi3105 ($208.26 in chips) 
Seat 7: bigned1975 ($55.54 in chips) 
Seat 9: korrastaja ($66.02 in chips) 
lonely fire: posts small blind $0.25
Kahmi3105: posts big blind $0.50
wildermorph: sits out 
*** HOLE CARDS ***
bigned1975: raises $1 to $1.50
korrastaja: folds 
Corlogiro: folds 
artemxxl: folds 
Cressy21: folds 
TATAP85: folds 
lonely fire: folds 
Kahmi3105: calls $1
*** FLOP *** [3s 6c 8c]
Kahmi3105: checks 
bigned1975: checks 
*** TURN *** [3s 6c 8c] [Td]
Kahmi3105: bets $3.09
bigned1975: folds 
Uncalled bet ($3.09) returned to Kahmi3105
Kahmi3105 collected $3.05 from pot
*** SUMMARY ***
Total pot $3.25 | Rake $0.20 
Board [3s 6c 8c Td]
Seat 1: Corlogiro folded before Flop (didn't bet)
Seat 2: artemxxl folded before Flop (didn't bet)
Seat 3: Cressy21 folded before Flop (didn't bet)
Seat 4: TATAP85 (button) folded before Flop (didn't bet)
Seat 5: lonely fire (small blind) folded before Flop
Seat 6: Kahmi3105 (big blind) collected ($3.05)
Seat 7: bigned1975 folded on the Turn
Seat 9: korrastaja folded before Flop (didn't bet)



PokerStars Hand #228688802280:  Hold'em No Limit ($0.25/$0.50 USD) - 2021/07/30 16:37:55 ET
Table 'Aitne III' 9-max Seat #5 is the button
Seat 1: Corlogiro ($53.44 in chips) 
Seat 2: artemxxl ($73.55 in chips) 
Seat 3: Cressy21 ($34.78 in chips) 
Seat 4: TATAP85 ($50 in chips) 
Seat 5: lonely fire ($61.80 in chips) 
Seat 6: Kahmi3105 ($209.81 in chips) 
Seat 7: bigned1975 ($54.04 in chips) 
Seat 9: korrastaja ($66.02 in chips) 
Kahmi3105: posts small blind $0.25
bigned1975: posts big blind $0.50
wildermorph: sits out 
*** HOLE CARDS ***
korrastaja: folds 
Corlogiro: raises $0.75 to $1.25
artemxxl: folds 
Cressy21: folds 
TATAP85: folds 
lonely fire: raises $3.25 to $4.50
Kahmi3105: folds 
bigned1975: folds 
Corlogiro: folds 
Uncalled bet ($3.25) returned to lonely fire
lonely fire collected $3.25 from pot
lonely fire: doesn't show hand 
*** SUMMARY ***
Total pot $3.25 | Rake $0 
Seat 1: Corlogiro folded before Flop
Seat 2: artemxxl folded before Flop (didn't bet)
Seat 3: Cressy21 folded before Flop (didn't bet)
Seat 4: TATAP85 folded before Flop (didn't bet)
Seat 5: lonely fire (button) collected ($3.25)
Seat 6: Kahmi3105 (small blind) folded before Flop
Seat 7: bigned1975 (big blind) folded before Flop
Seat 9: korrastaja folded before Flop (didn't bet)



PokerStars Hand #228688846652:  Hold'em No Limit ($0.25/$0.50 USD) - 2021/07/30 16:39:27 ET
Table 'Aitne III' 9-max Seat #7 is the button
Seat 1: Corlogiro ($52.19 in chips) 
Seat 2: artemxxl ($73.55 in chips) 
Seat 3: Cressy21 ($34.78 in chips) 
Seat 4: TATAP85 ($50 in chips) 
Seat 5: lonely fire ($62.30 in chips) 
Seat 6: Kahmi3105 ($216.75 in chips) 
Seat 7: bigned1975 ($48.54 in chips) 
Seat 8: wildermorph ($50 in chips) 
Seat 9: korrastaja ($66.02 in chips) 
wildermorph: posts small blind $0.25
korrastaja: posts big blind $0.50
*** HOLE CARDS ***
Corlogiro: folds 
artemxxl: raises $1 to $1.50
Cressy21: folds 
TATAP85: folds 
lonely fire: folds 
Kahmi3105: folds 
bigned1975: folds 
wildermorph: folds 
korrastaja: raises $4.50 to $6
artemxxl: calls $4.50
*** FLOP *** [3h Qh 5d]
korrastaja: bets $4
artemxxl: calls $4
*** TURN *** [3h Qh 5d] [Jc]
korrastaja: bets $13
artemxxl: calls $13
*** RIVER *** [3h Qh 5d Jc] [6d]
korrastaja: checks 
artemxxl: checks 
*** SHOW DOWN ***
korrastaja: shows [As Ks] (high card Ace)
artemxxl: shows [Kh Qs] (a pair of Queens)
artemxxl collected $44.25 from pot
*** SUMMARY ***
Total pot $46.25 | Rake $2 
Board [3h Qh 5d Jc 6d]
Seat 1: Corlogiro folded before Flop (didn't bet)
Seat 2: artemxxl showed [Kh Qs] and won ($44.25) with a pair of Queens
Seat 3: Cressy21 folded before Flop (didn't bet)
Seat 4: TATAP85 folded before Flop (didn't bet)
Seat 5: lonely fire folded before Flop (didn't bet)
Seat 6: Kahmi3105 folded before Flop (didn't bet)
Seat 7: bigned1975 (button) folded before Flop (didn't bet)
Seat 8: wildermorph (small blind) folded before Flop
Seat 9: korrastaja (big blind) showed [As Ks] and lost with high card Ace



PokerStars Hand #228688875387:  Hold'em No Limit ($0.25/$0.50 USD) - 2021/07/30 16:40:27 ET
Table 'Aitne III' 9-max Seat #8 is the button
Seat 1: Corlogiro ($52.19 in chips) 
Seat 2: artemxxl ($94.80 in chips) 
Seat 3: Cressy21 ($34.78 in chips) 
Seat 4: TATAP85 ($50 in chips) 
Seat 5: lonely fire ($62.30 in chips) 
Seat 6: Kahmi3105 ($216.75 in chips) 
Seat 7: bigned1975 ($50 in chips) 
Seat 8: wildermorph ($49.75 in chips) 
Seat 9: korrastaja ($50 in chips) 
korrastaja: posts small blind $0.25
Corlogiro: posts big blind $0.50
*** HOLE CARDS ***
artemxxl: folds 
Cressy21: calls $0.50
TATAP85: folds 
lonely fire: folds 
Kahmi3105: raises $1.75 to $2.25
bigned1975: folds 
wildermorph: folds 
korrastaja: folds 
Corlogiro: folds 
Cressy21: calls $1.75
*** FLOP *** [9d 5s 4h]
Cressy21: checks 
Kahmi3105: bets $3.50
Cressy21: folds 
Uncalled bet ($3.50) returned to Kahmi3105
Kahmi3105 collected $4.93 from pot
*** SUMMARY ***
Total pot $5.25 | Rake $0.32 
Board [9d 5s 4h]
Seat 1: Corlogiro (big blind) folded before Flop
Seat 2: artemxxl folded before Flop (didn't bet)
Seat 3: Cressy21 folded on the Flop
Seat 4: TATAP85 folded before Flop (didn't bet)
Seat 5: lonely fire folded before Flop (didn't bet)
Seat 6: Kahmi3105 collected ($4.93)
Seat 7: bigned1975 folded before Flop (didn't bet)
Seat 8: wildermorph (button) folded before Flop (didn't bet)
Seat 9: korrastaja (small blind) folded before Flop



PokerStars Hand #228688894546:  Hold'em No Limit ($0.25/$0.50 USD) - 2021/07/30 16:41:00 ET
Table 'Aitne III' 9-max Seat #9 is the button
Seat 1: Corlogiro ($51.69 in chips) 
Seat 2: artemxxl ($94.80 in chips) 
Seat 3: Cressy21 ($32.53 in chips) 
Seat 4: TATAP85 ($50 in chips) 
Seat 5: lonely fire ($62.30 in chips) 
Seat 6: Kahmi3105 ($219.43 in chips) 
Seat 7: bigned1975 ($50 in chips) 
Seat 8: wildermorph ($49.75 in chips) 
Seat 9: korrastaja ($50 in chips) 
Corlogiro: posts small blind $0.25
artemxxl: posts big blind $0.50
*** HOLE CARDS ***
Cressy21: folds 
TATAP85: folds 
lonely fire: folds 
Kahmi3105: raises $1.25 to $1.75
bigned1975: folds 
wildermorph: folds 
korrastaja: folds 
Corlogiro: folds 
artemxxl: folds 
Uncalled bet ($1.25) returned to Kahmi3105
Kahmi3105 collected $1.25 from pot
*** SUMMARY ***
Total pot $1.25 | Rake $0 
Seat 1: Corlogiro (small blind) folded before Flop
Seat 2: artemxxl (big blind) folded before Flop
Seat 3: Cressy21 folded before Flop (didn't bet)
Seat 4: TATAP85 folded before Flop (didn't bet)
Seat 5: lonely fire folded before Flop (didn't bet)
Seat 6: Kahmi3105 collected ($1.25)
Seat 7: bigned1975 folded before Flop (didn't bet)
Seat 8: wildermorph folded before Flop (didn't bet)
Seat 9: korrastaja (button) folded before Flop (didn't bet)



PokerStars Hand #228688904606:  Hold'em No Limit ($0.25/$0.50 USD) - 2021/07/30 16:41:21 ET
Table 'Aitne III' 9-max Seat #1 is the button
Seat 1: Corlogiro ($51.44 in chips) 
Seat 2: artemxxl ($94.30 in chips) 
Seat 3: Cressy21 ($32.53 in chips) 
Seat 4: TATAP85 ($50 in chips) 
Seat 5: lonely fire ($62.30 in chips) 
Seat 6: Kahmi3105 ($220.18 in chips) 
Seat 7: bigned1975 ($50 in chips) 
Seat 8: wildermorph ($49.75 in chips) 
Seat 9: korrastaja ($50 in chips) 
artemxxl: posts small blind $0.25
Cressy21: posts big blind $0.50
*** HOLE CARDS ***
TATAP85: folds 
lonely fire: folds 
Kahmi3105: raises $1.25 to $1.75
bigned1975: folds 
wildermorph: folds 
korrastaja: raises $3.25 to $5
Corlogiro: folds 
artemxxl: folds 
Cressy21: folds 
Kahmi3105: calls $3.25
*** FLOP *** [Tc 6c 7d]
Kahmi3105: checks 
korrastaja: bets $5.50
Kahmi3105: calls $5.50
*** TURN *** [Tc 6c 7d] [4d]
Kahmi3105: checks 
korrastaja: bets $12
Kahmi3105: calls $12
*** RIVER *** [Tc 6c 7d 4d] [Qd]
Kahmi3105: checks 
korrastaja: checks 
*** SHOW DOWN ***
Kahmi3105: shows [Ad Kd] (a flush, Ace high)
korrastaja: mucks hand 
Kahmi3105 collected $43.25 from pot
*** SUMMARY ***
Total pot $45.75 | Rake $2.50 
Board [Tc 6c 7d 4d Qd]
Seat 1: Corlogiro (button) folded before Flop (didn't bet)
Seat 2: artemxxl (small blind) folded before Flop
Seat 3: Cressy21 (big blind) folded before Flop
Seat 4: TATAP85 folded before Flop (didn't bet)
Seat 5: lonely fire folded before Flop (didn't bet)
Seat 6: Kahmi3105 showed [Ad Kd] and won ($43.25) with a flush, Ace high
Seat 7: bigned1975 folded before Flop (didn't bet)
Seat 8: wildermorph folded before Flop (didn't bet)
Seat 9: korrastaja mucked



PokerStars Hand #228688927678:  Hold'em No Limit ($0.25/$0.50 USD) - 2021/07/30 16:42:11 ET
Table 'Aitne III' 9-max Seat #2 is the button
Seat 1: Corlogiro ($51.44 in chips) 
Seat 2: artemxxl ($94.05 in chips) 
Seat 3: Cressy21 ($32.03 in chips) 
Seat 4: TATAP85 ($50 in chips) 
Seat 5: lonely fire ($62.30 in chips) 
Seat 6: Kahmi3105 ($240.93 in chips) 
Seat 7: bigned1975 ($50 in chips) 
Seat 8: wildermorph ($49.75 in chips) 
Seat 9: korrastaja ($27.50 in chips) 
Cressy21: posts small blind $0.25
TATAP85: posts big blind $0.50
*** HOLE CARDS ***
lonely fire: folds 
Kahmi3105: raises $1.25 to $1.75
bigned1975: folds 
wildermorph: calls $1.75
korrastaja: folds 
Corlogiro: folds 
artemxxl: folds 
Cressy21: calls $1.50
TATAP85: folds 
*** FLOP *** [Jh 9d 9h]
Cressy21: checks 
Kahmi3105: checks 
wildermorph: checks 
*** TURN *** [Jh 9d 9h] [4d]
Cressy21: checks 
Kahmi3105: checks 
wildermorph: bets $2.73
Cressy21: folds 
Kahmi3105: folds 
Uncalled bet ($2.73) returned to wildermorph
wildermorph collected $5.46 from pot
*** SUMMARY ***
Total pot $5.75 | Rake $0.29 
Board [Jh 9d 9h 4d]
Seat 1: Corlogiro folded before Flop (didn't bet)
Seat 2: artemxxl (button) folded before Flop (didn't bet)
Seat 3: Cressy21 (small blind) folded on the Turn
Seat 4: TATAP85 (big blind) folded before Flop
Seat 5: lonely fire folded before Flop (didn't bet)
Seat 6: Kahmi3105 folded on the Turn
Seat 7: bigned1975 folded before Flop (didn't bet)
Seat 8: wildermorph collected ($5.46)
Seat 9: korrastaja folded before Flop (didn't bet)



PokerStars Hand #228689040160:  Hold'em No Limit ($0.25/$0.50 USD) - 2021/07/30 16:45:51 ET
Table 'Aitne III' 9-max Seat #6 is the button
Seat 1: Corlogiro ($51.44 in chips) 
Seat 2: artemxxl ($92.80 in chips) 
Seat 4: TATAP85 ($55 in chips) 
Seat 5: lonely fire ($61.55 in chips) 
Seat 6: Kahmi3105 ($238.18 in chips) 
Seat 7: bigned1975 ($53.06 in chips) 
Seat 8: wildermorph ($51.96 in chips) 
Seat 9: korrastaja ($50 in chips) 
bigned1975: posts small blind $0.25
wildermorph: posts big blind $0.50
SwimmingPooI: sits out 
*** HOLE CARDS ***
korrastaja: folds 
Corlogiro: folds 
artemxxl: folds 
TATAP85: folds 
lonely fire: raises $1 to $1.50
Kahmi3105: folds 
bigned1975: folds 
wildermorph: folds 
Uncalled bet ($1) returned to lonely fire
lonely fire collected $1.25 from pot
lonely fire: doesn't show hand 
*** SUMMARY ***
Total pot $1.25 | Rake $0 
Seat 1: Corlogiro folded before Flop (didn't bet)
Seat 2: artemxxl folded before Flop (didn't bet)
Seat 4: TATAP85 folded before Flop (didn't bet)
Seat 5: lonely fire collected ($1.25)
Seat 6: Kahmi3105 (button) folded before Flop (didn't bet)
Seat 7: bigned1975 (small blind) folded before Flop
Seat 8: wildermorph (big blind) folded before Flop
Seat 9: korrastaja folded before Flop (didn't bet)



PokerStars Hand #228689049714:  Hold'em No Limit ($0.25/$0.50 USD) - 2021/07/30 16:46:10 ET
Table 'Aitne III' 9-max Seat #7 is the button
Seat 1: Corlogiro ($51.44 in chips) 
Seat 2: artemxxl ($92.80 in chips) 
Seat 4: TATAP85 ($55 in chips) 
Seat 5: lonely fire ($62.30 in chips) 
Seat 6: Kahmi3105 ($238.18 in chips) 
Seat 7: bigned1975 ($52.81 in chips) 
Seat 9: korrastaja ($50 in chips) 
korrastaja: posts small blind $0.25
Corlogiro: posts big blind $0.50
SwimmingPooI: sits out 
*** HOLE CARDS ***
artemxxl: folds 
wildermorph leaves the table
TATAP85: folds 
lonely fire: folds 
Kahmi3105: folds 
bigned1975: raises $1 to $1.50
korrastaja: folds 
Corlogiro: folds 
Uncalled bet ($1) returned to bigned1975
bigned1975 collected $1.25 from pot
bigned1975: doesn't show hand 
*** SUMMARY ***
Total pot $1.25 | Rake $0 
Seat 1: Corlogiro (big blind) folded before Flop
Seat 2: artemxxl folded before Flop (didn't bet)
Seat 4: TATAP85 folded before Flop (didn't bet)
Seat 5: lonely fire folded before Flop (didn't bet)
Seat 6: Kahmi3105 folded before Flop (didn't bet)
Seat 7: bigned1975 (button) collected ($1.25)
Seat 9: korrastaja (small blind) folded before Flop



PokerStars Hand #228689057662:  Hold'em No Limit ($0.25/$0.50 USD) - 2021/07/30 16:46:27 ET
Table 'Aitne III' 9-max Seat #9 is the button
Seat 1: Corlogiro ($50.94 in chips) 
Seat 2: artemxxl ($92.80 in chips) 
Seat 4: TATAP85 ($55 in chips) 
Seat 5: lonely fire ($62.30 in chips) 
Seat 6: Kahmi3105 ($238.18 in chips) 
Seat 7: bigned1975 ($53.56 in chips) 
Seat 9: korrastaja ($50 in chips) 
Corlogiro: posts small blind $0.25
artemxxl: posts big blind $0.50
SwimmingPooI: sits out 
*** HOLE CARDS ***
TATAP85: folds 
lonely fire: folds 
SwimmingPooI leaves the table
Kahmi3105: raises $1.25 to $1.75
bigned1975: folds 
korrastaja: folds 
Corlogiro: folds 
artemxxl: folds 
Uncalled bet ($1.25) returned to Kahmi3105
Kahmi3105 collected $1.25 from pot
*** SUMMARY ***
Total pot $1.25 | Rake $0 
Seat 1: Corlogiro (small blind) folded before Flop
Seat 2: artemxxl (big blind) folded before Flop
Seat 4: TATAP85 folded before Flop (didn't bet)
Seat 5: lonely fire folded before Flop (didn't bet)
Seat 6: Kahmi3105 collected ($1.25)
Seat 7: bigned1975 folded before Flop (didn't bet)
Seat 9: korrastaja (button) folded before Flop (didn't bet)



PokerStars Hand #228689066528:  Hold'em No Limit ($0.25/$0.50 USD) - 2021/07/30 16:46:45 ET
Table 'Aitne III' 9-max Seat #1 is the button
Seat 1: Corlogiro ($50.69 in chips) 
Seat 2: artemxxl ($92.30 in chips) 
Seat 4: TATAP85 ($55 in chips) 
Seat 5: lonely fire ($62.30 in chips) 
Seat 6: Kahmi3105 ($238.93 in chips) 
Seat 7: bigned1975 ($53.56 in chips) 
Seat 9: korrastaja ($50 in chips) 
artemxxl: posts small blind $0.25
TATAP85: posts big blind $0.50
*** HOLE CARDS ***
lonely fire: folds 
Kahmi3105: folds 
bigned1975: folds 
korrastaja: raises $1 to $1.50
Corlogiro: calls $1.50
artemxxl: folds 
TATAP85: calls $1
*** FLOP *** [9s 7h 3d]
TATAP85: checks 
korrastaja: checks 
Corlogiro: checks 
*** TURN *** [9s 7h 3d] [Tc]
oudine2 joins the table at seat #8 
TATAP85: bets $2.98
korrastaja: folds 
Corlogiro: folds 
Uncalled bet ($2.98) returned to TATAP85
TATAP85 collected $4.51 from pot
TATAP85: doesn't show hand 
*** SUMMARY ***
Total pot $4.75 | Rake $0.24 
Board [9s 7h 3d Tc]
Seat 1: Corlogiro (button) folded on the Turn
Seat 2: artemxxl (small blind) folded before Flop
Seat 4: TATAP85 (big blind) collected ($4.51)
Seat 5: lonely fire folded before Flop (didn't bet)
Seat 6: Kahmi3105 folded before Flop (didn't bet)
Seat 7: bigned1975 folded before Flop (didn't bet)
Seat 9: korrastaja folded on the Turn



PokerStars Hand #228688382590:  Hold'em No Limit ($0.25/$0.50 USD) - 2021/07/30 16:23:28 ET
Table 'Aitne III' 9-max Seat #8 is the button
Seat 1: Corlogiro ($50 in chips) 
Seat 2: artemxxl ($70.80 in chips) 
Seat 4: v.sting ($50 in chips) 
Seat 5: Nestle170 ($130.64 in chips) 
Seat 6: Kahmi3105 ($218.46 in chips) 
Seat 7: bigned1975 ($58.68 in chips) 
Seat 8: Gluck35 ($98.15 in chips) 
Seat 9: korrastaja ($54.17 in chips) 
korrastaja: posts small blind $0.25
Corlogiro: posts big blind $0.50
*** HOLE CARDS ***
artemxxl: folds 
v.sting: raises $1 to $1.50
Nestle170: folds 
Kahmi3105: folds 
bigned1975: folds 
Gluck35: folds 
korrastaja: folds 
Corlogiro: calls $1
*** FLOP *** [3s 5h Jc]
Corlogiro: checks 
v.sting: bets $1.02
Corlogiro: folds 
Uncalled bet ($1.02) returned to v.sting
v.sting collected $3.09 from pot
v.sting: doesn't show hand 
*** SUMMARY ***
Total pot $3.25 | Rake $0.16 
Board [3s 5h Jc]
Seat 1: Corlogiro (big blind) folded on the Flop
Seat 2: artemxxl folded before Flop (didn't bet)
Seat 4: v.sting collected ($3.09)
Seat 5: Nestle170 folded before Flop (didn't bet)
Seat 6: Kahmi3105 folded before Flop (didn't bet)
Seat 7: bigned1975 folded before Flop (didn't bet)
Seat 8: Gluck35 (button) folded before Flop (didn't bet)
Seat 9: korrastaja (small blind) folded before Flop



PokerStars Hand #228688401108:  Hold'em No Limit ($0.25/$0.50 USD) - 2021/07/30 16:24:06 ET
Table 'Aitne III' 9-max Seat #9 is the button
Seat 1: Corlogiro ($50 in chips) 
Seat 2: artemxxl ($70.80 in chips) 
Seat 4: v.sting ($51.59 in chips) 
Seat 5: Nestle170 ($130.64 in chips) 
Seat 6: Kahmi3105 ($218.46 in chips) 
Seat 7: bigned1975 ($58.68 in chips) 
Seat 8: Gluck35 ($98.15 in chips) 
Seat 9: korrastaja ($53.92 in chips) 
Corlogiro: posts small blind $0.25
artemxxl: posts big blind $0.50
*** HOLE CARDS ***
v.sting: folds 
Nestle170: folds 
Kahmi3105: folds 
bigned1975: folds 
Gluck35: folds 
korrastaja: raises $1 to $1.50
Corlogiro: raises $3 to $4.50
artemxxl: raises $5.25 to $9.75
korrastaja: folds 
Corlogiro: folds 
Uncalled bet ($5.25) returned to artemxxl
artemxxl collected $10.50 from pot
artemxxl: doesn't show hand 
*** SUMMARY ***
Total pot $10.50 | Rake $0 
Seat 1: Corlogiro (small blind) folded before Flop
Seat 2: artemxxl (big blind) collected ($10.50)
Seat 4: v.sting folded before Flop (didn't bet)
Seat 5: Nestle170 folded before Flop (didn't bet)
Seat 6: Kahmi3105 folded before Flop (didn't bet)
Seat 7: bigned1975 folded before Flop (didn't bet)
Seat 8: Gluck35 folded before Flop (didn't bet)
Seat 9: korrastaja (button) folded before Flop



PokerStars Hand #228688583028:  Hold'em No Limit ($0.25/$0.50 USD) - 2021/07/30 16:30:22 ET
Table 'Aitne III' 9-max Seat #6 is the button
Seat 1: Corlogiro ($53.68 in chips) 
Seat 3: Cressy21 ($38.75 in chips) 
Seat 4: v.sting ($50.09 in chips) 
Seat 5: lonely fire ($50 in chips) 
Seat 6: Kahmi3105 ($223.01 in chips) 
Seat 7: bigned1975 ($58.79 in chips) 
Seat 8: sonova ($50.75 in chips) 
Seat 9: korrastaja ($55.06 in chips) 
bigned1975: posts small blind $0.25
sonova: posts big blind $0.50
*** HOLE CARDS ***
korrastaja: folds 
Corlogiro: folds 
Cressy21: folds 
v.sting: raises $0.75 to $1.25
lonely fire: folds 
Kahmi3105: folds 
bigned1975: folds 
sonova: folds 
Uncalled bet ($0.75) returned to v.sting
v.sting collected $1.25 from pot
v.sting: doesn't show hand 
*** SUMMARY ***
Total pot $1.25 | Rake $0 
Seat 1: Corlogiro folded before Flop (didn't bet)
Seat 3: Cressy21 folded before Flop (didn't bet)
Seat 4: v.sting collected ($1.25)
Seat 5: lonely fire folded before Flop (didn't bet)
Seat 6: Kahmi3105 (button) folded before Flop (didn't bet)
Seat 7: bigned1975 (small blind) folded before Flop
Seat 8: sonova (big blind) folded before Flop
Seat 9: korrastaja folded before Flop (didn't bet)



PokerStars Hand #228688596164:  Hold'em No Limit ($0.25/$0.50 USD) - 2021/07/30 16:30:50 ET
Table 'Aitne III' 9-max Seat #7 is the button
Seat 1: Corlogiro ($53.68 in chips) 
Seat 3: Cressy21 ($38.75 in chips) 
Seat 4: v.sting ($50.84 in chips) 
Seat 5: lonely fire ($50 in chips) 
Seat 6: Kahmi3105 ($223.01 in chips) 
Seat 7: bigned1975 ($58.54 in chips) 
Seat 8: sonova ($50.25 in chips) 
Seat 9: korrastaja ($55.06 in chips) 
sonova: posts small blind $0.25
korrastaja: posts big blind $0.50
*** HOLE CARDS ***
Corlogiro: folds 
Cressy21: raises $0.50 to $1
v.sting: folds 
lonely fire: folds 
Kahmi3105: folds 
bigned1975: folds 
sonova: folds 
korrastaja: folds 
Uncalled bet ($0.50) returned to Cressy21
Cressy21 collected $1.25 from pot
Cressy21: doesn't show hand 
*** SUMMARY ***
Total pot $1.25 | Rake $0 
Seat 1: Corlogiro folded before Flop (didn't bet)
Seat 3: Cressy21 collected ($1.25)
Seat 4: v.sting folded before Flop (didn't bet)
Seat 5: lonely fire folded before Flop (didn't bet)
Seat 6: Kahmi3105 folded before Flop (didn't bet)
Seat 7: bigned1975 (button) folded before Flop (didn't bet)
Seat 8: sonova (small blind) folded before Flop
Seat 9: korrastaja (big blind) folded before Flop



PokerStars Hand #228688601059:  Hold'em No Limit ($0.25/$0.50 USD) - 2021/07/30 16:31:00 ET
Table 'Aitne III' 9-max Seat #8 is the button
Seat 1: Corlogiro ($53.68 in chips) 
Seat 3: Cressy21 ($39.50 in chips) 
Seat 4: v.sting ($50.84 in chips) 
Seat 5: lonely fire ($50 in chips) 
Seat 6: Kahmi3105 ($223.01 in chips) 
Seat 7: bigned1975 ($58.54 in chips) 
Seat 8: sonova ($50 in chips) 
Seat 9: korrastaja ($54.56 in chips) 
korrastaja: posts small blind $0.25
Corlogiro: posts big blind $0.50
*** HOLE CARDS ***
Cressy21: raises $1 to $1.50
v.sting: folds 
lonely fire: folds 
Kahmi3105: folds 
bigned1975: folds 
sonova: folds 
korrastaja: folds 
Corlogiro: folds 
Uncalled bet ($1) returned to Cressy21
Cressy21 collected $1.25 from pot
Cressy21: doesn't show hand 
*** SUMMARY ***
Total pot $1.25 | Rake $0 
Seat 1: Corlogiro (big blind) folded before Flop
Seat 3: Cressy21 collected ($1.25)
Seat 4: v.sting folded before Flop (didn't bet)
Seat 5: lonely fire folded before Flop (didn't bet)
Seat 6: Kahmi3105 folded before Flop (didn't bet)
Seat 7: bigned1975 folded before Flop (didn't bet)
Seat 8: sonova (button) folded before Flop (didn't bet)
Seat 9: korrastaja (small blind) folded before Flop



PokerStars Hand #228688611216:  Hold'em No Limit ($0.25/$0.50 USD) - 2021/07/30 16:31:21 ET
Table 'Aitne III' 9-max Seat #9 is the button
Seat 1: Corlogiro ($53.18 in chips) 
Seat 3: Cressy21 ($40.25 in chips) 
Seat 4: v.sting ($50.84 in chips) 
Seat 5: lonely fire ($50 in chips) 
Seat 6: Kahmi3105 ($223.01 in chips) 
Seat 7: bigned1975 ($58.54 in chips) 
Seat 8: sonova ($50 in chips) 
Seat 9: korrastaja ($54.31 in chips) 
Corlogiro: posts small blind $0.25
Cressy21: posts big blind $0.50
*** HOLE CARDS ***
v.sting: folds 
lonely fire: folds 
Kahmi3105: raises $1.25 to $1.75
bigned1975: folds 
sonova: folds 
korrastaja: raises $4.25 to $6
Corlogiro: folds 
Cressy21: folds 
Kahmi3105: calls $4.25
*** FLOP *** [Th 9c 2c]
Kahmi3105: checks 
korrastaja: bets $6.50
Kahmi3105: calls $6.50
*** TURN *** [Th 9c 2c] [Ac]
Kahmi3105: checks 
korrastaja: bets $14
Kahmi3105: folds 
Uncalled bet ($14) returned to korrastaja
korrastaja collected $24.46 from pot
korrastaja: doesn't show hand 
*** SUMMARY ***
Total pot $25.75 | Rake $1.29 
Board [Th 9c 2c Ac]
Seat 1: Corlogiro (small blind) folded before Flop
Seat 3: Cressy21 (big blind) folded before Flop
Seat 4: v.sting folded before Flop (didn't bet)
Seat 5: lonely fire folded before Flop (didn't bet)
Seat 6: Kahmi3105 folded on the Turn
Seat 7: bigned1975 folded before Flop (didn't bet)
Seat 8: sonova folded before Flop (didn't bet)
Seat 9: korrastaja (button) collected ($24.46)



PokerStars Hand #228688633687:  Hold'em No Limit ($0.25/$0.50 USD) - 2021/07/30 16:32:03 ET
Table 'Aitne III' 9-max Seat #1 is the button
Seat 1: Corlogiro ($52.93 in chips) 
Seat 3: Cressy21 ($39.75 in chips) 
Seat 5: lonely fire ($50 in chips) 
Seat 6: Kahmi3105 ($210.51 in chips) 
Seat 7: bigned1975 ($58.54 in chips) 
Seat 8: sonova ($50 in chips) 
Seat 9: korrastaja ($66.27 in chips) 
Cressy21: posts small blind $0.25
v.sting: is sitting out 
lonely fire: posts big blind $0.50
*** HOLE CARDS ***
Kahmi3105: folds 
bigned1975: folds 
v.sting leaves the table
sonova: folds 
korrastaja: folds 
Corlogiro: folds 
Cressy21: calls $0.25
TATAP85 joins the table at seat #4 
lonely fire: checks 
*** FLOP *** [3c Tc 9h]
Cressy21: bets $1
lonely fire: folds 
Uncalled bet ($1) returned to Cressy21
Cressy21 collected $0.95 from pot
Cressy21: doesn't show hand 
*** SUMMARY ***
Total pot $1 | Rake $0.05 
Board [3c Tc 9h]
Seat 1: Corlogiro (button) folded before Flop (didn't bet)
Seat 3: Cressy21 (small blind) collected ($0.95)
Seat 5: lonely fire (big blind) folded on the Flop
Seat 6: Kahmi3105 folded before Flop (didn't bet)
Seat 7: bigned1975 folded before Flop (didn't bet)
Seat 8: sonova folded before Flop (didn't bet)
Seat 9: korrastaja folded before Flop (didn't bet)



PokerStars Hand #228688815006:  Hold'em No Limit ($0.25/$0.50 USD) - 2021/07/30 16:38:20 ET
Table 'Aitne III' 9-max Seat #6 is the button
Seat 1: Corlogiro ($52.19 in chips) 
Seat 2: artemxxl ($73.55 in chips) 
Seat 3: Cressy21 ($34.78 in chips) 
Seat 4: TATAP85 ($50 in chips) 
Seat 5: lonely fire ($63.80 in chips) 
Seat 6: Kahmi3105 ($209.56 in chips) 
Seat 7: bigned1975 ($53.54 in chips) 
Seat 8: wildermorph ($50 in chips) 
Seat 9: korrastaja ($66.02 in chips) 
bigned1975: posts small blind $0.25
wildermorph: posts big blind $0.50
*** HOLE CARDS ***
korrastaja: folds 
Corlogiro: folds 
artemxxl: folds 
Cressy21: folds 
TATAP85: folds 
lonely fire: raises $1 to $1.50
Kahmi3105: calls $1.50
bigned1975: calls $1.25
wildermorph: calls $1
*** FLOP *** [6c 9d 5h]
bigned1975: checks 
wildermorph: checks 
lonely fire: checks 
Kahmi3105: bets $3.50
bigned1975: calls $3.50
wildermorph: folds 
lonely fire: folds 
*** TURN *** [6c 9d 5h] [Kc]
bigned1975: checks 
Kahmi3105: bets $7
bigned1975: folds 
Uncalled bet ($7) returned to Kahmi3105
Kahmi3105 collected $12.19 from pot
*** SUMMARY ***
Total pot $13 | Rake $0.81 
Board [6c 9d 5h Kc]
Seat 1: Corlogiro folded before Flop (didn't bet)
Seat 2: artemxxl folded before Flop (didn't bet)
Seat 3: Cressy21 folded before Flop (didn't bet)
Seat 4: TATAP85 folded before Flop (didn't bet)
Seat 5: lonely fire folded on the Flop
Seat 6: Kahmi3105 (button) collected ($12.19)
Seat 7: bigned1975 (small blind) folded on the Turn
Seat 8: wildermorph (big blind) folded on the Flop
Seat 9: korrastaja folded before Flop (didn't bet)



PokerStars Hand #228688960360:  Hold'em No Limit ($0.25/$0.50 USD) - 2021/07/30 16:43:20 ET
Table 'Aitne III' 9-max Seat #3 is the button
Seat 1: Corlogiro ($51.44 in chips) 
Seat 2: artemxxl ($94.05 in chips) 
Seat 3: Cressy21 ($30.28 in chips) 
Seat 4: TATAP85 ($50 in chips) 
Seat 5: lonely fire ($62.30 in chips) 
Seat 6: Kahmi3105 ($239.18 in chips) 
Seat 7: bigned1975 ($50 in chips) 
Seat 8: wildermorph ($53.46 in chips) 
Seat 9: korrastaja ($50 in chips) 
TATAP85: posts small blind $0.25
lonely fire: posts big blind $0.50
*** HOLE CARDS ***
Kahmi3105: calls $0.50
bigned1975: folds 
wildermorph: folds 
korrastaja: raises $1.50 to $2
Corlogiro: folds 
artemxxl: folds 
Cressy21: calls $2
TATAP85: raises $6.50 to $8.50
lonely fire: folds 
Kahmi3105: folds 
korrastaja: folds 
Cressy21: folds 
Uncalled bet ($6.50) returned to TATAP85
TATAP85 collected $7 from pot
TATAP85: doesn't show hand 
*** SUMMARY ***
Total pot $7 | Rake $0 
Seat 1: Corlogiro folded before Flop (didn't bet)
Seat 2: artemxxl folded before Flop (didn't bet)
Seat 3: Cressy21 (button) folded before Flop
Seat 4: TATAP85 (small blind) collected ($7)
Seat 5: lonely fire (big blind) folded before Flop
Seat 6: Kahmi3105 folded before Flop
Seat 7: bigned1975 folded before Flop (didn't bet)
Seat 8: wildermorph folded before Flop (didn't bet)
Seat 9: korrastaja folded before Flop



PokerStars Hand #228688984526:  Hold'em No Limit ($0.25/$0.50 USD) - 2021/07/30 16:44:12 ET
Table 'Aitne III' 9-max Seat #4 is the button
Seat 1: Corlogiro ($51.44 in chips) 
Seat 2: artemxxl ($94.05 in chips) 
Seat 3: Cressy21 ($28.28 in chips) 
Seat 4: TATAP85 ($55 in chips) 
Seat 5: lonely fire ($61.80 in chips) 
Seat 6: Kahmi3105 ($238.68 in chips) 
Seat 7: bigned1975 ($50 in chips) 
Seat 8: wildermorph ($53.46 in chips) 
Seat 9: korrastaja ($50 in chips) 
lonely fire: posts small blind $0.25
Kahmi3105: posts big blind $0.50
*** HOLE CARDS ***
bigned1975: raises $1 to $1.50
wildermorph: calls $1.50
korrastaja: folds 
Corlogiro: folds 
artemxxl: folds 
Cressy21: folds 
Cressy21 leaves the table
TATAP85: folds 
lonely fire: folds 
SwimmingPooI joins the table at seat #3 
Kahmi3105: raises $6 to $7.50
bigned1975: folds 
wildermorph: folds 
Uncalled bet ($6) returned to Kahmi3105
Kahmi3105 collected $4.75 from pot
*** SUMMARY ***
Total pot $4.75 | Rake $0 
Seat 1: Corlogiro folded before Flop (didn't bet)
Seat 2: artemxxl folded before Flop (didn't bet)
Seat 3: Cressy21 folded before Flop (didn't bet)
Seat 4: TATAP85 (button) folded before Flop (didn't bet)
Seat 5: lonely fire (small blind) folded before Flop
Seat 6: Kahmi3105 (big blind) collected ($4.75)
Seat 7: bigned1975 folded before Flop
Seat 8: wildermorph folded before Flop
Seat 9: korrastaja folded before Flop (didn't bet)



PokerStars Hand #228689006498:  Hold'em No Limit ($0.25/$0.50 USD) - 2021/07/30 16:44:59 ET
Table 'Aitne III' 9-max Seat #5 is the button
Seat 1: Corlogiro ($51.44 in chips) 
Seat 2: artemxxl ($94.05 in chips) 
Seat 4: TATAP85 ($55 in chips) 
Seat 5: lonely fire ($61.55 in chips) 
Seat 6: Kahmi3105 ($241.93 in chips) 
Seat 7: bigned1975 ($48.50 in chips) 
Seat 8: wildermorph ($51.96 in chips) 
Seat 9: korrastaja ($50 in chips) 
Kahmi3105: posts small blind $0.25
bigned1975: posts big blind $0.50
SwimmingPooI: sits out 
*** HOLE CARDS ***
wildermorph: folds 
korrastaja: folds 
Corlogiro: folds 
artemxxl: raises $0.75 to $1.25
TATAP85: folds 
lonely fire: folds 
Kahmi3105: calls $1
bigned1975: calls $0.75
*** FLOP *** [9d 3c 4d]
Kahmi3105: checks 
bigned1975: bets $2.50
artemxxl: folds 
Kahmi3105: calls $2.50
*** TURN *** [9d 3c 4d] [Td]
Kahmi3105: checks 
bigned1975: bets $5.50
Kahmi3105: folds 
Uncalled bet ($5.50) returned to bigned1975
bigned1975 collected $8.31 from pot
bigned1975: doesn't show hand 
*** SUMMARY ***
Total pot $8.75 | Rake $0.44 
Board [9d 3c 4d Td]
Seat 1: Corlogiro folded before Flop (didn't bet)
Seat 2: artemxxl folded on the Flop
Seat 4: TATAP85 folded before Flop (didn't bet)
Seat 5: lonely fire (button) folded before Flop (didn't bet)
Seat 6: Kahmi3105 (small blind) folded on the Turn
Seat 7: bigned1975 (big blind) collected ($8.31)
Seat 8: wildermorph folded before Flop (didn't bet)
Seat 9: korrastaja folded before Flop (didn't bet)



PokerStars Hand #228689090883:  Hold'em No Limit ($0.25/$0.50 USD) - 2021/07/30 16:47:36 ET
Table 'Aitne III' 9-max Seat #2 is the button
Seat 1: Corlogiro ($50 in chips) 
Seat 2: artemxxl ($92.05 in chips) 
Seat 4: TATAP85 ($58.01 in chips) 
Seat 6: Kahmi3105 ($238.93 in chips) 
Seat 7: bigned1975 ($53.56 in chips) 
Seat 9: korrastaja ($50 in chips) 
TATAP85: posts small blind $0.25
lonely fire: is sitting out 
Kahmi3105: posts big blind $0.50
oudine2: sits out 
*** HOLE CARDS ***
bigned1975: folds 
korrastaja: raises $0.50 to $1
Corlogiro: folds 
artemxxl: folds 
TATAP85: folds 
Kahmi3105: folds 
Uncalled bet ($0.50) returned to korrastaja
korrastaja collected $1.25 from pot
korrastaja: doesn't show hand 
*** SUMMARY ***
Total pot $1.25 | Rake $0 
Seat 1: Corlogiro folded before Flop (didn't bet)
Seat 2: artemxxl (button) folded before Flop (didn't bet)
Seat 4: TATAP85 (small blind) folded before Flop
Seat 6: Kahmi3105 (big blind) folded before Flop
Seat 7: bigned1975 folded before Flop (didn't bet)
Seat 9: korrastaja collected ($1.25)



PokerStars Hand #228689100325:  Hold'em No Limit ($0.25/$0.50 USD) - 2021/07/30 16:47:56 ET
Table 'Aitne III' 9-max Seat #4 is the button
Seat 1: Corlogiro ($50 in chips) 
Seat 2: artemxxl ($92.05 in chips) 
Seat 4: TATAP85 ($57.76 in chips) 
Seat 6: Kahmi3105 ($238.43 in chips) 
Seat 7: bigned1975 ($53.56 in chips) 
Seat 9: korrastaja ($50.75 in chips) 
Kahmi3105: posts small blind $0.25
bigned1975: posts big blind $0.50
oudine2: sits out 
*** HOLE CARDS ***
korrastaja: folds 
Corlogiro: folds 
artemxxl: folds 
TATAP85: folds 
Kahmi3105: folds 
Uncalled bet ($0.25) returned to bigned1975
bigned1975 collected $0.50 from pot
bigned1975: doesn't show hand 
*** SUMMARY ***
Total pot $0.50 | Rake $0 
Seat 1: Corlogiro folded before Flop (didn't bet)
Seat 2: artemxxl folded before Flop (didn't bet)
Seat 4: TATAP85 (button) folded before Flop (didn't bet)
Seat 6: Kahmi3105 (small blind) folded before Flop
Seat 7: bigned1975 (big blind) collected ($0.50)
Seat 9: korrastaja folded before Flop (didn't bet)



PokerStars Hand #228689105786:  Hold'em No Limit ($0.25/$0.50 USD) - 2021/07/30 16:48:07 ET
Table 'Aitne III' 9-max Seat #6 is the button
Seat 1: Corlogiro ($50 in chips) 
Seat 2: artemxxl ($92.05 in chips) 
Seat 4: TATAP85 ($57.76 in chips) 
Seat 6: Kahmi3105 ($238.18 in chips) 
Seat 7: bigned1975 ($53.81 in chips) 
Seat 8: oudine2 ($50 in chips) 
Seat 9: korrastaja ($50.75 in chips) 
bigned1975: posts small blind $0.25
oudine2: posts big blind $0.50
*** HOLE CARDS ***
korrastaja: folds 
Corlogiro: folds 
artemxxl: folds 
korrastaja leaves the table
TATAP85: folds 
Kahmi3105: folds 
bigned1975: folds 
Uncalled bet ($0.25) returned to oudine2
oudine2 collected $0.50 from pot
oudine2: doesn't show hand 
*** SUMMARY ***
Total pot $0.50 | Rake $0 
Seat 1: Corlogiro folded before Flop (didn't bet)
Seat 2: artemxxl folded before Flop (didn't bet)
Seat 4: TATAP85 folded before Flop (didn't bet)
Seat 6: Kahmi3105 (button) folded before Flop (didn't bet)
Seat 7: bigned1975 (small blind) folded before Flop
Seat 8: oudine2 (big blind) collected ($0.50)
Seat 9: korrastaja folded before Flop (didn't bet)



PokerStars Hand #228689113908:  Hold'em No Limit ($0.25/$0.50 USD) - 2021/07/30 16:48:24 ET
Table 'Aitne III' 9-max Seat #7 is the button
Seat 1: Corlogiro ($50 in chips) 
Seat 2: artemxxl ($92.05 in chips) 
Seat 4: TATAP85 ($57.76 in chips) 
Seat 6: Kahmi3105 ($238.18 in chips) 
Seat 7: bigned1975 ($53.56 in chips) 
Seat 8: oudine2 ($50.25 in chips) 
oudine2: posts small blind $0.25
Corlogiro: posts big blind $0.50
*** HOLE CARDS ***
artemxxl: folds 
TATAP85: folds 
Kahmi3105: folds 
bigned1975: folds 
oudine2: folds 
Uncalled bet ($0.25) returned to Corlogiro
Corlogiro collected $0.50 from pot
Corlogiro: doesn't show hand 
*** SUMMARY ***
Total pot $0.50 | Rake $0 
Seat 1: Corlogiro (big blind) collected ($0.50)
Seat 2: artemxxl folded before Flop (didn't bet)
Seat 4: TATAP85 folded before Flop (didn't bet)
Seat 6: Kahmi3105 folded before Flop (didn't bet)
Seat 7: bigned1975 (button) folded before Flop (didn't bet)
Seat 8: oudine2 (small blind) folded before Flop



PokerStars Hand #228689119397:  Hold'em No Limit ($0.25/$0.50 USD) - 2021/07/30 16:48:35 ET
Table 'Aitne III' 9-max Seat #8 is the button
Seat 1: Corlogiro ($50.25 in chips) 
Seat 2: artemxxl ($92.05 in chips) 
Seat 4: TATAP85 ($57.76 in chips) 
Seat 6: Kahmi3105 ($238.18 in chips) 
Seat 7: bigned1975 ($53.56 in chips) 
Seat 8: oudine2 ($50 in chips) 
Corlogiro: posts small blind $0.25
artemxxl: posts big blind $0.50
*** HOLE CARDS ***
TATAP85: folds 
Kahmi3105: folds 
bigned1975: raises $1 to $1.50
oudine2: folds 
Corlogiro: folds 
artemxxl: folds 
Uncalled bet ($1) returned to bigned1975
bigned1975 collected $1.25 from pot
bigned1975: doesn't show hand 
*** SUMMARY ***
Total pot $1.25 | Rake $0 
Seat 1: Corlogiro (small blind) folded before Flop
Seat 2: artemxxl (big blind) folded before Flop
Seat 4: TATAP85 folded before Flop (didn't bet)
Seat 6: Kahmi3105 folded before Flop (didn't bet)
Seat 7: bigned1975 collected ($1.25)
Seat 8: oudine2 (button) folded before Flop (didn't bet)



PokerStars Hand #228689128459:  Hold'em No Limit ($0.25/$0.50 USD) - 2021/07/30 16:48:54 ET
Table 'Aitne III' 9-max Seat #1 is the button
Seat 1: Corlogiro ($50 in chips) 
Seat 2: artemxxl ($91.55 in chips) 
Seat 4: TATAP85 ($57.76 in chips) 
Seat 6: Kahmi3105 ($238.18 in chips) 
Seat 7: bigned1975 ($54.31 in chips) 
Seat 8: oudine2 ($50 in chips) 
artemxxl: posts small blind $0.25
TATAP85: posts big blind $0.50
*** HOLE CARDS ***
Kahmi3105: folds 
bigned1975: folds 
oudine2: raises $0.75 to $1.25
lonely fire leaves the table
Corlogiro: folds 
artemxxl: folds 
TATAP85: calls $0.75
*** FLOP *** [2d 5h 2h]
TATAP85: checks 
oudine2: checks 
*** TURN *** [2d 5h 2h] [6d]
TATAP85: checks 
oudine2: checks 
*** RIVER *** [2d 5h 2h 6d] [8c]
TATAP85: checks 
oudine2: checks 
*** SHOW DOWN ***
TATAP85: shows [Kc Qc] (a pair of Deuces)
oudine2: mucks hand 
TATAP85 collected $2.61 from pot
*** SUMMARY ***
Total pot $2.75 | Rake $0.14 
Board [2d 5h 2h 6d 8c]
Seat 1: Corlogiro (button) folded before Flop (didn't bet)
Seat 2: artemxxl (small blind) folded before Flop
Seat 4: TATAP85 (big blind) showed [Kc Qc] and won ($2.61) with a pair of Deuces
Seat 6: Kahmi3105 folded before Flop (didn't bet)
Seat 7: bigned1975 folded before Flop (didn't bet)
Seat 8: oudine2 mucked



PokerStars Hand #228689155922:  Hold'em No Limit ($0.25/$0.50 USD) - 2021/07/30 16:49:52 ET
Table 'Aitne III' 9-max Seat #2 is the button
Seat 1: Corlogiro ($50 in chips) 
Seat 2: artemxxl ($91.30 in chips) 
Seat 4: TATAP85 ($59.12 in chips) 
Seat 6: Kahmi3105 ($238.18 in chips) 
Seat 7: bigned1975 ($54.31 in chips) 
Seat 8: oudine2 ($50 in chips) 
TATAP85: posts small blind $0.25
Kahmi3105: posts big blind $0.50
*** HOLE CARDS ***
$lavik88 joins the table at seat #9 
bigned1975: raises $1 to $1.50
oudine2: folds 
Corlogiro: folds 
artemxxl: folds 
TATAP85: folds 
Kahmi3105: folds 
Uncalled bet ($1) returned to bigned1975
bigned1975 collected $1.25 from pot
bigned1975: doesn't show hand 
*** SUMMARY ***
Total pot $1.25 | Rake $0 
Seat 1: Corlogiro folded before Flop (didn't bet)
Seat 2: artemxxl (button) folded before Flop (didn't bet)
Seat 4: TATAP85 (small blind) folded before Flop
Seat 6: Kahmi3105 (big blind) folded before Flop
Seat 7: bigned1975 collected ($1.25)
Seat 8: oudine2 folded before Flop (didn't bet)



PokerStars Hand #228689164339:  Hold'em No Limit ($0.25/$0.50 USD) - 2021/07/30 16:50:09 ET
Table 'Aitne III' 9-max Seat #4 is the button
Seat 1: Corlogiro ($50 in chips) 
Seat 2: artemxxl ($91.30 in chips) 
Seat 4: TATAP85 ($58.87 in chips) 
Seat 6: Kahmi3105 ($237.68 in chips) 
Seat 7: bigned1975 ($55.06 in chips) 
Seat 8: oudine2 ($50 in chips) 
Kahmi3105: posts small blind $0.25
bigned1975: posts big blind $0.50
$lavik88: sits out 
*** HOLE CARDS ***
oudine2: folds 
Corlogiro: raises $0.75 to $1.25
artemxxl: folds 
TATAP85: folds 
Kahmi3105: folds 
bigned1975: folds 
Uncalled bet ($0.75) returned to Corlogiro
Corlogiro collected $1.25 from pot
Corlogiro: doesn't show hand 
*** SUMMARY ***
Total pot $1.25 | Rake $0 
Seat 1: Corlogiro collected ($1.25)
Seat 2: artemxxl folded before Flop (didn't bet)
Seat 4: TATAP85 (button) folded before Flop (didn't bet)
Seat 6: Kahmi3105 (small blind) folded before Flop
Seat 7: bigned1975 (big blind) folded before Flop
Seat 8: oudine2 folded before Flop (didn't bet)



PokerStars Hand #228689174947:  Hold'em No Limit ($0.25/$0.50 USD) - 2021/07/30 16:50:31 ET
Table 'Aitne III' 9-max Seat #6 is the button
Seat 1: Corlogiro ($50.75 in chips) 
Seat 2: artemxxl ($91.30 in chips) 
Seat 4: TATAP85 ($58.87 in chips) 
Seat 6: Kahmi3105 ($237.43 in chips) 
Seat 7: bigned1975 ($54.56 in chips) 
Seat 8: oudine2 ($50 in chips) 
bigned1975: posts small blind $0.25
oudine2: posts big blind $0.50
$lavik88: sits out 
*** HOLE CARDS ***
Corlogiro: raises $0.75 to $1.25
artemxxl: folds 
TATAP85: folds 
Kahmi3105: folds 
bigned1975: folds 
oudine2: folds 
Uncalled bet ($0.75) returned to Corlogiro
Corlogiro collected $1.25 from pot
Corlogiro: doesn't show hand 
*** SUMMARY ***
Total pot $1.25 | Rake $0 
Seat 1: Corlogiro collected ($1.25)
Seat 2: artemxxl folded before Flop (didn't bet)
Seat 4: TATAP85 folded before Flop (didn't bet)
Seat 6: Kahmi3105 (button) folded before Flop (didn't bet)
Seat 7: bigned1975 (small blind) folded before Flop
Seat 8: oudine2 (big blind) folded before Flop



PokerStars Hand #228689182562:  Hold'em No Limit ($0.25/$0.50 USD) - 2021/07/30 16:50:47 ET
Table 'Aitne III' 9-max Seat #7 is the button
Seat 1: Corlogiro ($51.50 in chips) 
Seat 2: artemxxl ($91.30 in chips) 
Seat 4: TATAP85 ($58.87 in chips) 
Seat 6: Kahmi3105 ($237.43 in chips) 
Seat 7: bigned1975 ($54.31 in chips) 
Seat 8: oudine2 ($50 in chips) 
Seat 9: $lavik88 ($50 in chips) 
oudine2: posts small blind $0.25
$lavik88: posts big blind $0.50
*** HOLE CARDS ***
Corlogiro: folds 
artemxxl: folds 
TATAP85: folds 
Kahmi3105: raises $1.25 to $1.75
bigned1975: folds 
oudine2: folds 
$lavik88: folds 
Uncalled bet ($1.25) returned to Kahmi3105
Kahmi3105 collected $1.25 from pot
*** SUMMARY ***
Total pot $1.25 | Rake $0 
Seat 1: Corlogiro folded before Flop (didn't bet)
Seat 2: artemxxl folded before Flop (didn't bet)
Seat 4: TATAP85 folded before Flop (didn't bet)
Seat 6: Kahmi3105 collected ($1.25)
Seat 7: bigned1975 (button) folded before Flop (didn't bet)
Seat 8: oudine2 (small blind) folded before Flop
Seat 9: $lavik88 (big blind) folded before Flop



PokerStars Hand #228689190701:  Hold'em No Limit ($0.25/$0.50 USD) - 2021/07/30 16:51:04 ET
Table 'Aitne III' 9-max Seat #8 is the button
Seat 1: Corlogiro ($51.50 in chips) 
Seat 2: artemxxl ($91.30 in chips) 
Seat 4: TATAP85 ($58.87 in chips) 
Seat 6: Kahmi3105 ($238.18 in chips) 
Seat 7: bigned1975 ($54.31 in chips) 
Seat 8: oudine2 ($50 in chips) 
Seat 9: $lavik88 ($50 in chips) 
$lavik88: posts small blind $0.25
Corlogiro: posts big blind $0.50
*** HOLE CARDS ***
artemxxl: raises $1 to $1.50
TATAP85: calls $1.50
Kahmi3105: folds 
bigned1975: folds 
oudine2: folds 
$lavik88: folds 
Corlogiro: folds 
*** FLOP *** [Jh Ac 3h]
artemxxl: bets $1.50
TATAP85: calls $1.50
*** TURN *** [Jh Ac 3h] [8h]
artemxxl: bets $4.81
TATAP85: calls $4.81
*** RIVER *** [Jh Ac 3h 8h] [5c]
artemxxl: bets $10.26
TATAP85: calls $10.26
*** SHOW DOWN ***
artemxxl: shows [8c 8d] (three of a kind, Eights)
TATAP85: shows [Jc Jd] (three of a kind, Jacks)
TATAP85 collected $35.05 from pot
*** SUMMARY ***
Total pot $36.89 | Rake $1.84 
Board [Jh Ac 3h 8h 5c]
Seat 1: Corlogiro (big blind) folded before Flop
Seat 2: artemxxl showed [8c 8d] and lost with three of a kind, Eights
Seat 4: TATAP85 showed [Jc Jd] and won ($35.05) with three of a kind, Jacks
Seat 6: Kahmi3105 folded before Flop (didn't bet)
Seat 7: bigned1975 folded before Flop (didn't bet)
Seat 8: oudine2 (button) folded before Flop (didn't bet)
Seat 9: $lavik88 (small blind) folded before Flop



PokerStars Hand #228689215994:  Hold'em No Limit ($0.25/$0.50 USD) - 2021/07/30 16:51:57 ET
Table 'Aitne III' 9-max Seat #9 is the button
Seat 1: Corlogiro ($51 in chips) 
Seat 2: artemxxl ($73.23 in chips) 
Seat 4: TATAP85 ($75.85 in chips) 
Seat 6: Kahmi3105 ($238.18 in chips) 
Seat 7: bigned1975 ($54.31 in chips) 
Seat 8: oudine2 ($50 in chips) 
Seat 9: $lavik88 ($50 in chips) 
Corlogiro: posts small blind $0.25
artemxxl: posts big blind $0.50
*** HOLE CARDS ***
TATAP85: folds 
Kahmi3105: raises $1.25 to $1.75
bigned1975: folds 
oudine2: calls $1.75
$lavik88: folds 
Corlogiro: folds 
artemxxl: calls $1.25
*** FLOP *** [8s 8d 4d]
artemxxl: checks 
Kahmi3105: bets $3.50
oudine2: folds 
artemxxl: calls $3.50
*** TURN *** [8s 8d 4d] [Tc]
artemxxl: checks 
Kahmi3105: checks 
*** RIVER *** [8s 8d 4d Tc] [6d]
artemxxl: bets $8.25
Kahmi3105: folds 
Uncalled bet ($8.25) returned to artemxxl
artemxxl collected $11.88 from pot
*** SUMMARY ***
Total pot $12.50 | Rake $0.62 
Board [8s 8d 4d Tc 6d]
Seat 1: Corlogiro (small blind) folded before Flop
Seat 2: artemxxl (big blind) collected ($11.88)
Seat 4: TATAP85 folded before Flop (didn't bet)
Seat 6: Kahmi3105 folded on the River
Seat 7: bigned1975 folded before Flop (didn't bet)
Seat 8: oudine2 folded on the Flop
Seat 9: $lavik88 (button) folded before Flop (didn't bet)



PokerStars Hand #228689235966:  Hold'em No Limit ($0.25/$0.50 USD) - 2021/07/30 16:52:38 ET
Table 'Aitne III' 9-max Seat #1 is the button
Seat 1: Corlogiro ($50.75 in chips) 
Seat 2: artemxxl ($79.86 in chips) 
Seat 4: TATAP85 ($75.85 in chips) 
Seat 6: Kahmi3105 ($232.93 in chips) 
Seat 7: bigned1975 ($54.31 in chips) 
Seat 8: oudine2 ($50 in chips) 
Seat 9: $lavik88 ($50 in chips) 
artemxxl: posts small blind $0.25
TATAP85: posts big blind $0.50
*** HOLE CARDS ***
Kahmi3105: raises $1.25 to $1.75
bigned1975: folds 
oudine2: folds 
$lavik88: folds 
Corlogiro: folds 
artemxxl: folds 
TATAP85: folds 
Uncalled bet ($1.25) returned to Kahmi3105
Kahmi3105 collected $1.25 from pot
*** SUMMARY ***
Total pot $1.25 | Rake $0 
Seat 1: Corlogiro (button) folded before Flop (didn't bet)
Seat 2: artemxxl (small blind) folded before Flop
Seat 4: TATAP85 (big blind) folded before Flop
Seat 6: Kahmi3105 collected ($1.25)
Seat 7: bigned1975 folded before Flop (didn't bet)
Seat 8: oudine2 folded before Flop (didn't bet)
Seat 9: $lavik88 folded before Flop (didn't bet)



PokerStars Hand #228689247162:  Hold'em No Limit ($0.25/$0.50 USD) - 2021/07/30 16:53:02 ET
Table 'Aitne III' 9-max Seat #2 is the button
Seat 1: Corlogiro ($50.75 in chips) 
Seat 2: artemxxl ($79.61 in chips) 
Seat 4: TATAP85 ($75.35 in chips) 
Seat 6: Kahmi3105 ($233.68 in chips) 
Seat 7: bigned1975 ($54.31 in chips) 
Seat 8: oudine2 ($50 in chips) 
Seat 9: $lavik88 ($50 in chips) 
TATAP85: posts small blind $0.25
Kahmi3105: posts big blind $0.50
*** HOLE CARDS ***
alexrus18 joins the table at seat #3 
bigned1975: folds 
oudine2: folds 
$lavik88: raises $1 to $1.50
Corlogiro: raises $2.50 to $4
artemxxl: folds 
TATAP85: folds 
Kahmi3105: folds 
$lavik88: folds 
Uncalled bet ($2.50) returned to Corlogiro
Corlogiro collected $3.75 from pot
Corlogiro: doesn't show hand 
*** SUMMARY ***
Total pot $3.75 | Rake $0 
Seat 1: Corlogiro collected ($3.75)
Seat 2: artemxxl (button) folded before Flop (didn't bet)
Seat 4: TATAP85 (small blind) folded before Flop
Seat 6: Kahmi3105 (big blind) folded before Flop
Seat 7: bigned1975 folded before Flop (didn't bet)
Seat 8: oudine2 folded before Flop (didn't bet)
Seat 9: $lavik88 folded before Flop



PokerStars Hand #228689261651:  Hold'em No Limit ($0.25/$0.50 USD) - 2021/07/30 16:53:32 ET
Table 'Aitne III' 9-max Seat #4 is the button
Seat 1: Corlogiro ($53 in chips) 
Seat 2: artemxxl ($79.61 in chips) 
Seat 4: TATAP85 ($75.10 in chips) 
Seat 6: Kahmi3105 ($233.18 in chips) 
Seat 7: bigned1975 ($54.31 in chips) 
Seat 8: oudine2 ($50 in chips) 
Seat 9: $lavik88 ($50 in chips) 
Kahmi3105: posts small blind $0.25
bigned1975: posts big blind $0.50
alexrus18: sits out 
*** HOLE CARDS ***
oudine2: folds 
$lavik88: folds 
Corlogiro: folds 
artemxxl: folds 
TATAP85: folds 
Kahmi3105: folds 
Uncalled bet ($0.25) returned to bigned1975
bigned1975 collected $0.50 from pot
bigned1975: doesn't show hand 
*** SUMMARY ***
Total pot $0.50 | Rake $0 
Seat 1: Corlogiro folded before Flop (didn't bet)
Seat 2: artemxxl folded before Flop (didn't bet)
Seat 4: TATAP85 (button) folded before Flop (didn't bet)
Seat 6: Kahmi3105 (small blind) folded before Flop
Seat 7: bigned1975 (big blind) collected ($0.50)
Seat 8: oudine2 folded before Flop (didn't bet)
Seat 9: $lavik88 folded before Flop (didn't bet)



PokerStars Hand #228689266963:  Hold'em No Limit ($0.25/$0.50 USD) - 2021/07/30 16:53:43 ET
Table 'Aitne III' 9-max Seat #6 is the button
Seat 1: Corlogiro ($53 in chips) 
Seat 2: artemxxl ($79.61 in chips) 
Seat 4: TATAP85 ($75.10 in chips) 
Seat 6: Kahmi3105 ($232.93 in chips) 
Seat 7: bigned1975 ($54.56 in chips) 
Seat 8: oudine2 ($50 in chips) 
Seat 9: $lavik88 ($50 in chips) 
bigned1975: posts small blind $0.25
oudine2: posts big blind $0.50
alexrus18: sits out 
*** HOLE CARDS ***
$lavik88: folds 
Corlogiro: folds 
artemxxl: raises $0.75 to $1.25
TATAP85: folds 
Kahmi3105: calls $1.25
bigned1975: folds 
oudine2: folds 
*** FLOP *** [Ts 3c 4s]
artemxxl: bets $2.04
Kahmi3105: calls $2.04
*** TURN *** [Ts 3c 4s] [7d]
artemxxl: checks 
Kahmi3105: bets $3.48
artemxxl: folds 
Uncalled bet ($3.48) returned to Kahmi3105
Kahmi3105 collected $6.87 from pot
*** SUMMARY ***
Total pot $7.33 | Rake $0.46 
Board [Ts 3c 4s 7d]
Seat 1: Corlogiro folded before Flop (didn't bet)
Seat 2: artemxxl folded on the Turn
Seat 4: TATAP85 folded before Flop (didn't bet)
Seat 6: Kahmi3105 (button) collected ($6.87)
Seat 7: bigned1975 (small blind) folded before Flop
Seat 8: oudine2 (big blind) folded before Flop
Seat 9: $lavik88 folded before Flop (didn't bet)



PokerStars Hand #228689295214:  Hold'em No Limit ($0.25/$0.50 USD) - 2021/07/30 16:54:24 ET
Table 'Aitne III' 9-max Seat #7 is the button
Seat 1: Corlogiro ($53 in chips) 
Seat 2: artemxxl ($76.32 in chips) 
Seat 4: TATAP85 ($75.10 in chips) 
Seat 6: Kahmi3105 ($236.51 in chips) 
Seat 7: bigned1975 ($54.31 in chips) 
Seat 8: oudine2 ($50 in chips) 
Seat 9: $lavik88 ($50 in chips) 
oudine2: posts small blind $0.25
$lavik88: posts big blind $0.50
alexrus18: sits out 
*** HOLE CARDS ***
Corlogiro: folds 
artemxxl: folds 
TATAP85: folds 
Kahmi3105: raises $1.25 to $1.75
bigned1975 has timed out
bigned1975: folds 
oudine2: folds 
$lavik88: folds 
Uncalled bet ($1.25) returned to Kahmi3105
Kahmi3105 collected $1.25 from pot
*** SUMMARY ***
Total pot $1.25 | Rake $0 
Seat 1: Corlogiro folded before Flop (didn't bet)
Seat 2: artemxxl folded before Flop (didn't bet)
Seat 4: TATAP85 folded before Flop (didn't bet)
Seat 6: Kahmi3105 collected ($1.25)
Seat 7: bigned1975 (button) folded before Flop (didn't bet)
Seat 8: oudine2 (small blind) folded before Flop
Seat 9: $lavik88 (big blind) folded before Flop



PokerStars Hand #228689314044:  Hold'em No Limit ($0.25/$0.50 USD) - 2021/07/30 16:55:04 ET
Table 'Aitne III' 9-max Seat #8 is the button
Seat 1: Corlogiro ($53 in chips) 
Seat 2: artemxxl ($76.32 in chips) 
Seat 4: TATAP85 ($75.10 in chips) 
Seat 6: Kahmi3105 ($237.26 in chips) 
Seat 7: bigned1975 ($54.31 in chips) 
Seat 8: oudine2 ($50 in chips) 
Seat 9: $lavik88 ($50 in chips) 
$lavik88: posts small blind $0.25
Corlogiro: posts big blind $0.50
alexrus18: sits out 
*** HOLE CARDS ***
artemxxl: folds 
TATAP85: folds 
Kahmi3105 has timed out
Kahmi3105: folds 
bigned1975: raises $1 to $1.50
oudine2: folds 
$lavik88: folds 
Corlogiro: folds 
Uncalled bet ($1) returned to bigned1975
bigned1975 collected $1.25 from pot
bigned1975: doesn't show hand 
*** SUMMARY ***
Total pot $1.25 | Rake $0 
Seat 1: Corlogiro (big blind) folded before Flop
Seat 2: artemxxl folded before Flop (didn't bet)
Seat 4: TATAP85 folded before Flop (didn't bet)
Seat 6: Kahmi3105 folded before Flop (didn't bet)
Seat 7: bigned1975 collected ($1.25)
Seat 8: oudine2 (button) folded before Flop (didn't bet)
Seat 9: $lavik88 (small blind) folded before Flop



PokerStars Hand #228689323332:  Hold'em No Limit ($0.25/$0.50 USD) - 2021/07/30 16:55:29 ET
Table 'Aitne III' 9-max Seat #9 is the button
Seat 1: Corlogiro ($52.50 in chips) 
Seat 2: artemxxl ($76.32 in chips) 
Seat 4: TATAP85 ($75.10 in chips) 
Seat 6: Kahmi3105 ($237.26 in chips) 
Seat 7: bigned1975 ($55.06 in chips) 
Seat 8: oudine2 ($50 in chips) 
Seat 9: $lavik88 ($50 in chips) 
Corlogiro: posts small blind $0.25
artemxxl: posts big blind $0.50
alexrus18: sits out 
*** HOLE CARDS ***
TATAP85: folds 
Kahmi3105: raises $1.25 to $1.75
bigned1975: folds 
oudine2: folds 
$lavik88: folds 
Corlogiro: folds 
artemxxl: calls $1.25
*** FLOP *** [4c 4d 7s]
artemxxl: checks 
Kahmi3105: bets $3.56
alexrus18 leaves the table
artemxxl: calls $3.56
*** TURN *** [4c 4d 7s] [5d]
artemxxl: checks 
Kahmi3105: checks 
*** RIVER *** [4c 4d 7s 5d] [6s]
artemxxl: bets $8.25
Kahmi3105: folds 
Uncalled bet ($8.25) returned to artemxxl
artemxxl collected $10.33 from pot
*** SUMMARY ***
Total pot $10.87 | Rake $0.54 
Board [4c 4d 7s 5d 6s]
Seat 1: Corlogiro (small blind) folded before Flop
Seat 2: artemxxl (big blind) collected ($10.33)
Seat 4: TATAP85 folded before Flop (didn't bet)
Seat 6: Kahmi3105 folded on the River
Seat 7: bigned1975 folded before Flop (didn't bet)
Seat 8: oudine2 folded before Flop (didn't bet)
Seat 9: $lavik88 (button) folded before Flop (didn't bet)



PokerStars Hand #228689336295:  Hold'em No Limit ($0.25/$0.50 USD) - 2021/07/30 16:56:08 ET
Table 'Aitne III' 9-max Seat #1 is the button
Seat 1: Corlogiro ($52.25 in chips) 
Seat 2: artemxxl ($81.34 in chips) 
Seat 4: TATAP85 ($75.10 in chips) 
Seat 6: Kahmi3105 ($231.95 in chips) 
Seat 7: bigned1975 ($55.06 in chips) 
Seat 8: oudine2 ($50 in chips) 
Seat 9: $lavik88 ($50 in chips) 
artemxxl: posts small blind $0.25
TATAP85: posts big blind $0.50
*** HOLE CARDS ***
Kahmi3105: raises $1.25 to $1.75
bigned1975: folds 
oudine2: folds 
$lavik88: folds 
Corlogiro: folds 
artemxxl: folds 
TATAP85: folds 
Uncalled bet ($1.25) returned to Kahmi3105
Kahmi3105 collected $1.25 from pot
*** SUMMARY ***
Total pot $1.25 | Rake $0 
Seat 1: Corlogiro (button) folded before Flop (didn't bet)
Seat 2: artemxxl (small blind) folded before Flop
Seat 4: TATAP85 (big blind) folded before Flop
Seat 6: Kahmi3105 collected ($1.25)
Seat 7: bigned1975 folded before Flop (didn't bet)
Seat 8: oudine2 folded before Flop (didn't bet)
Seat 9: $lavik88 folded before Flop (didn't bet)



PokerStars Hand #228689342496:  Hold'em No Limit ($0.25/$0.50 USD) - 2021/07/30 16:56:26 ET
Table 'Aitne III' 9-max Seat #2 is the button
Seat 1: Corlogiro ($52.25 in chips) 
Seat 2: artemxxl ($81.09 in chips) 
Seat 4: TATAP85 ($74.60 in chips) 
Seat 6: Kahmi3105 ($232.70 in chips) 
Seat 7: bigned1975 ($55.06 in chips) 
Seat 8: oudine2 ($50 in chips) 
Seat 9: $lavik88 ($50 in chips) 
TATAP85: posts small blind $0.25
Kahmi3105: posts big blind $0.50
*** HOLE CARDS ***
bigned1975: folds 
oudine2: folds 
$lavik88: folds 
Corlogiro: raises $0.75 to $1.25
artemxxl: folds 
TATAP85: folds 
Kahmi3105: folds 
Uncalled bet ($0.75) returned to Corlogiro
Corlogiro collected $1.25 from pot
Corlogiro: doesn't show hand 
*** SUMMARY ***
Total pot $1.25 | Rake $0 
Seat 1: Corlogiro collected ($1.25)
Seat 2: artemxxl (button) folded before Flop (didn't bet)
Seat 4: TATAP85 (small blind) folded before Flop
Seat 6: Kahmi3105 (big blind) folded before Flop
Seat 7: bigned1975 folded before Flop (didn't bet)
Seat 8: oudine2 folded before Flop (didn't bet)
Seat 9: $lavik88 folded before Flop (didn't bet)



PokerStars Hand #228689347533:  Hold'em No Limit ($0.25/$0.50 USD) - 2021/07/30 16:56:41 ET
Table 'Aitne III' 9-max Seat #4 is the button
Seat 1: Corlogiro ($53 in chips) 
Seat 2: artemxxl ($81.09 in chips) 
Seat 4: TATAP85 ($74.35 in chips) 
Seat 6: Kahmi3105 ($232.20 in chips) 
Seat 7: bigned1975 ($55.06 in chips) 
Seat 8: oudine2 ($50 in chips) 
Seat 9: $lavik88 ($50 in chips) 
Kahmi3105: posts small blind $0.25
bigned1975: posts big blind $0.50
*** HOLE CARDS ***
oudine2: raises $1 to $1.50
$lavik88: folds 
Corlogiro: folds 
artemxxl: folds 
TATAP85: folds 
Kahmi3105: folds 
bigned1975: calls $1
*** FLOP *** [Jh Qh 9c]
bigned1975: checks 
oudine2: checks 
*** TURN *** [Jh Qh 9c] [3d]
bigned1975: checks 
oudine2: checks 
*** RIVER *** [Jh Qh 9c 3d] [Td]
bigned1975: checks 
oudine2: checks 
*** SHOW DOWN ***
bigned1975: shows [2d 2c] (a pair of Deuces)
oudine2: shows [5d 5h] (a pair of Fives)
oudine2 collected $3.09 from pot
*** SUMMARY ***
Total pot $3.25 | Rake $0.16 
Board [Jh Qh 9c 3d Td]
Seat 1: Corlogiro folded before Flop (didn't bet)
Seat 2: artemxxl folded before Flop (didn't bet)
Seat 4: TATAP85 (button) folded before Flop (didn't bet)
Seat 6: Kahmi3105 (small blind) folded before Flop
Seat 7: bigned1975 (big blind) showed [2d 2c] and lost with a pair of Deuces
Seat 8: oudine2 showed [5d 5h] and won ($3.09) with a pair of Fives
Seat 9: $lavik88 folded before Flop (didn't bet)



PokerStars Hand #228689364299:  Hold'em No Limit ($0.25/$0.50 USD) - 2021/07/30 16:57:29 ET
Table 'Aitne III' 9-max Seat #6 is the button
Seat 1: Corlogiro ($53 in chips) 
Seat 2: artemxxl ($81.09 in chips) 
Seat 4: TATAP85 ($74.35 in chips) 
Seat 6: Kahmi3105 ($231.95 in chips) 
Seat 7: bigned1975 ($53.56 in chips) 
Seat 8: oudine2 ($51.59 in chips) 
Seat 9: $lavik88 ($50 in chips) 
bigned1975: posts small blind $0.25
oudine2: posts big blind $0.50
*** HOLE CARDS ***
$lavik88: folds 
Corlogiro: raises $0.75 to $1.25
artemxxl: folds 
TATAP85: folds 
Kahmi3105: folds 
bigned1975: calls $1
oudine2: folds 
*** FLOP *** [Jc 7d 3d]
jasperge 40 joins the table at seat #3 
bigned1975: checks 
Corlogiro: bets $1.50
dikanmax joins the table at seat #5 
bigned1975: folds 
Uncalled bet ($1.50) returned to Corlogiro
Corlogiro collected $2.81 from pot
Corlogiro: doesn't show hand 
*** SUMMARY ***
Total pot $3 | Rake $0.19 
Board [Jc 7d 3d]
Seat 1: Corlogiro collected ($2.81)
Seat 2: artemxxl folded before Flop (didn't bet)
Seat 4: TATAP85 folded before Flop (didn't bet)
Seat 6: Kahmi3105 (button) folded before Flop (didn't bet)
Seat 7: bigned1975 (small blind) folded on the Flop
Seat 8: oudine2 (big blind) folded before Flop
Seat 9: $lavik88 folded before Flop (didn't bet)



PokerStars Hand #228689377734:  Hold'em No Limit ($0.25/$0.50 USD) - 2021/07/30 16:58:08 ET
Table 'Aitne III' 9-max Seat #7 is the button
Seat 1: Corlogiro ($54.56 in chips) 
Seat 2: artemxxl ($81.09 in chips) 
Seat 4: TATAP85 ($74.35 in chips) 
Seat 6: Kahmi3105 ($231.95 in chips) 
Seat 7: bigned1975 ($52.31 in chips) 
Seat 8: oudine2 ($51.09 in chips) 
Seat 9: $lavik88 ($50 in chips) 
oudine2: posts small blind $0.25
$lavik88: posts big blind $0.50
jasperge 40: sits out 
*** HOLE CARDS ***
Corlogiro: folds 
artemxxl: folds 
TATAP85: folds 
Kahmi3105: raises $1.25 to $1.75
bigned1975: calls $1.75
oudine2: raises $6.25 to $8
$lavik88: folds 
Kahmi3105: folds 
bigned1975: calls $6.25
*** FLOP *** [6c 3c 4d]
oudine2: bets $12.14
bigned1975: calls $12.14
*** TURN *** [6c 3c 4d] [3h]
oudine2: bets $30.95 and is all-in
bigned1975: calls $30.95
*** RIVER *** [6c 3c 4d 3h] [3s]
*** SHOW DOWN ***
oudine2: shows [Ad Ac] (a full house, Threes full of Aces)
bigned1975: shows [4s 4h] (a full house, Fours full of Threes)
bigned1975 cashed out the hand for $96.79 | Cash Out Fee $0.98
*** SUMMARY ***
Total pot $104.43 | Rake $2 
Board [6c 3c 4d 3h 3s]
Seat 1: Corlogiro folded before Flop (didn't bet)
Seat 2: artemxxl folded before Flop (didn't bet)
Seat 4: TATAP85 folded before Flop (didn't bet)
Seat 6: Kahmi3105 folded before Flop
Seat 7: bigned1975 (button) showed [4s 4h] and won ($102.43) with a full house, Fours full of Threes (pot not awarded as player cashed out)
Seat 8: oudine2 (small blind) showed [Ad Ac] and lost with a full house, Threes full of Aces
Seat 9: $lavik88 (big blind) folded before Flop



PokerStars Hand #228689399070:  Hold'em No Limit ($0.25/$0.50 USD) - 2021/07/30 16:59:10 ET
Table 'Aitne III' 9-max Seat #8 is the button
Seat 1: Corlogiro ($54.56 in chips) 
Seat 2: artemxxl ($81.09 in chips) 
Seat 3: jasperge 40 ($20 in chips) 
Seat 4: TATAP85 ($74.35 in chips) 
Seat 6: Kahmi3105 ($230.20 in chips) 
Seat 7: bigned1975 ($98.01 in chips) 
Seat 8: oudine2 ($50 in chips) 
Seat 9: $lavik88 ($50 in chips) 
$lavik88: posts small blind $0.25
Corlogiro: posts big blind $0.50
jasperge 40: posts big blind $0.50
*** HOLE CARDS ***
artemxxl: folds 
jasperge 40: checks 
TATAP85: folds 
Kahmi3105: folds 
bigned1975: raises $1 to $1.50
oudine2: folds 
$lavik88: folds 
Corlogiro: folds 
jasperge 40: calls $1
*** FLOP *** [5h Kh 2h]
jasperge 40: checks 
bigned1975: bets $2.25
jasperge 40: calls $2.25
*** TURN *** [5h Kh 2h] [6s]
jasperge 40: checks 
bigned1975: checks 
*** RIVER *** [5h Kh 2h 6s] [8s]
jasperge 40: bets $3.92
bigned1975: folds 
Uncalled bet ($3.92) returned to jasperge 40
jasperge 40 collected $7.84 from pot
jasperge 40: doesn't show hand 
*** SUMMARY ***
Total pot $8.25 | Rake $0.41 
Board [5h Kh 2h 6s 8s]
Seat 1: Corlogiro (big blind) folded before Flop
Seat 2: artemxxl folded before Flop (didn't bet)
Seat 3: jasperge 40 collected ($7.84)
Seat 4: TATAP85 folded before Flop (didn't bet)
Seat 6: Kahmi3105 folded before Flop (didn't bet)
Seat 7: bigned1975 folded on the River
Seat 8: oudine2 (button) folded before Flop (didn't bet)
Seat 9: $lavik88 (small blind) folded before Flop



PokerStars Hand #228689421225:  Hold'em No Limit ($0.25/$0.50 USD) - 2021/07/30 17:00:14 ET
Table 'Aitne III' 9-max Seat #9 is the button
Seat 1: Corlogiro ($54.06 in chips) 
Seat 2: artemxxl ($81.09 in chips) 
Seat 3: jasperge 40 ($24.09 in chips) 
Seat 4: TATAP85 ($74.35 in chips) 
Seat 6: Kahmi3105 ($230.20 in chips) 
Seat 7: bigned1975 ($94.26 in chips) 
Seat 8: oudine2 ($50 in chips) 
Seat 9: $lavik88 ($50 in chips) 
Corlogiro: posts small blind $0.25
artemxxl: posts big blind $0.50
*** HOLE CARDS ***
jasperge 40: calls $0.50
TATAP85: folds 
Kahmi3105: raises $1.75 to $2.25
bigned1975: calls $2.25
oudine2: folds 
$lavik88: folds 
Corlogiro: folds 
artemxxl: folds 
jasperge 40: calls $1.75
*** FLOP *** [3c 6c 4s]
jasperge 40: checks 
Kahmi3105: checks 
bigned1975: bets $5.50
jasperge 40: raises $16.34 to $21.84 and is all-in
Kahmi3105: folds 
bigned1975: calls $16.34
*** TURN *** [3c 6c 4s] [6h]
*** RIVER *** [3c 6c 4s 6h] [Jh]
*** SHOW DOWN ***
jasperge 40: shows [Jc 9c] (two pair, Jacks and Sixes)
bigned1975: shows [7h 7d] (two pair, Sevens and Sixes)
jasperge 40 collected $49.18 from pot
*** SUMMARY ***
Total pot $51.18 | Rake $2 
Board [3c 6c 4s 6h Jh]
Seat 1: Corlogiro (small blind) folded before Flop
Seat 2: artemxxl (big blind) folded before Flop
Seat 3: jasperge 40 showed [Jc 9c] and won ($49.18) with two pair, Jacks and Sixes
Seat 4: TATAP85 folded before Flop (didn't bet)
Seat 6: Kahmi3105 folded on the Flop
Seat 7: bigned1975 showed [7h 7d] and lost with two pair, Sevens and Sixes
Seat 8: oudine2 folded before Flop (didn't bet)
Seat 9: $lavik88 (button) folded before Flop (didn't bet)



PokerStars Hand #228689449439:  Hold'em No Limit ($0.25/$0.50 USD) - 2021/07/30 17:01:26 ET
Table 'Aitne III' 9-max Seat #1 is the button
Seat 1: Corlogiro ($53.81 in chips) 
Seat 2: artemxxl ($80.59 in chips) 
Seat 3: jasperge 40 ($49.18 in chips) 
Seat 4: TATAP85 ($74.35 in chips) 
Seat 6: Kahmi3105 ($227.95 in chips) 
Seat 7: bigned1975 ($70.17 in chips) 
Seat 8: oudine2 ($50 in chips) 
Seat 9: $lavik88 ($50 in chips) 
artemxxl: posts small blind $0.25
jasperge 40: posts big blind $0.50
*** HOLE CARDS ***
TATAP85: folds 
Kahmi3105: folds 
bigned1975: raises $1 to $1.50
oudine2: folds 
$lavik88: folds 
Corlogiro: raises $3 to $4.50
artemxxl: folds 
jasperge 40: folds 
bigned1975: calls $3
*** FLOP *** [6d 8s 2d]
bigned1975: checks 
Corlogiro: bets $4.50
bigned1975: folds 
Uncalled bet ($4.50) returned to Corlogiro
Corlogiro collected $9.14 from pot
Corlogiro: doesn't show hand 
*** SUMMARY ***
Total pot $9.75 | Rake $0.61 
Board [6d 8s 2d]
Seat 1: Corlogiro (button) collected ($9.14)
Seat 2: artemxxl (small blind) folded before Flop
Seat 3: jasperge 40 (big blind) folded before Flop
Seat 4: TATAP85 folded before Flop (didn't bet)
Seat 6: Kahmi3105 folded before Flop (didn't bet)
Seat 7: bigned1975 folded on the Flop
Seat 8: oudine2 folded before Flop (didn't bet)
Seat 9: $lavik88 folded before Flop (didn't bet)



PokerStars Hand #228689480782:  Hold'em No Limit ($0.25/$0.50 USD) - 2021/07/30 17:02:34 ET
Table 'Aitne III' 9-max Seat #2 is the button
Seat 1: Corlogiro ($58.45 in chips) 
Seat 2: artemxxl ($80.34 in chips) 
Seat 3: jasperge 40 ($48.68 in chips) 
Seat 4: TATAP85 ($74.35 in chips) 
Seat 7: bigned1975 ($65.67 in chips) 
Seat 8: oudine2 ($50 in chips) 
Seat 9: $lavik88 ($50 in chips) 
jasperge 40: posts small blind $0.25
TATAP85: posts big blind $0.50
*** HOLE CARDS ***
bigned1975: raises $1 to $1.50
oudine2: folds 
$lavik88: folds 
Corlogiro: folds 
artemxxl: folds 
jasperge 40: folds 
TATAP85: folds 
Uncalled bet ($1) returned to bigned1975
bigned1975 collected $1.25 from pot
bigned1975: doesn't show hand 
*** SUMMARY ***
Total pot $1.25 | Rake $0 
Seat 1: Corlogiro folded before Flop (didn't bet)
Seat 2: artemxxl (button) folded before Flop (didn't bet)
Seat 3: jasperge 40 (small blind) folded before Flop
Seat 4: TATAP85 (big blind) folded before Flop
Seat 7: bigned1975 collected ($1.25)
Seat 8: oudine2 folded before Flop (didn't bet)
Seat 9: $lavik88 folded before Flop (didn't bet)



PokerStars Hand #228689490878:  Hold'em No Limit ($0.25/$0.50 USD) - 2021/07/30 17:02:56 ET
Table 'Aitne III' 9-max Seat #3 is the button
Seat 1: Corlogiro ($58.45 in chips) 
Seat 2: artemxxl ($80.34 in chips) 
Seat 3: jasperge 40 ($48.43 in chips) 
Seat 4: TATAP85 ($73.85 in chips) 
Seat 7: bigned1975 ($66.42 in chips) 
Seat 8: oudine2 ($50 in chips) 
Seat 9: $lavik88 ($50 in chips) 
TATAP85: posts small blind $0.25
bigned1975: posts big blind $0.50
*** HOLE CARDS ***
oudine2: folds 
$lavik88: folds 
Corlogiro: folds 
artemxxl: folds 
jasperge 40: calls $0.50
TATAP85: calls $0.25
bigned1975: checks 
*** FLOP *** [Jd 6h Td]
TATAP85: checks 
bigned1975: checks 
jasperge 40: checks 
*** TURN *** [Jd 6h Td] [2d]
TATAP85: checks 
bigned1975: bets $1.50
jasperge 40: folds 
TATAP85: folds 
Uncalled bet ($1.50) returned to bigned1975
bigned1975 collected $1.42 from pot
bigned1975: doesn't show hand 
*** SUMMARY ***
Total pot $1.50 | Rake $0.08 
Board [Jd 6h Td 2d]
Seat 1: Corlogiro folded before Flop (didn't bet)
Seat 2: artemxxl folded before Flop (didn't bet)
Seat 3: jasperge 40 (button) folded on the Turn
Seat 4: TATAP85 (small blind) folded on the Turn
Seat 7: bigned1975 (big blind) collected ($1.42)
Seat 8: oudine2 folded before Flop (didn't bet)
Seat 9: $lavik88 folded before Flop (didn't bet)



PokerStars Hand #228689520340:  Hold'em No Limit ($0.25/$0.50 USD) - 2021/07/30 17:03:58 ET
Table 'Aitne III' 9-max Seat #4 is the button
Seat 1: Corlogiro ($58.45 in chips) 
Seat 2: artemxxl ($80.34 in chips) 
Seat 3: jasperge 40 ($47.93 in chips) 
Seat 4: TATAP85 ($73.35 in chips) 
Seat 7: bigned1975 ($67.34 in chips) 
Seat 8: oudine2 ($50 in chips) 
Seat 9: $lavik88 ($50 in chips) 
bigned1975: posts small blind $0.25
oudine2: posts big blind $0.50
*** HOLE CARDS ***
$lavik88: folds 
Corlogiro: folds 
artemxxl: folds 
jasperge 40: raises $0.75 to $1.25
TATAP85: folds 
bigned1975: folds 
oudine2: folds 
Uncalled bet ($0.75) returned to jasperge 40
jasperge 40 collected $1.25 from pot
jasperge 40: doesn't show hand 
*** SUMMARY ***
Total pot $1.25 | Rake $0 
Seat 1: Corlogiro folded before Flop (didn't bet)
Seat 2: artemxxl folded before Flop (didn't bet)
Seat 3: jasperge 40 collected ($1.25)
Seat 4: TATAP85 (button) folded before Flop (didn't bet)
Seat 7: bigned1975 (small blind) folded before Flop
Seat 8: oudine2 (big blind) folded before Flop
Seat 9: $lavik88 folded before Flop (didn't bet)



PokerStars Hand #228689532063:  Hold'em No Limit ($0.25/$0.50 USD) - 2021/07/30 17:04:23 ET
Table 'Aitne III' 9-max Seat #7 is the button
Seat 1: Corlogiro ($58.45 in chips) 
Seat 2: artemxxl ($80.34 in chips) 
Seat 3: jasperge 40 ($48.68 in chips) 
Seat 4: TATAP85 ($73.35 in chips) 
Seat 7: bigned1975 ($67.09 in chips) 
Seat 8: oudine2 ($50 in chips) 
Seat 9: $lavik88 ($50 in chips) 
oudine2: posts small blind $0.25
$lavik88: posts big blind $0.50
*** HOLE CARDS ***
Corlogiro: folds 
artemxxl: folds 
jasperge 40: raises $1 to $1.50
TATAP85: folds 
bigned1975: folds 
oudine2: folds 
$lavik88: folds 
Uncalled bet ($1) returned to jasperge 40
jasperge 40 collected $1.25 from pot
jasperge 40: doesn't show hand 
*** SUMMARY ***
Total pot $1.25 | Rake $0 
Seat 1: Corlogiro folded before Flop (didn't bet)
Seat 2: artemxxl folded before Flop (didn't bet)
Seat 3: jasperge 40 collected ($1.25)
Seat 4: TATAP85 folded before Flop (didn't bet)
Seat 7: bigned1975 (button) folded before Flop (didn't bet)
Seat 8: oudine2 (small blind) folded before Flop
Seat 9: $lavik88 (big blind) folded before Flop



PokerStars Hand #228689544873:  Hold'em No Limit ($0.25/$0.50 USD) - 2021/07/30 17:04:45 ET
Table 'Aitne III' 9-max Seat #8 is the button
Seat 1: Corlogiro ($58.45 in chips) 
Seat 2: artemxxl ($80.34 in chips) 
Seat 3: jasperge 40 ($49.43 in chips) 
Seat 4: TATAP85 ($73.35 in chips) 
Seat 7: bigned1975 ($67.09 in chips) 
Seat 8: oudine2 ($50 in chips) 
Seat 9: $lavik88 ($50 in chips) 
$lavik88: posts small blind $0.25
Corlogiro: posts big blind $0.50
*** HOLE CARDS ***
artemxxl: folds 
jasperge 40: folds 
TATAP85: folds 
bigned1975: raises $1 to $1.50
oudine2: raises $3.50 to $5
$lavik88: folds 
Corlogiro: folds 
bigned1975: calls $3.50
*** FLOP *** [8s Ac Kd]
bigned1975: checks 
oudine2: bets $5.11
bigned1975: folds 
Uncalled bet ($5.11) returned to oudine2
oudine2 collected $10.21 from pot
oudine2: doesn't show hand 
*** SUMMARY ***
Total pot $10.75 | Rake $0.54 
Board [8s Ac Kd]
Seat 1: Corlogiro (big blind) folded before Flop
Seat 2: artemxxl folded before Flop (didn't bet)
Seat 3: jasperge 40 folded before Flop (didn't bet)
Seat 4: TATAP85 folded before Flop (didn't bet)
Seat 7: bigned1975 folded on the Flop
Seat 8: oudine2 (button) collected ($10.21)
Seat 9: $lavik88 (small blind) folded before Flop



PokerStars Hand #228689568895:  Hold'em No Limit ($0.25/$0.50 USD) - 2021/07/30 17:05:35 ET
Table 'Aitne III' 9-max Seat #9 is the button
Seat 1: Corlogiro ($57.95 in chips) 
Seat 2: artemxxl ($80.34 in chips) 
Seat 3: jasperge 40 ($49.43 in chips) 
Seat 4: TATAP85 ($73.35 in chips) 
Seat 6: Kahmi3105 ($227.95 in chips) 
Seat 7: bigned1975 ($62.09 in chips) 
Seat 8: oudine2 ($55.21 in chips) 
Seat 9: $lavik88 ($50 in chips) 
Corlogiro: posts small blind $0.25
artemxxl: posts big blind $0.50
dikanmax: sits out 
Kahmi3105: posts small & big blinds $0.75
*** HOLE CARDS ***
jasperge 40: folds 
TATAP85: folds 
Kahmi3105: raises $2 to $2.50
bigned1975: calls $2.50
oudine2: folds 
$lavik88: folds 
Corlogiro: folds 
artemxxl: folds 
*** FLOP *** [Ac Kh Qh]
Kahmi3105: bets $3.50
bigned1975: raises $6.35 to $9.85
Kahmi3105: calls $6.35
*** TURN *** [Ac Kh Qh] [Th]
Kahmi3105: checks 
bigned1975: bets $12.50
Kahmi3105: calls $12.50
*** RIVER *** [Ac Kh Qh Th] [4h]
Kahmi3105: checks 
bigned1975: checks 
*** SHOW DOWN ***
Kahmi3105: shows [As Qc] (two pair, Aces and Queens)
bigned1975: shows [Ts Js] (a straight, Ten to Ace)
bigned1975 collected $48.70 from pot
*** SUMMARY ***
Total pot $50.70 | Rake $2 
Board [Ac Kh Qh Th 4h]
Seat 1: Corlogiro (small blind) folded before Flop
Seat 2: artemxxl (big blind) folded before Flop
Seat 3: jasperge 40 folded before Flop (didn't bet)
Seat 4: TATAP85 folded before Flop (didn't bet)
Seat 6: Kahmi3105 showed [As Qc] and lost with two pair, Aces and Queens
Seat 7: bigned1975 showed [Ts Js] and won ($48.70) with a straight, Ten to Ace
Seat 8: oudine2 folded before Flop (didn't bet)
Seat 9: $lavik88 (button) folded before Flop (didn't bet)



PokerStars Hand #228689596517:  Hold'em No Limit ($0.25/$0.50 USD) - 2021/07/30 17:06:33 ET
Table 'Aitne III' 9-max Seat #1 is the button
Seat 1: Corlogiro ($57.70 in chips) 
Seat 2: artemxxl ($79.84 in chips) 
Seat 3: jasperge 40 ($49.43 in chips) 
Seat 4: TATAP85 ($73.35 in chips) 
Seat 6: Kahmi3105 ($202.85 in chips) 
Seat 7: bigned1975 ($85.94 in chips) 
Seat 8: oudine2 ($55.21 in chips) 
Seat 9: $lavik88 ($50 in chips) 
artemxxl: posts small blind $0.25
jasperge 40: posts big blind $0.50
dikanmax: sits out 
*** HOLE CARDS ***
TATAP85: folds 
Kahmi3105: raises $1.25 to $1.75
bigned1975: folds 
oudine2: folds 
$lavik88: folds 
Corlogiro: folds 
artemxxl: folds 
jasperge 40: folds 
Uncalled bet ($1.25) returned to Kahmi3105
Kahmi3105 collected $1.25 from pot
*** SUMMARY ***
Total pot $1.25 | Rake $0 
Seat 1: Corlogiro (button) folded before Flop (didn't bet)
Seat 2: artemxxl (small blind) folded before Flop
Seat 3: jasperge 40 (big blind) folded before Flop
Seat 4: TATAP85 folded before Flop (didn't bet)
Seat 6: Kahmi3105 collected ($1.25)
Seat 7: bigned1975 folded before Flop (didn't bet)
Seat 8: oudine2 folded before Flop (didn't bet)
Seat 9: $lavik88 folded before Flop (didn't bet)



PokerStars Hand #228689604910:  Hold'em No Limit ($0.25/$0.50 USD) - 2021/07/30 17:06:50 ET
Table 'Aitne III' 9-max Seat #2 is the button
Seat 1: Corlogiro ($57.70 in chips) 
Seat 2: artemxxl ($79.59 in chips) 
Seat 3: jasperge 40 ($48.93 in chips) 
Seat 4: TATAP85 ($73.35 in chips) 
Seat 6: Kahmi3105 ($203.60 in chips) 
Seat 7: bigned1975 ($85.94 in chips) 
Seat 8: oudine2 ($55.21 in chips) 
Seat 9: $lavik88 ($50 in chips) 
jasperge 40: posts small blind $0.25
TATAP85: posts big blind $0.50
dikanmax: sits out 
*** HOLE CARDS ***
Kahmi3105: folds 
bigned1975: folds 
oudine2: folds 
$lavik88: raises $1 to $1.50
Corlogiro: folds 
artemxxl: folds 
jasperge 40: calls $1.25
TATAP85: folds 
*** FLOP *** [9d 8s Ks]
jasperge 40: checks 
$lavik88: bets $2.49
jasperge 40: folds 
Uncalled bet ($2.49) returned to $lavik88
$lavik88 collected $3.32 from pot
$lavik88: doesn't show hand 
*** SUMMARY ***
Total pot $3.50 | Rake $0.18 
Board [9d 8s Ks]
Seat 1: Corlogiro folded before Flop (didn't bet)
Seat 2: artemxxl (button) folded before Flop (didn't bet)
Seat 3: jasperge 40 (small blind) folded on the Flop
Seat 4: TATAP85 (big blind) folded before Flop
Seat 6: Kahmi3105 folded before Flop (didn't bet)
Seat 7: bigned1975 folded before Flop (didn't bet)
Seat 8: oudine2 folded before Flop (didn't bet)
Seat 9: $lavik88 collected ($3.32)



PokerStars Hand #228689629844:  Hold'em No Limit ($0.25/$0.50 USD) - 2021/07/30 17:07:43 ET
Table 'Aitne III' 9-max Seat #3 is the button
Seat 1: Corlogiro ($57.70 in chips) 
Seat 2: artemxxl ($79.59 in chips) 
Seat 3: jasperge 40 ($47.43 in chips) 
Seat 4: TATAP85 ($72.85 in chips) 
Seat 5: dikanmax ($50 in chips) 
Seat 6: Kahmi3105 ($203.60 in chips) 
Seat 7: bigned1975 ($85.94 in chips) 
Seat 8: oudine2 ($55.21 in chips) 
Seat 9: $lavik88 ($51.82 in chips) 
TATAP85: posts small blind $0.25
dikanmax: posts big blind $0.50
*** HOLE CARDS ***
Kahmi3105: folds 
bigned1975: folds 
oudine2: folds 
$lavik88: folds 
Corlogiro: raises $0.75 to $1.25
artemxxl: folds 
jasperge 40: calls $1.25
TATAP85: folds 
dikanmax: folds 
*** FLOP *** [9h Qd 4h]
Corlogiro: checks 
jasperge 40: bets $1.55
Corlogiro: calls $1.55
*** TURN *** [9h Qd 4h] [2s]
Corlogiro: checks 
jasperge 40: checks 
*** RIVER *** [9h Qd 4h 2s] [Ad]
Corlogiro: checks 
jasperge 40: checks 
*** SHOW DOWN ***
Corlogiro: shows [Ah Jd] (a pair of Aces)
jasperge 40: mucks hand 
Corlogiro collected $5.95 from pot
*** SUMMARY ***
Total pot $6.35 | Rake $0.40 
Board [9h Qd 4h 2s Ad]
Seat 1: Corlogiro showed [Ah Jd] and won ($5.95) with a pair of Aces
Seat 2: artemxxl folded before Flop (didn't bet)
Seat 3: jasperge 40 (button) mucked
Seat 4: TATAP85 (small blind) folded before Flop
Seat 5: dikanmax (big blind) folded before Flop
Seat 6: Kahmi3105 folded before Flop (didn't bet)
Seat 7: bigned1975 folded before Flop (didn't bet)
Seat 8: oudine2 folded before Flop (didn't bet)
Seat 9: $lavik88 folded before Flop (didn't bet)



PokerStars Hand #228689670632:  Hold'em No Limit ($0.25/$0.50 USD) - 2021/07/30 17:09:10 ET
Table 'Aitne III' 9-max Seat #4 is the button
Seat 1: Corlogiro ($60.85 in chips) 
Seat 2: artemxxl ($79.59 in chips) 
Seat 3: jasperge 40 ($44.63 in chips) 
Seat 4: TATAP85 ($72.60 in chips) 
Seat 5: dikanmax ($50 in chips) 
Seat 6: Kahmi3105 ($203.60 in chips) 
Seat 7: bigned1975 ($85.94 in chips) 
Seat 8: oudine2 ($55.21 in chips) 
Seat 9: $lavik88 ($51.82 in chips) 
dikanmax: posts small blind $0.25
Kahmi3105: posts big blind $0.50
*** HOLE CARDS ***
bigned1975: folds 
oudine2: folds 
$lavik88: folds 
Corlogiro: folds 
artemxxl: folds 
jasperge 40 has timed out
jasperge 40: folds 
TATAP85: raises $1 to $1.50
dikanmax: folds 
Kahmi3105: folds 
Uncalled bet ($1) returned to TATAP85
TATAP85 collected $1.25 from pot
TATAP85: doesn't show hand 
*** SUMMARY ***
Total pot $1.25 | Rake $0 
Seat 1: Corlogiro folded before Flop (didn't bet)
Seat 2: artemxxl folded before Flop (didn't bet)
Seat 3: jasperge 40 folded before Flop (didn't bet)
Seat 4: TATAP85 (button) collected ($1.25)
Seat 5: dikanmax (small blind) folded before Flop
Seat 6: Kahmi3105 (big blind) folded before Flop
Seat 7: bigned1975 folded before Flop (didn't bet)
Seat 8: oudine2 folded before Flop (didn't bet)
Seat 9: $lavik88 folded before Flop (didn't bet)



PokerStars Hand #228689683195:  Hold'em No Limit ($0.25/$0.50 USD) - 2021/07/30 17:09:37 ET
Table 'Aitne III' 9-max Seat #5 is the button
Seat 1: Corlogiro ($60.85 in chips) 
Seat 2: artemxxl ($79.59 in chips) 
Seat 3: jasperge 40 ($44.63 in chips) 
Seat 4: TATAP85 ($73.35 in chips) 
Seat 5: dikanmax ($50 in chips) 
Seat 6: Kahmi3105 ($203.10 in chips) 
Seat 7: bigned1975 ($85.94 in chips) 
Seat 8: oudine2 ($55.21 in chips) 
Seat 9: $lavik88 ($51.82 in chips) 
Kahmi3105: posts small blind $0.25
bigned1975: posts big blind $0.50
*** HOLE CARDS ***
oudine2: folds 
$lavik88: folds 
Corlogiro: raises $0.75 to $1.25
artemxxl: folds 
jasperge 40: folds 
TATAP85: folds 
dikanmax: folds 
Kahmi3105: folds 
bigned1975: calls $0.75
*** FLOP *** [Qh 8s Td]
bigned1975: checks 
Corlogiro: checks 
*** TURN *** [Qh 8s Td] [2d]
bigned1975: checks 
Corlogiro: checks 
*** RIVER *** [Qh 8s Td 2d] [5d]
bigned1975: checks 
Corlogiro: checks 
*** SHOW DOWN ***
bigned1975: shows [Ac 4c] (high card Ace)
Corlogiro: shows [7c 7h] (a pair of Sevens)
Corlogiro collected $2.57 from pot
*** SUMMARY ***
Total pot $2.75 | Rake $0.18 
Board [Qh 8s Td 2d 5d]
Seat 1: Corlogiro showed [7c 7h] and won ($2.57) with a pair of Sevens
Seat 2: artemxxl folded before Flop (didn't bet)
Seat 3: jasperge 40 folded before Flop (didn't bet)
Seat 4: TATAP85 folded before Flop (didn't bet)
Seat 5: dikanmax (button) folded before Flop (didn't bet)
Seat 6: Kahmi3105 (small blind) folded before Flop
Seat 7: bigned1975 (big blind) showed [Ac 4c] and lost with high card Ace
Seat 8: oudine2 folded before Flop (didn't bet)
Seat 9: $lavik88 folded before Flop (didn't bet)



PokerStars Hand #228689718169:  Hold'em No Limit ($0.25/$0.50 USD) - 2021/07/30 17:10:51 ET
Table 'Aitne III' 9-max Seat #6 is the button
Seat 1: Corlogiro ($62.17 in chips) 
Seat 2: artemxxl ($79.59 in chips) 
Seat 3: jasperge 40 ($44.63 in chips) 
Seat 4: TATAP85 ($73.35 in chips) 
Seat 5: dikanmax ($50 in chips) 
Seat 6: Kahmi3105 ($202.85 in chips) 
Seat 7: bigned1975 ($84.69 in chips) 
Seat 8: oudine2 ($55.21 in chips) 
Seat 9: $lavik88 ($51.82 in chips) 
bigned1975: posts small blind $0.25
oudine2: posts big blind $0.50
*** HOLE CARDS ***
$lavik88: folds 
Corlogiro: folds 
artemxxl: folds 
jasperge 40: folds 
TATAP85: folds 
dikanmax: folds 
Kahmi3105: raises $1.25 to $1.75
dikanmax leaves the table
bigned1975: folds 
oudine2: folds 
Uncalled bet ($1.25) returned to Kahmi3105
Kahmi3105 collected $1.25 from pot
Pablo1405 joins the table at seat #5 
*** SUMMARY ***
Total pot $1.25 | Rake $0 
Seat 1: Corlogiro folded before Flop (didn't bet)
Seat 2: artemxxl folded before Flop (didn't bet)
Seat 3: jasperge 40 folded before Flop (didn't bet)
Seat 4: TATAP85 folded before Flop (didn't bet)
Seat 5: dikanmax folded before Flop (didn't bet)
Seat 6: Kahmi3105 (button) collected ($1.25)
Seat 7: bigned1975 (small blind) folded before Flop
Seat 8: oudine2 (big blind) folded before Flop
Seat 9: $lavik88 folded before Flop (didn't bet)



PokerStars Hand #228689732655:  Hold'em No Limit ($0.25/$0.50 USD) - 2021/07/30 17:11:23 ET
Table 'Aitne III' 9-max Seat #7 is the button
Seat 1: Corlogiro ($62.17 in chips) 
Seat 2: artemxxl ($79.59 in chips) 
Seat 3: jasperge 40 ($44.63 in chips) 
Seat 4: TATAP85 ($73.35 in chips) 
Seat 6: Kahmi3105 ($203.60 in chips) 
Seat 7: bigned1975 ($84.44 in chips) 
Seat 8: oudine2 ($54.71 in chips) 
Seat 9: $lavik88 ($51.82 in chips) 
oudine2: posts small blind $0.25
$lavik88: posts big blind $0.50
Pablo1405: sits out 
*** HOLE CARDS ***
Corlogiro: folds 
artemxxl: raises $1 to $1.50
jasperge 40: folds 
TATAP85: folds 
Kahmi3105: folds 
bigned1975: raises $3.50 to $5
oudine2: folds 
$lavik88: folds 
artemxxl: folds 
Uncalled bet ($3.50) returned to bigned1975
bigned1975 collected $3.75 from pot
bigned1975: doesn't show hand 
*** SUMMARY ***
Total pot $3.75 | Rake $0 
Seat 1: Corlogiro folded before Flop (didn't bet)
Seat 2: artemxxl folded before Flop
Seat 3: jasperge 40 folded before Flop (didn't bet)
Seat 4: TATAP85 folded before Flop (didn't bet)
Seat 6: Kahmi3105 folded before Flop (didn't bet)
Seat 7: bigned1975 (button) collected ($3.75)
Seat 8: oudine2 (small blind) folded before Flop
Seat 9: $lavik88 (big blind) folded before Flop



PokerStars Hand #228689752412:  Hold'em No Limit ($0.25/$0.50 USD) - 2021/07/30 17:12:06 ET
Table 'Aitne III' 9-max Seat #8 is the button
Seat 1: Corlogiro ($62.17 in chips) 
Seat 2: artemxxl ($78.09 in chips) 
Seat 3: jasperge 40 ($44.63 in chips) 
Seat 4: TATAP85 ($73.35 in chips) 
Seat 6: Kahmi3105 ($203.60 in chips) 
Seat 7: bigned1975 ($86.69 in chips) 
Seat 8: oudine2 ($54.46 in chips) 
Seat 9: $lavik88 ($51.32 in chips) 
$lavik88: posts small blind $0.25
Corlogiro: posts big blind $0.50
Pablo1405: sits out 
*** HOLE CARDS ***
artemxxl: folds 
artemxxl leaves the table
jasperge 40: folds 
TATAP85: raises $0.50 to $1
Kahmi3105: folds 
bigned1975: folds 
Pachebrash joins the table at seat #2 
oudine2: folds 
$lavik88: folds 
Corlogiro: folds 
Uncalled bet ($0.50) returned to TATAP85
TATAP85 collected $1.25 from pot
TATAP85: doesn't show hand 
*** SUMMARY ***
Total pot $1.25 | Rake $0 
Seat 1: Corlogiro (big blind) folded before Flop
Seat 2: artemxxl folded before Flop (didn't bet)
Seat 3: jasperge 40 folded before Flop (didn't bet)
Seat 4: TATAP85 collected ($1.25)
Seat 6: Kahmi3105 folded before Flop (didn't bet)
Seat 7: bigned1975 folded before Flop (didn't bet)
Seat 8: oudine2 (button) folded before Flop (didn't bet)
Seat 9: $lavik88 (small blind) folded before Flop



PokerStars Hand #228689763560:  Hold'em No Limit ($0.25/$0.50 USD) - 2021/07/30 17:12:30 ET
Table 'Aitne III' 9-max Seat #9 is the button
Seat 1: Corlogiro ($61.67 in chips) 
Seat 2: Pachebrash ($105.85 in chips) 
Seat 3: jasperge 40 ($44.63 in chips) 
Seat 4: TATAP85 ($74.10 in chips) 
Seat 6: Kahmi3105 ($203.60 in chips) 
Seat 7: bigned1975 ($86.69 in chips) 
Seat 8: oudine2 ($54.46 in chips) 
Seat 9: $lavik88 ($51.07 in chips) 
Corlogiro: posts small blind $0.25
Pachebrash: posts big blind $0.50
Pablo1405: sits out 
*** HOLE CARDS ***
jasperge 40: raises $0.75 to $1.25
TATAP85: folds 
Kahmi3105: folds 
bigned1975: calls $1.25
oudine2: calls $1.25
$lavik88: raises $5.25 to $6.50
Corlogiro: folds 
Pachebrash: folds 
jasperge 40: calls $5.25
bigned1975: calls $5.25
oudine2: calls $5.25
*** FLOP *** [4c 6d 3h]
jasperge 40: checks 
bigned1975: checks 
oudine2: checks 
$lavik88: bets $7.62
jasperge 40: calls $7.62
bigned1975: folds 
oudine2: calls $7.62
*** TURN *** [4c 6d 3h] [Qd]
Pablo1405 was removed from the table for failing to post
Pablo1405 leaves the table
jasperge 40: bets $30.51 and is all-in
Sonny0306 joins the table at seat #5 
oudine2: folds 
$lavik88: folds 
Uncalled bet ($30.51) returned to jasperge 40
jasperge 40 collected $47.61 from pot
jasperge 40: doesn't show hand 
*** SUMMARY ***
Total pot $49.61 | Rake $2 
Board [4c 6d 3h Qd]
Seat 1: Corlogiro (small blind) folded before Flop
Seat 2: Pachebrash (big blind) folded before Flop
Seat 3: jasperge 40 collected ($47.61)
Seat 4: TATAP85 folded before Flop (didn't bet)
Seat 6: Kahmi3105 folded before Flop (didn't bet)
Seat 7: bigned1975 folded on the Flop
Seat 8: oudine2 folded on the Turn
Seat 9: $lavik88 (button) folded on the Turn



PokerStars Hand #228689813653:  Hold'em No Limit ($0.25/$0.50 USD) - 2021/07/30 17:13:56 ET
Table 'Aitne III' 9-max Seat #1 is the button
Seat 1: Corlogiro ($61.42 in chips) 
Seat 2: Pachebrash ($105.35 in chips) 
Seat 3: jasperge 40 ($78.12 in chips) 
Seat 4: TATAP85 ($74.10 in chips) 
Seat 6: Kahmi3105 ($203.60 in chips) 
Seat 7: bigned1975 ($80.19 in chips) 
Seat 8: oudine2 ($50 in chips) 
Seat 9: $lavik88 ($50 in chips) 
Pachebrash: posts small blind $0.25
jasperge 40: posts big blind $0.50
Sonny0306: sits out 
*** HOLE CARDS ***
TATAP85: folds 
Kahmi3105: folds 
bigned1975: folds 
oudine2: folds 
$lavik88: folds 
Corlogiro: raises $0.75 to $1.25
Pachebrash: folds 
jasperge 40: calls $0.75
*** FLOP *** [5s 9h Kd]
jasperge 40: bets $1.31
Corlogiro: folds 
Uncalled bet ($1.31) returned to jasperge 40
jasperge 40 collected $2.61 from pot
jasperge 40: doesn't show hand 
*** SUMMARY ***
Total pot $2.75 | Rake $0.14 
Board [5s 9h Kd]
Seat 1: Corlogiro (button) folded on the Flop
Seat 2: Pachebrash (small blind) folded before Flop
Seat 3: jasperge 40 (big blind) collected ($2.61)
Seat 4: TATAP85 folded before Flop (didn't bet)
Seat 6: Kahmi3105 folded before Flop (didn't bet)
Seat 7: bigned1975 folded before Flop (didn't bet)
Seat 8: oudine2 folded before Flop (didn't bet)
Seat 9: $lavik88 folded before Flop (didn't bet)



PokerStars Hand #228689828588:  Hold'em No Limit ($0.25/$0.50 USD) - 2021/07/30 17:14:28 ET
Table 'Aitne III' 9-max Seat #2 is the button
Seat 1: Corlogiro ($60.17 in chips) 
Seat 2: Pachebrash ($105.10 in chips) 
Seat 3: jasperge 40 ($79.48 in chips) 
Seat 4: TATAP85 ($74.10 in chips) 
Seat 6: Kahmi3105 ($203.60 in chips) 
Seat 7: bigned1975 ($80.19 in chips) 
Seat 8: oudine2 ($50 in chips) 
Seat 9: $lavik88 ($50 in chips) 
jasperge 40: posts small blind $0.25
TATAP85: posts big blind $0.50
Sonny0306: sits out 
*** HOLE CARDS ***
Kahmi3105: folds 
bigned1975: folds 
oudine2: folds 
$lavik88: folds 
Corlogiro: folds 
Pachebrash: folds 
jasperge 40: raises $0.50 to $1
TATAP85: folds 
Uncalled bet ($0.50) returned to jasperge 40
jasperge 40 collected $1 from pot
jasperge 40: doesn't show hand 
*** SUMMARY ***
Total pot $1 | Rake $0 
Seat 1: Corlogiro folded before Flop (didn't bet)
Seat 2: Pachebrash (button) folded before Flop (didn't bet)
Seat 3: jasperge 40 (small blind) collected ($1)
Seat 4: TATAP85 (big blind) folded before Flop
Seat 6: Kahmi3105 folded before Flop (didn't bet)
Seat 7: bigned1975 folded before Flop (didn't bet)
Seat 8: oudine2 folded before Flop (didn't bet)
Seat 9: $lavik88 folded before Flop (didn't bet)



PokerStars Hand #228689844584:  Hold'em No Limit ($0.25/$0.50 USD) - 2021/07/30 17:15:02 ET
Table 'Aitne III' 9-max Seat #3 is the button
Seat 1: Corlogiro ($60.17 in chips) 
Seat 2: Pachebrash ($105.10 in chips) 
Seat 3: jasperge 40 ($79.98 in chips) 
Seat 4: TATAP85 ($73.60 in chips) 
Seat 5: Sonny0306 ($50 in chips) 
Seat 6: Kahmi3105 ($203.60 in chips) 
Seat 7: bigned1975 ($80.19 in chips) 
Seat 8: oudine2 ($50 in chips) 
Seat 9: $lavik88 ($50 in chips) 
TATAP85: posts small blind $0.25
Sonny0306: posts big blind $0.50
*** HOLE CARDS ***
Kahmi3105: folds 
bigned1975: folds 
oudine2: folds 
$lavik88: folds 
Corlogiro: folds 
Pachebrash: raises $0.75 to $1.25
jasperge 40: calls $1.25
TATAP85: folds 
Sonny0306: folds 
*** FLOP *** [2d 3h 2s]
Pachebrash: bets $1.58
jasperge 40: folds 
Uncalled bet ($1.58) returned to Pachebrash
Pachebrash collected $3.09 from pot
Pachebrash: doesn't show hand 
*** SUMMARY ***
Total pot $3.25 | Rake $0.16 
Board [2d 3h 2s]
Seat 1: Corlogiro folded before Flop (didn't bet)
Seat 2: Pachebrash collected ($3.09)
Seat 3: jasperge 40 (button) folded on the Flop
Seat 4: TATAP85 (small blind) folded before Flop
Seat 5: Sonny0306 (big blind) folded before Flop
Seat 6: Kahmi3105 folded before Flop (didn't bet)
Seat 7: bigned1975 folded before Flop (didn't bet)
Seat 8: oudine2 folded before Flop (didn't bet)
Seat 9: $lavik88 folded before Flop (didn't bet)



PokerStars Hand #228689864815:  Hold'em No Limit ($0.25/$0.50 USD) - 2021/07/30 17:15:45 ET
Table 'Aitne III' 9-max Seat #4 is the button
Seat 1: Corlogiro ($60.17 in chips) 
Seat 2: Pachebrash ($106.94 in chips) 
Seat 3: jasperge 40 ($78.73 in chips) 
Seat 4: TATAP85 ($73.35 in chips) 
Seat 5: Sonny0306 ($50 in chips) 
Seat 6: Kahmi3105 ($203.60 in chips) 
Seat 7: bigned1975 ($80.19 in chips) 
Seat 8: oudine2 ($50 in chips) 
Seat 9: $lavik88 ($50 in chips) 
Sonny0306: posts small blind $0.25
Kahmi3105: posts big blind $0.50
*** HOLE CARDS ***
bigned1975: folds 
oudine2: folds 
$lavik88: folds 
Corlogiro: folds 
Pachebrash: folds 
jasperge 40: raises $0.75 to $1.25
TATAP85: folds 
Sonny0306: raises $3.25 to $4.50
Kahmi3105: folds 
jasperge 40: calls $3.25
*** FLOP *** [3c 4h 5s]
Sonny0306: bets $3.50
jasperge 40: calls $3.50
*** TURN *** [3c 4h 5s] [Ad]
Sonny0306: checks 
jasperge 40: bets $7.84
Sonny0306: calls $7.84
*** RIVER *** [3c 4h 5s Ad] [Js]
Sonny0306: checks 
jasperge 40: bets $15.29
Sonny0306: calls $15.29
*** SHOW DOWN ***
jasperge 40: shows [8c 6c] (high card Ace)
Sonny0306: shows [Ah Kh] (a pair of Aces)
Sonny0306 collected $60.76 from pot
*** SUMMARY ***
Total pot $62.76 | Rake $2 
Board [3c 4h 5s Ad Js]
Seat 1: Corlogiro folded before Flop (didn't bet)
Seat 2: Pachebrash folded before Flop (didn't bet)
Seat 3: jasperge 40 showed [8c 6c] and lost with high card Ace
Seat 4: TATAP85 (button) folded before Flop (didn't bet)
Seat 5: Sonny0306 (small blind) showed [Ah Kh] and won ($60.76) with a pair of Aces
Seat 6: Kahmi3105 (big blind) folded before Flop
Seat 7: bigned1975 folded before Flop (didn't bet)
Seat 8: oudine2 folded before Flop (didn't bet)
Seat 9: $lavik88 folded before Flop (didn't bet)



PokerStars Hand #228689913061:  Hold'em No Limit ($0.25/$0.50 USD) - 2021/07/30 17:17:28 ET
Table 'Aitne III' 9-max Seat #5 is the button
Seat 1: Corlogiro ($60.17 in chips) 
Seat 2: Pachebrash ($106.94 in chips) 
Seat 3: jasperge 40 ($47.60 in chips) 
Seat 4: TATAP85 ($73.35 in chips) 
Seat 5: Sonny0306 ($79.63 in chips) 
Seat 6: Kahmi3105 ($203.10 in chips) 
Seat 7: bigned1975 ($80.19 in chips) 
Seat 8: oudine2 ($50 in chips) 
Seat 9: $lavik88 ($50 in chips) 
Kahmi3105: posts small blind $0.25
bigned1975: posts big blind $0.50
*** HOLE CARDS ***
oudine2: folds 
$lavik88: folds 
Corlogiro: folds 
Pachebrash: folds 
jasperge 40: raises $0.75 to $1.25
TATAP85: folds 
Sonny0306: calls $1.25
Kahmi3105: calls $1
bigned1975: calls $0.75
*** FLOP *** [Ts 7h 9c]
Kahmi3105: checks 
bigned1975: checks 
jasperge 40: bets $2.38
Sonny0306: folds 
Kahmi3105: calls $2.38
bigned1975: folds 
*** TURN *** [Ts 7h 9c] [9h]
Kahmi3105: checks 
jasperge 40: bets $2.78
Kahmi3105: calls $2.78
*** RIVER *** [Ts 7h 9c 9h] [7d]
Kahmi3105: checks 
jasperge 40: bets $7.28
Kahmi3105: raises $15.22 to $22.50
jasperge 40: calls $15.22
*** SHOW DOWN ***
Kahmi3105: shows [9d As] (a full house, Nines full of Sevens)
jasperge 40: shows [9s Ks] (a full house, Nines full of Sevens)
Kahmi3105 collected $28.91 from pot
jasperge 40 collected $29.16 from pot
*** SUMMARY ***
Total pot $60.32 | Rake $2.25 
Board [Ts 7h 9c 9h 7d]
Seat 1: Corlogiro folded before Flop (didn't bet)
Seat 2: Pachebrash folded before Flop (didn't bet)
Seat 3: jasperge 40 showed [9s Ks] and won ($29.16) with a full house, Nines full of Sevens
Seat 4: TATAP85 folded before Flop (didn't bet)
Seat 5: Sonny0306 (button) folded on the Flop
Seat 6: Kahmi3105 (small blind) showed [9d As] and won ($28.91) with a full house, Nines full of Sevens
Seat 7: bigned1975 (big blind) folded on the Flop
Seat 8: oudine2 folded before Flop (didn't bet)
Seat 9: $lavik88 folded before Flop (didn't bet)



PokerStars Hand #228689959879:  Hold'em No Limit ($0.25/$0.50 USD) - 2021/07/30 17:19:10 ET
Table 'Aitne III' 9-max Seat #6 is the button
Seat 1: Corlogiro ($60.17 in chips) 
Seat 2: Pachebrash ($106.94 in chips) 
Seat 3: jasperge 40 ($47.85 in chips) 
Seat 4: TATAP85 ($73.35 in chips) 
Seat 5: Sonny0306 ($78.38 in chips) 
Seat 6: Kahmi3105 ($203.10 in chips) 
Seat 7: bigned1975 ($78.94 in chips) 
Seat 8: oudine2 ($50 in chips) 
Seat 9: $lavik88 ($50 in chips) 
bigned1975: posts small blind $0.25
oudine2: posts big blind $0.50
*** HOLE CARDS ***
$lavik88: folds 
Corlogiro: folds 
Pachebrash: folds 
jasperge 40: folds 
TATAP85: folds 
Sonny0306: raises $0.75 to $1.25
Kahmi3105: folds 
bigned1975: folds 
oudine2: folds 
Uncalled bet ($0.75) returned to Sonny0306
Sonny0306 collected $1.25 from pot
Sonny0306: doesn't show hand 
*** SUMMARY ***
Total pot $1.25 | Rake $0 
Seat 1: Corlogiro folded before Flop (didn't bet)
Seat 2: Pachebrash folded before Flop (didn't bet)
Seat 3: jasperge 40 folded before Flop (didn't bet)
Seat 4: TATAP85 folded before Flop (didn't bet)
Seat 5: Sonny0306 collected ($1.25)
Seat 6: Kahmi3105 (button) folded before Flop (didn't bet)
Seat 7: bigned1975 (small blind) folded before Flop
Seat 8: oudine2 (big blind) folded before Flop
Seat 9: $lavik88 folded before Flop (didn't bet)



PokerStars Hand #228689974121:  Hold'em No Limit ($0.25/$0.50 USD) - 2021/07/30 17:19:41 ET
Table 'Aitne III' 9-max Seat #7 is the button
Seat 1: Corlogiro ($60.17 in chips) 
Seat 2: Pachebrash ($106.94 in chips) 
Seat 3: jasperge 40 ($47.85 in chips) 
Seat 4: TATAP85 ($73.35 in chips) 
Seat 5: Sonny0306 ($79.13 in chips) 
Seat 6: Kahmi3105 ($203.10 in chips) 
Seat 7: bigned1975 ($78.69 in chips) 
Seat 8: oudine2 ($50 in chips) 
oudine2: posts small blind $0.25
$lavik88: is sitting out 
$lavik88 leaves the table
Corlogiro: posts big blind $0.50
*** HOLE CARDS ***
Pachebrash: folds 
jasperge 40: folds 
TATAP85: folds 
Sonny0306: folds 
Kahmi3105: raises $1.25 to $1.75
bigned1975: folds 
oudine2: folds 
Corlogiro: folds 
Uncalled bet ($1.25) returned to Kahmi3105
Kahmi3105 collected $1.25 from pot
*** SUMMARY ***
Total pot $1.25 | Rake $0 
Seat 1: Corlogiro (big blind) folded before Flop
Seat 2: Pachebrash folded before Flop (didn't bet)
Seat 3: jasperge 40 folded before Flop (didn't bet)
Seat 4: TATAP85 folded before Flop (didn't bet)
Seat 5: Sonny0306 folded before Flop (didn't bet)
Seat 6: Kahmi3105 collected ($1.25)
Seat 7: bigned1975 (button) folded before Flop (didn't bet)
Seat 8: oudine2 (small blind) folded before Flop



PokerStars Hand #228689982987:  Hold'em No Limit ($0.25/$0.50 USD) - 2021/07/30 17:20:00 ET
Table 'Aitne III' 9-max Seat #8 is the button
Seat 1: Corlogiro ($59.67 in chips) 
Seat 2: Pachebrash ($106.94 in chips) 
Seat 3: jasperge 40 ($47.85 in chips) 
Seat 4: TATAP85 ($73.35 in chips) 
Seat 5: Sonny0306 ($79.13 in chips) 
Seat 6: Kahmi3105 ($203.85 in chips) 
Seat 7: bigned1975 ($78.69 in chips) 
Seat 8: oudine2 ($50 in chips) 
Corlogiro: posts small blind $0.25
Pachebrash: posts big blind $0.50
*** HOLE CARDS ***
jasperge 40: raises $1.25 to $1.75
TATAP85: folds 
Sonny0306: folds 
Kahmi3105: calls $1.75
Nestle170 joins the table at seat #9 
bigned1975: folds 
oudine2: folds 
Corlogiro: folds 
Pachebrash: folds 
*** FLOP *** [7c Ad 6s]
jasperge 40: bets $2.02
Kahmi3105: folds 
Uncalled bet ($2.02) returned to jasperge 40
jasperge 40 collected $4.04 from pot
jasperge 40: doesn't show hand 
*** SUMMARY ***
Total pot $4.25 | Rake $0.21 
Board [7c Ad 6s]
Seat 1: Corlogiro (small blind) folded before Flop
Seat 2: Pachebrash (big blind) folded before Flop
Seat 3: jasperge 40 collected ($4.04)
Seat 4: TATAP85 folded before Flop (didn't bet)
Seat 5: Sonny0306 folded before Flop (didn't bet)
Seat 6: Kahmi3105 folded on the Flop
Seat 7: bigned1975 folded before Flop (didn't bet)
Seat 8: oudine2 (button) folded before Flop (didn't bet)



PokerStars Hand #228689995602:  Hold'em No Limit ($0.25/$0.50 USD) - 2021/07/30 17:20:27 ET
Table 'Aitne III' 9-max Seat #1 is the button
Seat 1: Corlogiro ($59.42 in chips) 
Seat 2: Pachebrash ($106.44 in chips) 
Seat 3: jasperge 40 ($50.14 in chips) 
Seat 4: TATAP85 ($73.35 in chips) 
Seat 5: Sonny0306 ($79.13 in chips) 
Seat 6: Kahmi3105 ($202.10 in chips) 
Seat 7: bigned1975 ($78.69 in chips) 
Seat 8: oudine2 ($50 in chips) 
Pachebrash: posts small blind $0.25
jasperge 40: posts big blind $0.50
Nestle170: sits out 
*** HOLE CARDS ***
TATAP85: folds 
Sonny0306: folds 
Kahmi3105: folds 
bigned1975: folds 
oudine2: folds 
Corlogiro: folds 
Pachebrash: raises $0.50 to $1
jasperge 40: raises $2 to $3
Pachebrash: folds 
Uncalled bet ($2) returned to jasperge 40
jasperge 40 collected $2 from pot
jasperge 40: doesn't show hand 
*** SUMMARY ***
Total pot $2 | Rake $0 
Seat 1: Corlogiro (button) folded before Flop (didn't bet)
Seat 2: Pachebrash (small blind) folded before Flop
Seat 3: jasperge 40 (big blind) collected ($2)
Seat 4: TATAP85 folded before Flop (didn't bet)
Seat 5: Sonny0306 folded before Flop (didn't bet)
Seat 6: Kahmi3105 folded before Flop (didn't bet)
Seat 7: bigned1975 folded before Flop (didn't bet)
Seat 8: oudine2 folded before Flop (didn't bet)



PokerStars Hand #228690235134:  Hold'em No Limit ($0.25/$0.50 USD) - 2021/07/30 17:28:56 ET
Table 'Aitne III' 9-max Seat #5 is the button
Seat 1: Corlogiro ($107.42 in chips) 
Seat 2: Pachebrash ($106.19 in chips) 
Seat 3: SwissSkier ($50 in chips) 
Seat 4: TATAP85 ($70.85 in chips) 
Seat 5: Sonny0306 ($79.96 in chips) 
Seat 6: Kahmi3105 ($183.08 in chips) 
Seat 7: bigned1975 ($80 in chips) 
Seat 8: oudine2 ($50 in chips) 
Seat 9: Nestle170 ($123.48 in chips) 
Kahmi3105: posts small blind $0.25
bigned1975: posts big blind $0.50
*** HOLE CARDS ***
oudine2: folds 
Nestle170: folds 
Corlogiro: folds 
Pachebrash: folds 
SwissSkier: folds 
TATAP85: folds 
Sonny0306: folds 
Kahmi3105: folds 
Uncalled bet ($0.25) returned to bigned1975
bigned1975 collected $0.50 from pot
bigned1975: doesn't show hand 
*** SUMMARY ***
Total pot $0.50 | Rake $0 
Seat 1: Corlogiro folded before Flop (didn't bet)
Seat 2: Pachebrash folded before Flop (didn't bet)
Seat 3: SwissSkier folded before Flop (didn't bet)
Seat 4: TATAP85 folded before Flop (didn't bet)
Seat 5: Sonny0306 (button) folded before Flop (didn't bet)
Seat 6: Kahmi3105 (small blind) folded before Flop
Seat 7: bigned1975 (big blind) collected ($0.50)
Seat 8: oudine2 folded before Flop (didn't bet)
Seat 9: Nestle170 folded before Flop (didn't bet)



PokerStars Hand #228690864209:  Hold'em No Limit ($0.25/$0.50 USD) - 2021/07/30 17:52:29 ET
Table 'Aitne III' 9-max Seat #5 is the button
Seat 1: Corlogiro ($92.92 in chips) 
Seat 2: Pachebrash ($107.12 in chips) 
Seat 3: SwissSkier ($77.07 in chips) 
Seat 4: TATAP85 ($65.65 in chips) 
Seat 5: Sonny0306 ($82.06 in chips) 
Seat 6: Kahmi3105 ($208.06 in chips) 
Seat 7: bigned1975 ($60.62 in chips) 
Seat 8: oudine2 ($50 in chips) 
Seat 9: leooooon79 ($19.60 in chips) 
Kahmi3105: posts small blind $0.25
bigned1975: posts big blind $0.50
*** HOLE CARDS ***
oudine2: calls $0.50
leooooon79: calls $0.50
Corlogiro: folds 
Pachebrash: folds 
SwissSkier: folds 
TATAP85: folds 
Sonny0306: folds 
Kahmi3105: folds 
bigned1975: checks 
*** FLOP *** [Kd Ks 7s]
bigned1975: checks 
oudine2: checks 
leooooon79: checks 
*** TURN *** [Kd Ks 7s] [4d]
bigned1975: bets $1
oudine2: folds 
leooooon79: folds 
Uncalled bet ($1) returned to bigned1975
bigned1975 collected $1.66 from pot
bigned1975: doesn't show hand 
*** SUMMARY ***
Total pot $1.75 | Rake $0.09 
Board [Kd Ks 7s 4d]
Seat 1: Corlogiro folded before Flop (didn't bet)
Seat 2: Pachebrash folded before Flop (didn't bet)
Seat 3: SwissSkier folded before Flop (didn't bet)
Seat 4: TATAP85 folded before Flop (didn't bet)
Seat 5: Sonny0306 (button) folded before Flop (didn't bet)
Seat 6: Kahmi3105 (small blind) folded before Flop
Seat 7: bigned1975 (big blind) collected ($1.66)
Seat 8: oudine2 folded on the Turn
Seat 9: leooooon79 folded on the Turn



PokerStars Hand #228690890510:  Hold'em No Limit ($0.25/$0.50 USD) - 2021/07/30 17:53:28 ET
Table 'Aitne III' 9-max Seat #6 is the button
Seat 1: Corlogiro ($92.92 in chips) 
Seat 2: Pachebrash ($107.12 in chips) 
Seat 4: TATAP85 ($65.65 in chips) 
Seat 5: Sonny0306 ($82.06 in chips) 
Seat 6: Kahmi3105 ($207.81 in chips) 
Seat 7: bigned1975 ($61.78 in chips) 
Seat 8: oudine2 ($50 in chips) 
Seat 9: leooooon79 ($19.10 in chips) 
bigned1975: posts small blind $0.25
oudine2: posts big blind $0.50
*** HOLE CARDS ***
leooooon79: folds 
Corlogiro: folds 
Pachebrash: folds 
TATAP85: folds 
Sonny0306: raises $0.75 to $1.25
Kahmi3105: folds 
bigned1975: folds 
oudine2: folds 
Uncalled bet ($0.75) returned to Sonny0306
Sonny0306 collected $1.25 from pot
Sonny0306: doesn't show hand 
*** SUMMARY ***
Total pot $1.25 | Rake $0 
Seat 1: Corlogiro folded before Flop (didn't bet)
Seat 2: Pachebrash folded before Flop (didn't bet)
Seat 4: TATAP85 folded before Flop (didn't bet)
Seat 5: Sonny0306 collected ($1.25)
Seat 6: Kahmi3105 (button) folded before Flop (didn't bet)
Seat 7: bigned1975 (small blind) folded before Flop
Seat 8: oudine2 (big blind) folded before Flop
Seat 9: leooooon79 folded before Flop (didn't bet)



PokerStars Hand #228690899355:  Hold'em No Limit ($0.25/$0.50 USD) - 2021/07/30 17:53:49 ET
Table 'Aitne III' 9-max Seat #7 is the button
Seat 1: Corlogiro ($92.92 in chips) 
Seat 2: Pachebrash ($107.12 in chips) 
Seat 4: TATAP85 ($65.65 in chips) 
Seat 5: Sonny0306 ($82.81 in chips) 
Seat 6: Kahmi3105 ($207.81 in chips) 
Seat 7: bigned1975 ($61.53 in chips) 
Seat 8: oudine2 ($50 in chips) 
Seat 9: leooooon79 ($19.10 in chips) 
oudine2: posts small blind $0.25
leooooon79: posts big blind $0.50
*** HOLE CARDS ***
Corlogiro: folds 
Pachebrash: folds 
TATAP85: folds 
Sonny0306: folds 
Kahmi3105: folds 
bigned1975: raises $1 to $1.50
oudine2: folds 
leooooon79: calls $1
*** FLOP *** [7d 8s Qc]
leooooon79: checks 
bigned1975: bets $2.75
leooooon79: calls $2.75
*** TURN *** [7d 8s Qc] [Qh]
leooooon79: checks 
bigned1975: checks 
*** RIVER *** [7d 8s Qc Qh] [Th]
leooooon79: bets $6.15
bigned1975: folds 
Uncalled bet ($6.15) returned to leooooon79
leooooon79 collected $8.31 from pot
leooooon79: doesn't show hand 
*** SUMMARY ***
Total pot $8.75 | Rake $0.44 
Board [7d 8s Qc Qh Th]
Seat 1: Corlogiro folded before Flop (didn't bet)
Seat 2: Pachebrash folded before Flop (didn't bet)
Seat 4: TATAP85 folded before Flop (didn't bet)
Seat 5: Sonny0306 folded before Flop (didn't bet)
Seat 6: Kahmi3105 folded before Flop (didn't bet)
Seat 7: bigned1975 (button) folded on the River
Seat 8: oudine2 (small blind) folded before Flop
Seat 9: leooooon79 (big blind) collected ($8.31)



PokerStars Hand #228690009544:  Hold'em No Limit ($0.25/$0.50 USD) - 2021/07/30 17:20:57 ET
Table 'Aitne III' 9-max Seat #2 is the button
Seat 1: Corlogiro ($59.42 in chips) 
Seat 2: Pachebrash ($105.44 in chips) 
Seat 3: jasperge 40 ($51.14 in chips) 
Seat 4: TATAP85 ($73.35 in chips) 
Seat 5: Sonny0306 ($79.13 in chips) 
Seat 6: Kahmi3105 ($202.10 in chips) 
Seat 7: bigned1975 ($78.69 in chips) 
Seat 8: oudine2 ($50 in chips) 
jasperge 40: posts small blind $0.25
TATAP85: posts big blind $0.50
Nestle170: sits out 
*** HOLE CARDS ***
Sonny0306: folds 
Kahmi3105: raises $1.25 to $1.75
bigned1975: folds 
oudine2: folds 
Corlogiro: folds 
Pachebrash: folds 
jasperge 40: raises $4 to $5.75
TATAP85: folds 
Kahmi3105: calls $4
*** FLOP *** [4d Js 7c]
jasperge 40: bets $5.70
Kahmi3105: calls $5.70
*** TURN *** [4d Js 7c] [8d]
jasperge 40: bets $11.12
Kahmi3105: calls $11.12
*** RIVER *** [4d Js 7c 8d] [Jh]
jasperge 40: bets $28.57 and is all-in
Kahmi3105: folds 
Uncalled bet ($28.57) returned to jasperge 40
jasperge 40 collected $43.64 from pot
jasperge 40: doesn't show hand 
*** SUMMARY ***
Total pot $45.64 | Rake $2 
Board [4d Js 7c 8d Jh]
Seat 1: Corlogiro folded before Flop (didn't bet)
Seat 2: Pachebrash (button) folded before Flop (didn't bet)
Seat 3: jasperge 40 (small blind) collected ($43.64)
Seat 4: TATAP85 (big blind) folded before Flop
Seat 5: Sonny0306 folded before Flop (didn't bet)
Seat 6: Kahmi3105 folded on the River
Seat 7: bigned1975 folded before Flop (didn't bet)
Seat 8: oudine2 folded before Flop (didn't bet)



PokerStars Hand #228690044445:  Hold'em No Limit ($0.25/$0.50 USD) - 2021/07/30 17:22:13 ET
Table 'Aitne III' 9-max Seat #3 is the button
Seat 1: Corlogiro ($59.42 in chips) 
Seat 2: Pachebrash ($105.44 in chips) 
Seat 3: jasperge 40 ($72.21 in chips) 
Seat 4: TATAP85 ($72.85 in chips) 
Seat 5: Sonny0306 ($79.13 in chips) 
Seat 6: Kahmi3105 ($179.53 in chips) 
Seat 7: bigned1975 ($78.69 in chips) 
Seat 8: oudine2 ($50 in chips) 
TATAP85: posts small blind $0.25
Sonny0306: posts big blind $0.50
Nestle170: sits out 
*** HOLE CARDS ***
Kahmi3105: folds 
bigned1975: raises $1 to $1.50
oudine2: folds 
Corlogiro: calls $1.50
Pachebrash: folds 
jasperge 40: folds 
TATAP85: folds 
Sonny0306: folds 
*** FLOP *** [3d 5c Qs]
bigned1975: bets $2.25
Corlogiro: folds 
Uncalled bet ($2.25) returned to bigned1975
bigned1975 collected $3.56 from pot
bigned1975: doesn't show hand 
*** SUMMARY ***
Total pot $3.75 | Rake $0.19 
Board [3d 5c Qs]
Seat 1: Corlogiro folded on the Flop
Seat 2: Pachebrash folded before Flop (didn't bet)
Seat 3: jasperge 40 (button) folded before Flop (didn't bet)
Seat 4: TATAP85 (small blind) folded before Flop
Seat 5: Sonny0306 (big blind) folded before Flop
Seat 6: Kahmi3105 folded before Flop (didn't bet)
Seat 7: bigned1975 collected ($3.56)
Seat 8: oudine2 folded before Flop (didn't bet)



PokerStars Hand #228690060317:  Hold'em No Limit ($0.25/$0.50 USD) - 2021/07/30 17:22:47 ET
Table 'Aitne III' 9-max Seat #4 is the button
Seat 1: Corlogiro ($57.92 in chips) 
Seat 2: Pachebrash ($105.44 in chips) 
Seat 3: jasperge 40 ($72.21 in chips) 
Seat 4: TATAP85 ($72.60 in chips) 
Seat 5: Sonny0306 ($78.63 in chips) 
Seat 6: Kahmi3105 ($179.53 in chips) 
Seat 7: bigned1975 ($80.75 in chips) 
Seat 8: oudine2 ($50 in chips) 
Sonny0306: posts small blind $0.25
Kahmi3105: posts big blind $0.50
Nestle170: sits out 
*** HOLE CARDS ***
bigned1975: folds 
oudine2: folds 
Corlogiro: raises $0.75 to $1.25
Pachebrash: folds 
jasperge 40: folds 
TATAP85: calls $1.25
Sonny0306: folds 
Kahmi3105: calls $0.75
*** FLOP *** [8c As Jc]
jasperge 40 leaves the table
Kahmi3105: checks 
Corlogiro: checks 
galina8383 joins the table at seat #3 
TATAP85: checks 
*** TURN *** [8c As Jc] [2c]
Kahmi3105: checks 
Corlogiro: checks 
galina8383 leaves the table
TATAP85: checks 
*** RIVER *** [8c As Jc 2c] [3h]
Kahmi3105: checks 
Corlogiro: checks 
TATAP85: checks 
*** SHOW DOWN ***
Kahmi3105: shows [Jd Qh] (a pair of Jacks)
Corlogiro: mucks hand 
TATAP85: mucks hand 
Kahmi3105 collected $3.75 from pot
*** SUMMARY ***
Total pot $4 | Rake $0.25 
Board [8c As Jc 2c 3h]
Seat 1: Corlogiro mucked
Seat 2: Pachebrash folded before Flop (didn't bet)
Seat 3: jasperge 40 folded before Flop (didn't bet)
Seat 4: TATAP85 (button) mucked
Seat 5: Sonny0306 (small blind) folded before Flop
Seat 6: Kahmi3105 (big blind) showed [Jd Qh] and won ($3.75) with a pair of Jacks
Seat 7: bigned1975 folded before Flop (didn't bet)
Seat 8: oudine2 folded before Flop (didn't bet)



PokerStars Hand #228690097658:  Hold'em No Limit ($0.25/$0.50 USD) - 2021/07/30 17:24:08 ET
Table 'Aitne III' 9-max Seat #5 is the button
Seat 1: Corlogiro ($56.67 in chips) 
Seat 2: Pachebrash ($105.44 in chips) 
Seat 4: TATAP85 ($71.35 in chips) 
Seat 5: Sonny0306 ($78.38 in chips) 
Seat 6: Kahmi3105 ($182.03 in chips) 
Seat 7: bigned1975 ($80.75 in chips) 
Seat 8: oudine2 ($50 in chips) 
Kahmi3105: posts small blind $0.25
bigned1975: posts big blind $0.50
Nestle170: sits out 
*** HOLE CARDS ***
oudine2: folds 
Corlogiro: folds 
Pachebrash: raises $1 to $1.50
TATAP85: folds 
Sonny0306: folds 
Kahmi3105: folds 
bigned1975: folds 
Uncalled bet ($1) returned to Pachebrash
Pachebrash collected $1.25 from pot
Pachebrash: doesn't show hand 
*** SUMMARY ***
Total pot $1.25 | Rake $0 
Seat 1: Corlogiro folded before Flop (didn't bet)
Seat 2: Pachebrash collected ($1.25)
Seat 4: TATAP85 folded before Flop (didn't bet)
Seat 5: Sonny0306 (button) folded before Flop (didn't bet)
Seat 6: Kahmi3105 (small blind) folded before Flop
Seat 7: bigned1975 (big blind) folded before Flop
Seat 8: oudine2 folded before Flop (didn't bet)



PokerStars Hand #228690106816:  Hold'em No Limit ($0.25/$0.50 USD) - 2021/07/30 17:24:28 ET
Table 'Aitne III' 9-max Seat #6 is the button
Seat 1: Corlogiro ($56.67 in chips) 
Seat 2: Pachebrash ($106.19 in chips) 
Seat 4: TATAP85 ($71.35 in chips) 
Seat 5: Sonny0306 ($78.38 in chips) 
Seat 6: Kahmi3105 ($181.78 in chips) 
Seat 7: bigned1975 ($80.25 in chips) 
Seat 8: oudine2 ($50 in chips) 
bigned1975: posts small blind $0.25
oudine2: posts big blind $0.50
Nestle170: sits out 
*** HOLE CARDS ***
Corlogiro: folds 
Pachebrash: folds 
TATAP85: folds 
Sonny0306: folds 
Kahmi3105: folds 
SwissSkier joins the table at seat #3 
bigned1975: folds 
Uncalled bet ($0.25) returned to oudine2
oudine2 collected $0.50 from pot
oudine2: doesn't show hand 
*** SUMMARY ***
Total pot $0.50 | Rake $0 
Seat 1: Corlogiro folded before Flop (didn't bet)
Seat 2: Pachebrash folded before Flop (didn't bet)
Seat 4: TATAP85 folded before Flop (didn't bet)
Seat 5: Sonny0306 folded before Flop (didn't bet)
Seat 6: Kahmi3105 (button) folded before Flop (didn't bet)
Seat 7: bigned1975 (small blind) folded before Flop
Seat 8: oudine2 (big blind) collected ($0.50)



PokerStars Hand #228690114180:  Hold'em No Limit ($0.25/$0.50 USD) - 2021/07/30 17:24:44 ET
Table 'Aitne III' 9-max Seat #7 is the button
Seat 1: Corlogiro ($56.67 in chips) 
Seat 2: Pachebrash ($106.19 in chips) 
Seat 4: TATAP85 ($71.35 in chips) 
Seat 5: Sonny0306 ($78.38 in chips) 
Seat 6: Kahmi3105 ($181.78 in chips) 
Seat 7: bigned1975 ($80 in chips) 
Seat 8: oudine2 ($50.25 in chips) 
Seat 9: Nestle170 ($125.39 in chips) 
oudine2: posts small blind $0.25
Nestle170: posts big blind $0.50
SwissSkier: sits out 
*** HOLE CARDS ***
Corlogiro: folds 
Pachebrash: folds 
TATAP85: folds 
Sonny0306: raises $0.75 to $1.25
Kahmi3105: folds 
bigned1975: folds 
oudine2: folds 
Nestle170: calls $0.75
*** FLOP *** [9h Td 5c]
Nestle170: checks 
Sonny0306: bets $1.91
Nestle170: calls $1.91
*** TURN *** [9h Td 5c] [2h]
Nestle170: checks 
Sonny0306: bets $5.12
Nestle170: folds 
Uncalled bet ($5.12) returned to Sonny0306
Sonny0306 collected $6.24 from pot
Sonny0306: doesn't show hand 
*** SUMMARY ***
Total pot $6.57 | Rake $0.33 
Board [9h Td 5c 2h]
Seat 1: Corlogiro folded before Flop (didn't bet)
Seat 2: Pachebrash folded before Flop (didn't bet)
Seat 4: TATAP85 folded before Flop (didn't bet)
Seat 5: Sonny0306 collected ($6.24)
Seat 6: Kahmi3105 folded before Flop (didn't bet)
Seat 7: bigned1975 (button) folded before Flop (didn't bet)
Seat 8: oudine2 (small blind) folded before Flop
Seat 9: Nestle170 (big blind) folded on the Turn



PokerStars Hand #228690139917:  Hold'em No Limit ($0.25/$0.50 USD) - 2021/07/30 17:25:40 ET
Table 'Aitne III' 9-max Seat #8 is the button
Seat 1: Corlogiro ($56.67 in chips) 
Seat 2: Pachebrash ($106.19 in chips) 
Seat 4: TATAP85 ($71.35 in chips) 
Seat 5: Sonny0306 ($81.46 in chips) 
Seat 6: Kahmi3105 ($181.78 in chips) 
Seat 7: bigned1975 ($80 in chips) 
Seat 8: oudine2 ($50 in chips) 
Seat 9: Nestle170 ($122.23 in chips) 
Nestle170: posts small blind $0.25
Corlogiro: posts big blind $0.50
SwissSkier: sits out 
*** HOLE CARDS ***
Pachebrash: folds 
TATAP85: folds 
Sonny0306: raises $0.75 to $1.25
Kahmi3105: calls $1.25
bigned1975: folds 
oudine2: folds 
Nestle170: folds 
Corlogiro: folds 
*** FLOP *** [Ts 6c 8c]
Sonny0306: checks 
Kahmi3105: bets $3.09
Sonny0306: folds 
Uncalled bet ($3.09) returned to Kahmi3105
Kahmi3105 collected $3.05 from pot
*** SUMMARY ***
Total pot $3.25 | Rake $0.20 
Board [Ts 6c 8c]
Seat 1: Corlogiro (big blind) folded before Flop
Seat 2: Pachebrash folded before Flop (didn't bet)
Seat 4: TATAP85 folded before Flop (didn't bet)
Seat 5: Sonny0306 folded on the Flop
Seat 6: Kahmi3105 collected ($3.05)
Seat 7: bigned1975 folded before Flop (didn't bet)
Seat 8: oudine2 (button) folded before Flop (didn't bet)
Seat 9: Nestle170 (small blind) folded before Flop



PokerStars Hand #228690158373:  Hold'em No Limit ($0.25/$0.50 USD) - 2021/07/30 17:26:20 ET
Table 'Aitne III' 9-max Seat #9 is the button
Seat 1: Corlogiro ($56.17 in chips) 
Seat 2: Pachebrash ($106.19 in chips) 
Seat 4: TATAP85 ($71.35 in chips) 
Seat 5: Sonny0306 ($80.21 in chips) 
Seat 6: Kahmi3105 ($183.58 in chips) 
Seat 7: bigned1975 ($80 in chips) 
Seat 8: oudine2 ($50 in chips) 
Seat 9: Nestle170 ($121.98 in chips) 
Corlogiro: posts small blind $0.25
Pachebrash: posts big blind $0.50
SwissSkier: sits out 
*** HOLE CARDS ***
TATAP85: folds 
Sonny0306: folds 
Kahmi3105 has timed out
Kahmi3105: folds 
bigned1975: folds 
oudine2: folds 
Nestle170: raises $0.60 to $1.10
Corlogiro: folds 
Pachebrash: folds 
Uncalled bet ($0.60) returned to Nestle170
Nestle170 collected $1.25 from pot
Nestle170: doesn't show hand 
*** SUMMARY ***
Total pot $1.25 | Rake $0 
Seat 1: Corlogiro (small blind) folded before Flop
Seat 2: Pachebrash (big blind) folded before Flop
Seat 4: TATAP85 folded before Flop (didn't bet)
Seat 5: Sonny0306 folded before Flop (didn't bet)
Seat 6: Kahmi3105 folded before Flop (didn't bet)
Seat 7: bigned1975 folded before Flop (didn't bet)
Seat 8: oudine2 folded before Flop (didn't bet)
Seat 9: Nestle170 (button) collected ($1.25)



PokerStars Hand #228690175617:  Hold'em No Limit ($0.25/$0.50 USD) - 2021/07/30 17:26:46 ET
Table 'Aitne III' 9-max Seat #1 is the button
Seat 1: Corlogiro ($55.92 in chips) 
Seat 2: Pachebrash ($105.69 in chips) 
Seat 3: SwissSkier ($50 in chips) 
Seat 4: TATAP85 ($71.35 in chips) 
Seat 5: Sonny0306 ($80.21 in chips) 
Seat 6: Kahmi3105 ($183.58 in chips) 
Seat 7: bigned1975 ($80 in chips) 
Seat 8: oudine2 ($50 in chips) 
Seat 9: Nestle170 ($122.73 in chips) 
Pachebrash: posts small blind $0.25
SwissSkier: posts big blind $0.50
*** HOLE CARDS ***
TATAP85: folds 
Sonny0306: folds 
Kahmi3105: folds 
bigned1975: folds 
oudine2: folds 
Nestle170: raises $0.75 to $1.25
Corlogiro: folds 
Pachebrash: folds 
SwissSkier: folds 
Uncalled bet ($0.75) returned to Nestle170
Nestle170 collected $1.25 from pot
Nestle170: doesn't show hand 
*** SUMMARY ***
Total pot $1.25 | Rake $0 
Seat 1: Corlogiro (button) folded before Flop (didn't bet)
Seat 2: Pachebrash (small blind) folded before Flop
Seat 3: SwissSkier (big blind) folded before Flop
Seat 4: TATAP85 folded before Flop (didn't bet)
Seat 5: Sonny0306 folded before Flop (didn't bet)
Seat 6: Kahmi3105 folded before Flop (didn't bet)
Seat 7: bigned1975 folded before Flop (didn't bet)
Seat 8: oudine2 folded before Flop (didn't bet)
Seat 9: Nestle170 collected ($1.25)



PokerStars Hand #228690184760:  Hold'em No Limit ($0.25/$0.50 USD) - 2021/07/30 17:27:06 ET
Table 'Aitne III' 9-max Seat #2 is the button
Seat 1: Corlogiro ($55.92 in chips) 
Seat 2: Pachebrash ($105.44 in chips) 
Seat 3: SwissSkier ($49.50 in chips) 
Seat 4: TATAP85 ($71.35 in chips) 
Seat 5: Sonny0306 ($80.21 in chips) 
Seat 6: Kahmi3105 ($183.58 in chips) 
Seat 7: bigned1975 ($80 in chips) 
Seat 8: oudine2 ($50 in chips) 
Seat 9: Nestle170 ($123.48 in chips) 
SwissSkier: posts small blind $0.25
TATAP85: posts big blind $0.50
*** HOLE CARDS ***
Sonny0306: folds 
Kahmi3105: folds 
bigned1975: folds 
oudine2: raises $1 to $1.50
Nestle170: folds 
Corlogiro: calls $1.50
Pachebrash: folds 
SwissSkier: calls $1.25
TATAP85: folds 
*** FLOP *** [Qh Qd 3h]
SwissSkier: checks 
oudine2: checks 
Corlogiro: checks 
*** TURN *** [Qh Qd 3h] [9h]
SwissSkier: bets $2.50
oudine2: calls $2.50
Corlogiro: calls $2.50
*** RIVER *** [Qh Qd 3h 9h] [Js]
SwissSkier: bets $12
oudine2: folds 
Corlogiro: raises $39.92 to $51.92 and is all-in
SwissSkier: calls $33.50 and is all-in
Uncalled bet ($6.42) returned to Corlogiro
*** SHOW DOWN ***
Corlogiro: shows [Jc Qc] (a full house, Queens full of Jacks)
SwissSkier: shows [3d 3s] (a full house, Threes full of Queens)
Corlogiro collected $101 from pot
*** SUMMARY ***
Total pot $103.50 | Rake $2.50 
Board [Qh Qd 3h 9h Js]
Seat 1: Corlogiro showed [Jc Qc] and won ($101) with a full house, Queens full of Jacks
Seat 2: Pachebrash (button) folded before Flop (didn't bet)
Seat 3: SwissSkier (small blind) showed [3d 3s] and lost with a full house, Threes full of Queens
Seat 4: TATAP85 (big blind) folded before Flop
Seat 5: Sonny0306 folded before Flop (didn't bet)
Seat 6: Kahmi3105 folded before Flop (didn't bet)
Seat 7: bigned1975 folded before Flop (didn't bet)
Seat 8: oudine2 folded on the River
Seat 9: Nestle170 folded before Flop (didn't bet)



PokerStars Hand #228690227042:  Hold'em No Limit ($0.25/$0.50 USD) - 2021/07/30 17:28:39 ET
Table 'Aitne III' 9-max Seat #4 is the button
Seat 1: Corlogiro ($107.42 in chips) 
Seat 2: Pachebrash ($105.44 in chips) 
Seat 4: TATAP85 ($70.85 in chips) 
Seat 5: Sonny0306 ($80.21 in chips) 
Seat 6: Kahmi3105 ($183.58 in chips) 
Seat 7: bigned1975 ($80 in chips) 
Seat 8: oudine2 ($50 in chips) 
Seat 9: Nestle170 ($123.48 in chips) 
Sonny0306: posts small blind $0.25
Kahmi3105: posts big blind $0.50
*** HOLE CARDS ***
bigned1975: folds 
oudine2: folds 
Nestle170: folds 
Corlogiro: folds 
Pachebrash: raises $0.75 to $1.25
TATAP85: folds 
Sonny0306: folds 
Kahmi3105: folds 
Uncalled bet ($0.75) returned to Pachebrash
Pachebrash collected $1.25 from pot
Pachebrash: doesn't show hand 
*** SUMMARY ***
Total pot $1.25 | Rake $0 
Seat 1: Corlogiro folded before Flop (didn't bet)
Seat 2: Pachebrash collected ($1.25)
Seat 4: TATAP85 (button) folded before Flop (didn't bet)
Seat 5: Sonny0306 (small blind) folded before Flop
Seat 6: Kahmi3105 (big blind) folded before Flop
Seat 7: bigned1975 folded before Flop (didn't bet)
Seat 8: oudine2 folded before Flop (didn't bet)
Seat 9: Nestle170 folded before Flop (didn't bet)



PokerStars Hand #228690240269:  Hold'em No Limit ($0.25/$0.50 USD) - 2021/07/30 17:29:08 ET
Table 'Aitne III' 9-max Seat #6 is the button
Seat 1: Corlogiro ($107.42 in chips) 
Seat 2: Pachebrash ($106.19 in chips) 
Seat 3: SwissSkier ($50 in chips) 
Seat 4: TATAP85 ($70.85 in chips) 
Seat 5: Sonny0306 ($79.96 in chips) 
Seat 6: Kahmi3105 ($182.83 in chips) 
Seat 7: bigned1975 ($80.25 in chips) 
Seat 8: oudine2 ($50 in chips) 
bigned1975: posts small blind $0.25
oudine2: posts big blind $0.50
*** HOLE CARDS ***
Nestle170 leaves the table
Corlogiro: folds 
Pachebrash: folds 
SwissSkier: folds 
TATAP85: raises $1 to $1.50
Popokluev joins the table at seat #9 
Sonny0306: calls $1.50
Kahmi3105: folds 
bigned1975: calls $1.25
oudine2: calls $1
*** FLOP *** [Qh 8h Ks]
bigned1975: checks 
oudine2: checks 
TATAP85: checks 
Sonny0306: checks 
*** TURN *** [Qh 8h Ks] [2s]
bigned1975: bets $4
oudine2: folds 
TATAP85: folds 
Sonny0306: folds 
Uncalled bet ($4) returned to bigned1975
bigned1975 collected $5.70 from pot
bigned1975: doesn't show hand 
*** SUMMARY ***
Total pot $6 | Rake $0.30 
Board [Qh 8h Ks 2s]
Seat 1: Corlogiro folded before Flop (didn't bet)
Seat 2: Pachebrash folded before Flop (didn't bet)
Seat 3: SwissSkier folded before Flop (didn't bet)
Seat 4: TATAP85 folded on the Turn
Seat 5: Sonny0306 folded on the Turn
Seat 6: Kahmi3105 (button) folded before Flop (didn't bet)
Seat 7: bigned1975 (small blind) collected ($5.70)
Seat 8: oudine2 (big blind) folded on the Turn



PokerStars Hand #228690270553:  Hold'em No Limit ($0.25/$0.50 USD) - 2021/07/30 17:30:15 ET
Table 'Aitne III' 9-max Seat #7 is the button
Seat 1: Corlogiro ($107.42 in chips) 
Seat 2: Pachebrash ($106.19 in chips) 
Seat 3: SwissSkier ($50 in chips) 
Seat 4: TATAP85 ($69.35 in chips) 
Seat 5: Sonny0306 ($78.46 in chips) 
Seat 6: Kahmi3105 ($182.83 in chips) 
Seat 7: bigned1975 ($84.45 in chips) 
Seat 8: oudine2 ($50 in chips) 
Seat 9: Popokluev ($50 in chips) 
oudine2: posts small blind $0.25
Popokluev: posts big blind $0.50
*** HOLE CARDS ***
Corlogiro: folds 
Pachebrash: folds 
SwissSkier: folds 
TATAP85: folds 
Sonny0306: folds 
Kahmi3105: folds 
bigned1975: raises $1 to $1.50
oudine2: raises $4.50 to $6
Popokluev: raises $8.40 to $14.40
bigned1975: folds 
oudine2: folds 
Uncalled bet ($8.40) returned to Popokluev
Popokluev collected $13.50 from pot
Popokluev: doesn't show hand 
*** SUMMARY ***
Total pot $13.50 | Rake $0 
Seat 1: Corlogiro folded before Flop (didn't bet)
Seat 2: Pachebrash folded before Flop (didn't bet)
Seat 3: SwissSkier folded before Flop (didn't bet)
Seat 4: TATAP85 folded before Flop (didn't bet)
Seat 5: Sonny0306 folded before Flop (didn't bet)
Seat 6: Kahmi3105 folded before Flop (didn't bet)
Seat 7: bigned1975 (button) folded before Flop
Seat 8: oudine2 (small blind) folded before Flop
Seat 9: Popokluev (big blind) collected ($13.50)



PokerStars Hand #228690287905:  Hold'em No Limit ($0.25/$0.50 USD) - 2021/07/30 17:30:53 ET
Table 'Aitne III' 9-max Seat #8 is the button
Seat 1: Corlogiro ($107.42 in chips) 
Seat 2: Pachebrash ($106.19 in chips) 
Seat 3: SwissSkier ($50 in chips) 
Seat 4: TATAP85 ($69.35 in chips) 
Seat 5: Sonny0306 ($78.46 in chips) 
Seat 6: Kahmi3105 ($182.83 in chips) 
Seat 7: bigned1975 ($82.95 in chips) 
Seat 8: oudine2 ($50 in chips) 
Seat 9: Popokluev ($57.50 in chips) 
Popokluev: posts small blind $0.25
Corlogiro: posts big blind $0.50
*** HOLE CARDS ***
Pachebrash: raises $1 to $1.50
SwissSkier: calls $1.50
TATAP85: folds 
Sonny0306: folds 
Kahmi3105: calls $1.50
bigned1975: folds 
oudine2: folds 
Popokluev: folds 
Corlogiro: calls $1
*** FLOP *** [3d 3c 3s]
Corlogiro: checks 
Pachebrash: checks 
SwissSkier: bets $3
Kahmi3105: folds 
Corlogiro: folds 
Pachebrash: folds 
Uncalled bet ($3) returned to SwissSkier
SwissSkier collected $5.94 from pot
*** SUMMARY ***
Total pot $6.25 | Rake $0.31 
Board [3d 3c 3s]
Seat 1: Corlogiro (big blind) folded on the Flop
Seat 2: Pachebrash folded on the Flop
Seat 3: SwissSkier collected ($5.94)
Seat 4: TATAP85 folded before Flop (didn't bet)
Seat 5: Sonny0306 folded before Flop (didn't bet)
Seat 6: Kahmi3105 folded on the Flop
Seat 7: bigned1975 folded before Flop (didn't bet)
Seat 8: oudine2 (button) folded before Flop (didn't bet)
Seat 9: Popokluev (small blind) folded before Flop



PokerStars Hand #228690310350:  Hold'em No Limit ($0.25/$0.50 USD) - 2021/07/30 17:31:42 ET
Table 'Aitne III' 9-max Seat #9 is the button
Seat 1: Corlogiro ($105.92 in chips) 
Seat 2: Pachebrash ($104.69 in chips) 
Seat 3: SwissSkier ($54.44 in chips) 
Seat 4: TATAP85 ($69.35 in chips) 
Seat 5: Sonny0306 ($78.46 in chips) 
Seat 6: Kahmi3105 ($181.33 in chips) 
Seat 7: bigned1975 ($82.95 in chips) 
Seat 8: oudine2 ($50 in chips) 
Seat 9: Popokluev ($57.25 in chips) 
Corlogiro: posts small blind $0.25
Pachebrash: posts big blind $0.50
*** HOLE CARDS ***
SwissSkier: raises $1 to $1.50
TATAP85: folds 
Sonny0306: calls $1.50
Kahmi3105: folds 
bigned1975: folds 
oudine2: folds 
Popokluev: folds 
Corlogiro: folds 
Pachebrash: folds 
*** FLOP *** [6h Th Js]
SwissSkier: checks 
Sonny0306: checks 
*** TURN *** [6h Th Js] [Jc]
SwissSkier: bets $2
Sonny0306: raises $5.96 to $7.96
SwissSkier: folds 
Uncalled bet ($5.96) returned to Sonny0306
Sonny0306 collected $7.36 from pot
Sonny0306: doesn't show hand 
*** SUMMARY ***
Total pot $7.75 | Rake $0.39 
Board [6h Th Js Jc]
Seat 1: Corlogiro (small blind) folded before Flop
Seat 2: Pachebrash (big blind) folded before Flop
Seat 3: SwissSkier folded on the Turn
Seat 4: TATAP85 folded before Flop (didn't bet)
Seat 5: Sonny0306 collected ($7.36)
Seat 6: Kahmi3105 folded before Flop (didn't bet)
Seat 7: bigned1975 folded before Flop (didn't bet)
Seat 8: oudine2 folded before Flop (didn't bet)
Seat 9: Popokluev (button) folded before Flop (didn't bet)



PokerStars Hand #228690334168:  Hold'em No Limit ($0.25/$0.50 USD) - 2021/07/30 17:32:35 ET
Table 'Aitne III' 9-max Seat #1 is the button
Seat 1: Corlogiro ($105.67 in chips) 
Seat 2: Pachebrash ($104.19 in chips) 
Seat 3: SwissSkier ($50.94 in chips) 
Seat 4: TATAP85 ($69.35 in chips) 
Seat 5: Sonny0306 ($82.32 in chips) 
Seat 6: Kahmi3105 ($181.33 in chips) 
Seat 7: bigned1975 ($82.95 in chips) 
Seat 8: oudine2 ($50 in chips) 
Seat 9: Popokluev ($57.25 in chips) 
Pachebrash: posts small blind $0.25
SwissSkier: posts big blind $0.50
*** HOLE CARDS ***
TATAP85: folds 
Sonny0306: folds 
Kahmi3105: raises $1.25 to $1.75
bigned1975: calls $1.75
oudine2: folds 
Popokluev: folds 
Corlogiro: folds 
Pachebrash: folds 
SwissSkier: folds 
*** FLOP *** [Tc Kh Kd]
Kahmi3105: checks 
bigned1975: checks 
*** TURN *** [Tc Kh Kd] [6d]
Kahmi3105: checks 
bigned1975: checks 
*** RIVER *** [Tc Kh Kd 6d] [2c]
Kahmi3105: checks 
bigned1975: checks 
*** SHOW DOWN ***
Kahmi3105: shows [Qd Qh] (two pair, Kings and Queens)
bigned1975: mucks hand 
Kahmi3105 collected $3.99 from pot
*** SUMMARY ***
Total pot $4.25 | Rake $0.26 
Board [Tc Kh Kd 6d 2c]
Seat 1: Corlogiro (button) folded before Flop (didn't bet)
Seat 2: Pachebrash (small blind) folded before Flop
Seat 3: SwissSkier (big blind) folded before Flop
Seat 4: TATAP85 folded before Flop (didn't bet)
Seat 5: Sonny0306 folded before Flop (didn't bet)
Seat 6: Kahmi3105 showed [Qd Qh] and won ($3.99) with two pair, Kings and Queens
Seat 7: bigned1975 mucked
Seat 8: oudine2 folded before Flop (didn't bet)
Seat 9: Popokluev folded before Flop (didn't bet)



PokerStars Hand #228690352234:  Hold'em No Limit ($0.25/$0.50 USD) - 2021/07/30 17:33:15 ET
Table 'Aitne III' 9-max Seat #2 is the button
Seat 1: Corlogiro ($105.67 in chips) 
Seat 2: Pachebrash ($103.94 in chips) 
Seat 3: SwissSkier ($50.44 in chips) 
Seat 4: TATAP85 ($69.35 in chips) 
Seat 5: Sonny0306 ($82.32 in chips) 
Seat 6: Kahmi3105 ($183.57 in chips) 
Seat 7: bigned1975 ($81.20 in chips) 
Seat 8: oudine2 ($50 in chips) 
Seat 9: Popokluev ($57.25 in chips) 
SwissSkier: posts small blind $0.25
TATAP85: posts big blind $0.50
*** HOLE CARDS ***
Sonny0306: folds 
Kahmi3105: folds 
bigned1975: folds 
oudine2: folds 
Popokluev: folds 
Corlogiro: folds 
Pachebrash: raises $0.70 to $1.20
SwissSkier: folds 
TATAP85: calls $0.70
*** FLOP *** [6d 9h 2d]
TATAP85: checks 
Pachebrash: bets $1.50
TATAP85: folds 
Uncalled bet ($1.50) returned to Pachebrash
Pachebrash collected $2.52 from pot
Pachebrash: doesn't show hand 
*** SUMMARY ***
Total pot $2.65 | Rake $0.13 
Board [6d 9h 2d]
Seat 1: Corlogiro folded before Flop (didn't bet)
Seat 2: Pachebrash (button) collected ($2.52)
Seat 3: SwissSkier (small blind) folded before Flop
Seat 4: TATAP85 (big blind) folded on the Flop
Seat 5: Sonny0306 folded before Flop (didn't bet)
Seat 6: Kahmi3105 folded before Flop (didn't bet)
Seat 7: bigned1975 folded before Flop (didn't bet)
Seat 8: oudine2 folded before Flop (didn't bet)
Seat 9: Popokluev folded before Flop (didn't bet)



PokerStars Hand #228690369749:  Hold'em No Limit ($0.25/$0.50 USD) - 2021/07/30 17:33:54 ET
Table 'Aitne III' 9-max Seat #3 is the button
Seat 1: Corlogiro ($105.67 in chips) 
Seat 2: Pachebrash ($105.26 in chips) 
Seat 3: SwissSkier ($50.19 in chips) 
Seat 4: TATAP85 ($68.15 in chips) 
Seat 5: Sonny0306 ($82.32 in chips) 
Seat 6: Kahmi3105 ($183.57 in chips) 
Seat 7: bigned1975 ($81.20 in chips) 
Seat 8: oudine2 ($50 in chips) 
Seat 9: Popokluev ($57.25 in chips) 
TATAP85: posts small blind $0.25
Sonny0306: posts big blind $0.50
*** HOLE CARDS ***
Kahmi3105: folds 
bigned1975: folds 
oudine2: folds 
Popokluev: folds 
Corlogiro: folds 
Pachebrash: folds 
SwissSkier: folds 
TATAP85: folds 
Uncalled bet ($0.25) returned to Sonny0306
Sonny0306 collected $0.50 from pot
Sonny0306: doesn't show hand 
*** SUMMARY ***
Total pot $0.50 | Rake $0 
Seat 1: Corlogiro folded before Flop (didn't bet)
Seat 2: Pachebrash folded before Flop (didn't bet)
Seat 3: SwissSkier (button) folded before Flop (didn't bet)
Seat 4: TATAP85 (small blind) folded before Flop
Seat 5: Sonny0306 (big blind) collected ($0.50)
Seat 6: Kahmi3105 folded before Flop (didn't bet)
Seat 7: bigned1975 folded before Flop (didn't bet)
Seat 8: oudine2 folded before Flop (didn't bet)
Seat 9: Popokluev folded before Flop (didn't bet)



PokerStars Hand #228690377131:  Hold'em No Limit ($0.25/$0.50 USD) - 2021/07/30 17:34:10 ET
Table 'Aitne III' 9-max Seat #4 is the button
Seat 1: Corlogiro ($105.67 in chips) 
Seat 2: Pachebrash ($105.26 in chips) 
Seat 3: SwissSkier ($50.19 in chips) 
Seat 4: TATAP85 ($67.90 in chips) 
Seat 5: Sonny0306 ($82.57 in chips) 
Seat 6: Kahmi3105 ($183.57 in chips) 
Seat 7: bigned1975 ($81.20 in chips) 
Seat 8: oudine2 ($50 in chips) 
Seat 9: Popokluev ($57.25 in chips) 
Sonny0306: posts small blind $0.25
Kahmi3105: posts big blind $0.50
*** HOLE CARDS ***
bigned1975: folds 
oudine2: folds 
Popokluev: raises $1 to $1.50
Corlogiro: folds 
Pachebrash: folds 
SwissSkier: raises $2 to $3.50
TATAP85: folds 
Sonny0306: folds 
Kahmi3105: folds 
Popokluev: calls $2
*** FLOP *** [6s Ts 3c]
Popokluev: checks 
SwissSkier: bets $4.50
Popokluev: calls $4.50
*** TURN *** [6s Ts 3c] [Tc]
Popokluev: checks 
SwissSkier: bets $8
Popokluev: calls $8
*** RIVER *** [6s Ts 3c Tc] [2h]
Popokluev: checks 
SwissSkier: bets $34.19 and is all-in
Popokluev: folds 
Uncalled bet ($34.19) returned to SwissSkier
SwissSkier collected $31.11 from pot
*** SUMMARY ***
Total pot $32.75 | Rake $1.64 
Board [6s Ts 3c Tc 2h]
Seat 1: Corlogiro folded before Flop (didn't bet)
Seat 2: Pachebrash folded before Flop (didn't bet)
Seat 3: SwissSkier collected ($31.11)
Seat 4: TATAP85 (button) folded before Flop (didn't bet)
Seat 5: Sonny0306 (small blind) folded before Flop
Seat 6: Kahmi3105 (big blind) folded before Flop
Seat 7: bigned1975 folded before Flop (didn't bet)
Seat 8: oudine2 folded before Flop (didn't bet)
Seat 9: Popokluev folded on the River



PokerStars Hand #228690411003:  Hold'em No Limit ($0.25/$0.50 USD) - 2021/07/30 17:35:25 ET
Table 'Aitne III' 9-max Seat #5 is the button
Seat 1: Corlogiro ($105.67 in chips) 
Seat 2: Pachebrash ($105.26 in chips) 
Seat 3: SwissSkier ($65.30 in chips) 
Seat 4: TATAP85 ($67.90 in chips) 
Seat 5: Sonny0306 ($82.32 in chips) 
Seat 6: Kahmi3105 ($183.07 in chips) 
Seat 7: bigned1975 ($81.20 in chips) 
Seat 8: oudine2 ($50 in chips) 
Kahmi3105: posts small blind $0.25
bigned1975: posts big blind $0.50
*** HOLE CARDS ***
oudine2: folds 
Popokluev leaves the table
Corlogiro: raises $0.75 to $1.25
Pachebrash: folds 
SwissSkier: calls $1.25
TATAP85: folds 
Sonny0306: folds 
Kahmi3105: folds 
bigned1975: calls $0.75
*** FLOP *** [7c 5c 3d]
bigned1975: checks 
Corlogiro: checks 
SwissSkier: bets $1.90
bigned1975: folds 
Corlogiro: folds 
Uncalled bet ($1.90) returned to SwissSkier
SwissSkier collected $3.80 from pot
*** SUMMARY ***
Total pot $4 | Rake $0.20 
Board [7c 5c 3d]
Seat 1: Corlogiro folded on the Flop
Seat 2: Pachebrash folded before Flop (didn't bet)
Seat 3: SwissSkier collected ($3.80)
Seat 4: TATAP85 folded before Flop (didn't bet)
Seat 5: Sonny0306 (button) folded before Flop (didn't bet)
Seat 6: Kahmi3105 (small blind) folded before Flop
Seat 7: bigned1975 (big blind) folded on the Flop
Seat 8: oudine2 folded before Flop (didn't bet)



PokerStars Hand #228690433076:  Hold'em No Limit ($0.25/$0.50 USD) - 2021/07/30 17:36:14 ET
Table 'Aitne III' 9-max Seat #6 is the button
Seat 1: Corlogiro ($104.42 in chips) 
Seat 2: Pachebrash ($105.26 in chips) 
Seat 3: SwissSkier ($67.85 in chips) 
Seat 4: TATAP85 ($67.90 in chips) 
Seat 5: Sonny0306 ($82.32 in chips) 
Seat 6: Kahmi3105 ($182.82 in chips) 
Seat 7: bigned1975 ($79.95 in chips) 
Seat 8: oudine2 ($50 in chips) 
bigned1975: posts small blind $0.25
oudine2: posts big blind $0.50
*** HOLE CARDS ***
Corlogiro: folds 
Pachebrash: folds 
SwissSkier: folds 
TATAP85: folds 
Sonny0306: folds 
Kahmi3105: raises $1.25 to $1.75
bigned1975: folds 
oudine2: folds 
Uncalled bet ($1.25) returned to Kahmi3105
Kahmi3105 collected $1.25 from pot
*** SUMMARY ***
Total pot $1.25 | Rake $0 
Seat 1: Corlogiro folded before Flop (didn't bet)
Seat 2: Pachebrash folded before Flop (didn't bet)
Seat 3: SwissSkier folded before Flop (didn't bet)
Seat 4: TATAP85 folded before Flop (didn't bet)
Seat 5: Sonny0306 folded before Flop (didn't bet)
Seat 6: Kahmi3105 (button) collected ($1.25)
Seat 7: bigned1975 (small blind) folded before Flop
Seat 8: oudine2 (big blind) folded before Flop



PokerStars Hand #228690441433:  Hold'em No Limit ($0.25/$0.50 USD) - 2021/07/30 17:36:33 ET
Table 'Aitne III' 9-max Seat #7 is the button
Seat 1: Corlogiro ($104.42 in chips) 
Seat 2: Pachebrash ($105.26 in chips) 
Seat 3: SwissSkier ($67.85 in chips) 
Seat 4: TATAP85 ($67.90 in chips) 
Seat 5: Sonny0306 ($82.32 in chips) 
Seat 6: Kahmi3105 ($183.57 in chips) 
Seat 7: bigned1975 ($79.70 in chips) 
Seat 8: oudine2 ($50 in chips) 
oudine2: posts small blind $0.25
Corlogiro: posts big blind $0.50
*** HOLE CARDS ***
Pachebrash: raises $1 to $1.50
jumbo69 joins the table at seat #9 
SwissSkier: folds 
TATAP85: folds 
Sonny0306: folds 
Kahmi3105: folds 
bigned1975: folds 
oudine2: folds 
Corlogiro: folds 
Uncalled bet ($1) returned to Pachebrash
Pachebrash collected $1.25 from pot
Pachebrash: doesn't show hand 
*** SUMMARY ***
Total pot $1.25 | Rake $0 
Seat 1: Corlogiro (big blind) folded before Flop
Seat 2: Pachebrash collected ($1.25)
Seat 3: SwissSkier folded before Flop (didn't bet)
Seat 4: TATAP85 folded before Flop (didn't bet)
Seat 5: Sonny0306 folded before Flop (didn't bet)
Seat 6: Kahmi3105 folded before Flop (didn't bet)
Seat 7: bigned1975 (button) folded before Flop (didn't bet)
Seat 8: oudine2 (small blind) folded before Flop



PokerStars Hand #228690449715:  Hold'em No Limit ($0.25/$0.50 USD) - 2021/07/30 17:36:51 ET
Table 'Aitne III' 9-max Seat #8 is the button
Seat 1: Corlogiro ($103.92 in chips) 
Seat 2: Pachebrash ($106.01 in chips) 
Seat 3: SwissSkier ($67.85 in chips) 
Seat 4: TATAP85 ($67.90 in chips) 
Seat 5: Sonny0306 ($82.32 in chips) 
Seat 6: Kahmi3105 ($183.57 in chips) 
Seat 7: bigned1975 ($79.70 in chips) 
Seat 8: oudine2 ($50 in chips) 
Corlogiro: posts small blind $0.25
Pachebrash: posts big blind $0.50
*** HOLE CARDS ***
SwissSkier: folds 
TATAP85: folds 
Sonny0306: folds 
Kahmi3105: folds 
bigned1975: folds 
oudine2: folds 
Corlogiro: raises $1 to $1.50
Pachebrash: calls $1
*** FLOP *** [8h Ad 8s]
Corlogiro: checks 
Pachebrash: bets $1.45
Corlogiro: folds 
Uncalled bet ($1.45) returned to Pachebrash
Pachebrash collected $2.85 from pot
Pachebrash: doesn't show hand 
*** SUMMARY ***
Total pot $3 | Rake $0.15 
Board [8h Ad 8s]
Seat 1: Corlogiro (small blind) folded on the Flop
Seat 2: Pachebrash (big blind) collected ($2.85)
Seat 3: SwissSkier folded before Flop (didn't bet)
Seat 4: TATAP85 folded before Flop (didn't bet)
Seat 5: Sonny0306 folded before Flop (didn't bet)
Seat 6: Kahmi3105 folded before Flop (didn't bet)
Seat 7: bigned1975 folded before Flop (didn't bet)
Seat 8: oudine2 (button) folded before Flop (didn't bet)



PokerStars Hand #228690472689:  Hold'em No Limit ($0.25/$0.50 USD) - 2021/07/30 17:37:43 ET
Table 'Aitne III' 9-max Seat #1 is the button
Seat 1: Corlogiro ($102.42 in chips) 
Seat 2: Pachebrash ($107.36 in chips) 
Seat 3: SwissSkier ($67.85 in chips) 
Seat 4: TATAP85 ($67.90 in chips) 
Seat 5: Sonny0306 ($82.32 in chips) 
Seat 6: Kahmi3105 ($183.57 in chips) 
Seat 7: bigned1975 ($79.70 in chips) 
Seat 8: oudine2 ($50 in chips) 
Pachebrash: posts small blind $0.25
SwissSkier: posts big blind $0.50
jumbo69: sits out 
*** HOLE CARDS ***
TATAP85: folds 
Sonny0306: folds 
Kahmi3105: folds 
bigned1975: folds 
oudine2: folds 
Corlogiro: folds 
Pachebrash: folds 
Uncalled bet ($0.25) returned to SwissSkier
SwissSkier collected $0.50 from pot
*** SUMMARY ***
Total pot $0.50 | Rake $0 
Seat 1: Corlogiro (button) folded before Flop (didn't bet)
Seat 2: Pachebrash (small blind) folded before Flop
Seat 3: SwissSkier (big blind) collected ($0.50)
Seat 4: TATAP85 folded before Flop (didn't bet)
Seat 5: Sonny0306 folded before Flop (didn't bet)
Seat 6: Kahmi3105 folded before Flop (didn't bet)
Seat 7: bigned1975 folded before Flop (didn't bet)
Seat 8: oudine2 folded before Flop (didn't bet)



PokerStars Hand #228690483684:  Hold'em No Limit ($0.25/$0.50 USD) - 2021/07/30 17:38:01 ET
Table 'Aitne III' 9-max Seat #2 is the button
Seat 1: Corlogiro ($102.42 in chips) 
Seat 2: Pachebrash ($107.11 in chips) 
Seat 3: SwissSkier ($68.10 in chips) 
Seat 4: TATAP85 ($67.90 in chips) 
Seat 5: Sonny0306 ($82.32 in chips) 
Seat 6: Kahmi3105 ($183.57 in chips) 
Seat 7: bigned1975 ($79.70 in chips) 
Seat 8: oudine2 ($50 in chips) 
SwissSkier: posts small blind $0.25
TATAP85: posts big blind $0.50
jumbo69: sits out 
*** HOLE CARDS ***
Sonny0306: raises $0.75 to $1.25
Kahmi3105: calls $1.25
bigned1975: folds 
oudine2: folds 
Corlogiro: folds 
Pachebrash: calls $1.25
SwissSkier: folds 
TATAP85: folds 
*** FLOP *** [8s 4h 7d]
Sonny0306: bets $1.87
Kahmi3105: folds 
Pachebrash: folds 
Uncalled bet ($1.87) returned to Sonny0306
Sonny0306 collected $4.28 from pot
Sonny0306: doesn't show hand 
*** SUMMARY ***
Total pot $4.50 | Rake $0.22 
Board [8s 4h 7d]
Seat 1: Corlogiro folded before Flop (didn't bet)
Seat 2: Pachebrash (button) folded on the Flop
Seat 3: SwissSkier (small blind) folded before Flop
Seat 4: TATAP85 (big blind) folded before Flop
Seat 5: Sonny0306 collected ($4.28)
Seat 6: Kahmi3105 folded on the Flop
Seat 7: bigned1975 folded before Flop (didn't bet)
Seat 8: oudine2 folded before Flop (didn't bet)



PokerStars Hand #228690498551:  Hold'em No Limit ($0.25/$0.50 USD) - 2021/07/30 17:38:35 ET
Table 'Aitne III' 9-max Seat #3 is the button
Seat 1: Corlogiro ($102.42 in chips) 
Seat 2: Pachebrash ($105.86 in chips) 
Seat 3: SwissSkier ($67.85 in chips) 
Seat 4: TATAP85 ($67.40 in chips) 
Seat 5: Sonny0306 ($85.35 in chips) 
Seat 6: Kahmi3105 ($182.32 in chips) 
Seat 7: bigned1975 ($79.70 in chips) 
Seat 8: oudine2 ($50 in chips) 
TATAP85: posts small blind $0.25
Sonny0306: posts big blind $0.50
jumbo69: sits out 
*** HOLE CARDS ***
Kahmi3105: folds 
bigned1975: folds 
oudine2: folds 
Corlogiro: folds 
Pachebrash: folds 
SwissSkier: raises $1 to $1.50
TATAP85: folds 
Sonny0306: raises $3.55 to $5.05
jumbo69 leaves the table
SwissSkier: raises $6.95 to $12
Sonny0306: folds 
Uncalled bet ($6.95) returned to SwissSkier
SwissSkier collected $10.35 from pot
*** SUMMARY ***
Total pot $10.35 | Rake $0 
Seat 1: Corlogiro folded before Flop (didn't bet)
Seat 2: Pachebrash folded before Flop (didn't bet)
Seat 3: SwissSkier (button) collected ($10.35)
Seat 4: TATAP85 (small blind) folded before Flop
Seat 5: Sonny0306 (big blind) folded before Flop
Seat 6: Kahmi3105 folded before Flop (didn't bet)
Seat 7: bigned1975 folded before Flop (didn't bet)
Seat 8: oudine2 folded before Flop (didn't bet)



PokerStars Hand #228690516552:  Hold'em No Limit ($0.25/$0.50 USD) - 2021/07/30 17:39:16 ET
Table 'Aitne III' 9-max Seat #4 is the button
Seat 1: Corlogiro ($102.42 in chips) 
Seat 2: Pachebrash ($105.86 in chips) 
Seat 3: SwissSkier ($73.15 in chips) 
Seat 4: TATAP85 ($67.15 in chips) 
Seat 5: Sonny0306 ($80.30 in chips) 
Seat 6: Kahmi3105 ($182.32 in chips) 
Seat 7: bigned1975 ($79.70 in chips) 
Seat 8: oudine2 ($50 in chips) 
Sonny0306: posts small blind $0.25
Kahmi3105: posts big blind $0.50
*** HOLE CARDS ***
bigned1975: folds 
oudine2: raises $1 to $1.50
Corlogiro: folds 
Pachebrash: folds 
Infinities4 joins the table at seat #9 
SwissSkier: calls $1.50
TATAP85: folds 
Sonny0306: folds 
Kahmi3105: folds 
*** FLOP *** [6c 9c Kh]
oudine2: bets $1.78
SwissSkier: calls $1.78
*** TURN *** [6c 9c Kh] [7s]
oudine2: checks 
SwissSkier: bets $6.50
oudine2: folds 
Uncalled bet ($6.50) returned to SwissSkier
SwissSkier collected $6.94 from pot
*** SUMMARY ***
Total pot $7.31 | Rake $0.37 
Board [6c 9c Kh 7s]
Seat 1: Corlogiro folded before Flop (didn't bet)
Seat 2: Pachebrash folded before Flop (didn't bet)
Seat 3: SwissSkier collected ($6.94)
Seat 4: TATAP85 (button) folded before Flop (didn't bet)
Seat 5: Sonny0306 (small blind) folded before Flop
Seat 6: Kahmi3105 (big blind) folded before Flop
Seat 7: bigned1975 folded before Flop (didn't bet)
Seat 8: oudine2 folded on the Turn



PokerStars Hand #228690533153:  Hold'em No Limit ($0.25/$0.50 USD) - 2021/07/30 17:39:53 ET
Table 'Aitne III' 9-max Seat #5 is the button
Seat 1: Corlogiro ($102.42 in chips) 
Seat 2: Pachebrash ($105.86 in chips) 
Seat 3: SwissSkier ($76.81 in chips) 
Seat 4: TATAP85 ($67.15 in chips) 
Seat 5: Sonny0306 ($80.05 in chips) 
Seat 6: Kahmi3105 ($181.82 in chips) 
Seat 7: bigned1975 ($79.70 in chips) 
Seat 8: oudine2 ($50 in chips) 
Kahmi3105: posts small blind $0.25
bigned1975: posts big blind $0.50
Infinities4: sits out 
*** HOLE CARDS ***
oudine2: folds 
Corlogiro: folds 
Pachebrash: folds 
SwissSkier: folds 
TATAP85: folds 
Sonny0306: raises $0.75 to $1.25
Kahmi3105: folds 
bigned1975: folds 
Uncalled bet ($0.75) returned to Sonny0306
Sonny0306 collected $1.25 from pot
Sonny0306: doesn't show hand 
*** SUMMARY ***
Total pot $1.25 | Rake $0 
Seat 1: Corlogiro folded before Flop (didn't bet)
Seat 2: Pachebrash folded before Flop (didn't bet)
Seat 3: SwissSkier folded before Flop (didn't bet)
Seat 4: TATAP85 folded before Flop (didn't bet)
Seat 5: Sonny0306 (button) collected ($1.25)
Seat 6: Kahmi3105 (small blind) folded before Flop
Seat 7: bigned1975 (big blind) folded before Flop
Seat 8: oudine2 folded before Flop (didn't bet)



PokerStars Hand #228690543771:  Hold'em No Limit ($0.25/$0.50 USD) - 2021/07/30 17:40:17 ET
Table 'Aitne III' 9-max Seat #6 is the button
Seat 1: Corlogiro ($102.42 in chips) 
Seat 2: Pachebrash ($105.86 in chips) 
Seat 3: SwissSkier ($76.81 in chips) 
Seat 4: TATAP85 ($67.15 in chips) 
Seat 5: Sonny0306 ($80.80 in chips) 
Seat 6: Kahmi3105 ($181.57 in chips) 
Seat 7: bigned1975 ($79.20 in chips) 
Seat 8: oudine2 ($50 in chips) 
bigned1975: posts small blind $0.25
oudine2: posts big blind $0.50
Infinities4: sits out 
*** HOLE CARDS ***
Corlogiro: folds 
Pachebrash: folds 
SwissSkier: folds 
TATAP85: folds 
Sonny0306: folds 
Kahmi3105: raises $1.25 to $1.75
bigned1975: folds 
oudine2: folds 
Uncalled bet ($1.25) returned to Kahmi3105
Kahmi3105 collected $1.25 from pot
*** SUMMARY ***
Total pot $1.25 | Rake $0 
Seat 1: Corlogiro folded before Flop (didn't bet)
Seat 2: Pachebrash folded before Flop (didn't bet)
Seat 3: SwissSkier folded before Flop (didn't bet)
Seat 4: TATAP85 folded before Flop (didn't bet)
Seat 5: Sonny0306 folded before Flop (didn't bet)
Seat 6: Kahmi3105 (button) collected ($1.25)
Seat 7: bigned1975 (small blind) folded before Flop
Seat 8: oudine2 (big blind) folded before Flop



PokerStars Hand #228690552414:  Hold'em No Limit ($0.25/$0.50 USD) - 2021/07/30 17:40:37 ET
Table 'Aitne III' 9-max Seat #7 is the button
Seat 1: Corlogiro ($102.42 in chips) 
Seat 2: Pachebrash ($105.86 in chips) 
Seat 3: SwissSkier ($76.81 in chips) 
Seat 4: TATAP85 ($67.15 in chips) 
Seat 5: Sonny0306 ($80.80 in chips) 
Seat 6: Kahmi3105 ($182.32 in chips) 
Seat 7: bigned1975 ($78.95 in chips) 
Seat 8: oudine2 ($50 in chips) 
Seat 9: Infinities4 ($50 in chips) 
oudine2: posts small blind $0.25
Infinities4: posts big blind $0.50
*** HOLE CARDS ***
Corlogiro: folds 
Pachebrash: raises $1 to $1.50
SwissSkier: folds 
TATAP85: folds 
Sonny0306: folds 
Kahmi3105: folds 
bigned1975: calls $1.50
oudine2: folds 
Infinities4: calls $1
*** FLOP *** [Ts 3c 6h]
Infinities4: checks 
Pachebrash: bets $1.53
bigned1975: folds 
Infinities4: folds 
Uncalled bet ($1.53) returned to Pachebrash
Pachebrash collected $4.51 from pot
Pachebrash: doesn't show hand 
*** SUMMARY ***
Total pot $4.75 | Rake $0.24 
Board [Ts 3c 6h]
Seat 1: Corlogiro folded before Flop (didn't bet)
Seat 2: Pachebrash collected ($4.51)
Seat 3: SwissSkier folded before Flop (didn't bet)
Seat 4: TATAP85 folded before Flop (didn't bet)
Seat 5: Sonny0306 folded before Flop (didn't bet)
Seat 6: Kahmi3105 folded before Flop (didn't bet)
Seat 7: bigned1975 (button) folded on the Flop
Seat 8: oudine2 (small blind) folded before Flop
Seat 9: Infinities4 (big blind) folded on the Flop



PokerStars Hand #228690570771:  Hold'em No Limit ($0.25/$0.50 USD) - 2021/07/30 17:41:18 ET
Table 'Aitne III' 9-max Seat #8 is the button
Seat 1: Corlogiro ($102.42 in chips) 
Seat 2: Pachebrash ($108.87 in chips) 
Seat 3: SwissSkier ($76.81 in chips) 
Seat 4: TATAP85 ($67.15 in chips) 
Seat 5: Sonny0306 ($80.80 in chips) 
Seat 6: Kahmi3105 ($182.32 in chips) 
Seat 7: bigned1975 ($77.45 in chips) 
Seat 8: oudine2 ($50 in chips) 
Corlogiro: posts small blind $0.25
Pachebrash: posts big blind $0.50
*** HOLE CARDS ***
Infinities4 leaves the table
Dragonclawss joins the table at seat #9 
SwissSkier: raises $0.50 to $1
TATAP85: folds 
Sonny0306: folds 
Kahmi3105: folds 
bigned1975: calls $1
oudine2: folds 
Corlogiro: folds 
Pachebrash: folds 
*** FLOP *** [Jc Js 9s]
SwissSkier: checks 
Dragonclawss leaves the table
bigned1975: bets $2
SwissSkier: calls $2
*** TURN *** [Jc Js 9s] [8s]
SwissSkier: checks 
lulu19911991 joins the table at seat #9 
bigned1975: bets $5.50
SwissSkier: folds 
Uncalled bet ($5.50) returned to bigned1975
bigned1975 collected $6.41 from pot
bigned1975: doesn't show hand 
*** SUMMARY ***
Total pot $6.75 | Rake $0.34 
Board [Jc Js 9s 8s]
Seat 1: Corlogiro (small blind) folded before Flop
Seat 2: Pachebrash (big blind) folded before Flop
Seat 3: SwissSkier folded on the Turn
Seat 4: TATAP85 folded before Flop (didn't bet)
Seat 5: Sonny0306 folded before Flop (didn't bet)
Seat 6: Kahmi3105 folded before Flop (didn't bet)
Seat 7: bigned1975 collected ($6.41)
Seat 8: oudine2 (button) folded before Flop (didn't bet)



PokerStars Hand #228690601265:  Hold'em No Limit ($0.25/$0.50 USD) - 2021/07/30 17:42:27 ET
Table 'Aitne III' 9-max Seat #1 is the button
Seat 1: Corlogiro ($102.17 in chips) 
Seat 2: Pachebrash ($108.37 in chips) 
Seat 3: SwissSkier ($73.81 in chips) 
Seat 4: TATAP85 ($67.15 in chips) 
Seat 5: Sonny0306 ($80.80 in chips) 
Seat 6: Kahmi3105 ($182.32 in chips) 
Seat 7: bigned1975 ($80.86 in chips) 
Seat 8: oudine2 ($50 in chips) 
Pachebrash: posts small blind $0.25
SwissSkier: posts big blind $0.50
lulu19911991: sits out 
*** HOLE CARDS ***
TATAP85: folds 
Sonny0306: folds 
Kahmi3105: raises $1.25 to $1.75
lulu19911991 leaves the table
bigned1975: folds 
oudine2: folds 
Corlogiro: folds 
Pachebrash: folds 
SwissSkier: folds 
Uncalled bet ($1.25) returned to Kahmi3105
Kahmi3105 collected $1.25 from pot
*** SUMMARY ***
Total pot $1.25 | Rake $0 
Seat 1: Corlogiro (button) folded before Flop (didn't bet)
Seat 2: Pachebrash (small blind) folded before Flop
Seat 3: SwissSkier (big blind) folded before Flop
Seat 4: TATAP85 folded before Flop (didn't bet)
Seat 5: Sonny0306 folded before Flop (didn't bet)
Seat 6: Kahmi3105 collected ($1.25)
Seat 7: bigned1975 folded before Flop (didn't bet)
Seat 8: oudine2 folded before Flop (didn't bet)



PokerStars Hand #228690611852:  Hold'em No Limit ($0.25/$0.50 USD) - 2021/07/30 17:42:51 ET
Table 'Aitne III' 9-max Seat #2 is the button
Seat 1: Corlogiro ($102.17 in chips) 
Seat 2: Pachebrash ($108.12 in chips) 
Seat 3: SwissSkier ($73.31 in chips) 
Seat 4: TATAP85 ($67.15 in chips) 
Seat 5: Sonny0306 ($80.80 in chips) 
Seat 6: Kahmi3105 ($183.07 in chips) 
Seat 7: bigned1975 ($80.86 in chips) 
Seat 8: oudine2 ($50 in chips) 
SwissSkier: posts small blind $0.25
TATAP85: posts big blind $0.50
*** HOLE CARDS ***
Sonny0306: raises $0.75 to $1.25
Kahmi3105: folds 
bigned1975: folds 
oudine2: folds 
Corlogiro: folds 
Pachebrash: folds 
SwissSkier: folds 
TATAP85: folds 
Uncalled bet ($0.75) returned to Sonny0306
Sonny0306 collected $1.25 from pot
Sonny0306: doesn't show hand 
*** SUMMARY ***
Total pot $1.25 | Rake $0 
Seat 1: Corlogiro folded before Flop (didn't bet)
Seat 2: Pachebrash (button) folded before Flop (didn't bet)
Seat 3: SwissSkier (small blind) folded before Flop
Seat 4: TATAP85 (big blind) folded before Flop
Seat 5: Sonny0306 collected ($1.25)
Seat 6: Kahmi3105 folded before Flop (didn't bet)
Seat 7: bigned1975 folded before Flop (didn't bet)
Seat 8: oudine2 folded before Flop (didn't bet)



PokerStars Hand #228690622178:  Hold'em No Limit ($0.25/$0.50 USD) - 2021/07/30 17:43:14 ET
Table 'Aitne III' 9-max Seat #3 is the button
Seat 1: Corlogiro ($102.17 in chips) 
Seat 2: Pachebrash ($108.12 in chips) 
Seat 3: SwissSkier ($73.06 in chips) 
Seat 4: TATAP85 ($66.65 in chips) 
Seat 5: Sonny0306 ($81.55 in chips) 
Seat 6: Kahmi3105 ($183.07 in chips) 
Seat 7: bigned1975 ($80.86 in chips) 
Seat 8: oudine2 ($50 in chips) 
TATAP85: posts small blind $0.25
Sonny0306: posts big blind $0.50
*** HOLE CARDS ***
Kahmi3105: raises $1.25 to $1.75
bigned1975: folds 
oudine2: folds 
Corlogiro: raises $3.75 to $5.50
Pachebrash: folds 
SwissSkier: folds 
TATAP85: folds 
Sonny0306: folds 
Kahmi3105: calls $3.75
*** FLOP *** [8s Qh 8c]
Kahmi3105: checks 
galina8383 joins the table at seat #9 
Corlogiro: checks 
*** TURN *** [8s Qh 8c] [5s]
Kahmi3105: bets $7.50
Corlogiro: folds 
Uncalled bet ($7.50) returned to Kahmi3105
Kahmi3105 collected $11.01 from pot
*** SUMMARY ***
Total pot $11.75 | Rake $0.74 
Board [8s Qh 8c 5s]
Seat 1: Corlogiro folded on the Turn
Seat 2: Pachebrash folded before Flop (didn't bet)
Seat 3: SwissSkier (button) folded before Flop (didn't bet)
Seat 4: TATAP85 (small blind) folded before Flop
Seat 5: Sonny0306 (big blind) folded before Flop
Seat 6: Kahmi3105 collected ($11.01)
Seat 7: bigned1975 folded before Flop (didn't bet)
Seat 8: oudine2 folded before Flop (didn't bet)



PokerStars Hand #228690658125:  Hold'em No Limit ($0.25/$0.50 USD) - 2021/07/30 17:44:36 ET
Table 'Aitne III' 9-max Seat #4 is the button
Seat 1: Corlogiro ($96.67 in chips) 
Seat 2: Pachebrash ($108.12 in chips) 
Seat 3: SwissSkier ($73.06 in chips) 
Seat 4: TATAP85 ($66.40 in chips) 
Seat 5: Sonny0306 ($81.05 in chips) 
Seat 6: Kahmi3105 ($188.58 in chips) 
Seat 7: bigned1975 ($80.86 in chips) 
Seat 8: oudine2 ($50 in chips) 
Sonny0306: posts small blind $0.25
Kahmi3105: posts big blind $0.50
galina8383: sits out 
*** HOLE CARDS ***
bigned1975: folds 
oudine2: folds 
Corlogiro: folds 
Pachebrash: folds 
SwissSkier: raises $1 to $1.50
TATAP85: folds 
Sonny0306: folds 
Kahmi3105: calls $1
*** FLOP *** [8d 2c Tc]
Kahmi3105: checks 
SwissSkier: checks 
*** TURN *** [8d 2c Tc] [4d]
Kahmi3105: bets $4
SwissSkier: folds 
Uncalled bet ($4) returned to Kahmi3105
Kahmi3105 collected $3.05 from pot
*** SUMMARY ***
Total pot $3.25 | Rake $0.20 
Board [8d 2c Tc 4d]
Seat 1: Corlogiro folded before Flop (didn't bet)
Seat 2: Pachebrash folded before Flop (didn't bet)
Seat 3: SwissSkier folded on the Turn
Seat 4: TATAP85 (button) folded before Flop (didn't bet)
Seat 5: Sonny0306 (small blind) folded before Flop
Seat 6: Kahmi3105 (big blind) collected ($3.05)
Seat 7: bigned1975 folded before Flop (didn't bet)
Seat 8: oudine2 folded before Flop (didn't bet)



PokerStars Hand #228690671075:  Hold'em No Limit ($0.25/$0.50 USD) - 2021/07/30 17:45:06 ET
Table 'Aitne III' 9-max Seat #5 is the button
Seat 1: Corlogiro ($96.67 in chips) 
Seat 2: Pachebrash ($108.12 in chips) 
Seat 3: SwissSkier ($71.56 in chips) 
Seat 4: TATAP85 ($66.40 in chips) 
Seat 5: Sonny0306 ($80.80 in chips) 
Seat 6: Kahmi3105 ($190.13 in chips) 
Seat 7: bigned1975 ($80.86 in chips) 
Seat 8: oudine2 ($50 in chips) 
Kahmi3105: posts small blind $0.25
bigned1975: posts big blind $0.50
galina8383: sits out 
*** HOLE CARDS ***
oudine2: folds 
Corlogiro: folds 
Pachebrash: folds 
SwissSkier: folds 
TATAP85: folds 
Sonny0306: raises $0.75 to $1.25
Kahmi3105: folds 
bigned1975: calls $0.75
*** FLOP *** [9s 6h Jh]
bigned1975: checks 
Sonny0306: checks 
*** TURN *** [9s 6h Jh] [Kc]
bigned1975: checks 
Sonny0306: bets $1.03
bigned1975: folds 
Uncalled bet ($1.03) returned to Sonny0306
Sonny0306 collected $2.61 from pot
Sonny0306: doesn't show hand 
*** SUMMARY ***
Total pot $2.75 | Rake $0.14 
Board [9s 6h Jh Kc]
Seat 1: Corlogiro folded before Flop (didn't bet)
Seat 2: Pachebrash folded before Flop (didn't bet)
Seat 3: SwissSkier folded before Flop (didn't bet)
Seat 4: TATAP85 folded before Flop (didn't bet)
Seat 5: Sonny0306 (button) collected ($2.61)
Seat 6: Kahmi3105 (small blind) folded before Flop
Seat 7: bigned1975 (big blind) folded on the Turn
Seat 8: oudine2 folded before Flop (didn't bet)



PokerStars Hand #228690700594:  Hold'em No Limit ($0.25/$0.50 USD) - 2021/07/30 17:46:13 ET
Table 'Aitne III' 9-max Seat #6 is the button
Seat 1: Corlogiro ($96.67 in chips) 
Seat 2: Pachebrash ($108.12 in chips) 
Seat 3: SwissSkier ($71.56 in chips) 
Seat 4: TATAP85 ($66.40 in chips) 
Seat 5: Sonny0306 ($82.16 in chips) 
Seat 6: Kahmi3105 ($189.88 in chips) 
Seat 7: bigned1975 ($79.61 in chips) 
Seat 8: oudine2 ($50 in chips) 
bigned1975: posts small blind $0.25
oudine2: posts big blind $0.50
galina8383: sits out 
*** HOLE CARDS ***
Corlogiro: raises $0.75 to $1.25
Pachebrash: folds 
SwissSkier: raises $1.75 to $3
TATAP85: folds 
Sonny0306: folds 
Kahmi3105: calls $3
bigned1975: folds 
oudine2: folds 
Corlogiro: calls $1.75
*** FLOP *** [Ts 4s 3h]
Corlogiro: checks 
SwissSkier: bets $5.50
Kahmi3105: folds 
Corlogiro: folds 
Uncalled bet ($5.50) returned to SwissSkier
SwissSkier collected $9.26 from pot
*** SUMMARY ***
Total pot $9.75 | Rake $0.49 
Board [Ts 4s 3h]
Seat 1: Corlogiro folded on the Flop
Seat 2: Pachebrash folded before Flop (didn't bet)
Seat 3: SwissSkier collected ($9.26)
Seat 4: TATAP85 folded before Flop (didn't bet)
Seat 5: Sonny0306 folded before Flop (didn't bet)
Seat 6: Kahmi3105 (button) folded on the Flop
Seat 7: bigned1975 (small blind) folded before Flop
Seat 8: oudine2 (big blind) folded before Flop



PokerStars Hand #228690723358:  Hold'em No Limit ($0.25/$0.50 USD) - 2021/07/30 17:47:06 ET
Table 'Aitne III' 9-max Seat #7 is the button
Seat 1: Corlogiro ($93.67 in chips) 
Seat 2: Pachebrash ($108.12 in chips) 
Seat 3: SwissSkier ($77.82 in chips) 
Seat 4: TATAP85 ($66.40 in chips) 
Seat 5: Sonny0306 ($82.16 in chips) 
Seat 6: Kahmi3105 ($186.88 in chips) 
Seat 7: bigned1975 ($79.36 in chips) 
Seat 8: oudine2 ($50 in chips) 
Seat 9: galina8383 ($50 in chips) 
oudine2: posts small blind $0.25
galina8383: posts big blind $0.50
*** HOLE CARDS ***
Corlogiro: folds 
Pachebrash: folds 
SwissSkier: folds 
TATAP85: folds 
Sonny0306: raises $0.75 to $1.25
Kahmi3105: calls $1.25
bigned1975: folds 
oudine2: folds 
galina8383: folds 
*** FLOP *** [Ad 2d 5c]
Sonny0306: bets $1.13
Kahmi3105: calls $1.13
*** TURN *** [Ad 2d 5c] [Kd]
Sonny0306: checks 
Kahmi3105: bets $3.50
Sonny0306: folds 
Uncalled bet ($3.50) returned to Kahmi3105
Kahmi3105 collected $5.16 from pot
*** SUMMARY ***
Total pot $5.51 | Rake $0.35 
Board [Ad 2d 5c Kd]
Seat 1: Corlogiro folded before Flop (didn't bet)
Seat 2: Pachebrash folded before Flop (didn't bet)
Seat 3: SwissSkier folded before Flop (didn't bet)
Seat 4: TATAP85 folded before Flop (didn't bet)
Seat 5: Sonny0306 folded on the Turn
Seat 6: Kahmi3105 collected ($5.16)
Seat 7: bigned1975 (button) folded before Flop (didn't bet)
Seat 8: oudine2 (small blind) folded before Flop
Seat 9: galina8383 (big blind) folded before Flop



PokerStars Hand #228690746561:  Hold'em No Limit ($0.25/$0.50 USD) - 2021/07/30 17:48:00 ET
Table 'Aitne III' 9-max Seat #8 is the button
Seat 1: Corlogiro ($93.67 in chips) 
Seat 2: Pachebrash ($108.12 in chips) 
Seat 3: SwissSkier ($77.82 in chips) 
Seat 4: TATAP85 ($66.40 in chips) 
Seat 5: Sonny0306 ($79.78 in chips) 
Seat 6: Kahmi3105 ($189.66 in chips) 
Seat 7: bigned1975 ($79.36 in chips) 
Seat 8: oudine2 ($50 in chips) 
Seat 9: galina8383 ($50 in chips) 
galina8383: posts small blind $0.25
Corlogiro: posts big blind $0.50
*** HOLE CARDS ***
Pachebrash: folds 
SwissSkier: folds 
TATAP85: folds 
Sonny0306: raises $0.75 to $1.25
Kahmi3105: calls $1.25
bigned1975: calls $1.25
oudine2: folds 
galina8383: folds 
Corlogiro: folds 
*** FLOP *** [Jd 4d Kd]
Sonny0306: bets $2
Kahmi3105: folds 
bigned1975: folds 
Uncalled bet ($2) returned to Sonny0306
Sonny0306 collected $4.28 from pot
Sonny0306: doesn't show hand 
*** SUMMARY ***
Total pot $4.50 | Rake $0.22 
Board [Jd 4d Kd]
Seat 1: Corlogiro (big blind) folded before Flop
Seat 2: Pachebrash folded before Flop (didn't bet)
Seat 3: SwissSkier folded before Flop (didn't bet)
Seat 4: TATAP85 folded before Flop (didn't bet)
Seat 5: Sonny0306 collected ($4.28)
Seat 6: Kahmi3105 folded on the Flop
Seat 7: bigned1975 folded on the Flop
Seat 8: oudine2 (button) folded before Flop (didn't bet)
Seat 9: galina8383 (small blind) folded before Flop



PokerStars Hand #228690774970:  Hold'em No Limit ($0.25/$0.50 USD) - 2021/07/30 17:49:07 ET
Table 'Aitne III' 9-max Seat #9 is the button
Seat 1: Corlogiro ($93.17 in chips) 
Seat 2: Pachebrash ($108.12 in chips) 
Seat 3: SwissSkier ($77.82 in chips) 
Seat 4: TATAP85 ($66.40 in chips) 
Seat 5: Sonny0306 ($82.81 in chips) 
Seat 6: Kahmi3105 ($188.41 in chips) 
Seat 7: bigned1975 ($78.11 in chips) 
Seat 8: oudine2 ($50 in chips) 
Seat 9: galina8383 ($50 in chips) 
Corlogiro: posts small blind $0.25
Pachebrash: posts big blind $0.50
*** HOLE CARDS ***
SwissSkier: folds 
TATAP85: folds 
Sonny0306: folds 
Kahmi3105: raises $1.25 to $1.75
bigned1975: folds 
oudine2: folds 
galina8383: folds 
Corlogiro: folds 
Pachebrash: folds 
Uncalled bet ($1.25) returned to Kahmi3105
Kahmi3105 collected $1.25 from pot
*** SUMMARY ***
Total pot $1.25 | Rake $0 
Seat 1: Corlogiro (small blind) folded before Flop
Seat 2: Pachebrash (big blind) folded before Flop
Seat 3: SwissSkier folded before Flop (didn't bet)
Seat 4: TATAP85 folded before Flop (didn't bet)
Seat 5: Sonny0306 folded before Flop (didn't bet)
Seat 6: Kahmi3105 collected ($1.25)
Seat 7: bigned1975 folded before Flop (didn't bet)
Seat 8: oudine2 folded before Flop (didn't bet)
Seat 9: galina8383 (button) folded before Flop (didn't bet)



PokerStars Hand #228690785346:  Hold'em No Limit ($0.25/$0.50 USD) - 2021/07/30 17:49:31 ET
Table 'Aitne III' 9-max Seat #1 is the button
Seat 1: Corlogiro ($92.92 in chips) 
Seat 2: Pachebrash ($107.62 in chips) 
Seat 3: SwissSkier ($77.82 in chips) 
Seat 4: TATAP85 ($66.40 in chips) 
Seat 5: Sonny0306 ($82.81 in chips) 
Seat 6: Kahmi3105 ($189.16 in chips) 
Seat 7: bigned1975 ($78.11 in chips) 
Seat 8: oudine2 ($50 in chips) 
Seat 9: galina8383 ($50 in chips) 
Pachebrash: posts small blind $0.25
SwissSkier: posts big blind $0.50
*** HOLE CARDS ***
TATAP85: folds 
Sonny0306: folds 
Kahmi3105: calls $0.50
bigned1975: folds 
oudine2: folds 
galina8383: folds 
Corlogiro: folds 
Pachebrash: calls $0.25
SwissSkier: checks 
*** FLOP *** [7d Th Qs]
Pachebrash: checks 
SwissSkier: checks 
Kahmi3105: bets $2
Pachebrash: folds 
SwissSkier: folds 
Uncalled bet ($2) returned to Kahmi3105
Kahmi3105 collected $1.40 from pot
*** SUMMARY ***
Total pot $1.50 | Rake $0.10 
Board [7d Th Qs]
Seat 1: Corlogiro (button) folded before Flop (didn't bet)
Seat 2: Pachebrash (small blind) folded on the Flop
Seat 3: SwissSkier (big blind) folded on the Flop
Seat 4: TATAP85 folded before Flop (didn't bet)
Seat 5: Sonny0306 folded before Flop (didn't bet)
Seat 6: Kahmi3105 collected ($1.40)
Seat 7: bigned1975 folded before Flop (didn't bet)
Seat 8: oudine2 folded before Flop (didn't bet)
Seat 9: galina8383 folded before Flop (didn't bet)



PokerStars Hand #228690803524:  Hold'em No Limit ($0.25/$0.50 USD) - 2021/07/30 17:50:14 ET
Table 'Aitne III' 9-max Seat #2 is the button
Seat 1: Corlogiro ($92.92 in chips) 
Seat 2: Pachebrash ($107.12 in chips) 
Seat 3: SwissSkier ($77.32 in chips) 
Seat 4: TATAP85 ($66.40 in chips) 
Seat 5: Sonny0306 ($82.81 in chips) 
Seat 6: Kahmi3105 ($190.06 in chips) 
Seat 7: bigned1975 ($78.11 in chips) 
Seat 8: oudine2 ($50 in chips) 
Seat 9: galina8383 ($50 in chips) 
SwissSkier: posts small blind $0.25
TATAP85: posts big blind $0.50
*** HOLE CARDS ***
Sonny0306: folds 
Kahmi3105: raises $1.25 to $1.75
bigned1975: folds 
oudine2: folds 
galina8383: folds 
Corlogiro: folds 
Pachebrash: folds 
SwissSkier: folds 
galina8383 was removed from the table for failing to post
galina8383 leaves the table
TATAP85: folds 
Uncalled bet ($1.25) returned to Kahmi3105
Kahmi3105 collected $1.25 from pot
*** SUMMARY ***
Total pot $1.25 | Rake $0 
Seat 1: Corlogiro folded before Flop (didn't bet)
Seat 2: Pachebrash (button) folded before Flop (didn't bet)
Seat 3: SwissSkier (small blind) folded before Flop
Seat 4: TATAP85 (big blind) folded before Flop
Seat 5: Sonny0306 folded before Flop (didn't bet)
Seat 6: Kahmi3105 collected ($1.25)
Seat 7: bigned1975 folded before Flop (didn't bet)
Seat 8: oudine2 folded before Flop (didn't bet)
Seat 9: galina8383 folded before Flop (didn't bet)



PokerStars Hand #228690814432:  Hold'em No Limit ($0.25/$0.50 USD) - 2021/07/30 17:50:39 ET
Table 'Aitne III' 9-max Seat #3 is the button
Seat 1: Corlogiro ($92.92 in chips) 
Seat 2: Pachebrash ($107.12 in chips) 
Seat 3: SwissSkier ($77.07 in chips) 
Seat 4: TATAP85 ($65.90 in chips) 
Seat 5: Sonny0306 ($82.81 in chips) 
Seat 6: Kahmi3105 ($190.81 in chips) 
Seat 7: bigned1975 ($78.11 in chips) 
Seat 8: oudine2 ($50 in chips) 
TATAP85: posts small blind $0.25
Sonny0306: posts big blind $0.50
*** HOLE CARDS ***
Kahmi3105: calls $0.50
leooooon79 joins the table at seat #9 
bigned1975: raises $2 to $2.50
oudine2: folds 
Corlogiro: folds 
Pachebrash: folds 
SwissSkier: folds 
TATAP85: folds 
Sonny0306: folds 
Kahmi3105: calls $2
*** FLOP *** [7h Jh 5h]
Kahmi3105: checks 
bigned1975: bets $3.50
Kahmi3105: calls $3.50
*** TURN *** [7h Jh 5h] [Jd]
Kahmi3105: checks 
bigned1975: checks 
*** RIVER *** [7h Jh 5h Jd] [2c]
Kahmi3105: bets $14.50
bigned1975: calls $14.50
*** SHOW DOWN ***
Kahmi3105: shows [5s 5d] (a full house, Fives full of Jacks)
bigned1975: mucks hand 
Kahmi3105 collected $39.25 from pot
*** SUMMARY ***
Total pot $41.75 | Rake $2.50 
Board [7h Jh 5h Jd 2c]
Seat 1: Corlogiro folded before Flop (didn't bet)
Seat 2: Pachebrash folded before Flop (didn't bet)
Seat 3: SwissSkier (button) folded before Flop (didn't bet)
Seat 4: TATAP85 (small blind) folded before Flop
Seat 5: Sonny0306 (big blind) folded before Flop
Seat 6: Kahmi3105 showed [5s 5d] and won ($39.25) with a full house, Fives full of Jacks
Seat 7: bigned1975 mucked
Seat 8: oudine2 folded before Flop (didn't bet)



PokerStars Hand #228690846414:  Hold'em No Limit ($0.25/$0.50 USD) - 2021/07/30 17:51:47 ET
Table 'Aitne III' 9-max Seat #4 is the button
Seat 1: Corlogiro ($92.92 in chips) 
Seat 2: Pachebrash ($107.12 in chips) 
Seat 3: SwissSkier ($77.07 in chips) 
Seat 4: TATAP85 ($65.65 in chips) 
Seat 5: Sonny0306 ($82.31 in chips) 
Seat 6: Kahmi3105 ($209.56 in chips) 
Seat 7: bigned1975 ($57.61 in chips) 
Seat 8: oudine2 ($50 in chips) 
Seat 9: leooooon79 ($21.10 in chips) 
Sonny0306: posts small blind $0.25
Kahmi3105: posts big blind $0.50
leooooon79: posts big blind $0.50
*** HOLE CARDS ***
bigned1975: raises $1 to $1.50
oudine2: folds 
leooooon79: calls $1
Corlogiro: folds 
Pachebrash: folds 
SwissSkier: folds 
TATAP85: folds 
Sonny0306: folds 
Kahmi3105: calls $1
*** FLOP *** [Jc 2c Kh]
Kahmi3105: checks 
bigned1975: bets $3.50
leooooon79: folds 
Kahmi3105: folds 
Uncalled bet ($3.50) returned to bigned1975
bigned1975 collected $4.51 from pot
bigned1975: doesn't show hand 
*** SUMMARY ***
Total pot $4.75 | Rake $0.24 
Board [Jc 2c Kh]
Seat 1: Corlogiro folded before Flop (didn't bet)
Seat 2: Pachebrash folded before Flop (didn't bet)
Seat 3: SwissSkier folded before Flop (didn't bet)
Seat 4: TATAP85 (button) folded before Flop (didn't bet)
Seat 5: Sonny0306 (small blind) folded before Flop
Seat 6: Kahmi3105 (big blind) folded on the Flop
Seat 7: bigned1975 collected ($4.51)
Seat 8: oudine2 folded before Flop (didn't bet)
Seat 9: leooooon79 folded on the Flop



PokerStars Hand #228690933101:  Hold'em No Limit ($0.25/$0.50 USD) - 2021/07/30 17:55:09 ET
Table 'Aitne III' 9-max Seat #8 is the button
Seat 1: Corlogiro ($92.92 in chips) 
Seat 2: Pachebrash ($107.12 in chips) 
Seat 4: TATAP85 ($65.65 in chips) 
Seat 5: Sonny0306 ($82.81 in chips) 
Seat 6: Kahmi3105 ($207.81 in chips) 
Seat 7: bigned1975 ($57.28 in chips) 
Seat 8: oudine2 ($50 in chips) 
Seat 9: leooooon79 ($23.16 in chips) 
leooooon79: posts small blind $0.25
Corlogiro: posts big blind $0.50
*** HOLE CARDS ***
Pachebrash: folds 
TATAP85: folds 
Sonny0306: raises $0.75 to $1.25
Kahmi3105: calls $1.25
bigned1975: folds 
oudine2: calls $1.25
leooooon79: calls $1
Corlogiro: calls $0.75
*** FLOP *** [7s 3h 7h]
leooooon79: checks 
Corlogiro: bets $2.50
Sonny0306: folds 
Kahmi3105: calls $2.50
oudine2: folds 
leooooon79: calls $2.50
*** TURN *** [7s 3h 7h] [Ad]
leooooon79: checks 
Corlogiro: bets $7.50
Kahmi3105: folds 
leooooon79: calls $7.50
*** RIVER *** [7s 3h 7h Ad] [9c]
leooooon79: checks 
Corlogiro: checks 
*** SHOW DOWN ***
leooooon79: shows [Jh 7c] (three of a kind, Sevens)
Corlogiro: mucks hand 
leooooon79 collected $27.31 from pot
*** SUMMARY ***
Total pot $28.75 | Rake $1.44 
Board [7s 3h 7h Ad 9c]
Seat 1: Corlogiro (big blind) mucked
Seat 2: Pachebrash folded before Flop (didn't bet)
Seat 4: TATAP85 folded before Flop (didn't bet)
Seat 5: Sonny0306 folded on the Flop
Seat 6: Kahmi3105 folded on the Turn
Seat 7: bigned1975 folded before Flop (didn't bet)
Seat 8: oudine2 (button) folded on the Flop
Seat 9: leooooon79 (small blind) showed [Jh 7c] and won ($27.31) with three of a kind, Sevens



PokerStars Hand #228690971381:  Hold'em No Limit ($0.25/$0.50 USD) - 2021/07/30 17:57:07 ET
Table 'Aitne III' 9-max Seat #9 is the button
Seat 1: Corlogiro ($81.67 in chips) 
Seat 2: Pachebrash ($107.12 in chips) 
Seat 3: SwissSkier ($77.07 in chips) 
Seat 4: TATAP85 ($65.65 in chips) 
Seat 5: Sonny0306 ($81.56 in chips) 
Seat 6: Kahmi3105 ($204.06 in chips) 
Seat 7: bigned1975 ($57.28 in chips) 
Seat 8: oudine2 ($50 in chips) 
Seat 9: leooooon79 ($39.22 in chips) 
Corlogiro: posts small blind $0.25
Pachebrash: posts big blind $0.50
*** HOLE CARDS ***
SwissSkier: raises $0.50 to $1
TATAP85: folds 
Sonny0306: folds 
Kahmi3105: raises $2.75 to $3.75
bigned1975: folds 
oudine2: folds 
leooooon79: folds 
Corlogiro: folds 
Pachebrash: folds 
SwissSkier: folds 
Uncalled bet ($2.75) returned to Kahmi3105
Kahmi3105 collected $2.75 from pot
*** SUMMARY ***
Total pot $2.75 | Rake $0 
Seat 1: Corlogiro (small blind) folded before Flop
Seat 2: Pachebrash (big blind) folded before Flop
Seat 3: SwissSkier folded before Flop
Seat 4: TATAP85 folded before Flop (didn't bet)
Seat 5: Sonny0306 folded before Flop (didn't bet)
Seat 6: Kahmi3105 collected ($2.75)
Seat 7: bigned1975 folded before Flop (didn't bet)
Seat 8: oudine2 folded before Flop (didn't bet)
Seat 9: leooooon79 (button) folded before Flop (didn't bet)



PokerStars Hand #228690979437:  Hold'em No Limit ($0.25/$0.50 USD) - 2021/07/30 17:57:32 ET
Table 'Aitne III' 9-max Seat #1 is the button
Seat 1: Corlogiro ($81.42 in chips) 
Seat 2: Pachebrash ($106.62 in chips) 
Seat 3: SwissSkier ($76.07 in chips) 
Seat 4: TATAP85 ($65.65 in chips) 
Seat 5: Sonny0306 ($81.56 in chips) 
Seat 6: Kahmi3105 ($205.81 in chips) 
Seat 7: bigned1975 ($57.28 in chips) 
Seat 8: oudine2 ($50 in chips) 
Seat 9: leooooon79 ($39.22 in chips) 
Pachebrash: posts small blind $0.25
SwissSkier: posts big blind $0.50
*** HOLE CARDS ***
TATAP85: folds 
Sonny0306: raises $0.75 to $1.25
Kahmi3105: calls $1.25
bigned1975: folds 
oudine2: folds 
leooooon79: calls $1.25
Corlogiro: folds 
Pachebrash: folds 
SwissSkier: folds 
*** FLOP *** [Qs 4h 7s]
Sonny0306: bets $3.11
Kahmi3105: folds 
leooooon79: calls $3.11
*** TURN *** [Qs 4h 7s] [Jc]
Sonny0306: bets $7.20
leooooon79: calls $7.20
*** RIVER *** [Qs 4h 7s Jc] [6d]
Sonny0306: bets $15.66
leooooon79: calls $15.66
*** SHOW DOWN ***
Sonny0306: shows [Kd Kh] (a pair of Kings)
leooooon79: mucks hand 
Sonny0306 collected $54.44 from pot
*** SUMMARY ***
Total pot $56.44 | Rake $2 
Board [Qs 4h 7s Jc 6d]
Seat 1: Corlogiro (button) folded before Flop (didn't bet)
Seat 2: Pachebrash (small blind) folded before Flop
Seat 3: SwissSkier (big blind) folded before Flop
Seat 4: TATAP85 folded before Flop (didn't bet)
Seat 5: Sonny0306 showed [Kd Kh] and won ($54.44) with a pair of Kings
Seat 6: Kahmi3105 folded on the Flop
Seat 7: bigned1975 folded before Flop (didn't bet)
Seat 8: oudine2 folded before Flop (didn't bet)
Seat 9: leooooon79 mucked



PokerStars Hand #228691027677:  Hold'em No Limit ($0.25/$0.50 USD) - 2021/07/30 17:59:14 ET
Table 'Aitne III' 9-max Seat #2 is the button
Seat 1: Corlogiro ($81.42 in chips) 
Seat 2: Pachebrash ($106.37 in chips) 
Seat 3: SwissSkier ($75.57 in chips) 
Seat 5: Sonny0306 ($108.78 in chips) 
Seat 6: Kahmi3105 ($204.56 in chips) 
Seat 7: bigned1975 ($57.28 in chips) 
Seat 8: oudine2 ($50 in chips) 
Seat 9: leooooon79 ($12 in chips) 
SwissSkier: posts small blind $0.25
TATAP85: is sitting out 
Sonny0306: posts big blind $0.50
*** HOLE CARDS ***
TATAP85 leaves the table
Kahmi3105: raises $1.25 to $1.75
ruQx01 joins the table at seat #4 
bigned1975: folds 
oudine2: folds 
leooooon79: folds 
Corlogiro: folds 
Pachebrash: folds 
SwissSkier: folds 
Sonny0306: folds 
Uncalled bet ($1.25) returned to Kahmi3105
Sonny0306 leaves the table
Kahmi3105 collected $1.25 from pot
*** SUMMARY ***
Total pot $1.25 | Rake $0 
Seat 1: Corlogiro folded before Flop (didn't bet)
Seat 2: Pachebrash (button) folded before Flop (didn't bet)
Seat 3: SwissSkier (small blind) folded before Flop
Seat 5: Sonny0306 (big blind) folded before Flop
Seat 6: Kahmi3105 collected ($1.25)
Seat 7: bigned1975 folded before Flop (didn't bet)
Seat 8: oudine2 folded before Flop (didn't bet)
Seat 9: leooooon79 folded before Flop (didn't bet)



PokerStars Hand #228691034489:  Hold'em No Limit ($0.25/$0.50 USD) - 2021/07/30 17:59:35 ET
Table 'Aitne III' 9-max Seat #3 is the button
Seat 1: Corlogiro ($81.42 in chips) 
Seat 2: Pachebrash ($106.37 in chips) 
Seat 3: SwissSkier ($75.32 in chips) 
Seat 6: Kahmi3105 ($205.31 in chips) 
Seat 7: bigned1975 ($57.28 in chips) 
Seat 8: oudine2 ($50 in chips) 
Seat 9: leooooon79 ($12 in chips) 
Kahmi3105: posts small blind $0.25
bigned1975: posts big blind $0.50
*** HOLE CARDS ***
UPERAD joins the table at seat #5 
oudine2: raises $1 to $1.50
leooooon79: folds 
Corlogiro: folds 
Pachebrash: folds 
SwissSkier: folds 
Kahmi3105: folds 
bigned1975: folds 
Uncalled bet ($1) returned to oudine2
oudine2 collected $1.25 from pot
oudine2: doesn't show hand 
*** SUMMARY ***
Total pot $1.25 | Rake $0 
Seat 1: Corlogiro folded before Flop (didn't bet)
Seat 2: Pachebrash folded before Flop (didn't bet)
Seat 3: SwissSkier (button) folded before Flop (didn't bet)
Seat 6: Kahmi3105 (small blind) folded before Flop
Seat 7: bigned1975 (big blind) folded before Flop
Seat 8: oudine2 collected ($1.25)
Seat 9: leooooon79 folded before Flop (didn't bet)



PokerStars Hand #228691040936:  Hold'em No Limit ($0.25/$0.50 USD) - 2021/07/30 17:59:55 ET
Table 'Aitne III' 9-max Seat #6 is the button
Seat 1: Corlogiro ($81.42 in chips) 
Seat 2: Pachebrash ($106.37 in chips) 
Seat 3: SwissSkier ($75.32 in chips) 
Seat 6: Kahmi3105 ($205.06 in chips) 
Seat 7: bigned1975 ($56.78 in chips) 
Seat 8: oudine2 ($50.75 in chips) 
Seat 9: leooooon79 ($12 in chips) 
bigned1975: posts small blind $0.25
oudine2: posts big blind $0.50
ruQx01: sits out 
UPERAD: sits out 
*** HOLE CARDS ***
leooooon79: folds 
Corlogiro: folds 
Pachebrash: folds 
SwissSkier: folds 
Kahmi3105: folds 
bigned1975: calls $0.25
oudine2: raises $2 to $2.50
bigned1975: folds 
Uncalled bet ($2) returned to oudine2
oudine2 collected $1 from pot
oudine2: doesn't show hand 
*** SUMMARY ***
Total pot $1 | Rake $0 
Seat 1: Corlogiro folded before Flop (didn't bet)
Seat 2: Pachebrash folded before Flop (didn't bet)
Seat 3: SwissSkier folded before Flop (didn't bet)
Seat 6: Kahmi3105 (button) folded before Flop (didn't bet)
Seat 7: bigned1975 (small blind) folded before Flop
Seat 8: oudine2 (big blind) collected ($1)
Seat 9: leooooon79 folded before Flop (didn't bet)



PokerStars Hand #228691048822:  Hold'em No Limit ($0.25/$0.50 USD) - 2021/07/30 18:00:18 ET
Table 'Aitne III' 9-max Seat #7 is the button
Seat 1: Corlogiro ($81.42 in chips) 
Seat 2: Pachebrash ($106.37 in chips) 
Seat 3: SwissSkier ($75.32 in chips) 
Seat 6: Kahmi3105 ($205.06 in chips) 
Seat 7: bigned1975 ($56.28 in chips) 
Seat 8: oudine2 ($51.25 in chips) 
Seat 9: leooooon79 ($12 in chips) 
oudine2: posts small blind $0.25
leooooon79: posts big blind $0.50
ruQx01: sits out 
UPERAD: sits out 
*** HOLE CARDS ***
Corlogiro: folds 
Pachebrash: folds 
SwissSkier: folds 
Kahmi3105: raises $1.25 to $1.75
bigned1975: folds 
oudine2: folds 
leooooon79: calls $1.25
*** FLOP *** [Qd Qc Tc]
leooooon79: checks 
Kahmi3105: checks 
*** TURN *** [Qd Qc Tc] [Ts]
leooooon79: bets $0.50
Kahmi3105: folds 
Uncalled bet ($0.50) returned to leooooon79
leooooon79 collected $3.56 from pot
leooooon79: doesn't show hand 
*** SUMMARY ***
Total pot $3.75 | Rake $0.19 
Board [Qd Qc Tc Ts]
Seat 1: Corlogiro folded before Flop (didn't bet)
Seat 2: Pachebrash folded before Flop (didn't bet)
Seat 3: SwissSkier folded before Flop (didn't bet)
Seat 6: Kahmi3105 folded on the Turn
Seat 7: bigned1975 (button) folded before Flop (didn't bet)
Seat 8: oudine2 (small blind) folded before Flop
Seat 9: leooooon79 (big blind) collected ($3.56)



PokerStars Hand #228691059562:  Hold'em No Limit ($0.25/$0.50 USD) - 2021/07/30 18:00:48 ET
Table 'Aitne III' 9-max Seat #8 is the button
Seat 1: Corlogiro ($81.42 in chips) 
Seat 2: Pachebrash ($106.37 in chips) 
Seat 3: SwissSkier ($75.32 in chips) 
Seat 6: Kahmi3105 ($203.31 in chips) 
Seat 7: bigned1975 ($56.28 in chips) 
Seat 8: oudine2 ($51 in chips) 
Seat 9: leooooon79 ($13.81 in chips) 
leooooon79: posts small blind $0.25
Corlogiro: posts big blind $0.50
ruQx01: sits out 
UPERAD: sits out 
*** HOLE CARDS ***
Pachebrash: folds 
SwissSkier: folds 
Kahmi3105: folds 
bigned1975: folds 
oudine2: raises $0.75 to $1.25
leooooon79: calls $1
Corlogiro: calls $0.75
*** FLOP *** [2d 8d Jc]
leooooon79: checks 
Corlogiro: checks 
oudine2: bets $2.49
leooooon79: folds 
Corlogiro: folds 
Uncalled bet ($2.49) returned to oudine2
oudine2 collected $3.56 from pot
oudine2: doesn't show hand 
*** SUMMARY ***
Total pot $3.75 | Rake $0.19 
Board [2d 8d Jc]
Seat 1: Corlogiro (big blind) folded on the Flop
Seat 2: Pachebrash folded before Flop (didn't bet)
Seat 3: SwissSkier folded before Flop (didn't bet)
Seat 6: Kahmi3105 folded before Flop (didn't bet)
Seat 7: bigned1975 folded before Flop (didn't bet)
Seat 8: oudine2 (button) collected ($3.56)
Seat 9: leooooon79 (small blind) folded on the Flop



PokerStars Hand #228691077540:  Hold'em No Limit ($0.25/$0.50 USD) - 2021/07/30 18:01:34 ET
Table 'Aitne III' 9-max Seat #9 is the button
Seat 1: Corlogiro ($80.17 in chips) 
Seat 2: Pachebrash ($106.37 in chips) 
Seat 3: SwissSkier ($75.32 in chips) 
Seat 6: Kahmi3105 ($203.31 in chips) 
Seat 7: bigned1975 ($56.28 in chips) 
Seat 8: oudine2 ($53.31 in chips) 
Seat 9: leooooon79 ($12.56 in chips) 
Corlogiro: posts small blind $0.25
Pachebrash: posts big blind $0.50
ruQx01: sits out 
UPERAD: sits out 
*** HOLE CARDS ***
SwissSkier: folds 
Kahmi3105: raises $1.25 to $1.75
bigned1975: folds 
oudine2: folds 
leooooon79: folds 
Corlogiro: raises $4.25 to $6
Pachebrash: folds 
Kahmi3105: calls $4.25
*** FLOP *** [3d 8s Qs]
Corlogiro: bets $7
Kahmi3105: calls $7
*** TURN *** [3d 8s Qs] [6s]
Corlogiro: bets $14.50
Kahmi3105: raises $54.18 to $68.68
Corlogiro: calls $52.67 and is all-in
Uncalled bet ($1.51) returned to Kahmi3105
*** RIVER *** [3d 8s Qs 6s] [Jh]
*** SHOW DOWN ***
Corlogiro: shows [Kd Kc] (a pair of Kings)
Kahmi3105: shows [5s 7s] (a flush, Queen high)
Kahmi3105 collected $158.34 from pot
*** SUMMARY ***
Total pot $160.84 | Rake $2.50 
Board [3d 8s Qs 6s Jh]
Seat 1: Corlogiro (small blind) showed [Kd Kc] and lost with a pair of Kings
Seat 2: Pachebrash (big blind) folded before Flop
Seat 3: SwissSkier folded before Flop (didn't bet)
Seat 6: Kahmi3105 showed [5s 7s] and won ($158.34) with a flush, Queen high
Seat 7: bigned1975 folded before Flop (didn't bet)
Seat 8: oudine2 folded before Flop (didn't bet)
Seat 9: leooooon79 (button) folded before Flop (didn't bet)



PokerStars Hand #228691107152:  Hold'em No Limit ($0.25/$0.50 USD) - 2021/07/30 18:02:45 ET
Table 'Aitne III' 9-max Seat #1 is the button
Seat 1: Corlogiro ($50 in chips) 
Seat 2: Pachebrash ($105.87 in chips) 
Seat 3: SwissSkier ($75.32 in chips) 
Seat 6: Kahmi3105 ($281.48 in chips) 
Seat 7: bigned1975 ($56.28 in chips) 
Seat 8: oudine2 ($53.31 in chips) 
Seat 9: leooooon79 ($12.56 in chips) 
Pachebrash: posts small blind $0.25
SwissSkier: posts big blind $0.50
ruQx01: sits out 
UPERAD: sits out 
*** HOLE CARDS ***
Kahmi3105: raises $1.25 to $1.75
bigned1975: calls $1.75
oudine2: folds 
leooooon79: calls $1.75
Corlogiro: folds 
Pachebrash: folds 
SwissSkier: folds 
*** FLOP *** [6c 3d 7d]
Kahmi3105: checks 
bigned1975: bets $3.50
leooooon79: folds 
Kahmi3105: folds 
Uncalled bet ($3.50) returned to bigned1975
bigned1975 collected $5.70 from pot
bigned1975: doesn't show hand 
*** SUMMARY ***
Total pot $6 | Rake $0.30 
Board [6c 3d 7d]
Seat 1: Corlogiro (button) folded before Flop (didn't bet)
Seat 2: Pachebrash (small blind) folded before Flop
Seat 3: SwissSkier (big blind) folded before Flop
Seat 6: Kahmi3105 folded on the Flop
Seat 7: bigned1975 collected ($5.70)
Seat 8: oudine2 folded before Flop (didn't bet)
Seat 9: leooooon79 folded on the Flop



PokerStars Hand #228691124421:  Hold'em No Limit ($0.25/$0.50 USD) - 2021/07/30 18:03:26 ET
Table 'Aitne III' 9-max Seat #2 is the button
Seat 1: Corlogiro ($50 in chips) 
Seat 2: Pachebrash ($105.62 in chips) 
Seat 3: SwissSkier ($74.82 in chips) 
Seat 4: ruQx01 ($50 in chips) 
Seat 6: Kahmi3105 ($279.73 in chips) 
Seat 7: bigned1975 ($60.23 in chips) 
Seat 8: oudine2 ($53.31 in chips) 
Seat 9: leooooon79 ($10.81 in chips) 
SwissSkier: posts small blind $0.25
ruQx01: posts big blind $0.50
UPERAD: sits out 
*** HOLE CARDS ***
Kahmi3105: raises $1.25 to $1.75
bigned1975: folds 
oudine2: folds 
leooooon79: folds 
Corlogiro: calls $1.75
Pachebrash: folds 
SwissSkier: folds 
ruQx01: folds 
*** FLOP *** [Qh Qc Ks]
Kahmi3105: bets $3
Corlogiro: folds 
Uncalled bet ($3) returned to Kahmi3105
Kahmi3105 collected $3.99 from pot
*** SUMMARY ***
Total pot $4.25 | Rake $0.26 
Board [Qh Qc Ks]
Seat 1: Corlogiro folded on the Flop
Seat 2: Pachebrash (button) folded before Flop (didn't bet)
Seat 3: SwissSkier (small blind) folded before Flop
Seat 4: ruQx01 (big blind) folded before Flop
Seat 6: Kahmi3105 collected ($3.99)
Seat 7: bigned1975 folded before Flop (didn't bet)
Seat 8: oudine2 folded before Flop (didn't bet)
Seat 9: leooooon79 folded before Flop (didn't bet)



PokerStars Hand #228691137982:  Hold'em No Limit ($0.25/$0.50 USD) - 2021/07/30 18:03:57 ET
Table 'Aitne III' 9-max Seat #3 is the button
Seat 1: Corlogiro ($50 in chips) 
Seat 2: Pachebrash ($105.62 in chips) 
Seat 3: SwissSkier ($74.57 in chips) 
Seat 4: ruQx01 ($50 in chips) 
Seat 5: UPERAD ($50 in chips) 
Seat 6: Kahmi3105 ($281.97 in chips) 
Seat 7: bigned1975 ($60.23 in chips) 
Seat 8: oudine2 ($53.31 in chips) 
Seat 9: leooooon79 ($10.81 in chips) 
ruQx01: posts small blind $0.25
UPERAD: posts big blind $0.50
*** HOLE CARDS ***
Kahmi3105 has timed out
Kahmi3105: folds 
bigned1975: folds 
oudine2: folds 
leooooon79: calls $0.50
Corlogiro: folds 
Pachebrash: folds 
SwissSkier: folds 
ruQx01: folds 
UPERAD: checks 
*** FLOP *** [3s 9h Th]
UPERAD: checks 
leooooon79: checks 
*** TURN *** [3s 9h Th] [Ah]
UPERAD: checks 
leooooon79: bets $0.50
UPERAD: folds 
Uncalled bet ($0.50) returned to leooooon79
leooooon79 collected $1.19 from pot
leooooon79: doesn't show hand 
*** SUMMARY ***
Total pot $1.25 | Rake $0.06 
Board [3s 9h Th Ah]
Seat 1: Corlogiro folded before Flop (didn't bet)
Seat 2: Pachebrash folded before Flop (didn't bet)
Seat 3: SwissSkier (button) folded before Flop (didn't bet)
Seat 4: ruQx01 (small blind) folded before Flop
Seat 5: UPERAD (big blind) folded on the Turn
Seat 6: Kahmi3105 folded before Flop (didn't bet)
Seat 7: bigned1975 folded before Flop (didn't bet)
Seat 8: oudine2 folded before Flop (didn't bet)
Seat 9: leooooon79 collected ($1.19)



PokerStars Hand #228691151412:  Hold'em No Limit ($0.25/$0.50 USD) - 2021/07/30 18:04:29 ET
Table 'Aitne III' 9-max Seat #4 is the button
Seat 1: Corlogiro ($50 in chips) 
Seat 2: Pachebrash ($105.62 in chips) 
Seat 3: SwissSkier ($74.57 in chips) 
Seat 4: ruQx01 ($50 in chips) 
Seat 5: UPERAD ($49.50 in chips) 
Seat 6: Kahmi3105 ($281.97 in chips) 
Seat 7: bigned1975 ($60.23 in chips) 
Seat 8: oudine2 ($53.31 in chips) 
Seat 9: leooooon79 ($11.50 in chips) 
UPERAD: posts small blind $0.25
Kahmi3105: posts big blind $0.50
*** HOLE CARDS ***
bigned1975: folds 
oudine2: folds 
leooooon79: calls $0.50
Corlogiro: folds 
Pachebrash: folds 
SwissSkier: folds 
ruQx01: folds 
UPERAD: calls $0.25
Kahmi3105: checks 
*** FLOP *** [6s Qd 5s]
UPERAD: checks 
Kahmi3105: checks 
leooooon79: checks 
*** TURN *** [6s Qd 5s] [5h]
UPERAD: checks 
Kahmi3105: bets $1.50
leooooon79: calls $1.50
UPERAD: folds 
*** RIVER *** [6s Qd 5s 5h] [3s]
Kahmi3105: checks 
leooooon79: bets $2.14
Kahmi3105: folds 
Uncalled bet ($2.14) returned to leooooon79
leooooon79 collected $4.28 from pot
leooooon79: doesn't show hand 
*** SUMMARY ***
Total pot $4.50 | Rake $0.22 
Board [6s Qd 5s 5h 3s]
Seat 1: Corlogiro folded before Flop (didn't bet)
Seat 2: Pachebrash folded before Flop (didn't bet)
Seat 3: SwissSkier folded before Flop (didn't bet)
Seat 4: ruQx01 (button) folded before Flop (didn't bet)
Seat 5: UPERAD (small blind) folded on the Turn
Seat 6: Kahmi3105 (big blind) folded on the River
Seat 7: bigned1975 folded before Flop (didn't bet)
Seat 8: oudine2 folded before Flop (didn't bet)
Seat 9: leooooon79 collected ($4.28)



PokerStars Hand #228691169709:  Hold'em No Limit ($0.25/$0.50 USD) - 2021/07/30 18:05:12 ET
Table 'Aitne III' 9-max Seat #5 is the button
Seat 1: Corlogiro ($50 in chips) 
Seat 2: Pachebrash ($105.62 in chips) 
Seat 3: SwissSkier ($74.57 in chips) 
Seat 4: ruQx01 ($50 in chips) 
Seat 5: UPERAD ($49 in chips) 
Seat 7: bigned1975 ($60.23 in chips) 
Seat 8: oudine2 ($53.31 in chips) 
Seat 9: leooooon79 ($13.78 in chips) 
bigned1975: posts small blind $0.25
oudine2: posts big blind $0.50
*** HOLE CARDS ***
leooooon79: calls $0.50
Corlogiro: folds 
Pachebrash: folds 
SwissSkier: folds 
ruQx01: folds 
UPERAD: folds 
bigned1975: folds 
oudine2: checks 
*** FLOP *** [Kc Qc 7c]
oudine2: checks 
leooooon79: checks 
*** TURN *** [Kc Qc 7c] [5c]
oudine2: checks 
leooooon79: bets $0.59
oudine2: folds 
Uncalled bet ($0.59) returned to leooooon79
leooooon79 collected $1.19 from pot
leooooon79: doesn't show hand 
*** SUMMARY ***
Total pot $1.25 | Rake $0.06 
Board [Kc Qc 7c 5c]
Seat 1: Corlogiro folded before Flop (didn't bet)
Seat 2: Pachebrash folded before Flop (didn't bet)
Seat 3: SwissSkier folded before Flop (didn't bet)
Seat 4: ruQx01 folded before Flop (didn't bet)
Seat 5: UPERAD (button) folded before Flop (didn't bet)
Seat 7: bigned1975 (small blind) folded before Flop
Seat 8: oudine2 (big blind) folded on the Turn
Seat 9: leooooon79 collected ($1.19)



PokerStars Hand #228691192957:  Hold'em No Limit ($0.25/$0.50 USD) - 2021/07/30 18:06:07 ET
Table 'Aitne III' 9-max Seat #7 is the button
Seat 1: Corlogiro ($50 in chips) 
Seat 2: Pachebrash ($105.62 in chips) 
Seat 3: SwissSkier ($74.57 in chips) 
Seat 4: ruQx01 ($50 in chips) 
Seat 5: UPERAD ($49 in chips) 
Seat 7: bigned1975 ($59.98 in chips) 
Seat 8: oudine2 ($52.81 in chips) 
Seat 9: leooooon79 ($14.47 in chips) 
oudine2: posts small blind $0.25
leooooon79: posts big blind $0.50
*** HOLE CARDS ***
Corlogiro: folds 
Pachebrash: folds 
SwissSkier: folds 
ruQx01: folds 
UPERAD: folds 
bigned1975: folds 
oudine2: folds 
Uncalled bet ($0.25) returned to leooooon79
leooooon79 collected $0.50 from pot
leooooon79: doesn't show hand 
*** SUMMARY ***
Total pot $0.50 | Rake $0 
Seat 1: Corlogiro folded before Flop (didn't bet)
Seat 2: Pachebrash folded before Flop (didn't bet)
Seat 3: SwissSkier folded before Flop (didn't bet)
Seat 4: ruQx01 folded before Flop (didn't bet)
Seat 5: UPERAD folded before Flop (didn't bet)
Seat 7: bigned1975 (button) folded before Flop (didn't bet)
Seat 8: oudine2 (small blind) folded before Flop
Seat 9: leooooon79 (big blind) collected ($0.50)



PokerStars Hand #228691204339:  Hold'em No Limit ($0.25/$0.50 USD) - 2021/07/30 18:06:34 ET
Table 'Aitne III' 9-max Seat #8 is the button
Seat 1: Corlogiro ($50 in chips) 
Seat 2: Pachebrash ($105.62 in chips) 
Seat 3: SwissSkier ($74.57 in chips) 
Seat 4: ruQx01 ($50 in chips) 
Seat 5: UPERAD ($49 in chips) 
Seat 7: bigned1975 ($59.98 in chips) 
Seat 8: oudine2 ($52.56 in chips) 
Seat 9: leooooon79 ($14.72 in chips) 
leooooon79: posts small blind $0.25
Corlogiro: posts big blind $0.50
*** HOLE CARDS ***
Pachebrash: folds 
SwissSkier: folds 
ruQx01: folds 
UPERAD: folds 
bigned1975: raises $1 to $1.50
oudine2: folds 
leooooon79: calls $1.25
Corlogiro: calls $1
*** FLOP *** [Ac 9h 3c]
leooooon79: checks 
Corlogiro: checks 
bigned1975: bets $3
leooooon79: folds 
Corlogiro: folds 
Uncalled bet ($3) returned to bigned1975
bigned1975 collected $4.28 from pot
bigned1975: doesn't show hand 
*** SUMMARY ***
Total pot $4.50 | Rake $0.22 
Board [Ac 9h 3c]
Seat 1: Corlogiro (big blind) folded on the Flop
Seat 2: Pachebrash folded before Flop (didn't bet)
Seat 3: SwissSkier folded before Flop (didn't bet)
Seat 4: ruQx01 folded before Flop (didn't bet)
Seat 5: UPERAD folded before Flop (didn't bet)
Seat 7: bigned1975 collected ($4.28)
Seat 8: oudine2 (button) folded before Flop (didn't bet)
Seat 9: leooooon79 (small blind) folded on the Flop



PokerStars Hand #228691229028:  Hold'em No Limit ($0.25/$0.50 USD) - 2021/07/30 18:07:33 ET
Table 'Aitne III' 9-max Seat #9 is the button
Seat 1: Corlogiro ($50 in chips) 
Seat 2: Pachebrash ($105.62 in chips) 
Seat 3: SwissSkier ($74.57 in chips) 
Seat 4: ruQx01 ($50 in chips) 
Seat 5: UPERAD ($49 in chips) 
Seat 7: bigned1975 ($62.76 in chips) 
Seat 8: oudine2 ($52.56 in chips) 
Seat 9: leooooon79 ($13.22 in chips) 
Corlogiro: posts small blind $0.25
Pachebrash: posts big blind $0.50
*** HOLE CARDS ***
SwissSkier: raises $1 to $1.50
ruQx01: folds 
UPERAD: folds 
bigned1975: folds 
oudine2: folds 
leooooon79: folds 
Corlogiro: folds 
Pachebrash: folds 
Uncalled bet ($1) returned to SwissSkier
SwissSkier collected $1.25 from pot
*** SUMMARY ***
Total pot $1.25 | Rake $0 
Seat 1: Corlogiro (small blind) folded before Flop
Seat 2: Pachebrash (big blind) folded before Flop
Seat 3: SwissSkier collected ($1.25)
Seat 4: ruQx01 folded before Flop (didn't bet)
Seat 5: UPERAD folded before Flop (didn't bet)
Seat 7: bigned1975 folded before Flop (didn't bet)
Seat 8: oudine2 folded before Flop (didn't bet)
Seat 9: leooooon79 (button) folded before Flop (didn't bet)



PokerStars Hand #228691245154:  Hold'em No Limit ($0.25/$0.50 USD) - 2021/07/30 18:07:54 ET
Table 'Aitne III' 9-max Seat #1 is the button
Seat 1: Corlogiro ($50 in chips) 
Seat 2: Pachebrash ($105.12 in chips) 
Seat 3: SwissSkier ($75.32 in chips) 
Seat 4: ruQx01 ($50 in chips) 
Seat 5: UPERAD ($49 in chips) 
Seat 7: bigned1975 ($62.76 in chips) 
Seat 8: oudine2 ($52.56 in chips) 
Seat 9: leooooon79 ($13.22 in chips) 
Pachebrash: posts small blind $0.25
SwissSkier: posts big blind $0.50
*** HOLE CARDS ***
ruQx01: folds 
UPERAD: folds 
bigned1975: folds 
oudine2: raises $1 to $1.50
leooooon79: calls $1.50
Corlogiro: folds 
Pachebrash: raises $5 to $6.50
SwissSkier: folds 
oudine2: folds 
leooooon79: folds 
Uncalled bet ($5) returned to Pachebrash
Pachebrash collected $5 from pot
Pachebrash: doesn't show hand 
*** SUMMARY ***
Total pot $5 | Rake $0 
Seat 1: Corlogiro (button) folded before Flop (didn't bet)
Seat 2: Pachebrash (small blind) collected ($5)
Seat 3: SwissSkier (big blind) folded before Flop
Seat 4: ruQx01 folded before Flop (didn't bet)
Seat 5: UPERAD folded before Flop (didn't bet)
Seat 7: bigned1975 folded before Flop (didn't bet)
Seat 8: oudine2 folded before Flop
Seat 9: leooooon79 folded before Flop



PokerStars Hand #228691262268:  Hold'em No Limit ($0.25/$0.50 USD) - 2021/07/30 18:08:34 ET
Table 'Aitne III' 9-max Seat #2 is the button
Seat 1: Corlogiro ($50 in chips) 
Seat 2: Pachebrash ($108.62 in chips) 
Seat 3: SwissSkier ($74.82 in chips) 
Seat 4: ruQx01 ($50 in chips) 
Seat 5: UPERAD ($49 in chips) 
Seat 6: Kahmi3105 ($279.97 in chips) 
Seat 7: bigned1975 ($62.76 in chips) 
Seat 8: oudine2 ($51.06 in chips) 
Seat 9: leooooon79 ($11.72 in chips) 
SwissSkier: posts small blind $0.25
ruQx01: posts big blind $0.50
Kahmi3105: posts small blind $0.25
*** HOLE CARDS ***
UPERAD: folds 
Kahmi3105: raises $1.50 to $2
bigned1975: raises $4 to $6
oudine2: folds 
leooooon79: folds 
Corlogiro: folds 
Pachebrash: folds 
SwissSkier: folds 
ruQx01: folds 
Kahmi3105: calls $4
*** FLOP *** [Ac 7c 9c]
Kahmi3105: checks 
bigned1975: checks 
*** TURN *** [Ac 7c 9c] [Qc]
Kahmi3105: checks 
bigned1975: checks 
*** RIVER *** [Ac 7c 9c Qc] [2h]
Kahmi3105: checks 
bigned1975: checks 
*** SHOW DOWN ***
Kahmi3105: shows [5h 5c] (a flush, Ace high)
bigned1975: mucks hand 
Kahmi3105 collected $12.19 from pot
*** SUMMARY ***
Total pot $13 | Rake $0.81 
Board [Ac 7c 9c Qc 2h]
Seat 1: Corlogiro folded before Flop (didn't bet)
Seat 2: Pachebrash (button) folded before Flop (didn't bet)
Seat 3: SwissSkier (small blind) folded before Flop
Seat 4: ruQx01 (big blind) folded before Flop
Seat 5: UPERAD folded before Flop (didn't bet)
Seat 6: Kahmi3105 showed [5h 5c] and won ($12.19) with a flush, Ace high
Seat 7: bigned1975 mucked
Seat 8: oudine2 folded before Flop (didn't bet)
Seat 9: leooooon79 folded before Flop (didn't bet)



PokerStars Hand #228691282273:  Hold'em No Limit ($0.25/$0.50 USD) - 2021/07/30 18:09:22 ET
Table 'Aitne III' 9-max Seat #3 is the button
Seat 1: Corlogiro ($50 in chips) 
Seat 2: Pachebrash ($108.62 in chips) 
Seat 3: SwissSkier ($74.57 in chips) 
Seat 4: ruQx01 ($50 in chips) 
Seat 5: UPERAD ($49 in chips) 
Seat 6: Kahmi3105 ($285.91 in chips) 
Seat 7: bigned1975 ($56.76 in chips) 
Seat 8: oudine2 ($51.06 in chips) 
Seat 9: leooooon79 ($11.72 in chips) 
ruQx01: posts small blind $0.25
UPERAD: posts big blind $0.50
*** HOLE CARDS ***
Kahmi3105: folds 
bigned1975: raises $1 to $1.50
oudine2: folds 
leooooon79: folds 
Corlogiro: folds 
Pachebrash: folds 
SwissSkier: folds 
ruQx01: folds 
UPERAD: folds 
Uncalled bet ($1) returned to bigned1975
bigned1975 collected $1.25 from pot
bigned1975: doesn't show hand 
*** SUMMARY ***
Total pot $1.25 | Rake $0 
Seat 1: Corlogiro folded before Flop (didn't bet)
Seat 2: Pachebrash folded before Flop (didn't bet)
Seat 3: SwissSkier (button) folded before Flop (didn't bet)
Seat 4: ruQx01 (small blind) folded before Flop
Seat 5: UPERAD (big blind) folded before Flop
Seat 6: Kahmi3105 folded before Flop (didn't bet)
Seat 7: bigned1975 collected ($1.25)
Seat 8: oudine2 folded before Flop (didn't bet)
Seat 9: leooooon79 folded before Flop (didn't bet)



PokerStars Hand #228691294942:  Hold'em No Limit ($0.25/$0.50 USD) - 2021/07/30 18:09:52 ET
Table 'Aitne III' 9-max Seat #4 is the button
Seat 1: Corlogiro ($50 in chips) 
Seat 2: Pachebrash ($108.62 in chips) 
Seat 3: SwissSkier ($74.57 in chips) 
Seat 4: ruQx01 ($50 in chips) 
Seat 5: UPERAD ($48.50 in chips) 
Seat 6: Kahmi3105 ($285.91 in chips) 
Seat 7: bigned1975 ($57.51 in chips) 
Seat 8: oudine2 ($51.06 in chips) 
Seat 9: leooooon79 ($11.72 in chips) 
UPERAD: posts small blind $0.25
Kahmi3105: posts big blind $0.50
*** HOLE CARDS ***
bigned1975: raises $1 to $1.50
oudine2: calls $1.50
leooooon79: folds 
Corlogiro: folds 
Pachebrash: folds 
SwissSkier: raises $2 to $3.50
ruQx01: folds 
UPERAD: folds 
Kahmi3105: folds 
bigned1975: calls $2
oudine2: calls $2
*** FLOP *** [4d 7h 9s]
bigned1975: checks 
oudine2: checks 
SwissSkier: checks 
*** TURN *** [4d 7h 9s] [Jd]
bigned1975: bets $6
oudine2: calls $6
SwissSkier: calls $6
*** RIVER *** [4d 7h 9s Jd] [Ks]
bigned1975: checks 
oudine2: bets $13.90
SwissSkier: folds 
bigned1975 is disconnected 
bigned1975 has timed out while disconnected
bigned1975: folds 
Uncalled bet ($13.90) returned to oudine2
oudine2 collected $27.79 from pot
oudine2: doesn't show hand 
*** SUMMARY ***
Total pot $29.25 | Rake $1.46 
Board [4d 7h 9s Jd Ks]
Seat 1: Corlogiro folded before Flop (didn't bet)
Seat 2: Pachebrash folded before Flop (didn't bet)
Seat 3: SwissSkier folded on the River
Seat 4: ruQx01 (button) folded before Flop (didn't bet)
Seat 5: UPERAD (small blind) folded before Flop
Seat 6: Kahmi3105 (big blind) folded before Flop
Seat 7: bigned1975 folded on the River
Seat 8: oudine2 collected ($27.79)
Seat 9: leooooon79 folded before Flop (didn't bet)



PokerStars Hand #228691446958:  Hold'em No Limit ($0.25/$0.50 USD) - 2021/07/30 18:16:02 ET
Table 'Aitne III' 9-max Seat #5 is the button
Seat 1: Corlogiro ($50 in chips) 
Seat 2: Pachebrash ($108.62 in chips) 
Seat 3: SwissSkier ($65.07 in chips) 
Seat 4: ruQx01 ($50 in chips) 
Seat 5: UPERAD ($48.25 in chips) 
Seat 6: Kahmi3105 ($285.41 in chips) 
Seat 8: oudine2 ($69.35 in chips) 
Seat 9: leooooon79 ($11.72 in chips) 
Kahmi3105: posts small blind $0.25
oudine2: posts big blind $0.50
*** HOLE CARDS ***
leooooon79: calls $0.50
Corlogiro: folds 
Pachebrash: folds 
SwissSkier: folds 
ruQx01: raises $1.50 to $2
UPERAD: folds 
Kahmi3105: folds 
oudine2: folds 
leooooon79: calls $1.50
*** FLOP *** [6h Kd 2s]
leooooon79: checks 
ruQx01: bets $2.26
leooooon79: folds 
Uncalled bet ($2.26) returned to ruQx01
ruQx01 collected $4.51 from pot
ruQx01: doesn't show hand 
*** SUMMARY ***
Total pot $4.75 | Rake $0.24 
Board [6h Kd 2s]
Seat 1: Corlogiro folded before Flop (didn't bet)
Seat 2: Pachebrash folded before Flop (didn't bet)
Seat 3: SwissSkier folded before Flop (didn't bet)
Seat 4: ruQx01 collected ($4.51)
Seat 5: UPERAD (button) folded before Flop (didn't bet)
Seat 6: Kahmi3105 (small blind) folded before Flop
Seat 8: oudine2 (big blind) folded before Flop
Seat 9: leooooon79 folded on the Flop



PokerStars Hand #228691465154:  Hold'em No Limit ($0.25/$0.50 USD) - 2021/07/30 18:16:46 ET
Table 'Aitne III' 9-max Seat #6 is the button
Seat 1: Corlogiro ($50 in chips) 
Seat 2: Pachebrash ($108.62 in chips) 
Seat 3: SwissSkier ($65.07 in chips) 
Seat 4: ruQx01 ($52.51 in chips) 
Seat 5: UPERAD ($48.25 in chips) 
Seat 6: Kahmi3105 ($285.16 in chips) 
Seat 8: oudine2 ($68.85 in chips) 
Seat 9: leooooon79 ($9.72 in chips) 
oudine2: posts small blind $0.25
leooooon79: posts big blind $0.50
*** HOLE CARDS ***
Corlogiro: folds 
Pachebrash: folds 
SwissSkier: folds 
ruQx01: raises $0.63 to $1.13
UPERAD: folds 
Kahmi3105: calls $1.13
oudine2: folds 
leooooon79: calls $0.63
*** FLOP *** [7s 5d Jd]
leooooon79: checks 
ruQx01: checks 
Kahmi3105: bets $3.46
leooooon79: folds 
ruQx01: folds 
Uncalled bet ($3.46) returned to Kahmi3105
Kahmi3105 collected $3.42 from pot
*** SUMMARY ***
Total pot $3.64 | Rake $0.22 
Board [7s 5d Jd]
Seat 1: Corlogiro folded before Flop (didn't bet)
Seat 2: Pachebrash folded before Flop (didn't bet)
Seat 3: SwissSkier folded before Flop (didn't bet)
Seat 4: ruQx01 folded on the Flop
Seat 5: UPERAD folded before Flop (didn't bet)
Seat 6: Kahmi3105 (button) collected ($3.42)
Seat 8: oudine2 (small blind) folded before Flop
Seat 9: leooooon79 (big blind) folded on the Flop



PokerStars Hand #228691485870:  Hold'em No Limit ($0.25/$0.50 USD) - 2021/07/30 18:17:37 ET
Table 'Aitne III' 9-max Seat #8 is the button
Seat 1: Corlogiro ($50 in chips) 
Seat 2: Pachebrash ($108.62 in chips) 
Seat 3: SwissSkier ($65.07 in chips) 
Seat 4: ruQx01 ($51.38 in chips) 
Seat 5: UPERAD ($48.25 in chips) 
Seat 6: Kahmi3105 ($287.45 in chips) 
Seat 8: oudine2 ($68.60 in chips) 
Seat 9: leooooon79 ($8.59 in chips) 
leooooon79: posts small blind $0.25
Corlogiro: posts big blind $0.50
*** HOLE CARDS ***
Pachebrash: folds 
SwissSkier: folds 
ruQx01: folds 
UPERAD: raises $1 to $1.50
Kahmi3105: folds 
oudine2: folds 
leooooon79: folds 
Corlogiro: folds 
Uncalled bet ($1) returned to UPERAD
UPERAD collected $1.25 from pot
UPERAD: doesn't show hand 
*** SUMMARY ***
Total pot $1.25 | Rake $0 
Seat 1: Corlogiro (big blind) folded before Flop
Seat 2: Pachebrash folded before Flop (didn't bet)
Seat 3: SwissSkier folded before Flop (didn't bet)
Seat 4: ruQx01 folded before Flop (didn't bet)
Seat 5: UPERAD collected ($1.25)
Seat 6: Kahmi3105 folded before Flop (didn't bet)
Seat 8: oudine2 (button) folded before Flop (didn't bet)
Seat 9: leooooon79 (small blind) folded before Flop



PokerStars Hand #228691492573:  Hold'em No Limit ($0.25/$0.50 USD) - 2021/07/30 18:17:53 ET
Table 'Aitne III' 9-max Seat #9 is the button
Seat 1: Corlogiro ($50 in chips) 
Seat 2: Pachebrash ($108.62 in chips) 
Seat 3: SwissSkier ($65.07 in chips) 
Seat 4: ruQx01 ($51.38 in chips) 
Seat 5: UPERAD ($49 in chips) 
Seat 6: Kahmi3105 ($287.45 in chips) 
Seat 8: oudine2 ($68.60 in chips) 
Seat 9: leooooon79 ($8.34 in chips) 
Corlogiro: posts small blind $0.25
Pachebrash: posts big blind $0.50
*** HOLE CARDS ***
SwissSkier: raises $0.50 to $1
ruQx01: folds 
UPERAD: folds 
Kahmi3105: raises $2.75 to $3.75
oudine2: folds 
leooooon79: folds 
Corlogiro: folds 
Pachebrash: folds 
SwissSkier: calls $2.75
*** FLOP *** [9h Ah As]
SwissSkier: checks 
Kahmi3105: bets $4
SwissSkier: folds 
Uncalled bet ($4) returned to Kahmi3105
Kahmi3105 collected $7.74 from pot
*** SUMMARY ***
Total pot $8.25 | Rake $0.51 
Board [9h Ah As]
Seat 1: Corlogiro (small blind) folded before Flop
Seat 2: Pachebrash (big blind) folded before Flop
Seat 3: SwissSkier folded on the Flop
Seat 4: ruQx01 folded before Flop (didn't bet)
Seat 5: UPERAD folded before Flop (didn't bet)
Seat 6: Kahmi3105 collected ($7.74)
Seat 8: oudine2 folded before Flop (didn't bet)
Seat 9: leooooon79 (button) folded before Flop (didn't bet)



PokerStars Hand #228691504859:  Hold'em No Limit ($0.25/$0.50 USD) - 2021/07/30 18:18:24 ET
Table 'Aitne III' 9-max Seat #1 is the button
Seat 1: Corlogiro ($50 in chips) 
Seat 2: Pachebrash ($108.12 in chips) 
Seat 3: SwissSkier ($61.32 in chips) 
Seat 4: ruQx01 ($51.38 in chips) 
Seat 5: UPERAD ($49 in chips) 
Seat 6: Kahmi3105 ($291.44 in chips) 
Seat 8: oudine2 ($68.60 in chips) 
Seat 9: leooooon79 ($8.34 in chips) 
Pachebrash: posts small blind $0.25
SwissSkier: posts big blind $0.50
*** HOLE CARDS ***
ruQx01: folds 
UPERAD: raises $1 to $1.50
Kahmi3105: folds 
oudine2: folds 
leooooon79: folds 
Corlogiro: raises $3 to $4.50
Pachebrash: folds 
SwissSkier: folds 
UPERAD: raises $7.50 to $12
Corlogiro: calls $7.50
*** FLOP *** [7h 9d 4s]
ruQx01 leaves the table
UPERAD: bets $5.88
el Fatto joins the table at seat #4 
Corlogiro: calls $5.88
*** TURN *** [7h 9d 4s] [4d]
UPERAD: checks 
Corlogiro: bets $32.12 and is all-in
UPERAD: calls $31.12 and is all-in
Uncalled bet ($1) returned to Corlogiro
*** FIRST RIVER *** [7h 9d 4s 4d] [3h]
*** SECOND RIVER *** [7h 9d 4s 4d] [2s]
*** FIRST SHOW DOWN ***
UPERAD: shows [As Ah] (two pair, Aces and Fours)
Corlogiro: shows [Kc Kd] (two pair, Kings and Fours)
UPERAD collected $48.38 from pot
*** SECOND SHOW DOWN ***
UPERAD: shows [As Ah] (two pair, Aces and Fours)
Corlogiro: shows [Kc Kd] (two pair, Kings and Fours)
UPERAD collected $48.37 from pot
*** SUMMARY ***
Total pot $98.75 | Rake $2 
Hand was run twice
FIRST Board [7h 9d 4s 4d 3h]
SECOND Board [7h 9d 4s 4d 2s]
Seat 1: Corlogiro (button) showed [Kc Kd] and lost with two pair, Kings and Fours, and lost with two pair, Kings and Fours
Seat 2: Pachebrash (small blind) folded before Flop
Seat 3: SwissSkier (big blind) folded before Flop
Seat 4: ruQx01 folded before Flop (didn't bet)
Seat 5: UPERAD showed [As Ah] and won ($48.38) with two pair, Aces and Fours, and won ($48.37) with two pair, Aces and Fours
Seat 6: Kahmi3105 folded before Flop (didn't bet)
Seat 8: oudine2 folded before Flop (didn't bet)
Seat 9: leooooon79 folded before Flop (didn't bet)



PokerStars Hand #228691533696:  Hold'em No Limit ($0.25/$0.50 USD) - 2021/07/30 18:19:35 ET
Table 'Aitne III' 9-max Seat #2 is the button
Seat 1: Corlogiro ($50 in chips) 
Seat 2: Pachebrash ($107.87 in chips) 
Seat 3: SwissSkier ($60.82 in chips) 
Seat 4: el Fatto ($50 in chips) 
Seat 5: UPERAD ($96.75 in chips) 
Seat 6: Kahmi3105 ($291.44 in chips) 
Seat 8: oudine2 ($68.60 in chips) 
Seat 9: leooooon79 ($8.34 in chips) 
SwissSkier: posts small blind $0.25
el Fatto: posts big blind $0.50
*** HOLE CARDS ***
UPERAD: folds 
Kahmi3105: folds 
oudine2: folds 
leooooon79: folds 
Corlogiro: folds 
Pachebrash: folds 
SwissSkier: raises $1 to $1.50
el Fatto: folds 
Uncalled bet ($1) returned to SwissSkier
SwissSkier collected $1 from pot
*** SUMMARY ***
Total pot $1 | Rake $0 
Seat 1: Corlogiro folded before Flop (didn't bet)
Seat 2: Pachebrash (button) folded before Flop (didn't bet)
Seat 3: SwissSkier (small blind) collected ($1)
Seat 4: el Fatto (big blind) folded before Flop
Seat 5: UPERAD folded before Flop (didn't bet)
Seat 6: Kahmi3105 folded before Flop (didn't bet)
Seat 8: oudine2 folded before Flop (didn't bet)
Seat 9: leooooon79 folded before Flop (didn't bet)



PokerStars Hand #228691542392:  Hold'em No Limit ($0.25/$0.50 USD) - 2021/07/30 18:19:57 ET
Table 'Aitne III' 9-max Seat #3 is the button
Seat 1: Corlogiro ($50 in chips) 
Seat 2: Pachebrash ($107.87 in chips) 
Seat 3: SwissSkier ($61.32 in chips) 
Seat 4: el Fatto ($50 in chips) 
Seat 5: UPERAD ($96.75 in chips) 
Seat 6: Kahmi3105 ($291.44 in chips) 
Seat 8: oudine2 ($68.60 in chips) 
Seat 9: leooooon79 ($8.34 in chips) 
el Fatto: posts small blind $0.25
UPERAD: posts big blind $0.50
*** HOLE CARDS ***
Kahmi3105: folds 
oudine2: folds 
leooooon79: folds 
Corlogiro: folds 
Pachebrash: folds 
SwissSkier: folds 
el Fatto: folds 
Uncalled bet ($0.25) returned to UPERAD
UPERAD collected $0.50 from pot
UPERAD: doesn't show hand 
*** SUMMARY ***
Total pot $0.50 | Rake $0 
Seat 1: Corlogiro folded before Flop (didn't bet)
Seat 2: Pachebrash folded before Flop (didn't bet)
Seat 3: SwissSkier (button) folded before Flop (didn't bet)
Seat 4: el Fatto (small blind) folded before Flop
Seat 5: UPERAD (big blind) collected ($0.50)
Seat 6: Kahmi3105 folded before Flop (didn't bet)
Seat 8: oudine2 folded before Flop (didn't bet)
Seat 9: leooooon79 folded before Flop (didn't bet)



PokerStars Hand #228691548465:  Hold'em No Limit ($0.25/$0.50 USD) - 2021/07/30 18:20:12 ET
Table 'Aitne III' 9-max Seat #4 is the button
Seat 1: Corlogiro ($50 in chips) 
Seat 2: Pachebrash ($107.87 in chips) 
Seat 3: SwissSkier ($61.32 in chips) 
Seat 4: el Fatto ($50 in chips) 
Seat 5: UPERAD ($97 in chips) 
Seat 6: Kahmi3105 ($291.44 in chips) 
Seat 8: oudine2 ($68.60 in chips) 
Seat 9: leooooon79 ($8.34 in chips) 
UPERAD: posts small blind $0.25
Kahmi3105: posts big blind $0.50
*** HOLE CARDS ***
oudine2: folds 
leooooon79: calls $0.50
Corlogiro: folds 
Pachebrash: folds 
SwissSkier: folds 
el Fatto: folds 
UPERAD: calls $0.25
Kahmi3105: checks 
*** FLOP *** [Ah Jc 9d]
UPERAD: checks 
Kahmi3105: checks 
leooooon79: checks 
*** TURN *** [Ah Jc 9d] [7d]
UPERAD: checks 
Kahmi3105: bets $1.42
leooooon79: folds 
UPERAD: folds 
Uncalled bet ($1.42) returned to Kahmi3105
Kahmi3105 collected $1.40 from pot
*** SUMMARY ***
Total pot $1.50 | Rake $0.10 
Board [Ah Jc 9d 7d]
Seat 1: Corlogiro folded before Flop (didn't bet)
Seat 2: Pachebrash folded before Flop (didn't bet)
Seat 3: SwissSkier folded before Flop (didn't bet)
Seat 4: el Fatto (button) folded before Flop (didn't bet)
Seat 5: UPERAD (small blind) folded on the Turn
Seat 6: Kahmi3105 (big blind) collected ($1.40)
Seat 8: oudine2 folded before Flop (didn't bet)
Seat 9: leooooon79 folded on the Turn



PokerStars Hand #228692390578:  Hold'em No Limit ($0.25/$0.50 USD) - 2021/07/30 18:55:30 ET
Table 'Aitne III' 9-max Seat #3 is the button
Seat 1: alexrus18 ($52.01 in chips) 
Seat 2: Pachebrash ($97.53 in chips) 
Seat 3: mazefaka007 ($53.50 in chips) 
Seat 6: Kahmi3105 ($319.17 in chips) 
Kahmi3105: posts small blind $0.25
Popokluev: is sitting out 
galina8383: is sitting out 
alexrus18: posts big blind $0.50
*** HOLE CARDS ***
An1an1 leaves the table
Pachebrash: folds 
galina8383 leaves the table
Popokluev leaves the table
mazefaka007: folds 
Kahmi3105: calls $0.25
alexrus18: raises $1.75 to $2.25
Kahmi3105: calls $1.75
*** FLOP *** [3h 5c Kc]
Kahmi3105: checks 
alexrus18: checks 
*** TURN *** [3h 5c Kc] [3s]
Kahmi3105: checks 
alexrus18: bets $1.41
Kahmi3105: calls $1.41
*** RIVER *** [3h 5c Kc 3s] [Qc]
Kahmi3105: checks 
alexrus18: checks 
*** SHOW DOWN ***
Kahmi3105: shows [Ad 2s] (a pair of Threes)
alexrus18: shows [Ah Qs] (two pair, Queens and Threes)
alexrus18 collected $6.95 from pot
*** SUMMARY ***
Total pot $7.32 | Rake $0.37 
Board [3h 5c Kc 3s Qc]
Seat 1: alexrus18 (big blind) showed [Ah Qs] and won ($6.95) with two pair, Queens and Threes
Seat 2: Pachebrash folded before Flop (didn't bet)
Seat 3: mazefaka007 (button) folded before Flop (didn't bet)
Seat 6: Kahmi3105 (small blind) showed [Ad 2s] and lost with a pair of Threes



PokerStars Hand #228692403222:  Hold'em No Limit ($0.25/$0.50 USD) - 2021/07/30 18:56:13 ET
Table 'Aitne III' 9-max Seat #1 is the button
Seat 1: alexrus18 ($55.30 in chips) 
Seat 6: Kahmi3105 ($315.51 in chips) 
alexrus18: posts small blind $0.25
Pachebrash: is sitting out 
mazefaka007: is sitting out 
Kahmi3105: posts big blind $0.50
*** HOLE CARDS ***
alexrus18: folds 
Uncalled bet ($0.25) returned to Kahmi3105
Kahmi3105 collected $0.50 from pot
*** SUMMARY ***
Total pot $0.50 | Rake $0 
Seat 1: alexrus18 (button) (small blind) folded before Flop
Seat 6: Kahmi3105 (big blind) collected ($0.50)



PokerStars Hand #228692652205:  Hold'em No Limit ($0.25/$0.50 USD) - 2021/07/30 19:07:36 ET
Table 'Aitne III' 9-max Seat #8 is the button
Seat 1: OCBslim44 ($27.83 in chips) 
Seat 2: KerilTheBoss ($62.79 in chips) 
Seat 5: jumbo69 ($44.32 in chips) 
Seat 6: KARANN899 ($48.70 in chips) 
Seat 7: gustguaira ($50.89 in chips) 
Seat 8: goorest777 ($50 in chips) 
Seat 9: BarUnDuck ($19.50 in chips) 
BarUnDuck: posts small blind $0.25
OCBslim44: posts big blind $0.50
chekita1965: sits out 
*** HOLE CARDS ***
KerilTheBoss: folds 
jumbo69: raises $0.68 to $1.18
KARANN899: folds 
gustguaira: calls $1.18
goorest777: folds 
BarUnDuck: folds 
OCBslim44: folds 
*** FLOP *** [6d 7s 9d]
mazefaka007 leaves the table
jumbo69: bets $1.03
gustguaira: calls $1.03
*** TURN *** [6d 7s 9d] [Ad]
UPERAD joins the table at seat #3 
jumbo69: bets $2.46
gustguaira: calls $2.46
*** RIVER *** [6d 7s 9d Ad] [Th]
jumbo69: checks 
gustguaira: checks 
*** SHOW DOWN ***
jumbo69: shows [6h 6s] (three of a kind, Sixes)
gustguaira: mucks hand 
jumbo69 collected $9.59 from pot
*** SUMMARY ***
Total pot $10.09 | Rake $0.50 
Board [6d 7s 9d Ad Th]
Seat 1: OCBslim44 (big blind) folded before Flop
Seat 2: KerilTheBoss folded before Flop (didn't bet)
Seat 5: jumbo69 showed [6h 6s] and won ($9.59) with three of a kind, Sixes
Seat 6: KARANN899 folded before Flop (didn't bet)
Seat 7: gustguaira mucked
Seat 8: goorest777 (button) folded before Flop (didn't bet)
Seat 9: BarUnDuck (small blind) folded before Flop



PokerStars Hand #228692667095:  Hold'em No Limit ($0.25/$0.50 USD) - 2021/07/30 19:08:18 ET
Table 'Aitne III' 9-max Seat #9 is the button
Seat 1: OCBslim44 ($27.33 in chips) 
Seat 4: chekita1965 ($50 in chips) 
Seat 5: jumbo69 ($49.24 in chips) 
Seat 6: KARANN899 ($48.70 in chips) 
Seat 7: gustguaira ($46.22 in chips) 
Seat 8: goorest777 ($50 in chips) 
Seat 9: BarUnDuck ($20 in chips) 
OCBslim44: posts small blind $0.25
KerilTheBoss: is sitting out 
chekita1965: posts big blind $0.50
*** HOLE CARDS ***
KerilTheBoss leaves the table
UPERAD leaves the table
jumbo69: raises $0.68 to $1.18
KARANN899: folds 
gustguaira: folds 
goorest777: folds 
BarUnDuck: folds 
OCBslim44: calls $0.93
chekita1965: calls $0.68
*** FLOP *** [9h Kc Js]
OCBslim44: bets $3.36
ms1272 joins the table at seat #2 
chekita1965: calls $3.36
jumbo69: folds 
*** TURN *** [9h Kc Js] [6c]
OCBslim44: bets $9.75
chekita1965: folds 
Uncalled bet ($9.75) returned to OCBslim44
OCBslim44 collected $9.75 from pot
OCBslim44: doesn't show hand 
*** SUMMARY ***
Total pot $10.26 | Rake $0.51 
Board [9h Kc Js 6c]
Seat 1: OCBslim44 (small blind) collected ($9.75)
Seat 4: chekita1965 (big blind) folded on the Turn
Seat 5: jumbo69 folded on the Flop
Seat 6: KARANN899 folded before Flop (didn't bet)
Seat 7: gustguaira folded before Flop (didn't bet)
Seat 8: goorest777 folded before Flop (didn't bet)
Seat 9: BarUnDuck (button) folded before Flop (didn't bet)



PokerStars Hand #228692686422:  Hold'em No Limit ($0.25/$0.50 USD) - 2021/07/30 19:09:11 ET
Table 'Aitne III' 9-max Seat #1 is the button
Seat 1: OCBslim44 ($32.54 in chips) 
Seat 4: chekita1965 ($45.46 in chips) 
Seat 5: jumbo69 ($48.06 in chips) 
Seat 6: KARANN899 ($48.70 in chips) 
Seat 7: gustguaira ($46.22 in chips) 
Seat 8: goorest777 ($50 in chips) 
Seat 9: BarUnDuck ($20 in chips) 
chekita1965: posts small blind $0.25
jumbo69: posts big blind $0.50
*** HOLE CARDS ***
KARANN899: folds 
gustguaira: folds 
goorest777: raises $1 to $1.50
BarUnDuck: folds 
OCBslim44: folds 
chekita1965: calls $1.25
jumbo69: calls $1
*** FLOP *** [7d Qh 9h]
chekita1965: bets $2.14
jumbo69: calls $2.14
goorest777: folds 
*** TURN *** [7d Qh 9h] [7s]
chekita1965: bets $4.17
jumbo69: calls $4.17
*** RIVER *** [7d Qh 9h 7s] [Jd]
chekita1965: bets $8.13
jumbo69: calls $8.13
*** SHOW DOWN ***
chekita1965: shows [9d Ks] (two pair, Nines and Sevens)
jumbo69: shows [Qc As] (two pair, Queens and Sevens)
jumbo69 collected $31.71 from pot
*** SUMMARY ***
Total pot $33.38 | Rake $1.67 
Board [7d Qh 9h 7s Jd]
Seat 1: OCBslim44 (button) folded before Flop (didn't bet)
Seat 4: chekita1965 (small blind) showed [9d Ks] and lost with two pair, Nines and Sevens
Seat 5: jumbo69 (big blind) showed [Qc As] and won ($31.71) with two pair, Queens and Sevens
Seat 6: KARANN899 folded before Flop (didn't bet)
Seat 7: gustguaira folded before Flop (didn't bet)
Seat 8: goorest777 folded on the Flop
Seat 9: BarUnDuck folded before Flop (didn't bet)



PokerStars Hand #228692704207:  Hold'em No Limit ($0.25/$0.50 USD) - 2021/07/30 19:10:01 ET
Table 'Aitne III' 9-max Seat #4 is the button
Seat 1: OCBslim44 ($32.54 in chips) 
Seat 2: ms1272 ($50 in chips) 
Seat 4: chekita1965 ($29.52 in chips) 
Seat 5: jumbo69 ($63.83 in chips) 
Seat 6: KARANN899 ($48.70 in chips) 
Seat 7: gustguaira ($46.22 in chips) 
Seat 8: goorest777 ($50 in chips) 
Seat 9: BarUnDuck ($20 in chips) 
jumbo69: posts small blind $0.25
KARANN899: posts big blind $0.50
ms1272: posts big blind $0.50
*** HOLE CARDS ***
gustguaira: folds 
goorest777: folds 
BarUnDuck: raises $0.50 to $1
OCBslim44: folds 
ms1272: calls $0.50
chekita1965: raises $28.52 to $29.52 and is all-in
jumbo69: folds 
KARANN899: folds 
BarUnDuck: folds 
ms1272: folds 
Uncalled bet ($28.52) returned to chekita1965
chekita1965 collected $3.75 from pot
chekita1965: doesn't show hand 
*** SUMMARY ***
Total pot $3.75 | Rake $0 
Seat 1: OCBslim44 folded before Flop (didn't bet)
Seat 2: ms1272 folded before Flop
Seat 4: chekita1965 (button) collected ($3.75)
Seat 5: jumbo69 (small blind) folded before Flop
Seat 6: KARANN899 (big blind) folded before Flop
Seat 7: gustguaira folded before Flop (didn't bet)
Seat 8: goorest777 folded before Flop (didn't bet)
Seat 9: BarUnDuck folded before Flop



PokerStars Hand #228692865858:  Hold'em No Limit ($0.25/$0.50 USD) - 2021/07/30 19:17:39 ET
Table 'Aitne III' 9-max Seat #2 is the button
Seat 1: GDOF68 ($50 in chips) 
Seat 2: ms1272 ($66.83 in chips) 
Seat 3: BollyMith ($27.48 in chips) 
Seat 4: chekita1965 ($50 in chips) 
Seat 5: Sadyhov V.V. ($51.98 in chips) 
Seat 6: KARANN899 ($50 in chips) 
Seat 7: gustguaira ($49.68 in chips) 
Seat 8: PanicJX ($49.25 in chips) 
Seat 9: BarUnDuck ($20 in chips) 
BollyMith: posts small blind $0.25
chekita1965: posts big blind $0.50
*** HOLE CARDS ***
Sadyhov V.V.: folds 
KARANN899: folds 
gustguaira: folds 
PanicJX: folds 
BarUnDuck: folds 
GDOF68: folds 
ms1272: raises $0.50 to $1
BollyMith: calls $0.75
Sadyhov V.V. leaves the table
chekita1965: calls $0.50
*** FLOP *** [8c 4c 2d]
BollyMith: checks 
Dragonclawss joins the table at seat #5 
chekita1965: checks 
ms1272: checks 
*** TURN *** [8c 4c 2d] [7s]
BollyMith: checks 
chekita1965: bets $2.85
ms1272: folds 
BollyMith: folds 
Uncalled bet ($2.85) returned to chekita1965
chekita1965 collected $2.85 from pot
chekita1965: doesn't show hand 
*** SUMMARY ***
Total pot $3 | Rake $0.15 
Board [8c 4c 2d 7s]
Seat 1: GDOF68 folded before Flop (didn't bet)
Seat 2: ms1272 (button) folded on the Turn
Seat 3: BollyMith (small blind) folded on the Turn
Seat 4: chekita1965 (big blind) collected ($2.85)
Seat 5: Sadyhov V.V. folded before Flop (didn't bet)
Seat 6: KARANN899 folded before Flop (didn't bet)
Seat 7: gustguaira folded before Flop (didn't bet)
Seat 8: PanicJX folded before Flop (didn't bet)
Seat 9: BarUnDuck folded before Flop (didn't bet)



PokerStars Hand #228692878141:  Hold'em No Limit ($0.25/$0.50 USD) - 2021/07/30 19:18:14 ET
Table 'Aitne III' 9-max Seat #3 is the button
Seat 1: GDOF68 ($50 in chips) 
Seat 2: ms1272 ($65.83 in chips) 
Seat 3: BollyMith ($26.48 in chips) 
Seat 4: chekita1965 ($51.85 in chips) 
Seat 5: Dragonclawss ($50 in chips) 
Seat 6: KARANN899 ($50 in chips) 
Seat 7: gustguaira ($49.68 in chips) 
Seat 8: PanicJX ($49.25 in chips) 
Seat 9: BarUnDuck ($20 in chips) 
chekita1965: posts small blind $0.25
Dragonclawss: posts big blind $0.50
*** HOLE CARDS ***
KARANN899: folds 
gustguaira: folds 
PanicJX: folds 
BarUnDuck: raises $0.50 to $1
GDOF68: folds 
ms1272: folds 
BollyMith: calls $1
chekita1965: folds 
Dragonclawss: folds 
*** FLOP *** [4d 3c 7c]
BarUnDuck: checks 
BollyMith: bets $1.44
BarUnDuck: folds 
Uncalled bet ($1.44) returned to BollyMith
BollyMith collected $2.61 from pot
BollyMith: doesn't show hand 
*** SUMMARY ***
Total pot $2.75 | Rake $0.14 
Board [4d 3c 7c]
Seat 1: GDOF68 folded before Flop (didn't bet)
Seat 2: ms1272 folded before Flop (didn't bet)
Seat 3: BollyMith (button) collected ($2.61)
Seat 4: chekita1965 (small blind) folded before Flop
Seat 5: Dragonclawss (big blind) folded before Flop
Seat 6: KARANN899 folded before Flop (didn't bet)
Seat 7: gustguaira folded before Flop (didn't bet)
Seat 8: PanicJX folded before Flop (didn't bet)
Seat 9: BarUnDuck folded on the Flop



PokerStars Hand #228692892219:  Hold'em No Limit ($0.25/$0.50 USD) - 2021/07/30 19:18:55 ET
Table 'Aitne III' 9-max Seat #4 is the button
Seat 1: GDOF68 ($50 in chips) 
Seat 2: ms1272 ($65.83 in chips) 
Seat 3: BollyMith ($28.09 in chips) 
Seat 4: chekita1965 ($51.60 in chips) 
Seat 5: Dragonclawss ($50 in chips) 
Seat 6: KARANN899 ($50 in chips) 
Seat 7: gustguaira ($49.68 in chips) 
Seat 8: PanicJX ($49.25 in chips) 
Seat 9: BarUnDuck ($20 in chips) 
Dragonclawss: posts small blind $0.25
KARANN899: posts big blind $0.50
*** HOLE CARDS ***
gustguaira: folds 
PanicJX: folds 
BarUnDuck: folds 
GDOF68: folds 
ms1272: folds 
BollyMith: folds 
chekita1965: folds 
Dragonclawss: folds 
Uncalled bet ($0.25) returned to KARANN899
KARANN899 collected $0.50 from pot
KARANN899: doesn't show hand 
*** SUMMARY ***
Total pot $0.50 | Rake $0 
Seat 1: GDOF68 folded before Flop (didn't bet)
Seat 2: ms1272 folded before Flop (didn't bet)
Seat 3: BollyMith folded before Flop (didn't bet)
Seat 4: chekita1965 (button) folded before Flop (didn't bet)
Seat 5: Dragonclawss (small blind) folded before Flop
Seat 6: KARANN899 (big blind) collected ($0.50)
Seat 7: gustguaira folded before Flop (didn't bet)
Seat 8: PanicJX folded before Flop (didn't bet)
Seat 9: BarUnDuck folded before Flop (didn't bet)



PokerStars Hand #228692898279:  Hold'em No Limit ($0.25/$0.50 USD) - 2021/07/30 19:19:12 ET
Table 'Aitne III' 9-max Seat #5 is the button
Seat 1: GDOF68 ($50 in chips) 
Seat 2: ms1272 ($65.83 in chips) 
Seat 3: BollyMith ($28.09 in chips) 
Seat 4: chekita1965 ($51.60 in chips) 
Seat 5: Dragonclawss ($50 in chips) 
Seat 6: KARANN899 ($50.25 in chips) 
Seat 7: gustguaira ($49.68 in chips) 
Seat 8: PanicJX ($49.25 in chips) 
Seat 9: BarUnDuck ($20 in chips) 
KARANN899: posts small blind $0.25
gustguaira: posts big blind $0.50
*** HOLE CARDS ***
PanicJX: folds 
BarUnDuck: folds 
GDOF68: folds 
ms1272: folds 
BollyMith: folds 
chekita1965: folds 
Dragonclawss: folds 
KARANN899: raises $1 to $1.50
gustguaira: folds 
Uncalled bet ($1) returned to KARANN899
KARANN899 collected $1 from pot
KARANN899: doesn't show hand 
*** SUMMARY ***
Total pot $1 | Rake $0 
Seat 1: GDOF68 folded before Flop (didn't bet)
Seat 2: ms1272 folded before Flop (didn't bet)
Seat 3: BollyMith folded before Flop (didn't bet)
Seat 4: chekita1965 folded before Flop (didn't bet)
Seat 5: Dragonclawss (button) folded before Flop (didn't bet)
Seat 6: KARANN899 (small blind) collected ($1)
Seat 7: gustguaira (big blind) folded before Flop
Seat 8: PanicJX folded before Flop (didn't bet)
Seat 9: BarUnDuck folded before Flop (didn't bet)



PokerStars Hand #228692905349:  Hold'em No Limit ($0.25/$0.50 USD) - 2021/07/30 19:19:32 ET
Table 'Aitne III' 9-max Seat #6 is the button
Seat 1: GDOF68 ($50 in chips) 
Seat 2: ms1272 ($65.83 in chips) 
Seat 3: BollyMith ($28.09 in chips) 
Seat 4: chekita1965 ($51.60 in chips) 
Seat 5: Dragonclawss ($50 in chips) 
Seat 6: KARANN899 ($50.75 in chips) 
Seat 7: gustguaira ($49.18 in chips) 
Seat 8: PanicJX ($49.25 in chips) 
Seat 9: BarUnDuck ($20 in chips) 
gustguaira: posts small blind $0.25
PanicJX: posts big blind $0.50
*** HOLE CARDS ***
BarUnDuck: raises $0.50 to $1
GDOF68: folds 
ms1272: folds 
BollyMith: folds 
chekita1965: folds 
Dragonclawss: folds 
KARANN899: folds 
gustguaira: folds 
PanicJX: calls $0.50
*** FLOP *** [7c Tc 5d]
PanicJX: checks 
BarUnDuck is disconnected 
BarUnDuck has timed out while disconnected
BarUnDuck: checks 
*** TURN *** [7c Tc 5d] [Th]
PanicJX: bets $2.14
BarUnDuck is connected 
BarUnDuck: calls $2.14
*** RIVER *** [7c Tc 5d Th] [4h]
PanicJX: checks 
BarUnDuck: bets $2.17
PanicJX: raises $6.33 to $8.50
BarUnDuck: folds 
Uncalled bet ($6.33) returned to PanicJX
PanicJX collected $10.33 from pot
PanicJX: doesn't show hand 
*** SUMMARY ***
Total pot $10.87 | Rake $0.54 
Board [7c Tc 5d Th 4h]
Seat 1: GDOF68 folded before Flop (didn't bet)
Seat 2: ms1272 folded before Flop (didn't bet)
Seat 3: BollyMith folded before Flop (didn't bet)
Seat 4: chekita1965 folded before Flop (didn't bet)
Seat 5: Dragonclawss folded before Flop (didn't bet)
Seat 6: KARANN899 (button) folded before Flop (didn't bet)
Seat 7: gustguaira (small blind) folded before Flop
Seat 8: PanicJX (big blind) collected ($10.33)
Seat 9: BarUnDuck folded on the River



PokerStars Hand #228692933438:  Hold'em No Limit ($0.25/$0.50 USD) - 2021/07/30 19:20:53 ET
Table 'Aitne III' 9-max Seat #7 is the button
Seat 1: GDOF68 ($50 in chips) 
Seat 2: ms1272 ($65.83 in chips) 
Seat 3: BollyMith ($28.09 in chips) 
Seat 4: chekita1965 ($51.60 in chips) 
Seat 5: Dragonclawss ($50 in chips) 
Seat 6: KARANN899 ($50.75 in chips) 
Seat 7: gustguaira ($48.93 in chips) 
Seat 8: PanicJX ($54.27 in chips) 
Seat 9: BarUnDuck ($20 in chips) 
PanicJX: posts small blind $0.25
BarUnDuck: posts big blind $0.50
*** HOLE CARDS ***
GDOF68: folds 
ms1272: folds 
BollyMith: raises $0.60 to $1.10
chekita1965: folds 
Dragonclawss: folds 
KARANN899: folds 
gustguaira: calls $1.10
PanicJX: folds 
BarUnDuck: folds 
*** FLOP *** [Qc Jd 9h]
BollyMith: bets $1.54
gustguaira: calls $1.54
*** TURN *** [Qc Jd 9h] [Th]
BollyMith: bets $4.30
gustguaira: calls $4.30
*** RIVER *** [Qc Jd 9h Th] [2d]
BollyMith: checks 
gustguaira: bets $13.90
BollyMith: folds 
Uncalled bet ($13.90) returned to gustguaira
gustguaira collected $13.90 from pot
gustguaira: doesn't show hand 
*** SUMMARY ***
Total pot $14.63 | Rake $0.73 
Board [Qc Jd 9h Th 2d]
Seat 1: GDOF68 folded before Flop (didn't bet)
Seat 2: ms1272 folded before Flop (didn't bet)
Seat 3: BollyMith folded on the River
Seat 4: chekita1965 folded before Flop (didn't bet)
Seat 5: Dragonclawss folded before Flop (didn't bet)
Seat 6: KARANN899 folded before Flop (didn't bet)
Seat 7: gustguaira (button) collected ($13.90)
Seat 8: PanicJX (small blind) folded before Flop
Seat 9: BarUnDuck (big blind) folded before Flop



PokerStars Hand #228693003393:  Hold'em No Limit ($0.25/$0.50 USD) - 2021/07/30 19:24:03 ET
Table 'Aitne III' 9-max Seat #2 is the button
Seat 1: GDOF68 ($50 in chips) 
Seat 2: ms1272 ($64.48 in chips) 
Seat 3: BollyMith ($23.10 in chips) 
Seat 5: Dragonclawss ($50 in chips) 
Seat 6: KARANN899 ($50.75 in chips) 
Seat 8: PanicJX ($57.10 in chips) 
Seat 9: BarUnDuck ($20 in chips) 
BollyMith: posts small blind $0.25
Dragonclawss: posts big blind $0.50
FeersPoker: sits out 
*** HOLE CARDS ***
KARANN899: raises $1 to $1.50
PanicJX: folds 
BarUnDuck: folds 
GDOF68: folds 
ms1272: folds 
BollyMith: folds 
Dragonclawss: folds 
Uncalled bet ($1) returned to KARANN899
KARANN899 collected $1.25 from pot
KARANN899: doesn't show hand 
*** SUMMARY ***
Total pot $1.25 | Rake $0 
Seat 1: GDOF68 folded before Flop (didn't bet)
Seat 2: ms1272 (button) folded before Flop (didn't bet)
Seat 3: BollyMith (small blind) folded before Flop
Seat 5: Dragonclawss (big blind) folded before Flop
Seat 6: KARANN899 collected ($1.25)
Seat 8: PanicJX folded before Flop (didn't bet)
Seat 9: BarUnDuck folded before Flop (didn't bet)



PokerStars Hand #228693008509:  Hold'em No Limit ($0.25/$0.50 USD) - 2021/07/30 19:24:17 ET
Table 'Aitne III' 9-max Seat #3 is the button
Seat 1: GDOF68 ($50 in chips) 
Seat 2: ms1272 ($64.48 in chips) 
Seat 3: BollyMith ($22.85 in chips) 
Seat 5: Dragonclawss ($50 in chips) 
Seat 6: KARANN899 ($51.50 in chips) 
Seat 8: PanicJX ($57.10 in chips) 
Seat 9: BarUnDuck ($20 in chips) 
Dragonclawss: posts small blind $0.25
KARANN899: posts big blind $0.50
FeersPoker: sits out 
*** HOLE CARDS ***
PanicJX: folds 
BarUnDuck: folds 
GDOF68: folds 
ms1272: folds 
BollyMith: folds 
Dragonclawss: folds 
Uncalled bet ($0.25) returned to KARANN899
KARANN899 collected $0.50 from pot
KARANN899: doesn't show hand 
*** SUMMARY ***
Total pot $0.50 | Rake $0 
Seat 1: GDOF68 folded before Flop (didn't bet)
Seat 2: ms1272 folded before Flop (didn't bet)
Seat 3: BollyMith (button) folded before Flop (didn't bet)
Seat 5: Dragonclawss (small blind) folded before Flop
Seat 6: KARANN899 (big blind) collected ($0.50)
Seat 8: PanicJX folded before Flop (didn't bet)
Seat 9: BarUnDuck folded before Flop (didn't bet)



PokerStars Hand #228693013963:  Hold'em No Limit ($0.25/$0.50 USD) - 2021/07/30 19:24:33 ET
Table 'Aitne III' 9-max Seat #5 is the button
Seat 1: GDOF68 ($50 in chips) 
Seat 2: ms1272 ($64.48 in chips) 
Seat 3: BollyMith ($22.85 in chips) 
Seat 5: Dragonclawss ($50 in chips) 
Seat 6: KARANN899 ($51.75 in chips) 
Seat 7: FeersPoker ($50 in chips) 
Seat 8: PanicJX ($57.10 in chips) 
Seat 9: BarUnDuck ($20 in chips) 
KARANN899: posts small blind $0.25
FeersPoker: posts big blind $0.50
*** HOLE CARDS ***
PanicJX: folds 
BarUnDuck: folds 
GDOF68: folds 
ms1272: folds 
BollyMith: raises $0.60 to $1.10
Dragonclawss: folds 
KARANN899: folds 
FeersPoker: folds 
Uncalled bet ($0.60) returned to BollyMith
BollyMith collected $1.25 from pot
*** SUMMARY ***
Total pot $1.25 | Rake $0 
Seat 1: GDOF68 folded before Flop (didn't bet)
Seat 2: ms1272 folded before Flop (didn't bet)
Seat 3: BollyMith collected ($1.25)
Seat 5: Dragonclawss (button) folded before Flop (didn't bet)
Seat 6: KARANN899 (small blind) folded before Flop
Seat 7: FeersPoker (big blind) folded before Flop
Seat 8: PanicJX folded before Flop (didn't bet)
Seat 9: BarUnDuck folded before Flop (didn't bet)



PokerStars Hand #228693021008:  Hold'em No Limit ($0.25/$0.50 USD) - 2021/07/30 19:24:54 ET
Table 'Aitne III' 9-max Seat #6 is the button
Seat 1: GDOF68 ($50 in chips) 
Seat 2: ms1272 ($64.48 in chips) 
Seat 3: BollyMith ($23.60 in chips) 
Seat 5: Dragonclawss ($50 in chips) 
Seat 6: KARANN899 ($51.50 in chips) 
Seat 7: FeersPoker ($50 in chips) 
Seat 8: PanicJX ($57.10 in chips) 
Seat 9: BarUnDuck ($20 in chips) 
FeersPoker: posts small blind $0.25
PanicJX: posts big blind $0.50
*** HOLE CARDS ***
BarUnDuck: folds 
GDOF68: folds 
ms1272: folds 
BollyMith: folds 
Dragonclawss: raises $0.75 to $1.25
KARANN899: folds 
FeersPoker: calls $1
PanicJX: folds 
*** FLOP *** [Jc 4d 3h]
FeersPoker: checks 
Dragonclawss: checks 
*** TURN *** [Jc 4d 3h] [8h]
FeersPoker: bets $0.94
Dragonclawss: folds 
Uncalled bet ($0.94) returned to FeersPoker
FeersPoker collected $2.85 from pot
FeersPoker: doesn't show hand 
*** SUMMARY ***
Total pot $3 | Rake $0.15 
Board [Jc 4d 3h 8h]
Seat 1: GDOF68 folded before Flop (didn't bet)
Seat 2: ms1272 folded before Flop (didn't bet)
Seat 3: BollyMith folded before Flop (didn't bet)
Seat 5: Dragonclawss folded on the Turn
Seat 6: KARANN899 (button) folded before Flop (didn't bet)
Seat 7: FeersPoker (small blind) collected ($2.85)
Seat 8: PanicJX (big blind) folded before Flop
Seat 9: BarUnDuck folded before Flop (didn't bet)



PokerStars Hand #228693034930:  Hold'em No Limit ($0.25/$0.50 USD) - 2021/07/30 19:25:34 ET
Table 'Aitne III' 9-max Seat #7 is the button
Seat 1: GDOF68 ($50 in chips) 
Seat 2: ms1272 ($64.48 in chips) 
Seat 3: BollyMith ($23.60 in chips) 
Seat 5: Dragonclawss ($50 in chips) 
Seat 6: KARANN899 ($51.50 in chips) 
Seat 7: FeersPoker ($51.60 in chips) 
Seat 8: PanicJX ($56.60 in chips) 
Seat 9: BarUnDuck ($20 in chips) 
PanicJX: posts small blind $0.25
BarUnDuck: posts big blind $0.50
*** HOLE CARDS ***
GDOF68: folds 
ms1272: raises $0.50 to $1
BollyMith: folds 
Dragonclawss: folds 
KARANN899: folds 
FeersPoker: folds 
PanicJX: folds 
BarUnDuck: folds 
Uncalled bet ($0.50) returned to ms1272
ms1272 collected $1.25 from pot
ms1272: doesn't show hand 
*** SUMMARY ***
Total pot $1.25 | Rake $0 
Seat 1: GDOF68 folded before Flop (didn't bet)
Seat 2: ms1272 collected ($1.25)
Seat 3: BollyMith folded before Flop (didn't bet)
Seat 5: Dragonclawss folded before Flop (didn't bet)
Seat 6: KARANN899 folded before Flop (didn't bet)
Seat 7: FeersPoker (button) folded before Flop (didn't bet)
Seat 8: PanicJX (small blind) folded before Flop
Seat 9: BarUnDuck (big blind) folded before Flop



PokerStars Hand #228693040351:  Hold'em No Limit ($0.25/$0.50 USD) - 2021/07/30 19:25:50 ET
Table 'Aitne III' 9-max Seat #8 is the button
Seat 1: GDOF68 ($50 in chips) 
Seat 2: ms1272 ($65.23 in chips) 
Seat 3: BollyMith ($23.60 in chips) 
Seat 5: Dragonclawss ($50 in chips) 
Seat 6: KARANN899 ($51.50 in chips) 
Seat 7: FeersPoker ($51.60 in chips) 
Seat 8: PanicJX ($56.35 in chips) 
Seat 9: BarUnDuck ($19.50 in chips) 
BarUnDuck: posts small blind $0.25
GDOF68: posts big blind $0.50
*** HOLE CARDS ***
ms1272: raises $0.50 to $1
BollyMith: folds 
Dragonclawss: folds 
KARANN899: folds 
FeersPoker: calls $1
PanicJX: folds 
BarUnDuck: folds 
GDOF68: folds 
*** FLOP *** [4s 9c Kc]
ms1272: bets $1.30
FeersPoker: raises $2.61 to $3.91
ms1272: folds 
Uncalled bet ($2.61) returned to FeersPoker
FeersPoker collected $5.08 from pot
FeersPoker: doesn't show hand 
*** SUMMARY ***
Total pot $5.35 | Rake $0.27 
Board [4s 9c Kc]
Seat 1: GDOF68 (big blind) folded before Flop
Seat 2: ms1272 folded on the Flop
Seat 3: BollyMith folded before Flop (didn't bet)
Seat 5: Dragonclawss folded before Flop (didn't bet)
Seat 6: KARANN899 folded before Flop (didn't bet)
Seat 7: FeersPoker collected ($5.08)
Seat 8: PanicJX (button) folded before Flop (didn't bet)
Seat 9: BarUnDuck (small blind) folded before Flop



PokerStars Hand #228693051742:  Hold'em No Limit ($0.25/$0.50 USD) - 2021/07/30 19:26:23 ET
Table 'Aitne III' 9-max Seat #9 is the button
Seat 1: GDOF68 ($50 in chips) 
Seat 2: ms1272 ($62.93 in chips) 
Seat 3: BollyMith ($23.60 in chips) 
Seat 5: Dragonclawss ($50 in chips) 
Seat 6: KARANN899 ($51.50 in chips) 
Seat 7: FeersPoker ($54.38 in chips) 
Seat 8: PanicJX ($56.35 in chips) 
Seat 9: BarUnDuck ($20 in chips) 
GDOF68: posts small blind $0.25
ms1272: posts big blind $0.50
*** HOLE CARDS ***
BollyMith: folds 
Dragonclawss: folds 
KARANN899: folds 
FeersPoker: folds 
PanicJX: folds 
BarUnDuck: raises $0.50 to $1
GDOF68: calls $0.75
ms1272: calls $0.50
*** FLOP *** [Kh 2d 7c]
GDOF68: checks 
ms1272: checks 
BarUnDuck: checks 
*** TURN *** [Kh 2d 7c] [As]
GDOF68: checks 
ms1272: checks 
BarUnDuck: bets $1.85
GDOF68: calls $1.85
ms1272: folds 
*** RIVER *** [Kh 2d 7c As] [6h]
GDOF68: checks 
BarUnDuck: bets $4.13
GDOF68: calls $4.13
*** SHOW DOWN ***
BarUnDuck: shows [2h 2c] (three of a kind, Deuces)
GDOF68: mucks hand 
BarUnDuck collected $14.21 from pot
*** SUMMARY ***
Total pot $14.96 | Rake $0.75 
Board [Kh 2d 7c As 6h]
Seat 1: GDOF68 (small blind) mucked
Seat 2: ms1272 (big blind) folded on the Turn
Seat 3: BollyMith folded before Flop (didn't bet)
Seat 5: Dragonclawss folded before Flop (didn't bet)
Seat 6: KARANN899 folded before Flop (didn't bet)
Seat 7: FeersPoker folded before Flop (didn't bet)
Seat 8: PanicJX folded before Flop (didn't bet)
Seat 9: BarUnDuck (button) showed [2h 2c] and won ($14.21) with three of a kind, Deuces



PokerStars Hand #228693216878:  Hold'em No Limit ($0.25/$0.50 USD) - 2021/07/30 19:34:02 ET
Table 'Aitne III' 9-max Seat #7 is the button
Seat 2: ms1272 ($65.39 in chips) 
Seat 3: BollyMith ($22.10 in chips) 
Seat 6: KARANN899 ($55.75 in chips) 
Seat 7: FeersPoker ($50.63 in chips) 
Seat 8: PanicJX ($57.59 in chips) 
Seat 9: BarUnDuck ($26.49 in chips) 
PanicJX: posts small blind $0.25
BarUnDuck: posts big blind $0.50
GastonLeFort: sits out 
*** HOLE CARDS ***
ms1272: raises $0.50 to $1
BollyMith: calls $1
KARANN899: raises $5 to $6
FeersPoker: folds 
PanicJX: folds 
BarUnDuck: folds 
ms1272: folds 
BollyMith: folds 
Uncalled bet ($5) returned to KARANN899
KARANN899 collected $3.75 from pot
KARANN899: doesn't show hand 
*** SUMMARY ***
Total pot $3.75 | Rake $0 
Seat 2: ms1272 folded before Flop
Seat 3: BollyMith folded before Flop
Seat 6: KARANN899 collected ($3.75)
Seat 7: FeersPoker (button) folded before Flop (didn't bet)
Seat 8: PanicJX (small blind) folded before Flop
Seat 9: BarUnDuck (big blind) folded before Flop



PokerStars Hand #228693224187:  Hold'em No Limit ($0.25/$0.50 USD) - 2021/07/30 19:34:24 ET
Table 'Aitne III' 9-max Seat #8 is the button
Seat 1: GastonLeFort ($50 in chips) 
Seat 2: ms1272 ($64.39 in chips) 
Seat 3: BollyMith ($21.10 in chips) 
Seat 6: KARANN899 ($58.50 in chips) 
Seat 7: FeersPoker ($50.63 in chips) 
Seat 8: PanicJX ($57.34 in chips) 
Seat 9: BarUnDuck ($25.99 in chips) 
BarUnDuck: posts small blind $0.25
GastonLeFort: posts big blind $0.50
*** HOLE CARDS ***
ms1272: raises $0.50 to $1
BollyMith: folds 
llov4 joins the table at seat #4 
KARANN899: folds 
FeersPoker: folds 
PanicJX: calls $1
BarUnDuck: folds 
llov4 leaves the table
GastonLeFort: folds 
*** FLOP *** [6s Qh 3c]
ms1272: checks 
PanicJX: checks 
*** TURN *** [6s Qh 3c] [8d]
ms1272: bets $1.30
PanicJX: raises $5.21 to $6.51
ms1272: folds 
Uncalled bet ($5.21) returned to PanicJX
PanicJX collected $5.08 from pot
PanicJX: doesn't show hand 
llov4 joins the table at seat #4 
*** SUMMARY ***
Total pot $5.35 | Rake $0.27 
Board [6s Qh 3c 8d]
Seat 1: GastonLeFort (big blind) folded before Flop
Seat 2: ms1272 folded on the Turn
Seat 3: BollyMith folded before Flop (didn't bet)
Seat 6: KARANN899 folded before Flop (didn't bet)
Seat 7: FeersPoker folded before Flop (didn't bet)
Seat 8: PanicJX (button) collected ($5.08)
Seat 9: BarUnDuck (small blind) folded before Flop



PokerStars Hand #228693239282:  Hold'em No Limit ($0.25/$0.50 USD) - 2021/07/30 19:35:09 ET
Table 'Aitne III' 9-max Seat #9 is the button
Seat 1: GastonLeFort ($50 in chips) 
Seat 2: ms1272 ($62.09 in chips) 
Seat 3: BollyMith ($21.10 in chips) 
Seat 6: KARANN899 ($58.50 in chips) 
Seat 7: FeersPoker ($50.63 in chips) 
Seat 8: PanicJX ($60.12 in chips) 
Seat 9: BarUnDuck ($25.74 in chips) 
GastonLeFort: posts small blind $0.25
ms1272: posts big blind $0.50
llov4: sits out 
*** HOLE CARDS ***
BollyMith: folds 
KARANN899: folds 
FeersPoker: folds 
PanicJX: folds 
BarUnDuck: folds 
GastonLeFort: raises $1 to $1.50
ms1272: calls $1
*** FLOP *** [As 5h Qc]
GastonLeFort: bets $0.71
ms1272: calls $0.71
*** TURN *** [As 5h Qc] [4c]
GastonLeFort: bets $1.05
ms1272: calls $1.05
*** RIVER *** [As 5h Qc 4c] [7d]
GastonLeFort: checks 
ms1272: checks 
*** SHOW DOWN ***
GastonLeFort: shows [9c Kc] (high card Ace)
ms1272: shows [Ah 2c] (a pair of Aces)
ms1272 collected $6.11 from pot
*** SUMMARY ***
Total pot $6.52 | Rake $0.41 
Board [As 5h Qc 4c 7d]
Seat 1: GastonLeFort (small blind) showed [9c Kc] and lost with high card Ace
Seat 2: ms1272 (big blind) showed [Ah 2c] and won ($6.11) with a pair of Aces
Seat 3: BollyMith folded before Flop (didn't bet)
Seat 6: KARANN899 folded before Flop (didn't bet)
Seat 7: FeersPoker folded before Flop (didn't bet)
Seat 8: PanicJX folded before Flop (didn't bet)
Seat 9: BarUnDuck (button) folded before Flop (didn't bet)



PokerStars Hand #228693259827:  Hold'em No Limit ($0.25/$0.50 USD) - 2021/07/30 19:36:11 ET
Table 'Aitne III' 9-max Seat #1 is the button
Seat 1: GastonLeFort ($50 in chips) 
Seat 2: ms1272 ($64.94 in chips) 
Seat 3: BollyMith ($21.10 in chips) 
Seat 6: KARANN899 ($58.50 in chips) 
Seat 7: FeersPoker ($50.63 in chips) 
Seat 8: PanicJX ($60.12 in chips) 
Seat 9: BarUnDuck ($25.74 in chips) 
ms1272: posts small blind $0.25
BollyMith: posts big blind $0.50
llov4: sits out 
*** HOLE CARDS ***
KARANN899: folds 
FeersPoker: folds 
PanicJX: raises $0.75 to $1.25
BarUnDuck: folds 
GastonLeFort: folds 
ms1272: folds 
BollyMith: raises $2.75 to $4
PanicJX: calls $2.75
*** FLOP *** [Ad 8s Qh]
BollyMith: checks 
PanicJX: checks 
*** TURN *** [Ad 8s Qh] [7s]
BollyMith: checks 
PanicJX: checks 
*** RIVER *** [Ad 8s Qh 7s] [Ks]
BollyMith: checks 
PanicJX: bets $56.12 and is all-in
BollyMith: calls $17.10 and is all-in
Uncalled bet ($39.02) returned to PanicJX
*** SHOW DOWN ***
PanicJX: shows [Td Ts] (a pair of Tens)
BollyMith: shows [Js As] (a flush, Ace high)
BollyMith collected $40.45 from pot
*** SUMMARY ***
Total pot $42.45 | Rake $2 
Board [Ad 8s Qh 7s Ks]
Seat 1: GastonLeFort (button) folded before Flop (didn't bet)
Seat 2: ms1272 (small blind) folded before Flop
Seat 3: BollyMith (big blind) showed [Js As] and won ($40.45) with a flush, Ace high
Seat 6: KARANN899 folded before Flop (didn't bet)
Seat 7: FeersPoker folded before Flop (didn't bet)
Seat 8: PanicJX showed [Td Ts] and lost with a pair of Tens
Seat 9: BarUnDuck folded before Flop (didn't bet)



PokerStars Hand #228693271356:  Hold'em No Limit ($0.25/$0.50 USD) - 2021/07/30 19:36:43 ET
Table 'Aitne III' 9-max Seat #2 is the button
Seat 1: GastonLeFort ($50 in chips) 
Seat 2: ms1272 ($64.69 in chips) 
Seat 3: BollyMith ($40.45 in chips) 
Seat 4: llov4 ($50 in chips) 
Seat 6: KARANN899 ($58.50 in chips) 
Seat 7: FeersPoker ($50.63 in chips) 
Seat 8: PanicJX ($39.02 in chips) 
Seat 9: BarUnDuck ($25.74 in chips) 
BollyMith: posts small blind $0.25
llov4: posts big blind $0.50
*** HOLE CARDS ***
KARANN899: raises $1 to $1.50
FeersPoker: folds 
PanicJX: folds 
BarUnDuck: folds 
GastonLeFort: raises $3 to $4.50
ms1272: folds 
BollyMith: folds 
llov4: folds 
KARANN899: calls $3
*** FLOP *** [5d Jc 5c]
KARANN899: checks 
GastonLeFort: bets $2.32
KARANN899: calls $2.32
*** TURN *** [5d Jc 5c] [7s]
KARANN899: checks 
GastonLeFort: checks 
*** RIVER *** [5d Jc 5c 7s] [8s]
KARANN899: bets $9
GastonLeFort: calls $9
*** SHOW DOWN ***
KARANN899: shows [Qc Qh] (two pair, Queens and Fives)
GastonLeFort: mucks hand 
KARANN899 collected $30.77 from pot
*** SUMMARY ***
Total pot $32.39 | Rake $1.62 
Board [5d Jc 5c 7s 8s]
Seat 1: GastonLeFort mucked
Seat 2: ms1272 (button) folded before Flop (didn't bet)
Seat 3: BollyMith (small blind) folded before Flop
Seat 4: llov4 (big blind) folded before Flop
Seat 6: KARANN899 showed [Qc Qh] and won ($30.77) with two pair, Queens and Fives
Seat 7: FeersPoker folded before Flop (didn't bet)
Seat 8: PanicJX folded before Flop (didn't bet)
Seat 9: BarUnDuck folded before Flop (didn't bet)



PokerStars Hand #228693292242:  Hold'em No Limit ($0.25/$0.50 USD) - 2021/07/30 19:37:47 ET
Table 'Aitne III' 9-max Seat #3 is the button
Seat 1: GastonLeFort ($50 in chips) 
Seat 2: ms1272 ($64.69 in chips) 
Seat 3: BollyMith ($40.20 in chips) 
Seat 4: llov4 ($49.50 in chips) 
Seat 6: KARANN899 ($73.45 in chips) 
Seat 7: FeersPoker ($50.63 in chips) 
Seat 8: PanicJX ($39.02 in chips) 
Seat 9: BarUnDuck ($25.74 in chips) 
llov4: posts small blind $0.25
KARANN899: posts big blind $0.50
*** HOLE CARDS ***
FeersPoker: folds 
PanicJX: folds 
BarUnDuck: folds 
GastonLeFort: folds 
ms1272: raises $0.50 to $1
BollyMith: folds 
llov4: folds 
KARANN899: folds 
Uncalled bet ($0.50) returned to ms1272
ms1272 collected $1.25 from pot
ms1272: doesn't show hand 
*** SUMMARY ***
Total pot $1.25 | Rake $0 
Seat 1: GastonLeFort folded before Flop (didn't bet)
Seat 2: ms1272 collected ($1.25)
Seat 3: BollyMith (button) folded before Flop (didn't bet)
Seat 4: llov4 (small blind) folded before Flop
Seat 6: KARANN899 (big blind) folded before Flop
Seat 7: FeersPoker folded before Flop (didn't bet)
Seat 8: PanicJX folded before Flop (didn't bet)
Seat 9: BarUnDuck folded before Flop (didn't bet)



PokerStars Hand #228693300178:  Hold'em No Limit ($0.25/$0.50 USD) - 2021/07/30 19:38:11 ET
Table 'Aitne III' 9-max Seat #4 is the button
Seat 1: GastonLeFort ($50 in chips) 
Seat 2: ms1272 ($65.44 in chips) 
Seat 3: BollyMith ($40.20 in chips) 
Seat 4: llov4 ($49.25 in chips) 
Seat 6: KARANN899 ($72.95 in chips) 
Seat 7: FeersPoker ($50.63 in chips) 
Seat 8: PanicJX ($39.02 in chips) 
Seat 9: BarUnDuck ($25.74 in chips) 
KARANN899: posts small blind $0.25
FeersPoker: posts big blind $0.50
*** HOLE CARDS ***
PanicJX: folds 
BarUnDuck: folds 
GastonLeFort: folds 
ms1272: raises $0.50 to $1
BollyMith: calls $1
llov4: calls $1
KARANN899: folds 
FeersPoker: calls $0.50
*** FLOP *** [Qs Tc 5s]
FeersPoker: checks 
ms1272: checks 
BollyMith: checks 
llov4: checks 
*** TURN *** [Qs Tc 5s] [7s]
FeersPoker: checks 
ms1272: checks 
BollyMith: bets $2.22
llov4: folds 
FeersPoker: calls $2.22
ms1272: folds 
*** RIVER *** [Qs Tc 5s 7s] [Kh]
FeersPoker: checks 
BollyMith: checks 
*** SHOW DOWN ***
FeersPoker: shows [6c Qc] (a pair of Queens)
BollyMith: mucks hand 
FeersPoker collected $8.26 from pot
*** SUMMARY ***
Total pot $8.69 | Rake $0.43 
Board [Qs Tc 5s 7s Kh]
Seat 1: GastonLeFort folded before Flop (didn't bet)
Seat 2: ms1272 folded on the Turn
Seat 3: BollyMith mucked
Seat 4: llov4 (button) folded on the Turn
Seat 6: KARANN899 (small blind) folded before Flop
Seat 7: FeersPoker (big blind) showed [6c Qc] and won ($8.26) with a pair of Queens
Seat 8: PanicJX folded before Flop (didn't bet)
Seat 9: BarUnDuck folded before Flop (didn't bet)



PokerStars Hand #228693331418:  Hold'em No Limit ($0.25/$0.50 USD) - 2021/07/30 19:39:26 ET
Table 'Aitne III' 9-max Seat #6 is the button
Seat 1: GastonLeFort ($50 in chips) 
Seat 2: ms1272 ($64.44 in chips) 
Seat 3: BollyMith ($36.98 in chips) 
Seat 4: llov4 ($48.25 in chips) 
Seat 6: KARANN899 ($72.70 in chips) 
Seat 7: FeersPoker ($55.67 in chips) 
Seat 8: PanicJX ($39.02 in chips) 
Seat 9: BarUnDuck ($25.74 in chips) 
FeersPoker: posts small blind $0.25
PanicJX: posts big blind $0.50
*** HOLE CARDS ***
BarUnDuck: raises $0.50 to $1
GastonLeFort: folds 
ms1272: folds 
BollyMith: calls $1
llov4: calls $1
KARANN899: calls $1
FeersPoker: folds 
PanicJX: calls $0.50
*** FLOP *** [3s 2s Jc]
PanicJX: checks 
BarUnDuck: checks 
BollyMith: checks 
llov4: checks 
KARANN899: checks 
*** TURN *** [3s 2s Jc] [5d]
PanicJX: checks 
nineaxe was removed from the table for failing to post
nineaxe leaves the table
BarUnDuck: bets $1.75
BollyMith: folds 
llov4: folds 
KARANN899: folds 
PanicJX: raises $8.49 to $10.24
BarUnDuck: folds 
Uncalled bet ($8.49) returned to PanicJX
PanicJX collected $8.31 from pot
PanicJX: doesn't show hand 
*** SUMMARY ***
Total pot $8.75 | Rake $0.44 
Board [3s 2s Jc 5d]
Seat 1: GastonLeFort folded before Flop (didn't bet)
Seat 2: ms1272 folded before Flop (didn't bet)
Seat 3: BollyMith folded on the Turn
Seat 4: llov4 folded on the Turn
Seat 6: KARANN899 (button) folded on the Turn
Seat 7: FeersPoker (small blind) folded before Flop
Seat 8: PanicJX (big blind) collected ($8.31)
Seat 9: BarUnDuck folded on the Turn



PokerStars Hand #228693358904:  Hold'em No Limit ($0.25/$0.50 USD) - 2021/07/30 19:40:49 ET
Table 'Aitne III' 9-max Seat #7 is the button
Seat 1: GastonLeFort ($50 in chips) 
Seat 2: ms1272 ($64.44 in chips) 
Seat 3: BollyMith ($35.98 in chips) 
Seat 4: llov4 ($47.25 in chips) 
Seat 6: KARANN899 ($71.70 in chips) 
Seat 7: FeersPoker ($55.42 in chips) 
Seat 8: PanicJX ($44.58 in chips) 
Seat 9: BarUnDuck ($22.99 in chips) 
PanicJX: posts small blind $0.25
BarUnDuck: posts big blind $0.50
*** HOLE CARDS ***
GastonLeFort: folds 
ms1272: folds 
BollyMith: raises $0.60 to $1.10
llov4: calls $1.10
KARANN899: folds 
FeersPoker: folds 
PanicJX: folds 
BarUnDuck: folds 
*** FLOP *** [5s Kd Qd]
BollyMith: checks 
llov4: bets $1.50
BollyMith: folds 
Uncalled bet ($1.50) returned to llov4
llov4 collected $2.80 from pot
llov4: doesn't show hand 
*** SUMMARY ***
Total pot $2.95 | Rake $0.15 
Board [5s Kd Qd]
Seat 1: GastonLeFort folded before Flop (didn't bet)
Seat 2: ms1272 folded before Flop (didn't bet)
Seat 3: BollyMith folded on the Flop
Seat 4: llov4 collected ($2.80)
Seat 6: KARANN899 folded before Flop (didn't bet)
Seat 7: FeersPoker (button) folded before Flop (didn't bet)
Seat 8: PanicJX (small blind) folded before Flop
Seat 9: BarUnDuck (big blind) folded before Flop



PokerStars Hand #228693366385:  Hold'em No Limit ($0.25/$0.50 USD) - 2021/07/30 19:41:12 ET
Table 'Aitne III' 9-max Seat #8 is the button
Seat 1: GastonLeFort ($50 in chips) 
Seat 2: ms1272 ($64.44 in chips) 
Seat 3: BollyMith ($34.88 in chips) 
Seat 4: llov4 ($48.95 in chips) 
Seat 6: KARANN899 ($71.70 in chips) 
Seat 7: FeersPoker ($55.42 in chips) 
Seat 8: PanicJX ($44.33 in chips) 
Seat 9: BarUnDuck ($22.49 in chips) 
BarUnDuck: posts small blind $0.25
GastonLeFort: posts big blind $0.50
*** HOLE CARDS ***
ms1272: folds 
BollyMith: folds 
llov4: folds 
KARANN899: folds 
FeersPoker: folds 
PanicJX: folds 
BarUnDuck: folds 
Uncalled bet ($0.25) returned to GastonLeFort
GastonLeFort collected $0.50 from pot
GastonLeFort: doesn't show hand 
*** SUMMARY ***
Total pot $0.50 | Rake $0 
Seat 1: GastonLeFort (big blind) collected ($0.50)
Seat 2: ms1272 folded before Flop (didn't bet)
Seat 3: BollyMith folded before Flop (didn't bet)
Seat 4: llov4 folded before Flop (didn't bet)
Seat 6: KARANN899 folded before Flop (didn't bet)
Seat 7: FeersPoker folded before Flop (didn't bet)
Seat 8: PanicJX (button) folded before Flop (didn't bet)
Seat 9: BarUnDuck (small blind) folded before Flop



PokerStars Hand #228693380308:  Hold'em No Limit ($0.25/$0.50 USD) - 2021/07/30 19:41:24 ET
Table 'Aitne III' 9-max Seat #9 is the button
Seat 1: GastonLeFort ($50.25 in chips) 
Seat 2: ms1272 ($64.44 in chips) 
Seat 3: BollyMith ($34.88 in chips) 
Seat 4: llov4 ($48.95 in chips) 
Seat 6: KARANN899 ($71.70 in chips) 
Seat 7: FeersPoker ($55.42 in chips) 
Seat 8: PanicJX ($44.33 in chips) 
Seat 9: BarUnDuck ($22.24 in chips) 
GastonLeFort: posts small blind $0.25
ms1272: posts big blind $0.50
*** HOLE CARDS ***
BollyMith: folds 
llov4: folds 
KARANN899: raises $1 to $1.50
FeersPoker: folds 
PanicJX: folds 
BarUnDuck: folds 
GastonLeFort: folds 
ms1272: calls $1
*** FLOP *** [9c 9h 8d]
ms1272: checks 
KARANN899: bets $2.06
ms1272: folds 
Uncalled bet ($2.06) returned to KARANN899
KARANN899 collected $3.09 from pot
*** SUMMARY ***
Total pot $3.25 | Rake $0.16 
Board [9c 9h 8d]
Seat 1: GastonLeFort (small blind) folded before Flop
Seat 2: ms1272 (big blind) folded on the Flop
Seat 3: BollyMith folded before Flop (didn't bet)
Seat 4: llov4 folded before Flop (didn't bet)
Seat 6: KARANN899 collected ($3.09)
Seat 7: FeersPoker folded before Flop (didn't bet)
Seat 8: PanicJX folded before Flop (didn't bet)
Seat 9: BarUnDuck (button) folded before Flop (didn't bet)



PokerStars Hand #228693388862:  Hold'em No Limit ($0.25/$0.50 USD) - 2021/07/30 19:41:51 ET
Table 'Aitne III' 9-max Seat #1 is the button
Seat 1: GastonLeFort ($50 in chips) 
Seat 2: ms1272 ($62.94 in chips) 
Seat 3: BollyMith ($34.88 in chips) 
Seat 4: llov4 ($48.95 in chips) 
Seat 6: KARANN899 ($73.29 in chips) 
Seat 7: FeersPoker ($55.42 in chips) 
Seat 8: PanicJX ($44.33 in chips) 
Seat 9: BarUnDuck ($22.24 in chips) 
ms1272: posts small blind $0.25
BollyMith: posts big blind $0.50
*** HOLE CARDS ***
llov4: calls $0.50
KARANN899: folds 
FeersPoker: raises $1.50 to $2
PanicJX: folds 
BarUnDuck: folds 
GastonLeFort: folds 
ms1272: folds 
BollyMith: folds 
llov4: calls $1.50
*** FLOP *** [3s 4d Td]
llov4: checks 
FeersPoker: bets $2.26
Xamil666 joins the table at seat #5 
llov4: calls $2.26
*** TURN *** [3s 4d Td] [5c]
llov4: checks 
FeersPoker: bets $5.90
llov4: folds 
Uncalled bet ($5.90) returned to FeersPoker
FeersPoker collected $8.81 from pot
FeersPoker: doesn't show hand 
*** SUMMARY ***
Total pot $9.27 | Rake $0.46 
Board [3s 4d Td 5c]
Seat 1: GastonLeFort (button) folded before Flop (didn't bet)
Seat 2: ms1272 (small blind) folded before Flop
Seat 3: BollyMith (big blind) folded before Flop
Seat 4: llov4 folded on the Turn
Seat 6: KARANN899 folded before Flop (didn't bet)
Seat 7: FeersPoker collected ($8.81)
Seat 8: PanicJX folded before Flop (didn't bet)
Seat 9: BarUnDuck folded before Flop (didn't bet)



PokerStars Hand #228693409854:  Hold'em No Limit ($0.25/$0.50 USD) - 2021/07/30 19:42:55 ET
Table 'Aitne III' 9-max Seat #2 is the button
Seat 1: GastonLeFort ($50 in chips) 
Seat 2: ms1272 ($62.69 in chips) 
Seat 3: BollyMith ($34.38 in chips) 
Seat 4: llov4 ($44.69 in chips) 
Seat 6: KARANN899 ($73.29 in chips) 
Seat 7: FeersPoker ($59.97 in chips) 
Seat 8: PanicJX ($44.33 in chips) 
Seat 9: BarUnDuck ($22.24 in chips) 
BollyMith: posts small blind $0.25
llov4: posts big blind $0.50
Xamil666: sits out 
*** HOLE CARDS ***
KARANN899: folds 
FeersPoker: folds 
PanicJX: folds 
BarUnDuck: folds 
GastonLeFort: folds 
ms1272: raises $0.50 to $1
BollyMith: folds 
llov4: folds 
Uncalled bet ($0.50) returned to ms1272
ms1272 collected $1.25 from pot
ms1272: doesn't show hand 
*** SUMMARY ***
Total pot $1.25 | Rake $0 
Seat 1: GastonLeFort folded before Flop (didn't bet)
Seat 2: ms1272 (button) collected ($1.25)
Seat 3: BollyMith (small blind) folded before Flop
Seat 4: llov4 (big blind) folded before Flop
Seat 6: KARANN899 folded before Flop (didn't bet)
Seat 7: FeersPoker folded before Flop (didn't bet)
Seat 8: PanicJX folded before Flop (didn't bet)
Seat 9: BarUnDuck folded before Flop (didn't bet)



PokerStars Hand #228693415032:  Hold'em No Limit ($0.25/$0.50 USD) - 2021/07/30 19:43:12 ET
Table 'Aitne III' 9-max Seat #3 is the button
Seat 1: GastonLeFort ($50 in chips) 
Seat 2: ms1272 ($63.44 in chips) 
Seat 3: BollyMith ($34.13 in chips) 
Seat 4: llov4 ($44.19 in chips) 
Seat 5: Xamil666 ($50 in chips) 
Seat 6: KARANN899 ($73.29 in chips) 
Seat 7: FeersPoker ($59.97 in chips) 
Seat 8: PanicJX ($44.33 in chips) 
Seat 9: BarUnDuck ($22.24 in chips) 
llov4: posts small blind $0.25
Xamil666: posts big blind $0.50
*** HOLE CARDS ***
KARANN899: folds 
FeersPoker: folds 
PanicJX: folds 
BarUnDuck: folds 
GastonLeFort: folds 
ms1272: folds 
BollyMith: raises $0.60 to $1.10
llov4: calls $0.85
Xamil666: folds 
*** FLOP *** [Kc 5s Th]
llov4: bets $1.50
BollyMith: calls $1.50
*** TURN *** [Kc 5s Th] [6s]
llov4: bets $3
BollyMith: calls $3
*** RIVER *** [Kc 5s Th 6s] [9d]
llov4: bets $5.50
BollyMith: raises $23.03 to $28.53 and is all-in
llov4: folds 
Uncalled bet ($23.03) returned to BollyMith
BollyMith collected $21.56 from pot
BollyMith: doesn't show hand 
*** SUMMARY ***
Total pot $22.70 | Rake $1.14 
Board [Kc 5s Th 6s 9d]
Seat 1: GastonLeFort folded before Flop (didn't bet)
Seat 2: ms1272 folded before Flop (didn't bet)
Seat 3: BollyMith (button) collected ($21.56)
Seat 4: llov4 (small blind) folded on the River
Seat 5: Xamil666 (big blind) folded before Flop
Seat 6: KARANN899 folded before Flop (didn't bet)
Seat 7: FeersPoker folded before Flop (didn't bet)
Seat 8: PanicJX folded before Flop (didn't bet)
Seat 9: BarUnDuck folded before Flop (didn't bet)



PokerStars Hand #228693437962:  Hold'em No Limit ($0.25/$0.50 USD) - 2021/07/30 19:44:23 ET
Table 'Aitne III' 9-max Seat #4 is the button
Seat 1: GastonLeFort ($50 in chips) 
Seat 2: ms1272 ($63.44 in chips) 
Seat 3: BollyMith ($44.59 in chips) 
Seat 4: llov4 ($33.09 in chips) 
Seat 5: Xamil666 ($50 in chips) 
Seat 6: KARANN899 ($73.29 in chips) 
Seat 7: FeersPoker ($59.97 in chips) 
Seat 8: PanicJX ($44.33 in chips) 
Seat 9: BarUnDuck ($22.24 in chips) 
Xamil666: posts small blind $0.25
KARANN899: posts big blind $0.50
*** HOLE CARDS ***
FeersPoker: folds 
PanicJX: folds 
BarUnDuck: folds 
GastonLeFort: folds 
ms1272: folds 
BollyMith: folds 
llov4: folds 
Xamil666: folds 
Uncalled bet ($0.25) returned to KARANN899
KARANN899 collected $0.50 from pot
KARANN899: doesn't show hand 
*** SUMMARY ***
Total pot $0.50 | Rake $0 
Seat 1: GastonLeFort folded before Flop (didn't bet)
Seat 2: ms1272 folded before Flop (didn't bet)
Seat 3: BollyMith folded before Flop (didn't bet)
Seat 4: llov4 (button) folded before Flop (didn't bet)
Seat 5: Xamil666 (small blind) folded before Flop
Seat 6: KARANN899 (big blind) collected ($0.50)
Seat 7: FeersPoker folded before Flop (didn't bet)
Seat 8: PanicJX folded before Flop (didn't bet)
Seat 9: BarUnDuck folded before Flop (didn't bet)



PokerStars Hand #228693443131:  Hold'em No Limit ($0.25/$0.50 USD) - 2021/07/30 19:44:39 ET
Table 'Aitne III' 9-max Seat #5 is the button
Seat 1: GastonLeFort ($50 in chips) 
Seat 2: ms1272 ($63.44 in chips) 
Seat 3: BollyMith ($44.59 in chips) 
Seat 4: llov4 ($33.09 in chips) 
Seat 5: Xamil666 ($50 in chips) 
Seat 6: KARANN899 ($73.54 in chips) 
Seat 8: PanicJX ($44.33 in chips) 
Seat 9: BarUnDuck ($22.24 in chips) 
KARANN899: posts small blind $0.25
FeersPoker: is sitting out 
PanicJX: posts big blind $0.50
*** HOLE CARDS ***
BarUnDuck: folds 
GastonLeFort: folds 
ms1272: raises $0.50 to $1
BollyMith: folds 
FeersPoker leaves the table
llov4: calls $1
Xamil666: calls $1
KARANN899: folds 
PanicJX: calls $0.50
*** FLOP *** [6d Jd Jc]
PanicJX: checks 
ms1272: checks 
llov4: checks 
Xamil666: checks 
*** TURN *** [6d Jd Jc] [7s]
PanicJX: bets $4.04
ms1272: calls $4.04
llov4: folds 
Xamil666: folds 
*** RIVER *** [6d Jd Jc 7s] [2d]
PanicJX: checks 
ms1272: bets $11.71
PanicJX: folds 
Uncalled bet ($11.71) returned to ms1272
ms1272 collected $11.55 from pot
ms1272: doesn't show hand 
*** SUMMARY ***
Total pot $12.33 | Rake $0.78 
Board [6d Jd Jc 7s 2d]
Seat 1: GastonLeFort folded before Flop (didn't bet)
Seat 2: ms1272 collected ($11.55)
Seat 3: BollyMith folded before Flop (didn't bet)
Seat 4: llov4 folded on the Turn
Seat 5: Xamil666 (button) folded on the Turn
Seat 6: KARANN899 (small blind) folded before Flop
Seat 8: PanicJX (big blind) folded on the River
Seat 9: BarUnDuck folded before Flop (didn't bet)



PokerStars Hand #228693463028:  Hold'em No Limit ($0.25/$0.50 USD) - 2021/07/30 19:45:41 ET
Table 'Aitne III' 9-max Seat #6 is the button
Seat 1: GastonLeFort ($50 in chips) 
Seat 2: ms1272 ($69.95 in chips) 
Seat 3: BollyMith ($44.59 in chips) 
Seat 4: llov4 ($32.09 in chips) 
Seat 5: Xamil666 ($50 in chips) 
Seat 6: KARANN899 ($73.29 in chips) 
Seat 8: PanicJX ($39.29 in chips) 
Seat 9: BarUnDuck ($22.24 in chips) 
PanicJX: posts small blind $0.25
BarUnDuck: posts big blind $0.50
*** HOLE CARDS ***
GastonLeFort: folds 
ms1272: folds 
BollyMith: folds 
llov4: folds 
Xamil666: folds 
KARANN899: folds 
PanicJX: folds 
Uncalled bet ($0.25) returned to BarUnDuck
BarUnDuck collected $0.50 from pot
BarUnDuck: doesn't show hand 
*** SUMMARY ***
Total pot $0.50 | Rake $0 
Seat 1: GastonLeFort folded before Flop (didn't bet)
Seat 2: ms1272 folded before Flop (didn't bet)
Seat 3: BollyMith folded before Flop (didn't bet)
Seat 4: llov4 folded before Flop (didn't bet)
Seat 5: Xamil666 folded before Flop (didn't bet)
Seat 6: KARANN899 (button) folded before Flop (didn't bet)
Seat 8: PanicJX (small blind) folded before Flop
Seat 9: BarUnDuck (big blind) collected ($0.50)



PokerStars Hand #228693465281:  Hold'em No Limit ($0.25/$0.50 USD) - 2021/07/30 19:45:48 ET
Table 'Aitne III' 9-max Seat #8 is the button
Seat 1: GastonLeFort ($50 in chips) 
Seat 2: ms1272 ($69.95 in chips) 
Seat 3: BollyMith ($44.59 in chips) 
Seat 4: llov4 ($32.09 in chips) 
Seat 5: Xamil666 ($50 in chips) 
Seat 6: KARANN899 ($73.29 in chips) 
Seat 8: PanicJX ($39.04 in chips) 
Seat 9: BarUnDuck ($22.49 in chips) 
BarUnDuck: posts small blind $0.25
GastonLeFort: posts big blind $0.50
*** HOLE CARDS ***
ms1272: raises $0.50 to $1
BollyMith: folds 
daria130399 joins the table at seat #7 
llov4: calls $1
Xamil666: folds 
KARANN899: folds 
PanicJX: folds 
BarUnDuck: folds 
GastonLeFort: folds 
*** FLOP *** [9h 6d 4d]
ms1272: checks 
llov4: checks 
*** TURN *** [9h 6d 4d] [Jc]
ms1272: bets $1.30
llov4: calls $1.30
*** RIVER *** [9h 6d 4d Jc] [7s]
ms1272: checks 
llov4: bets $3
ms1272: folds 
Uncalled bet ($3) returned to llov4
llov4 collected $5.08 from pot
llov4: doesn't show hand 
*** SUMMARY ***
Total pot $5.35 | Rake $0.27 
Board [9h 6d 4d Jc 7s]
Seat 1: GastonLeFort (big blind) folded before Flop
Seat 2: ms1272 folded on the River
Seat 3: BollyMith folded before Flop (didn't bet)
Seat 4: llov4 collected ($5.08)
Seat 5: Xamil666 folded before Flop (didn't bet)
Seat 6: KARANN899 folded before Flop (didn't bet)
Seat 8: PanicJX (button) folded before Flop (didn't bet)
Seat 9: BarUnDuck (small blind) folded before Flop



PokerStars Hand #228693477112:  Hold'em No Limit ($0.25/$0.50 USD) - 2021/07/30 19:46:24 ET
Table 'Aitne III' 9-max Seat #9 is the button
Seat 1: GastonLeFort ($50 in chips) 
Seat 2: ms1272 ($67.65 in chips) 
Seat 3: BollyMith ($44.59 in chips) 
Seat 4: llov4 ($34.87 in chips) 
Seat 5: Xamil666 ($50 in chips) 
Seat 6: KARANN899 ($73.29 in chips) 
Seat 8: PanicJX ($39.04 in chips) 
Seat 9: BarUnDuck ($22.24 in chips) 
GastonLeFort: posts small blind $0.25
ms1272: posts big blind $0.50
daria130399: sits out 
*** HOLE CARDS ***
BollyMith: folds 
llov4: raises $1.50 to $2
Xamil666: folds 
KARANN899: calls $2
PanicJX: folds 
BarUnDuck: folds 
GastonLeFort: folds 
ms1272: folds 
*** FLOP *** [4h 7s Ah]
llov4: bets $2.50
KARANN899: raises $4 to $6.50
llov4: folds 
Uncalled bet ($4) returned to KARANN899
KARANN899 collected $9.26 from pot
KARANN899: doesn't show hand 
*** SUMMARY ***
Total pot $9.75 | Rake $0.49 
Board [4h 7s Ah]
Seat 1: GastonLeFort (small blind) folded before Flop
Seat 2: ms1272 (big blind) folded before Flop
Seat 3: BollyMith folded before Flop (didn't bet)
Seat 4: llov4 folded on the Flop
Seat 5: Xamil666 folded before Flop (didn't bet)
Seat 6: KARANN899 collected ($9.26)
Seat 8: PanicJX folded before Flop (didn't bet)
Seat 9: BarUnDuck (button) folded before Flop (didn't bet)



PokerStars Hand #228693488433:  Hold'em No Limit ($0.25/$0.50 USD) - 2021/07/30 19:47:00 ET
Table 'Aitne III' 9-max Seat #1 is the button
Seat 1: GastonLeFort ($50 in chips) 
Seat 2: ms1272 ($67.15 in chips) 
Seat 3: BollyMith ($44.59 in chips) 
Seat 4: llov4 ($30.37 in chips) 
Seat 5: Xamil666 ($50 in chips) 
Seat 6: KARANN899 ($78.05 in chips) 
Seat 8: PanicJX ($39.04 in chips) 
Seat 9: BarUnDuck ($22.24 in chips) 
ms1272: posts small blind $0.25
BollyMith: posts big blind $0.50
daria130399: sits out 
*** HOLE CARDS ***
llov4: folds 
Xamil666: folds 
KARANN899: raises $0.50 to $1
PanicJX: folds 
BarUnDuck: folds 
GastonLeFort: folds 
ms1272: folds 
BollyMith: calls $0.50
*** FLOP *** [3d 3h Tc]
BollyMith: checks 
KARANN899: bets $1.07
BollyMith: folds 
Uncalled bet ($1.07) returned to KARANN899
KARANN899 collected $2.14 from pot
KARANN899: doesn't show hand 
*** SUMMARY ***
Total pot $2.25 | Rake $0.11 
Board [3d 3h Tc]
Seat 1: GastonLeFort (button) folded before Flop (didn't bet)
Seat 2: ms1272 (small blind) folded before Flop
Seat 3: BollyMith (big blind) folded on the Flop
Seat 4: llov4 folded before Flop (didn't bet)
Seat 5: Xamil666 folded before Flop (didn't bet)
Seat 6: KARANN899 collected ($2.14)
Seat 8: PanicJX folded before Flop (didn't bet)
Seat 9: BarUnDuck folded before Flop (didn't bet)



PokerStars Hand #228693495277:  Hold'em No Limit ($0.25/$0.50 USD) - 2021/07/30 19:47:22 ET
Table 'Aitne III' 9-max Seat #2 is the button
Seat 1: GastonLeFort ($50 in chips) 
Seat 2: ms1272 ($66.90 in chips) 
Seat 3: BollyMith ($43.59 in chips) 
Seat 4: llov4 ($30.37 in chips) 
Seat 5: Xamil666 ($50 in chips) 
Seat 6: KARANN899 ($79.19 in chips) 
Seat 8: PanicJX ($39.04 in chips) 
Seat 9: BarUnDuck ($22.24 in chips) 
BollyMith: posts small blind $0.25
llov4: posts big blind $0.50
daria130399: sits out 
*** HOLE CARDS ***
Xamil666: raises $1 to $1.50
KARANN899: folds 
PanicJX: folds 
BarUnDuck: folds 
GastonLeFort: folds 
ms1272: folds 
BollyMith: folds 
llov4: folds 
Uncalled bet ($1) returned to Xamil666
Xamil666 collected $1.25 from pot
*** SUMMARY ***
Total pot $1.25 | Rake $0 
Seat 1: GastonLeFort folded before Flop (didn't bet)
Seat 2: ms1272 (button) folded before Flop (didn't bet)
Seat 3: BollyMith (small blind) folded before Flop
Seat 4: llov4 (big blind) folded before Flop
Seat 5: Xamil666 collected ($1.25)
Seat 6: KARANN899 folded before Flop (didn't bet)
Seat 8: PanicJX folded before Flop (didn't bet)
Seat 9: BarUnDuck folded before Flop (didn't bet)



PokerStars Hand #228693502375:  Hold'em No Limit ($0.25/$0.50 USD) - 2021/07/30 19:47:44 ET
Table 'Aitne III' 9-max Seat #3 is the button
Seat 1: GastonLeFort ($50 in chips) 
Seat 2: ms1272 ($66.90 in chips) 
Seat 3: BollyMith ($43.34 in chips) 
Seat 4: llov4 ($29.87 in chips) 
Seat 5: Xamil666 ($50.75 in chips) 
Seat 6: KARANN899 ($79.19 in chips) 
Seat 8: PanicJX ($39.04 in chips) 
Seat 9: BarUnDuck ($22.24 in chips) 
llov4: posts small blind $0.25
Xamil666: posts big blind $0.50
daria130399: sits out 
*** HOLE CARDS ***
KARANN899: folds 
PanicJX: folds 
BarUnDuck: folds 
GastonLeFort: raises $1 to $1.50
ms1272: folds 
BollyMith: calls $1.50
llov4: raises $2.50 to $4
Xamil666: folds 
GastonLeFort: calls $2.50
BollyMith: calls $2.50
*** FLOP *** [Ac 7h 5h]
llov4: checks 
GastonLeFort: checks 
BollyMith: checks 
*** TURN *** [Ac 7h 5h] [2s]
llov4: bets $6
GastonLeFort: calls $6
BollyMith: folds 
*** RIVER *** [Ac 7h 5h 2s] [4h]
llov4: checks 
GastonLeFort: bets $40 and is all-in
llov4: folds 
Uncalled bet ($40) returned to GastonLeFort
GastonLeFort collected $23.28 from pot
GastonLeFort: doesn't show hand 
*** SUMMARY ***
Total pot $24.50 | Rake $1.22 
Board [Ac 7h 5h 2s 4h]
Seat 1: GastonLeFort collected ($23.28)
Seat 2: ms1272 folded before Flop (didn't bet)
Seat 3: BollyMith (button) folded on the Turn
Seat 4: llov4 (small blind) folded on the River
Seat 5: Xamil666 (big blind) folded before Flop
Seat 6: KARANN899 folded before Flop (didn't bet)
Seat 8: PanicJX folded before Flop (didn't bet)
Seat 9: BarUnDuck folded before Flop (didn't bet)



PokerStars Hand #228693530995:  Hold'em No Limit ($0.25/$0.50 USD) - 2021/07/30 19:49:15 ET
Table 'Aitne III' 9-max Seat #4 is the button
Seat 1: GastonLeFort ($63.28 in chips) 
Seat 2: ms1272 ($66.90 in chips) 
Seat 3: BollyMith ($39.34 in chips) 
Seat 4: llov4 ($19.87 in chips) 
Seat 5: Xamil666 ($50.25 in chips) 
Seat 6: KARANN899 ($79.19 in chips) 
Seat 8: PanicJX ($39.04 in chips) 
Seat 9: BarUnDuck ($22.24 in chips) 
Xamil666: posts small blind $0.25
KARANN899: posts big blind $0.50
daria130399: sits out 
*** HOLE CARDS ***
PanicJX: folds 
BarUnDuck: folds 
GastonLeFort: folds 
ms1272: folds 
BollyMith: raises $0.60 to $1.10
llov4: calls $1.10
Xamil666: raises $3.40 to $4.50
KARANN899: folds 
BollyMith: folds 
llov4: folds 
Uncalled bet ($3.40) returned to Xamil666
Xamil666 collected $3.80 from pot
*** SUMMARY ***
Total pot $3.80 | Rake $0 
Seat 1: GastonLeFort folded before Flop (didn't bet)
Seat 2: ms1272 folded before Flop (didn't bet)
Seat 3: BollyMith folded before Flop
Seat 4: llov4 (button) folded before Flop
Seat 5: Xamil666 (small blind) collected ($3.80)
Seat 6: KARANN899 (big blind) folded before Flop
Seat 8: PanicJX folded before Flop (didn't bet)
Seat 9: BarUnDuck folded before Flop (didn't bet)



PokerStars Hand #228693539130:  Hold'em No Limit ($0.25/$0.50 USD) - 2021/07/30 19:49:41 ET
Table 'Aitne III' 9-max Seat #5 is the button
Seat 1: GastonLeFort ($63.28 in chips) 
Seat 2: ms1272 ($66.90 in chips) 
Seat 3: BollyMith ($38.24 in chips) 
Seat 4: llov4 ($18.77 in chips) 
Seat 5: Xamil666 ($52.95 in chips) 
Seat 6: KARANN899 ($78.69 in chips) 
Seat 7: daria130399 ($50 in chips) 
Seat 8: PanicJX ($39.04 in chips) 
Seat 9: BarUnDuck ($22.24 in chips) 
KARANN899: posts small blind $0.25
daria130399: posts big blind $0.50
*** HOLE CARDS ***
PanicJX has timed out
PanicJX: folds 
BarUnDuck: folds 
GastonLeFort: folds 
ms1272: folds 
BollyMith: folds 
llov4: raises $1 to $1.50
Xamil666: folds 
KARANN899: folds 
daria130399: calls $1
*** FLOP *** [Kc 6h Ad]
daria130399: bets $1.02
llov4: folds 
Uncalled bet ($1.02) returned to daria130399
daria130399 collected $3.09 from pot
daria130399: doesn't show hand 
*** SUMMARY ***
Total pot $3.25 | Rake $0.16 
Board [Kc 6h Ad]
Seat 1: GastonLeFort folded before Flop (didn't bet)
Seat 2: ms1272 folded before Flop (didn't bet)
Seat 3: BollyMith folded before Flop (didn't bet)
Seat 4: llov4 folded on the Flop
Seat 5: Xamil666 (button) folded before Flop (didn't bet)
Seat 6: KARANN899 (small blind) folded before Flop
Seat 7: daria130399 (big blind) collected ($3.09)
Seat 8: PanicJX folded before Flop (didn't bet)
Seat 9: BarUnDuck folded before Flop (didn't bet)



PokerStars Hand #228693554645:  Hold'em No Limit ($0.25/$0.50 USD) - 2021/07/30 19:50:30 ET
Table 'Aitne III' 9-max Seat #6 is the button
Seat 1: GastonLeFort ($63.28 in chips) 
Seat 2: ms1272 ($66.90 in chips) 
Seat 3: BollyMith ($38.24 in chips) 
Seat 4: llov4 ($17.27 in chips) 
Seat 5: Xamil666 ($52.95 in chips) 
Seat 6: KARANN899 ($78.44 in chips) 
Seat 7: daria130399 ($51.59 in chips) 
Seat 8: PanicJX ($39.04 in chips) 
Seat 9: BarUnDuck ($22.24 in chips) 
daria130399: posts small blind $0.25
PanicJX: posts big blind $0.50
*** HOLE CARDS ***
BarUnDuck: folds 
GastonLeFort: raises $1 to $1.50
ms1272: folds 
BollyMith: folds 
llov4: folds 
Xamil666: raises $3 to $4.50
KARANN899: calls $4.50
daria130399: folds 
PanicJX: folds 
GastonLeFort: calls $3
*** FLOP *** [5d 2c Qd]
GastonLeFort: checks 
Xamil666: bets $4.47
KARANN899: folds 
GastonLeFort: calls $4.47
*** TURN *** [5d 2c Qd] [Qh]
GastonLeFort: checks 
Xamil666: checks 
*** RIVER *** [5d 2c Qd Qh] [4c]
GastonLeFort: bets $5.51
Xamil666: calls $5.51
*** SHOW DOWN ***
GastonLeFort: shows [8s 8d] (two pair, Queens and Eights)
Xamil666: shows [As Ad] (two pair, Aces and Queens)
Xamil666 collected $32.50 from pot
*** SUMMARY ***
Total pot $34.21 | Rake $1.71 
Board [5d 2c Qd Qh 4c]
Seat 1: GastonLeFort showed [8s 8d] and lost with two pair, Queens and Eights
Seat 2: ms1272 folded before Flop (didn't bet)
Seat 3: BollyMith folded before Flop (didn't bet)
Seat 4: llov4 folded before Flop (didn't bet)
Seat 5: Xamil666 showed [As Ad] and won ($32.50) with two pair, Aces and Queens
Seat 6: KARANN899 (button) folded on the Flop
Seat 7: daria130399 (small blind) folded before Flop
Seat 8: PanicJX (big blind) folded before Flop
Seat 9: BarUnDuck folded before Flop (didn't bet)



PokerStars Hand #228693583324:  Hold'em No Limit ($0.25/$0.50 USD) - 2021/07/30 19:52:03 ET
Table 'Aitne III' 9-max Seat #7 is the button
Seat 1: GastonLeFort ($50 in chips) 
Seat 2: ms1272 ($66.90 in chips) 
Seat 3: BollyMith ($38.24 in chips) 
Seat 4: llov4 ($17.27 in chips) 
Seat 5: Xamil666 ($70.97 in chips) 
Seat 6: KARANN899 ($73.94 in chips) 
Seat 7: daria130399 ($51.34 in chips) 
Seat 8: PanicJX ($38.54 in chips) 
Seat 9: BarUnDuck ($22.24 in chips) 
PanicJX: posts small blind $0.25
BarUnDuck: posts big blind $0.50
*** HOLE CARDS ***
GastonLeFort: folds 
ms1272: folds 
BollyMith: folds 
llov4: calls $0.50
Xamil666: raises $1 to $1.50
KARANN899: folds 
daria130399: folds 
PanicJX: folds 
BarUnDuck: calls $1
llov4: calls $1
*** FLOP *** [6c 3d Ah]
BarUnDuck: checks 
llov4: bets $2.50
Xamil666: folds 
BarUnDuck: folds 
Uncalled bet ($2.50) returned to llov4
llov4 collected $4.51 from pot
llov4: doesn't show hand 
*** SUMMARY ***
Total pot $4.75 | Rake $0.24 
Board [6c 3d Ah]
Seat 1: GastonLeFort folded before Flop (didn't bet)
Seat 2: ms1272 folded before Flop (didn't bet)
Seat 3: BollyMith folded before Flop (didn't bet)
Seat 4: llov4 collected ($4.51)
Seat 5: Xamil666 folded on the Flop
Seat 6: KARANN899 folded before Flop (didn't bet)
Seat 7: daria130399 (button) folded before Flop (didn't bet)
Seat 8: PanicJX (small blind) folded before Flop
Seat 9: BarUnDuck (big blind) folded on the Flop



PokerStars Hand #228693599288:  Hold'em No Limit ($0.25/$0.50 USD) - 2021/07/30 19:52:54 ET
Table 'Aitne III' 9-max Seat #8 is the button
Seat 1: GastonLeFort ($50 in chips) 
Seat 2: ms1272 ($66.90 in chips) 
Seat 3: BollyMith ($38.24 in chips) 
Seat 4: llov4 ($20.28 in chips) 
Seat 5: Xamil666 ($69.47 in chips) 
Seat 6: KARANN899 ($73.94 in chips) 
Seat 7: daria130399 ($51.34 in chips) 
Seat 8: PanicJX ($38.29 in chips) 
Seat 9: BarUnDuck ($20.74 in chips) 
BarUnDuck: posts small blind $0.25
GastonLeFort: posts big blind $0.50
*** HOLE CARDS ***
ms1272: folds 
BollyMith: folds 
llov4: folds 
Xamil666: folds 
KARANN899: folds 
daria130399: folds 
PanicJX: raises $0.75 to $1.25
BarUnDuck: raises $3 to $4.25
GastonLeFort: folds 
PanicJX: folds 
Uncalled bet ($3) returned to BarUnDuck
BarUnDuck collected $3 from pot
BarUnDuck: doesn't show hand 
*** SUMMARY ***
Total pot $3 | Rake $0 
Seat 1: GastonLeFort (big blind) folded before Flop
Seat 2: ms1272 folded before Flop (didn't bet)
Seat 3: BollyMith folded before Flop (didn't bet)
Seat 4: llov4 folded before Flop (didn't bet)
Seat 5: Xamil666 folded before Flop (didn't bet)
Seat 6: KARANN899 folded before Flop (didn't bet)
Seat 7: daria130399 folded before Flop (didn't bet)
Seat 8: PanicJX (button) folded before Flop
Seat 9: BarUnDuck (small blind) collected ($3)



PokerStars Hand #228693611828:  Hold'em No Limit ($0.25/$0.50 USD) - 2021/07/30 19:53:13 ET
Table 'Aitne III' 9-max Seat #9 is the button
Seat 1: GastonLeFort ($50 in chips) 
Seat 2: ms1272 ($66.90 in chips) 
Seat 3: BollyMith ($38.24 in chips) 
Seat 4: llov4 ($20.28 in chips) 
Seat 5: Xamil666 ($69.47 in chips) 
Seat 6: KARANN899 ($73.94 in chips) 
Seat 7: daria130399 ($51.34 in chips) 
Seat 8: PanicJX ($37.04 in chips) 
Seat 9: BarUnDuck ($22.49 in chips) 
GastonLeFort: posts small blind $0.25
ms1272: posts big blind $0.50
*** HOLE CARDS ***
BollyMith: folds 
llov4: folds 
Xamil666: folds 
KARANN899: folds 
daria130399: folds 
PanicJX: raises $0.75 to $1.25
BarUnDuck: folds 
GastonLeFort: folds 
ms1272: calls $0.75
*** FLOP *** [Qh 3c 7c]
ms1272: checks 
PanicJX: bets $1.31
ms1272: calls $1.31
*** TURN *** [Qh 3c 7c] [Ad]
ms1272: checks 
PanicJX: checks 
*** RIVER *** [Qh 3c 7c Ad] [Ah]
ms1272: checks 
PanicJX: bets $5.10
ms1272: folds 
Uncalled bet ($5.10) returned to PanicJX
PanicJX collected $5.10 from pot
PanicJX: doesn't show hand 
*** SUMMARY ***
Total pot $5.37 | Rake $0.27 
Board [Qh 3c 7c Ad Ah]
Seat 1: GastonLeFort (small blind) folded before Flop
Seat 2: ms1272 (big blind) folded on the River
Seat 3: BollyMith folded before Flop (didn't bet)
Seat 4: llov4 folded before Flop (didn't bet)
Seat 5: Xamil666 folded before Flop (didn't bet)
Seat 6: KARANN899 folded before Flop (didn't bet)
Seat 7: daria130399 folded before Flop (didn't bet)
Seat 8: PanicJX collected ($5.10)
Seat 9: BarUnDuck (button) folded before Flop (didn't bet)



PokerStars Hand #228693626007:  Hold'em No Limit ($0.25/$0.50 USD) - 2021/07/30 19:53:59 ET
Table 'Aitne III' 9-max Seat #1 is the button
Seat 1: GastonLeFort ($50 in chips) 
Seat 2: ms1272 ($64.34 in chips) 
Seat 3: BollyMith ($38.24 in chips) 
Seat 4: llov4 ($20.28 in chips) 
Seat 5: Xamil666 ($69.47 in chips) 
Seat 6: KARANN899 ($73.94 in chips) 
Seat 7: daria130399 ($51.34 in chips) 
Seat 8: PanicJX ($39.58 in chips) 
Seat 9: BarUnDuck ($22.49 in chips) 
ms1272: posts small blind $0.25
BollyMith: posts big blind $0.50
*** HOLE CARDS ***
llov4: raises $1 to $1.50
Xamil666: folds 
KARANN899: folds 
daria130399: calls $1.50
PanicJX: folds 
BarUnDuck: folds 
GastonLeFort: folds 
ms1272: folds 
BollyMith: calls $1
*** FLOP *** [Jh 6h 2d]
BollyMith: checks 
llov4: bets $2.50
daria130399: folds 
BollyMith: folds 
Uncalled bet ($2.50) returned to llov4
llov4 collected $4.51 from pot
llov4: doesn't show hand 
*** SUMMARY ***
Total pot $4.75 | Rake $0.24 
Board [Jh 6h 2d]
Seat 1: GastonLeFort (button) folded before Flop (didn't bet)
Seat 2: ms1272 (small blind) folded before Flop
Seat 3: BollyMith (big blind) folded on the Flop
Seat 4: llov4 collected ($4.51)
Seat 5: Xamil666 folded before Flop (didn't bet)
Seat 6: KARANN899 folded before Flop (didn't bet)
Seat 7: daria130399 folded on the Flop
Seat 8: PanicJX folded before Flop (didn't bet)
Seat 9: BarUnDuck folded before Flop (didn't bet)



PokerStars Hand #228693636408:  Hold'em No Limit ($0.25/$0.50 USD) - 2021/07/30 19:54:33 ET
Table 'Aitne III' 9-max Seat #2 is the button
Seat 1: GastonLeFort ($50 in chips) 
Seat 2: ms1272 ($64.09 in chips) 
Seat 3: BollyMith ($36.74 in chips) 
Seat 4: llov4 ($23.29 in chips) 
Seat 5: Xamil666 ($69.47 in chips) 
Seat 6: KARANN899 ($73.94 in chips) 
Seat 7: daria130399 ($50 in chips) 
Seat 8: PanicJX ($39.58 in chips) 
Seat 9: BarUnDuck ($22.49 in chips) 
BollyMith: posts small blind $0.25
llov4: posts big blind $0.50
*** HOLE CARDS ***
Xamil666: folds 
KARANN899: folds 
daria130399: folds 
PanicJX: folds 
BarUnDuck: folds 
GastonLeFort: folds 
ms1272: folds 
BollyMith: calls $0.25
llov4: checks 
*** FLOP *** [9c Ts Jh]
BollyMith: checks 
llov4: checks 
*** TURN *** [9c Ts Jh] [9s]
BollyMith: checks 
llov4: bets $1
BollyMith: calls $1
*** RIVER *** [9c Ts Jh 9s] [6h]
BollyMith: checks 
llov4: bets $2.50
BollyMith: calls $2.50
*** SHOW DOWN ***
llov4: shows [2h 8s] (a pair of Nines)
BollyMith: shows [Kc Kh] (two pair, Kings and Nines)
BollyMith collected $7.60 from pot
*** SUMMARY ***
Total pot $8 | Rake $0.40 
Board [9c Ts Jh 9s 6h]
Seat 1: GastonLeFort folded before Flop (didn't bet)
Seat 2: ms1272 (button) folded before Flop (didn't bet)
Seat 3: BollyMith (small blind) showed [Kc Kh] and won ($7.60) with two pair, Kings and Nines
Seat 4: llov4 (big blind) showed [2h 8s] and lost with a pair of Nines
Seat 5: Xamil666 folded before Flop (didn't bet)
Seat 6: KARANN899 folded before Flop (didn't bet)
Seat 7: daria130399 folded before Flop (didn't bet)
Seat 8: PanicJX folded before Flop (didn't bet)
Seat 9: BarUnDuck folded before Flop (didn't bet)



PokerStars Hand #228693650100:  Hold'em No Limit ($0.25/$0.50 USD) - 2021/07/30 19:55:19 ET
Table 'Aitne III' 9-max Seat #3 is the button
Seat 1: GastonLeFort ($50 in chips) 
Seat 2: ms1272 ($64.09 in chips) 
Seat 3: BollyMith ($40.34 in chips) 
Seat 4: llov4 ($19.29 in chips) 
Seat 5: Xamil666 ($69.47 in chips) 
Seat 6: KARANN899 ($73.94 in chips) 
Seat 7: daria130399 ($50 in chips) 
Seat 8: PanicJX ($39.58 in chips) 
Seat 9: BarUnDuck ($22.49 in chips) 
llov4: posts small blind $0.25
Xamil666: posts big blind $0.50
*** HOLE CARDS ***
KARANN899: folds 
daria130399: folds 
PanicJX: folds 
BarUnDuck: folds 
GastonLeFort: folds 
ms1272: raises $0.50 to $1
BollyMith: folds 
llov4: folds 
Xamil666: calls $0.50
*** FLOP *** [3d Ad Qd]
Xamil666: checks 
ms1272: bets $1.07
Xamil666: folds 
Uncalled bet ($1.07) returned to ms1272
ms1272 collected $2.11 from pot
ms1272: doesn't show hand 
*** SUMMARY ***
Total pot $2.25 | Rake $0.14 
Board [3d Ad Qd]
Seat 1: GastonLeFort folded before Flop (didn't bet)
Seat 2: ms1272 collected ($2.11)
Seat 3: BollyMith (button) folded before Flop (didn't bet)
Seat 4: llov4 (small blind) folded before Flop
Seat 5: Xamil666 (big blind) folded on the Flop
Seat 6: KARANN899 folded before Flop (didn't bet)
Seat 7: daria130399 folded before Flop (didn't bet)
Seat 8: PanicJX folded before Flop (didn't bet)
Seat 9: BarUnDuck folded before Flop (didn't bet)



PokerStars Hand #228693657765:  Hold'em No Limit ($0.25/$0.50 USD) - 2021/07/30 19:55:49 ET
Table 'Aitne III' 9-max Seat #4 is the button
Seat 1: GastonLeFort ($50 in chips) 
Seat 2: ms1272 ($65.20 in chips) 
Seat 3: BollyMith ($40.34 in chips) 
Seat 4: llov4 ($19.04 in chips) 
Seat 5: Xamil666 ($68.47 in chips) 
Seat 6: KARANN899 ($73.94 in chips) 
Seat 7: daria130399 ($50 in chips) 
Seat 8: PanicJX ($39.58 in chips) 
Seat 9: BarUnDuck ($22.49 in chips) 
Xamil666: posts small blind $0.25
KARANN899: posts big blind $0.50
*** HOLE CARDS ***
daria130399: folds 
PanicJX: raises $0.75 to $1.25
BarUnDuck: folds 
GastonLeFort: folds 
ms1272: calls $1.25
BollyMith: folds 
llov4: calls $1.25
Xamil666: folds 
KARANN899: calls $0.75
*** FLOP *** [Jc 8h 2s]
KARANN899: checks 
PanicJX: bets $1.65
ms1272: folds 
llov4: folds 
KARANN899: calls $1.65
*** TURN *** [Jc 8h 2s] [9h]
KARANN899: checks 
PanicJX: bets $8.12
KARANN899: folds 
Uncalled bet ($8.12) returned to PanicJX
PanicJX collected $8.12 from pot
PanicJX: doesn't show hand 
*** SUMMARY ***
Total pot $8.55 | Rake $0.43 
Board [Jc 8h 2s 9h]
Seat 1: GastonLeFort folded before Flop (didn't bet)
Seat 2: ms1272 folded on the Flop
Seat 3: BollyMith folded before Flop (didn't bet)
Seat 4: llov4 (button) folded on the Flop
Seat 5: Xamil666 (small blind) folded before Flop
Seat 6: KARANN899 (big blind) folded on the Turn
Seat 7: daria130399 folded before Flop (didn't bet)
Seat 8: PanicJX collected ($8.12)
Seat 9: BarUnDuck folded before Flop (didn't bet)



PokerStars Hand #228693668964:  Hold'em No Limit ($0.25/$0.50 USD) - 2021/07/30 19:56:34 ET
Table 'Aitne III' 9-max Seat #5 is the button
Seat 1: GastonLeFort ($50 in chips) 
Seat 2: ms1272 ($63.95 in chips) 
Seat 3: BollyMith ($40.34 in chips) 
Seat 4: llov4 ($17.79 in chips) 
Seat 5: Xamil666 ($68.22 in chips) 
Seat 6: KARANN899 ($71.04 in chips) 
Seat 8: PanicJX ($44.80 in chips) 
Seat 9: BarUnDuck ($22.49 in chips) 
KARANN899: posts small blind $0.25
daria130399: is sitting out 
PanicJX: posts big blind $0.50
*** HOLE CARDS ***
BarUnDuck: folds 
GastonLeFort: folds 
ms1272: raises $0.50 to $1
BollyMith: calls $1
llov4: folds 
Xamil666: folds 
KARANN899: folds 
PanicJX: folds 
*** FLOP *** [Kh Ts Qd]
ms1272: checks 
BollyMith: bets $0.91
ms1272: calls $0.91
*** TURN *** [Kh Ts Qd] [9c]
ms1272: checks 
BollyMith: checks 
*** RIVER *** [Kh Ts Qd 9c] [6s]
ms1272: bets $2.17
BollyMith: calls $2.17
*** SHOW DOWN ***
ms1272: shows [Jd Jc] (a straight, Nine to King)
BollyMith: shows [Jh Kc] (a straight, Nine to King)
ms1272 collected $4.17 from pot
BollyMith collected $4.23 from pot
*** SUMMARY ***
Total pot $8.91 | Rake $0.51 
Board [Kh Ts Qd 9c 6s]
Seat 1: GastonLeFort folded before Flop (didn't bet)
Seat 2: ms1272 showed [Jd Jc] and won ($4.17) with a straight, Nine to King
Seat 3: BollyMith showed [Jh Kc] and won ($4.23) with a straight, Nine to King
Seat 4: llov4 folded before Flop (didn't bet)
Seat 5: Xamil666 (button) folded before Flop (didn't bet)
Seat 6: KARANN899 (small blind) folded before Flop
Seat 8: PanicJX (big blind) folded before Flop
Seat 9: BarUnDuck folded before Flop (didn't bet)



PokerStars Hand #228693682154:  Hold'em No Limit ($0.25/$0.50 USD) - 2021/07/30 19:57:27 ET
Table 'Aitne III' 9-max Seat #6 is the button
Seat 1: GastonLeFort ($50 in chips) 
Seat 2: ms1272 ($64.04 in chips) 
Seat 3: BollyMith ($40.49 in chips) 
Seat 4: llov4 ($17.79 in chips) 
Seat 5: Xamil666 ($68.22 in chips) 
Seat 6: KARANN899 ($70.79 in chips) 
Seat 8: PanicJX ($44.30 in chips) 
PanicJX: posts small blind $0.25
GastonLeFort: posts big blind $0.50
*** HOLE CARDS ***
ms1272: folds 
BollyMith: raises $0.60 to $1.10
llov4: calls $1.10
Xamil666: folds 
KARANN899: raises $4.40 to $5.50
PanicJX: folds 
GastonLeFort: folds 
BollyMith: folds 
llov4: folds 
Uncalled bet ($4.40) returned to KARANN899
KARANN899 collected $4.05 from pot
KARANN899: doesn't show hand 
*** SUMMARY ***
Total pot $4.05 | Rake $0 
Seat 1: GastonLeFort (big blind) folded before Flop
Seat 2: ms1272 folded before Flop (didn't bet)
Seat 3: BollyMith folded before Flop
Seat 4: llov4 folded before Flop
Seat 5: Xamil666 folded before Flop (didn't bet)
Seat 6: KARANN899 (button) collected ($4.05)
Seat 8: PanicJX (small blind) folded before Flop



PokerStars Hand #228693688652:  Hold'em No Limit ($0.25/$0.50 USD) - 2021/07/30 19:57:53 ET
Table 'Aitne III' 9-max Seat #8 is the button
Seat 1: GastonLeFort ($50 in chips) 
Seat 2: ms1272 ($64.04 in chips) 
Seat 3: BollyMith ($39.39 in chips) 
Seat 4: llov4 ($16.69 in chips) 
Seat 5: Xamil666 ($68.22 in chips) 
Seat 6: KARANN899 ($73.74 in chips) 
Seat 8: PanicJX ($44.05 in chips) 
GastonLeFort: posts small blind $0.25
ms1272: posts big blind $0.50
*** HOLE CARDS ***
BollyMith: folds 
llov4: folds 
Xamil666: folds 
KARANN899: folds 
PanicJX: folds 
GastonLeFort: folds 
Uncalled bet ($0.25) returned to ms1272
ms1272 collected $0.50 from pot
ms1272: doesn't show hand 
*** SUMMARY ***
Total pot $0.50 | Rake $0 
Seat 1: GastonLeFort (small blind) folded before Flop
Seat 2: ms1272 (big blind) collected ($0.50)
Seat 3: BollyMith folded before Flop (didn't bet)
Seat 4: llov4 folded before Flop (didn't bet)
Seat 5: Xamil666 folded before Flop (didn't bet)
Seat 6: KARANN899 folded before Flop (didn't bet)
Seat 8: PanicJX (button) folded before Flop (didn't bet)



PokerStars Hand #228693690839:  Hold'em No Limit ($0.25/$0.50 USD) - 2021/07/30 19:58:02 ET
Table 'Aitne III' 9-max Seat #1 is the button
Seat 1: GastonLeFort ($50 in chips) 
Seat 2: ms1272 ($64.29 in chips) 
Seat 3: BollyMith ($39.39 in chips) 
Seat 4: llov4 ($16.69 in chips) 
Seat 5: Xamil666 ($68.22 in chips) 
Seat 6: KARANN899 ($73.74 in chips) 
Seat 8: PanicJX ($44.05 in chips) 
ms1272: posts small blind $0.25
BollyMith: posts big blind $0.50
*** HOLE CARDS ***
llov4: folds 
Xamil666: folds 
KARANN899: raises $1 to $1.50
PanicJX: folds 
GastonLeFort: folds 
ms1272: folds 
BollyMith: folds 
Uncalled bet ($1) returned to KARANN899
KARANN899 collected $1.25 from pot
KARANN899: doesn't show hand 
*** SUMMARY ***
Total pot $1.25 | Rake $0 
Seat 1: GastonLeFort (button) folded before Flop (didn't bet)
Seat 2: ms1272 (small blind) folded before Flop
Seat 3: BollyMith (big blind) folded before Flop
Seat 4: llov4 folded before Flop (didn't bet)
Seat 5: Xamil666 folded before Flop (didn't bet)
Seat 6: KARANN899 collected ($1.25)
Seat 8: PanicJX folded before Flop (didn't bet)



PokerStars Hand #228693695205:  Hold'em No Limit ($0.25/$0.50 USD) - 2021/07/30 19:58:19 ET
Table 'Aitne III' 9-max Seat #2 is the button
Seat 1: GastonLeFort ($50 in chips) 
Seat 2: ms1272 ($64.04 in chips) 
Seat 3: BollyMith ($38.89 in chips) 
Seat 4: llov4 ($16.69 in chips) 
Seat 5: Xamil666 ($68.22 in chips) 
Seat 6: KARANN899 ($74.49 in chips) 
Seat 8: PanicJX ($44.05 in chips) 
BollyMith: posts small blind $0.25
llov4: posts big blind $0.50
*** HOLE CARDS ***
Xamil666: folds 
KARANN899: folds 
PanicJX: folds 
GastonLeFort: folds 
ms1272: raises $0.50 to $1
BollyMith: folds 
llov4: calls $0.50
*** FLOP *** [4h 6h 7h]
llov4: checks 
ms1272: bets $1.07
llov4: calls $1.07
*** TURN *** [4h 6h 7h] [5d]
llov4: checks 
ms1272: checks 
*** RIVER *** [4h 6h 7h 5d] [7c]
llov4: bets $3.50
ms1272: calls $3.50
*** SHOW DOWN ***
llov4: shows [3h As] (a straight, Three to Seven)
ms1272: shows [3s Qs] (a straight, Three to Seven)
llov4 collected $5.41 from pot
ms1272 collected $5.34 from pot
*** SUMMARY ***
Total pot $11.39 | Rake $0.64 
Board [4h 6h 7h 5d 7c]
Seat 1: GastonLeFort folded before Flop (didn't bet)
Seat 2: ms1272 (button) showed [3s Qs] and won ($5.34) with a straight, Three to Seven
Seat 3: BollyMith (small blind) folded before Flop
Seat 4: llov4 (big blind) showed [3h As] and won ($5.41) with a straight, Three to Seven
Seat 5: Xamil666 folded before Flop (didn't bet)
Seat 6: KARANN899 folded before Flop (didn't bet)
Seat 8: PanicJX folded before Flop (didn't bet)



PokerStars Hand #228693703743:  Hold'em No Limit ($0.25/$0.50 USD) - 2021/07/30 19:58:53 ET
Table 'Aitne III' 9-max Seat #3 is the button
Seat 1: GastonLeFort ($50 in chips) 
Seat 2: ms1272 ($63.81 in chips) 
Seat 3: BollyMith ($38.64 in chips) 
Seat 4: llov4 ($16.53 in chips) 
Seat 5: Xamil666 ($68.22 in chips) 
Seat 6: KARANN899 ($74.49 in chips) 
Seat 8: PanicJX ($44.05 in chips) 
llov4: posts small blind $0.25
Xamil666: posts big blind $0.50
*** HOLE CARDS ***
KARANN899: raises $0.50 to $1
PanicJX: folds 
GastonLeFort: folds 
ms1272: folds 
BollyMith: folds 
llov4: folds 
Xamil666: folds 
Uncalled bet ($0.50) returned to KARANN899
KARANN899 collected $1.25 from pot
KARANN899: doesn't show hand 
*** SUMMARY ***
Total pot $1.25 | Rake $0 
Seat 1: GastonLeFort folded before Flop (didn't bet)
Seat 2: ms1272 folded before Flop (didn't bet)
Seat 3: BollyMith (button) folded before Flop (didn't bet)
Seat 4: llov4 (small blind) folded before Flop
Seat 5: Xamil666 (big blind) folded before Flop
Seat 6: KARANN899 collected ($1.25)
Seat 8: PanicJX folded before Flop (didn't bet)



PokerStars Hand #228693707066:  Hold'em No Limit ($0.25/$0.50 USD) - 2021/07/30 19:59:06 ET
Table 'Aitne III' 9-max Seat #4 is the button
Seat 1: GastonLeFort ($50 in chips) 
Seat 2: ms1272 ($63.81 in chips) 
Seat 3: BollyMith ($38.64 in chips) 
Seat 4: llov4 ($16.28 in chips) 
Seat 5: Xamil666 ($67.72 in chips) 
Seat 6: KARANN899 ($75.24 in chips) 
Seat 8: PanicJX ($44.05 in chips) 
Xamil666: posts small blind $0.25
KARANN899: posts big blind $0.50
*** HOLE CARDS ***
PanicJX: folds 
GastonLeFort: folds 
ms1272: folds 
BollyMith: folds 
llov4: folds 
Xamil666: folds 
Uncalled bet ($0.25) returned to KARANN899
KARANN899 collected $0.50 from pot
KARANN899: doesn't show hand 
*** SUMMARY ***
Total pot $0.50 | Rake $0 
Seat 1: GastonLeFort folded before Flop (didn't bet)
Seat 2: ms1272 folded before Flop (didn't bet)
Seat 3: BollyMith folded before Flop (didn't bet)
Seat 4: llov4 (button) folded before Flop (didn't bet)
Seat 5: Xamil666 (small blind) folded before Flop
Seat 6: KARANN899 (big blind) collected ($0.50)
Seat 8: PanicJX folded before Flop (didn't bet)



PokerStars Hand #228693711320:  Hold'em No Limit ($0.25/$0.50 USD) - 2021/07/30 19:59:23 ET
Table 'Aitne III' 9-max Seat #5 is the button
Seat 1: GastonLeFort ($50 in chips) 
Seat 2: ms1272 ($63.81 in chips) 
Seat 3: BollyMith ($38.64 in chips) 
Seat 4: llov4 ($16.28 in chips) 
Seat 5: Xamil666 ($67.47 in chips) 
Seat 6: KARANN899 ($75.49 in chips) 
Seat 8: PanicJX ($44.05 in chips) 
KARANN899: posts small blind $0.25
PanicJX: posts big blind $0.50
*** HOLE CARDS ***
GastonLeFort: folds 
ms1272: folds 
BollyMith: raises $0.60 to $1.10
llov4: calls $1.10
Xamil666: raises $3.40 to $4.50
KARANN899: raises $10.50 to $15
PanicJX: folds 
BollyMith: folds 
llov4: folds 
Xamil666: folds 
Uncalled bet ($10.50) returned to KARANN899
KARANN899 collected $11.70 from pot
KARANN899: doesn't show hand 
*** SUMMARY ***
Total pot $11.70 | Rake $0 
Seat 1: GastonLeFort folded before Flop (didn't bet)
Seat 2: ms1272 folded before Flop (didn't bet)
Seat 3: BollyMith folded before Flop
Seat 4: llov4 folded before Flop
Seat 5: Xamil666 (button) folded before Flop
Seat 6: KARANN899 (small blind) collected ($11.70)
Seat 8: PanicJX (big blind) folded before Flop



PokerStars Hand #228693719709:  Hold'em No Limit ($0.25/$0.50 USD) - 2021/07/30 19:59:57 ET
Table 'Aitne III' 9-max Seat #6 is the button
Seat 1: GastonLeFort ($50 in chips) 
Seat 2: ms1272 ($63.81 in chips) 
Seat 3: BollyMith ($37.54 in chips) 
Seat 4: llov4 ($15.18 in chips) 
Seat 5: Xamil666 ($62.97 in chips) 
Seat 6: KARANN899 ($82.69 in chips) 
Seat 8: PanicJX ($43.55 in chips) 
PanicJX: posts small blind $0.25
GastonLeFort: posts big blind $0.50
*** HOLE CARDS ***
ms1272: folds 
BollyMith has timed out
BollyMith: folds 
llov4: folds 
Xamil666: folds 
KARANN899: raises $0.75 to $1.25
PanicJX: folds 
GastonLeFort: folds 
Uncalled bet ($0.75) returned to KARANN899
KARANN899 collected $1.25 from pot
KARANN899: doesn't show hand 
*** SUMMARY ***
Total pot $1.25 | Rake $0 
Seat 1: GastonLeFort (big blind) folded before Flop
Seat 2: ms1272 folded before Flop (didn't bet)
Seat 3: BollyMith folded before Flop (didn't bet)
Seat 4: llov4 folded before Flop (didn't bet)
Seat 5: Xamil666 folded before Flop (didn't bet)
Seat 6: KARANN899 (button) collected ($1.25)
Seat 8: PanicJX (small blind) folded before Flop



PokerStars Hand #228693727831:  Hold'em No Limit ($0.25/$0.50 USD) - 2021/07/30 20:00:28 ET
Table 'Aitne III' 9-max Seat #8 is the button
Seat 1: GastonLeFort ($50 in chips) 
Seat 3: BollyMith ($37.54 in chips) 
Seat 4: llov4 ($15.18 in chips) 
Seat 5: Xamil666 ($62.97 in chips) 
Seat 6: KARANN899 ($83.44 in chips) 
Seat 8: PanicJX ($43.30 in chips) 
GastonLeFort: posts small blind $0.25
ms1272 has timed out
ms1272: is sitting out 
BollyMith: posts big blind $0.50
daria130399: sits out 
*** HOLE CARDS ***
llov4: folds 
Xamil666: folds 
KARANN899: folds 
PanicJX: raises $0.75 to $1.25
GastonLeFort: folds 
BollyMith: folds 
Uncalled bet ($0.75) returned to PanicJX
ms1272 is disconnected 
PanicJX collected $1.25 from pot
*** SUMMARY ***
Total pot $1.25 | Rake $0 
Seat 1: GastonLeFort (small blind) folded before Flop
Seat 3: BollyMith (big blind) folded before Flop
Seat 4: llov4 folded before Flop (didn't bet)
Seat 5: Xamil666 folded before Flop (didn't bet)
Seat 6: KARANN899 folded before Flop (didn't bet)
Seat 8: PanicJX (button) collected ($1.25)



PokerStars Hand #228693734217:  Hold'em No Limit ($0.25/$0.50 USD) - 2021/07/30 20:00:52 ET
Table 'Aitne III' 9-max Seat #1 is the button
Seat 1: GastonLeFort ($50 in chips) 
Seat 3: BollyMith ($37.04 in chips) 
Seat 4: llov4 ($15.18 in chips) 
Seat 5: Xamil666 ($62.97 in chips) 
Seat 6: KARANN899 ($83.44 in chips) 
Seat 8: PanicJX ($44.05 in chips) 
BollyMith: posts small blind $0.25
llov4: posts big blind $0.50
daria130399: sits out 
*** HOLE CARDS ***
Xamil666: folds 
KARANN899: folds 
PanicJX: folds 
GastonLeFort: folds 
BollyMith: calls $0.25
llov4: checks 
*** FLOP *** [4c 7h 9s]
BollyMith: checks 
llov4: checks 
*** TURN *** [4c 7h 9s] [7c]
BollyMith: checks 
llov4: checks 
*** RIVER *** [4c 7h 9s 7c] [6c]
BollyMith: checks 
llov4: bets $1.50
BollyMith: calls $1.50
*** SHOW DOWN ***
llov4: shows [2c Kc] (a flush, King high)
BollyMith: mucks hand 
llov4 collected $3.80 from pot
*** SUMMARY ***
Total pot $4 | Rake $0.20 
Board [4c 7h 9s 7c 6c]
Seat 1: GastonLeFort (button) folded before Flop (didn't bet)
Seat 3: BollyMith (small blind) mucked
Seat 4: llov4 (big blind) showed [2c Kc] and won ($3.80) with a flush, King high
Seat 5: Xamil666 folded before Flop (didn't bet)
Seat 6: KARANN899 folded before Flop (didn't bet)
Seat 8: PanicJX folded before Flop (didn't bet)



PokerStars Hand #228691566824:  Hold'em No Limit ($0.25/$0.50 USD) - 2021/07/30 18:20:57 ET
Table 'Aitne III' 9-max Seat #5 is the button
Seat 1: Corlogiro ($50 in chips) 
Seat 2: Pachebrash ($107.87 in chips) 
Seat 3: SwissSkier ($61.32 in chips) 
Seat 4: el Fatto ($50 in chips) 
Seat 5: UPERAD ($96.50 in chips) 
Seat 6: Kahmi3105 ($292.34 in chips) 
Seat 8: oudine2 ($68.60 in chips) 
Seat 9: leooooon79 ($7.84 in chips) 
Kahmi3105: posts small blind $0.25
oudine2: posts big blind $0.50
*** HOLE CARDS ***
leooooon79: calls $0.50
Corlogiro: folds 
Pachebrash: folds 
SwissSkier: folds 
el Fatto: raises $1 to $1.50
UPERAD: folds 
Kahmi3105: folds 
oudine2: folds 
leooooon79: calls $1
*** FLOP *** [7h 5h 2s]
leooooon79: checks 
el Fatto: bets $6.75
leooooon79: folds 
Uncalled bet ($6.75) returned to el Fatto
el Fatto collected $3.56 from pot
el Fatto: doesn't show hand 
*** SUMMARY ***
Total pot $3.75 | Rake $0.19 
Board [7h 5h 2s]
Seat 1: Corlogiro folded before Flop (didn't bet)
Seat 2: Pachebrash folded before Flop (didn't bet)
Seat 3: SwissSkier folded before Flop (didn't bet)
Seat 4: el Fatto collected ($3.56)
Seat 5: UPERAD (button) folded before Flop (didn't bet)
Seat 6: Kahmi3105 (small blind) folded before Flop
Seat 8: oudine2 (big blind) folded before Flop
Seat 9: leooooon79 folded on the Flop



PokerStars Hand #228691579276:  Hold'em No Limit ($0.25/$0.50 USD) - 2021/07/30 18:21:28 ET
Table 'Aitne III' 9-max Seat #6 is the button
Seat 1: Corlogiro ($50 in chips) 
Seat 2: Pachebrash ($107.87 in chips) 
Seat 3: SwissSkier ($61.32 in chips) 
Seat 4: el Fatto ($52.06 in chips) 
Seat 5: UPERAD ($96.50 in chips) 
Seat 6: Kahmi3105 ($292.09 in chips) 
Seat 8: oudine2 ($68.10 in chips) 
Seat 9: leooooon79 ($6.34 in chips) 
oudine2: posts small blind $0.25
leooooon79: posts big blind $0.50
*** HOLE CARDS ***
Corlogiro: folds 
Pachebrash: folds 
SwissSkier: folds 
el Fatto: folds 
UPERAD: folds 
Kahmi3105: folds 
oudine2: folds 
Uncalled bet ($0.25) returned to leooooon79
leooooon79 collected $0.50 from pot
leooooon79: doesn't show hand 
*** SUMMARY ***
Total pot $0.50 | Rake $0 
Seat 1: Corlogiro folded before Flop (didn't bet)
Seat 2: Pachebrash folded before Flop (didn't bet)
Seat 3: SwissSkier folded before Flop (didn't bet)
Seat 4: el Fatto folded before Flop (didn't bet)
Seat 5: UPERAD folded before Flop (didn't bet)
Seat 6: Kahmi3105 (button) folded before Flop (didn't bet)
Seat 8: oudine2 (small blind) folded before Flop
Seat 9: leooooon79 (big blind) collected ($0.50)



PokerStars Hand #228691585944:  Hold'em No Limit ($0.25/$0.50 USD) - 2021/07/30 18:21:45 ET
Table 'Aitne III' 9-max Seat #8 is the button
Seat 2: Pachebrash ($107.87 in chips) 
Seat 3: SwissSkier ($61.32 in chips) 
Seat 4: el Fatto ($52.06 in chips) 
Seat 5: UPERAD ($96.50 in chips) 
Seat 6: Kahmi3105 ($292.09 in chips) 
Seat 8: oudine2 ($67.85 in chips) 
Seat 9: leooooon79 ($6.59 in chips) 
leooooon79: posts small blind $0.25
Corlogiro: is sitting out 
Pachebrash: posts big blind $0.50
*** HOLE CARDS ***
SwissSkier: folds 
el Fatto: folds 
Corlogiro leaves the table
UPERAD: folds 
alexrus18 joins the table at seat #1 
Kahmi3105: folds 
oudine2: folds 
leooooon79: calls $0.25
Pachebrash: checks 
*** FLOP *** [Ad 8c Ac]
leooooon79: checks 
Pachebrash: checks 
*** TURN *** [Ad 8c Ac] [4d]
leooooon79: bets $0.50
Pachebrash: folds 
Uncalled bet ($0.50) returned to leooooon79
leooooon79 collected $0.95 from pot
leooooon79: doesn't show hand 
*** SUMMARY ***
Total pot $1 | Rake $0.05 
Board [Ad 8c Ac 4d]
Seat 2: Pachebrash (big blind) folded on the Turn
Seat 3: SwissSkier folded before Flop (didn't bet)
Seat 4: el Fatto folded before Flop (didn't bet)
Seat 5: UPERAD folded before Flop (didn't bet)
Seat 6: Kahmi3105 folded before Flop (didn't bet)
Seat 8: oudine2 (button) folded before Flop (didn't bet)
Seat 9: leooooon79 (small blind) collected ($0.95)



PokerStars Hand #228691597397:  Hold'em No Limit ($0.25/$0.50 USD) - 2021/07/30 18:22:13 ET
Table 'Aitne III' 9-max Seat #9 is the button
Seat 2: Pachebrash ($107.37 in chips) 
Seat 3: SwissSkier ($61.32 in chips) 
Seat 4: el Fatto ($52.06 in chips) 
Seat 5: UPERAD ($96.50 in chips) 
Seat 6: Kahmi3105 ($292.09 in chips) 
Seat 8: oudine2 ($67.85 in chips) 
Seat 9: leooooon79 ($7.04 in chips) 
Pachebrash: posts small blind $0.25
SwissSkier: posts big blind $0.50
*** HOLE CARDS ***
el Fatto: folds 
UPERAD: raises $1 to $1.50
Kahmi3105: folds 
oudine2: folds 
leooooon79: calls $1.50
Pachebrash: folds 
SwissSkier: folds 
*** FLOP *** [9s 8c 2h]
UPERAD: checks 
leooooon79: checks 
*** TURN *** [9s 8c 2h] [7h]
UPERAD: checks 
leooooon79: checks 
*** RIVER *** [9s 8c 2h 7h] [6d]
UPERAD: checks 
leooooon79: bets $1.78
UPERAD: folds 
Uncalled bet ($1.78) returned to leooooon79
leooooon79 collected $3.56 from pot
leooooon79: doesn't show hand 
*** SUMMARY ***
Total pot $3.75 | Rake $0.19 
Board [9s 8c 2h 7h 6d]
Seat 2: Pachebrash (small blind) folded before Flop
Seat 3: SwissSkier (big blind) folded before Flop
Seat 4: el Fatto folded before Flop (didn't bet)
Seat 5: UPERAD folded on the River
Seat 6: Kahmi3105 folded before Flop (didn't bet)
Seat 8: oudine2 folded before Flop (didn't bet)
Seat 9: leooooon79 (button) collected ($3.56)



PokerStars Hand #228691609691:  Hold'em No Limit ($0.25/$0.50 USD) - 2021/07/30 18:22:44 ET
Table 'Aitne III' 9-max Seat #2 is the button
Seat 2: Pachebrash ($107.12 in chips) 
Seat 3: SwissSkier ($60.82 in chips) 
Seat 4: el Fatto ($52.06 in chips) 
Seat 5: UPERAD ($95 in chips) 
Seat 6: Kahmi3105 ($292.09 in chips) 
Seat 8: oudine2 ($67.85 in chips) 
Seat 9: leooooon79 ($9.10 in chips) 
SwissSkier: posts small blind $0.25
el Fatto: posts big blind $0.50
alexrus18: sits out 
*** HOLE CARDS ***
UPERAD: folds 
Kahmi3105: folds 
oudine2: folds 
leooooon79: calls $0.50
Pachebrash: folds 
SwissSkier: folds 
el Fatto: raises $9.25 to $9.75
leooooon79: folds 
Uncalled bet ($9.25) returned to el Fatto
el Fatto collected $1.25 from pot
el Fatto: doesn't show hand 
*** SUMMARY ***
Total pot $1.25 | Rake $0 
Seat 2: Pachebrash (button) folded before Flop (didn't bet)
Seat 3: SwissSkier (small blind) folded before Flop
Seat 4: el Fatto (big blind) collected ($1.25)
Seat 5: UPERAD folded before Flop (didn't bet)
Seat 6: Kahmi3105 folded before Flop (didn't bet)
Seat 8: oudine2 folded before Flop (didn't bet)
Seat 9: leooooon79 folded before Flop



PokerStars Hand #228691618464:  Hold'em No Limit ($0.25/$0.50 USD) - 2021/07/30 18:23:07 ET
Table 'Aitne III' 9-max Seat #3 is the button
Seat 2: Pachebrash ($107.12 in chips) 
Seat 3: SwissSkier ($60.57 in chips) 
Seat 4: el Fatto ($52.81 in chips) 
Seat 5: UPERAD ($95 in chips) 
Seat 6: Kahmi3105 ($292.09 in chips) 
Seat 8: oudine2 ($67.85 in chips) 
Seat 9: leooooon79 ($8.60 in chips) 
el Fatto: posts small blind $0.25
UPERAD: posts big blind $0.50
alexrus18: sits out 
*** HOLE CARDS ***
Kahmi3105: folds 
oudine2: folds 
leooooon79: calls $0.50
Pachebrash: folds 
SwissSkier: folds 
el Fatto: folds 
UPERAD: checks 
*** FLOP *** [Kc 7s 7c]
UPERAD: checks 
leooooon79: checks 
*** TURN *** [Kc 7s 7c] [3s]
UPERAD: bets $0.80
leooooon79: folds 
Uncalled bet ($0.80) returned to UPERAD
UPERAD collected $1.19 from pot
UPERAD: doesn't show hand 
*** SUMMARY ***
Total pot $1.25 | Rake $0.06 
Board [Kc 7s 7c 3s]
Seat 2: Pachebrash folded before Flop (didn't bet)
Seat 3: SwissSkier (button) folded before Flop (didn't bet)
Seat 4: el Fatto (small blind) folded before Flop
Seat 5: UPERAD (big blind) collected ($1.19)
Seat 6: Kahmi3105 folded before Flop (didn't bet)
Seat 8: oudine2 folded before Flop (didn't bet)
Seat 9: leooooon79 folded on the Turn



PokerStars Hand #228691626855:  Hold'em No Limit ($0.25/$0.50 USD) - 2021/07/30 18:23:28 ET
Table 'Aitne III' 9-max Seat #4 is the button
Seat 2: Pachebrash ($107.12 in chips) 
Seat 3: SwissSkier ($60.57 in chips) 
Seat 4: el Fatto ($52.56 in chips) 
Seat 5: UPERAD ($95.69 in chips) 
Seat 6: Kahmi3105 ($292.09 in chips) 
Seat 8: oudine2 ($67.85 in chips) 
Seat 9: leooooon79 ($8.10 in chips) 
UPERAD: posts small blind $0.25
Kahmi3105: posts big blind $0.50
alexrus18: sits out 
*** HOLE CARDS ***
oudine2: folds 
leooooon79: calls $0.50
Pachebrash: folds 
SwissSkier: folds 
el Fatto: folds 
UPERAD: calls $0.25
Kahmi3105: checks 
*** FLOP *** [Ks 6s 2d]
UPERAD: checks 
Kahmi3105: checks 
leooooon79: checks 
*** TURN *** [Ks 6s 2d] [6h]
UPERAD: checks 
Kahmi3105: bets $0.50
leooooon79: calls $0.50
UPERAD: folds 
*** RIVER *** [Ks 6s 2d 6h] [Jh]
Kahmi3105: bets $0.50
leooooon79: raises $1.69 to $2.19
Kahmi3105: folds 
Uncalled bet ($1.69) returned to leooooon79
leooooon79 collected $3.32 from pot
leooooon79: doesn't show hand 
*** SUMMARY ***
Total pot $3.50 | Rake $0.18 
Board [Ks 6s 2d 6h Jh]
Seat 2: Pachebrash folded before Flop (didn't bet)
Seat 3: SwissSkier folded before Flop (didn't bet)
Seat 4: el Fatto (button) folded before Flop (didn't bet)
Seat 5: UPERAD (small blind) folded on the Turn
Seat 6: Kahmi3105 (big blind) folded on the River
Seat 8: oudine2 folded before Flop (didn't bet)
Seat 9: leooooon79 collected ($3.32)



PokerStars Hand #228691652550:  Hold'em No Limit ($0.25/$0.50 USD) - 2021/07/30 18:24:33 ET
Table 'Aitne III' 9-max Seat #5 is the button
Seat 2: Pachebrash ($107.12 in chips) 
Seat 3: SwissSkier ($60.57 in chips) 
Seat 4: el Fatto ($52.56 in chips) 
Seat 5: UPERAD ($95.19 in chips) 
Seat 6: Kahmi3105 ($290.59 in chips) 
Seat 8: oudine2 ($67.85 in chips) 
Seat 9: leooooon79 ($9.92 in chips) 
Kahmi3105: posts small blind $0.25
oudine2: posts big blind $0.50
alexrus18: sits out 
*** HOLE CARDS ***
leooooon79: calls $0.50
Pachebrash: folds 
SwissSkier: folds 
el Fatto: folds 
UPERAD: folds 
Kahmi3105: folds 
oudine2: checks 
*** FLOP *** [9d 8s 9c]
oudine2: bets $0.83
leooooon79: calls $0.83
*** TURN *** [9d 8s 9c] [Qs]
oudine2: bets $1.93
leooooon79: calls $1.93
*** RIVER *** [9d 8s 9c Qs] [7c]
oudine2: bets $8.04
leooooon79: calls $6.66 and is all-in
Uncalled bet ($1.38) returned to oudine2
*** SHOW DOWN ***
oudine2: shows [9s Ac] (three of a kind, Nines)
leooooon79: shows [Jd Tc] (a straight, Eight to Queen)
leooooon79 collected $19.09 from pot
*** SUMMARY ***
Total pot $20.09 | Rake $1 
Board [9d 8s 9c Qs 7c]
Seat 2: Pachebrash folded before Flop (didn't bet)
Seat 3: SwissSkier folded before Flop (didn't bet)
Seat 4: el Fatto folded before Flop (didn't bet)
Seat 5: UPERAD (button) folded before Flop (didn't bet)
Seat 6: Kahmi3105 (small blind) folded before Flop
Seat 8: oudine2 (big blind) showed [9s Ac] and lost with three of a kind, Nines
Seat 9: leooooon79 showed [Jd Tc] and won ($19.09) with a straight, Eight to Queen



PokerStars Hand #228691673703:  Hold'em No Limit ($0.25/$0.50 USD) - 2021/07/30 18:25:26 ET
Table 'Aitne III' 9-max Seat #6 is the button
Seat 2: Pachebrash ($107.12 in chips) 
Seat 3: SwissSkier ($60.57 in chips) 
Seat 4: el Fatto ($52.56 in chips) 
Seat 5: UPERAD ($95.19 in chips) 
Seat 6: Kahmi3105 ($290.34 in chips) 
Seat 8: oudine2 ($57.93 in chips) 
Seat 9: leooooon79 ($19.09 in chips) 
oudine2: posts small blind $0.25
leooooon79: posts big blind $0.50
alexrus18: sits out 
*** HOLE CARDS ***
Pachebrash: folds 
SwissSkier: folds 
el Fatto: raises $1 to $1.50
UPERAD: folds 
Kahmi3105: calls $1.50
oudine2: folds 
leooooon79: calls $1
*** FLOP *** [Qc Ks 6c]
leooooon79: checks 
el Fatto: checks 
Kahmi3105: bets $0.50
bigned1975 was removed from the table for failing to post
bigned1975 leaves the table
leooooon79: raises $2.76 to $3.26
el Fatto: folds 
Kahmi3105: calls $2.76
*** TURN *** [Qc Ks 6c] [3s]
leooooon79: checks 
Popokluev joins the table at seat #7 
Kahmi3105: checks 
*** RIVER *** [Qc Ks 6c 3s] [Qh]
leooooon79: bets $5.35
Kahmi3105: folds 
Uncalled bet ($5.35) returned to leooooon79
leooooon79 collected $10.71 from pot
leooooon79: doesn't show hand 
*** SUMMARY ***
Total pot $11.27 | Rake $0.56 
Board [Qc Ks 6c 3s Qh]
Seat 2: Pachebrash folded before Flop (didn't bet)
Seat 3: SwissSkier folded before Flop (didn't bet)
Seat 4: el Fatto folded on the Flop
Seat 5: UPERAD folded before Flop (didn't bet)
Seat 6: Kahmi3105 (button) folded on the River
Seat 8: oudine2 (small blind) folded before Flop
Seat 9: leooooon79 (big blind) collected ($10.71)



PokerStars Hand #228691700091:  Hold'em No Limit ($0.25/$0.50 USD) - 2021/07/30 18:26:33 ET
Table 'Aitne III' 9-max Seat #8 is the button
Seat 1: alexrus18 ($50 in chips) 
Seat 2: Pachebrash ($107.12 in chips) 
Seat 3: SwissSkier ($60.57 in chips) 
Seat 4: el Fatto ($51.06 in chips) 
Seat 5: UPERAD ($95.19 in chips) 
Seat 6: Kahmi3105 ($285.58 in chips) 
Seat 8: oudine2 ($57.68 in chips) 
Seat 9: leooooon79 ($25.04 in chips) 
leooooon79: posts small blind $0.25
alexrus18: posts big blind $0.50
Popokluev: sits out 
*** HOLE CARDS ***
Pachebrash: folds 
SwissSkier: folds 
el Fatto: raises $1 to $1.50
UPERAD: folds 
Kahmi3105: calls $1.50
oudine2: folds 
leooooon79: folds 
alexrus18: folds 
*** FLOP *** [3s 7d Td]
el Fatto: checks 
Kahmi3105: checks 
*** TURN *** [3s 7d Td] [As]
el Fatto: bets $2.50
Kahmi3105: raises $2.50 to $5
el Fatto: calls $2.50
*** RIVER *** [3s 7d Td As] [5s]
el Fatto: checks 
Kahmi3105: bets $8.50
el Fatto: folds 
Uncalled bet ($8.50) returned to Kahmi3105
Kahmi3105 collected $12.89 from pot
*** SUMMARY ***
Total pot $13.75 | Rake $0.86 
Board [3s 7d Td As 5s]
Seat 1: alexrus18 (big blind) folded before Flop
Seat 2: Pachebrash folded before Flop (didn't bet)
Seat 3: SwissSkier folded before Flop (didn't bet)
Seat 4: el Fatto folded on the River
Seat 5: UPERAD folded before Flop (didn't bet)
Seat 6: Kahmi3105 collected ($12.89)
Seat 8: oudine2 (button) folded before Flop (didn't bet)
Seat 9: leooooon79 (small blind) folded before Flop



PokerStars Hand #228691732508:  Hold'em No Limit ($0.25/$0.50 USD) - 2021/07/30 18:27:42 ET
Table 'Aitne III' 9-max Seat #9 is the button
Seat 1: alexrus18 ($50 in chips) 
Seat 2: Pachebrash ($107.12 in chips) 
Seat 3: SwissSkier ($60.57 in chips) 
Seat 4: el Fatto ($50 in chips) 
Seat 5: UPERAD ($95.19 in chips) 
Seat 6: Kahmi3105 ($291.97 in chips) 
Seat 8: oudine2 ($57.68 in chips) 
Seat 9: leooooon79 ($24.79 in chips) 
alexrus18: posts small blind $0.25
Pachebrash: posts big blind $0.50
Popokluev: sits out 
*** HOLE CARDS ***
SwissSkier: folds 
el Fatto: folds 
UPERAD: raises $1 to $1.50
Kahmi3105: folds 
oudine2: folds 
leooooon79: calls $1.50
alexrus18: folds 
Pachebrash: folds 
*** FLOP *** [Kc Qc 4c]
UPERAD: bets $2.35
leooooon79: calls $2.35
*** TURN *** [Kc Qc 4c] [Ah]
UPERAD: bets $5.35
leooooon79: folds 
Uncalled bet ($5.35) returned to UPERAD
UPERAD collected $8.03 from pot
UPERAD: doesn't show hand 
*** SUMMARY ***
Total pot $8.45 | Rake $0.42 
Board [Kc Qc 4c Ah]
Seat 1: alexrus18 (small blind) folded before Flop
Seat 2: Pachebrash (big blind) folded before Flop
Seat 3: SwissSkier folded before Flop (didn't bet)
Seat 4: el Fatto folded before Flop (didn't bet)
Seat 5: UPERAD collected ($8.03)
Seat 6: Kahmi3105 folded before Flop (didn't bet)
Seat 8: oudine2 folded before Flop (didn't bet)
Seat 9: leooooon79 (button) folded on the Turn



PokerStars Hand #228691753288:  Hold'em No Limit ($0.25/$0.50 USD) - 2021/07/30 18:28:35 ET
Table 'Aitne III' 9-max Seat #1 is the button
Seat 1: alexrus18 ($50 in chips) 
Seat 2: Pachebrash ($106.62 in chips) 
Seat 3: SwissSkier ($60.57 in chips) 
Seat 4: el Fatto ($50 in chips) 
Seat 5: UPERAD ($99.37 in chips) 
Seat 6: Kahmi3105 ($291.97 in chips) 
Seat 8: oudine2 ($57.68 in chips) 
Seat 9: leooooon79 ($20.94 in chips) 
Pachebrash: posts small blind $0.25
SwissSkier: posts big blind $0.50
Popokluev: sits out 
*** HOLE CARDS ***
el Fatto: folds 
UPERAD: folds 
Kahmi3105: folds 
oudine2: folds 
leooooon79: calls $0.50
alexrus18: folds 
Pachebrash: calls $0.25
SwissSkier: checks 
*** FLOP *** [8d 7s As]
Pachebrash: checks 
SwissSkier: checks 
leooooon79: checks 
*** TURN *** [8d 7s As] [Ah]
Pachebrash: checks 
SwissSkier: checks 
leooooon79: checks 
*** RIVER *** [8d 7s As Ah] [7h]
Pachebrash: checks 
SwissSkier: checks 
leooooon79: bets $0.71
Pachebrash: folds 
SwissSkier: folds 
Uncalled bet ($0.71) returned to leooooon79
leooooon79 collected $1.42 from pot
leooooon79: doesn't show hand 
*** SUMMARY ***
Total pot $1.50 | Rake $0.08 
Board [8d 7s As Ah 7h]
Seat 1: alexrus18 (button) folded before Flop (didn't bet)
Seat 2: Pachebrash (small blind) folded on the River
Seat 3: SwissSkier (big blind) folded on the River
Seat 4: el Fatto folded before Flop (didn't bet)
Seat 5: UPERAD folded before Flop (didn't bet)
Seat 6: Kahmi3105 folded before Flop (didn't bet)
Seat 8: oudine2 folded before Flop (didn't bet)
Seat 9: leooooon79 collected ($1.42)



PokerStars Hand #228691776321:  Hold'em No Limit ($0.25/$0.50 USD) - 2021/07/30 18:29:34 ET
Table 'Aitne III' 9-max Seat #2 is the button
Seat 1: alexrus18 ($50 in chips) 
Seat 2: Pachebrash ($106.12 in chips) 
Seat 3: SwissSkier ($60.07 in chips) 
Seat 4: el Fatto ($50 in chips) 
Seat 5: UPERAD ($99.37 in chips) 
Seat 6: Kahmi3105 ($291.97 in chips) 
Seat 8: oudine2 ($57.68 in chips) 
Seat 9: leooooon79 ($21.86 in chips) 
SwissSkier: posts small blind $0.25
el Fatto: posts big blind $0.50
Popokluev: sits out 
*** HOLE CARDS ***
UPERAD: folds 
Kahmi3105: folds 
oudine2: folds 
leooooon79 has timed out
leooooon79: folds 
alexrus18: folds 
Pachebrash: raises $0.70 to $1.20
SwissSkier: calls $0.95
el Fatto: folds 
*** FLOP *** [Qh Js 6s]
SwissSkier: checks 
Pachebrash: bets $1.92
SwissSkier: calls $1.92
*** TURN *** [Qh Js 6s] [8d]
SwissSkier: checks 
Pachebrash: bets $4.75
SwissSkier: folds 
Uncalled bet ($4.75) returned to Pachebrash
Pachebrash collected $6.40 from pot
Pachebrash: doesn't show hand 
*** SUMMARY ***
Total pot $6.74 | Rake $0.34 
Board [Qh Js 6s 8d]
Seat 1: alexrus18 folded before Flop (didn't bet)
Seat 2: Pachebrash (button) collected ($6.40)
Seat 3: SwissSkier (small blind) folded on the Turn
Seat 4: el Fatto (big blind) folded before Flop
Seat 5: UPERAD folded before Flop (didn't bet)
Seat 6: Kahmi3105 folded before Flop (didn't bet)
Seat 8: oudine2 folded before Flop (didn't bet)
Seat 9: leooooon79 folded before Flop (didn't bet)



PokerStars Hand #228691803417:  Hold'em No Limit ($0.25/$0.50 USD) - 2021/07/30 18:30:42 ET
Table 'Aitne III' 9-max Seat #3 is the button
Seat 1: alexrus18 ($50 in chips) 
Seat 2: Pachebrash ($109.40 in chips) 
Seat 3: SwissSkier ($56.95 in chips) 
Seat 4: el Fatto ($50 in chips) 
Seat 5: UPERAD ($99.37 in chips) 
Seat 6: Kahmi3105 ($291.97 in chips) 
Seat 8: oudine2 ($57.68 in chips) 
Seat 9: leooooon79 ($21.86 in chips) 
el Fatto: posts small blind $0.25
UPERAD: posts big blind $0.50
Popokluev: sits out 
*** HOLE CARDS ***
Kahmi3105: folds 
oudine2: folds 
leooooon79: calls $0.50
alexrus18: folds 
Pachebrash: folds 
SwissSkier: folds 
el Fatto: folds 
UPERAD: checks 
*** FLOP *** [Jh 5c Qs]
UPERAD: checks 
leooooon79: checks 
*** TURN *** [Jh 5c Qs] [2c]
UPERAD: checks 
leooooon79: bets $0.50
UPERAD: folds 
Uncalled bet ($0.50) returned to leooooon79
leooooon79 collected $1.19 from pot
leooooon79: doesn't show hand 
*** SUMMARY ***
Total pot $1.25 | Rake $0.06 
Board [Jh 5c Qs 2c]
Seat 1: alexrus18 folded before Flop (didn't bet)
Seat 2: Pachebrash folded before Flop (didn't bet)
Seat 3: SwissSkier (button) folded before Flop (didn't bet)
Seat 4: el Fatto (small blind) folded before Flop
Seat 5: UPERAD (big blind) folded on the Turn
Seat 6: Kahmi3105 folded before Flop (didn't bet)
Seat 8: oudine2 folded before Flop (didn't bet)
Seat 9: leooooon79 collected ($1.19)



PokerStars Hand #228691816065:  Hold'em No Limit ($0.25/$0.50 USD) - 2021/07/30 18:31:13 ET
Table 'Aitne III' 9-max Seat #4 is the button
Seat 1: alexrus18 ($50 in chips) 
Seat 2: Pachebrash ($109.40 in chips) 
Seat 3: SwissSkier ($56.95 in chips) 
Seat 4: el Fatto ($50 in chips) 
Seat 5: UPERAD ($98.87 in chips) 
Seat 6: Kahmi3105 ($291.97 in chips) 
Seat 8: oudine2 ($57.68 in chips) 
Seat 9: leooooon79 ($22.55 in chips) 
UPERAD: posts small blind $0.25
Kahmi3105: posts big blind $0.50
Popokluev: sits out 
*** HOLE CARDS ***
oudine2: folds 
leooooon79: calls $0.50
alexrus18: raises $1.75 to $2.25
Pachebrash: folds 
SwissSkier has timed out
SwissSkier: folds 
el Fatto: folds 
UPERAD: folds 
Kahmi3105: folds 
leooooon79: folds 
Uncalled bet ($1.75) returned to alexrus18
alexrus18 collected $1.75 from pot
alexrus18: doesn't show hand 
*** SUMMARY ***
Total pot $1.75 | Rake $0 
Seat 1: alexrus18 collected ($1.75)
Seat 2: Pachebrash folded before Flop (didn't bet)
Seat 3: SwissSkier folded before Flop (didn't bet)
Seat 4: el Fatto (button) folded before Flop (didn't bet)
Seat 5: UPERAD (small blind) folded before Flop
Seat 6: Kahmi3105 (big blind) folded before Flop
Seat 8: oudine2 folded before Flop (didn't bet)
Seat 9: leooooon79 folded before Flop



PokerStars Hand #228691831016:  Hold'em No Limit ($0.25/$0.50 USD) - 2021/07/30 18:31:51 ET
Table 'Aitne III' 9-max Seat #5 is the button
Seat 1: alexrus18 ($51.25 in chips) 
Seat 2: Pachebrash ($109.40 in chips) 
Seat 3: SwissSkier ($56.95 in chips) 
Seat 4: el Fatto ($50 in chips) 
Seat 5: UPERAD ($98.62 in chips) 
Seat 6: Kahmi3105 ($291.47 in chips) 
Seat 7: Popokluev ($50 in chips) 
Seat 8: oudine2 ($57.68 in chips) 
Seat 9: leooooon79 ($22.05 in chips) 
Kahmi3105: posts small blind $0.25
Popokluev: posts big blind $0.50
*** HOLE CARDS ***
oudine2: raises $1 to $1.50
leooooon79: folds 
alexrus18: raises $3 to $4.50
Pachebrash: folds 
SwissSkier: folds 
el Fatto: folds 
UPERAD: folds 
Kahmi3105: folds 
Popokluev: folds 
oudine2: folds 
Uncalled bet ($3) returned to alexrus18
alexrus18 collected $3.75 from pot
alexrus18: doesn't show hand 
*** SUMMARY ***
Total pot $3.75 | Rake $0 
Seat 1: alexrus18 collected ($3.75)
Seat 2: Pachebrash folded before Flop (didn't bet)
Seat 3: SwissSkier folded before Flop (didn't bet)
Seat 4: el Fatto folded before Flop (didn't bet)
Seat 5: UPERAD (button) folded before Flop (didn't bet)
Seat 6: Kahmi3105 (small blind) folded before Flop
Seat 7: Popokluev (big blind) folded before Flop
Seat 8: oudine2 folded before Flop
Seat 9: leooooon79 folded before Flop (didn't bet)



PokerStars Hand #228691840437:  Hold'em No Limit ($0.25/$0.50 USD) - 2021/07/30 18:32:14 ET
Table 'Aitne III' 9-max Seat #6 is the button
Seat 1: alexrus18 ($53.50 in chips) 
Seat 2: Pachebrash ($109.40 in chips) 
Seat 3: SwissSkier ($56.95 in chips) 
Seat 4: el Fatto ($50 in chips) 
Seat 5: UPERAD ($98.62 in chips) 
Seat 6: Kahmi3105 ($291.22 in chips) 
Seat 7: Popokluev ($50 in chips) 
Seat 9: leooooon79 ($22.05 in chips) 
Popokluev: posts small blind $0.25
oudine2: is sitting out 
leooooon79: posts big blind $0.50
*** HOLE CARDS ***
oudine2 leaves the table
alexrus18: raises $0.75 to $1.25
Pachebrash: folds 
galina8383 joins the table at seat #8 
SwissSkier: raises $3.25 to $4.50
el Fatto: folds 
UPERAD: folds 
Kahmi3105: folds 
Popokluev: folds 
leooooon79: folds 
alexrus18: folds 
Uncalled bet ($3.25) returned to SwissSkier
SwissSkier collected $3.25 from pot
*** SUMMARY ***
Total pot $3.25 | Rake $0 
Seat 1: alexrus18 folded before Flop
Seat 2: Pachebrash folded before Flop (didn't bet)
Seat 3: SwissSkier collected ($3.25)
Seat 4: el Fatto folded before Flop (didn't bet)
Seat 5: UPERAD folded before Flop (didn't bet)
Seat 6: Kahmi3105 (button) folded before Flop (didn't bet)
Seat 7: Popokluev (small blind) folded before Flop
Seat 9: leooooon79 (big blind) folded before Flop



PokerStars Hand #228691850320:  Hold'em No Limit ($0.25/$0.50 USD) - 2021/07/30 18:32:39 ET
Table 'Aitne III' 9-max Seat #7 is the button
Seat 1: alexrus18 ($52.25 in chips) 
Seat 2: Pachebrash ($109.40 in chips) 
Seat 3: SwissSkier ($58.95 in chips) 
Seat 4: el Fatto ($50 in chips) 
Seat 5: UPERAD ($98.62 in chips) 
Seat 6: Kahmi3105 ($291.22 in chips) 
Seat 7: Popokluev ($50 in chips) 
Seat 9: leooooon79 ($21.55 in chips) 
leooooon79: posts small blind $0.25
alexrus18: posts big blind $0.50
*** HOLE CARDS ***
Pachebrash: folds 
SwissSkier: folds 
el Fatto: folds 
UPERAD: folds 
Kahmi3105: folds 
Popokluev: raises $0.75 to $1.25
leooooon79: folds 
alexrus18: folds 
Uncalled bet ($0.75) returned to Popokluev
Popokluev collected $1.25 from pot
Popokluev: doesn't show hand 
*** SUMMARY ***
Total pot $1.25 | Rake $0 
Seat 1: alexrus18 (big blind) folded before Flop
Seat 2: Pachebrash folded before Flop (didn't bet)
Seat 3: SwissSkier folded before Flop (didn't bet)
Seat 4: el Fatto folded before Flop (didn't bet)
Seat 5: UPERAD folded before Flop (didn't bet)
Seat 6: Kahmi3105 folded before Flop (didn't bet)
Seat 7: Popokluev (button) collected ($1.25)
Seat 9: leooooon79 (small blind) folded before Flop



PokerStars Hand #228691857211:  Hold'em No Limit ($0.25/$0.50 USD) - 2021/07/30 18:32:56 ET
Table 'Aitne III' 9-max Seat #9 is the button
Seat 1: alexrus18 ($51.75 in chips) 
Seat 2: Pachebrash ($109.40 in chips) 
Seat 3: SwissSkier ($58.95 in chips) 
Seat 4: el Fatto ($50 in chips) 
Seat 5: UPERAD ($98.62 in chips) 
Seat 6: Kahmi3105 ($291.22 in chips) 
Seat 7: Popokluev ($50.75 in chips) 
Seat 9: leooooon79 ($21.30 in chips) 
alexrus18: posts small blind $0.25
Pachebrash: posts big blind $0.50
galina8383: sits out 
*** HOLE CARDS ***
SwissSkier: folds 
el Fatto: folds 
UPERAD: folds 
Kahmi3105: raises $1.25 to $1.75
Popokluev: folds 
leooooon79: calls $1.75
alexrus18: folds 
Pachebrash: folds 
*** FLOP *** [Jc Tc 6d]
Kahmi3105: bets $4.04
leooooon79: calls $4.04
*** TURN *** [Jc Tc 6d] [Qc]
Kahmi3105: checks 
leooooon79: bets $5.85
Kahmi3105: folds 
Uncalled bet ($5.85) returned to leooooon79
leooooon79 collected $11.71 from pot
leooooon79: doesn't show hand 
*** SUMMARY ***
Total pot $12.33 | Rake $0.62 
Board [Jc Tc 6d Qc]
Seat 1: alexrus18 (small blind) folded before Flop
Seat 2: Pachebrash (big blind) folded before Flop
Seat 3: SwissSkier folded before Flop (didn't bet)
Seat 4: el Fatto folded before Flop (didn't bet)
Seat 5: UPERAD folded before Flop (didn't bet)
Seat 6: Kahmi3105 folded on the Turn
Seat 7: Popokluev folded before Flop (didn't bet)
Seat 9: leooooon79 (button) collected ($11.71)



PokerStars Hand #228691873732:  Hold'em No Limit ($0.25/$0.50 USD) - 2021/07/30 18:33:38 ET
Table 'Aitne III' 9-max Seat #1 is the button
Seat 1: alexrus18 ($51.50 in chips) 
Seat 2: Pachebrash ($108.90 in chips) 
Seat 3: SwissSkier ($58.95 in chips) 
Seat 4: el Fatto ($50 in chips) 
Seat 5: UPERAD ($98.62 in chips) 
Seat 6: Kahmi3105 ($285.43 in chips) 
Seat 7: Popokluev ($50.75 in chips) 
Seat 9: leooooon79 ($27.22 in chips) 
Pachebrash: posts small blind $0.25
SwissSkier: posts big blind $0.50
galina8383: sits out 
*** HOLE CARDS ***
el Fatto: raises $1 to $1.50
UPERAD: folds 
Kahmi3105: calls $1.50
Popokluev: folds 
leooooon79: calls $1.50
alexrus18: folds 
Pachebrash: folds 
SwissSkier: folds 
*** FLOP *** [3h 6c 3d]
el Fatto: bets $3.74
Kahmi3105: folds 
leooooon79: folds 
Uncalled bet ($3.74) returned to el Fatto
el Fatto collected $4.99 from pot
el Fatto: doesn't show hand 
*** SUMMARY ***
Total pot $5.25 | Rake $0.26 
Board [3h 6c 3d]
Seat 1: alexrus18 (button) folded before Flop (didn't bet)
Seat 2: Pachebrash (small blind) folded before Flop
Seat 3: SwissSkier (big blind) folded before Flop
Seat 4: el Fatto collected ($4.99)
Seat 5: UPERAD folded before Flop (didn't bet)
Seat 6: Kahmi3105 folded on the Flop
Seat 7: Popokluev folded before Flop (didn't bet)
Seat 9: leooooon79 folded on the Flop



PokerStars Hand #228691891122:  Hold'em No Limit ($0.25/$0.50 USD) - 2021/07/30 18:34:09 ET
Table 'Aitne III' 9-max Seat #2 is the button
Seat 1: alexrus18 ($51.50 in chips) 
Seat 2: Pachebrash ($108.65 in chips) 
Seat 3: SwissSkier ($58.45 in chips) 
Seat 5: UPERAD ($98.62 in chips) 
Seat 6: Kahmi3105 ($283.93 in chips) 
Seat 7: Popokluev ($50.75 in chips) 
Seat 9: leooooon79 ($25.72 in chips) 
SwissSkier: posts small blind $0.25
el Fatto: is sitting out 
UPERAD: posts big blind $0.50
galina8383: sits out 
*** HOLE CARDS ***
el Fatto leaves the table
Kahmi3105: raises $1.25 to $1.75
Popokluev: folds 
leooooon79: calls $1.75
alexrus18: folds 
Pachebrash: folds 
SwissSkier: folds 
UPERAD: folds 
*** FLOP *** [8d 7s 8s]
Kahmi3105: checks 
leooooon79: bets $2.02
Kahmi3105: folds 
Uncalled bet ($2.02) returned to leooooon79
leooooon79 collected $4.04 from pot
leooooon79: doesn't show hand 
*** SUMMARY ***
Total pot $4.25 | Rake $0.21 
Board [8d 7s 8s]
Seat 1: alexrus18 folded before Flop (didn't bet)
Seat 2: Pachebrash (button) folded before Flop (didn't bet)
Seat 3: SwissSkier (small blind) folded before Flop
Seat 5: UPERAD (big blind) folded before Flop
Seat 6: Kahmi3105 folded on the Flop
Seat 7: Popokluev folded before Flop (didn't bet)
Seat 9: leooooon79 collected ($4.04)



PokerStars Hand #228691905453:  Hold'em No Limit ($0.25/$0.50 USD) - 2021/07/30 18:34:45 ET
Table 'Aitne III' 9-max Seat #3 is the button
Seat 1: alexrus18 ($51.50 in chips) 
Seat 2: Pachebrash ($108.65 in chips) 
Seat 3: SwissSkier ($58.20 in chips) 
Seat 5: UPERAD ($98.12 in chips) 
Seat 6: Kahmi3105 ($282.18 in chips) 
Seat 7: Popokluev ($50.75 in chips) 
Seat 9: leooooon79 ($28.01 in chips) 
UPERAD: posts small blind $0.25
Kahmi3105: posts big blind $0.50
galina8383: sits out 
*** HOLE CARDS ***
Popokluev: folds 
leooooon79: calls $0.50
alexrus18: folds 
Pachebrash: folds 
SwissSkier: folds 
UPERAD: calls $0.25
Kahmi3105: checks 
*** FLOP *** [6h Jd 6s]
UPERAD: checks 
Kahmi3105: checks 
dikanmax joins the table at seat #4 
leooooon79: checks 
*** TURN *** [6h Jd 6s] [Jc]
UPERAD: checks 
Kahmi3105: checks 
leooooon79: bets $0.71
UPERAD: folds 
Kahmi3105: folds 
Uncalled bet ($0.71) returned to leooooon79
leooooon79 collected $1.42 from pot
leooooon79: doesn't show hand 
*** SUMMARY ***
Total pot $1.50 | Rake $0.08 
Board [6h Jd 6s Jc]
Seat 1: alexrus18 folded before Flop (didn't bet)
Seat 2: Pachebrash folded before Flop (didn't bet)
Seat 3: SwissSkier (button) folded before Flop (didn't bet)
Seat 5: UPERAD (small blind) folded on the Turn
Seat 6: Kahmi3105 (big blind) folded on the Turn
Seat 7: Popokluev folded before Flop (didn't bet)
Seat 9: leooooon79 collected ($1.42)



PokerStars Hand #228691917231:  Hold'em No Limit ($0.25/$0.50 USD) - 2021/07/30 18:35:14 ET
Table 'Aitne III' 9-max Seat #5 is the button
Seat 1: alexrus18 ($51.50 in chips) 
Seat 2: Pachebrash ($108.65 in chips) 
Seat 3: SwissSkier ($58.20 in chips) 
Seat 5: UPERAD ($97.62 in chips) 
Seat 6: Kahmi3105 ($281.68 in chips) 
Seat 7: Popokluev ($50.75 in chips) 
Seat 9: leooooon79 ($28.93 in chips) 
Kahmi3105: posts small blind $0.25
Popokluev: posts big blind $0.50
galina8383: sits out 
dikanmax: sits out 
*** HOLE CARDS ***
leooooon79: calls $0.50
alexrus18: folds 
Pachebrash: folds 
SwissSkier: raises $1 to $1.50
UPERAD: folds 
Kahmi3105: raises $4 to $5.50
Popokluev: folds 
leooooon79: folds 
SwissSkier: folds 
Uncalled bet ($4) returned to Kahmi3105
Kahmi3105 collected $4 from pot
*** SUMMARY ***
Total pot $4 | Rake $0 
Seat 1: alexrus18 folded before Flop (didn't bet)
Seat 2: Pachebrash folded before Flop (didn't bet)
Seat 3: SwissSkier folded before Flop
Seat 5: UPERAD (button) folded before Flop (didn't bet)
Seat 6: Kahmi3105 (small blind) collected ($4)
Seat 7: Popokluev (big blind) folded before Flop
Seat 9: leooooon79 folded before Flop



PokerStars Hand #228691931293:  Hold'em No Limit ($0.25/$0.50 USD) - 2021/07/30 18:35:50 ET
Table 'Aitne III' 9-max Seat #6 is the button
Seat 1: alexrus18 ($51.50 in chips) 
Seat 2: Pachebrash ($108.65 in chips) 
Seat 3: SwissSkier ($56.70 in chips) 
Seat 5: UPERAD ($97.62 in chips) 
Seat 6: Kahmi3105 ($284.18 in chips) 
Seat 7: Popokluev ($50.25 in chips) 
Seat 8: galina8383 ($50 in chips) 
Seat 9: leooooon79 ($28.43 in chips) 
Popokluev: posts small blind $0.25
galina8383: posts big blind $0.50
dikanmax: sits out 
*** HOLE CARDS ***
leooooon79: folds 
alexrus18: folds 
Pachebrash: folds 
SwissSkier: raises $1 to $1.50
UPERAD: folds 
Kahmi3105: folds 
Popokluev: folds 
galina8383: folds 
Uncalled bet ($1) returned to SwissSkier
SwissSkier collected $1.25 from pot
*** SUMMARY ***
Total pot $1.25 | Rake $0 
Seat 1: alexrus18 folded before Flop (didn't bet)
Seat 2: Pachebrash folded before Flop (didn't bet)
Seat 3: SwissSkier collected ($1.25)
Seat 5: UPERAD folded before Flop (didn't bet)
Seat 6: Kahmi3105 (button) folded before Flop (didn't bet)
Seat 7: Popokluev (small blind) folded before Flop
Seat 8: galina8383 (big blind) folded before Flop
Seat 9: leooooon79 folded before Flop (didn't bet)



PokerStars Hand #228691940588:  Hold'em No Limit ($0.25/$0.50 USD) - 2021/07/30 18:36:13 ET
Table 'Aitne III' 9-max Seat #7 is the button
Seat 1: alexrus18 ($51.50 in chips) 
Seat 2: Pachebrash ($108.65 in chips) 
Seat 3: SwissSkier ($57.45 in chips) 
Seat 5: UPERAD ($97.62 in chips) 
Seat 6: Kahmi3105 ($284.18 in chips) 
Seat 7: Popokluev ($50 in chips) 
Seat 8: galina8383 ($50 in chips) 
Seat 9: leooooon79 ($28.43 in chips) 
galina8383: posts small blind $0.25
leooooon79: posts big blind $0.50
dikanmax: sits out 
*** HOLE CARDS ***
alexrus18: folds 
Pachebrash: folds 
SwissSkier: folds 
UPERAD: raises $1 to $1.50
Kahmi3105: folds 
Popokluev: folds 
galina8383: raises $3.50 to $5
leooooon79: folds 
UPERAD: calls $3.50
*** FLOP *** [3d Jd 6s]
galina8383: bets $7.49
UPERAD: calls $7.49
*** TURN *** [3d Jd 6s] [8c]
galina8383: bets $12
UPERAD: folds 
Uncalled bet ($12) returned to galina8383
galina8383 collected $24.21 from pot
galina8383: doesn't show hand 
*** SUMMARY ***
Total pot $25.48 | Rake $1.27 
Board [3d Jd 6s 8c]
Seat 1: alexrus18 folded before Flop (didn't bet)
Seat 2: Pachebrash folded before Flop (didn't bet)
Seat 3: SwissSkier folded before Flop (didn't bet)
Seat 5: UPERAD folded on the Turn
Seat 6: Kahmi3105 folded before Flop (didn't bet)
Seat 7: Popokluev (button) folded before Flop (didn't bet)
Seat 8: galina8383 (small blind) collected ($24.21)
Seat 9: leooooon79 (big blind) folded before Flop



PokerStars Hand #228691968808:  Hold'em No Limit ($0.25/$0.50 USD) - 2021/07/30 18:37:24 ET
Table 'Aitne III' 9-max Seat #8 is the button
Seat 1: alexrus18 ($51.50 in chips) 
Seat 2: Pachebrash ($108.65 in chips) 
Seat 3: SwissSkier ($57.45 in chips) 
Seat 5: UPERAD ($85.13 in chips) 
Seat 6: Kahmi3105 ($284.18 in chips) 
Seat 7: Popokluev ($50 in chips) 
Seat 8: galina8383 ($61.72 in chips) 
Seat 9: leooooon79 ($27.93 in chips) 
leooooon79: posts small blind $0.25
alexrus18: posts big blind $0.50
dikanmax: sits out 
*** HOLE CARDS ***
Pachebrash: folds 
SwissSkier: folds 
UPERAD: folds 
Kahmi3105: folds 
Popokluev: raises $0.75 to $1.25
galina8383: folds 
leooooon79: calls $1
alexrus18: folds 
*** FLOP *** [Qc Jh Tc]
leooooon79: checks 
Popokluev: checks 
*** TURN *** [Qc Jh Tc] [2h]
leooooon79: bets $1.42
Popokluev: calls $1.42
*** RIVER *** [Qc Jh Tc 2h] [5h]
leooooon79: bets $2.77
Popokluev: calls $2.77
*** SHOW DOWN ***
leooooon79: shows [Kc Jd] (a pair of Jacks)
Popokluev: mucks hand 
leooooon79 collected $10.81 from pot
*** SUMMARY ***
Total pot $11.38 | Rake $0.57 
Board [Qc Jh Tc 2h 5h]
Seat 1: alexrus18 (big blind) folded before Flop
Seat 2: Pachebrash folded before Flop (didn't bet)
Seat 3: SwissSkier folded before Flop (didn't bet)
Seat 5: UPERAD folded before Flop (didn't bet)
Seat 6: Kahmi3105 folded before Flop (didn't bet)
Seat 7: Popokluev mucked
Seat 8: galina8383 (button) folded before Flop (didn't bet)
Seat 9: leooooon79 (small blind) showed [Kc Jd] and won ($10.81) with a pair of Jacks



PokerStars Hand #228691986270:  Hold'em No Limit ($0.25/$0.50 USD) - 2021/07/30 18:38:08 ET
Table 'Aitne III' 9-max Seat #9 is the button
Seat 1: alexrus18 ($51 in chips) 
Seat 2: Pachebrash ($108.65 in chips) 
Seat 3: SwissSkier ($57.45 in chips) 
Seat 5: UPERAD ($85.13 in chips) 
Seat 6: Kahmi3105 ($284.18 in chips) 
Seat 7: Popokluev ($50 in chips) 
Seat 8: galina8383 ($61.72 in chips) 
Seat 9: leooooon79 ($33.30 in chips) 
alexrus18: posts small blind $0.25
Pachebrash: posts big blind $0.50
dikanmax: sits out 
*** HOLE CARDS ***
SwissSkier: folds 
UPERAD: folds 
Kahmi3105: raises $1.25 to $1.75
Popokluev: folds 
galina8383: folds 
leooooon79: calls $1.75
alexrus18: folds 
Pachebrash: folds 
*** FLOP *** [3s Ac 8h]
Kahmi3105: bets $4.04
leooooon79: folds 
Uncalled bet ($4.04) returned to Kahmi3105
Kahmi3105 collected $3.99 from pot
*** SUMMARY ***
Total pot $4.25 | Rake $0.26 
Board [3s Ac 8h]
Seat 1: alexrus18 (small blind) folded before Flop
Seat 2: Pachebrash (big blind) folded before Flop
Seat 3: SwissSkier folded before Flop (didn't bet)
Seat 5: UPERAD folded before Flop (didn't bet)
Seat 6: Kahmi3105 collected ($3.99)
Seat 7: Popokluev folded before Flop (didn't bet)
Seat 8: galina8383 folded before Flop (didn't bet)
Seat 9: leooooon79 (button) folded on the Flop



PokerStars Hand #228692004199:  Hold'em No Limit ($0.25/$0.50 USD) - 2021/07/30 18:38:54 ET
Table 'Aitne III' 9-max Seat #1 is the button
Seat 1: alexrus18 ($50.75 in chips) 
Seat 2: Pachebrash ($108.15 in chips) 
Seat 3: SwissSkier ($57.45 in chips) 
Seat 5: UPERAD ($85.13 in chips) 
Seat 6: Kahmi3105 ($286.42 in chips) 
Seat 7: Popokluev ($50 in chips) 
Seat 8: galina8383 ($61.72 in chips) 
Seat 9: leooooon79 ($31.55 in chips) 
Pachebrash: posts small blind $0.25
SwissSkier: posts big blind $0.50
dikanmax: sits out 
*** HOLE CARDS ***
UPERAD: folds 
Kahmi3105: folds 
Popokluev: folds 
galina8383: raises $0.75 to $1.25
leooooon79: folds 
alexrus18: folds 
Pachebrash: folds 
SwissSkier: folds 
Uncalled bet ($0.75) returned to galina8383
galina8383 collected $1.25 from pot
galina8383: doesn't show hand 
*** SUMMARY ***
Total pot $1.25 | Rake $0 
Seat 1: alexrus18 (button) folded before Flop (didn't bet)
Seat 2: Pachebrash (small blind) folded before Flop
Seat 3: SwissSkier (big blind) folded before Flop
Seat 5: UPERAD folded before Flop (didn't bet)
Seat 6: Kahmi3105 folded before Flop (didn't bet)
Seat 7: Popokluev folded before Flop (didn't bet)
Seat 8: galina8383 collected ($1.25)
Seat 9: leooooon79 folded before Flop (didn't bet)



PokerStars Hand #228692015795:  Hold'em No Limit ($0.25/$0.50 USD) - 2021/07/30 18:39:23 ET
Table 'Aitne III' 9-max Seat #2 is the button
Seat 1: alexrus18 ($50.75 in chips) 
Seat 2: Pachebrash ($107.90 in chips) 
Seat 3: SwissSkier ($56.95 in chips) 
Seat 4: dikanmax ($50 in chips) 
Seat 5: UPERAD ($85.13 in chips) 
Seat 6: Kahmi3105 ($286.42 in chips) 
Seat 7: Popokluev ($50 in chips) 
Seat 8: galina8383 ($62.47 in chips) 
Seat 9: leooooon79 ($31.55 in chips) 
SwissSkier: posts small blind $0.25
dikanmax: posts big blind $0.50
*** HOLE CARDS ***
UPERAD: raises $1 to $1.50
Kahmi3105: folds 
Popokluev: folds 
galina8383: folds 
leooooon79: folds 
alexrus18: folds 
Pachebrash: folds 
SwissSkier: folds 
dikanmax: folds 
Uncalled bet ($1) returned to UPERAD
UPERAD collected $1.25 from pot
UPERAD: doesn't show hand 
*** SUMMARY ***
Total pot $1.25 | Rake $0 
Seat 1: alexrus18 folded before Flop (didn't bet)
Seat 2: Pachebrash (button) folded before Flop (didn't bet)
Seat 3: SwissSkier (small blind) folded before Flop
Seat 4: dikanmax (big blind) folded before Flop
Seat 5: UPERAD collected ($1.25)
Seat 6: Kahmi3105 folded before Flop (didn't bet)
Seat 7: Popokluev folded before Flop (didn't bet)
Seat 8: galina8383 folded before Flop (didn't bet)
Seat 9: leooooon79 folded before Flop (didn't bet)



PokerStars Hand #228692023965:  Hold'em No Limit ($0.25/$0.50 USD) - 2021/07/30 18:39:43 ET
Table 'Aitne III' 9-max Seat #3 is the button
Seat 1: alexrus18 ($50.75 in chips) 
Seat 2: Pachebrash ($107.90 in chips) 
Seat 3: SwissSkier ($56.70 in chips) 
Seat 4: dikanmax ($50 in chips) 
Seat 5: UPERAD ($85.88 in chips) 
Seat 6: Kahmi3105 ($286.42 in chips) 
Seat 7: Popokluev ($50 in chips) 
Seat 8: galina8383 ($62.47 in chips) 
Seat 9: leooooon79 ($31.55 in chips) 
dikanmax: posts small blind $0.25
UPERAD: posts big blind $0.50
*** HOLE CARDS ***
Kahmi3105: raises $1.25 to $1.75
Popokluev: folds 
galina8383: folds 
leooooon79: folds 
alexrus18: folds 
Pachebrash: folds 
SwissSkier: folds 
dikanmax: folds 
UPERAD: calls $1.25
*** FLOP *** [Tc 5s 7h]
UPERAD: checks 
Kahmi3105: bets $2.50
UPERAD: calls $2.50
*** TURN *** [Tc 5s 7h] [Qs]
UPERAD: checks 
Kahmi3105: bets $5.50
UPERAD: folds 
Uncalled bet ($5.50) returned to Kahmi3105
Kahmi3105 collected $8.20 from pot
*** SUMMARY ***
Total pot $8.75 | Rake $0.55 
Board [Tc 5s 7h Qs]
Seat 1: alexrus18 folded before Flop (didn't bet)
Seat 2: Pachebrash folded before Flop (didn't bet)
Seat 3: SwissSkier (button) folded before Flop (didn't bet)
Seat 4: dikanmax (small blind) folded before Flop
Seat 5: UPERAD (big blind) folded on the Turn
Seat 6: Kahmi3105 collected ($8.20)
Seat 7: Popokluev folded before Flop (didn't bet)
Seat 8: galina8383 folded before Flop (didn't bet)
Seat 9: leooooon79 folded before Flop (didn't bet)



PokerStars Hand #228692039821:  Hold'em No Limit ($0.25/$0.50 USD) - 2021/07/30 18:40:24 ET
Table 'Aitne III' 9-max Seat #4 is the button
Seat 1: alexrus18 ($50.75 in chips) 
Seat 2: Pachebrash ($107.90 in chips) 
Seat 3: SwissSkier ($56.70 in chips) 
Seat 4: dikanmax ($50 in chips) 
Seat 5: UPERAD ($81.63 in chips) 
Seat 6: Kahmi3105 ($290.37 in chips) 
Seat 7: Popokluev ($50 in chips) 
Seat 8: galina8383 ($62.47 in chips) 
Seat 9: leooooon79 ($31.55 in chips) 
UPERAD: posts small blind $0.25
Kahmi3105: posts big blind $0.50
*** HOLE CARDS ***
Popokluev: folds 
galina8383: folds 
leooooon79: folds 
alexrus18: folds 
Pachebrash: folds 
SwissSkier: folds 
dikanmax: raises $1 to $1.50
UPERAD: folds 
Kahmi3105: calls $1
*** FLOP *** [8c 7c 9d]
Kahmi3105: checks 
dikanmax: checks 
*** TURN *** [8c 7c 9d] [6s]
Kahmi3105: checks 
dikanmax: checks 
*** RIVER *** [8c 7c 9d 6s] [8d]
Kahmi3105: bets $0.50
dikanmax: calls $0.50
*** SHOW DOWN ***
Kahmi3105: shows [5s 4s] (a straight, Five to Nine)
dikanmax: mucks hand 
Kahmi3105 collected $3.99 from pot
*** SUMMARY ***
Total pot $4.25 | Rake $0.26 
Board [8c 7c 9d 6s 8d]
Seat 1: alexrus18 folded before Flop (didn't bet)
Seat 2: Pachebrash folded before Flop (didn't bet)
Seat 3: SwissSkier folded before Flop (didn't bet)
Seat 4: dikanmax (button) mucked
Seat 5: UPERAD (small blind) folded before Flop
Seat 6: Kahmi3105 (big blind) showed [5s 4s] and won ($3.99) with a straight, Five to Nine
Seat 7: Popokluev folded before Flop (didn't bet)
Seat 8: galina8383 folded before Flop (didn't bet)
Seat 9: leooooon79 folded before Flop (didn't bet)



PokerStars Hand #228692055586:  Hold'em No Limit ($0.25/$0.50 USD) - 2021/07/30 18:41:04 ET
Table 'Aitne III' 9-max Seat #5 is the button
Seat 1: alexrus18 ($50.75 in chips) 
Seat 2: Pachebrash ($107.90 in chips) 
Seat 3: SwissSkier ($56.70 in chips) 
Seat 4: dikanmax ($50 in chips) 
Seat 5: UPERAD ($81.38 in chips) 
Seat 6: Kahmi3105 ($292.36 in chips) 
Seat 7: Popokluev ($50 in chips) 
Seat 8: galina8383 ($62.47 in chips) 
Seat 9: leooooon79 ($31.55 in chips) 
Kahmi3105: posts small blind $0.25
Popokluev: posts big blind $0.50
*** HOLE CARDS ***
galina8383: folds 
leooooon79: folds 
alexrus18: folds 
Pachebrash: folds 
SwissSkier: raises $0.50 to $1
dikanmax: folds 
UPERAD: folds 
Kahmi3105: folds 
Popokluev: calls $0.50
*** FLOP *** [5c Qh Tc]
Popokluev: checks 
SwissSkier: checks 
*** TURN *** [5c Qh Tc] [Qc]
Popokluev: checks 
SwissSkier: checks 
*** RIVER *** [5c Qh Tc Qc] [7h]
Popokluev: bets $1.65
SwissSkier: calls $1.65
*** SHOW DOWN ***
Popokluev: shows [Ac Ts] (two pair, Queens and Tens)
SwissSkier: mucks hand 
Popokluev collected $5.27 from pot
*** SUMMARY ***
Total pot $5.55 | Rake $0.28 
Board [5c Qh Tc Qc 7h]
Seat 1: alexrus18 folded before Flop (didn't bet)
Seat 2: Pachebrash folded before Flop (didn't bet)
Seat 3: SwissSkier mucked
Seat 4: dikanmax folded before Flop (didn't bet)
Seat 5: UPERAD (button) folded before Flop (didn't bet)
Seat 6: Kahmi3105 (small blind) folded before Flop
Seat 7: Popokluev (big blind) showed [Ac Ts] and won ($5.27) with two pair, Queens and Tens
Seat 8: galina8383 folded before Flop (didn't bet)
Seat 9: leooooon79 folded before Flop (didn't bet)



PokerStars Hand #228692073720:  Hold'em No Limit ($0.25/$0.50 USD) - 2021/07/30 18:41:50 ET
Table 'Aitne III' 9-max Seat #6 is the button
Seat 1: alexrus18 ($50.75 in chips) 
Seat 2: Pachebrash ($107.90 in chips) 
Seat 3: SwissSkier ($54.05 in chips) 
Seat 4: dikanmax ($50 in chips) 
Seat 5: UPERAD ($81.38 in chips) 
Seat 6: Kahmi3105 ($292.11 in chips) 
Seat 7: Popokluev ($52.62 in chips) 
Seat 8: galina8383 ($62.47 in chips) 
Seat 9: leooooon79 ($31.55 in chips) 
Popokluev: posts small blind $0.25
galina8383: posts big blind $0.50
*** HOLE CARDS ***
leooooon79: calls $0.50
alexrus18: folds 
Pachebrash: folds 
SwissSkier: raises $1.75 to $2.25
dikanmax: folds 
UPERAD: folds 
Kahmi3105: raises $5.75 to $8
Popokluev: folds 
galina8383: folds 
leooooon79: folds 
SwissSkier: calls $5.75
*** FLOP *** [8s Kc Qc]
SwissSkier: checks 
Kahmi3105: bets $16.39
SwissSkier: calls $16.39
*** TURN *** [8s Kc Qc] [Qd]
SwissSkier: checks 
Kahmi3105: bets $267.72 and is all-in
SwissSkier: folds 
Uncalled bet ($267.72) returned to Kahmi3105
Kahmi3105 collected $47.53 from pot
*** SUMMARY ***
Total pot $50.03 | Rake $2.50 
Board [8s Kc Qc Qd]
Seat 1: alexrus18 folded before Flop (didn't bet)
Seat 2: Pachebrash folded before Flop (didn't bet)
Seat 3: SwissSkier folded on the Turn
Seat 4: dikanmax folded before Flop (didn't bet)
Seat 5: UPERAD folded before Flop (didn't bet)
Seat 6: Kahmi3105 (button) collected ($47.53)
Seat 7: Popokluev (small blind) folded before Flop
Seat 8: galina8383 (big blind) folded before Flop
Seat 9: leooooon79 folded before Flop



PokerStars Hand #228692096089:  Hold'em No Limit ($0.25/$0.50 USD) - 2021/07/30 18:42:48 ET
Table 'Aitne III' 9-max Seat #7 is the button
Seat 1: alexrus18 ($50.75 in chips) 
Seat 2: Pachebrash ($107.90 in chips) 
Seat 3: SwissSkier ($29.66 in chips) 
Seat 4: dikanmax ($50 in chips) 
Seat 5: UPERAD ($81.38 in chips) 
Seat 6: Kahmi3105 ($315.25 in chips) 
Seat 7: Popokluev ($52.37 in chips) 
Seat 8: galina8383 ($61.97 in chips) 
Seat 9: leooooon79 ($31.05 in chips) 
galina8383: posts small blind $0.25
leooooon79: posts big blind $0.50
*** HOLE CARDS ***
alexrus18: folds 
Pachebrash: raises $1 to $1.50
SwissSkier: folds 
dikanmax: folds 
UPERAD: folds 
Kahmi3105: folds 
Popokluev: folds 
galina8383: folds 
leooooon79: calls $1
*** FLOP *** [3c 2c 6c]
leooooon79: checks 
Pachebrash: bets $1.58
leooooon79: calls $1.58
*** TURN *** [3c 2c 6c] [Kh]
leooooon79: bets $3.04
Pachebrash: calls $3.04
*** RIVER *** [3c 2c 6c Kh] [Ts]
leooooon79: bets $5.93
Pachebrash: folds 
Uncalled bet ($5.93) returned to leooooon79
leooooon79 collected $11.87 from pot
leooooon79: doesn't show hand 
*** SUMMARY ***
Total pot $12.49 | Rake $0.62 
Board [3c 2c 6c Kh Ts]
Seat 1: alexrus18 folded before Flop (didn't bet)
Seat 2: Pachebrash folded on the River
Seat 3: SwissSkier folded before Flop (didn't bet)
Seat 4: dikanmax folded before Flop (didn't bet)
Seat 5: UPERAD folded before Flop (didn't bet)
Seat 6: Kahmi3105 folded before Flop (didn't bet)
Seat 7: Popokluev (button) folded before Flop (didn't bet)
Seat 8: galina8383 (small blind) folded before Flop
Seat 9: leooooon79 (big blind) collected ($11.87)



PokerStars Hand #228692117575:  Hold'em No Limit ($0.25/$0.50 USD) - 2021/07/30 18:43:43 ET
Table 'Aitne III' 9-max Seat #8 is the button
Seat 1: alexrus18 ($50.75 in chips) 
Seat 2: Pachebrash ($101.78 in chips) 
Seat 3: SwissSkier ($29.66 in chips) 
Seat 4: dikanmax ($50 in chips) 
Seat 5: UPERAD ($81.38 in chips) 
Seat 6: Kahmi3105 ($315.25 in chips) 
Seat 7: Popokluev ($52.37 in chips) 
Seat 8: galina8383 ($61.72 in chips) 
Seat 9: leooooon79 ($36.80 in chips) 
leooooon79: posts small blind $0.25
alexrus18: posts big blind $0.50
*** HOLE CARDS ***
Pachebrash: folds 
SwissSkier: folds 
dikanmax: folds 
UPERAD: folds 
Kahmi3105: folds 
Popokluev: folds 
galina8383: folds 
leooooon79: calls $0.25
alexrus18: checks 
*** FLOP *** [As 3h 6s]
leooooon79: checks 
alexrus18: checks 
*** TURN *** [As 3h 6s] [9d]
leooooon79: bets $0.50
alexrus18: folds 
Uncalled bet ($0.50) returned to leooooon79
leooooon79 collected $0.95 from pot
leooooon79: doesn't show hand 
*** SUMMARY ***
Total pot $1 | Rake $0.05 
Board [As 3h 6s 9d]
Seat 1: alexrus18 (big blind) folded on the Turn
Seat 2: Pachebrash folded before Flop (didn't bet)
Seat 3: SwissSkier folded before Flop (didn't bet)
Seat 4: dikanmax folded before Flop (didn't bet)
Seat 5: UPERAD folded before Flop (didn't bet)
Seat 6: Kahmi3105 folded before Flop (didn't bet)
Seat 7: Popokluev folded before Flop (didn't bet)
Seat 8: galina8383 (button) folded before Flop (didn't bet)
Seat 9: leooooon79 (small blind) collected ($0.95)



PokerStars Hand #228692132703:  Hold'em No Limit ($0.25/$0.50 USD) - 2021/07/30 18:44:22 ET
Table 'Aitne III' 9-max Seat #9 is the button
Seat 1: alexrus18 ($50.25 in chips) 
Seat 2: Pachebrash ($101.78 in chips) 
Seat 3: SwissSkier ($29.66 in chips) 
Seat 4: dikanmax ($50 in chips) 
Seat 5: UPERAD ($81.38 in chips) 
Seat 6: Kahmi3105 ($315.25 in chips) 
Seat 7: Popokluev ($52.37 in chips) 
Seat 8: galina8383 ($61.72 in chips) 
Seat 9: leooooon79 ($37.25 in chips) 
alexrus18: posts small blind $0.25
Pachebrash: posts big blind $0.50
*** HOLE CARDS ***
SwissSkier: folds 
dikanmax: folds 
UPERAD: folds 
Kahmi3105: raises $1.25 to $1.75
Popokluev: folds 
galina8383: folds 
leooooon79: folds 
alexrus18: folds 
Pachebrash: folds 
Uncalled bet ($1.25) returned to Kahmi3105
Kahmi3105 collected $1.25 from pot
*** SUMMARY ***
Total pot $1.25 | Rake $0 
Seat 1: alexrus18 (small blind) folded before Flop
Seat 2: Pachebrash (big blind) folded before Flop
Seat 3: SwissSkier folded before Flop (didn't bet)
Seat 4: dikanmax folded before Flop (didn't bet)
Seat 5: UPERAD folded before Flop (didn't bet)
Seat 6: Kahmi3105 collected ($1.25)
Seat 7: Popokluev folded before Flop (didn't bet)
Seat 8: galina8383 folded before Flop (didn't bet)
Seat 9: leooooon79 (button) folded before Flop (didn't bet)



PokerStars Hand #228692145244:  Hold'em No Limit ($0.25/$0.50 USD) - 2021/07/30 18:44:54 ET
Table 'Aitne III' 9-max Seat #1 is the button
Seat 1: alexrus18 ($50 in chips) 
Seat 2: Pachebrash ($101.28 in chips) 
Seat 5: UPERAD ($81.38 in chips) 
Seat 6: Kahmi3105 ($316 in chips) 
Seat 7: Popokluev ($52.37 in chips) 
Seat 8: galina8383 ($61.72 in chips) 
Seat 9: leooooon79 ($37.25 in chips) 
Pachebrash: posts small blind $0.25
SwissSkier: is sitting out 
dikanmax: is sitting out 
UPERAD: posts big blind $0.50
*** HOLE CARDS ***
dikanmax leaves the table
Kahmi3105: calls $0.50
An1an1 joins the table at seat #4 
Popokluev: folds 
galina8383: folds 
leooooon79: calls $0.50
alexrus18: raises $2.50 to $3
Pachebrash: folds 
UPERAD: folds 
SwissSkier leaves the table
Kahmi3105: calls $2.50
mazefaka007 joins the table at seat #3 
leooooon79: calls $2.50
*** FLOP *** [3h Kh 7c]
Kahmi3105: checks 
leooooon79: checks 
alexrus18: bets $6.11
Kahmi3105: folds 
leooooon79: folds 
Uncalled bet ($6.11) returned to alexrus18
alexrus18 collected $9.26 from pot
alexrus18: doesn't show hand 
*** SUMMARY ***
Total pot $9.75 | Rake $0.49 
Board [3h Kh 7c]
Seat 1: alexrus18 (button) collected ($9.26)
Seat 2: Pachebrash (small blind) folded before Flop
Seat 5: UPERAD (big blind) folded before Flop
Seat 6: Kahmi3105 folded on the Flop
Seat 7: Popokluev folded before Flop (didn't bet)
Seat 8: galina8383 folded before Flop (didn't bet)
Seat 9: leooooon79 folded on the Flop



PokerStars Hand #228692171081:  Hold'em No Limit ($0.25/$0.50 USD) - 2021/07/30 18:46:01 ET
Table 'Aitne III' 9-max Seat #2 is the button
Seat 1: alexrus18 ($56.26 in chips) 
Seat 2: Pachebrash ($101.03 in chips) 
Seat 5: UPERAD ($80.88 in chips) 
Seat 6: Kahmi3105 ($313 in chips) 
Seat 7: Popokluev ($52.37 in chips) 
Seat 8: galina8383 ($61.72 in chips) 
Seat 9: leooooon79 ($34.25 in chips) 
UPERAD: posts small blind $0.25
Kahmi3105: posts big blind $0.50
*** HOLE CARDS ***
Popokluev: folds 
galina8383: folds 
leooooon79: folds 
alexrus18: folds 
Pachebrash: folds 
UPERAD: raises $1 to $1.50
Kahmi3105: folds 
Uncalled bet ($1) returned to UPERAD
UPERAD collected $1 from pot
UPERAD: doesn't show hand 
*** SUMMARY ***
Total pot $1 | Rake $0 
Seat 1: alexrus18 folded before Flop (didn't bet)
Seat 2: Pachebrash (button) folded before Flop (didn't bet)
Seat 5: UPERAD (small blind) collected ($1)
Seat 6: Kahmi3105 (big blind) folded before Flop
Seat 7: Popokluev folded before Flop (didn't bet)
Seat 8: galina8383 folded before Flop (didn't bet)
Seat 9: leooooon79 folded before Flop (didn't bet)



PokerStars Hand #228692176772:  Hold'em No Limit ($0.25/$0.50 USD) - 2021/07/30 18:46:16 ET
Table 'Aitne III' 9-max Seat #5 is the button
Seat 1: alexrus18 ($56.26 in chips) 
Seat 2: Pachebrash ($101.03 in chips) 
Seat 5: UPERAD ($81.38 in chips) 
Seat 6: Kahmi3105 ($312.50 in chips) 
Seat 7: Popokluev ($52.37 in chips) 
Seat 8: galina8383 ($61.72 in chips) 
Seat 9: leooooon79 ($34.25 in chips) 
Kahmi3105: posts small blind $0.25
Popokluev: posts big blind $0.50
mazefaka007: sits out 
An1an1: sits out 
*** HOLE CARDS ***
galina8383: folds 
leooooon79: calls $0.50
alexrus18: folds 
Pachebrash: folds 
UPERAD: folds 
Kahmi3105: calls $0.25
Popokluev: checks 
*** FLOP *** [Qc Ac 6d]
Kahmi3105: checks 
Popokluev: checks 
leooooon79: checks 
*** TURN *** [Qc Ac 6d] [9d]
Kahmi3105: checks 
Popokluev: checks 
leooooon79: checks 
*** RIVER *** [Qc Ac 6d 9d] [7c]
Kahmi3105: checks 
Popokluev: checks 
leooooon79: bets $0.71
Kahmi3105: folds 
Popokluev: folds 
Uncalled bet ($0.71) returned to leooooon79
leooooon79 collected $1.42 from pot
leooooon79: doesn't show hand 
*** SUMMARY ***
Total pot $1.50 | Rake $0.08 
Board [Qc Ac 6d 9d 7c]
Seat 1: alexrus18 folded before Flop (didn't bet)
Seat 2: Pachebrash folded before Flop (didn't bet)
Seat 5: UPERAD (button) folded before Flop (didn't bet)
Seat 6: Kahmi3105 (small blind) folded on the River
Seat 7: Popokluev (big blind) folded on the River
Seat 8: galina8383 folded before Flop (didn't bet)
Seat 9: leooooon79 collected ($1.42)



PokerStars Hand #228692199935:  Hold'em No Limit ($0.25/$0.50 USD) - 2021/07/30 18:47:16 ET
Table 'Aitne III' 9-max Seat #6 is the button
Seat 1: alexrus18 ($56.26 in chips) 
Seat 2: Pachebrash ($101.03 in chips) 
Seat 5: UPERAD ($81.38 in chips) 
Seat 6: Kahmi3105 ($312 in chips) 
Seat 7: Popokluev ($51.87 in chips) 
Seat 8: galina8383 ($61.72 in chips) 
Seat 9: leooooon79 ($35.17 in chips) 
Popokluev: posts small blind $0.25
galina8383: posts big blind $0.50
mazefaka007: sits out 
An1an1: sits out 
*** HOLE CARDS ***
leooooon79: calls $0.50
alexrus18: folds 
Pachebrash: raises $1.50 to $2
UPERAD: folds 
Kahmi3105: raises $5.25 to $7.25
Popokluev: folds 
galina8383: folds 
leooooon79: folds 
Pachebrash: folds 
Uncalled bet ($5.25) returned to Kahmi3105
Kahmi3105 collected $5.25 from pot
*** SUMMARY ***
Total pot $5.25 | Rake $0 
Seat 1: alexrus18 folded before Flop (didn't bet)
Seat 2: Pachebrash folded before Flop
Seat 5: UPERAD folded before Flop (didn't bet)
Seat 6: Kahmi3105 (button) collected ($5.25)
Seat 7: Popokluev (small blind) folded before Flop
Seat 8: galina8383 (big blind) folded before Flop
Seat 9: leooooon79 folded before Flop



PokerStars Hand #228692210689:  Hold'em No Limit ($0.25/$0.50 USD) - 2021/07/30 18:47:43 ET
Table 'Aitne III' 9-max Seat #7 is the button
Seat 1: alexrus18 ($56.26 in chips) 
Seat 2: Pachebrash ($99.03 in chips) 
Seat 5: UPERAD ($81.38 in chips) 
Seat 6: Kahmi3105 ($315.25 in chips) 
Seat 7: Popokluev ($51.62 in chips) 
Seat 8: galina8383 ($61.22 in chips) 
Seat 9: leooooon79 ($34.67 in chips) 
galina8383: posts small blind $0.25
leooooon79: posts big blind $0.50
mazefaka007: sits out 
An1an1: sits out 
*** HOLE CARDS ***
alexrus18: folds 
Pachebrash: folds 
UPERAD: raises $1 to $1.50
Kahmi3105: calls $1.50
Popokluev: folds 
galina8383: folds 
leooooon79: calls $1
*** FLOP *** [2s 7c 4c]
leooooon79: checks 
UPERAD: bets $2.26
Kahmi3105: folds 
leooooon79: folds 
Uncalled bet ($2.26) returned to UPERAD
UPERAD collected $4.51 from pot
UPERAD: doesn't show hand 
*** SUMMARY ***
Total pot $4.75 | Rake $0.24 
Board [2s 7c 4c]
Seat 1: alexrus18 folded before Flop (didn't bet)
Seat 2: Pachebrash folded before Flop (didn't bet)
Seat 5: UPERAD collected ($4.51)
Seat 6: Kahmi3105 folded on the Flop
Seat 7: Popokluev (button) folded before Flop (didn't bet)
Seat 8: galina8383 (small blind) folded before Flop
Seat 9: leooooon79 (big blind) folded on the Flop



PokerStars Hand #228692219373:  Hold'em No Limit ($0.25/$0.50 USD) - 2021/07/30 18:48:06 ET
Table 'Aitne III' 9-max Seat #8 is the button
Seat 1: alexrus18 ($56.26 in chips) 
Seat 2: Pachebrash ($99.03 in chips) 
Seat 5: UPERAD ($84.39 in chips) 
Seat 6: Kahmi3105 ($313.75 in chips) 
Seat 7: Popokluev ($51.62 in chips) 
Seat 8: galina8383 ($60.97 in chips) 
Seat 9: leooooon79 ($33.17 in chips) 
leooooon79: posts small blind $0.25
alexrus18: posts big blind $0.50
mazefaka007: sits out 
An1an1: sits out 
*** HOLE CARDS ***
Pachebrash: folds 
UPERAD: folds 
Kahmi3105: folds 
Popokluev: folds 
galina8383: folds 
leooooon79: calls $0.25
alexrus18: checks 
*** FLOP *** [Jc 4h Ks]
leooooon79: checks 
alexrus18: checks 
*** TURN *** [Jc 4h Ks] [Tc]
leooooon79: checks 
alexrus18: checks 
*** RIVER *** [Jc 4h Ks Tc] [7c]
leooooon79: bets $0.50
alexrus18: calls $0.50
*** SHOW DOWN ***
leooooon79: shows [Qs Qh] (a pair of Queens)
alexrus18: mucks hand 
leooooon79 collected $1.90 from pot
*** SUMMARY ***
Total pot $2 | Rake $0.10 
Board [Jc 4h Ks Tc 7c]
Seat 1: alexrus18 (big blind) mucked
Seat 2: Pachebrash folded before Flop (didn't bet)
Seat 5: UPERAD folded before Flop (didn't bet)
Seat 6: Kahmi3105 folded before Flop (didn't bet)
Seat 7: Popokluev folded before Flop (didn't bet)
Seat 8: galina8383 (button) folded before Flop (didn't bet)
Seat 9: leooooon79 (small blind) showed [Qs Qh] and won ($1.90) with a pair of Queens



PokerStars Hand #228692233151:  Hold'em No Limit ($0.25/$0.50 USD) - 2021/07/30 18:48:42 ET
Table 'Aitne III' 9-max Seat #9 is the button
Seat 1: alexrus18 ($55.26 in chips) 
Seat 2: Pachebrash ($99.03 in chips) 
Seat 5: UPERAD ($84.39 in chips) 
Seat 6: Kahmi3105 ($313.75 in chips) 
Seat 7: Popokluev ($51.62 in chips) 
Seat 8: galina8383 ($60.97 in chips) 
Seat 9: leooooon79 ($34.07 in chips) 
alexrus18: posts small blind $0.25
Pachebrash: posts big blind $0.50
mazefaka007: sits out 
An1an1: sits out 
*** HOLE CARDS ***
UPERAD: folds 
Kahmi3105: folds 
Popokluev: folds 
galina8383: raises $0.75 to $1.25
leooooon79: folds 
alexrus18: folds 
Pachebrash: folds 
Uncalled bet ($0.75) returned to galina8383
galina8383 collected $1.25 from pot
galina8383: doesn't show hand 
*** SUMMARY ***
Total pot $1.25 | Rake $0 
Seat 1: alexrus18 (small blind) folded before Flop
Seat 2: Pachebrash (big blind) folded before Flop
Seat 5: UPERAD folded before Flop (didn't bet)
Seat 6: Kahmi3105 folded before Flop (didn't bet)
Seat 7: Popokluev folded before Flop (didn't bet)
Seat 8: galina8383 collected ($1.25)
Seat 9: leooooon79 (button) folded before Flop (didn't bet)



PokerStars Hand #228692238645:  Hold'em No Limit ($0.25/$0.50 USD) - 2021/07/30 18:48:57 ET
Table 'Aitne III' 9-max Seat #1 is the button
Seat 1: alexrus18 ($55.01 in chips) 
Seat 2: Pachebrash ($98.53 in chips) 
Seat 3: mazefaka007 ($50 in chips) 
Seat 5: UPERAD ($84.39 in chips) 
Seat 6: Kahmi3105 ($313.75 in chips) 
Seat 7: Popokluev ($51.62 in chips) 
Seat 8: galina8383 ($61.72 in chips) 
Seat 9: leooooon79 ($34.07 in chips) 
Pachebrash: posts small blind $0.25
mazefaka007: posts big blind $0.50
An1an1: sits out 
*** HOLE CARDS ***
UPERAD: folds 
Kahmi3105: raises $1.25 to $1.75
Popokluev: folds 
galina8383: folds 
leooooon79: folds 
alexrus18: folds 
Pachebrash: folds 
mazefaka007: folds 
Uncalled bet ($1.25) returned to Kahmi3105
Kahmi3105 collected $1.25 from pot
*** SUMMARY ***
Total pot $1.25 | Rake $0 
Seat 1: alexrus18 (button) folded before Flop (didn't bet)
Seat 2: Pachebrash (small blind) folded before Flop
Seat 3: mazefaka007 (big blind) folded before Flop
Seat 5: UPERAD folded before Flop (didn't bet)
Seat 6: Kahmi3105 collected ($1.25)
Seat 7: Popokluev folded before Flop (didn't bet)
Seat 8: galina8383 folded before Flop (didn't bet)
Seat 9: leooooon79 folded before Flop (didn't bet)



PokerStars Hand #228692251549:  Hold'em No Limit ($0.25/$0.50 USD) - 2021/07/30 18:49:31 ET
Table 'Aitne III' 9-max Seat #2 is the button
Seat 1: alexrus18 ($55.01 in chips) 
Seat 2: Pachebrash ($98.28 in chips) 
Seat 3: mazefaka007 ($50 in chips) 
Seat 4: An1an1 ($50 in chips) 
Seat 5: UPERAD ($84.39 in chips) 
Seat 6: Kahmi3105 ($314.50 in chips) 
Seat 7: Popokluev ($51.62 in chips) 
Seat 8: galina8383 ($61.72 in chips) 
Seat 9: leooooon79 ($34.07 in chips) 
mazefaka007: posts small blind $0.25
An1an1: posts big blind $0.50
*** HOLE CARDS ***
UPERAD: folds 
Kahmi3105: raises $1.25 to $1.75
Popokluev: folds 
galina8383: folds 
leooooon79: folds 
alexrus18: folds 
Pachebrash: folds 
mazefaka007: folds 
An1an1: folds 
Uncalled bet ($1.25) returned to Kahmi3105
Kahmi3105 collected $1.25 from pot
*** SUMMARY ***
Total pot $1.25 | Rake $0 
Seat 1: alexrus18 folded before Flop (didn't bet)
Seat 2: Pachebrash (button) folded before Flop (didn't bet)
Seat 3: mazefaka007 (small blind) folded before Flop
Seat 4: An1an1 (big blind) folded before Flop
Seat 5: UPERAD folded before Flop (didn't bet)
Seat 6: Kahmi3105 collected ($1.25)
Seat 7: Popokluev folded before Flop (didn't bet)
Seat 8: galina8383 folded before Flop (didn't bet)
Seat 9: leooooon79 folded before Flop (didn't bet)



PokerStars Hand #228692264223:  Hold'em No Limit ($0.25/$0.50 USD) - 2021/07/30 18:49:59 ET
Table 'Aitne III' 9-max Seat #3 is the button
Seat 1: alexrus18 ($55.01 in chips) 
Seat 2: Pachebrash ($98.28 in chips) 
Seat 3: mazefaka007 ($50 in chips) 
Seat 4: An1an1 ($50 in chips) 
Seat 5: UPERAD ($84.39 in chips) 
Seat 6: Kahmi3105 ($315.25 in chips) 
Seat 7: Popokluev ($51.62 in chips) 
Seat 8: galina8383 ($61.72 in chips) 
Seat 9: leooooon79 ($34.07 in chips) 
An1an1: posts small blind $0.25
UPERAD: posts big blind $0.50
*** HOLE CARDS ***
Kahmi3105: calls $0.50
Popokluev: folds 
galina8383: folds 
leooooon79: calls $0.50
alexrus18: folds 
Pachebrash: folds 
mazefaka007: folds 
An1an1: folds 
UPERAD: checks 
*** FLOP *** [Qc 4s 3s]
UPERAD: checks 
Kahmi3105: checks 
leooooon79: checks 
*** TURN *** [Qc 4s 3s] [Jh]
UPERAD: checks 
Kahmi3105: checks 
leooooon79: checks 
*** RIVER *** [Qc 4s 3s Jh] [Ac]
UPERAD: checks 
Kahmi3105: checks 
leooooon79: bets $0.83
UPERAD: folds 
Kahmi3105: folds 
Uncalled bet ($0.83) returned to leooooon79
leooooon79 collected $1.66 from pot
leooooon79: doesn't show hand 
*** SUMMARY ***
Total pot $1.75 | Rake $0.09 
Board [Qc 4s 3s Jh Ac]
Seat 1: alexrus18 folded before Flop (didn't bet)
Seat 2: Pachebrash folded before Flop (didn't bet)
Seat 3: mazefaka007 (button) folded before Flop (didn't bet)
Seat 4: An1an1 (small blind) folded before Flop
Seat 5: UPERAD (big blind) folded on the River
Seat 6: Kahmi3105 folded on the River
Seat 7: Popokluev folded before Flop (didn't bet)
Seat 8: galina8383 folded before Flop (didn't bet)
Seat 9: leooooon79 collected ($1.66)



PokerStars Hand #228692283684:  Hold'em No Limit ($0.25/$0.50 USD) - 2021/07/30 18:50:47 ET
Table 'Aitne III' 9-max Seat #4 is the button
Seat 1: alexrus18 ($55.01 in chips) 
Seat 2: Pachebrash ($98.28 in chips) 
Seat 3: mazefaka007 ($50 in chips) 
Seat 4: An1an1 ($50 in chips) 
Seat 5: UPERAD ($83.89 in chips) 
Seat 6: Kahmi3105 ($314.75 in chips) 
Seat 7: Popokluev ($51.62 in chips) 
Seat 8: galina8383 ($61.72 in chips) 
Seat 9: leooooon79 ($35.23 in chips) 
UPERAD: posts small blind $0.25
Kahmi3105: posts big blind $0.50
*** HOLE CARDS ***
Popokluev: folds 
galina8383: folds 
leooooon79: calls $0.50
alexrus18: folds 
Pachebrash: folds 
mazefaka007: folds 
An1an1: folds 
UPERAD: folds 
Kahmi3105: checks 
*** FLOP *** [Kc Jd Jc]
Kahmi3105: checks 
leooooon79: checks 
*** TURN *** [Kc Jd Jc] [4s]
Kahmi3105: checks 
leooooon79: checks 
*** RIVER *** [Kc Jd Jc 4s] [3s]
Kahmi3105: bets $2
leooooon79: folds 
Uncalled bet ($2) returned to Kahmi3105
Kahmi3105 collected $1.17 from pot
*** SUMMARY ***
Total pot $1.25 | Rake $0.08 
Board [Kc Jd Jc 4s 3s]
Seat 1: alexrus18 folded before Flop (didn't bet)
Seat 2: Pachebrash folded before Flop (didn't bet)
Seat 3: mazefaka007 folded before Flop (didn't bet)
Seat 4: An1an1 (button) folded before Flop (didn't bet)
Seat 5: UPERAD (small blind) folded before Flop
Seat 6: Kahmi3105 (big blind) collected ($1.17)
Seat 7: Popokluev folded before Flop (didn't bet)
Seat 8: galina8383 folded before Flop (didn't bet)
Seat 9: leooooon79 folded on the River



PokerStars Hand #228692296573:  Hold'em No Limit ($0.25/$0.50 USD) - 2021/07/30 18:51:21 ET
Table 'Aitne III' 9-max Seat #5 is the button
Seat 1: alexrus18 ($55.01 in chips) 
Seat 2: Pachebrash ($98.28 in chips) 
Seat 3: mazefaka007 ($50 in chips) 
Seat 4: An1an1 ($50 in chips) 
Seat 5: UPERAD ($83.64 in chips) 
Seat 6: Kahmi3105 ($315.42 in chips) 
Seat 7: Popokluev ($51.62 in chips) 
Seat 8: galina8383 ($61.72 in chips) 
Seat 9: leooooon79 ($34.73 in chips) 
Kahmi3105: posts small blind $0.25
Popokluev: posts big blind $0.50
*** HOLE CARDS ***
galina8383: folds 
leooooon79: calls $0.50
alexrus18: folds 
Pachebrash: folds 
mazefaka007: folds 
An1an1: raises $1.25 to $1.75
UPERAD: folds 
Kahmi3105: folds 
Popokluev: folds 
leooooon79: calls $1.25
*** FLOP *** [5h 6h Ad]
leooooon79: checks 
An1an1: bets $3.03
leooooon79: calls $3.03
*** TURN *** [5h 6h Ad] [Th]
leooooon79: checks 
An1an1: checks 
*** RIVER *** [5h 6h Ad Th] [4s]
leooooon79: bets $4.89
An1an1: calls $4.89
*** SHOW DOWN ***
leooooon79: shows [6d 4d] (two pair, Sixes and Fours)
An1an1: mucks hand 
leooooon79 collected $19.09 from pot
*** SUMMARY ***
Total pot $20.09 | Rake $1 
Board [5h 6h Ad Th 4s]
Seat 1: alexrus18 folded before Flop (didn't bet)
Seat 2: Pachebrash folded before Flop (didn't bet)
Seat 3: mazefaka007 folded before Flop (didn't bet)
Seat 4: An1an1 mucked
Seat 5: UPERAD (button) folded before Flop (didn't bet)
Seat 6: Kahmi3105 (small blind) folded before Flop
Seat 7: Popokluev (big blind) folded before Flop
Seat 8: galina8383 folded before Flop (didn't bet)
Seat 9: leooooon79 showed [6d 4d] and won ($19.09) with two pair, Sixes and Fours



PokerStars Hand #228692319687:  Hold'em No Limit ($0.25/$0.50 USD) - 2021/07/30 18:52:22 ET
Table 'Aitne III' 9-max Seat #6 is the button
Seat 1: alexrus18 ($55.01 in chips) 
Seat 2: Pachebrash ($98.28 in chips) 
Seat 3: mazefaka007 ($50 in chips) 
Seat 4: An1an1 ($50 in chips) 
Seat 5: UPERAD ($83.64 in chips) 
Seat 6: Kahmi3105 ($315.17 in chips) 
Seat 7: Popokluev ($51.12 in chips) 
Seat 8: galina8383 ($61.72 in chips) 
Seat 9: leooooon79 ($44.15 in chips) 
Popokluev: posts small blind $0.25
galina8383: posts big blind $0.50
*** HOLE CARDS ***
leooooon79: calls $0.50
alexrus18: raises $1.75 to $2.25
Pachebrash: folds 
mazefaka007: raises $4 to $6.25
An1an1: folds 
UPERAD: folds 
Kahmi3105: folds 
Popokluev: folds 
galina8383: folds 
leooooon79: folds 
alexrus18: folds 
Uncalled bet ($4) returned to mazefaka007
mazefaka007 collected $5.75 from pot
mazefaka007: doesn't show hand 
*** SUMMARY ***
Total pot $5.75 | Rake $0 
Seat 1: alexrus18 folded before Flop
Seat 2: Pachebrash folded before Flop (didn't bet)
Seat 3: mazefaka007 collected ($5.75)
Seat 4: An1an1 folded before Flop (didn't bet)
Seat 5: UPERAD folded before Flop (didn't bet)
Seat 6: Kahmi3105 (button) folded before Flop (didn't bet)
Seat 7: Popokluev (small blind) folded before Flop
Seat 8: galina8383 (big blind) folded before Flop
Seat 9: leooooon79 folded before Flop



PokerStars Hand #228692331229:  Hold'em No Limit ($0.25/$0.50 USD) - 2021/07/30 18:52:53 ET
Table 'Aitne III' 9-max Seat #7 is the button
Seat 1: alexrus18 ($52.76 in chips) 
Seat 2: Pachebrash ($98.28 in chips) 
Seat 3: mazefaka007 ($53.50 in chips) 
Seat 4: An1an1 ($50 in chips) 
Seat 5: UPERAD ($83.64 in chips) 
Seat 6: Kahmi3105 ($315.17 in chips) 
Seat 7: Popokluev ($50.87 in chips) 
Seat 8: galina8383 ($61.22 in chips) 
Seat 9: leooooon79 ($43.65 in chips) 
galina8383: posts small blind $0.25
leooooon79: posts big blind $0.50
*** HOLE CARDS ***
alexrus18: folds 
Pachebrash: folds 
mazefaka007: folds 
An1an1: raises $0.75 to $1.25
UPERAD: folds 
Kahmi3105: calls $1.25
Popokluev: folds 
galina8383: folds 
leooooon79: calls $0.75
*** FLOP *** [Qc 9s 2h]
leooooon79: checks 
An1an1: checks 
Kahmi3105: bets $2.50
leooooon79: folds 
An1an1: folds 
Uncalled bet ($2.50) returned to Kahmi3105
Kahmi3105 collected $3.75 from pot
*** SUMMARY ***
Total pot $4 | Rake $0.25 
Board [Qc 9s 2h]
Seat 1: alexrus18 folded before Flop (didn't bet)
Seat 2: Pachebrash folded before Flop (didn't bet)
Seat 3: mazefaka007 folded before Flop (didn't bet)
Seat 4: An1an1 folded on the Flop
Seat 5: UPERAD folded before Flop (didn't bet)
Seat 6: Kahmi3105 collected ($3.75)
Seat 7: Popokluev (button) folded before Flop (didn't bet)
Seat 8: galina8383 (small blind) folded before Flop
Seat 9: leooooon79 (big blind) folded on the Flop



PokerStars Hand #228692347083:  Hold'em No Limit ($0.25/$0.50 USD) - 2021/07/30 18:53:35 ET
Table 'Aitne III' 9-max Seat #8 is the button
Seat 1: alexrus18 ($52.76 in chips) 
Seat 2: Pachebrash ($98.28 in chips) 
Seat 3: mazefaka007 ($53.50 in chips) 
Seat 4: An1an1 ($50 in chips) 
Seat 5: UPERAD ($83.64 in chips) 
Seat 6: Kahmi3105 ($317.67 in chips) 
Seat 7: Popokluev ($50.87 in chips) 
Seat 8: galina8383 ($60.97 in chips) 
Seat 9: leooooon79 ($42.40 in chips) 
leooooon79: posts small blind $0.25
alexrus18: posts big blind $0.50
*** HOLE CARDS ***
Pachebrash: folds 
mazefaka007: folds 
An1an1: folds 
UPERAD: folds 
Kahmi3105: folds 
Popokluev: raises $0.75 to $1.25
galina8383: folds 
leooooon79: calls $1
alexrus18: folds 
*** FLOP *** [9d 4s 3s]
leooooon79: checks 
Popokluev: bets $0.94
leooooon79: calls $0.94
*** TURN *** [9d 4s 3s] [Tc]
leooooon79: checks 
Popokluev: checks 
*** RIVER *** [9d 4s 3s Tc] [9s]
leooooon79: bets $2.32
Popokluev: calls $2.32
*** SHOW DOWN ***
leooooon79: shows [8s Qh] (a pair of Nines)
Popokluev: shows [2c 2s] (two pair, Nines and Deuces)
Popokluev collected $9.04 from pot
*** SUMMARY ***
Total pot $9.52 | Rake $0.48 
Board [9d 4s 3s Tc 9s]
Seat 1: alexrus18 (big blind) folded before Flop
Seat 2: Pachebrash folded before Flop (didn't bet)
Seat 3: mazefaka007 folded before Flop (didn't bet)
Seat 4: An1an1 folded before Flop (didn't bet)
Seat 5: UPERAD folded before Flop (didn't bet)
Seat 6: Kahmi3105 folded before Flop (didn't bet)
Seat 7: Popokluev showed [2c 2s] and won ($9.04) with two pair, Nines and Deuces
Seat 8: galina8383 (button) folded before Flop (didn't bet)
Seat 9: leooooon79 (small blind) showed [8s Qh] and lost with a pair of Nines



PokerStars Hand #228692370428:  Hold'em No Limit ($0.25/$0.50 USD) - 2021/07/30 18:54:32 ET
Table 'Aitne III' 9-max Seat #9 is the button
Seat 1: alexrus18 ($52.26 in chips) 
Seat 2: Pachebrash ($98.28 in chips) 
Seat 3: mazefaka007 ($53.50 in chips) 
Seat 4: An1an1 ($50 in chips) 
Seat 5: UPERAD ($83.64 in chips) 
Seat 6: Kahmi3105 ($317.67 in chips) 
Seat 7: Popokluev ($55.40 in chips) 
Seat 8: galina8383 ($60.97 in chips) 
Seat 9: leooooon79 ($37.89 in chips) 
alexrus18: posts small blind $0.25
Pachebrash: posts big blind $0.50
*** HOLE CARDS ***
mazefaka007: folds 
An1an1: folds 
UPERAD: folds 
Kahmi3105: raises $1.25 to $1.75
Popokluev: folds 
galina8383: folds 
leooooon79: folds 
alexrus18: folds 
Pachebrash: folds 
Uncalled bet ($1.25) returned to Kahmi3105
leooooon79 leaves the table
Kahmi3105 collected $1.25 from pot
*** SUMMARY ***
Total pot $1.25 | Rake $0 
Seat 1: alexrus18 (small blind) folded before Flop
Seat 2: Pachebrash (big blind) folded before Flop
Seat 3: mazefaka007 folded before Flop (didn't bet)
Seat 4: An1an1 folded before Flop (didn't bet)
Seat 5: UPERAD folded before Flop (didn't bet)
Seat 6: Kahmi3105 collected ($1.25)
Seat 7: Popokluev folded before Flop (didn't bet)
Seat 8: galina8383 folded before Flop (didn't bet)
Seat 9: leooooon79 (button) folded before Flop (didn't bet)



PokerStars Hand #228692378051:  Hold'em No Limit ($0.25/$0.50 USD) - 2021/07/30 18:54:52 ET
Table 'Aitne III' 9-max Seat #1 is the button
Seat 1: alexrus18 ($52.01 in chips) 
Seat 2: Pachebrash ($97.78 in chips) 
Seat 3: mazefaka007 ($53.50 in chips) 
Seat 4: An1an1 ($50 in chips) 
Seat 5: UPERAD ($83.64 in chips) 
Seat 6: Kahmi3105 ($318.42 in chips) 
Seat 7: Popokluev ($55.40 in chips) 
Seat 8: galina8383 ($60.97 in chips) 
Pachebrash: posts small blind $0.25
mazefaka007: posts big blind $0.50
*** HOLE CARDS ***
An1an1: folds 
UPERAD: folds 
Kahmi3105: folds 
Popokluev: folds 
galina8383: folds 
alexrus18: folds 
Pachebrash: folds 
Uncalled bet ($0.25) returned to mazefaka007
mazefaka007 collected $0.50 from pot
mazefaka007: doesn't show hand 
*** SUMMARY ***
Total pot $0.50 | Rake $0 
Seat 1: alexrus18 (button) folded before Flop (didn't bet)
Seat 2: Pachebrash (small blind) folded before Flop
Seat 3: mazefaka007 (big blind) collected ($0.50)
Seat 4: An1an1 folded before Flop (didn't bet)
Seat 5: UPERAD folded before Flop (didn't bet)
Seat 6: Kahmi3105 folded before Flop (didn't bet)
Seat 7: Popokluev folded before Flop (didn't bet)
Seat 8: galina8383 folded before Flop (didn't bet)



PokerStars Hand #228692383985:  Hold'em No Limit ($0.25/$0.50 USD) - 2021/07/30 18:55:08 ET
Table 'Aitne III' 9-max Seat #2 is the button
Seat 1: alexrus18 ($52.01 in chips) 
Seat 2: Pachebrash ($97.53 in chips) 
Seat 3: mazefaka007 ($53.75 in chips) 
Seat 4: An1an1 ($50 in chips) 
Seat 5: UPERAD ($83.64 in chips) 
Seat 6: Kahmi3105 ($318.42 in chips) 
Seat 7: Popokluev ($55.40 in chips) 
Seat 8: galina8383 ($60.97 in chips) 
mazefaka007: posts small blind $0.25
An1an1: posts big blind $0.50
*** HOLE CARDS ***
UPERAD: folds 
Kahmi3105: raises $1.25 to $1.75
Popokluev: folds 
galina8383: folds 
UPERAD leaves the table
alexrus18: folds 
Pachebrash: folds 
mazefaka007: folds 
An1an1: folds 
Uncalled bet ($1.25) returned to Kahmi3105
Kahmi3105 collected $1.25 from pot
*** SUMMARY ***
Total pot $1.25 | Rake $0 
Seat 1: alexrus18 folded before Flop (didn't bet)
Seat 2: Pachebrash (button) folded before Flop (didn't bet)
Seat 3: mazefaka007 (small blind) folded before Flop
Seat 4: An1an1 (big blind) folded before Flop
Seat 5: UPERAD folded before Flop (didn't bet)
Seat 6: Kahmi3105 collected ($1.25)
Seat 7: Popokluev folded before Flop (didn't bet)
Seat 8: galina8383 folded before Flop (didn't bet)



PokerStars Hand #228692599592:  Hold'em No Limit ($0.25/$0.50 USD) - 2021/07/30 19:05:10 ET
Table 'Aitne III' 9-max Seat #2 is the button
Seat 1: OCBslim44 ($40 in chips) 
Seat 2: KerilTheBoss ($50 in chips) 
KerilTheBoss: posts small blind $0.25
OCBslim44: posts big blind $0.50
*** HOLE CARDS ***
KerilTheBoss: raises $1 to $1.50
OCBslim44: calls $1
*** FLOP *** [6c Kc 7c]
chekita1965 joins the table at seat #4 
OCBslim44: checks 
KerilTheBoss: checks 
*** TURN *** [6c Kc 7c] [3c]
KARANN899 joins the table at seat #6 
OCBslim44: bets $2.85
KerilTheBoss: calls $2.85
*** RIVER *** [6c Kc 7c 3c] [Ks]
OCBslim44: bets $8.26
jumbo69 joins the table at seat #5 
KerilTheBoss: calls $8.26
*** SHOW DOWN ***
OCBslim44: shows [4c 4s] (a flush, King high)
KerilTheBoss: shows [Ad 8c] (a flush, King high - Eight higher)
KerilTheBoss collected $24.47 from pot
*** SUMMARY ***
Total pot $25.22 | Rake $0.75 
Board [6c Kc 7c 3c Ks]
Seat 1: OCBslim44 (big blind) showed [4c 4s] and lost with a flush, King high
Seat 2: KerilTheBoss (button) (small blind) showed [Ad 8c] and won ($24.47) with a flush, King high



PokerStars Hand #228692609959:  Hold'em No Limit ($0.25/$0.50 USD) - 2021/07/30 19:05:39 ET
Table 'Aitne III' 9-max Seat #1 is the button
Seat 1: OCBslim44 ($27.39 in chips) 
Seat 2: KerilTheBoss ($61.86 in chips) 
Seat 5: jumbo69 ($45.07 in chips) 
KerilTheBoss: posts small blind $0.25
jumbo69: posts big blind $0.50
KARANN899: sits out 
*** HOLE CARDS ***
OCBslim44: calls $0.50
gustguaira joins the table at seat #7 
KerilTheBoss: folds 
jumbo69: checks 
*** FLOP *** [3h 4d 4h]
goorest777 joins the table at seat #8 
jumbo69: checks 
OCBslim44: checks 
*** TURN *** [3h 4d 4h] [Ad]
jumbo69: checks 
OCBslim44: checks 
*** RIVER *** [3h 4d 4h Ad] [6d]
jumbo69: checks 
OCBslim44: checks 
*** SHOW DOWN ***
jumbo69: shows [6c Jd] (two pair, Sixes and Fours)
OCBslim44: shows [Qc Qh] (two pair, Queens and Fours)
OCBslim44 collected $1.19 from pot
*** SUMMARY ***
Total pot $1.25 | Rake $0.06 
Board [3h 4d 4h Ad 6d]
Seat 1: OCBslim44 (button) showed [Qc Qh] and won ($1.19) with two pair, Queens and Fours
Seat 2: KerilTheBoss (small blind) folded before Flop
Seat 5: jumbo69 (big blind) showed [6c Jd] and lost with two pair, Sixes and Fours



PokerStars Hand #228692617008:  Hold'em No Limit ($0.25/$0.50 USD) - 2021/07/30 19:05:59 ET
Table 'Aitne III' 9-max Seat #2 is the button
Seat 1: OCBslim44 ($28.08 in chips) 
Seat 2: KerilTheBoss ($61.61 in chips) 
Seat 5: jumbo69 ($44.57 in chips) 
Seat 6: KARANN899 ($50 in chips) 
jumbo69: posts small blind $0.25
KARANN899: posts big blind $0.50
gustguaira: sits out 
goorest777: sits out 
*** HOLE CARDS ***
OCBslim44: folds 
KerilTheBoss: raises $0.55 to $1.05
jumbo69: folds 
KARANN899: calls $0.55
*** FLOP *** [2c Qh Ah]
KARANN899: checks 
KerilTheBoss: bets $0.74
KARANN899: folds 
Uncalled bet ($0.74) returned to KerilTheBoss
KerilTheBoss collected $2.23 from pot
KerilTheBoss: doesn't show hand 
*** SUMMARY ***
Total pot $2.35 | Rake $0.12 
Board [2c Qh Ah]
Seat 1: OCBslim44 folded before Flop (didn't bet)
Seat 2: KerilTheBoss (button) collected ($2.23)
Seat 5: jumbo69 (small blind) folded before Flop
Seat 6: KARANN899 (big blind) folded on the Flop



PokerStars Hand #228692624047:  Hold'em No Limit ($0.25/$0.50 USD) - 2021/07/30 19:06:19 ET
Table 'Aitne III' 9-max Seat #5 is the button
Seat 1: OCBslim44 ($28.08 in chips) 
Seat 2: KerilTheBoss ($62.79 in chips) 
Seat 5: jumbo69 ($44.32 in chips) 
Seat 6: KARANN899 ($48.95 in chips) 
Seat 7: gustguaira ($50 in chips) 
KARANN899: posts small blind $0.25
gustguaira: posts big blind $0.50
goorest777: sits out 
*** HOLE CARDS ***
OCBslim44: calls $0.50
KerilTheBoss: folds 
BarUnDuck joins the table at seat #9 
jumbo69: folds 
KARANN899: folds 
gustguaira: checks 
*** FLOP *** [9h 5c Kd]
gustguaira: checks 
OCBslim44: checks 
*** TURN *** [9h 5c Kd] [6c]
gustguaira: bets $0.50
OCBslim44: calls $0.50
*** RIVER *** [9h 5c Kd 6c] [6s]
gustguaira: bets $0.50
OCBslim44: folds 
Uncalled bet ($0.50) returned to gustguaira
gustguaira collected $2.14 from pot
gustguaira: doesn't show hand 
*** SUMMARY ***
Total pot $2.25 | Rake $0.11 
Board [9h 5c Kd 6c 6s]
Seat 1: OCBslim44 folded on the River
Seat 2: KerilTheBoss folded before Flop (didn't bet)
Seat 5: jumbo69 (button) folded before Flop (didn't bet)
Seat 6: KARANN899 (small blind) folded before Flop
Seat 7: gustguaira (big blind) collected ($2.14)



PokerStars Hand #228692635671:  Hold'em No Limit ($0.25/$0.50 USD) - 2021/07/30 19:06:51 ET
Table 'Aitne III' 9-max Seat #6 is the button
Seat 1: OCBslim44 ($27.08 in chips) 
Seat 2: KerilTheBoss ($62.79 in chips) 
Seat 5: jumbo69 ($44.32 in chips) 
Seat 6: KARANN899 ($48.70 in chips) 
Seat 7: gustguaira ($51.14 in chips) 
Seat 8: goorest777 ($50 in chips) 
gustguaira: posts small blind $0.25
goorest777: posts big blind $0.50
BarUnDuck: sits out 
chekita1965: sits out 
*** HOLE CARDS ***
OCBslim44: folds 
KerilTheBoss: folds 
jumbo69: folds 
KARANN899: folds 
gustguaira: folds 
Uncalled bet ($0.25) returned to goorest777
goorest777 collected $0.50 from pot
*** SUMMARY ***
Total pot $0.50 | Rake $0 
Seat 1: OCBslim44 folded before Flop (didn't bet)
Seat 2: KerilTheBoss folded before Flop (didn't bet)
Seat 5: jumbo69 folded before Flop (didn't bet)
Seat 6: KARANN899 (button) folded before Flop (didn't bet)
Seat 7: gustguaira (small blind) folded before Flop
Seat 8: goorest777 (big blind) collected ($0.50)



PokerStars Hand #228692639717:  Hold'em No Limit ($0.25/$0.50 USD) - 2021/07/30 19:07:02 ET
Table 'Aitne III' 9-max Seat #7 is the button
Seat 1: OCBslim44 ($27.08 in chips) 
Seat 2: KerilTheBoss ($62.79 in chips) 
Seat 5: jumbo69 ($44.32 in chips) 
Seat 6: KARANN899 ($48.70 in chips) 
Seat 7: gustguaira ($50.89 in chips) 
Seat 8: goorest777 ($50.25 in chips) 
Seat 9: BarUnDuck ($20 in chips) 
goorest777: posts small blind $0.25
BarUnDuck: posts big blind $0.50
chekita1965: sits out 
*** HOLE CARDS ***
OCBslim44: raises $1.25 to $1.75
KerilTheBoss: folds 
jumbo69: folds 
KARANN899: folds 
gustguaira: folds 
goorest777: folds 
BarUnDuck: folds 
Uncalled bet ($1.25) returned to OCBslim44
OCBslim44 collected $1.25 from pot
OCBslim44: doesn't show hand 
*** SUMMARY ***
Total pot $1.25 | Rake $0 
Seat 1: OCBslim44 collected ($1.25)
Seat 2: KerilTheBoss folded before Flop (didn't bet)
Seat 5: jumbo69 folded before Flop (didn't bet)
Seat 6: KARANN899 folded before Flop (didn't bet)
Seat 7: gustguaira (button) folded before Flop (didn't bet)
Seat 8: goorest777 (small blind) folded before Flop
Seat 9: BarUnDuck (big blind) folded before Flop



PokerStars Hand #228692710821:  Hold'em No Limit ($0.25/$0.50 USD) - 2021/07/30 19:10:19 ET
Table 'Aitne III' 9-max Seat #5 is the button
Seat 1: OCBslim44 ($32.54 in chips) 
Seat 2: ms1272 ($50 in chips) 
Seat 4: chekita1965 ($32.27 in chips) 
Seat 5: jumbo69 ($63.58 in chips) 
Seat 6: KARANN899 ($48.20 in chips) 
Seat 7: gustguaira ($46.22 in chips) 
Seat 8: goorest777 ($50 in chips) 
Seat 9: BarUnDuck ($20 in chips) 
KARANN899: posts small blind $0.25
BollyMith joins the table at seat #3 
gustguaira: posts big blind $0.50
*** HOLE CARDS ***
goorest777: folds 
BarUnDuck: folds 
OCBslim44: folds 
ms1272: folds 
chekita1965: raises $1.25 to $1.75
jumbo69: folds 
jumbo69 leaves the table
KARANN899: folds 
gustguaira: folds 
Uncalled bet ($1.25) returned to chekita1965
chekita1965 collected $1.25 from pot
chekita1965: doesn't show hand 
*** SUMMARY ***
Total pot $1.25 | Rake $0 
Seat 1: OCBslim44 folded before Flop (didn't bet)
Seat 2: ms1272 folded before Flop (didn't bet)
Seat 4: chekita1965 collected ($1.25)
Seat 5: jumbo69 (button) folded before Flop (didn't bet)
Seat 6: KARANN899 (small blind) folded before Flop
Seat 7: gustguaira (big blind) folded before Flop
Seat 8: goorest777 folded before Flop (didn't bet)
Seat 9: BarUnDuck folded before Flop (didn't bet)



PokerStars Hand #228692716542:  Hold'em No Limit ($0.25/$0.50 USD) - 2021/07/30 19:10:36 ET
Table 'Aitne III' 9-max Seat #6 is the button
Seat 1: OCBslim44 ($32.54 in chips) 
Seat 2: ms1272 ($50 in chips) 
Seat 3: BollyMith ($25 in chips) 
Seat 4: chekita1965 ($33.02 in chips) 
Seat 6: KARANN899 ($47.95 in chips) 
Seat 7: gustguaira ($45.72 in chips) 
Seat 9: BarUnDuck ($20 in chips) 
gustguaira: posts small blind $0.25
goorest777: is sitting out 
BarUnDuck: posts big blind $0.50
BollyMith: posts big blind $0.50
*** HOLE CARDS ***
OCBslim44: calls $0.50
ms1272: calls $0.50
goorest777 leaves the table
BollyMith: checks 
chekita1965: calls $0.50
Sadyhov V.V. joins the table at seat #5 
KARANN899: raises $5 to $5.50
gustguaira: folds 
BarUnDuck: folds 
OCBslim44: folds 
ms1272: folds 
BollyMith: folds 
chekita1965: calls $5
*** FLOP *** [8s 4h 9c]
chekita1965: checks 
KARANN899: bets $6
chekita1965: calls $6
*** TURN *** [8s 4h 9c] [Ts]
chekita1965: bets $21.52 and is all-in
KARANN899: calls $21.52
*** RIVER *** [8s 4h 9c Ts] [6c]
*** SHOW DOWN ***
chekita1965: shows [7s Ks] (a straight, Six to Ten)
KARANN899: shows [Jh Kh] (high card King)
chekita1965 cashed out the hand for $20.89 | Cash Out Fee $0.21
*** SUMMARY ***
Total pot $68.29 | Rake $2 
Board [8s 4h 9c Ts 6c]
Seat 1: OCBslim44 folded before Flop
Seat 2: ms1272 folded before Flop
Seat 3: BollyMith folded before Flop (didn't bet)
Seat 4: chekita1965 showed [7s Ks] and won ($66.29) with a straight, Six to Ten (pot not awarded as player cashed out)
Seat 6: KARANN899 (button) showed [Jh Kh] and lost with high card King
Seat 7: gustguaira (small blind) folded before Flop
Seat 9: BarUnDuck (big blind) folded before Flop



PokerStars Hand #228692740300:  Hold'em No Limit ($0.25/$0.50 USD) - 2021/07/30 19:11:42 ET
Table 'Aitne III' 9-max Seat #7 is the button
Seat 1: OCBslim44 ($32.04 in chips) 
Seat 2: ms1272 ($50 in chips) 
Seat 3: BollyMith ($24.50 in chips) 
Seat 4: chekita1965 ($20.89 in chips) 
Seat 6: KARANN899 ($28.48 in chips) 
Seat 7: gustguaira ($45.47 in chips) 
Seat 9: BarUnDuck ($19.50 in chips) 
BarUnDuck: posts small blind $0.25
OCBslim44: posts big blind $0.50
Sadyhov V.V.: sits out 
*** HOLE CARDS ***
ms1272: folds 
BollyMith: folds 
chekita1965: raises $20.39 to $20.89 and is all-in
KARANN899: folds 
gustguaira: folds 
BarUnDuck: folds 
OCBslim44: folds 
Uncalled bet ($20.39) returned to chekita1965
chekita1965 collected $1.25 from pot
chekita1965: doesn't show hand 
*** SUMMARY ***
Total pot $1.25 | Rake $0 
Seat 1: OCBslim44 (big blind) folded before Flop
Seat 2: ms1272 folded before Flop (didn't bet)
Seat 3: BollyMith folded before Flop (didn't bet)
Seat 4: chekita1965 collected ($1.25)
Seat 6: KARANN899 folded before Flop (didn't bet)
Seat 7: gustguaira (button) folded before Flop (didn't bet)
Seat 9: BarUnDuck (small blind) folded before Flop



PokerStars Hand #228692744398:  Hold'em No Limit ($0.25/$0.50 USD) - 2021/07/30 19:11:53 ET
Table 'Aitne III' 9-max Seat #9 is the button
Seat 1: OCBslim44 ($31.54 in chips) 
Seat 2: ms1272 ($50 in chips) 
Seat 3: BollyMith ($24.50 in chips) 
Seat 4: chekita1965 ($21.64 in chips) 
Seat 6: KARANN899 ($48.48 in chips) 
Seat 7: gustguaira ($45.47 in chips) 
Seat 9: BarUnDuck ($20 in chips) 
OCBslim44: posts small blind $0.25
ms1272: posts big blind $0.50
Sadyhov V.V.: sits out 
*** HOLE CARDS ***
BollyMith: raises $0.60 to $1.10
chekita1965: raises $20.54 to $21.64 and is all-in
KARANN899: folds 
gustguaira: folds 
BarUnDuck: calls $20 and is all-in
OCBslim44: calls $21.39
ms1272: folds 
BollyMith: calls $20.54
*** FLOP *** [Ac 7c 3c]
OCBslim44: bets $9.90 and is all-in
BollyMith: calls $2.86 and is all-in
Uncalled bet ($7.04) returned to OCBslim44
*** TURN *** [Ac 7c 3c] [Kh]
*** RIVER *** [Ac 7c 3c Kh] [Tc]
*** SHOW DOWN ***
OCBslim44: shows [Kd Qc] (a flush, Ace high)
BollyMith: shows [9h 9s] (a pair of Nines)
OCBslim44 collected $5.72 from side pot-2 
chekita1965: shows [4s 4c] (a flush, Ace high - lower cards)
OCBslim44 collected $4.92 from side pot-1 
BarUnDuck: shows [Js Jc] (a flush, Ace high - lower cards)
OCBslim44 collected $78.50 from main pot
chekita1965 cashed out the hand for $7.97 | Cash Out Fee $0.08
*** SUMMARY ***
Total pot $91.14 Main pot $78.50. Side pot-1 $4.92. Side pot-2 $5.72. | Rake $2 
Board [Ac 7c 3c Kh Tc]
Seat 1: OCBslim44 (small blind) showed [Kd Qc] and won ($89.14) with a flush, Ace high
Seat 2: ms1272 (big blind) folded before Flop
Seat 3: BollyMith showed [9h 9s] and lost with a pair of Nines
Seat 4: chekita1965 showed [4s 4c] and lost with a flush, Ace high (cashed out).
Seat 6: KARANN899 folded before Flop (didn't bet)
Seat 7: gustguaira folded before Flop (didn't bet)
Seat 9: BarUnDuck (button) showed [Js Jc] and lost with a flush, Ace high



PokerStars Hand #228692760047:  Hold'em No Limit ($0.25/$0.50 USD) - 2021/07/30 19:12:37 ET
Table 'Aitne III' 9-max Seat #1 is the button
Seat 1: OCBslim44 ($96.18 in chips) 
Seat 2: ms1272 ($50 in chips) 
Seat 4: chekita1965 ($7.97 in chips) 
Seat 6: KARANN899 ($48.48 in chips) 
Seat 7: gustguaira ($45.47 in chips) 
Seat 9: BarUnDuck ($20 in chips) 
ms1272: posts small blind $0.25
chekita1965: posts big blind $0.50
Sadyhov V.V.: sits out 
*** HOLE CARDS ***
KARANN899: folds 
gustguaira: folds 
PanicJX joins the table at seat #8 
BarUnDuck: raises $0.50 to $1
OCBslim44: folds 
ms1272: folds 
chekita1965: raises $6.97 to $7.97 and is all-in
BarUnDuck: calls $6.97
OCBslim44 leaves the table
*** FLOP *** [4s Qs 3s]
*** TURN *** [4s Qs 3s] [6c]
*** RIVER *** [4s Qs 3s 6c] [5c]
*** SHOW DOWN ***
chekita1965: shows [6s Ac] (a pair of Sixes)
BarUnDuck: shows [8h As] (high card Ace)
GDOF68 joins the table at seat #1 
chekita1965 collected $15.38 from pot
*** SUMMARY ***
Total pot $16.19 | Rake $0.81 
Board [4s Qs 3s 6c 5c]
Seat 1: OCBslim44 (button) folded before Flop (didn't bet)
Seat 2: ms1272 (small blind) folded before Flop
Seat 4: chekita1965 (big blind) showed [6s Ac] and won ($15.38) with a pair of Sixes
Seat 6: KARANN899 folded before Flop (didn't bet)
Seat 7: gustguaira folded before Flop (didn't bet)
Seat 9: BarUnDuck showed [8h As] and lost with high card Ace



PokerStars Hand #228692769857:  Hold'em No Limit ($0.25/$0.50 USD) - 2021/07/30 19:13:05 ET
Table 'Aitne III' 9-max Seat #2 is the button
Seat 2: ms1272 ($50 in chips) 
Seat 4: chekita1965 ($15.38 in chips) 
Seat 5: Sadyhov V.V. ($50 in chips) 
Seat 6: KARANN899 ($48.48 in chips) 
Seat 7: gustguaira ($45.47 in chips) 
Seat 9: BarUnDuck ($20 in chips) 
chekita1965: posts small blind $0.25
Sadyhov V.V.: posts big blind $0.50
PanicJX: sits out 
GDOF68: sits out 
*** HOLE CARDS ***
KARANN899: folds 
gustguaira: folds 
BarUnDuck: folds 
ms1272: folds 
chekita1965: raises $1 to $1.50
Sadyhov V.V.: folds 
Uncalled bet ($1) returned to chekita1965
chekita1965 collected $1 from pot
chekita1965: doesn't show hand 
*** SUMMARY ***
Total pot $1 | Rake $0 
Seat 2: ms1272 (button) folded before Flop (didn't bet)
Seat 4: chekita1965 (small blind) collected ($1)
Seat 5: Sadyhov V.V. (big blind) folded before Flop
Seat 6: KARANN899 folded before Flop (didn't bet)
Seat 7: gustguaira folded before Flop (didn't bet)
Seat 9: BarUnDuck folded before Flop (didn't bet)



PokerStars Hand #228692773330:  Hold'em No Limit ($0.25/$0.50 USD) - 2021/07/30 19:13:15 ET
Table 'Aitne III' 9-max Seat #4 is the button
Seat 2: ms1272 ($50 in chips) 
Seat 3: BollyMith ($25.31 in chips) 
Seat 4: chekita1965 ($15.88 in chips) 
Seat 5: Sadyhov V.V. ($50 in chips) 
Seat 6: KARANN899 ($48.48 in chips) 
Seat 7: gustguaira ($45.47 in chips) 
Seat 9: BarUnDuck ($20 in chips) 
Sadyhov V.V.: posts small blind $0.25
KARANN899: posts big blind $0.50
PanicJX: sits out 
GDOF68: sits out 
BollyMith: posts small & big blinds $0.75
*** HOLE CARDS ***
gustguaira: calls $0.50
BarUnDuck: folds 
ms1272: calls $0.50
BollyMith: checks 
chekita1965: raises $3 to $3.50
Sadyhov V.V.: folds 
KARANN899: folds 
gustguaira: calls $3
ms1272: raises $46.50 to $50 and is all-in
BollyMith: folds 
chekita1965: calls $12.38 and is all-in
gustguaira: folds 
Uncalled bet ($34.12) returned to ms1272
*** FLOP *** [Qs Ks 7s]
*** TURN *** [Qs Ks 7s] [7h]
*** RIVER *** [Qs Ks 7s 7h] [3c]
*** SHOW DOWN ***
ms1272: shows [Td Th] (two pair, Tens and Sevens)
chekita1965: shows [Ah 3h] (two pair, Sevens and Threes)
ms1272 collected $34.46 from pot
chekita1965 cashed out the hand for $11.19 | Cash Out Fee $0.11
*** SUMMARY ***
Total pot $36.76 | Rake $2.30 
Board [Qs Ks 7s 7h 3c]
Seat 2: ms1272 showed [Td Th] and won ($34.46) with two pair, Tens and Sevens
Seat 3: BollyMith folded before Flop (didn't bet)
Seat 4: chekita1965 (button) showed [Ah 3h] and lost with two pair, Sevens and Threes (cashed out).
Seat 5: Sadyhov V.V. (small blind) folded before Flop
Seat 6: KARANN899 (big blind) folded before Flop
Seat 7: gustguaira folded before Flop
Seat 9: BarUnDuck folded before Flop (didn't bet)



PokerStars Hand #228692788599:  Hold'em No Limit ($0.25/$0.50 USD) - 2021/07/30 19:13:58 ET
Table 'Aitne III' 9-max Seat #5 is the button
Seat 2: ms1272 ($68.58 in chips) 
Seat 3: BollyMith ($24.56 in chips) 
Seat 4: chekita1965 ($11.19 in chips) 
Seat 5: Sadyhov V.V. ($50 in chips) 
Seat 6: KARANN899 ($47.98 in chips) 
Seat 7: gustguaira ($41.97 in chips) 
Seat 9: BarUnDuck ($20 in chips) 
KARANN899: posts small blind $0.25
gustguaira: posts big blind $0.50
PanicJX: sits out 
GDOF68: sits out 
*** HOLE CARDS ***
BarUnDuck: folds 
ms1272: raises $0.50 to $1
BollyMith: raises $3 to $4
chekita1965: folds 
Sadyhov V.V.: folds 
KARANN899: folds 
gustguaira: folds 
ms1272: folds 
Uncalled bet ($3) returned to BollyMith
BollyMith collected $2.75 from pot
BollyMith: doesn't show hand 
*** SUMMARY ***
Total pot $2.75 | Rake $0 
Seat 2: ms1272 folded before Flop
Seat 3: BollyMith collected ($2.75)
Seat 4: chekita1965 folded before Flop (didn't bet)
Seat 5: Sadyhov V.V. (button) folded before Flop (didn't bet)
Seat 6: KARANN899 (small blind) folded before Flop
Seat 7: gustguaira (big blind) folded before Flop
Seat 9: BarUnDuck folded before Flop (didn't bet)



PokerStars Hand #228692797027:  Hold'em No Limit ($0.25/$0.50 USD) - 2021/07/30 19:14:22 ET
Table 'Aitne III' 9-max Seat #6 is the button
Seat 2: ms1272 ($67.58 in chips) 
Seat 3: BollyMith ($26.31 in chips) 
Seat 4: chekita1965 ($11.19 in chips) 
Seat 5: Sadyhov V.V. ($50 in chips) 
Seat 6: KARANN899 ($47.73 in chips) 
Seat 7: gustguaira ($41.47 in chips) 
Seat 8: PanicJX ($50 in chips) 
Seat 9: BarUnDuck ($20 in chips) 
gustguaira: posts small blind $0.25
PanicJX: posts big blind $0.50
GDOF68: sits out 
*** HOLE CARDS ***
BarUnDuck: raises $0.50 to $1
ms1272: folds 
BollyMith: folds 
chekita1965: folds 
Sadyhov V.V.: folds 
KARANN899: folds 
gustguaira: folds 
PanicJX: folds 
Uncalled bet ($0.50) returned to BarUnDuck
BarUnDuck collected $1.25 from pot
BarUnDuck: doesn't show hand 
*** SUMMARY ***
Total pot $1.25 | Rake $0 
Seat 2: ms1272 folded before Flop (didn't bet)
Seat 3: BollyMith folded before Flop (didn't bet)
Seat 4: chekita1965 folded before Flop (didn't bet)
Seat 5: Sadyhov V.V. folded before Flop (didn't bet)
Seat 6: KARANN899 (button) folded before Flop (didn't bet)
Seat 7: gustguaira (small blind) folded before Flop
Seat 8: PanicJX (big blind) folded before Flop
Seat 9: BarUnDuck collected ($1.25)



PokerStars Hand #228692803125:  Hold'em No Limit ($0.25/$0.50 USD) - 2021/07/30 19:14:39 ET
Table 'Aitne III' 9-max Seat #7 is the button
Seat 2: ms1272 ($67.58 in chips) 
Seat 3: BollyMith ($26.31 in chips) 
Seat 4: chekita1965 ($11.19 in chips) 
Seat 5: Sadyhov V.V. ($50 in chips) 
Seat 6: KARANN899 ($47.73 in chips) 
Seat 7: gustguaira ($41.22 in chips) 
Seat 8: PanicJX ($49.50 in chips) 
Seat 9: BarUnDuck ($20.75 in chips) 
PanicJX: posts small blind $0.25
BarUnDuck: posts big blind $0.50
GDOF68: sits out 
*** HOLE CARDS ***
ms1272: folds 
BollyMith: raises $0.60 to $1.10
chekita1965: folds 
Sadyhov V.V.: folds 
KARANN899: folds 
gustguaira: calls $1.10
PanicJX: folds 
BarUnDuck: calls $0.60
*** FLOP *** [3s 5s 7c]
BarUnDuck: checks 
BollyMith: bets $1.85
gustguaira: folds 
BarUnDuck: folds 
Uncalled bet ($1.85) returned to BollyMith
BollyMith collected $3.37 from pot
*** SUMMARY ***
Total pot $3.55 | Rake $0.18 
Board [3s 5s 7c]
Seat 2: ms1272 folded before Flop (didn't bet)
Seat 3: BollyMith collected ($3.37)
Seat 4: chekita1965 folded before Flop (didn't bet)
Seat 5: Sadyhov V.V. folded before Flop (didn't bet)
Seat 6: KARANN899 folded before Flop (didn't bet)
Seat 7: gustguaira (button) folded on the Flop
Seat 8: PanicJX (small blind) folded before Flop
Seat 9: BarUnDuck (big blind) folded on the Flop



PokerStars Hand #228692815939:  Hold'em No Limit ($0.25/$0.50 USD) - 2021/07/30 19:15:16 ET
Table 'Aitne III' 9-max Seat #8 is the button
Seat 1: GDOF68 ($50 in chips) 
Seat 2: ms1272 ($67.58 in chips) 
Seat 3: BollyMith ($28.58 in chips) 
Seat 4: chekita1965 ($50 in chips) 
Seat 5: Sadyhov V.V. ($50 in chips) 
Seat 6: KARANN899 ($47.73 in chips) 
Seat 7: gustguaira ($40.12 in chips) 
Seat 8: PanicJX ($49.25 in chips) 
Seat 9: BarUnDuck ($19.65 in chips) 
BarUnDuck: posts small blind $0.25
GDOF68: posts big blind $0.50
*** HOLE CARDS ***
ms1272: folds 
BollyMith: folds 
chekita1965: folds 
Sadyhov V.V.: raises $0.60 to $1.10
KARANN899: folds 
gustguaira: folds 
PanicJX: folds 
BarUnDuck: folds 
GDOF68: folds 
Uncalled bet ($0.60) returned to Sadyhov V.V.
Sadyhov V.V. collected $1.25 from pot
Sadyhov V.V.: doesn't show hand 
*** SUMMARY ***
Total pot $1.25 | Rake $0 
Seat 1: GDOF68 (big blind) folded before Flop
Seat 2: ms1272 folded before Flop (didn't bet)
Seat 3: BollyMith folded before Flop (didn't bet)
Seat 4: chekita1965 folded before Flop (didn't bet)
Seat 5: Sadyhov V.V. collected ($1.25)
Seat 6: KARANN899 folded before Flop (didn't bet)
Seat 7: gustguaira folded before Flop (didn't bet)
Seat 8: PanicJX (button) folded before Flop (didn't bet)
Seat 9: BarUnDuck (small blind) folded before Flop



PokerStars Hand #228692824399:  Hold'em No Limit ($0.25/$0.50 USD) - 2021/07/30 19:15:40 ET
Table 'Aitne III' 9-max Seat #9 is the button
Seat 1: GDOF68 ($50 in chips) 
Seat 2: ms1272 ($67.58 in chips) 
Seat 3: BollyMith ($28.58 in chips) 
Seat 4: chekita1965 ($50 in chips) 
Seat 5: Sadyhov V.V. ($50.75 in chips) 
Seat 6: KARANN899 ($47.73 in chips) 
Seat 7: gustguaira ($40.12 in chips) 
Seat 8: PanicJX ($49.25 in chips) 
Seat 9: BarUnDuck ($20 in chips) 
GDOF68: posts small blind $0.25
ms1272: posts big blind $0.50
*** HOLE CARDS ***
BollyMith: folds 
chekita1965: folds 
Sadyhov V.V.: folds 
KARANN899: raises $1 to $1.50
gustguaira: calls $1.50
PanicJX: folds 
BarUnDuck: folds 
GDOF68: calls $1.25
ms1272: folds 
*** FLOP *** [Kc Td As]
GDOF68: checks 
KARANN899: bets $2.38
gustguaira: calls $2.38
GDOF68: folds 
*** TURN *** [Kc Td As] [Qh]
KARANN899: checks 
gustguaira: bets $4.63
KARANN899: calls $4.63
*** RIVER *** [Kc Td As Qh] [4s]
KARANN899: checks 
gustguaira: bets $9.03
KARANN899: folds 
Uncalled bet ($9.03) returned to gustguaira
gustguaira collected $18.07 from pot
gustguaira: doesn't show hand 
*** SUMMARY ***
Total pot $19.02 | Rake $0.95 
Board [Kc Td As Qh 4s]
Seat 1: GDOF68 (small blind) folded on the Flop
Seat 2: ms1272 (big blind) folded before Flop
Seat 3: BollyMith folded before Flop (didn't bet)
Seat 4: chekita1965 folded before Flop (didn't bet)
Seat 5: Sadyhov V.V. folded before Flop (didn't bet)
Seat 6: KARANN899 folded on the River
Seat 7: gustguaira collected ($18.07)
Seat 8: PanicJX folded before Flop (didn't bet)
Seat 9: BarUnDuck (button) folded before Flop (didn't bet)



PokerStars Hand #228692852034:  Hold'em No Limit ($0.25/$0.50 USD) - 2021/07/30 19:16:59 ET
Table 'Aitne III' 9-max Seat #1 is the button
Seat 1: GDOF68 ($50 in chips) 
Seat 2: ms1272 ($67.08 in chips) 
Seat 3: BollyMith ($28.58 in chips) 
Seat 4: chekita1965 ($50 in chips) 
Seat 5: Sadyhov V.V. ($50.75 in chips) 
Seat 6: KARANN899 ($50 in chips) 
Seat 7: gustguaira ($49.68 in chips) 
Seat 8: PanicJX ($49.25 in chips) 
Seat 9: BarUnDuck ($20 in chips) 
ms1272: posts small blind $0.25
BollyMith: posts big blind $0.50
*** HOLE CARDS ***
chekita1965: folds 
Sadyhov V.V.: raises $0.60 to $1.10
KARANN899: folds 
gustguaira: folds 
PanicJX: folds 
BarUnDuck: folds 
GDOF68: folds 
ms1272: folds 
BollyMith: calls $0.60
*** FLOP *** [6d Ac 9s]
BollyMith: checks 
Sadyhov V.V.: bets $1.75
BollyMith: folds 
Uncalled bet ($1.75) returned to Sadyhov V.V.
Sadyhov V.V. collected $2.33 from pot
Sadyhov V.V.: doesn't show hand 
*** SUMMARY ***
Total pot $2.45 | Rake $0.12 
Board [6d Ac 9s]
Seat 1: GDOF68 (button) folded before Flop (didn't bet)
Seat 2: ms1272 (small blind) folded before Flop
Seat 3: BollyMith (big blind) folded on the Flop
Seat 4: chekita1965 folded before Flop (didn't bet)
Seat 5: Sadyhov V.V. collected ($2.33)
Seat 6: KARANN899 folded before Flop (didn't bet)
Seat 7: gustguaira folded before Flop (didn't bet)
Seat 8: PanicJX folded before Flop (didn't bet)
Seat 9: BarUnDuck folded before Flop (didn't bet)



PokerStars Hand #228693754286:  Hold'em No Limit ($0.25/$0.50 USD) - 2021/07/30 20:02:00 ET
Table 'Aitne III' 9-max Seat #5 is the button
Seat 1: GastonLeFort ($50 in chips) 
Seat 3: BollyMith ($35.04 in chips) 
Seat 4: llov4 ($16.73 in chips) 
Seat 5: Xamil666 ($62.97 in chips) 
Seat 6: KARANN899 ($85.03 in chips) 
Seat 8: PanicJX ($42.55 in chips) 
KARANN899: posts small blind $0.25
PanicJX: posts big blind $0.50
BarUnDuck: sits out 
*** HOLE CARDS ***
GastonLeFort: folds 
BollyMith: folds 
llov4: calls $0.50
Xamil666: folds 
KARANN899: calls $0.25
PanicJX: checks 
*** FLOP *** [7s 7d 8c]
KARANN899: checks 
PanicJX: checks 
llov4: checks 
*** TURN *** [7s 7d 8c] [Jc]
frankiboy71 joins the table at seat #7 
KARANN899: checks 
PanicJX: checks 
llov4: bets $1.50
KARANN899: folds 
PanicJX: folds 
Uncalled bet ($1.50) returned to llov4
llov4 collected $1.42 from pot
llov4: doesn't show hand 
*** SUMMARY ***
Total pot $1.50 | Rake $0.08 
Board [7s 7d 8c Jc]
Seat 1: GastonLeFort folded before Flop (didn't bet)
Seat 3: BollyMith folded before Flop (didn't bet)
Seat 4: llov4 collected ($1.42)
Seat 5: Xamil666 (button) folded before Flop (didn't bet)
Seat 6: KARANN899 (small blind) folded on the Turn
Seat 8: PanicJX (big blind) folded on the Turn



PokerStars Hand #228693766435:  Hold'em No Limit ($0.25/$0.50 USD) - 2021/07/30 20:02:41 ET
Table 'Aitne III' 9-max Seat #6 is the button
Seat 1: GastonLeFort ($50 in chips) 
Seat 3: BollyMith ($35.04 in chips) 
Seat 4: llov4 ($17.65 in chips) 
Seat 5: Xamil666 ($62.97 in chips) 
Seat 6: KARANN899 ($84.53 in chips) 
Seat 8: PanicJX ($42.05 in chips) 
Seat 9: BarUnDuck ($22.49 in chips) 
PanicJX: posts small blind $0.25
BarUnDuck: posts big blind $0.50
*** HOLE CARDS ***
GastonLeFort: folds 
BollyMith: raises $0.60 to $1.10
llov4: folds 
Xamil666: calls $1.10
KARANN899: folds 
PanicJX: folds 
BarUnDuck: folds 
*** FLOP *** [Ah 5d Qh]
BollyMith: bets $1.54
Xamil666: folds 
Uncalled bet ($1.54) returned to BollyMith
BollyMith collected $2.80 from pot
*** SUMMARY ***
Total pot $2.95 | Rake $0.15 
Board [Ah 5d Qh]
Seat 1: GastonLeFort folded before Flop (didn't bet)
Seat 3: BollyMith collected ($2.80)
Seat 4: llov4 folded before Flop (didn't bet)
Seat 5: Xamil666 folded on the Flop
Seat 6: KARANN899 (button) folded before Flop (didn't bet)
Seat 8: PanicJX (small blind) folded before Flop
Seat 9: BarUnDuck (big blind) folded before Flop



PokerStars Hand #228693773626:  Hold'em No Limit ($0.25/$0.50 USD) - 2021/07/30 20:03:05 ET
Table 'Aitne III' 9-max Seat #8 is the button
Seat 1: GastonLeFort ($50 in chips) 
Seat 3: BollyMith ($36.74 in chips) 
Seat 4: llov4 ($17.65 in chips) 
Seat 5: Xamil666 ($61.87 in chips) 
Seat 6: KARANN899 ($84.53 in chips) 
Seat 7: frankiboy71 ($20.51 in chips) 
Seat 8: PanicJX ($41.80 in chips) 
Seat 9: BarUnDuck ($21.99 in chips) 
BarUnDuck: posts small blind $0.25
GastonLeFort: posts big blind $0.50
frankiboy71: posts big blind $0.50
*** HOLE CARDS ***
BollyMith: folds 
llov4: folds 
Xamil666: folds 
KARANN899: raises $2 to $2.50
frankiboy71: calls $2
PanicJX: folds 
BarUnDuck: folds 
GastonLeFort: folds 
*** FLOP *** [9s Jh Ad]
KARANN899: bets $2.50
frankiboy71: calls $2.50
*** TURN *** [9s Jh Ad] [Td]
KARANN899: bets $16
frankiboy71: folds 
Uncalled bet ($16) returned to KARANN899
KARANN899 collected $10.21 from pot
KARANN899: doesn't show hand 
*** SUMMARY ***
Total pot $10.75 | Rake $0.54 
Board [9s Jh Ad Td]
Seat 1: GastonLeFort (big blind) folded before Flop
Seat 3: BollyMith folded before Flop (didn't bet)
Seat 4: llov4 folded before Flop (didn't bet)
Seat 5: Xamil666 folded before Flop (didn't bet)
Seat 6: KARANN899 collected ($10.21)
Seat 7: frankiboy71 folded on the Turn
Seat 8: PanicJX (button) folded before Flop (didn't bet)
Seat 9: BarUnDuck (small blind) folded before Flop



PokerStars Hand #228693792425:  Hold'em No Limit ($0.25/$0.50 USD) - 2021/07/30 20:03:55 ET
Table 'Aitne III' 9-max Seat #9 is the button
Seat 1: GastonLeFort ($50 in chips) 
Seat 3: BollyMith ($36.74 in chips) 
Seat 4: llov4 ($17.65 in chips) 
Seat 5: Xamil666 ($61.87 in chips) 
Seat 6: KARANN899 ($89.74 in chips) 
Seat 7: frankiboy71 ($15.51 in chips) 
Seat 8: PanicJX ($41.80 in chips) 
Seat 9: BarUnDuck ($21.74 in chips) 
GastonLeFort: posts small blind $0.25
BollyMith: posts big blind $0.50
*** HOLE CARDS ***
llov4: folds 
Xamil666: folds 
KARANN899: raises $1 to $1.50
frankiboy71: folds 
PanicJX: folds 
BarUnDuck: folds 
GastonLeFort: folds 
BollyMith: calls $1
*** FLOP *** [4s 9s 6h]
BollyMith: checks 
KARANN899: bets $2.06
BollyMith: raises $4.44 to $6.50
KARANN899: raises $81.74 to $88.24 and is all-in
BollyMith: folds 
Uncalled bet ($81.74) returned to KARANN899
KARANN899 collected $15.44 from pot
KARANN899: doesn't show hand 
*** SUMMARY ***
Total pot $16.25 | Rake $0.81 
Board [4s 9s 6h]
Seat 1: GastonLeFort (small blind) folded before Flop
Seat 3: BollyMith (big blind) folded on the Flop
Seat 4: llov4 folded before Flop (didn't bet)
Seat 5: Xamil666 folded before Flop (didn't bet)
Seat 6: KARANN899 collected ($15.44)
Seat 7: frankiboy71 folded before Flop (didn't bet)
Seat 8: PanicJX folded before Flop (didn't bet)
Seat 9: BarUnDuck (button) folded before Flop (didn't bet)



PokerStars Hand #228693807630:  Hold'em No Limit ($0.25/$0.50 USD) - 2021/07/30 20:04:47 ET
Table 'Aitne III' 9-max Seat #1 is the button
Seat 1: GastonLeFort ($50 in chips) 
Seat 3: BollyMith ($28.74 in chips) 
Seat 4: llov4 ($17.65 in chips) 
Seat 5: Xamil666 ($61.87 in chips) 
Seat 6: KARANN899 ($97.18 in chips) 
Seat 7: frankiboy71 ($15.51 in chips) 
Seat 8: PanicJX ($41.80 in chips) 
Seat 9: BarUnDuck ($21.74 in chips) 
BollyMith: posts small blind $0.25
llov4: posts big blind $0.50
*** HOLE CARDS ***
Xamil666: folds 
KARANN899: folds 
frankiboy71: folds 
PanicJX: folds 
BarUnDuck: folds 
GastonLeFort: folds 
BollyMith: calls $0.25
llov4: checks 
*** FLOP *** [Ah Ad Kh]
BollyMith: checks 
llov4: checks 
*** TURN *** [Ah Ad Kh] [Ks]
BollyMith: checks 
llov4: checks 
*** RIVER *** [Ah Ad Kh Ks] [5d]
BollyMith: checks 
llov4: checks 
*** SHOW DOWN ***
BollyMith: shows [4d 2d] (two pair, Aces and Kings)
llov4: shows [9h 7c] (two pair, Aces and Kings - Nine kicker)
llov4 collected $0.95 from pot
*** SUMMARY ***
Total pot $1 | Rake $0.05 
Board [Ah Ad Kh Ks 5d]
Seat 1: GastonLeFort (button) folded before Flop (didn't bet)
Seat 3: BollyMith (small blind) showed [4d 2d] and lost with two pair, Aces and Kings
Seat 4: llov4 (big blind) showed [9h 7c] and won ($0.95) with two pair, Aces and Kings
Seat 5: Xamil666 folded before Flop (didn't bet)
Seat 6: KARANN899 folded before Flop (didn't bet)
Seat 7: frankiboy71 folded before Flop (didn't bet)
Seat 8: PanicJX folded before Flop (didn't bet)
Seat 9: BarUnDuck folded before Flop (didn't bet)



PokerStars Hand #228693814512:  Hold'em No Limit ($0.25/$0.50 USD) - 2021/07/30 20:05:10 ET
Table 'Aitne III' 9-max Seat #3 is the button
Seat 1: GastonLeFort ($50 in chips) 
Seat 3: BollyMith ($28.24 in chips) 
Seat 4: llov4 ($18.10 in chips) 
Seat 5: Xamil666 ($61.87 in chips) 
Seat 6: KARANN899 ($97.18 in chips) 
Seat 7: frankiboy71 ($15.51 in chips) 
Seat 8: PanicJX ($41.80 in chips) 
Seat 9: BarUnDuck ($21.74 in chips) 
llov4: posts small blind $0.25
Xamil666: posts big blind $0.50
*** HOLE CARDS ***
KARANN899: raises $1 to $1.50
frankiboy71: calls $1.50
PanicJX: folds 
BarUnDuck: folds 
GastonLeFort: folds 
BollyMith: folds 
llov4: folds 
Xamil666: folds 
*** FLOP *** [Qs 7d Jh]
KARANN899: bets $1.78
frankiboy71: calls $1.78
*** TURN *** [Qs 7d Jh] [8h]
KARANN899: bets $5.21
frankiboy71: folds 
Uncalled bet ($5.21) returned to KARANN899
KARANN899 collected $6.94 from pot
KARANN899: doesn't show hand 
*** SUMMARY ***
Total pot $7.31 | Rake $0.37 
Board [Qs 7d Jh 8h]
Seat 1: GastonLeFort folded before Flop (didn't bet)
Seat 3: BollyMith (button) folded before Flop (didn't bet)
Seat 4: llov4 (small blind) folded before Flop
Seat 5: Xamil666 (big blind) folded before Flop
Seat 6: KARANN899 collected ($6.94)
Seat 7: frankiboy71 folded on the Turn
Seat 8: PanicJX folded before Flop (didn't bet)
Seat 9: BarUnDuck folded before Flop (didn't bet)



PokerStars Hand #228693824614:  Hold'em No Limit ($0.25/$0.50 USD) - 2021/07/30 20:05:43 ET
Table 'Aitne III' 9-max Seat #4 is the button
Seat 1: GastonLeFort ($50 in chips) 
Seat 3: BollyMith ($28.24 in chips) 
Seat 4: llov4 ($17.85 in chips) 
Seat 5: Xamil666 ($61.37 in chips) 
Seat 6: KARANN899 ($100.84 in chips) 
Seat 7: frankiboy71 ($12.23 in chips) 
Seat 8: PanicJX ($41.80 in chips) 
Seat 9: BarUnDuck ($21.74 in chips) 
Xamil666: posts small blind $0.25
KARANN899: posts big blind $0.50
*** HOLE CARDS ***
frankiboy71: folds 
PanicJX: folds 
BarUnDuck: folds 
GastonLeFort: raises $1 to $1.50
BollyMith: raises $2.50 to $4
llov4: folds 
Xamil666: folds 
KARANN899: folds 
GastonLeFort: folds 
Uncalled bet ($2.50) returned to BollyMith
BollyMith collected $3.75 from pot
BollyMith: doesn't show hand 
*** SUMMARY ***
Total pot $3.75 | Rake $0 
Seat 1: GastonLeFort folded before Flop
Seat 3: BollyMith collected ($3.75)
Seat 4: llov4 (button) folded before Flop (didn't bet)
Seat 5: Xamil666 (small blind) folded before Flop
Seat 6: KARANN899 (big blind) folded before Flop
Seat 7: frankiboy71 folded before Flop (didn't bet)
Seat 8: PanicJX folded before Flop (didn't bet)
Seat 9: BarUnDuck folded before Flop (didn't bet)



PokerStars Hand #228693834525:  Hold'em No Limit ($0.25/$0.50 USD) - 2021/07/30 20:06:17 ET
Table 'Aitne III' 9-max Seat #5 is the button
Seat 1: GastonLeFort ($50 in chips) 
Seat 3: BollyMith ($30.49 in chips) 
Seat 4: llov4 ($17.85 in chips) 
Seat 5: Xamil666 ($61.12 in chips) 
Seat 6: KARANN899 ($100.34 in chips) 
Seat 7: frankiboy71 ($12.23 in chips) 
Seat 8: PanicJX ($41.80 in chips) 
Seat 9: BarUnDuck ($21.74 in chips) 
KARANN899: posts small blind $0.25
frankiboy71: posts big blind $0.50
*** HOLE CARDS ***
PanicJX: folds 
BarUnDuck: folds 
GastonLeFort: folds 
BollyMith: folds 
llov4: calls $0.50
Xamil666: folds 
KARANN899: calls $0.25
frankiboy71: checks 
*** FLOP *** [9h 8s 5c]
KARANN899: checks 
frankiboy71: checks 
llov4: bets $1.50
KARANN899: calls $1.50
frankiboy71: folds 
*** TURN *** [9h 8s 5c] [Jd]
KARANN899: checks 
llov4: checks 
*** RIVER *** [9h 8s 5c Jd] [2d]
KARANN899: checks 
llov4: bets $2.50
KARANN899: folds 
Uncalled bet ($2.50) returned to llov4
llov4 collected $4.28 from pot
llov4: doesn't show hand 
*** SUMMARY ***
Total pot $4.50 | Rake $0.22 
Board [9h 8s 5c Jd 2d]
Seat 1: GastonLeFort folded before Flop (didn't bet)
Seat 3: BollyMith folded before Flop (didn't bet)
Seat 4: llov4 collected ($4.28)
Seat 5: Xamil666 (button) folded before Flop (didn't bet)
Seat 6: KARANN899 (small blind) folded on the River
Seat 7: frankiboy71 (big blind) folded on the Flop
Seat 8: PanicJX folded before Flop (didn't bet)
Seat 9: BarUnDuck folded before Flop (didn't bet)



PokerStars Hand #228693852096:  Hold'em No Limit ($0.25/$0.50 USD) - 2021/07/30 20:07:17 ET
Table 'Aitne III' 9-max Seat #6 is the button
Seat 1: GastonLeFort ($50 in chips) 
Seat 3: BollyMith ($30.49 in chips) 
Seat 4: llov4 ($20.13 in chips) 
Seat 5: Xamil666 ($61.12 in chips) 
Seat 6: KARANN899 ($98.34 in chips) 
Seat 7: frankiboy71 ($11.73 in chips) 
Seat 8: PanicJX ($41.80 in chips) 
Seat 9: BarUnDuck ($21.74 in chips) 
frankiboy71: posts small blind $0.25
PanicJX: posts big blind $0.50
*** HOLE CARDS ***
BarUnDuck: folds 
GastonLeFort: folds 
BollyMith: folds 
llov4: folds 
Xamil666: raises $0.75 to $1.25
KARANN899: calls $1.25
frankiboy71: calls $1
PanicJX: calls $0.75
*** FLOP *** [Qc 5s 4s]
frankiboy71: checks 
PanicJX: checks 
Xamil666: bets $3.56
KARANN899: folds 
frankiboy71: raises $6.92 to $10.48 and is all-in
PanicJX: folds 
Xamil666: calls $6.92
*** TURN *** [Qc 5s 4s] [5d]
*** RIVER *** [Qc 5s 4s 5d] [4h]
*** SHOW DOWN ***
frankiboy71: shows [Ah Qd] (two pair, Queens and Fives)
Xamil666: shows [Ks Kh] (two pair, Kings and Fives)
Xamil666 collected $24.66 from pot
frankiboy71 cashed out the hand for $4.91 | Cash Out Fee $0.05
*** SUMMARY ***
Total pot $25.96 | Rake $1.30 
Board [Qc 5s 4s 5d 4h]
Seat 1: GastonLeFort folded before Flop (didn't bet)
Seat 3: BollyMith folded before Flop (didn't bet)
Seat 4: llov4 folded before Flop (didn't bet)
Seat 5: Xamil666 showed [Ks Kh] and won ($24.66) with two pair, Kings and Fives
Seat 6: KARANN899 (button) folded on the Flop
Seat 7: frankiboy71 (small blind) showed [Ah Qd] and lost with two pair, Queens and Fives (cashed out).
Seat 8: PanicJX (big blind) folded on the Flop
Seat 9: BarUnDuck folded before Flop (didn't bet)



PokerStars Hand #228693866615:  Hold'em No Limit ($0.25/$0.50 USD) - 2021/07/30 20:08:05 ET
Table 'Aitne III' 9-max Seat #7 is the button
Seat 1: GastonLeFort ($50 in chips) 
Seat 3: BollyMith ($30.49 in chips) 
Seat 4: llov4 ($20.13 in chips) 
Seat 5: Xamil666 ($74.05 in chips) 
Seat 6: KARANN899 ($97.09 in chips) 
Seat 7: frankiboy71 ($4.91 in chips) 
Seat 8: PanicJX ($40.55 in chips) 
Seat 9: BarUnDuck ($21.74 in chips) 
PanicJX: posts small blind $0.25
BarUnDuck: posts big blind $0.50
*** HOLE CARDS ***
GastonLeFort: folds 
BollyMith: folds 
llov4: folds 
Xamil666: raises $0.75 to $1.25
KARANN899: folds 
frankiboy71: raises $3.66 to $4.91 and is all-in
PanicJX: folds 
BarUnDuck: folds 
Xamil666: calls $3.66
*** FLOP *** [3c Kh 8d]
*** TURN *** [3c Kh 8d] [6c]
*** RIVER *** [3c Kh 8d 6c] [Jh]
*** SHOW DOWN ***
Xamil666: shows [Qs Kd] (a pair of Kings)
frankiboy71: shows [5d Ad] (high card Ace)
Xamil666 collected $10.04 from pot
*** SUMMARY ***
Total pot $10.57 | Rake $0.53 
Board [3c Kh 8d 6c Jh]
Seat 1: GastonLeFort folded before Flop (didn't bet)
Seat 3: BollyMith folded before Flop (didn't bet)
Seat 4: llov4 folded before Flop (didn't bet)
Seat 5: Xamil666 showed [Qs Kd] and won ($10.04) with a pair of Kings
Seat 6: KARANN899 folded before Flop (didn't bet)
Seat 7: frankiboy71 (button) showed [5d Ad] and lost with high card Ace
Seat 8: PanicJX (small blind) folded before Flop
Seat 9: BarUnDuck (big blind) folded before Flop



PokerStars Hand #228693873472:  Hold'em No Limit ($0.25/$0.50 USD) - 2021/07/30 20:08:28 ET
Table 'Aitne III' 9-max Seat #8 is the button
Seat 1: GastonLeFort ($50 in chips) 
Seat 3: BollyMith ($30.49 in chips) 
Seat 4: llov4 ($20.13 in chips) 
Seat 5: Xamil666 ($79.18 in chips) 
Seat 6: KARANN899 ($97.09 in chips) 
Seat 8: PanicJX ($40.30 in chips) 
Seat 9: BarUnDuck ($21.24 in chips) 
BarUnDuck: posts small blind $0.25
GastonLeFort: posts big blind $0.50
*** HOLE CARDS ***
BollyMith: folds 
frankiboy71 leaves the table
llov4: calls $0.50
Xamil666: folds 
KARANN899: folds 
PanicJX: folds 
Mc57Arnold joins the table at seat #7 
BarUnDuck: folds 
GastonLeFort: checks 
*** FLOP *** [5c Kd Ah]
GastonLeFort: checks 
llov4: checks 
*** TURN *** [5c Kd Ah] [5d]
GastonLeFort: checks 
llov4: bets $1.50
GastonLeFort: folds 
Uncalled bet ($1.50) returned to llov4
llov4 collected $1.19 from pot
llov4: doesn't show hand 
*** SUMMARY ***
Total pot $1.25 | Rake $0.06 
Board [5c Kd Ah 5d]
Seat 1: GastonLeFort (big blind) folded on the Turn
Seat 3: BollyMith folded before Flop (didn't bet)
Seat 4: llov4 collected ($1.19)
Seat 5: Xamil666 folded before Flop (didn't bet)
Seat 6: KARANN899 folded before Flop (didn't bet)
Seat 8: PanicJX (button) folded before Flop (didn't bet)
Seat 9: BarUnDuck (small blind) folded before Flop



PokerStars Hand #228693885460:  Hold'em No Limit ($0.25/$0.50 USD) - 2021/07/30 20:09:09 ET
Table 'Aitne III' 9-max Seat #9 is the button
Seat 1: GastonLeFort ($50 in chips) 
Seat 3: BollyMith ($30.49 in chips) 
Seat 4: llov4 ($20.82 in chips) 
Seat 5: Xamil666 ($79.18 in chips) 
Seat 6: KARANN899 ($97.09 in chips) 
Seat 8: PanicJX ($40.30 in chips) 
Seat 9: BarUnDuck ($20.99 in chips) 
GastonLeFort: posts small blind $0.25
BollyMith: posts big blind $0.50
Mc57Arnold: sits out 
*** HOLE CARDS ***
llov4: calls $0.50
Xamil666: folds 
KARANN899: folds 
PanicJX: folds 
BarUnDuck: folds 
GastonLeFort: folds 
BollyMith: checks 
*** FLOP *** [4d 6s 2h]
BollyMith: checks 
llov4: checks 
*** TURN *** [4d 6s 2h] [Ts]
BollyMith: bets $0.65
llov4: folds 
Uncalled bet ($0.65) returned to BollyMith
BollyMith collected $1.19 from pot
BollyMith: doesn't show hand 
*** SUMMARY ***
Total pot $1.25 | Rake $0.06 
Board [4d 6s 2h Ts]
Seat 1: GastonLeFort (small blind) folded before Flop
Seat 3: BollyMith (big blind) collected ($1.19)
Seat 4: llov4 folded on the Turn
Seat 5: Xamil666 folded before Flop (didn't bet)
Seat 6: KARANN899 folded before Flop (didn't bet)
Seat 8: PanicJX folded before Flop (didn't bet)
Seat 9: BarUnDuck (button) folded before Flop (didn't bet)



PokerStars Hand #228693893471:  Hold'em No Limit ($0.25/$0.50 USD) - 2021/07/30 20:09:36 ET
Table 'Aitne III' 9-max Seat #1 is the button
Seat 1: GastonLeFort ($50 in chips) 
Seat 3: BollyMith ($31.18 in chips) 
Seat 4: llov4 ($20.32 in chips) 
Seat 5: Xamil666 ($79.18 in chips) 
Seat 6: KARANN899 ($97.09 in chips) 
Seat 8: PanicJX ($40.30 in chips) 
Seat 9: BarUnDuck ($20.99 in chips) 
BollyMith: posts small blind $0.25
llov4: posts big blind $0.50
Mc57Arnold: sits out 
*** HOLE CARDS ***
Xamil666: folds 
KARANN899: folds 
PanicJX: raises $0.75 to $1.25
BarUnDuck: folds 
GastonLeFort: folds 
BollyMith: folds 
llov4: calls $0.75
*** FLOP *** [Qc Js 9h]
llov4: checks 
PanicJX: bets $0.65
llov4: calls $0.65
*** TURN *** [Qc Js 9h] [Kd]
llov4: checks 
PanicJX: bets $3.85
llov4: calls $3.85
*** RIVER *** [Qc Js 9h Kd] [Jh]
llov4: checks 
PanicJX: checks 
*** SHOW DOWN ***
llov4: shows [Jc Tc] (a straight, Nine to King)
PanicJX: mucks hand 
llov4 collected $11.16 from pot
*** SUMMARY ***
Total pot $11.75 | Rake $0.59 
Board [Qc Js 9h Kd Jh]
Seat 1: GastonLeFort (button) folded before Flop (didn't bet)
Seat 3: BollyMith (small blind) folded before Flop
Seat 4: llov4 (big blind) showed [Jc Tc] and won ($11.16) with a straight, Nine to King
Seat 5: Xamil666 folded before Flop (didn't bet)
Seat 6: KARANN899 folded before Flop (didn't bet)
Seat 8: PanicJX mucked
Seat 9: BarUnDuck folded before Flop (didn't bet)



PokerStars Hand #228693905990:  Hold'em No Limit ($0.25/$0.50 USD) - 2021/07/30 20:10:18 ET
Table 'Aitne III' 9-max Seat #3 is the button
Seat 1: GastonLeFort ($50 in chips) 
Seat 3: BollyMith ($30.93 in chips) 
Seat 4: llov4 ($25.73 in chips) 
Seat 5: Xamil666 ($79.18 in chips) 
Seat 6: KARANN899 ($97.09 in chips) 
Seat 8: PanicJX ($34.55 in chips) 
Seat 9: BarUnDuck ($20.99 in chips) 
llov4: posts small blind $0.25
Xamil666: posts big blind $0.50
Mc57Arnold: sits out 
*** HOLE CARDS ***
KARANN899: folds 
PanicJX: folds 
BarUnDuck has timed out
BarUnDuck: folds 
GastonLeFort: folds 
BollyMith: raises $0.60 to $1.10
llov4: folds 
Xamil666: calls $0.60
*** FLOP *** [8c Jc Qs]
Xamil666: checks 
BollyMith: checks 
*** TURN *** [8c Jc Qs] [Th]
Xamil666: checks 
BollyMith: bets $1.75
ms1272 leaves the table
Xamil666: folds 
Uncalled bet ($1.75) returned to BollyMith
BollyMith collected $2.33 from pot
BollyMith: doesn't show hand 
*** SUMMARY ***
Total pot $2.45 | Rake $0.12 
Board [8c Jc Qs Th]
Seat 1: GastonLeFort folded before Flop (didn't bet)
Seat 3: BollyMith (button) collected ($2.33)
Seat 4: llov4 (small blind) folded before Flop
Seat 5: Xamil666 (big blind) folded on the Turn
Seat 6: KARANN899 folded before Flop (didn't bet)
Seat 8: PanicJX folded before Flop (didn't bet)
Seat 9: BarUnDuck folded before Flop (didn't bet)



PokerStars Hand #228693916269:  Hold'em No Limit ($0.25/$0.50 USD) - 2021/07/30 20:10:53 ET
Table 'Aitne III' 9-max Seat #4 is the button
Seat 1: GastonLeFort ($50 in chips) 
Seat 3: BollyMith ($32.16 in chips) 
Seat 4: llov4 ($25.48 in chips) 
Seat 5: Xamil666 ($78.08 in chips) 
Seat 6: KARANN899 ($97.09 in chips) 
Seat 8: PanicJX ($34.55 in chips) 
Seat 9: BarUnDuck ($20.99 in chips) 
Xamil666: posts small blind $0.25
KARANN899: posts big blind $0.50
Mc57Arnold: sits out 
*** HOLE CARDS ***
PanicJX: raises $0.75 to $1.25
BarUnDuck: folds 
GastonLeFort: folds 
BollyMith: folds 
llov4: calls $1.25
Xamil666: folds 
KARANN899: folds 
*** FLOP *** [9c 7s 4d]
PanicJX: bets $1.55
llov4: calls $1.55
*** TURN *** [9c 7s 4d] [6d]
PanicJX: bets $6.03
llov4: raises $16.65 to $22.68 and is all-in
l_The_Nuts_l joins the table at seat #2 
PanicJX: calls $16.65
*** RIVER *** [9c 7s 4d 6d] [2s]
*** SHOW DOWN ***
PanicJX: shows [Ts Tc] (a pair of Tens)
llov4: shows [8h 9s] (a pair of Nines)
PanicJX cashed out the hand for $40.27 | Cash Out Fee $0.41
*** SUMMARY ***
Total pot $51.71 | Rake $2 
Board [9c 7s 4d 6d 2s]
Seat 1: GastonLeFort folded before Flop (didn't bet)
Seat 3: BollyMith folded before Flop (didn't bet)
Seat 4: llov4 (button) showed [8h 9s] and lost with a pair of Nines
Seat 5: Xamil666 (small blind) folded before Flop
Seat 6: KARANN899 (big blind) folded before Flop
Seat 8: PanicJX showed [Ts Tc] and won ($49.71) with a pair of Tens (pot not awarded as player cashed out)
Seat 9: BarUnDuck folded before Flop (didn't bet)



PokerStars Hand #228693934612:  Hold'em No Limit ($0.25/$0.50 USD) - 2021/07/30 20:11:55 ET
Table 'Aitne III' 9-max Seat #5 is the button
Seat 1: GastonLeFort ($50 in chips) 
Seat 3: BollyMith ($32.16 in chips) 
Seat 5: Xamil666 ($77.83 in chips) 
Seat 6: KARANN899 ($96.59 in chips) 
Seat 7: Mc57Arnold ($50 in chips) 
Seat 8: PanicJX ($49.34 in chips) 
Seat 9: BarUnDuck ($20.99 in chips) 
KARANN899: posts small blind $0.25
Mc57Arnold: posts big blind $0.50
l_The_Nuts_l: sits out 
*** HOLE CARDS ***
llov4 leaves the table
PanicJX: folds 
BarUnDuck: folds 
GastonLeFort: folds 
BollyMith: folds 
Xamil666: raises $0.75 to $1.25
KARANN899: folds 
Mc57Arnold: folds 
Uncalled bet ($0.75) returned to Xamil666
Xamil666 collected $1.25 from pot
*** SUMMARY ***
Total pot $1.25 | Rake $0 
Seat 1: GastonLeFort folded before Flop (didn't bet)
Seat 3: BollyMith folded before Flop (didn't bet)
Seat 5: Xamil666 (button) collected ($1.25)
Seat 6: KARANN899 (small blind) folded before Flop
Seat 7: Mc57Arnold (big blind) folded before Flop
Seat 8: PanicJX folded before Flop (didn't bet)
Seat 9: BarUnDuck folded before Flop (didn't bet)



PokerStars Hand #228693940774:  Hold'em No Limit ($0.25/$0.50 USD) - 2021/07/30 20:12:16 ET
Table 'Aitne III' 9-max Seat #6 is the button
Seat 1: GastonLeFort ($50 in chips) 
Seat 3: BollyMith ($32.16 in chips) 
Seat 5: Xamil666 ($78.58 in chips) 
Seat 6: KARANN899 ($96.34 in chips) 
Seat 7: Mc57Arnold ($50 in chips) 
Seat 8: PanicJX ($49.34 in chips) 
Seat 9: BarUnDuck ($20.99 in chips) 
Mc57Arnold: posts small blind $0.25
PanicJX: posts big blind $0.50
l_The_Nuts_l: sits out 
*** HOLE CARDS ***
BarUnDuck: folds 
GastonLeFort: folds 
BollyMith: folds 
Xamil666: folds 
KARANN899: raises $1 to $1.50
Mc57Arnold: folds 
PanicJX: calls $1
*** FLOP *** [Th 8c 6h]
PanicJX: checks 
KARANN899: bets $1.55
PanicJX: raises $1.55 to $3.10
KARANN899: calls $1.55
*** TURN *** [Th 8c 6h] [6s]
PanicJX: bets $8.98
KARANN899: folds 
Uncalled bet ($8.98) returned to PanicJX
PanicJX collected $8.98 from pot
PanicJX: doesn't show hand 
*** SUMMARY ***
Total pot $9.45 | Rake $0.47 
Board [Th 8c 6h 6s]
Seat 1: GastonLeFort folded before Flop (didn't bet)
Seat 3: BollyMith folded before Flop (didn't bet)
Seat 5: Xamil666 folded before Flop (didn't bet)
Seat 6: KARANN899 (button) folded on the Turn
Seat 7: Mc57Arnold (small blind) folded before Flop
Seat 8: PanicJX (big blind) collected ($8.98)
Seat 9: BarUnDuck folded before Flop (didn't bet)



PokerStars Hand #228693955966:  Hold'em No Limit ($0.25/$0.50 USD) - 2021/07/30 20:12:52 ET
Table 'Aitne III' 9-max Seat #7 is the button
Seat 1: GastonLeFort ($50 in chips) 
Seat 3: BollyMith ($32.16 in chips) 
Seat 5: Xamil666 ($78.58 in chips) 
Seat 6: KARANN899 ($91.74 in chips) 
Seat 7: Mc57Arnold ($50 in chips) 
Seat 8: PanicJX ($53.72 in chips) 
Seat 9: BarUnDuck ($20.99 in chips) 
PanicJX: posts small blind $0.25
BarUnDuck: posts big blind $0.50
l_The_Nuts_l: sits out 
*** HOLE CARDS ***
GastonLeFort: folds 
BollyMith: folds 
Xamil666: folds 
KARANN899: raises $0.75 to $1.25
Mc57Arnold: folds 
PanicJX: folds 
BarUnDuck: calls $0.75
*** FLOP *** [Ah As 5d]
BarUnDuck: checks 
KARANN899: bets $1.31
BarUnDuck: folds 
Uncalled bet ($1.31) returned to KARANN899
KARANN899 collected $2.61 from pot
KARANN899: doesn't show hand 
*** SUMMARY ***
Total pot $2.75 | Rake $0.14 
Board [Ah As 5d]
Seat 1: GastonLeFort folded before Flop (didn't bet)
Seat 3: BollyMith folded before Flop (didn't bet)
Seat 5: Xamil666 folded before Flop (didn't bet)
Seat 6: KARANN899 collected ($2.61)
Seat 7: Mc57Arnold (button) folded before Flop (didn't bet)
Seat 8: PanicJX (small blind) folded before Flop
Seat 9: BarUnDuck (big blind) folded on the Flop



PokerStars Hand #228693961583:  Hold'em No Limit ($0.25/$0.50 USD) - 2021/07/30 20:13:11 ET
Table 'Aitne III' 9-max Seat #8 is the button
Seat 1: GastonLeFort ($50 in chips) 
Seat 3: BollyMith ($32.16 in chips) 
Seat 5: Xamil666 ($78.58 in chips) 
Seat 6: KARANN899 ($93.10 in chips) 
Seat 7: Mc57Arnold ($50 in chips) 
Seat 8: PanicJX ($53.47 in chips) 
Seat 9: BarUnDuck ($19.74 in chips) 
BarUnDuck: posts small blind $0.25
GastonLeFort: posts big blind $0.50
l_The_Nuts_l: sits out 
*** HOLE CARDS ***
BollyMith: raises $0.60 to $1.10
Xamil666: folds 
KARANN899: folds 
Mc57Arnold: folds 
PanicJX: folds 
BarUnDuck: folds 
GastonLeFort: calls $0.60
*** FLOP *** [6s 3s Jc]
GastonLeFort: checks 
BollyMith: checks 
*** TURN *** [6s 3s Jc] [5d]
GastonLeFort: checks 
BollyMith: checks 
*** RIVER *** [6s 3s Jc 5d] [Qc]
GastonLeFort: bets $0.58
BollyMith: calls $0.58
*** SHOW DOWN ***
GastonLeFort: shows [Qh Th] (a pair of Queens)
BollyMith: mucks hand 
GastonLeFort collected $3.43 from pot
*** SUMMARY ***
Total pot $3.61 | Rake $0.18 
Board [6s 3s Jc 5d Qc]
Seat 1: GastonLeFort (big blind) showed [Qh Th] and won ($3.43) with a pair of Queens
Seat 3: BollyMith mucked
Seat 5: Xamil666 folded before Flop (didn't bet)
Seat 6: KARANN899 folded before Flop (didn't bet)
Seat 7: Mc57Arnold folded before Flop (didn't bet)
Seat 8: PanicJX (button) folded before Flop (didn't bet)
Seat 9: BarUnDuck (small blind) folded before Flop



PokerStars Hand #228693976022:  Hold'em No Limit ($0.25/$0.50 USD) - 2021/07/30 20:14:00 ET
Table 'Aitne III' 9-max Seat #9 is the button
Seat 1: GastonLeFort ($51.75 in chips) 
Seat 2: l_The_Nuts_l ($50 in chips) 
Seat 3: BollyMith ($30.48 in chips) 
Seat 5: Xamil666 ($78.58 in chips) 
Seat 6: KARANN899 ($93.10 in chips) 
Seat 7: Mc57Arnold ($50 in chips) 
Seat 8: PanicJX ($53.47 in chips) 
Seat 9: BarUnDuck ($20 in chips) 
GastonLeFort: posts small blind $0.25
l_The_Nuts_l: posts big blind $0.50
*** HOLE CARDS ***
BollyMith: folds 
Xamil666: folds 
KARANN899: raises $1 to $1.50
Mc57Arnold: folds 
PanicJX: folds 
BarUnDuck: folds 
GastonLeFort: folds 
christyirish joins the table at seat #4 
l_The_Nuts_l: calls $1
*** FLOP *** [7d Jc 8h]
l_The_Nuts_l: checks 
KARANN899: bets $2.32
l_The_Nuts_l: folds 
Uncalled bet ($2.32) returned to KARANN899
KARANN899 collected $3.09 from pot
KARANN899: doesn't show hand 
*** SUMMARY ***
Total pot $3.25 | Rake $0.16 
Board [7d Jc 8h]
Seat 1: GastonLeFort (small blind) folded before Flop
Seat 2: l_The_Nuts_l (big blind) folded on the Flop
Seat 3: BollyMith folded before Flop (didn't bet)
Seat 5: Xamil666 folded before Flop (didn't bet)
Seat 6: KARANN899 collected ($3.09)
Seat 7: Mc57Arnold folded before Flop (didn't bet)
Seat 8: PanicJX folded before Flop (didn't bet)
Seat 9: BarUnDuck (button) folded before Flop (didn't bet)



PokerStars Hand #228693986092:  Hold'em No Limit ($0.25/$0.50 USD) - 2021/07/30 20:14:34 ET
Table 'Aitne III' 9-max Seat #1 is the button
Seat 1: GastonLeFort ($51.50 in chips) 
Seat 2: l_The_Nuts_l ($50 in chips) 
Seat 3: BollyMith ($30.48 in chips) 
Seat 4: christyirish ($50 in chips) 
Seat 5: Xamil666 ($78.58 in chips) 
Seat 6: KARANN899 ($94.69 in chips) 
Seat 7: Mc57Arnold ($50 in chips) 
Seat 8: PanicJX ($53.47 in chips) 
Seat 9: BarUnDuck ($20 in chips) 
l_The_Nuts_l: posts small blind $0.25
BollyMith: posts big blind $0.50
christyirish: posts big blind $0.50
*** HOLE CARDS ***
christyirish: checks 
Xamil666: folds 
KARANN899: folds 
Mc57Arnold: folds 
PanicJX: folds 
BarUnDuck: folds 
GastonLeFort: raises $0.75 to $1.25
l_The_Nuts_l: folds 
BollyMith: calls $0.75
christyirish: folds 
*** FLOP *** [Jd 9h Qd]
BollyMith: checks 
GastonLeFort: bets $0.77
BollyMith: calls $0.77
*** TURN *** [Jd 9h Qd] [4c]
BollyMith: checks 
GastonLeFort: bets $6.83
BollyMith: folds 
Uncalled bet ($6.83) returned to GastonLeFort
GastonLeFort collected $4.55 from pot
GastonLeFort: doesn't show hand 
*** SUMMARY ***
Total pot $4.79 | Rake $0.24 
Board [Jd 9h Qd 4c]
Seat 1: GastonLeFort (button) collected ($4.55)
Seat 2: l_The_Nuts_l (small blind) folded before Flop
Seat 3: BollyMith (big blind) folded on the Turn
Seat 4: christyirish folded before Flop (didn't bet)
Seat 5: Xamil666 folded before Flop (didn't bet)
Seat 6: KARANN899 folded before Flop (didn't bet)
Seat 7: Mc57Arnold folded before Flop (didn't bet)
Seat 8: PanicJX folded before Flop (didn't bet)
Seat 9: BarUnDuck folded before Flop (didn't bet)



PokerStars Hand #228693999233:  Hold'em No Limit ($0.25/$0.50 USD) - 2021/07/30 20:15:20 ET
Table 'Aitne III' 9-max Seat #2 is the button
Seat 1: GastonLeFort ($54.03 in chips) 
Seat 2: l_The_Nuts_l ($50 in chips) 
Seat 3: BollyMith ($28.46 in chips) 
Seat 4: christyirish ($50 in chips) 
Seat 5: Xamil666 ($78.58 in chips) 
Seat 6: KARANN899 ($94.69 in chips) 
Seat 7: Mc57Arnold ($50 in chips) 
Seat 8: PanicJX ($53.47 in chips) 
Seat 9: BarUnDuck ($20 in chips) 
BollyMith: posts small blind $0.25
christyirish: posts big blind $0.50
*** HOLE CARDS ***
Xamil666: folds 
KARANN899: raises $0.75 to $1.25
Mc57Arnold: folds 
PanicJX: folds 
BarUnDuck: folds 
GastonLeFort: folds 
l_The_Nuts_l: folds 
BollyMith: folds 
christyirish: calls $0.75
*** FLOP *** [8d 4h 6s]
christyirish: checks 
Mc57Arnold leaves the table
KARANN899: bets $1.31
christyirish: calls $1.31
*** TURN *** [8d 4h 6s] [7d]
christyirish: checks 
l_The_Nuts_l was removed from the table for failing to post
l_The_Nuts_l leaves the table
KARANN899: checks 
*** RIVER *** [8d 4h 6s 7d] [2h]
christyirish: bets $5.10
KARANN899: folds 
Uncalled bet ($5.10) returned to christyirish
christyirish collected $5.10 from pot
*** SUMMARY ***
Total pot $5.37 | Rake $0.27 
Board [8d 4h 6s 7d 2h]
Seat 1: GastonLeFort folded before Flop (didn't bet)
Seat 2: l_The_Nuts_l (button) folded before Flop (didn't bet)
Seat 3: BollyMith (small blind) folded before Flop
Seat 4: christyirish (big blind) collected ($5.10)
Seat 5: Xamil666 folded before Flop (didn't bet)
Seat 6: KARANN899 folded on the River
Seat 7: Mc57Arnold folded before Flop (didn't bet)
Seat 8: PanicJX folded before Flop (didn't bet)
Seat 9: BarUnDuck folded before Flop (didn't bet)



PokerStars Hand #228694013497:  Hold'em No Limit ($0.25/$0.50 USD) - 2021/07/30 20:16:09 ET
Table 'Aitne III' 9-max Seat #3 is the button
Seat 1: GastonLeFort ($54.03 in chips) 
Seat 3: BollyMith ($28.21 in chips) 
Seat 4: christyirish ($52.54 in chips) 
Seat 6: KARANN899 ($92.13 in chips) 
Seat 8: PanicJX ($53.47 in chips) 
Seat 9: BarUnDuck ($20 in chips) 
christyirish: posts small blind $0.25
Xamil666: is sitting out 
KARANN899: posts big blind $0.50
*** HOLE CARDS ***
PanicJX: folds 
Xamil666 leaves the table
BarUnDuck: folds 
GastonLeFort: folds 
BollyMith: folds 
christyirish: raises $1 to $1.50
KARANN899: raises $3.50 to $5
christyirish: raises $8.50 to $13.50
KARANN899: folds 
Uncalled bet ($8.50) returned to christyirish
christyirish collected $10 from pot
christyirish: doesn't show hand 
*** SUMMARY ***
Total pot $10 | Rake $0 
Seat 1: GastonLeFort folded before Flop (didn't bet)
Seat 3: BollyMith (button) folded before Flop (didn't bet)
Seat 4: christyirish (small blind) collected ($10)
Seat 6: KARANN899 (big blind) folded before Flop
Seat 8: PanicJX folded before Flop (didn't bet)
Seat 9: BarUnDuck folded before Flop (didn't bet)



PokerStars Hand #228694031416:  Hold'em No Limit ($0.25/$0.50 USD) - 2021/07/30 20:17:10 ET
Table 'Aitne III' 9-max Seat #4 is the button
Seat 1: GastonLeFort ($54.03 in chips) 
Seat 3: BollyMith ($28.21 in chips) 
Seat 4: christyirish ($57.54 in chips) 
Seat 6: KARANN899 ($87.13 in chips) 
Seat 8: PanicJX ($53.47 in chips) 
Seat 9: BarUnDuck ($20 in chips) 
KARANN899: posts small blind $0.25
PanicJX: posts big blind $0.50
*** HOLE CARDS ***
BarUnDuck: raises $0.50 to $1
GastonLeFort: folds 
BollyMith: folds 
christyirish: calls $1
KARANN899: calls $0.75
PanicJX: folds 
*** FLOP *** [Jc Kd 8h]
KARANN899: checks 
BarUnDuck: checks 
Dragonclawss joins the table at seat #2 
christyirish: checks 
*** TURN *** [Jc Kd 8h] [4h]
KARANN899: bets $2.49
BarUnDuck: folds 
christyirish: folds 
Uncalled bet ($2.49) returned to KARANN899
KARANN899 collected $3.32 from pot
KARANN899: doesn't show hand 
*** SUMMARY ***
Total pot $3.50 | Rake $0.18 
Board [Jc Kd 8h 4h]
Seat 1: GastonLeFort folded before Flop (didn't bet)
Seat 3: BollyMith folded before Flop (didn't bet)
Seat 4: christyirish (button) folded on the Turn
Seat 6: KARANN899 (small blind) collected ($3.32)
Seat 8: PanicJX (big blind) folded before Flop
Seat 9: BarUnDuck folded on the Turn



PokerStars Hand #228694050087:  Hold'em No Limit ($0.25/$0.50 USD) - 2021/07/30 20:17:46 ET
Table 'Aitne III' 9-max Seat #6 is the button
Seat 1: GastonLeFort ($54.03 in chips) 
Seat 3: BollyMith ($28.21 in chips) 
Seat 4: christyirish ($56.54 in chips) 
Seat 6: KARANN899 ($89.45 in chips) 
Seat 8: PanicJX ($52.97 in chips) 
Seat 9: BarUnDuck ($20 in chips) 
PanicJX: posts small blind $0.25
BarUnDuck: posts big blind $0.50
*** HOLE CARDS ***
GastonLeFort: folds 
BollyMith: folds 
christyirish: raises $1 to $1.50
KARANN899: calls $1.50
jantheman222 joins the table at seat #5 
PanicJX: folds 
BarUnDuck: folds 
*** FLOP *** [Ah 4s 2c]
christyirish: bets $1.78
KARANN899: folds 
Uncalled bet ($1.78) returned to christyirish
christyirish collected $3.56 from pot
*** SUMMARY ***
Total pot $3.75 | Rake $0.19 
Board [Ah 4s 2c]
Seat 1: GastonLeFort folded before Flop (didn't bet)
Seat 3: BollyMith folded before Flop (didn't bet)
Seat 4: christyirish collected ($3.56)
Seat 6: KARANN899 (button) folded on the Flop
Seat 8: PanicJX (small blind) folded before Flop
Seat 9: BarUnDuck (big blind) folded before Flop



PokerStars Hand #228694056252:  Hold'em No Limit ($0.25/$0.50 USD) - 2021/07/30 20:18:07 ET
Table 'Aitne III' 9-max Seat #8 is the button
Seat 1: GastonLeFort ($54.03 in chips) 
Seat 3: BollyMith ($28.21 in chips) 
Seat 4: christyirish ($58.60 in chips) 
Seat 6: KARANN899 ($87.95 in chips) 
Seat 8: PanicJX ($52.72 in chips) 
Seat 9: BarUnDuck ($19.50 in chips) 
BarUnDuck: posts small blind $0.25
GastonLeFort: posts big blind $0.50
jantheman222: sits out 
*** HOLE CARDS ***
BollyMith: raises $0.60 to $1.10
christyirish: calls $1.10
KARANN899: folds 
PanicJX: folds 
BarUnDuck: calls $0.85
GastonLeFort: folds 
*** FLOP *** [7h 3c Jh]
Vusal11599 joins the table at seat #7 
BarUnDuck: checks 
BollyMith: bets $1.99
christyirish: folds 
BarUnDuck: calls $1.99
*** TURN *** [7h 3c Jh] [Qh]
BarUnDuck: checks 
Dragonclawss leaves the table
BollyMith: checks 
*** RIVER *** [7h 3c Jh Qh] [5d]
BarUnDuck: bets $2.59
BollyMith: calls $2.59
*** SHOW DOWN ***
BarUnDuck: shows [Tc Td] (a pair of Tens)
BollyMith: shows [Qs Js] (two pair, Queens and Jacks)
BollyMith collected $12.31 from pot
*** SUMMARY ***
Total pot $12.96 | Rake $0.65 
Board [7h 3c Jh Qh 5d]
Seat 1: GastonLeFort (big blind) folded before Flop
Seat 3: BollyMith showed [Qs Js] and won ($12.31) with two pair, Queens and Jacks
Seat 4: christyirish folded on the Flop
Seat 6: KARANN899 folded before Flop (didn't bet)
Seat 8: PanicJX (button) folded before Flop (didn't bet)
Seat 9: BarUnDuck (small blind) showed [Tc Td] and lost with a pair of Tens



PokerStars Hand #228694072173:  Hold'em No Limit ($0.25/$0.50 USD) - 2021/07/30 20:19:01 ET
Table 'Aitne III' 9-max Seat #9 is the button
Seat 1: GastonLeFort ($53.53 in chips) 
Seat 3: BollyMith ($34.84 in chips) 
Seat 4: christyirish ($57.50 in chips) 
Seat 6: KARANN899 ($87.95 in chips) 
Seat 7: Vusal11599 ($20 in chips) 
Seat 8: PanicJX ($52.72 in chips) 
Seat 9: BarUnDuck ($20 in chips) 
GastonLeFort: posts small blind $0.25
BollyMith: posts big blind $0.50
jantheman222: sits out 
Vusal11599: posts big blind $0.50
*** HOLE CARDS ***
christyirish: folds 
KARANN899: raises $1.50 to $2
Vusal11599: calls $1.50
PanicJX: folds 
BarUnDuck: folds 
GastonLeFort: raises $6.50 to $8.50
BollyMith: folds 
UpNDownNS joins the table at seat #2 
KARANN899: folds 
Vusal11599: raises $11.50 to $20 and is all-in
GastonLeFort: calls $11.50
*** FLOP *** [Qc Tc Ks]
*** TURN *** [Qc Tc Ks] [5s]
*** RIVER *** [Qc Tc Ks 5s] [4s]
*** SHOW DOWN ***
GastonLeFort: shows [Ac Kd] (a pair of Kings)
Vusal11599: shows [7h 7c] (a pair of Sevens)
GastonLeFort collected $40.50 from pot
Vusal11599 cashed out the hand for $22.04 | Cash Out Fee $0.22
*** SUMMARY ***
Total pot $42.50 | Rake $2 
Board [Qc Tc Ks 5s 4s]
Seat 1: GastonLeFort (small blind) showed [Ac Kd] and won ($40.50) with a pair of Kings
Seat 3: BollyMith (big blind) folded before Flop
Seat 4: christyirish folded before Flop (didn't bet)
Seat 6: KARANN899 folded before Flop
Seat 7: Vusal11599 showed [7h 7c] and lost with a pair of Sevens (cashed out).
Seat 8: PanicJX folded before Flop (didn't bet)
Seat 9: BarUnDuck (button) folded before Flop (didn't bet)



PokerStars Hand #228694083170:  Hold'em No Limit ($0.25/$0.50 USD) - 2021/07/30 20:19:40 ET
Table 'Aitne III' 9-max Seat #1 is the button
Seat 1: GastonLeFort ($74.03 in chips) 
Seat 3: BollyMith ($34.34 in chips) 
Seat 4: christyirish ($57.50 in chips) 
Seat 6: KARANN899 ($85.95 in chips) 
Seat 7: Vusal11599 ($22.04 in chips) 
Seat 8: PanicJX ($52.72 in chips) 
Seat 9: BarUnDuck ($20 in chips) 
BollyMith: posts small blind $0.25
christyirish: posts big blind $0.50
jantheman222: sits out 
*** HOLE CARDS ***
KARANN899: folds 
Vusal11599: raises $1 to $1.50
PanicJX: calls $1.50
BarUnDuck: folds 
GastonLeFort: folds 
BollyMith: folds 
christyirish: raises $4.75 to $6.25
Vusal11599: folds 
PanicJX: folds 
Uncalled bet ($4.75) returned to christyirish
christyirish collected $4.75 from pot
*** SUMMARY ***
Total pot $4.75 | Rake $0 
Seat 1: GastonLeFort (button) folded before Flop (didn't bet)
Seat 3: BollyMith (small blind) folded before Flop
Seat 4: christyirish (big blind) collected ($4.75)
Seat 6: KARANN899 folded before Flop (didn't bet)
Seat 7: Vusal11599 folded before Flop
Seat 8: PanicJX folded before Flop
Seat 9: BarUnDuck folded before Flop (didn't bet)



PokerStars Hand #228694091286:  Hold'em No Limit ($0.25/$0.50 USD) - 2021/07/30 20:20:08 ET
Table 'Aitne III' 9-max Seat #3 is the button
Seat 1: GastonLeFort ($74.03 in chips) 
Seat 2: UpNDownNS ($50 in chips) 
Seat 3: BollyMith ($34.09 in chips) 
Seat 4: christyirish ($60.75 in chips) 
Seat 5: jantheman222 ($50 in chips) 
Seat 6: KARANN899 ($85.95 in chips) 
Seat 7: Vusal11599 ($20.54 in chips) 
Seat 8: PanicJX ($51.22 in chips) 
Seat 9: BarUnDuck ($20 in chips) 
christyirish: posts small blind $0.25
jantheman222: posts big blind $0.50
UpNDownNS: posts big blind $0.50
*** HOLE CARDS ***
KARANN899: folds 
Vusal11599: calls $0.50
PanicJX: folds 
BarUnDuck: folds 
GastonLeFort: folds 
UpNDownNS: checks 
BollyMith: folds 
christyirish: raises $2 to $2.50
jantheman222: folds 
Vusal11599: calls $2
UpNDownNS: folds 
*** FLOP *** [3s 9s 4s]
christyirish: bets $2.85
Vusal11599: raises $15.19 to $18.04 and is all-in
christyirish: calls $15.19
*** TURN *** [3s 9s 4s] [7c]
*** RIVER *** [3s 9s 4s 7c] [3c]
*** SHOW DOWN ***
christyirish: shows [As Jd] (a pair of Threes)
Vusal11599: shows [8h 9d] (two pair, Nines and Threes)
Vusal11599 cashed out the hand for $19.24 | Cash Out Fee $0.19
*** SUMMARY ***
Total pot $42.08 | Rake $2 
Board [3s 9s 4s 7c 3c]
Seat 1: GastonLeFort folded before Flop (didn't bet)
Seat 2: UpNDownNS folded before Flop (didn't bet)
Seat 3: BollyMith (button) folded before Flop (didn't bet)
Seat 4: christyirish (small blind) showed [As Jd] and lost with a pair of Threes
Seat 5: jantheman222 (big blind) folded before Flop
Seat 6: KARANN899 folded before Flop (didn't bet)
Seat 7: Vusal11599 showed [8h 9d] and won ($40.08) with two pair, Nines and Threes (pot not awarded as player cashed out)
Seat 8: PanicJX folded before Flop (didn't bet)
Seat 9: BarUnDuck folded before Flop (didn't bet)



PokerStars Hand #228694108896:  Hold'em No Limit ($0.25/$0.50 USD) - 2021/07/30 20:21:09 ET
Table 'Aitne III' 9-max Seat #4 is the button
Seat 1: GastonLeFort ($74.03 in chips) 
Seat 2: UpNDownNS ($49.50 in chips) 
Seat 3: BollyMith ($34.09 in chips) 
Seat 4: christyirish ($50 in chips) 
Seat 5: jantheman222 ($49.50 in chips) 
Seat 6: KARANN899 ($85.95 in chips) 
Seat 7: Vusal11599 ($19.24 in chips) 
Seat 8: PanicJX ($51.22 in chips) 
Seat 9: BarUnDuck ($20 in chips) 
jantheman222: posts small blind $0.25
KARANN899: posts big blind $0.50
*** HOLE CARDS ***
Vusal11599: folds 
PanicJX: folds 
BarUnDuck: folds 
GastonLeFort: folds 
UpNDownNS: folds 
BollyMith: raises $0.60 to $1.10
christyirish: folds 
jantheman222: folds 
KARANN899: raises $3.25 to $4.35
BollyMith: calls $3.25
*** FLOP *** [9h 3c Ks]
KARANN899: bets $3.50
BollyMith: calls $3.50
*** TURN *** [9h 3c Ks] [8d]
KARANN899: bets $8.50
BollyMith: folds 
Uncalled bet ($8.50) returned to KARANN899
KARANN899 collected $15.15 from pot
KARANN899: doesn't show hand 
*** SUMMARY ***
Total pot $15.95 | Rake $0.80 
Board [9h 3c Ks 8d]
Seat 1: GastonLeFort folded before Flop (didn't bet)
Seat 2: UpNDownNS folded before Flop (didn't bet)
Seat 3: BollyMith folded on the Turn
Seat 4: christyirish (button) folded before Flop (didn't bet)
Seat 5: jantheman222 (small blind) folded before Flop
Seat 6: KARANN899 (big blind) collected ($15.15)
Seat 7: Vusal11599 folded before Flop (didn't bet)
Seat 8: PanicJX folded before Flop (didn't bet)
Seat 9: BarUnDuck folded before Flop (didn't bet)



PokerStars Hand #228694127902:  Hold'em No Limit ($0.25/$0.50 USD) - 2021/07/30 20:22:16 ET
Table 'Aitne III' 9-max Seat #5 is the button
Seat 1: GastonLeFort ($74.03 in chips) 
Seat 2: UpNDownNS ($49.50 in chips) 
Seat 3: BollyMith ($26.24 in chips) 
Seat 4: christyirish ($50 in chips) 
Seat 5: jantheman222 ($49.25 in chips) 
Seat 6: KARANN899 ($93.25 in chips) 
Seat 7: Vusal11599 ($19.24 in chips) 
Seat 8: PanicJX ($51.22 in chips) 
Seat 9: BarUnDuck ($20 in chips) 
KARANN899: posts small blind $0.25
Vusal11599: posts big blind $0.50
*** HOLE CARDS ***
PanicJX: folds 
BarUnDuck: folds 
GastonLeFort: folds 
UpNDownNS: folds 
BollyMith: folds 
christyirish: folds 
jantheman222: raises $0.75 to $1.25
KARANN899: folds 
Vusal11599: calls $0.75
*** FLOP *** [Ts 8d 6c]
Vusal11599: bets $1.30
jantheman222: raises $1.72 to $3.02
Vusal11599: calls $1.72
*** TURN *** [Ts 8d 6c] [Ks]
Vusal11599: checks 
jantheman222: checks 
*** RIVER *** [Ts 8d 6c Ks] [6d]
Vusal11599: bets $3
jantheman222: folds 
Uncalled bet ($3) returned to Vusal11599
Vusal11599 collected $8.35 from pot
Vusal11599: doesn't show hand 
*** SUMMARY ***
Total pot $8.79 | Rake $0.44 
Board [Ts 8d 6c Ks 6d]
Seat 1: GastonLeFort folded before Flop (didn't bet)
Seat 2: UpNDownNS folded before Flop (didn't bet)
Seat 3: BollyMith folded before Flop (didn't bet)
Seat 4: christyirish folded before Flop (didn't bet)
Seat 5: jantheman222 (button) folded on the River
Seat 6: KARANN899 (small blind) folded before Flop
Seat 7: Vusal11599 (big blind) collected ($8.35)
Seat 8: PanicJX folded before Flop (didn't bet)
Seat 9: BarUnDuck folded before Flop (didn't bet)



PokerStars Hand #228694144498:  Hold'em No Limit ($0.25/$0.50 USD) - 2021/07/30 20:23:14 ET
Table 'Aitne III' 9-max Seat #6 is the button
Seat 1: GastonLeFort ($74.03 in chips) 
Seat 2: UpNDownNS ($49.50 in chips) 
Seat 3: BollyMith ($26.24 in chips) 
Seat 4: christyirish ($50 in chips) 
Seat 5: jantheman222 ($44.98 in chips) 
Seat 6: KARANN899 ($93 in chips) 
Seat 7: Vusal11599 ($23.32 in chips) 
Seat 8: PanicJX ($51.22 in chips) 
Seat 9: BarUnDuck ($20 in chips) 
Vusal11599: posts small blind $0.25
PanicJX: posts big blind $0.50
*** HOLE CARDS ***
BarUnDuck: folds 
GastonLeFort: folds 
UpNDownNS: folds 
BollyMith: folds 
christyirish: folds 
jantheman222: folds 
KARANN899: folds 
Vusal11599: raises $1 to $1.50
PanicJX: calls $1
*** FLOP *** [5h Kc Jd]
Vusal11599: checks 
PanicJX: checks 
*** TURN *** [5h Kc Jd] [9d]
Vusal11599: bets $1.42
PanicJX: calls $1.42
*** RIVER *** [5h Kc Jd 9d] [Kd]
Vusal11599: bets $4.80
PanicJX: folds 
Uncalled bet ($4.80) returned to Vusal11599
Vusal11599 collected $5.55 from pot
Vusal11599: doesn't show hand 
*** SUMMARY ***
Total pot $5.84 | Rake $0.29 
Board [5h Kc Jd 9d Kd]
Seat 1: GastonLeFort folded before Flop (didn't bet)
Seat 2: UpNDownNS folded before Flop (didn't bet)
Seat 3: BollyMith folded before Flop (didn't bet)
Seat 4: christyirish folded before Flop (didn't bet)
Seat 5: jantheman222 folded before Flop (didn't bet)
Seat 6: KARANN899 (button) folded before Flop (didn't bet)
Seat 7: Vusal11599 (small blind) collected ($5.55)
Seat 8: PanicJX (big blind) folded on the River
Seat 9: BarUnDuck folded before Flop (didn't bet)



PokerStars Hand #228694157186:  Hold'em No Limit ($0.25/$0.50 USD) - 2021/07/30 20:23:59 ET
Table 'Aitne III' 9-max Seat #7 is the button
Seat 1: GastonLeFort ($74.03 in chips) 
Seat 2: UpNDownNS ($49.50 in chips) 
Seat 3: BollyMith ($26.24 in chips) 
Seat 4: christyirish ($50 in chips) 
Seat 5: jantheman222 ($44.98 in chips) 
Seat 6: KARANN899 ($93 in chips) 
Seat 7: Vusal11599 ($25.95 in chips) 
Seat 8: PanicJX ($48.30 in chips) 
Seat 9: BarUnDuck ($20 in chips) 
PanicJX: posts small blind $0.25
BarUnDuck: posts big blind $0.50
*** HOLE CARDS ***
GastonLeFort: folds 
UpNDownNS: folds 
BollyMith has timed out
BollyMith: folds 
christyirish: folds 
jantheman222: folds 
KARANN899: raises $0.75 to $1.25
Vusal11599: folds 
PanicJX: folds 
BarUnDuck: folds 
Uncalled bet ($0.75) returned to KARANN899
KARANN899 collected $1.25 from pot
KARANN899: doesn't show hand 
*** SUMMARY ***
Total pot $1.25 | Rake $0 
Seat 1: GastonLeFort folded before Flop (didn't bet)
Seat 2: UpNDownNS folded before Flop (didn't bet)
Seat 3: BollyMith folded before Flop (didn't bet)
Seat 4: christyirish folded before Flop (didn't bet)
Seat 5: jantheman222 folded before Flop (didn't bet)
Seat 6: KARANN899 collected ($1.25)
Seat 7: Vusal11599 (button) folded before Flop (didn't bet)
Seat 8: PanicJX (small blind) folded before Flop
Seat 9: BarUnDuck (big blind) folded before Flop



PokerStars Hand #228694163791:  Hold'em No Limit ($0.25/$0.50 USD) - 2021/07/30 20:24:23 ET
Table 'Aitne III' 9-max Seat #8 is the button
Seat 1: GastonLeFort ($74.03 in chips) 
Seat 2: UpNDownNS ($49.50 in chips) 
Seat 4: christyirish ($50 in chips) 
Seat 5: jantheman222 ($44.98 in chips) 
Seat 6: KARANN899 ($93.75 in chips) 
Seat 7: Vusal11599 ($25.95 in chips) 
Seat 8: PanicJX ($48.05 in chips) 
Seat 9: BarUnDuck ($19.50 in chips) 
BarUnDuck: posts small blind $0.25
GastonLeFort: posts big blind $0.50
*** HOLE CARDS ***
UpNDownNS: folds 
christyirish: folds 
jantheman222: folds 
KARANN899: folds 
Vusal11599: folds 
PanicJX: folds 
BarUnDuck: folds 
Uncalled bet ($0.25) returned to GastonLeFort
GastonLeFort collected $0.50 from pot
GastonLeFort: doesn't show hand 
*** SUMMARY ***
Total pot $0.50 | Rake $0 
Seat 1: GastonLeFort (big blind) collected ($0.50)
Seat 2: UpNDownNS folded before Flop (didn't bet)
Seat 4: christyirish folded before Flop (didn't bet)
Seat 5: jantheman222 folded before Flop (didn't bet)
Seat 6: KARANN899 folded before Flop (didn't bet)
Seat 7: Vusal11599 folded before Flop (didn't bet)
Seat 8: PanicJX (button) folded before Flop (didn't bet)
Seat 9: BarUnDuck (small blind) folded before Flop



PokerStars Hand #228694169041:  Hold'em No Limit ($0.25/$0.50 USD) - 2021/07/30 20:24:41 ET
Table 'Aitne III' 9-max Seat #9 is the button
Seat 1: GastonLeFort ($74.28 in chips) 
Seat 2: UpNDownNS ($49.50 in chips) 
Seat 4: christyirish ($50 in chips) 
Seat 5: jantheman222 ($44.98 in chips) 
Seat 6: KARANN899 ($93.75 in chips) 
Seat 7: Vusal11599 ($25.95 in chips) 
Seat 8: PanicJX ($48.05 in chips) 
Seat 9: BarUnDuck ($20 in chips) 
GastonLeFort: posts small blind $0.25
UpNDownNS: posts big blind $0.50
*** HOLE CARDS ***
christyirish: folds 
jantheman222: raises $0.75 to $1.25
KARANN899: folds 
Vusal11599: folds 
PanicJX: folds 
BarUnDuck: folds 
GastonLeFort: folds 
UpNDownNS: folds 
Uncalled bet ($0.75) returned to jantheman222
jantheman222 collected $1.25 from pot
jantheman222: doesn't show hand 
*** SUMMARY ***
Total pot $1.25 | Rake $0 
Seat 1: GastonLeFort (small blind) folded before Flop
Seat 2: UpNDownNS (big blind) folded before Flop
Seat 4: christyirish folded before Flop (didn't bet)
Seat 5: jantheman222 collected ($1.25)
Seat 6: KARANN899 folded before Flop (didn't bet)
Seat 7: Vusal11599 folded before Flop (didn't bet)
Seat 8: PanicJX folded before Flop (didn't bet)
Seat 9: BarUnDuck (button) folded before Flop (didn't bet)



PokerStars Hand #228694176605:  Hold'em No Limit ($0.25/$0.50 USD) - 2021/07/30 20:25:08 ET
Table 'Aitne III' 9-max Seat #1 is the button
Seat 1: GastonLeFort ($74.03 in chips) 
Seat 2: UpNDownNS ($49 in chips) 
Seat 3: BollyMith ($26.24 in chips) 
Seat 4: christyirish ($50 in chips) 
Seat 5: jantheman222 ($45.73 in chips) 
Seat 6: KARANN899 ($93.75 in chips) 
Seat 7: Vusal11599 ($25.95 in chips) 
Seat 8: PanicJX ($48.05 in chips) 
Seat 9: BarUnDuck ($20 in chips) 
UpNDownNS: posts small blind $0.25
BollyMith: posts big blind $0.50
*** HOLE CARDS ***
christyirish: raises $1 to $1.50
jantheman222: folds 
KARANN899: folds 
Vusal11599: folds 
PanicJX: raises $3 to $4.50
BarUnDuck: folds 
GastonLeFort: folds 
UpNDownNS: folds 
BollyMith: folds 
christyirish: calls $3
*** FLOP *** [Ts Td Kc]
christyirish: checks 
PanicJX: bets $3.35
christyirish: calls $3.35
*** TURN *** [Ts Td Kc] [Th]
christyirish: checks 
PanicJX: checks 
*** RIVER *** [Ts Td Kc Th] [2s]
christyirish: checks 
PanicJX: bets $15.63
christyirish: folds 
Uncalled bet ($15.63) returned to PanicJX
PanicJX collected $15.63 from pot
PanicJX: doesn't show hand 
*** SUMMARY ***
Total pot $16.45 | Rake $0.82 
Board [Ts Td Kc Th 2s]
Seat 1: GastonLeFort (button) folded before Flop (didn't bet)
Seat 2: UpNDownNS (small blind) folded before Flop
Seat 3: BollyMith (big blind) folded before Flop
Seat 4: christyirish folded on the River
Seat 5: jantheman222 folded before Flop (didn't bet)
Seat 6: KARANN899 folded before Flop (didn't bet)
Seat 7: Vusal11599 folded before Flop (didn't bet)
Seat 8: PanicJX collected ($15.63)
Seat 9: BarUnDuck folded before Flop (didn't bet)



PokerStars Hand #228694195514:  Hold'em No Limit ($0.25/$0.50 USD) - 2021/07/30 20:25:48 ET
Table 'Aitne III' 9-max Seat #2 is the button
Seat 1: GastonLeFort ($74.03 in chips) 
Seat 2: UpNDownNS ($48.75 in chips) 
Seat 3: BollyMith ($25.74 in chips) 
Seat 4: christyirish ($50 in chips) 
Seat 5: jantheman222 ($45.73 in chips) 
Seat 6: KARANN899 ($93.75 in chips) 
Seat 7: Vusal11599 ($25.95 in chips) 
Seat 8: PanicJX ($55.83 in chips) 
Seat 9: BarUnDuck ($20 in chips) 
BollyMith: posts small blind $0.25
christyirish: posts big blind $0.50
*** HOLE CARDS ***
jantheman222: folds 
KARANN899: raises $1 to $1.50
Vusal11599: folds 
PanicJX: folds 
PanicJX leaves the table
BarUnDuck: folds 
GastonLeFort: folds 
UpNDownNS: folds 
BollyMith: folds 
christyirish: folds 
Uncalled bet ($1) returned to KARANN899
KARANN899 collected $1.25 from pot
KARANN899: doesn't show hand 
*** SUMMARY ***
Total pot $1.25 | Rake $0 
Seat 1: GastonLeFort folded before Flop (didn't bet)
Seat 2: UpNDownNS (button) folded before Flop (didn't bet)
Seat 3: BollyMith (small blind) folded before Flop
Seat 4: christyirish (big blind) folded before Flop
Seat 5: jantheman222 folded before Flop (didn't bet)
Seat 6: KARANN899 collected ($1.25)
Seat 7: Vusal11599 folded before Flop (didn't bet)
Seat 8: PanicJX folded before Flop (didn't bet)
Seat 9: BarUnDuck folded before Flop (didn't bet)



PokerStars Hand #228694200644:  Hold'em No Limit ($0.25/$0.50 USD) - 2021/07/30 20:26:07 ET
Table 'Aitne III' 9-max Seat #3 is the button
Seat 1: GastonLeFort ($74.03 in chips) 
Seat 2: UpNDownNS ($48.75 in chips) 
Seat 3: BollyMith ($25.49 in chips) 
Seat 4: christyirish ($50 in chips) 
Seat 5: jantheman222 ($45.73 in chips) 
Seat 6: KARANN899 ($94.50 in chips) 
Seat 7: Vusal11599 ($25.95 in chips) 
Seat 9: BarUnDuck ($20 in chips) 
christyirish: posts small blind $0.25
jantheman222: posts big blind $0.50
*** HOLE CARDS ***
KARANN899: raises $1 to $1.50
Vusal11599: folds 
BarUnDuck: folds 
GastonLeFort: folds 
UpNDownNS: folds 
BollyMith: folds 
christyirish: folds 
jantheman222: folds 
Uncalled bet ($1) returned to KARANN899
KARANN899 collected $1.25 from pot
KARANN899: doesn't show hand 
*** SUMMARY ***
Total pot $1.25 | Rake $0 
Seat 1: GastonLeFort folded before Flop (didn't bet)
Seat 2: UpNDownNS folded before Flop (didn't bet)
Seat 3: BollyMith (button) folded before Flop (didn't bet)
Seat 4: christyirish (small blind) folded before Flop
Seat 5: jantheman222 (big blind) folded before Flop
Seat 6: KARANN899 collected ($1.25)
Seat 7: Vusal11599 folded before Flop (didn't bet)
Seat 9: BarUnDuck folded before Flop (didn't bet)



PokerStars Hand #228694205513:  Hold'em No Limit ($0.25/$0.50 USD) - 2021/07/30 20:26:24 ET
Table 'Aitne III' 9-max Seat #4 is the button
Seat 1: GastonLeFort ($74.03 in chips) 
Seat 2: UpNDownNS ($48.75 in chips) 
Seat 3: BollyMith ($25.49 in chips) 
Seat 4: christyirish ($50 in chips) 
Seat 5: jantheman222 ($45.23 in chips) 
Seat 6: KARANN899 ($95.25 in chips) 
Seat 7: Vusal11599 ($25.95 in chips) 
Seat 9: BarUnDuck ($20 in chips) 
jantheman222: posts small blind $0.25
KARANN899: posts big blind $0.50
*** HOLE CARDS ***
Vusal11599: folds 
BarUnDuck: folds 
Dragonclawss joins the table at seat #8 
GastonLeFort: folds 
UpNDownNS: folds 
BollyMith: folds 
christyirish: raises $1 to $1.50
jantheman222: folds 
Dragonclawss leaves the table
KARANN899: calls $1
*** FLOP *** [3h 7d Tc]
KARANN899: checks 
christyirish: bets $0.93
KARANN899: raises $2.57 to $3.50
christyirish: calls $2.57
*** TURN *** [3h 7d Tc] [Js]
KARANN899: checks 
christyirish: bets $2.92
KARANN899: calls $2.92
*** RIVER *** [3h 7d Tc Js] [Ah]
KARANN899: checks 
christyirish: bets $15.29
SteigEin84 joins the table at seat #8 
KARANN899: folds 
Uncalled bet ($15.29) returned to christyirish
christyirish collected $15.29 from pot
*** SUMMARY ***
Total pot $16.09 | Rake $0.80 
Board [3h 7d Tc Js Ah]
Seat 1: GastonLeFort folded before Flop (didn't bet)
Seat 2: UpNDownNS folded before Flop (didn't bet)
Seat 3: BollyMith folded before Flop (didn't bet)
Seat 4: christyirish (button) collected ($15.29)
Seat 5: jantheman222 (small blind) folded before Flop
Seat 6: KARANN899 (big blind) folded on the River
Seat 7: Vusal11599 folded before Flop (didn't bet)
Seat 9: BarUnDuck folded before Flop (didn't bet)



PokerStars Hand #228694222575:  Hold'em No Limit ($0.25/$0.50 USD) - 2021/07/30 20:27:24 ET
Table 'Aitne III' 9-max Seat #5 is the button
Seat 1: GastonLeFort ($74.03 in chips) 
Seat 2: UpNDownNS ($48.75 in chips) 
Seat 3: BollyMith ($25.49 in chips) 
Seat 4: christyirish ($57.37 in chips) 
Seat 5: jantheman222 ($44.98 in chips) 
Seat 6: KARANN899 ($87.33 in chips) 
Seat 7: Vusal11599 ($25.95 in chips) 
Seat 9: BarUnDuck ($20 in chips) 
KARANN899: posts small blind $0.25
Vusal11599: posts big blind $0.50
SteigEin84: sits out 
*** HOLE CARDS ***
BarUnDuck: folds 
GastonLeFort: folds 
UpNDownNS: raises $1 to $1.50
BollyMith: folds 
christyirish: folds 
jantheman222: folds 
KARANN899: folds 
Vusal11599: calls $1
*** FLOP *** [Qh 2c 5c]
Vusal11599: checks 
UpNDownNS: bets $1
Vusal11599: calls $1
*** TURN *** [Qh 2c 5c] [Kc]
Vusal11599: checks 
UpNDownNS: checks 
*** RIVER *** [Qh 2c 5c Kc] [7h]
Vusal11599: bets $2.49
UpNDownNS: calls $2.49
*** SHOW DOWN ***
Vusal11599: shows [8d Th] (high card King)
UpNDownNS: shows [6h 6c] (a pair of Sixes)
UpNDownNS collected $9.72 from pot
*** SUMMARY ***
Total pot $10.23 | Rake $0.51 
Board [Qh 2c 5c Kc 7h]
Seat 1: GastonLeFort folded before Flop (didn't bet)
Seat 2: UpNDownNS showed [6h 6c] and won ($9.72) with a pair of Sixes
Seat 3: BollyMith folded before Flop (didn't bet)
Seat 4: christyirish folded before Flop (didn't bet)
Seat 5: jantheman222 (button) folded before Flop (didn't bet)
Seat 6: KARANN899 (small blind) folded before Flop
Seat 7: Vusal11599 (big blind) showed [8d Th] and lost with high card King
Seat 9: BarUnDuck folded before Flop (didn't bet)



PokerStars Hand #228694239692:  Hold'em No Limit ($0.25/$0.50 USD) - 2021/07/30 20:28:25 ET
Table 'Aitne III' 9-max Seat #6 is the button
Seat 1: GastonLeFort ($74.03 in chips) 
Seat 2: UpNDownNS ($53.48 in chips) 
Seat 3: BollyMith ($25.49 in chips) 
Seat 4: christyirish ($57.37 in chips) 
Seat 5: jantheman222 ($44.98 in chips) 
Seat 6: KARANN899 ($87.08 in chips) 
Seat 7: Vusal11599 ($20.96 in chips) 
Seat 8: SteigEin84 ($40 in chips) 
Seat 9: BarUnDuck ($20 in chips) 
Vusal11599: posts small blind $0.25
SteigEin84: posts big blind $0.50
*** HOLE CARDS ***
BarUnDuck: folds 
GastonLeFort: folds 
UpNDownNS: folds 
BollyMith: folds 
christyirish: folds 
jantheman222: folds 
KARANN899: raises $0.75 to $1.25
Vusal11599: calls $1
SteigEin84: calls $0.75
*** FLOP *** [8s Jh Ac]
Vusal11599: checks 
SteigEin84: checks 
KARANN899: checks 
*** TURN *** [8s Jh Ac] [2c]
Vusal11599: bets $1.25
SteigEin84: folds 
KARANN899: folds 
Uncalled bet ($1.25) returned to Vusal11599
Vusal11599 collected $3.56 from pot
Vusal11599: doesn't show hand 
*** SUMMARY ***
Total pot $3.75 | Rake $0.19 
Board [8s Jh Ac 2c]
Seat 1: GastonLeFort folded before Flop (didn't bet)
Seat 2: UpNDownNS folded before Flop (didn't bet)
Seat 3: BollyMith folded before Flop (didn't bet)
Seat 4: christyirish folded before Flop (didn't bet)
Seat 5: jantheman222 folded before Flop (didn't bet)
Seat 6: KARANN899 (button) folded on the Turn
Seat 7: Vusal11599 (small blind) collected ($3.56)
Seat 8: SteigEin84 (big blind) folded on the Turn
Seat 9: BarUnDuck folded before Flop (didn't bet)



PokerStars Hand #228694250213:  Hold'em No Limit ($0.25/$0.50 USD) - 2021/07/30 20:29:03 ET
Table 'Aitne III' 9-max Seat #7 is the button
Seat 1: GastonLeFort ($74.03 in chips) 
Seat 2: UpNDownNS ($53.48 in chips) 
Seat 3: BollyMith ($25.49 in chips) 
Seat 4: christyirish ($57.37 in chips) 
Seat 5: jantheman222 ($44.98 in chips) 
Seat 6: KARANN899 ($85.83 in chips) 
Seat 7: Vusal11599 ($23.27 in chips) 
Seat 8: SteigEin84 ($38.75 in chips) 
Seat 9: BarUnDuck ($20 in chips) 
SteigEin84: posts small blind $0.25
BarUnDuck: posts big blind $0.50
*** HOLE CARDS ***
GastonLeFort: folds 
UpNDownNS: folds 
BollyMith: folds 
BollyMith leaves the table
christyirish: raises $1 to $1.50
jantheman222: folds 
KARANN899: folds 
Dragonclawss joins the table at seat #3 
Vusal11599: folds 
SteigEin84: calls $1.25
BarUnDuck: folds 
*** FLOP *** [Qs As 9d]
SteigEin84: bets $1.50
christyirish: calls $1.50
*** TURN *** [Qs As 9d] [6h]
SteigEin84: bets $3.09
christyirish: folds 
Uncalled bet ($3.09) returned to SteigEin84
SteigEin84 collected $6.10 from pot
SteigEin84: doesn't show hand 
*** SUMMARY ***
Total pot $6.50 | Rake $0.40 
Board [Qs As 9d 6h]
Seat 1: GastonLeFort folded before Flop (didn't bet)
Seat 2: UpNDownNS folded before Flop (didn't bet)
Seat 3: BollyMith folded before Flop (didn't bet)
Seat 4: christyirish folded on the Turn
Seat 5: jantheman222 folded before Flop (didn't bet)
Seat 6: KARANN899 folded before Flop (didn't bet)
Seat 7: Vusal11599 (button) folded before Flop (didn't bet)
Seat 8: SteigEin84 (small blind) collected ($6.10)
Seat 9: BarUnDuck (big blind) folded before Flop



PokerStars Hand #228694265439:  Hold'em No Limit ($0.25/$0.50 USD) - 2021/07/30 20:29:58 ET
Table 'Aitne III' 9-max Seat #8 is the button
Seat 1: GastonLeFort ($74.03 in chips) 
Seat 2: UpNDownNS ($53.48 in chips) 
Seat 4: christyirish ($54.37 in chips) 
Seat 5: jantheman222 ($44.98 in chips) 
Seat 6: KARANN899 ($85.83 in chips) 
Seat 7: Vusal11599 ($23.27 in chips) 
Seat 8: SteigEin84 ($41.85 in chips) 
Seat 9: BarUnDuck ($19.50 in chips) 
BarUnDuck: posts small blind $0.25
GastonLeFort: posts big blind $0.50
Dragonclawss: sits out 
*** HOLE CARDS ***
UpNDownNS: folds 
christyirish: folds 
jantheman222: folds 
KARANN899: raises $1 to $1.50
Vusal11599: folds 
SteigEin84: folds 
BarUnDuck: folds 
GastonLeFort: folds 
Uncalled bet ($1) returned to KARANN899
KARANN899 collected $1.25 from pot
KARANN899: doesn't show hand 
*** SUMMARY ***
Total pot $1.25 | Rake $0 
Seat 1: GastonLeFort (big blind) folded before Flop
Seat 2: UpNDownNS folded before Flop (didn't bet)
Seat 4: christyirish folded before Flop (didn't bet)
Seat 5: jantheman222 folded before Flop (didn't bet)
Seat 6: KARANN899 collected ($1.25)
Seat 7: Vusal11599 folded before Flop (didn't bet)
Seat 8: SteigEin84 (button) folded before Flop (didn't bet)
Seat 9: BarUnDuck (small blind) folded before Flop



PokerStars Hand #228694271300:  Hold'em No Limit ($0.25/$0.50 USD) - 2021/07/30 20:30:19 ET
Table 'Aitne III' 9-max Seat #9 is the button
Seat 1: GastonLeFort ($73.53 in chips) 
Seat 2: UpNDownNS ($53.48 in chips) 
Seat 4: christyirish ($54.37 in chips) 
Seat 5: jantheman222 ($44.98 in chips) 
Seat 6: KARANN899 ($86.58 in chips) 
Seat 7: Vusal11599 ($23.27 in chips) 
Seat 8: SteigEin84 ($41.85 in chips) 
Seat 9: BarUnDuck ($20 in chips) 
GastonLeFort: posts small blind $0.25
UpNDownNS: posts big blind $0.50
Dragonclawss: sits out 
*** HOLE CARDS ***
christyirish: raises $1 to $1.50
jantheman222: folds 
KARANN899: folds 
Vusal11599: folds 
SteigEin84: folds 
BarUnDuck: folds 
GastonLeFort: folds 
UpNDownNS: folds 
Uncalled bet ($1) returned to christyirish
christyirish collected $1.25 from pot
*** SUMMARY ***
Total pot $1.25 | Rake $0 
Seat 1: GastonLeFort (small blind) folded before Flop
Seat 2: UpNDownNS (big blind) folded before Flop
Seat 4: christyirish collected ($1.25)
Seat 5: jantheman222 folded before Flop (didn't bet)
Seat 6: KARANN899 folded before Flop (didn't bet)
Seat 7: Vusal11599 folded before Flop (didn't bet)
Seat 8: SteigEin84 folded before Flop (didn't bet)
Seat 9: BarUnDuck (button) folded before Flop (didn't bet)



PokerStars Hand #228694276715:  Hold'em No Limit ($0.25/$0.50 USD) - 2021/07/30 20:30:38 ET
Table 'Aitne III' 9-max Seat #1 is the button
Seat 1: GastonLeFort ($73.28 in chips) 
Seat 2: UpNDownNS ($52.98 in chips) 
Seat 3: Dragonclawss ($50 in chips) 
Seat 4: christyirish ($55.12 in chips) 
Seat 5: jantheman222 ($44.98 in chips) 
Seat 6: KARANN899 ($86.58 in chips) 
Seat 7: Vusal11599 ($23.27 in chips) 
Seat 8: SteigEin84 ($41.85 in chips) 
Seat 9: BarUnDuck ($20 in chips) 
UpNDownNS: posts small blind $0.25
Dragonclawss: posts big blind $0.50
*** HOLE CARDS ***
christyirish: raises $1 to $1.50
jantheman222: folds 
KARANN899: folds 
Vusal11599: folds 
SteigEin84: folds 
BarUnDuck: folds 
GastonLeFort: folds 
UpNDownNS: folds 
Dragonclawss: calls $1
*** FLOP *** [Qd 9h 7d]
Dragonclawss: checks 
christyirish: bets $1.55
Dragonclawss: folds 
Uncalled bet ($1.55) returned to christyirish
christyirish collected $3.09 from pot
*** SUMMARY ***
Total pot $3.25 | Rake $0.16 
Board [Qd 9h 7d]
Seat 1: GastonLeFort (button) folded before Flop (didn't bet)
Seat 2: UpNDownNS (small blind) folded before Flop
Seat 3: Dragonclawss (big blind) folded on the Flop
Seat 4: christyirish collected ($3.09)
Seat 5: jantheman222 folded before Flop (didn't bet)
Seat 6: KARANN899 folded before Flop (didn't bet)
Seat 7: Vusal11599 folded before Flop (didn't bet)
Seat 8: SteigEin84 folded before Flop (didn't bet)
Seat 9: BarUnDuck folded before Flop (didn't bet)



PokerStars Hand #228694285852:  Hold'em No Limit ($0.25/$0.50 USD) - 2021/07/30 20:31:10 ET
Table 'Aitne III' 9-max Seat #2 is the button
Seat 1: GastonLeFort ($73.28 in chips) 
Seat 2: UpNDownNS ($52.73 in chips) 
Seat 3: Dragonclawss ($50 in chips) 
Seat 4: christyirish ($56.71 in chips) 
Seat 5: jantheman222 ($44.98 in chips) 
Seat 6: KARANN899 ($86.58 in chips) 
Seat 7: Vusal11599 ($23.27 in chips) 
Seat 8: SteigEin84 ($41.85 in chips) 
Seat 9: BarUnDuck ($20 in chips) 
Dragonclawss: posts small blind $0.25
christyirish: posts big blind $0.50
*** HOLE CARDS ***
jantheman222: folds 
KARANN899: folds 
Vusal11599: raises $0.50 to $1
SteigEin84: calls $1
BarUnDuck: folds 
GastonLeFort: folds 
UpNDownNS: calls $1
Dragonclawss: calls $0.75
christyirish: calls $0.50
*** FLOP *** [6d Ac 5h]
Dragonclawss: checks 
christyirish: checks 
Vusal11599: checks 
SteigEin84: checks 
UpNDownNS: checks 
*** TURN *** [6d Ac 5h] [3h]
Dragonclawss: bets $2
christyirish: folds 
Vusal11599: folds 
SteigEin84: folds 
UpNDownNS: folds 
Uncalled bet ($2) returned to Dragonclawss
Dragonclawss collected $4.75 from pot
Dragonclawss: doesn't show hand 
*** SUMMARY ***
Total pot $5 | Rake $0.25 
Board [6d Ac 5h 3h]
Seat 1: GastonLeFort folded before Flop (didn't bet)
Seat 2: UpNDownNS (button) folded on the Turn
Seat 3: Dragonclawss (small blind) collected ($4.75)
Seat 4: christyirish (big blind) folded on the Turn
Seat 5: jantheman222 folded before Flop (didn't bet)
Seat 6: KARANN899 folded before Flop (didn't bet)
Seat 7: Vusal11599 folded on the Turn
Seat 8: SteigEin84 folded on the Turn
Seat 9: BarUnDuck folded before Flop (didn't bet)



PokerStars Hand #228694302163:  Hold'em No Limit ($0.25/$0.50 USD) - 2021/07/30 20:32:08 ET
Table 'Aitne III' 9-max Seat #3 is the button
Seat 1: GastonLeFort ($73.28 in chips) 
Seat 2: UpNDownNS ($51.73 in chips) 
Seat 3: Dragonclawss ($53.75 in chips) 
Seat 4: christyirish ($55.71 in chips) 
Seat 5: jantheman222 ($44.98 in chips) 
Seat 6: KARANN899 ($86.58 in chips) 
Seat 7: Vusal11599 ($22.27 in chips) 
Seat 8: SteigEin84 ($40.85 in chips) 
Seat 9: BarUnDuck ($20 in chips) 
christyirish: posts small blind $0.25
jantheman222: posts big blind $0.50
*** HOLE CARDS ***
KARANN899: folds 
Vusal11599: folds 
SteigEin84: folds 
BarUnDuck: raises $0.50 to $1
GastonLeFort: folds 
UpNDownNS: folds 
Dragonclawss: folds 
christyirish: folds 
jantheman222: folds 
Uncalled bet ($0.50) returned to BarUnDuck
BarUnDuck collected $1.25 from pot
BarUnDuck: doesn't show hand 
*** SUMMARY ***
Total pot $1.25 | Rake $0 
Seat 1: GastonLeFort folded before Flop (didn't bet)
Seat 2: UpNDownNS folded before Flop (didn't bet)
Seat 3: Dragonclawss (button) folded before Flop (didn't bet)
Seat 4: christyirish (small blind) folded before Flop
Seat 5: jantheman222 (big blind) folded before Flop
Seat 6: KARANN899 folded before Flop (didn't bet)
Seat 7: Vusal11599 folded before Flop (didn't bet)
Seat 8: SteigEin84 folded before Flop (didn't bet)
Seat 9: BarUnDuck collected ($1.25)



PokerStars Hand #228694307135:  Hold'em No Limit ($0.25/$0.50 USD) - 2021/07/30 20:32:25 ET
Table 'Aitne III' 9-max Seat #4 is the button
Seat 1: GastonLeFort ($73.28 in chips) 
Seat 2: UpNDownNS ($51.73 in chips) 
Seat 3: Dragonclawss ($53.75 in chips) 
Seat 4: christyirish ($55.46 in chips) 
Seat 5: jantheman222 ($44.48 in chips) 
Seat 6: KARANN899 ($86.58 in chips) 
Seat 7: Vusal11599 ($22.27 in chips) 
Seat 8: SteigEin84 ($40.85 in chips) 
Seat 9: BarUnDuck ($20.75 in chips) 
jantheman222: posts small blind $0.25
KARANN899: posts big blind $0.50
*** HOLE CARDS ***
Vusal11599: folds 
SteigEin84: raises $1 to $1.50
BarUnDuck: folds 
GastonLeFort: folds 
UpNDownNS: calls $1.50
Dragonclawss: folds 
christyirish: folds 
jantheman222: folds 
KARANN899: folds 
*** FLOP *** [Kd 9c 3s]
SteigEin84: checks 
UpNDownNS: bets $1.50
SteigEin84: calls $1.50
*** TURN *** [Kd 9c 3s] [3h]
SteigEin84: checks 
UpNDownNS: checks 
*** RIVER *** [Kd 9c 3s 3h] [6d]
SteigEin84: bets $4
UpNDownNS: calls $4
*** SHOW DOWN ***
SteigEin84: shows [Tc Kc] (two pair, Kings and Threes)
UpNDownNS: mucks hand 
SteigEin84 collected $13.83 from pot
*** SUMMARY ***
Total pot $14.75 | Rake $0.92 
Board [Kd 9c 3s 3h 6d]
Seat 1: GastonLeFort folded before Flop (didn't bet)
Seat 2: UpNDownNS mucked
Seat 3: Dragonclawss folded before Flop (didn't bet)
Seat 4: christyirish (button) folded before Flop (didn't bet)
Seat 5: jantheman222 (small blind) folded before Flop
Seat 6: KARANN899 (big blind) folded before Flop
Seat 7: Vusal11599 folded before Flop (didn't bet)
Seat 8: SteigEin84 showed [Tc Kc] and won ($13.83) with two pair, Kings and Threes
Seat 9: BarUnDuck folded before Flop (didn't bet)



PokerStars Hand #228694329260:  Hold'em No Limit ($0.25/$0.50 USD) - 2021/07/30 20:33:45 ET
Table 'Aitne III' 9-max Seat #5 is the button
Seat 1: GastonLeFort ($73.28 in chips) 
Seat 2: UpNDownNS ($44.73 in chips) 
Seat 3: Dragonclawss ($53.75 in chips) 
Seat 4: christyirish ($55.46 in chips) 
Seat 5: jantheman222 ($44.23 in chips) 
Seat 6: KARANN899 ($86.08 in chips) 
Seat 7: Vusal11599 ($22.27 in chips) 
Seat 8: SteigEin84 ($47.68 in chips) 
Seat 9: BarUnDuck ($20.75 in chips) 
KARANN899: posts small blind $0.25
Vusal11599: posts big blind $0.50
*** HOLE CARDS ***
SteigEin84: raises $1 to $1.50
BarUnDuck: folds 
GastonLeFort: folds 
UpNDownNS: folds 
Dragonclawss: folds 
christyirish: folds 
jantheman222: folds 
KARANN899: folds 
Vusal11599: calls $1
*** FLOP *** [3h As 5s]
Vusal11599: checks 
SteigEin84: bets $0.50
Vusal11599: calls $0.50
*** TURN *** [3h As 5s] [Qh]
Vusal11599: checks 
SteigEin84: bets $1
Vusal11599: folds 
Uncalled bet ($1) returned to SteigEin84
SteigEin84 collected $3.99 from pot
SteigEin84: doesn't show hand 
*** SUMMARY ***
Total pot $4.25 | Rake $0.26 
Board [3h As 5s Qh]
Seat 1: GastonLeFort folded before Flop (didn't bet)
Seat 2: UpNDownNS folded before Flop (didn't bet)
Seat 3: Dragonclawss folded before Flop (didn't bet)
Seat 4: christyirish folded before Flop (didn't bet)
Seat 5: jantheman222 (button) folded before Flop (didn't bet)
Seat 6: KARANN899 (small blind) folded before Flop
Seat 7: Vusal11599 (big blind) folded on the Turn
Seat 8: SteigEin84 collected ($3.99)
Seat 9: BarUnDuck folded before Flop (didn't bet)



PokerStars Hand #228694338539:  Hold'em No Limit ($0.25/$0.50 USD) - 2021/07/30 20:34:18 ET
Table 'Aitne III' 9-max Seat #6 is the button
Seat 1: GastonLeFort ($73.28 in chips) 
Seat 2: UpNDownNS ($44.73 in chips) 
Seat 3: Dragonclawss ($53.75 in chips) 
Seat 4: christyirish ($55.46 in chips) 
Seat 5: jantheman222 ($44.23 in chips) 
Seat 6: KARANN899 ($85.83 in chips) 
Seat 7: Vusal11599 ($20.27 in chips) 
Seat 8: SteigEin84 ($49.67 in chips) 
Seat 9: BarUnDuck ($20.75 in chips) 
Vusal11599: posts small blind $0.25
SteigEin84: posts big blind $0.50
*** HOLE CARDS ***
BarUnDuck: folds 
GastonLeFort: folds 
UpNDownNS: folds 
Dragonclawss: folds 
christyirish: raises $1 to $1.50
jantheman222: folds 
KARANN899: folds 
Vusal11599: folds 
SteigEin84: calls $1
*** FLOP *** [6s 3s 6d]
SteigEin84: checks 
christyirish: bets $0.93
SteigEin84: calls $0.93
*** TURN *** [6s 3s 6d] [Qd]
SteigEin84: checks 
christyirish: bets $2.43
SteigEin84: calls $2.43
*** RIVER *** [6s 3s 6d Qd] [Ad]
SteigEin84: checks 
christyirish: bets $4.74
SteigEin84: folds 
Uncalled bet ($4.74) returned to christyirish
christyirish collected $9.47 from pot
*** SUMMARY ***
Total pot $9.97 | Rake $0.50 
Board [6s 3s 6d Qd Ad]
Seat 1: GastonLeFort folded before Flop (didn't bet)
Seat 2: UpNDownNS folded before Flop (didn't bet)
Seat 3: Dragonclawss folded before Flop (didn't bet)
Seat 4: christyirish collected ($9.47)
Seat 5: jantheman222 folded before Flop (didn't bet)
Seat 6: KARANN899 (button) folded before Flop (didn't bet)
Seat 7: Vusal11599 (small blind) folded before Flop
Seat 8: SteigEin84 (big blind) folded on the River
Seat 9: BarUnDuck folded before Flop (didn't bet)



PokerStars Hand #228694348752:  Hold'em No Limit ($0.25/$0.50 USD) - 2021/07/30 20:34:55 ET
Table 'Aitne III' 9-max Seat #7 is the button
Seat 1: GastonLeFort ($73.28 in chips) 
Seat 2: UpNDownNS ($44.73 in chips) 
Seat 3: Dragonclawss ($53.75 in chips) 
Seat 4: christyirish ($60.07 in chips) 
Seat 5: jantheman222 ($44.23 in chips) 
Seat 6: KARANN899 ($85.83 in chips) 
Seat 7: Vusal11599 ($20.02 in chips) 
Seat 8: SteigEin84 ($44.81 in chips) 
Seat 9: BarUnDuck ($20.75 in chips) 
SteigEin84: posts small blind $0.25
BarUnDuck: posts big blind $0.50
*** HOLE CARDS ***
GastonLeFort: raises $1 to $1.50
UpNDownNS: folds 
Dragonclawss: folds 
christyirish: folds 
jantheman222: folds 
KARANN899: folds 
Vusal11599: folds 
SteigEin84: calls $1.25
BarUnDuck: calls $1
*** FLOP *** [2h 5s 2c]
SteigEin84: checks 
BarUnDuck: checks 
GastonLeFort: bets $1.07
SteigEin84: folds 
BarUnDuck: folds 
Uncalled bet ($1.07) returned to GastonLeFort
GastonLeFort collected $4.28 from pot
GastonLeFort: doesn't show hand 
*** SUMMARY ***
Total pot $4.50 | Rake $0.22 
Board [2h 5s 2c]
Seat 1: GastonLeFort collected ($4.28)
Seat 2: UpNDownNS folded before Flop (didn't bet)
Seat 3: Dragonclawss folded before Flop (didn't bet)
Seat 4: christyirish folded before Flop (didn't bet)
Seat 5: jantheman222 folded before Flop (didn't bet)
Seat 6: KARANN899 folded before Flop (didn't bet)
Seat 7: Vusal11599 (button) folded before Flop (didn't bet)
Seat 8: SteigEin84 (small blind) folded on the Flop
Seat 9: BarUnDuck (big blind) folded on the Flop



PokerStars Hand #228694359135:  Hold'em No Limit ($0.25/$0.50 USD) - 2021/07/30 20:35:32 ET
Table 'Aitne III' 9-max Seat #8 is the button
Seat 1: GastonLeFort ($76.06 in chips) 
Seat 2: UpNDownNS ($44.73 in chips) 
Seat 3: Dragonclawss ($53.75 in chips) 
Seat 4: christyirish ($60.07 in chips) 
Seat 5: jantheman222 ($44.23 in chips) 
Seat 6: KARANN899 ($85.83 in chips) 
Seat 7: Vusal11599 ($20.02 in chips) 
Seat 8: SteigEin84 ($43.31 in chips) 
Seat 9: BarUnDuck ($20 in chips) 
BarUnDuck: posts small blind $0.25
GastonLeFort: posts big blind $0.50
*** HOLE CARDS ***
UpNDownNS: folds 
Dragonclawss: folds 
christyirish: folds 
jantheman222: raises $0.75 to $1.25
KARANN899: folds 
Vusal11599: folds 
SteigEin84: raises $1.75 to $3
BarUnDuck: folds 
GastonLeFort: folds 
jantheman222: calls $1.75
*** FLOP *** [Qh 8s Ks]
jantheman222: checks 
SteigEin84: bets $4.50
jantheman222: raises $12 to $16.50
SteigEin84: folds 
Uncalled bet ($12) returned to jantheman222
jantheman222 collected $14.96 from pot
*** SUMMARY ***
Total pot $15.75 | Rake $0.79 
Board [Qh 8s Ks]
Seat 1: GastonLeFort (big blind) folded before Flop
Seat 2: UpNDownNS folded before Flop (didn't bet)
Seat 3: Dragonclawss folded before Flop (didn't bet)
Seat 4: christyirish folded before Flop (didn't bet)
Seat 5: jantheman222 collected ($14.96)
Seat 6: KARANN899 folded before Flop (didn't bet)
Seat 7: Vusal11599 folded before Flop (didn't bet)
Seat 8: SteigEin84 (button) folded on the Flop
Seat 9: BarUnDuck (small blind) folded before Flop



PokerStars Hand #228694376286:  Hold'em No Limit ($0.25/$0.50 USD) - 2021/07/30 20:36:33 ET
Table 'Aitne III' 9-max Seat #9 is the button
Seat 1: GastonLeFort ($75.56 in chips) 
Seat 2: UpNDownNS ($44.73 in chips) 
Seat 3: Dragonclawss ($53.75 in chips) 
Seat 4: christyirish ($60.07 in chips) 
Seat 5: jantheman222 ($51.69 in chips) 
Seat 6: KARANN899 ($85.83 in chips) 
Seat 7: Vusal11599 ($20.02 in chips) 
Seat 8: SteigEin84 ($35.81 in chips) 
Seat 9: BarUnDuck ($19.75 in chips) 
GastonLeFort: posts small blind $0.25
UpNDownNS: posts big blind $0.50
*** HOLE CARDS ***
Dragonclawss: folds 
christyirish: folds 
jantheman222: folds 
KARANN899: folds 
Vusal11599: raises $1 to $1.50
SteigEin84: calls $1.50
BarUnDuck: folds 
GastonLeFort: raises $5 to $6.50
UpNDownNS: folds 
Vusal11599: raises $13.52 to $20.02 and is all-in
SteigEin84: folds 
GastonLeFort: calls $13.52
*** FLOP *** [7d Kd 2c]
*** TURN *** [7d Kd 2c] [Tc]
*** RIVER *** [7d Kd 2c Tc] [5s]
*** SHOW DOWN ***
GastonLeFort: shows [Ks Ad] (a pair of Kings)
Vusal11599: shows [9s 9c] (a pair of Nines)
GastonLeFort collected $40.04 from pot
Vusal11599 cashed out the hand for $21.91 | Cash Out Fee $0.22
*** SUMMARY ***
Total pot $42.04 | Rake $2 
Board [7d Kd 2c Tc 5s]
Seat 1: GastonLeFort (small blind) showed [Ks Ad] and won ($40.04) with a pair of Kings
Seat 2: UpNDownNS (big blind) folded before Flop
Seat 3: Dragonclawss folded before Flop (didn't bet)
Seat 4: christyirish folded before Flop (didn't bet)
Seat 5: jantheman222 folded before Flop (didn't bet)
Seat 6: KARANN899 folded before Flop (didn't bet)
Seat 7: Vusal11599 showed [9s 9c] and lost with a pair of Nines (cashed out).
Seat 8: SteigEin84 folded before Flop
Seat 9: BarUnDuck (button) folded before Flop (didn't bet)



PokerStars Hand #228694394413:  Hold'em No Limit ($0.25/$0.50 USD) - 2021/07/30 20:37:39 ET
Table 'Aitne III' 9-max Seat #1 is the button
Seat 1: GastonLeFort ($95.58 in chips) 
Seat 2: UpNDownNS ($44.23 in chips) 
Seat 3: Dragonclawss ($53.75 in chips) 
Seat 4: christyirish ($60.07 in chips) 
Seat 5: jantheman222 ($51.69 in chips) 
Seat 6: KARANN899 ($85.83 in chips) 
Seat 7: Vusal11599 ($21.91 in chips) 
Seat 8: SteigEin84 ($34.31 in chips) 
Seat 9: BarUnDuck ($19.75 in chips) 
UpNDownNS: posts small blind $0.25
Dragonclawss: posts big blind $0.50
*** HOLE CARDS ***
christyirish: folds 
jantheman222: folds 
KARANN899: folds 
Vusal11599: folds 
SteigEin84: raises $0.50 to $1
BarUnDuck has timed out
BarUnDuck: folds 
GastonLeFort: folds 
UpNDownNS: raises $3.50 to $4.50
Dragonclawss: folds 
SteigEin84: calls $3.50
*** FLOP *** [5c Js 6c]
UpNDownNS: bets $7.50
SteigEin84: folds 
Uncalled bet ($7.50) returned to UpNDownNS
UpNDownNS collected $9.02 from pot
UpNDownNS: doesn't show hand 
*** SUMMARY ***
Total pot $9.50 | Rake $0.48 
Board [5c Js 6c]
Seat 1: GastonLeFort (button) folded before Flop (didn't bet)
Seat 2: UpNDownNS (small blind) collected ($9.02)
Seat 3: Dragonclawss (big blind) folded before Flop
Seat 4: christyirish folded before Flop (didn't bet)
Seat 5: jantheman222 folded before Flop (didn't bet)
Seat 6: KARANN899 folded before Flop (didn't bet)
Seat 7: Vusal11599 folded before Flop (didn't bet)
Seat 8: SteigEin84 folded on the Flop
Seat 9: BarUnDuck folded before Flop (didn't bet)



PokerStars Hand #228694407145:  Hold'em No Limit ($0.25/$0.50 USD) - 2021/07/30 20:38:25 ET
Table 'Aitne III' 9-max Seat #2 is the button
Seat 1: GastonLeFort ($95.58 in chips) 
Seat 2: UpNDownNS ($48.75 in chips) 
Seat 3: Dragonclawss ($53.25 in chips) 
Seat 4: christyirish ($60.07 in chips) 
Seat 5: jantheman222 ($51.69 in chips) 
Seat 6: KARANN899 ($85.83 in chips) 
Seat 7: Vusal11599 ($21.91 in chips) 
Seat 8: SteigEin84 ($29.81 in chips) 
Seat 9: BarUnDuck ($19.75 in chips) 
Dragonclawss: posts small blind $0.25
christyirish: posts big blind $0.50
*** HOLE CARDS ***
jantheman222: folds 
KARANN899: folds 
Vusal11599: raises $1 to $1.50
SteigEin84: calls $1.50
BarUnDuck: folds 
GastonLeFort: folds 
UpNDownNS: folds 
Dragonclawss: folds 
christyirish: folds 
*** FLOP *** [2d 7s 5s]
Vusal11599: checks 
SteigEin84: checks 
*** TURN *** [2d 7s 5s] [Ad]
Vusal11599: bets $1.78
SteigEin84: folds 
Uncalled bet ($1.78) returned to Vusal11599
Vusal11599 collected $3.56 from pot
Vusal11599: doesn't show hand 
*** SUMMARY ***
Total pot $3.75 | Rake $0.19 
Board [2d 7s 5s Ad]
Seat 1: GastonLeFort folded before Flop (didn't bet)
Seat 2: UpNDownNS (button) folded before Flop (didn't bet)
Seat 3: Dragonclawss (small blind) folded before Flop
Seat 4: christyirish (big blind) folded before Flop
Seat 5: jantheman222 folded before Flop (didn't bet)
Seat 6: KARANN899 folded before Flop (didn't bet)
Seat 7: Vusal11599 collected ($3.56)
Seat 8: SteigEin84 folded on the Turn
Seat 9: BarUnDuck folded before Flop (didn't bet)



PokerStars Hand #228694415079:  Hold'em No Limit ($0.25/$0.50 USD) - 2021/07/30 20:38:54 ET
Table 'Aitne III' 9-max Seat #3 is the button
Seat 1: GastonLeFort ($95.58 in chips) 
Seat 2: UpNDownNS ($48.75 in chips) 
Seat 3: Dragonclawss ($53 in chips) 
Seat 4: christyirish ($59.57 in chips) 
Seat 5: jantheman222 ($51.69 in chips) 
Seat 6: KARANN899 ($85.83 in chips) 
Seat 7: Vusal11599 ($23.97 in chips) 
Seat 8: SteigEin84 ($28.31 in chips) 
Seat 9: BarUnDuck ($19.75 in chips) 
christyirish: posts small blind $0.25
jantheman222: posts big blind $0.50
*** HOLE CARDS ***
KARANN899: folds 
Vusal11599: folds 
SteigEin84: calls $0.50
KARANN899 leaves the table
BarUnDuck: folds 
GastonLeFort: folds 
UpNDownNS: folds 
maisit* joins the table at seat #6 
Dragonclawss: folds 
christyirish: calls $0.25
jantheman222: checks 
*** FLOP *** [5s 9c 2d]
christyirish: checks 
jantheman222: checks 
SteigEin84: bets $1
christyirish: folds 
jantheman222: folds 
Uncalled bet ($1) returned to SteigEin84
SteigEin84 collected $1.40 from pot
SteigEin84: doesn't show hand 
*** SUMMARY ***
Total pot $1.50 | Rake $0.10 
Board [5s 9c 2d]
Seat 1: GastonLeFort folded before Flop (didn't bet)
Seat 2: UpNDownNS folded before Flop (didn't bet)
Seat 3: Dragonclawss (button) folded before Flop (didn't bet)
Seat 4: christyirish (small blind) folded on the Flop
Seat 5: jantheman222 (big blind) folded on the Flop
Seat 6: KARANN899 folded before Flop (didn't bet)
Seat 7: Vusal11599 folded before Flop (didn't bet)
Seat 8: SteigEin84 collected ($1.40)
Seat 9: BarUnDuck folded before Flop (didn't bet)



PokerStars Hand #228694427565:  Hold'em No Limit ($0.25/$0.50 USD) - 2021/07/30 20:39:39 ET
Table 'Aitne III' 9-max Seat #4 is the button
Seat 1: GastonLeFort ($95.58 in chips) 
Seat 2: UpNDownNS ($48.75 in chips) 
Seat 3: Dragonclawss ($53 in chips) 
Seat 4: christyirish ($59.07 in chips) 
Seat 5: jantheman222 ($51.19 in chips) 
Seat 6: maisit* ($50 in chips) 
Seat 7: Vusal11599 ($23.97 in chips) 
Seat 8: SteigEin84 ($29.21 in chips) 
Seat 9: BarUnDuck ($19.75 in chips) 
jantheman222: posts small blind $0.25
maisit*: posts big blind $0.50
*** HOLE CARDS ***
Vusal11599: folds 
SteigEin84: folds 
BarUnDuck: raises $0.50 to $1
GastonLeFort: folds 
UpNDownNS: folds 
Dragonclawss: folds 
christyirish: folds 
jantheman222: folds 
maisit*: folds 
Uncalled bet ($0.50) returned to BarUnDuck
BarUnDuck collected $1.25 from pot
BarUnDuck: doesn't show hand 
*** SUMMARY ***
Total pot $1.25 | Rake $0 
Seat 1: GastonLeFort folded before Flop (didn't bet)
Seat 2: UpNDownNS folded before Flop (didn't bet)
Seat 3: Dragonclawss folded before Flop (didn't bet)
Seat 4: christyirish (button) folded before Flop (didn't bet)
Seat 5: jantheman222 (small blind) folded before Flop
Seat 6: maisit* (big blind) folded before Flop
Seat 7: Vusal11599 folded before Flop (didn't bet)
Seat 8: SteigEin84 folded before Flop (didn't bet)
Seat 9: BarUnDuck collected ($1.25)



PokerStars Hand #228694434712:  Hold'em No Limit ($0.25/$0.50 USD) - 2021/07/30 20:40:05 ET
Table 'Aitne III' 9-max Seat #5 is the button
Seat 1: GastonLeFort ($95.58 in chips) 
Seat 2: UpNDownNS ($48.75 in chips) 
Seat 3: Dragonclawss ($53 in chips) 
Seat 4: christyirish ($59.07 in chips) 
Seat 5: jantheman222 ($50.94 in chips) 
Seat 6: maisit* ($50 in chips) 
Seat 7: Vusal11599 ($23.97 in chips) 
Seat 8: SteigEin84 ($29.21 in chips) 
Seat 9: BarUnDuck ($20.50 in chips) 
maisit*: posts small blind $0.25
Vusal11599: posts big blind $0.50
*** HOLE CARDS ***
SteigEin84: folds 
BarUnDuck: folds 
GastonLeFort: folds 
UpNDownNS: folds 
Dragonclawss: folds 
christyirish: folds 
jantheman222: raises $0.75 to $1.25
maisit*: folds 
Vusal11599: raises $2.75 to $4
jantheman222: folds 
Uncalled bet ($2.75) returned to Vusal11599
Vusal11599 collected $2.75 from pot
Vusal11599: doesn't show hand 
*** SUMMARY ***
Total pot $2.75 | Rake $0 
Seat 1: GastonLeFort folded before Flop (didn't bet)
Seat 2: UpNDownNS folded before Flop (didn't bet)
Seat 3: Dragonclawss folded before Flop (didn't bet)
Seat 4: christyirish folded before Flop (didn't bet)
Seat 5: jantheman222 (button) folded before Flop
Seat 6: maisit* (small blind) folded before Flop
Seat 7: Vusal11599 (big blind) collected ($2.75)
Seat 8: SteigEin84 folded before Flop (didn't bet)
Seat 9: BarUnDuck folded before Flop (didn't bet)



PokerStars Hand #228694445237:  Hold'em No Limit ($0.25/$0.50 USD) - 2021/07/30 20:40:43 ET
Table 'Aitne III' 9-max Seat #6 is the button
Seat 1: GastonLeFort ($95.58 in chips) 
Seat 2: UpNDownNS ($48.75 in chips) 
Seat 3: Dragonclawss ($53 in chips) 
Seat 4: christyirish ($59.07 in chips) 
Seat 5: jantheman222 ($49.69 in chips) 
Seat 6: maisit* ($50 in chips) 
Seat 7: Vusal11599 ($25.47 in chips) 
Seat 8: SteigEin84 ($29.21 in chips) 
Seat 9: BarUnDuck ($20.50 in chips) 
Vusal11599: posts small blind $0.25
SteigEin84: posts big blind $0.50
*** HOLE CARDS ***
BarUnDuck: folds 
GastonLeFort: folds 
UpNDownNS: folds 
Dragonclawss: folds 
christyirish: folds 
jantheman222: folds 
maisit*: raises $1 to $1.50
Vusal11599: calls $1.25
SteigEin84: calls $1
*** FLOP *** [Jd 5d Jc]
Vusal11599: checks 
SteigEin84: checks 
maisit*: bets $1.50
Vusal11599: calls $1.50
SteigEin84: folds 
*** TURN *** [Jd 5d Jc] [Tc]
Vusal11599: checks 
maisit*: checks 
*** RIVER *** [Jd 5d Jc Tc] [3c]
Vusal11599: bets $2.81
maisit*: folds 
Uncalled bet ($2.81) returned to Vusal11599
Vusal11599 collected $7.12 from pot
Vusal11599: doesn't show hand 
*** SUMMARY ***
Total pot $7.50 | Rake $0.38 
Board [Jd 5d Jc Tc 3c]
Seat 1: GastonLeFort folded before Flop (didn't bet)
Seat 2: UpNDownNS folded before Flop (didn't bet)
Seat 3: Dragonclawss folded before Flop (didn't bet)
Seat 4: christyirish folded before Flop (didn't bet)
Seat 5: jantheman222 folded before Flop (didn't bet)
Seat 6: maisit* (button) folded on the River
Seat 7: Vusal11599 (small blind) collected ($7.12)
Seat 8: SteigEin84 (big blind) folded on the Flop
Seat 9: BarUnDuck folded before Flop (didn't bet)



PokerStars Hand #228694461643:  Hold'em No Limit ($0.25/$0.50 USD) - 2021/07/30 20:41:43 ET
Table 'Aitne III' 9-max Seat #7 is the button
Seat 1: GastonLeFort ($95.58 in chips) 
Seat 2: UpNDownNS ($48.75 in chips) 
Seat 3: Dragonclawss ($53 in chips) 
Seat 4: christyirish ($59.07 in chips) 
Seat 5: jantheman222 ($49.69 in chips) 
Seat 6: maisit* ($50 in chips) 
Seat 7: Vusal11599 ($29.59 in chips) 
Seat 8: SteigEin84 ($27.71 in chips) 
Seat 9: BarUnDuck ($20.50 in chips) 
SteigEin84: posts small blind $0.25
BarUnDuck: posts big blind $0.50
*** HOLE CARDS ***
GastonLeFort: folds 
UpNDownNS: folds 
Dragonclawss: folds 
christyirish: raises $1 to $1.50
jantheman222: folds 
maisit*: folds 
Vusal11599: folds 
SteigEin84: calls $1.25
BarUnDuck: folds 
*** FLOP *** [As Qd 7h]
SteigEin84: checks 
christyirish: bets $1.66
SteigEin84: calls $1.66
*** TURN *** [As Qd 7h] [Jh]
SteigEin84: checks 
christyirish: checks 
*** RIVER *** [As Qd 7h Jh] [Tc]
SteigEin84: bets $3
christyirish: folds 
Uncalled bet ($3) returned to SteigEin84
SteigEin84 collected $6.40 from pot
SteigEin84: doesn't show hand 
*** SUMMARY ***
Total pot $6.82 | Rake $0.42 
Board [As Qd 7h Jh Tc]
Seat 1: GastonLeFort folded before Flop (didn't bet)
Seat 2: UpNDownNS folded before Flop (didn't bet)
Seat 3: Dragonclawss folded before Flop (didn't bet)
Seat 4: christyirish folded on the River
Seat 5: jantheman222 folded before Flop (didn't bet)
Seat 6: maisit* folded before Flop (didn't bet)
Seat 7: Vusal11599 (button) folded before Flop (didn't bet)
Seat 8: SteigEin84 (small blind) collected ($6.40)
Seat 9: BarUnDuck (big blind) folded before Flop



PokerStars Hand #228694472111:  Hold'em No Limit ($0.25/$0.50 USD) - 2021/07/30 20:42:21 ET
Table 'Aitne III' 9-max Seat #8 is the button
Seat 1: GastonLeFort ($95.58 in chips) 
Seat 2: UpNDownNS ($48.75 in chips) 
Seat 3: Dragonclawss ($53 in chips) 
Seat 4: christyirish ($55.91 in chips) 
Seat 5: jantheman222 ($49.69 in chips) 
Seat 6: maisit* ($50 in chips) 
Seat 7: Vusal11599 ($29.59 in chips) 
Seat 8: SteigEin84 ($30.95 in chips) 
Seat 9: BarUnDuck ($20 in chips) 
BarUnDuck: posts small blind $0.25
GastonLeFort: posts big blind $0.50
*** HOLE CARDS ***
UpNDownNS: folds 
Dragonclawss: folds 
christyirish: folds 
jantheman222: folds 
maisit*: folds 
Vusal11599: raises $1 to $1.50
SteigEin84: calls $1.50
BarUnDuck: folds 
GastonLeFort: folds 
*** FLOP *** [3c Th 5s]
Vusal11599: checks 
SteigEin84: checks 
*** TURN *** [3c Th 5s] [7s]
Vusal11599: checks 
SteigEin84: checks 
*** RIVER *** [3c Th 5s 7s] [9h]
Vusal11599: bets $3.56
SteigEin84: raises $3.56 to $7.12
Vusal11599: folds 
Uncalled bet ($3.56) returned to SteigEin84
SteigEin84 collected $10.19 from pot
SteigEin84: doesn't show hand 
*** SUMMARY ***
Total pot $10.87 | Rake $0.68 
Board [3c Th 5s 7s 9h]
Seat 1: GastonLeFort (big blind) folded before Flop
Seat 2: UpNDownNS folded before Flop (didn't bet)
Seat 3: Dragonclawss folded before Flop (didn't bet)
Seat 4: christyirish folded before Flop (didn't bet)
Seat 5: jantheman222 folded before Flop (didn't bet)
Seat 6: maisit* folded before Flop (didn't bet)
Seat 7: Vusal11599 folded on the River
Seat 8: SteigEin84 (button) collected ($10.19)
Seat 9: BarUnDuck (small blind) folded before Flop



PokerStars Hand #228694485144:  Hold'em No Limit ($0.25/$0.50 USD) - 2021/07/30 20:43:09 ET
Table 'Aitne III' 9-max Seat #9 is the button
Seat 1: GastonLeFort ($95.08 in chips) 
Seat 2: UpNDownNS ($48.75 in chips) 
Seat 3: Dragonclawss ($53 in chips) 
Seat 4: christyirish ($55.91 in chips) 
Seat 5: jantheman222 ($49.69 in chips) 
Seat 6: maisit* ($50 in chips) 
Seat 7: Vusal11599 ($24.53 in chips) 
Seat 8: SteigEin84 ($36.08 in chips) 
Seat 9: BarUnDuck ($19.75 in chips) 
GastonLeFort: posts small blind $0.25
UpNDownNS: posts big blind $0.50
*** HOLE CARDS ***
Dragonclawss: folds 
christyirish: folds 
jantheman222: folds 
maisit*: folds 
Vusal11599: folds 
SteigEin84: calls $0.50
BarUnDuck: folds 
GastonLeFort: raises $2 to $2.50
UpNDownNS: folds 
SteigEin84: calls $2
*** FLOP *** [Tc Td 2d]
GastonLeFort: bets $1.31
SteigEin84: calls $1.31
*** TURN *** [Tc Td 2d] [Ad]
GastonLeFort: bets $1.93
SteigEin84: raises $3.43 to $5.36
GastonLeFort: folds 
Uncalled bet ($3.43) returned to SteigEin84
SteigEin84 collected $11.23 from pot
SteigEin84: doesn't show hand 
*** SUMMARY ***
Total pot $11.98 | Rake $0.75 
Board [Tc Td 2d Ad]
Seat 1: GastonLeFort (small blind) folded on the Turn
Seat 2: UpNDownNS (big blind) folded before Flop
Seat 3: Dragonclawss folded before Flop (didn't bet)
Seat 4: christyirish folded before Flop (didn't bet)
Seat 5: jantheman222 folded before Flop (didn't bet)
Seat 6: maisit* folded before Flop (didn't bet)
Seat 7: Vusal11599 folded before Flop (didn't bet)
Seat 8: SteigEin84 collected ($11.23)
Seat 9: BarUnDuck (button) folded before Flop (didn't bet)



PokerStars Hand #228694511925:  Hold'em No Limit ($0.25/$0.50 USD) - 2021/07/30 20:44:44 ET
Table 'Aitne III' 9-max Seat #1 is the button
Seat 1: GastonLeFort ($89.34 in chips) 
Seat 2: UpNDownNS ($48.25 in chips) 
Seat 3: Dragonclawss ($53 in chips) 
Seat 4: christyirish ($55.91 in chips) 
Seat 5: jantheman222 ($49.69 in chips) 
Seat 6: maisit* ($50 in chips) 
Seat 7: Vusal11599 ($24.53 in chips) 
Seat 8: SteigEin84 ($41.57 in chips) 
Seat 9: BarUnDuck ($19.75 in chips) 
UpNDownNS: posts small blind $0.25
Dragonclawss: posts big blind $0.50
*** HOLE CARDS ***
christyirish: folds 
jantheman222: raises $0.75 to $1.25
maisit*: folds 
Vusal11599: folds 
SteigEin84: calls $1.25
BarUnDuck: folds 
GastonLeFort: folds 
UpNDownNS: folds 
Dragonclawss: folds 
*** FLOP *** [8c 3c 5h]
jantheman222: checks 
SteigEin84: checks 
*** TURN *** [8c 3c 5h] [Qs]
jantheman222: bets $1.02
SteigEin84: folds 
Uncalled bet ($1.02) returned to jantheman222
jantheman222 collected $3.09 from pot
*** SUMMARY ***
Total pot $3.25 | Rake $0.16 
Board [8c 3c 5h Qs]
Seat 1: GastonLeFort (button) folded before Flop (didn't bet)
Seat 2: UpNDownNS (small blind) folded before Flop
Seat 3: Dragonclawss (big blind) folded before Flop
Seat 4: christyirish folded before Flop (didn't bet)
Seat 5: jantheman222 collected ($3.09)
Seat 6: maisit* folded before Flop (didn't bet)
Seat 7: Vusal11599 folded before Flop (didn't bet)
Seat 8: SteigEin84 folded on the Turn
Seat 9: BarUnDuck folded before Flop (didn't bet)



PokerStars Hand #228694536061:  Hold'em No Limit ($0.25/$0.50 USD) - 2021/07/30 20:45:27 ET
Table 'Aitne III' 9-max Seat #2 is the button
Seat 1: GastonLeFort ($89.34 in chips) 
Seat 2: UpNDownNS ($48 in chips) 
Seat 3: Dragonclawss ($52.50 in chips) 
Seat 4: christyirish ($55.91 in chips) 
Seat 5: jantheman222 ($51.53 in chips) 
Seat 6: maisit* ($50 in chips) 
Seat 7: Vusal11599 ($24.53 in chips) 
Seat 8: SteigEin84 ($40.32 in chips) 
Seat 9: BarUnDuck ($19.75 in chips) 
Dragonclawss: posts small blind $0.25
christyirish: posts big blind $0.50
*** HOLE CARDS ***
jantheman222: folds 
maisit*: folds 
Vusal11599: folds 
SteigEin84: folds 
BarUnDuck: folds 
GastonLeFort: folds 
UpNDownNS: folds 
Dragonclawss: folds 
Uncalled bet ($0.25) returned to christyirish
christyirish collected $0.50 from pot
*** SUMMARY ***
Total pot $0.50 | Rake $0 
Seat 1: GastonLeFort folded before Flop (didn't bet)
Seat 2: UpNDownNS (button) folded before Flop (didn't bet)
Seat 3: Dragonclawss (small blind) folded before Flop
Seat 4: christyirish (big blind) collected ($0.50)
Seat 5: jantheman222 folded before Flop (didn't bet)
Seat 6: maisit* folded before Flop (didn't bet)
Seat 7: Vusal11599 folded before Flop (didn't bet)
Seat 8: SteigEin84 folded before Flop (didn't bet)
Seat 9: BarUnDuck folded before Flop (didn't bet)



PokerStars Hand #228694540034:  Hold'em No Limit ($0.25/$0.50 USD) - 2021/07/30 20:45:42 ET
Table 'Aitne III' 9-max Seat #3 is the button
Seat 1: GastonLeFort ($89.34 in chips) 
Seat 2: UpNDownNS ($48 in chips) 
Seat 3: Dragonclawss ($52.25 in chips) 
Seat 4: christyirish ($56.16 in chips) 
Seat 5: jantheman222 ($51.53 in chips) 
Seat 6: maisit* ($50 in chips) 
Seat 7: Vusal11599 ($24.53 in chips) 
Seat 8: SteigEin84 ($40.32 in chips) 
Seat 9: BarUnDuck ($19.75 in chips) 
christyirish: posts small blind $0.25
jantheman222: posts big blind $0.50
*** HOLE CARDS ***
maisit*: raises $1 to $1.50
Vusal11599: raises $3.75 to $5.25
SteigEin84: folds 
BarUnDuck: folds 
GastonLeFort: folds 
UpNDownNS: folds 
Dragonclawss: folds 
christyirish: folds 
jantheman222: folds 
maisit*: calls $3.75
*** FLOP *** [2c Qd Td]
maisit*: checks 
Vusal11599: checks 
*** TURN *** [2c Qd Td] [4d]
maisit*: bets $8.02
Vusal11599: raises $11.26 to $19.28 and is all-in
maisit*: folds 
Uncalled bet ($11.26) returned to Vusal11599
Vusal11599 collected $25.93 from pot
Vusal11599: doesn't show hand 
*** SUMMARY ***
Total pot $27.29 | Rake $1.36 
Board [2c Qd Td 4d]
Seat 1: GastonLeFort folded before Flop (didn't bet)
Seat 2: UpNDownNS folded before Flop (didn't bet)
Seat 3: Dragonclawss (button) folded before Flop (didn't bet)
Seat 4: christyirish (small blind) folded before Flop
Seat 5: jantheman222 (big blind) folded before Flop
Seat 6: maisit* folded on the Turn
Seat 7: Vusal11599 collected ($25.93)
Seat 8: SteigEin84 folded before Flop (didn't bet)
Seat 9: BarUnDuck folded before Flop (didn't bet)



PokerStars Hand #228694555342:  Hold'em No Limit ($0.25/$0.50 USD) - 2021/07/30 20:46:39 ET
Table 'Aitne III' 9-max Seat #4 is the button
Seat 1: GastonLeFort ($89.34 in chips) 
Seat 2: UpNDownNS ($48 in chips) 
Seat 3: Dragonclawss ($52.25 in chips) 
Seat 4: christyirish ($55.91 in chips) 
Seat 5: jantheman222 ($51.03 in chips) 
Seat 6: maisit* ($50 in chips) 
Seat 7: Vusal11599 ($37.19 in chips) 
Seat 8: SteigEin84 ($40.32 in chips) 
Seat 9: BarUnDuck ($19.75 in chips) 
jantheman222: posts small blind $0.25
maisit*: posts big blind $0.50
*** HOLE CARDS ***
Vusal11599: raises $0.50 to $1
SteigEin84: folds 
BarUnDuck: folds 
GastonLeFort: folds 
UpNDownNS: folds 
Dragonclawss: folds 
christyirish: folds 
jantheman222: calls $0.75
maisit*: calls $0.50
*** FLOP *** [Jh 8s 5s]
jantheman222: checks 
maisit*: checks 
Vusal11599: bets $1.25
jantheman222: folds 
maisit*: calls $1.25
*** TURN *** [Jh 8s 5s] [Ad]
maisit*: checks 
Vusal11599: checks 
*** RIVER *** [Jh 8s 5s Ad] [2s]
maisit*: bets $4
Vusal11599: raises $6.61 to $10.61
maisit*: raises $28.39 to $39
Vusal11599: calls $24.33 and is all-in
Uncalled bet ($4.06) returned to maisit*
*** SHOW DOWN ***
maisit*: shows [4s Ks] (a flush, King high)
Vusal11599: shows [Js Ts] (a flush, Jack high)
maisit* collected $73.38 from pot
*** SUMMARY ***
Total pot $75.38 | Rake $2 
Board [Jh 8s 5s Ad 2s]
Seat 1: GastonLeFort folded before Flop (didn't bet)
Seat 2: UpNDownNS folded before Flop (didn't bet)
Seat 3: Dragonclawss folded before Flop (didn't bet)
Seat 4: christyirish (button) folded before Flop (didn't bet)
Seat 5: jantheman222 (small blind) folded on the Flop
Seat 6: maisit* (big blind) showed [4s Ks] and won ($73.38) with a flush, King high
Seat 7: Vusal11599 showed [Js Ts] and lost with a flush, Jack high
Seat 8: SteigEin84 folded before Flop (didn't bet)
Seat 9: BarUnDuck folded before Flop (didn't bet)



PokerStars Hand #228694586126:  Hold'em No Limit ($0.25/$0.50 USD) - 2021/07/30 20:48:01 ET
Table 'Aitne III' 9-max Seat #5 is the button
Seat 1: GastonLeFort ($89.34 in chips) 
Seat 2: UpNDownNS ($48 in chips) 
Seat 3: Dragonclawss ($52.25 in chips) 
Seat 4: christyirish ($55.91 in chips) 
Seat 5: jantheman222 ($50.03 in chips) 
Seat 6: maisit* ($86.19 in chips) 
Seat 8: SteigEin84 ($40.32 in chips) 
Seat 9: BarUnDuck ($19.75 in chips) 
maisit*: posts small blind $0.25
SteigEin84: posts big blind $0.50
*** HOLE CARDS ***
BarUnDuck: raises $0.50 to $1
GastonLeFort: folds 
UpNDownNS: folds 
Vusal11599 leaves the table
Dragonclawss: raises $3.50 to $4.50
christyirish: folds 
jantheman222: folds 
maisit*: folds 
SteigEin84: folds 
BarUnDuck: raises $15.25 to $19.75 and is all-in
Dragonclawss: calls $15.25
*** FLOP *** [6s 7h 2d]
*** TURN *** [6s 7h 2d] [7d]
*** RIVER *** [6s 7h 2d 7d] [8s]
*** SHOW DOWN ***
BarUnDuck: shows [Qs Qd] (two pair, Queens and Sevens)
Dragonclawss: shows [Ah Kd] (a pair of Sevens)
BarUnDuck collected $38.25 from pot
*** SUMMARY ***
Total pot $40.25 | Rake $2 
Board [6s 7h 2d 7d 8s]
Seat 1: GastonLeFort folded before Flop (didn't bet)
Seat 2: UpNDownNS folded before Flop (didn't bet)
Seat 3: Dragonclawss showed [Ah Kd] and lost with a pair of Sevens
Seat 4: christyirish folded before Flop (didn't bet)
Seat 5: jantheman222 (button) folded before Flop (didn't bet)
Seat 6: maisit* (small blind) folded before Flop
Seat 8: SteigEin84 (big blind) folded before Flop
Seat 9: BarUnDuck showed [Qs Qd] and won ($38.25) with two pair, Queens and Sevens



PokerStars Hand #228694597158:  Hold'em No Limit ($0.25/$0.50 USD) - 2021/07/30 20:48:43 ET
Table 'Aitne III' 9-max Seat #6 is the button
Seat 1: GastonLeFort ($89.34 in chips) 
Seat 2: UpNDownNS ($48 in chips) 
Seat 3: Dragonclawss ($50 in chips) 
Seat 4: christyirish ($55.91 in chips) 
Seat 5: jantheman222 ($50.03 in chips) 
Seat 6: maisit* ($85.94 in chips) 
Seat 8: SteigEin84 ($39.82 in chips) 
Seat 9: BarUnDuck ($38.25 in chips) 
SteigEin84: posts small blind $0.25
BarUnDuck: posts big blind $0.50
*** HOLE CARDS ***
whitecillar3 joins the table at seat #7 
GastonLeFort: folds 
UpNDownNS: raises $1 to $1.50
Dragonclawss: folds 
christyirish: folds 
jantheman222: folds 
maisit*: folds 
SteigEin84: folds 
BarUnDuck: folds 
Uncalled bet ($1) returned to UpNDownNS
UpNDownNS collected $1.25 from pot
UpNDownNS: doesn't show hand 
*** SUMMARY ***
Total pot $1.25 | Rake $0 
Seat 1: GastonLeFort folded before Flop (didn't bet)
Seat 2: UpNDownNS collected ($1.25)
Seat 3: Dragonclawss folded before Flop (didn't bet)
Seat 4: christyirish folded before Flop (didn't bet)
Seat 5: jantheman222 folded before Flop (didn't bet)
Seat 6: maisit* (button) folded before Flop (didn't bet)
Seat 8: SteigEin84 (small blind) folded before Flop
Seat 9: BarUnDuck (big blind) folded before Flop



PokerStars Hand #228694600857:  Hold'em No Limit ($0.25/$0.50 USD) - 2021/07/30 20:48:57 ET
Table 'Aitne III' 9-max Seat #8 is the button
Seat 1: GastonLeFort ($89.34 in chips) 
Seat 2: UpNDownNS ($48.75 in chips) 
Seat 3: Dragonclawss ($50 in chips) 
Seat 4: christyirish ($55.91 in chips) 
Seat 5: jantheman222 ($50.03 in chips) 
Seat 6: maisit* ($85.94 in chips) 
Seat 8: SteigEin84 ($39.57 in chips) 
Seat 9: BarUnDuck ($37.75 in chips) 
BarUnDuck: posts small blind $0.25
GastonLeFort: posts big blind $0.50
whitecillar3: sits out 
*** HOLE CARDS ***
UpNDownNS: folds 
Dragonclawss: folds 
christyirish: folds 
jantheman222: folds 
maisit*: folds 
SteigEin84: raises $1 to $1.50
BarUnDuck: folds 
GastonLeFort: folds 
Uncalled bet ($1) returned to SteigEin84
SteigEin84 collected $1.25 from pot
SteigEin84: doesn't show hand 
*** SUMMARY ***
Total pot $1.25 | Rake $0 
Seat 1: GastonLeFort (big blind) folded before Flop
Seat 2: UpNDownNS folded before Flop (didn't bet)
Seat 3: Dragonclawss folded before Flop (didn't bet)
Seat 4: christyirish folded before Flop (didn't bet)
Seat 5: jantheman222 folded before Flop (didn't bet)
Seat 6: maisit* folded before Flop (didn't bet)
Seat 8: SteigEin84 (button) collected ($1.25)
Seat 9: BarUnDuck (small blind) folded before Flop



PokerStars Hand #228694607589:  Hold'em No Limit ($0.25/$0.50 USD) - 2021/07/30 20:49:22 ET
Table 'Aitne III' 9-max Seat #9 is the button
Seat 1: GastonLeFort ($88.84 in chips) 
Seat 2: UpNDownNS ($48.75 in chips) 
Seat 3: Dragonclawss ($50 in chips) 
Seat 4: christyirish ($55.91 in chips) 
Seat 5: jantheman222 ($50.03 in chips) 
Seat 6: maisit* ($85.94 in chips) 
Seat 8: SteigEin84 ($40.32 in chips) 
Seat 9: BarUnDuck ($37.50 in chips) 
GastonLeFort: posts small blind $0.25
UpNDownNS: posts big blind $0.50
whitecillar3: sits out 
*** HOLE CARDS ***
Dragonclawss: folds 
Dragonclawss leaves the table
christyirish: folds 
jantheman222: raises $0.75 to $1.25
maisit*: folds 
SteigEin84: folds 
BarUnDuck: raises $3.25 to $4.50
GastonLeFort: folds 
UpNDownNS: folds 
jantheman222: folds 
Uncalled bet ($3.25) returned to BarUnDuck
BarUnDuck collected $3.25 from pot
BarUnDuck: doesn't show hand 
*** SUMMARY ***
Total pot $3.25 | Rake $0 
Seat 1: GastonLeFort (small blind) folded before Flop
Seat 2: UpNDownNS (big blind) folded before Flop
Seat 3: Dragonclawss folded before Flop (didn't bet)
Seat 4: christyirish folded before Flop (didn't bet)
Seat 5: jantheman222 folded before Flop
Seat 6: maisit* folded before Flop (didn't bet)
Seat 8: SteigEin84 folded before Flop (didn't bet)
Seat 9: BarUnDuck (button) collected ($3.25)



PokerStars Hand #228694615855:  Hold'em No Limit ($0.25/$0.50 USD) - 2021/07/30 20:49:53 ET
Table 'Aitne III' 9-max Seat #1 is the button
Seat 1: GastonLeFort ($88.59 in chips) 
Seat 2: UpNDownNS ($48.25 in chips) 
Seat 4: christyirish ($55.91 in chips) 
Seat 5: jantheman222 ($48.78 in chips) 
Seat 6: maisit* ($85.94 in chips) 
Seat 8: SteigEin84 ($40.32 in chips) 
Seat 9: BarUnDuck ($39.50 in chips) 
UpNDownNS: posts small blind $0.25
christyirish: posts big blind $0.50
whitecillar3: sits out 
*** HOLE CARDS ***
jantheman222: folds 
maisit*: folds 
SteigEin84: folds 
BarUnDuck: folds 
GastonLeFort: raises $0.75 to $1.25
UpNDownNS: folds 
christyirish: calls $0.75
*** FLOP *** [Qd Ad Th]
christyirish: checks 
GastonLeFort: bets $0.65
christyirish: raises $2.93 to $3.58
GastonLeFort: folds 
Uncalled bet ($2.93) returned to christyirish
christyirish collected $3.85 from pot
christyirish: doesn't show hand 
*** SUMMARY ***
Total pot $4.05 | Rake $0.20 
Board [Qd Ad Th]
Seat 1: GastonLeFort (button) folded on the Flop
Seat 2: UpNDownNS (small blind) folded before Flop
Seat 4: christyirish (big blind) collected ($3.85)
Seat 5: jantheman222 folded before Flop (didn't bet)
Seat 6: maisit* folded before Flop (didn't bet)
Seat 8: SteigEin84 folded before Flop (didn't bet)
Seat 9: BarUnDuck folded before Flop (didn't bet)



PokerStars Hand #228694626375:  Hold'em No Limit ($0.25/$0.50 USD) - 2021/07/30 20:50:33 ET
Table 'Aitne III' 9-max Seat #2 is the button
Seat 1: GastonLeFort ($86.69 in chips) 
Seat 2: UpNDownNS ($48 in chips) 
Seat 4: christyirish ($57.86 in chips) 
Seat 5: jantheman222 ($48.78 in chips) 
Seat 6: maisit* ($85.94 in chips) 
Seat 8: SteigEin84 ($40.32 in chips) 
Seat 9: BarUnDuck ($39.50 in chips) 
christyirish: posts small blind $0.25
jantheman222: posts big blind $0.50
whitecillar3: sits out 
*** HOLE CARDS ***
maisit*: folds 
SteigEin84: calls $0.50
BarUnDuck: folds 
GastonLeFort: folds 
UpNDownNS: folds 
christyirish: folds 
jantheman222: raises $1.50 to $2
SteigEin84: calls $1.50
*** FLOP *** [5h Ah Ts]
isoxa joins the table at seat #3 
jantheman222: checks 
SteigEin84: checks 
*** TURN *** [5h Ah Ts] [7d]
jantheman222: bets $1.75
SteigEin84: folds 
Uncalled bet ($1.75) returned to jantheman222
jantheman222 collected $4.04 from pot
jantheman222: doesn't show hand 
*** SUMMARY ***
Total pot $4.25 | Rake $0.21 
Board [5h Ah Ts 7d]
Seat 1: GastonLeFort folded before Flop (didn't bet)
Seat 2: UpNDownNS (button) folded before Flop (didn't bet)
Seat 4: christyirish (small blind) folded before Flop
Seat 5: jantheman222 (big blind) collected ($4.04)
Seat 6: maisit* folded before Flop (didn't bet)
Seat 8: SteigEin84 folded on the Turn
Seat 9: BarUnDuck folded before Flop (didn't bet)



PokerStars Hand #228694638519:  Hold'em No Limit ($0.25/$0.50 USD) - 2021/07/30 20:51:18 ET
Table 'Aitne III' 9-max Seat #4 is the button
Seat 1: GastonLeFort ($86.69 in chips) 
Seat 2: UpNDownNS ($48 in chips) 
Seat 4: christyirish ($57.61 in chips) 
Seat 5: jantheman222 ($50.82 in chips) 
Seat 6: maisit* ($85.94 in chips) 
Seat 8: SteigEin84 ($38.32 in chips) 
Seat 9: BarUnDuck ($39.50 in chips) 
jantheman222: posts small blind $0.25
maisit*: posts big blind $0.50
whitecillar3: sits out 
isoxa: sits out 
*** HOLE CARDS ***
SteigEin84: folds 
BarUnDuck: folds 
GastonLeFort: raises $1 to $1.50
UpNDownNS: folds 
christyirish: calls $1.50
jantheman222: folds 
maisit*: calls $1
*** FLOP *** [9c 7d 8s]
maisit*: checks 
GastonLeFort: checks 
christyirish: checks 
*** TURN *** [9c 7d 8s] [9h]
maisit*: checks 
GastonLeFort: bets $1.13
christyirish: calls $1.13
maisit*: calls $1.13
*** RIVER *** [9c 7d 8s 9h] [8c]
maisit*: checks 
GastonLeFort: bets $4.25
christyirish: folds 
maisit*: folds 
Uncalled bet ($4.25) returned to GastonLeFort
GastonLeFort collected $7.73 from pot
GastonLeFort: doesn't show hand 
*** SUMMARY ***
Total pot $8.14 | Rake $0.41 
Board [9c 7d 8s 9h 8c]
Seat 1: GastonLeFort collected ($7.73)
Seat 2: UpNDownNS folded before Flop (didn't bet)
Seat 4: christyirish (button) folded on the River
Seat 5: jantheman222 (small blind) folded before Flop
Seat 6: maisit* (big blind) folded on the River
Seat 8: SteigEin84 folded before Flop (didn't bet)
Seat 9: BarUnDuck folded before Flop (didn't bet)



PokerStars Hand #228694661569:  Hold'em No Limit ($0.25/$0.50 USD) - 2021/07/30 20:52:45 ET
Table 'Aitne III' 9-max Seat #5 is the button
Seat 1: GastonLeFort ($91.79 in chips) 
Seat 2: UpNDownNS ($48 in chips) 
Seat 3: isoxa ($25.16 in chips) 
Seat 4: christyirish ($54.98 in chips) 
Seat 5: jantheman222 ($50.57 in chips) 
Seat 6: maisit* ($83.31 in chips) 
Seat 8: SteigEin84 ($38.32 in chips) 
Seat 9: BarUnDuck ($39.50 in chips) 
maisit*: posts small blind $0.25
SteigEin84: posts big blind $0.50
isoxa: posts big blind $0.50
*** HOLE CARDS ***
BarUnDuck: folds 
GastonLeFort: folds 
UpNDownNS: folds 
isoxa: checks 
christyirish: folds 
jantheman222: folds 
maisit*: folds 
SteigEin84: checks 
*** FLOP *** [3h Jc Qd]
SteigEin84: checks 
isoxa: bets $0.59
SteigEin84: calls $0.59
*** TURN *** [3h Jc Qd] [Qh]
SteigEin84: checks 
isoxa: bets $1.15
SteigEin84: raises $3.15 to $4.30
isoxa: raises $3.15 to $7.45
SteigEin84: folds 
Uncalled bet ($3.15) returned to isoxa
isoxa collected $10.48 from pot
isoxa: doesn't show hand 
*** SUMMARY ***
Total pot $11.03 | Rake $0.55 
Board [3h Jc Qd Qh]
Seat 1: GastonLeFort folded before Flop (didn't bet)
Seat 2: UpNDownNS folded before Flop (didn't bet)
Seat 3: isoxa collected ($10.48)
Seat 4: christyirish folded before Flop (didn't bet)
Seat 5: jantheman222 (button) folded before Flop (didn't bet)
Seat 6: maisit* (small blind) folded before Flop
Seat 8: SteigEin84 (big blind) folded on the Turn
Seat 9: BarUnDuck folded before Flop (didn't bet)



PokerStars Hand #228694686095:  Hold'em No Limit ($0.25/$0.50 USD) - 2021/07/30 20:53:44 ET
Table 'Aitne III' 9-max Seat #6 is the button
Seat 1: GastonLeFort ($91.79 in chips) 
Seat 2: UpNDownNS ($48 in chips) 
Seat 3: isoxa ($30.25 in chips) 
Seat 4: christyirish ($54.98 in chips) 
Seat 5: jantheman222 ($50.57 in chips) 
Seat 6: maisit* ($83.06 in chips) 
Seat 8: SteigEin84 ($32.93 in chips) 
Seat 9: BarUnDuck ($39.50 in chips) 
SteigEin84: posts small blind $0.25
BarUnDuck: posts big blind $0.50
*** HOLE CARDS ***
GastonLeFort: folds 
UpNDownNS: folds 
isoxa: calls $0.50
christyirish: folds 
jantheman222: folds 
maisit*: folds 
SteigEin84: folds 
BarUnDuck: checks 
*** FLOP *** [2c 7d 3d]
BarUnDuck: checks 
isoxa: checks 
*** TURN *** [2c 7d 3d] [Ah]
BarUnDuck: checks 
isoxa: bets $0.50
BarUnDuck: folds 
Uncalled bet ($0.50) returned to isoxa
isoxa collected $1.19 from pot
isoxa: doesn't show hand 
*** SUMMARY ***
Total pot $1.25 | Rake $0.06 
Board [2c 7d 3d Ah]
Seat 1: GastonLeFort folded before Flop (didn't bet)
Seat 2: UpNDownNS folded before Flop (didn't bet)
Seat 3: isoxa collected ($1.19)
Seat 4: christyirish folded before Flop (didn't bet)
Seat 5: jantheman222 folded before Flop (didn't bet)
Seat 6: maisit* (button) folded before Flop (didn't bet)
Seat 8: SteigEin84 (small blind) folded before Flop
Seat 9: BarUnDuck (big blind) folded on the Turn



PokerStars Hand #228694694469:  Hold'em No Limit ($0.25/$0.50 USD) - 2021/07/30 20:54:16 ET
Table 'Aitne III' 9-max Seat #8 is the button
Seat 1: GastonLeFort ($91.79 in chips) 
Seat 2: UpNDownNS ($48 in chips) 
Seat 3: isoxa ($30.94 in chips) 
Seat 4: christyirish ($54.98 in chips) 
Seat 5: jantheman222 ($50.57 in chips) 
Seat 6: maisit* ($83.06 in chips) 
Seat 8: SteigEin84 ($32.68 in chips) 
Seat 9: BarUnDuck ($39 in chips) 
BarUnDuck: posts small blind $0.25
GastonLeFort: posts big blind $0.50
*** HOLE CARDS ***
UpNDownNS: folds 
isoxa: calls $0.50
christyirish: folds 
jantheman222: folds 
maisit*: folds 
SteigEin84: folds 
BarUnDuck: folds 
GastonLeFort: checks 
*** FLOP *** [Jh 9d 2c]
GastonLeFort: checks 
isoxa: bets $0.50
GastonLeFort: calls $0.50
*** TURN *** [Jh 9d 2c] [2d]
GastonLeFort: checks 
isoxa: bets $0.50
GastonLeFort: calls $0.50
*** RIVER *** [Jh 9d 2c 2d] [As]
GastonLeFort: checks 
isoxa: checks 
*** SHOW DOWN ***
GastonLeFort: shows [9s 6s] (two pair, Nines and Deuces)
isoxa: shows [Jc Ts] (two pair, Jacks and Deuces)
isoxa collected $3.09 from pot
*** SUMMARY ***
Total pot $3.25 | Rake $0.16 
Board [Jh 9d 2c 2d As]
Seat 1: GastonLeFort (big blind) showed [9s 6s] and lost with two pair, Nines and Deuces
Seat 2: UpNDownNS folded before Flop (didn't bet)
Seat 3: isoxa showed [Jc Ts] and won ($3.09) with two pair, Jacks and Deuces
Seat 4: christyirish folded before Flop (didn't bet)
Seat 5: jantheman222 folded before Flop (didn't bet)
Seat 6: maisit* folded before Flop (didn't bet)
Seat 8: SteigEin84 (button) folded before Flop (didn't bet)
Seat 9: BarUnDuck (small blind) folded before Flop



PokerStars Hand #228694707177:  Hold'em No Limit ($0.25/$0.50 USD) - 2021/07/30 20:55:05 ET
Table 'Aitne III' 9-max Seat #9 is the button
Seat 1: GastonLeFort ($90.29 in chips) 
Seat 2: UpNDownNS ($48 in chips) 
Seat 3: isoxa ($32.53 in chips) 
Seat 4: christyirish ($54.98 in chips) 
Seat 5: jantheman222 ($50.57 in chips) 
Seat 6: maisit* ($83.06 in chips) 
Seat 8: SteigEin84 ($32.68 in chips) 
Seat 9: BarUnDuck ($38.75 in chips) 
GastonLeFort: posts small blind $0.25
UpNDownNS: posts big blind $0.50
*** HOLE CARDS ***
isoxa: calls $0.50
christyirish: folds 
jantheman222: calls $0.50
maisit*: folds 
SteigEin84: raises $2.50 to $3
BarUnDuck: folds 
GastonLeFort: folds 
UpNDownNS: folds 
isoxa: folds 
jantheman222: folds 
Uncalled bet ($2.50) returned to SteigEin84
SteigEin84 collected $2.25 from pot
SteigEin84: doesn't show hand 
*** SUMMARY ***
Total pot $2.25 | Rake $0 
Seat 1: GastonLeFort (small blind) folded before Flop
Seat 2: UpNDownNS (big blind) folded before Flop
Seat 3: isoxa folded before Flop
Seat 4: christyirish folded before Flop (didn't bet)
Seat 5: jantheman222 folded before Flop
Seat 6: maisit* folded before Flop (didn't bet)
Seat 8: SteigEin84 collected ($2.25)
Seat 9: BarUnDuck (button) folded before Flop (didn't bet)



PokerStars Hand #228694714169:  Hold'em No Limit ($0.25/$0.50 USD) - 2021/07/30 20:55:36 ET
Table 'Aitne III' 9-max Seat #1 is the button
Seat 1: GastonLeFort ($90.04 in chips) 
Seat 2: UpNDownNS ($47.50 in chips) 
Seat 3: isoxa ($32.03 in chips) 
Seat 4: christyirish ($54.98 in chips) 
Seat 5: jantheman222 ($50.07 in chips) 
Seat 6: maisit* ($83.06 in chips) 
Seat 8: SteigEin84 ($34.43 in chips) 
Seat 9: BarUnDuck ($38.75 in chips) 
UpNDownNS: posts small blind $0.25
isoxa: posts big blind $0.50
whitecillar3: sits out 
*** HOLE CARDS ***
christyirish: folds 
jantheman222: folds 
maisit*: folds 
SteigEin84: folds 
BarUnDuck: folds 
GastonLeFort: folds 
UpNDownNS: calls $0.25
isoxa: checks 
*** FLOP *** [2s Jd Qs]
UpNDownNS: bets $0.50
isoxa: raises $0.50 to $1
UpNDownNS: calls $0.50
*** TURN *** [2s Jd Qs] [4c]
BarUnDuck leaves the table
UpNDownNS: checks 
PleBeY95 joins the table at seat #9 
isoxa: bets $1.42
UpNDownNS: calls $1.42
*** RIVER *** [2s Jd Qs 4c] [8s]
UpNDownNS: bets $5
isoxa: calls $5
*** SHOW DOWN ***
UpNDownNS: shows [Th Kc] (high card King)
isoxa: shows [Qd 4h] (two pair, Queens and Fours)
isoxa collected $15.05 from pot
*** SUMMARY ***
Total pot $15.84 | Rake $0.79 
Board [2s Jd Qs 4c 8s]
Seat 1: GastonLeFort (button) folded before Flop (didn't bet)
Seat 2: UpNDownNS (small blind) showed [Th Kc] and lost with high card King
Seat 3: isoxa (big blind) showed [Qd 4h] and won ($15.05) with two pair, Queens and Fours
Seat 4: christyirish folded before Flop (didn't bet)
Seat 5: jantheman222 folded before Flop (didn't bet)
Seat 6: maisit* folded before Flop (didn't bet)
Seat 8: SteigEin84 folded before Flop (didn't bet)
Seat 9: BarUnDuck folded before Flop (didn't bet)



PokerStars Hand #228694725669:  Hold'em No Limit ($0.25/$0.50 USD) - 2021/07/30 20:56:29 ET
Table 'Aitne III' 9-max Seat #2 is the button
Seat 1: GastonLeFort ($90.04 in chips) 
Seat 2: UpNDownNS ($39.58 in chips) 
Seat 3: isoxa ($39.16 in chips) 
Seat 4: christyirish ($54.98 in chips) 
Seat 5: jantheman222 ($50.07 in chips) 
Seat 6: maisit* ($83.06 in chips) 
Seat 8: SteigEin84 ($34.43 in chips) 
isoxa: posts small blind $0.25
christyirish: posts big blind $0.50
whitecillar3: sits out 
PleBeY95: sits out 
*** HOLE CARDS ***
jantheman222: raises $0.75 to $1.25
maisit*: folds 
SteigEin84: calls $1.25
GastonLeFort: folds 
UpNDownNS: calls $1.25
isoxa: calls $1
christyirish: calls $0.75
*** FLOP *** [8d 4c 7s]
isoxa: checks 
christyirish: checks 
jantheman222: checks 
SteigEin84: checks 
UpNDownNS: checks 
*** TURN *** [8d 4c 7s] [Th]
isoxa: checks 
christyirish: bets $4.46
jantheman222: folds 
SteigEin84: folds 
UpNDownNS: raises $7.04 to $11.50
isoxa: folds 
christyirish: folds 
Uncalled bet ($7.04) returned to UpNDownNS
UpNDownNS collected $14.41 from pot
UpNDownNS: doesn't show hand 
*** SUMMARY ***
Total pot $15.17 | Rake $0.76 
Board [8d 4c 7s Th]
Seat 1: GastonLeFort folded before Flop (didn't bet)
Seat 2: UpNDownNS (button) collected ($14.41)
Seat 3: isoxa (small blind) folded on the Turn
Seat 4: christyirish (big blind) folded on the Turn
Seat 5: jantheman222 folded on the Turn
Seat 6: maisit* folded before Flop (didn't bet)
Seat 8: SteigEin84 folded on the Turn



PokerStars Hand #228694740211:  Hold'em No Limit ($0.25/$0.50 USD) - 2021/07/30 20:57:36 ET
Table 'Aitne III' 9-max Seat #3 is the button
Seat 1: GastonLeFort ($90.04 in chips) 
Seat 2: UpNDownNS ($48.28 in chips) 
Seat 3: isoxa ($37.91 in chips) 
Seat 4: christyirish ($50 in chips) 
Seat 5: jantheman222 ($48.82 in chips) 
Seat 6: maisit* ($83.06 in chips) 
Seat 8: SteigEin84 ($33.18 in chips) 
christyirish: posts small blind $0.25
jantheman222: posts big blind $0.50
whitecillar3: sits out 
PleBeY95: sits out 
*** HOLE CARDS ***
maisit*: folds 
SteigEin84: folds 
GastonLeFort: folds 
UpNDownNS: raises $1 to $1.50
isoxa: calls $1.50
christyirish: folds 
jantheman222: folds 
*** FLOP *** [4h Tc Qs]
UpNDownNS: bets $2
isoxa: calls $2
*** TURN *** [4h Tc Qs] [6h]
UpNDownNS: bets $5.50
isoxa: calls $5.50
*** RIVER *** [4h Tc Qs 6h] [8c]
UpNDownNS: checks 
isoxa: checks 
*** SHOW DOWN ***
UpNDownNS: shows [Kh Ah] (high card Ace)
isoxa: shows [9c Qc] (a pair of Queens)
isoxa collected $17.81 from pot
*** SUMMARY ***
Total pot $18.75 | Rake $0.94 
Board [4h Tc Qs 6h 8c]
Seat 1: GastonLeFort folded before Flop (didn't bet)
Seat 2: UpNDownNS showed [Kh Ah] and lost with high card Ace
Seat 3: isoxa (button) showed [9c Qc] and won ($17.81) with a pair of Queens
Seat 4: christyirish (small blind) folded before Flop
Seat 5: jantheman222 (big blind) folded before Flop
Seat 6: maisit* folded before Flop (didn't bet)
Seat 8: SteigEin84 folded before Flop (didn't bet)



PokerStars Hand #228694749239:  Hold'em No Limit ($0.25/$0.50 USD) - 2021/07/30 20:58:18 ET
Table 'Aitne III' 9-max Seat #4 is the button
Seat 1: GastonLeFort ($90.04 in chips) 
Seat 2: UpNDownNS ($39.28 in chips) 
Seat 3: isoxa ($46.72 in chips) 
Seat 4: christyirish ($50 in chips) 
Seat 5: jantheman222 ($48.32 in chips) 
Seat 6: maisit* ($83.06 in chips) 
Seat 8: SteigEin84 ($33.18 in chips) 
jantheman222: posts small blind $0.25
maisit*: posts big blind $0.50
whitecillar3: sits out 
PleBeY95: sits out 
*** HOLE CARDS ***
SteigEin84: folds 
GastonLeFort: folds 
UpNDownNS: folds 
isoxa: folds 
christyirish: raises $1 to $1.50
jantheman222: folds 
maisit*: calls $1
*** FLOP *** [7d 7h 9h]
maisit*: checks 
christyirish: bets $1.55
maisit*: folds 
Uncalled bet ($1.55) returned to christyirish
christyirish collected $3.09 from pot
christyirish: doesn't show hand 
*** SUMMARY ***
Total pot $3.25 | Rake $0.16 
Board [7d 7h 9h]
Seat 1: GastonLeFort folded before Flop (didn't bet)
Seat 2: UpNDownNS folded before Flop (didn't bet)
Seat 3: isoxa folded before Flop (didn't bet)
Seat 4: christyirish (button) collected ($3.09)
Seat 5: jantheman222 (small blind) folded before Flop
Seat 6: maisit* (big blind) folded on the Flop
Seat 8: SteigEin84 folded before Flop (didn't bet)



PokerStars Hand #228694758130:  Hold'em No Limit ($0.25/$0.50 USD) - 2021/07/30 20:58:59 ET
Table 'Aitne III' 9-max Seat #5 is the button
Seat 1: GastonLeFort ($90.04 in chips) 
Seat 2: UpNDownNS ($50 in chips) 
Seat 3: isoxa ($46.72 in chips) 
Seat 4: christyirish ($51.59 in chips) 
Seat 5: jantheman222 ($48.07 in chips) 
Seat 6: maisit* ($81.56 in chips) 
Seat 7: whitecillar3 ($28 in chips) 
Seat 8: SteigEin84 ($33.18 in chips) 
maisit*: posts small blind $0.25
whitecillar3: posts big blind $0.50
PleBeY95: sits out 
*** HOLE CARDS ***
SteigEin84: raises $1 to $1.50
GastonLeFort: folds 
UpNDownNS: folds 
isoxa: calls $1.50
christyirish: folds 
jantheman222: folds 
maisit*: folds 
whitecillar3: folds 
*** FLOP *** [Tc 3h 4c]
SteigEin84: bets $1.50
isoxa: calls $1.50
*** TURN *** [Tc 3h 4c] [2h]
SteigEin84: bets $4
isoxa: calls $4
*** RIVER *** [Tc 3h 4c 2h] [9d]
SteigEin84: bets $7
isoxa: folds 
Uncalled bet ($7) returned to SteigEin84
SteigEin84 collected $13.83 from pot
SteigEin84: doesn't show hand 
*** SUMMARY ***
Total pot $14.75 | Rake $0.92 
Board [Tc 3h 4c 2h 9d]
Seat 1: GastonLeFort folded before Flop (didn't bet)
Seat 2: UpNDownNS folded before Flop (didn't bet)
Seat 3: isoxa folded on the River
Seat 4: christyirish folded before Flop (didn't bet)
Seat 5: jantheman222 (button) folded before Flop (didn't bet)
Seat 6: maisit* (small blind) folded before Flop
Seat 7: whitecillar3 (big blind) folded before Flop
Seat 8: SteigEin84 collected ($13.83)



PokerStars Hand #228694775923:  Hold'em No Limit ($0.25/$0.50 USD) - 2021/07/30 21:00:19 ET
Table 'Aitne III' 9-max Seat #6 is the button
Seat 1: GastonLeFort ($90.04 in chips) 
Seat 2: UpNDownNS ($50 in chips) 
Seat 3: isoxa ($39.72 in chips) 
Seat 4: christyirish ($51.59 in chips) 
Seat 5: jantheman222 ($48.07 in chips) 
Seat 6: maisit* ($81.31 in chips) 
Seat 7: whitecillar3 ($27.50 in chips) 
Seat 8: SteigEin84 ($40.01 in chips) 
whitecillar3: posts small blind $0.25
SteigEin84: posts big blind $0.50
PleBeY95: sits out 
*** HOLE CARDS ***
GastonLeFort: folds 
UpNDownNS: raises $1 to $1.50
isoxa: folds 
christyirish: folds 
jantheman222: folds 
maisit*: folds 
whitecillar3: folds 
SteigEin84: raises $2.50 to $4
UpNDownNS: calls $2.50
*** FLOP *** [2s Kc 2c]
SteigEin84: bets $6
UpNDownNS: folds 
Uncalled bet ($6) returned to SteigEin84
SteigEin84 collected $7.74 from pot
SteigEin84: doesn't show hand 
*** SUMMARY ***
Total pot $8.25 | Rake $0.51 
Board [2s Kc 2c]
Seat 1: GastonLeFort folded before Flop (didn't bet)
Seat 2: UpNDownNS folded on the Flop
Seat 3: isoxa folded before Flop (didn't bet)
Seat 4: christyirish folded before Flop (didn't bet)
Seat 5: jantheman222 folded before Flop (didn't bet)
Seat 6: maisit* (button) folded before Flop (didn't bet)
Seat 7: whitecillar3 (small blind) folded before Flop
Seat 8: SteigEin84 (big blind) collected ($7.74)



PokerStars Hand #228694787048:  Hold'em No Limit ($0.25/$0.50 USD) - 2021/07/30 21:01:05 ET
Table 'Aitne III' 9-max Seat #7 is the button
Seat 1: GastonLeFort ($90.04 in chips) 
Seat 2: UpNDownNS ($46 in chips) 
Seat 3: isoxa ($39.72 in chips) 
Seat 4: christyirish ($51.59 in chips) 
Seat 5: jantheman222 ($48.07 in chips) 
Seat 6: maisit* ($81.31 in chips) 
Seat 7: whitecillar3 ($27.25 in chips) 
Seat 8: SteigEin84 ($43.75 in chips) 
Seat 9: PleBeY95 ($50 in chips) 
SteigEin84: posts small blind $0.25
PleBeY95: posts big blind $0.50
*** HOLE CARDS ***
GastonLeFort: folds 
UpNDownNS: raises $1 to $1.50
isoxa: calls $1.50
christyirish: folds 
jantheman222: folds 
maisit*: folds 
whitecillar3: folds 
SteigEin84: calls $1.25
PleBeY95: folds 
*** FLOP *** [5c 2d 3d]
SteigEin84: checks 
UpNDownNS: bets $3
isoxa: folds 
SteigEin84: folds 
Uncalled bet ($3) returned to UpNDownNS
UpNDownNS collected $4.75 from pot
UpNDownNS: doesn't show hand 
*** SUMMARY ***
Total pot $5 | Rake $0.25 
Board [5c 2d 3d]
Seat 1: GastonLeFort folded before Flop (didn't bet)
Seat 2: UpNDownNS collected ($4.75)
Seat 3: isoxa folded on the Flop
Seat 4: christyirish folded before Flop (didn't bet)
Seat 5: jantheman222 folded before Flop (didn't bet)
Seat 6: maisit* folded before Flop (didn't bet)
Seat 7: whitecillar3 (button) folded before Flop (didn't bet)
Seat 8: SteigEin84 (small blind) folded on the Flop
Seat 9: PleBeY95 (big blind) folded before Flop



PokerStars Hand #228694794913:  Hold'em No Limit ($0.25/$0.50 USD) - 2021/07/30 21:01:36 ET
Table 'Aitne III' 9-max Seat #8 is the button
Seat 1: GastonLeFort ($90.04 in chips) 
Seat 2: UpNDownNS ($49.25 in chips) 
Seat 3: isoxa ($38.22 in chips) 
Seat 4: christyirish ($51.59 in chips) 
Seat 5: jantheman222 ($48.07 in chips) 
Seat 6: maisit* ($81.31 in chips) 
Seat 7: whitecillar3 ($27.25 in chips) 
Seat 8: SteigEin84 ($42.25 in chips) 
Seat 9: PleBeY95 ($50 in chips) 
PleBeY95: posts small blind $0.25
GastonLeFort: posts big blind $0.50
*** HOLE CARDS ***
UpNDownNS: folds 
isoxa: folds 
christyirish: raises $1 to $1.50
jantheman222: folds 
maisit*: raises $3 to $4.50
whitecillar3: folds 
SteigEin84: folds 
PleBeY95: folds 
GastonLeFort: folds 
christyirish: folds 
Uncalled bet ($3) returned to maisit*
maisit* collected $3.75 from pot
maisit*: doesn't show hand 
*** SUMMARY ***
Total pot $3.75 | Rake $0 
Seat 1: GastonLeFort (big blind) folded before Flop
Seat 2: UpNDownNS folded before Flop (didn't bet)
Seat 3: isoxa folded before Flop (didn't bet)
Seat 4: christyirish folded before Flop
Seat 5: jantheman222 folded before Flop (didn't bet)
Seat 6: maisit* collected ($3.75)
Seat 7: whitecillar3 folded before Flop (didn't bet)
Seat 8: SteigEin84 (button) folded before Flop (didn't bet)
Seat 9: PleBeY95 (small blind) folded before Flop



PokerStars Hand #228694800266:  Hold'em No Limit ($0.25/$0.50 USD) - 2021/07/30 21:01:57 ET
Table 'Aitne III' 9-max Seat #9 is the button
Seat 1: GastonLeFort ($89.54 in chips) 
Seat 2: UpNDownNS ($49.25 in chips) 
Seat 3: isoxa ($38.22 in chips) 
Seat 4: christyirish ($50.09 in chips) 
Seat 5: jantheman222 ($48.07 in chips) 
Seat 6: maisit* ($83.56 in chips) 
Seat 7: whitecillar3 ($27.25 in chips) 
Seat 8: SteigEin84 ($42.25 in chips) 
Seat 9: PleBeY95 ($50 in chips) 
GastonLeFort: posts small blind $0.25
UpNDownNS: posts big blind $0.50
*** HOLE CARDS ***
isoxa: folds 
christyirish: folds 
jantheman222: folds 
maisit*: folds 
whitecillar3: folds 
SteigEin84: calls $0.50
PleBeY95: folds 
GastonLeFort: calls $0.25
UpNDownNS: checks 
*** FLOP *** [Ks 2s Jd]
GastonLeFort: checks 
UpNDownNS: checks 
SteigEin84: bets $1
GastonLeFort: folds 
UpNDownNS: folds 
Uncalled bet ($1) returned to SteigEin84
SteigEin84 collected $1.40 from pot
SteigEin84: doesn't show hand 
*** SUMMARY ***
Total pot $1.50 | Rake $0.10 
Board [Ks 2s Jd]
Seat 1: GastonLeFort (small blind) folded on the Flop
Seat 2: UpNDownNS (big blind) folded on the Flop
Seat 3: isoxa folded before Flop (didn't bet)
Seat 4: christyirish folded before Flop (didn't bet)
Seat 5: jantheman222 folded before Flop (didn't bet)
Seat 6: maisit* folded before Flop (didn't bet)
Seat 7: whitecillar3 folded before Flop (didn't bet)
Seat 8: SteigEin84 collected ($1.40)
Seat 9: PleBeY95 (button) folded before Flop (didn't bet)



PokerStars Hand #228694812576:  Hold'em No Limit ($0.25/$0.50 USD) - 2021/07/30 21:02:44 ET
Table 'Aitne III' 9-max Seat #1 is the button
Seat 1: GastonLeFort ($89.04 in chips) 
Seat 2: UpNDownNS ($48.75 in chips) 
Seat 3: isoxa ($38.22 in chips) 
Seat 4: christyirish ($50.09 in chips) 
Seat 5: jantheman222 ($48.07 in chips) 
Seat 6: maisit* ($83.56 in chips) 
Seat 7: whitecillar3 ($27.25 in chips) 
Seat 8: SteigEin84 ($43.15 in chips) 
Seat 9: PleBeY95 ($50 in chips) 
UpNDownNS: posts small blind $0.25
isoxa: posts big blind $0.50
*** HOLE CARDS ***
christyirish: raises $1 to $1.50
jantheman222: folds 
maisit*: raises $3 to $4.50
whitecillar3: folds 
SteigEin84: folds 
PleBeY95: folds 
GastonLeFort: folds 
UpNDownNS: folds 
isoxa: folds 
christyirish: calls $3
*** FLOP *** [Qh 7d 3h]
christyirish: checks 
maisit*: bets $3.06
christyirish: calls $3.06
*** TURN *** [Qh 7d 3h] [Ks]
christyirish: checks 
maisit*: checks 
*** RIVER *** [Qh 7d 3h Ks] [4h]
christyirish: checks 
maisit*: checks 
*** SHOW DOWN ***
christyirish: shows [5d 5h] (a pair of Fives)
maisit*: shows [Td Ts] (a pair of Tens)
maisit* collected $15.08 from pot
*** SUMMARY ***
Total pot $15.87 | Rake $0.79 
Board [Qh 7d 3h Ks 4h]
Seat 1: GastonLeFort (button) folded before Flop (didn't bet)
Seat 2: UpNDownNS (small blind) folded before Flop
Seat 3: isoxa (big blind) folded before Flop
Seat 4: christyirish showed [5d 5h] and lost with a pair of Fives
Seat 5: jantheman222 folded before Flop (didn't bet)
Seat 6: maisit* showed [Td Ts] and won ($15.08) with a pair of Tens
Seat 7: whitecillar3 folded before Flop (didn't bet)
Seat 8: SteigEin84 folded before Flop (didn't bet)
Seat 9: PleBeY95 folded before Flop (didn't bet)



PokerStars Hand #228694825769:  Hold'em No Limit ($0.25/$0.50 USD) - 2021/07/30 21:03:34 ET
Table 'Aitne III' 9-max Seat #2 is the button
Seat 1: GastonLeFort ($89.04 in chips) 
Seat 2: UpNDownNS ($48.50 in chips) 
Seat 3: isoxa ($37.72 in chips) 
Seat 4: christyirish ($50 in chips) 
Seat 5: jantheman222 ($48.07 in chips) 
Seat 6: maisit* ($91.08 in chips) 
Seat 7: whitecillar3 ($27.25 in chips) 
Seat 8: SteigEin84 ($43.15 in chips) 
Seat 9: PleBeY95 ($50 in chips) 
isoxa: posts small blind $0.25
christyirish: posts big blind $0.50
*** HOLE CARDS ***
jantheman222 has timed out
jantheman222: folds 
maisit*: folds 
whitecillar3: folds 
SteigEin84: folds 
PleBeY95: folds 
GastonLeFort: folds 
UpNDownNS: folds 
isoxa: calls $0.25
christyirish: checks 
*** FLOP *** [3h 6s 7s]
isoxa: bets $1
christyirish: folds 
Uncalled bet ($1) returned to isoxa
isoxa collected $0.95 from pot
isoxa: doesn't show hand 
*** SUMMARY ***
Total pot $1 | Rake $0.05 
Board [3h 6s 7s]
Seat 1: GastonLeFort folded before Flop (didn't bet)
Seat 2: UpNDownNS (button) folded before Flop (didn't bet)
Seat 3: isoxa (small blind) collected ($0.95)
Seat 4: christyirish (big blind) folded on the Flop
Seat 5: jantheman222 folded before Flop (didn't bet)
Seat 6: maisit* folded before Flop (didn't bet)
Seat 7: whitecillar3 folded before Flop (didn't bet)
Seat 8: SteigEin84 folded before Flop (didn't bet)
Seat 9: PleBeY95 folded before Flop (didn't bet)



PokerStars Hand #228694835215:  Hold'em No Limit ($0.25/$0.50 USD) - 2021/07/30 21:04:10 ET
Table 'Aitne III' 9-max Seat #3 is the button
Seat 1: GastonLeFort ($89.04 in chips) 
Seat 2: UpNDownNS ($48.50 in chips) 
Seat 3: isoxa ($38.17 in chips) 
Seat 4: christyirish ($50 in chips) 
Seat 5: jantheman222 ($48.07 in chips) 
Seat 6: maisit* ($91.08 in chips) 
Seat 7: whitecillar3 ($27.25 in chips) 
Seat 8: SteigEin84 ($43.15 in chips) 
Seat 9: PleBeY95 ($50 in chips) 
christyirish: posts small blind $0.25
jantheman222: posts big blind $0.50
*** HOLE CARDS ***
maisit*: folds 
whitecillar3: folds 
SteigEin84: folds 
PleBeY95: folds 
GastonLeFort: folds 
UpNDownNS: folds 
isoxa: folds 
christyirish: calls $0.25
jantheman222: raises $1.75 to $2.25
christyirish: calls $1.75
*** FLOP *** [Qs 8h 7h]
christyirish: checks 
jantheman222: bets $2.50
christyirish: calls $2.50
*** TURN *** [Qs 8h 7h] [As]
christyirish: checks 
jantheman222: bets $3.50
christyirish: calls $3.50
*** RIVER *** [Qs 8h 7h As] [7c]
christyirish: checks 
jantheman222: bets $8.50
christyirish: folds 
Uncalled bet ($8.50) returned to jantheman222
jantheman222 collected $15.68 from pot
*** SUMMARY ***
Total pot $16.50 | Rake $0.82 
Board [Qs 8h 7h As 7c]
Seat 1: GastonLeFort folded before Flop (didn't bet)
Seat 2: UpNDownNS folded before Flop (didn't bet)
Seat 3: isoxa (button) folded before Flop (didn't bet)
Seat 4: christyirish (small blind) folded on the River
Seat 5: jantheman222 (big blind) collected ($15.68)
Seat 6: maisit* folded before Flop (didn't bet)
Seat 7: whitecillar3 folded before Flop (didn't bet)
Seat 8: SteigEin84 folded before Flop (didn't bet)
Seat 9: PleBeY95 folded before Flop (didn't bet)



PokerStars Hand #228694862550:  Hold'em No Limit ($0.25/$0.50 USD) - 2021/07/30 21:05:55 ET
Table 'Aitne III' 9-max Seat #4 is the button
Seat 1: GastonLeFort ($89.04 in chips) 
Seat 2: UpNDownNS ($48.50 in chips) 
Seat 3: isoxa ($38.17 in chips) 
Seat 4: christyirish ($50 in chips) 
Seat 5: jantheman222 ($55.50 in chips) 
Seat 6: maisit* ($91.08 in chips) 
Seat 7: whitecillar3 ($27.25 in chips) 
Seat 8: SteigEin84 ($43.15 in chips) 
Seat 9: PleBeY95 ($50 in chips) 
jantheman222: posts small blind $0.25
maisit*: posts big blind $0.50
*** HOLE CARDS ***
whitecillar3: folds 
SteigEin84: raises $1 to $1.50
PleBeY95: folds 
GastonLeFort: folds 
UpNDownNS: folds 
isoxa: folds 
christyirish: folds 
jantheman222: folds 
maisit*: folds 
Uncalled bet ($1) returned to SteigEin84
SteigEin84 collected $1.25 from pot
SteigEin84: doesn't show hand 
*** SUMMARY ***
Total pot $1.25 | Rake $0 
Seat 1: GastonLeFort folded before Flop (didn't bet)
Seat 2: UpNDownNS folded before Flop (didn't bet)
Seat 3: isoxa folded before Flop (didn't bet)
Seat 4: christyirish (button) folded before Flop (didn't bet)
Seat 5: jantheman222 (small blind) folded before Flop
Seat 6: maisit* (big blind) folded before Flop
Seat 7: whitecillar3 folded before Flop (didn't bet)
Seat 8: SteigEin84 collected ($1.25)
Seat 9: PleBeY95 folded before Flop (didn't bet)



PokerStars Hand #228694869325:  Hold'em No Limit ($0.25/$0.50 USD) - 2021/07/30 21:06:21 ET
Table 'Aitne III' 9-max Seat #5 is the button
Seat 1: GastonLeFort ($89.04 in chips) 
Seat 2: UpNDownNS ($48.50 in chips) 
Seat 3: isoxa ($38.17 in chips) 
Seat 4: christyirish ($50 in chips) 
Seat 5: jantheman222 ($55.25 in chips) 
Seat 6: maisit* ($90.58 in chips) 
Seat 7: whitecillar3 ($27.25 in chips) 
Seat 8: SteigEin84 ($43.90 in chips) 
Seat 9: PleBeY95 ($50 in chips) 
maisit*: posts small blind $0.25
whitecillar3: posts big blind $0.50
*** HOLE CARDS ***
SteigEin84: folds 
PleBeY95: raises $1 to $1.50
GastonLeFort: folds 
UpNDownNS: folds 
isoxa: calls $1.50
christyirish: calls $1.50
jantheman222: folds 
maisit*: folds 
whitecillar3: folds 
*** FLOP *** [6d 3h 3c]
PleBeY95: checks 
isoxa: checks 
christyirish: checks 
*** TURN *** [6d 3h 3c] [Ad]
PleBeY95: bets $3.74
isoxa: calls $3.74
christyirish: folds 
*** RIVER *** [6d 3h 3c Ad] [4h]
PleBeY95: checks 
isoxa: checks 
*** SHOW DOWN ***
PleBeY95: shows [7d 8d] (a pair of Threes)
isoxa: shows [2h Ah] (two pair, Aces and Threes)
isoxa collected $12.09 from pot
*** SUMMARY ***
Total pot $12.73 | Rake $0.64 
Board [6d 3h 3c Ad 4h]
Seat 1: GastonLeFort folded before Flop (didn't bet)
Seat 2: UpNDownNS folded before Flop (didn't bet)
Seat 3: isoxa showed [2h Ah] and won ($12.09) with two pair, Aces and Threes
Seat 4: christyirish folded on the Turn
Seat 5: jantheman222 (button) folded before Flop (didn't bet)
Seat 6: maisit* (small blind) folded before Flop
Seat 7: whitecillar3 (big blind) folded before Flop
Seat 8: SteigEin84 folded before Flop (didn't bet)
Seat 9: PleBeY95 showed [7d 8d] and lost with a pair of Threes



PokerStars Hand #228694880766:  Hold'em No Limit ($0.25/$0.50 USD) - 2021/07/30 21:07:05 ET
Table 'Aitne III' 9-max Seat #6 is the button
Seat 1: GastonLeFort ($89.04 in chips) 
Seat 2: UpNDownNS ($48.50 in chips) 
Seat 3: isoxa ($45.02 in chips) 
Seat 4: christyirish ($50 in chips) 
Seat 5: jantheman222 ($55.25 in chips) 
Seat 6: maisit* ($90.33 in chips) 
Seat 7: whitecillar3 ($26.75 in chips) 
Seat 9: PleBeY95 ($50 in chips) 
whitecillar3: posts small blind $0.25
SteigEin84 is disconnected 
SteigEin84 has timed out while disconnected
SteigEin84: is sitting out 
PleBeY95: posts big blind $0.50
*** HOLE CARDS ***
GastonLeFort: folds 
UpNDownNS: raises $1 to $1.50
isoxa: folds 
christyirish: raises $3.75 to $5.25
jantheman222: folds 
maisit*: folds 
whitecillar3: folds 
PleBeY95: folds 
UpNDownNS: folds 
Uncalled bet ($3.75) returned to christyirish
christyirish collected $3.75 from pot
christyirish: doesn't show hand 
*** SUMMARY ***
Total pot $3.75 | Rake $0 
Seat 1: GastonLeFort folded before Flop (didn't bet)
Seat 2: UpNDownNS folded before Flop
Seat 3: isoxa folded before Flop (didn't bet)
Seat 4: christyirish collected ($3.75)
Seat 5: jantheman222 folded before Flop (didn't bet)
Seat 6: maisit* (button) folded before Flop (didn't bet)
Seat 7: whitecillar3 (small blind) folded before Flop
Seat 9: PleBeY95 (big blind) folded before Flop



PokerStars Hand #228694890816:  Hold'em No Limit ($0.25/$0.50 USD) - 2021/07/30 21:07:43 ET
Table 'Aitne III' 9-max Seat #7 is the button
Seat 1: GastonLeFort ($89.04 in chips) 
Seat 2: UpNDownNS ($47 in chips) 
Seat 3: isoxa ($45.02 in chips) 
Seat 4: christyirish ($52.25 in chips) 
Seat 5: jantheman222 ($55.25 in chips) 
Seat 6: maisit* ($90.33 in chips) 
Seat 7: whitecillar3 ($26.50 in chips) 
Seat 9: PleBeY95 ($50 in chips) 
PleBeY95: posts small blind $0.25
GastonLeFort: posts big blind $0.50
*** HOLE CARDS ***
UpNDownNS: folds 
isoxa: calls $0.50
christyirish: folds 
jantheman222: folds 
maisit*: folds 
whitecillar3: calls $0.50
PleBeY95: folds 
GastonLeFort: checks 
*** FLOP *** [2c 6h Js]
GastonLeFort: checks 
isoxa: checks 
whitecillar3: checks 
*** TURN *** [2c 6h Js] [6s]
GastonLeFort: bets $0.50
isoxa: calls $0.50
whitecillar3: calls $0.50
*** RIVER *** [2c 6h Js 6s] [Jc]
GastonLeFort: bets $1.70
isoxa: folds 
whitecillar3: folds 
Uncalled bet ($1.70) returned to GastonLeFort
GastonLeFort collected $3.09 from pot
GastonLeFort: doesn't show hand 
*** SUMMARY ***
Total pot $3.25 | Rake $0.16 
Board [2c 6h Js 6s Jc]
Seat 1: GastonLeFort (big blind) collected ($3.09)
Seat 2: UpNDownNS folded before Flop (didn't bet)
Seat 3: isoxa folded on the River
Seat 4: christyirish folded before Flop (didn't bet)
Seat 5: jantheman222 folded before Flop (didn't bet)
Seat 6: maisit* folded before Flop (didn't bet)
Seat 7: whitecillar3 (button) folded on the River
Seat 9: PleBeY95 (small blind) folded before Flop



PokerStars Hand #228694912463:  Hold'em No Limit ($0.25/$0.50 USD) - 2021/07/30 21:09:07 ET
Table 'Aitne III' 9-max Seat #9 is the button
Seat 1: GastonLeFort ($91.13 in chips) 
Seat 2: UpNDownNS ($47 in chips) 
Seat 3: isoxa ($44.02 in chips) 
Seat 5: jantheman222 ($55.25 in chips) 
Seat 6: maisit* ($90.33 in chips) 
Seat 7: whitecillar3 ($25.50 in chips) 
Seat 8: SteigEin84 ($43.90 in chips) 
Seat 9: PleBeY95 ($50 in chips) 
GastonLeFort: posts small blind $0.25
UpNDownNS: posts big blind $0.50
SteigEin84: posts small & big blinds $0.75
*** HOLE CARDS ***
isoxa: folds 
jantheman222: folds 
maisit*: folds 
whitecillar3: folds 
SteigEin84: raises $1 to $1.50
PleBeY95: folds 
GastonLeFort: folds 
UpNDownNS: raises $4.50 to $6
SteigEin84: folds 
Uncalled bet ($4.50) returned to UpNDownNS
UpNDownNS collected $3.50 from pot
UpNDownNS: doesn't show hand 
*** SUMMARY ***
Total pot $3.50 | Rake $0 
Seat 1: GastonLeFort (small blind) folded before Flop
Seat 2: UpNDownNS (big blind) collected ($3.50)
Seat 3: isoxa folded before Flop (didn't bet)
Seat 5: jantheman222 folded before Flop (didn't bet)
Seat 6: maisit* folded before Flop (didn't bet)
Seat 7: whitecillar3 folded before Flop (didn't bet)
Seat 8: SteigEin84 folded before Flop
Seat 9: PleBeY95 (button) folded before Flop (didn't bet)



PokerStars Hand #228694921937:  Hold'em No Limit ($0.25/$0.50 USD) - 2021/07/30 21:09:44 ET
Table 'Aitne III' 9-max Seat #1 is the button
Seat 1: GastonLeFort ($90.88 in chips) 
Seat 2: UpNDownNS ($49 in chips) 
Seat 3: isoxa ($44.02 in chips) 
Seat 5: jantheman222 ($55.25 in chips) 
Seat 6: maisit* ($90.33 in chips) 
Seat 7: whitecillar3 ($25.50 in chips) 
Seat 8: SteigEin84 ($42.15 in chips) 
Seat 9: PleBeY95 ($50 in chips) 
UpNDownNS: posts small blind $0.25
isoxa: posts big blind $0.50
*** HOLE CARDS ***
jantheman222: folds 
maisit*: folds 
whitecillar3: folds 
SteigEin84: raises $1 to $1.50
PleBeY95: folds 
GastonLeFort: raises $3 to $4.50
UpNDownNS: folds 
isoxa: folds 
SteigEin84: calls $3
*** FLOP *** [5h 4s Ad]
SteigEin84: bets $7.13
GastonLeFort: folds 
Uncalled bet ($7.13) returned to SteigEin84
SteigEin84 collected $9.14 from pot
SteigEin84: doesn't show hand 
*** SUMMARY ***
Total pot $9.75 | Rake $0.61 
Board [5h 4s Ad]
Seat 1: GastonLeFort (button) folded on the Flop
Seat 2: UpNDownNS (small blind) folded before Flop
Seat 3: isoxa (big blind) folded before Flop
Seat 5: jantheman222 folded before Flop (didn't bet)
Seat 6: maisit* folded before Flop (didn't bet)
Seat 7: whitecillar3 folded before Flop (didn't bet)
Seat 8: SteigEin84 collected ($9.14)
Seat 9: PleBeY95 folded before Flop (didn't bet)



PokerStars Hand #228694934228:  Hold'em No Limit ($0.25/$0.50 USD) - 2021/07/30 21:10:32 ET
Table 'Aitne III' 9-max Seat #2 is the button
Seat 1: GastonLeFort ($86.38 in chips) 
Seat 2: UpNDownNS ($48.75 in chips) 
Seat 3: isoxa ($43.52 in chips) 
Seat 5: jantheman222 ($55.25 in chips) 
Seat 6: maisit* ($90.33 in chips) 
Seat 7: whitecillar3 ($25.50 in chips) 
Seat 8: SteigEin84 ($46.79 in chips) 
Seat 9: PleBeY95 ($50 in chips) 
isoxa: posts small blind $0.25
jantheman222: posts big blind $0.50
*** HOLE CARDS ***
maisit*: folds 
whitecillar3: folds 
SteigEin84: calls $0.50
PleBeY95: folds 
GastonLeFort: folds 
UpNDownNS: folds 
isoxa: calls $0.25
jantheman222: checks 
*** FLOP *** [Kc Js Qs]
isoxa: bets $0.50
jantheman222: calls $0.50
SteigEin84: calls $0.50
*** TURN *** [Kc Js Qs] [Jd]
isoxa: bets $1.42
jantheman222: folds 
SteigEin84: folds 
Uncalled bet ($1.42) returned to isoxa
isoxa collected $2.85 from pot
isoxa: doesn't show hand 
*** SUMMARY ***
Total pot $3 | Rake $0.15 
Board [Kc Js Qs Jd]
Seat 1: GastonLeFort folded before Flop (didn't bet)
Seat 2: UpNDownNS (button) folded before Flop (didn't bet)
Seat 3: isoxa (small blind) collected ($2.85)
Seat 5: jantheman222 (big blind) folded on the Turn
Seat 6: maisit* folded before Flop (didn't bet)
Seat 7: whitecillar3 folded before Flop (didn't bet)
Seat 8: SteigEin84 folded on the Turn
Seat 9: PleBeY95 folded before Flop (didn't bet)



PokerStars Hand #228694943929:  Hold'em No Limit ($0.25/$0.50 USD) - 2021/07/30 21:11:10 ET
Table 'Aitne III' 9-max Seat #3 is the button
Seat 1: GastonLeFort ($86.38 in chips) 
Seat 2: UpNDownNS ($48.75 in chips) 
Seat 3: isoxa ($45.37 in chips) 
Seat 5: jantheman222 ($54.25 in chips) 
Seat 6: maisit* ($90.33 in chips) 
Seat 7: whitecillar3 ($25.50 in chips) 
Seat 8: SteigEin84 ($45.79 in chips) 
Seat 9: PleBeY95 ($50 in chips) 
jantheman222: posts small blind $0.25
maisit*: posts big blind $0.50
*** HOLE CARDS ***
whitecillar3: folds 
SteigEin84: folds 
PleBeY95: folds 
GastonLeFort: raises $1 to $1.50
UpNDownNS: folds 
isoxa: calls $1.50
jantheman222: folds 
maisit*: folds 
*** FLOP *** [Qh Th 2h]
GastonLeFort: checks 
isoxa: bets $3.56
GastonLeFort: calls $3.56
*** TURN *** [Qh Th 2h] [7h]
GastonLeFort: checks 
isoxa: checks 
*** RIVER *** [Qh Th 2h 7h] [4h]
GastonLeFort: checks 
isoxa: checks 
*** SHOW DOWN ***
GastonLeFort: shows [Qs Jc] (a flush, Queen high)
isoxa: shows [6d Ad] (a flush, Queen high)
GastonLeFort collected $5.17 from pot
isoxa collected $5.16 from pot
*** SUMMARY ***
Total pot $10.87 | Rake $0.54 
Board [Qh Th 2h 7h 4h]
Seat 1: GastonLeFort showed [Qs Jc] and won ($5.17) with a flush, Queen high
Seat 2: UpNDownNS folded before Flop (didn't bet)
Seat 3: isoxa (button) showed [6d Ad] and won ($5.16) with a flush, Queen high
Seat 5: jantheman222 (small blind) folded before Flop
Seat 6: maisit* (big blind) folded before Flop
Seat 7: whitecillar3 folded before Flop (didn't bet)
Seat 8: SteigEin84 folded before Flop (didn't bet)
Seat 9: PleBeY95 folded before Flop (didn't bet)



PokerStars Hand #228694963295:  Hold'em No Limit ($0.25/$0.50 USD) - 2021/07/30 21:12:25 ET
Table 'Aitne III' 9-max Seat #5 is the button
Seat 1: GastonLeFort ($86.49 in chips) 
Seat 2: UpNDownNS ($48.75 in chips) 
Seat 3: isoxa ($45.47 in chips) 
Seat 5: jantheman222 ($54 in chips) 
Seat 6: maisit* ($89.83 in chips) 
Seat 7: whitecillar3 ($25.50 in chips) 
Seat 8: SteigEin84 ($45.79 in chips) 
Seat 9: PleBeY95 ($50 in chips) 
maisit*: posts small blind $0.25
whitecillar3: posts big blind $0.50
*** HOLE CARDS ***
SteigEin84: folds 
PleBeY95: folds 
GastonLeFort: folds 
UpNDownNS: folds 
isoxa: calls $0.50
jantheman222: folds 
maisit*: folds 
whitecillar3: checks 
*** FLOP *** [Ac Qd Td]
whitecillar3: checks 
isoxa: bets $0.50
whitecillar3: calls $0.50
*** TURN *** [Ac Qd Td] [9s]
whitecillar3: checks 
isoxa: checks 
*** RIVER *** [Ac Qd Td 9s] [7c]
whitecillar3: checks 
isoxa: bets $1.07
whitecillar3: folds 
Uncalled bet ($1.07) returned to isoxa
isoxa collected $2.14 from pot
isoxa: doesn't show hand 
*** SUMMARY ***
Total pot $2.25 | Rake $0.11 
Board [Ac Qd Td 9s 7c]
Seat 1: GastonLeFort folded before Flop (didn't bet)
Seat 2: UpNDownNS folded before Flop (didn't bet)
Seat 3: isoxa collected ($2.14)
Seat 5: jantheman222 (button) folded before Flop (didn't bet)
Seat 6: maisit* (small blind) folded before Flop
Seat 7: whitecillar3 (big blind) folded on the River
Seat 8: SteigEin84 folded before Flop (didn't bet)
Seat 9: PleBeY95 folded before Flop (didn't bet)



PokerStars Hand #228694980655:  Hold'em No Limit ($0.25/$0.50 USD) - 2021/07/30 21:13:18 ET
Table 'Aitne III' 9-max Seat #6 is the button
Seat 1: GastonLeFort ($86.49 in chips) 
Seat 2: UpNDownNS ($48.75 in chips) 
Seat 3: isoxa ($46.61 in chips) 
Seat 5: jantheman222 ($54 in chips) 
Seat 6: maisit* ($89.58 in chips) 
Seat 7: whitecillar3 ($24.50 in chips) 
Seat 8: SteigEin84 ($45.79 in chips) 
Seat 9: PleBeY95 ($50 in chips) 
whitecillar3: posts small blind $0.25
SteigEin84: posts big blind $0.50
*** HOLE CARDS ***
PleBeY95: folds 
GastonLeFort: folds 
UpNDownNS: folds 
isoxa: folds 
jantheman222: folds 
maisit*: raises $1 to $1.50
whitecillar3: folds 
SteigEin84: calls $1
*** FLOP *** [8c Kh 4s]
SteigEin84: checks 
maisit*: checks 
*** TURN *** [8c Kh 4s] [8s]
SteigEin84: checks 
maisit*: checks 
*** RIVER *** [8c Kh 4s 8s] [3s]
SteigEin84: checks 
maisit*: checks 
*** SHOW DOWN ***
SteigEin84: shows [Ts Jh] (a pair of Eights)
maisit*: shows [7h Qh] (a pair of Eights - King+Queen kicker)
maisit* collected $3.09 from pot
*** SUMMARY ***
Total pot $3.25 | Rake $0.16 
Board [8c Kh 4s 8s 3s]
Seat 1: GastonLeFort folded before Flop (didn't bet)
Seat 2: UpNDownNS folded before Flop (didn't bet)
Seat 3: isoxa folded before Flop (didn't bet)
Seat 5: jantheman222 folded before Flop (didn't bet)
Seat 6: maisit* (button) showed [7h Qh] and won ($3.09) with a pair of Eights
Seat 7: whitecillar3 (small blind) folded before Flop
Seat 8: SteigEin84 (big blind) showed [Ts Jh] and lost with a pair of Eights
Seat 9: PleBeY95 folded before Flop (didn't bet)



PokerStars Hand #228695000112:  Hold'em No Limit ($0.25/$0.50 USD) - 2021/07/30 21:14:07 ET
Table 'Aitne III' 9-max Seat #7 is the button
Seat 1: GastonLeFort ($86.49 in chips) 
Seat 2: UpNDownNS ($48.75 in chips) 
Seat 3: isoxa ($46.61 in chips) 
Seat 5: jantheman222 ($54 in chips) 
Seat 6: maisit* ($91.17 in chips) 
Seat 7: whitecillar3 ($24.25 in chips) 
Seat 8: SteigEin84 ($44.29 in chips) 
Seat 9: PleBeY95 ($50 in chips) 
SteigEin84: posts small blind $0.25
PleBeY95: posts big blind $0.50
*** HOLE CARDS ***
GastonLeFort: folds 
UpNDownNS: raises $1 to $1.50
isoxa: folds 
jantheman222: folds 
maisit*: folds 
whitecillar3: folds 
SteigEin84: calls $1.25
PleBeY95: folds 
*** FLOP *** [Td Kh Qc]
SteigEin84: checks 
UpNDownNS: bets $1
SteigEin84: calls $1
*** TURN *** [Td Kh Qc] [3d]
SteigEin84: checks 
UpNDownNS: checks 
*** RIVER *** [Td Kh Qc 3d] [8d]
SteigEin84: bets $2
UpNDownNS: folds 
Uncalled bet ($2) returned to SteigEin84
SteigEin84 collected $5.15 from pot
SteigEin84: doesn't show hand 
*** SUMMARY ***
Total pot $5.50 | Rake $0.35 
Board [Td Kh Qc 3d 8d]
Seat 1: GastonLeFort folded before Flop (didn't bet)
Seat 2: UpNDownNS folded on the River
Seat 3: isoxa folded before Flop (didn't bet)
Seat 5: jantheman222 folded before Flop (didn't bet)
Seat 6: maisit* folded before Flop (didn't bet)
Seat 7: whitecillar3 (button) folded before Flop (didn't bet)
Seat 8: SteigEin84 (small blind) collected ($5.15)
Seat 9: PleBeY95 (big blind) folded before Flop



PokerStars Hand #228695014201:  Hold'em No Limit ($0.25/$0.50 USD) - 2021/07/30 21:15:03 ET
Table 'Aitne III' 9-max Seat #8 is the button
Seat 1: GastonLeFort ($86.49 in chips) 
Seat 2: UpNDownNS ($46.25 in chips) 
Seat 3: isoxa ($46.61 in chips) 
Seat 5: jantheman222 ($54 in chips) 
Seat 6: maisit* ($91.17 in chips) 
Seat 7: whitecillar3 ($24.25 in chips) 
Seat 8: SteigEin84 ($46.94 in chips) 
Seat 9: PleBeY95 ($50 in chips) 
PleBeY95: posts small blind $0.25
GastonLeFort: posts big blind $0.50
*** HOLE CARDS ***
UpNDownNS: folds 
isoxa: calls $0.50
jantheman222: folds 
maisit*: folds 
whitecillar3: folds 
SteigEin84: folds 
PleBeY95: folds 
GastonLeFort: checks 
*** FLOP *** [4h 5s Js]
GastonLeFort: checks 
isoxa: checks 
*** TURN *** [4h 5s Js] [Qs]
GastonLeFort: bets $0.89
isoxa: folds 
Uncalled bet ($0.89) returned to GastonLeFort
GastonLeFort collected $1.19 from pot
GastonLeFort: doesn't show hand 
*** SUMMARY ***
Total pot $1.25 | Rake $0.06 
Board [4h 5s Js Qs]
Seat 1: GastonLeFort (big blind) collected ($1.19)
Seat 2: UpNDownNS folded before Flop (didn't bet)
Seat 3: isoxa folded on the Turn
Seat 5: jantheman222 folded before Flop (didn't bet)
Seat 6: maisit* folded before Flop (didn't bet)
Seat 7: whitecillar3 folded before Flop (didn't bet)
Seat 8: SteigEin84 (button) folded before Flop (didn't bet)
Seat 9: PleBeY95 (small blind) folded before Flop



PokerStars Hand #228695021690:  Hold'em No Limit ($0.25/$0.50 USD) - 2021/07/30 21:15:33 ET
Table 'Aitne III' 9-max Seat #9 is the button
Seat 1: GastonLeFort ($87.18 in chips) 
Seat 2: UpNDownNS ($46.25 in chips) 
Seat 3: isoxa ($46.11 in chips) 
Seat 5: jantheman222 ($54 in chips) 
Seat 6: maisit* ($91.17 in chips) 
Seat 7: whitecillar3 ($24.25 in chips) 
Seat 8: SteigEin84 ($46.94 in chips) 
Seat 9: PleBeY95 ($50 in chips) 
GastonLeFort: posts small blind $0.25
UpNDownNS: posts big blind $0.50
*** HOLE CARDS ***
isoxa: folds 
jantheman222: folds 
maisit*: folds 
whitecillar3: folds 
SteigEin84: raises $1 to $1.50
PleBeY95: raises $3 to $4.50
GastonLeFort: folds 
UpNDownNS: folds 
SteigEin84: calls $3
*** FLOP *** [Th Jh 9h]
SteigEin84: checks 
PleBeY95: bets $3.06
SteigEin84: calls $3.06
*** TURN *** [Th Jh 9h] [Ts]
SteigEin84: checks 
PleBeY95: checks 
*** RIVER *** [Th Jh 9h Ts] [Qc]
SteigEin84: bets $6.50
PleBeY95: calls $6.50
*** SHOW DOWN ***
SteigEin84: shows [8c Tc] (a straight, Eight to Queen)
PleBeY95: mucks hand 
SteigEin84 collected $27.07 from pot
*** SUMMARY ***
Total pot $28.87 | Rake $1.80 
Board [Th Jh 9h Ts Qc]
Seat 1: GastonLeFort (small blind) folded before Flop
Seat 2: UpNDownNS (big blind) folded before Flop
Seat 3: isoxa folded before Flop (didn't bet)
Seat 5: jantheman222 folded before Flop (didn't bet)
Seat 6: maisit* folded before Flop (didn't bet)
Seat 7: whitecillar3 folded before Flop (didn't bet)
Seat 8: SteigEin84 showed [8c Tc] and won ($27.07) with a straight, Eight to Queen
Seat 9: PleBeY95 (button) mucked



PokerStars Hand #228695041513:  Hold'em No Limit ($0.25/$0.50 USD) - 2021/07/30 21:16:51 ET
Table 'Aitne III' 9-max Seat #1 is the button
Seat 1: GastonLeFort ($86.93 in chips) 
Seat 2: UpNDownNS ($45.75 in chips) 
Seat 3: isoxa ($46.11 in chips) 
Seat 5: jantheman222 ($54 in chips) 
Seat 6: maisit* ($91.17 in chips) 
Seat 7: whitecillar3 ($24.25 in chips) 
Seat 8: SteigEin84 ($59.95 in chips) 
Seat 9: PleBeY95 ($50 in chips) 
UpNDownNS: posts small blind $0.25
isoxa: posts big blind $0.50
*** HOLE CARDS ***
jantheman222: raises $0.75 to $1.25
maisit*: folds 
whitecillar3: calls $1.25
SteigEin84: calls $1.25
PleBeY95: raises $5.75 to $7
GastonLeFort: folds 
UpNDownNS: folds 
isoxa: folds 
jantheman222: calls $5.75
whitecillar3: raises $17.25 to $24.25 and is all-in
SteigEin84: folds 
PleBeY95: raises $25.75 to $50 and is all-in
jantheman222: folds 
Uncalled bet ($25.75) returned to PleBeY95
*** FLOP *** [7h 2s Kh]
*** TURN *** [7h 2s Kh] [4h]
*** RIVER *** [7h 2s Kh 4h] [3d]
*** SHOW DOWN ***
whitecillar3: shows [Kc Kd] (three of a kind, Kings)
PleBeY95: shows [Qc Qh] (a pair of Queens)
whitecillar3 collected $55.50 from pot
*** SUMMARY ***
Total pot $57.50 | Rake $2 
Board [7h 2s Kh 4h 3d]
Seat 1: GastonLeFort (button) folded before Flop (didn't bet)
Seat 2: UpNDownNS (small blind) folded before Flop
Seat 3: isoxa (big blind) folded before Flop
Seat 5: jantheman222 folded before Flop
Seat 6: maisit* folded before Flop (didn't bet)
Seat 7: whitecillar3 showed [Kc Kd] and won ($55.50) with three of a kind, Kings
Seat 8: SteigEin84 folded before Flop
Seat 9: PleBeY95 showed [Qc Qh] and lost with a pair of Queens



PokerStars Hand #228695068122:  Hold'em No Limit ($0.25/$0.50 USD) - 2021/07/30 21:18:36 ET
Table 'Aitne III' 9-max Seat #2 is the button
Seat 1: GastonLeFort ($86.93 in chips) 
Seat 2: UpNDownNS ($45.50 in chips) 
Seat 3: isoxa ($45.61 in chips) 
Seat 4: christyirish ($52.25 in chips) 
Seat 5: jantheman222 ($47 in chips) 
Seat 6: maisit* ($91.17 in chips) 
Seat 7: whitecillar3 ($55.50 in chips) 
Seat 8: SteigEin84 ($58.70 in chips) 
Seat 9: PleBeY95 ($50 in chips) 
isoxa: posts small blind $0.25
christyirish: posts big blind $0.50
*** HOLE CARDS ***
jantheman222: folds 
maisit*: folds 
whitecillar3: folds 
SteigEin84: folds 
PleBeY95: folds 
GastonLeFort: raises $1 to $1.50
UpNDownNS: folds 
isoxa: folds 
christyirish: calls $1
*** FLOP *** [9h Qd 8d]
christyirish: checks 
GastonLeFort: bets $0.77
christyirish: calls $0.77
*** TURN *** [9h Qd 8d] [4h]
christyirish: checks 
GastonLeFort: bets $3.41
christyirish: folds 
Uncalled bet ($3.41) returned to GastonLeFort
GastonLeFort collected $4.55 from pot
GastonLeFort: doesn't show hand 
*** SUMMARY ***
Total pot $4.79 | Rake $0.24 
Board [9h Qd 8d 4h]
Seat 1: GastonLeFort collected ($4.55)
Seat 2: UpNDownNS (button) folded before Flop (didn't bet)
Seat 3: isoxa (small blind) folded before Flop
Seat 4: christyirish (big blind) folded on the Turn
Seat 5: jantheman222 folded before Flop (didn't bet)
Seat 6: maisit* folded before Flop (didn't bet)
Seat 7: whitecillar3 folded before Flop (didn't bet)
Seat 8: SteigEin84 folded before Flop (didn't bet)
Seat 9: PleBeY95 folded before Flop (didn't bet)



PokerStars Hand #228695079377:  Hold'em No Limit ($0.25/$0.50 USD) - 2021/07/30 21:19:20 ET
Table 'Aitne III' 9-max Seat #3 is the button
Seat 1: GastonLeFort ($89.21 in chips) 
Seat 2: UpNDownNS ($45.50 in chips) 
Seat 3: isoxa ($45.36 in chips) 
Seat 4: christyirish ($50 in chips) 
Seat 5: jantheman222 ($47 in chips) 
Seat 6: maisit* ($91.17 in chips) 
Seat 7: whitecillar3 ($55.50 in chips) 
Seat 8: SteigEin84 ($58.70 in chips) 
Seat 9: PleBeY95 ($50 in chips) 
christyirish: posts small blind $0.25
jantheman222: posts big blind $0.50
*** HOLE CARDS ***
maisit*: raises $1 to $1.50
whitecillar3: folds 
SteigEin84: folds 
PleBeY95: folds 
GastonLeFort: folds 
UpNDownNS: folds 
isoxa has timed out
isoxa: folds 
christyirish: raises $3.50 to $5
jantheman222: folds 
maisit*: calls $3.50
*** FLOP *** [Tc Jc 2h]
christyirish: bets $2.99
maisit*: calls $2.99
*** TURN *** [Tc Jc 2h] [5d]
christyirish: bets $7.83
isoxa leaves the table
maisit*: calls $7.83
*** RIVER *** [Tc Jc 2h 5d] [As]
christyirish: checks 
maisit*: bets $14.50
christyirish: calls $14.50
*** SHOW DOWN ***
maisit*: shows [Qh Kh] (a straight, Ten to Ace)
christyirish: mucks hand 
maisit* collected $59.14 from pot
*** SUMMARY ***
Total pot $61.14 | Rake $2 
Board [Tc Jc 2h 5d As]
Seat 1: GastonLeFort folded before Flop (didn't bet)
Seat 2: UpNDownNS folded before Flop (didn't bet)
Seat 3: isoxa (button) folded before Flop (didn't bet)
Seat 4: christyirish (small blind) mucked
Seat 5: jantheman222 (big blind) folded before Flop
Seat 6: maisit* showed [Qh Kh] and won ($59.14) with a straight, Ten to Ace
Seat 7: whitecillar3 folded before Flop (didn't bet)
Seat 8: SteigEin84 folded before Flop (didn't bet)
Seat 9: PleBeY95 folded before Flop (didn't bet)



PokerStars Hand #228695102094:  Hold'em No Limit ($0.25/$0.50 USD) - 2021/07/30 21:20:51 ET
Table 'Aitne III' 9-max Seat #4 is the button
Seat 1: GastonLeFort ($89.21 in chips) 
Seat 2: UpNDownNS ($45.50 in chips) 
Seat 4: christyirish ($50 in chips) 
Seat 5: jantheman222 ($46.50 in chips) 
Seat 6: maisit* ($119.99 in chips) 
Seat 7: whitecillar3 ($55.50 in chips) 
Seat 8: SteigEin84 ($58.70 in chips) 
Seat 9: PleBeY95 ($50 in chips) 
jantheman222: posts small blind $0.25
maisit*: posts big blind $0.50
*** HOLE CARDS ***
whitecillar3: folds 
SteigEin84: calls $0.50
PleBeY95: folds 
GastonLeFort: folds 
UpNDownNS: folds 
christyirish: folds 
jantheman222: calls $0.25
maisit*: checks 
*** FLOP *** [Jd 4d 4s]
jantheman222: checks 
maisit*: checks 
SteigEin84: bets $1
jantheman222: folds 
maisit*: folds 
Uncalled bet ($1) returned to SteigEin84
SteigEin84 collected $1.40 from pot
SteigEin84: doesn't show hand 
*** SUMMARY ***
Total pot $1.50 | Rake $0.10 
Board [Jd 4d 4s]
Seat 1: GastonLeFort folded before Flop (didn't bet)
Seat 2: UpNDownNS folded before Flop (didn't bet)
Seat 4: christyirish (button) folded before Flop (didn't bet)
Seat 5: jantheman222 (small blind) folded on the Flop
Seat 6: maisit* (big blind) folded on the Flop
Seat 7: whitecillar3 folded before Flop (didn't bet)
Seat 8: SteigEin84 collected ($1.40)
Seat 9: PleBeY95 folded before Flop (didn't bet)



PokerStars Hand #228695117531:  Hold'em No Limit ($0.25/$0.50 USD) - 2021/07/30 21:21:27 ET
Table 'Aitne III' 9-max Seat #5 is the button
Seat 1: GastonLeFort ($89.21 in chips) 
Seat 2: UpNDownNS ($45.50 in chips) 
Seat 4: christyirish ($50 in chips) 
Seat 5: jantheman222 ($46 in chips) 
Seat 6: maisit* ($119.49 in chips) 
Seat 7: whitecillar3 ($55.50 in chips) 
Seat 8: SteigEin84 ($59.60 in chips) 
Seat 9: PleBeY95 ($50 in chips) 
maisit*: posts small blind $0.25
whitecillar3: posts big blind $0.50
*** HOLE CARDS ***
SteigEin84: folds 
PleBeY95: folds 
GastonLeFort: folds 
UpNDownNS: folds 
christyirish: folds 
jantheman222: raises $0.75 to $1.25
maisit*: folds 
whitecillar3: folds 
Uncalled bet ($0.75) returned to jantheman222
jantheman222 collected $1.25 from pot
*** SUMMARY ***
Total pot $1.25 | Rake $0 
Seat 1: GastonLeFort folded before Flop (didn't bet)
Seat 2: UpNDownNS folded before Flop (didn't bet)
Seat 4: christyirish folded before Flop (didn't bet)
Seat 5: jantheman222 (button) collected ($1.25)
Seat 6: maisit* (small blind) folded before Flop
Seat 7: whitecillar3 (big blind) folded before Flop
Seat 8: SteigEin84 folded before Flop (didn't bet)
Seat 9: PleBeY95 folded before Flop (didn't bet)



PokerStars Hand #228695122741:  Hold'em No Limit ($0.25/$0.50 USD) - 2021/07/30 21:21:48 ET
Table 'Aitne III' 9-max Seat #6 is the button
Seat 1: GastonLeFort ($89.21 in chips) 
Seat 2: UpNDownNS ($45.50 in chips) 
Seat 4: christyirish ($50 in chips) 
Seat 5: jantheman222 ($46.75 in chips) 
Seat 6: maisit* ($119.24 in chips) 
Seat 7: whitecillar3 ($55 in chips) 
Seat 8: SteigEin84 ($59.60 in chips) 
Seat 9: PleBeY95 ($50 in chips) 
whitecillar3: posts small blind $0.25
SteigEin84: posts big blind $0.50
*** HOLE CARDS ***
PleBeY95: raises $1 to $1.50
GastonLeFort: folds 
UpNDownNS: calls $1.50
christyirish: folds 
jantheman222: folds 
maisit*: folds 
whitecillar3: folds 
SteigEin84: calls $1
*** FLOP *** [As 8s Qc]
SteigEin84: checks 
PleBeY95: checks 
UpNDownNS: checks 
*** TURN *** [As 8s Qc] [4h]
SteigEin84: checks 
PleBeY95: bets $3.38
UpNDownNS: calls $3.38
SteigEin84: folds 
*** RIVER *** [As 8s Qc 4h] [6h]
PleBeY95: bets $9.29
UpNDownNS: raises $10.71 to $20
PleBeY95: calls $10.71
*** SHOW DOWN ***
UpNDownNS: shows [4d 4c] (three of a kind, Fours)
PleBeY95: shows [8h 8d] (three of a kind, Eights)
PleBeY95 collected $49.51 from pot
*** SUMMARY ***
Total pot $51.51 | Rake $2 
Board [As 8s Qc 4h 6h]
Seat 1: GastonLeFort folded before Flop (didn't bet)
Seat 2: UpNDownNS showed [4d 4c] and lost with three of a kind, Fours
Seat 4: christyirish folded before Flop (didn't bet)
Seat 5: jantheman222 folded before Flop (didn't bet)
Seat 6: maisit* (button) folded before Flop (didn't bet)
Seat 7: whitecillar3 (small blind) folded before Flop
Seat 8: SteigEin84 (big blind) folded on the Turn
Seat 9: PleBeY95 showed [8h 8d] and won ($49.51) with three of a kind, Eights



PokerStars Hand #228695141809:  Hold'em No Limit ($0.25/$0.50 USD) - 2021/07/30 21:23:04 ET
Table 'Aitne III' 9-max Seat #7 is the button
Seat 1: GastonLeFort ($89.21 in chips) 
Seat 2: UpNDownNS ($20.62 in chips) 
Seat 4: christyirish ($50 in chips) 
Seat 5: jantheman222 ($46.75 in chips) 
Seat 6: maisit* ($119.24 in chips) 
Seat 7: whitecillar3 ($54.75 in chips) 
Seat 8: SteigEin84 ($58.10 in chips) 
SteigEin84: posts small blind $0.25
PleBeY95: is sitting out 
PleBeY95 leaves the table
GastonLeFort: posts big blind $0.50
*** HOLE CARDS ***
UpNDownNS: folds 
christyirish: folds 
jantheman222: folds 
maisit*: folds 
whitecillar3: folds 
SteigEin84: raises $0.50 to $1
GastonLeFort: calls $0.50
*** FLOP *** [5s 6s 4h]
SteigEin84: checks 
GastonLeFort: bets $0.50
SteigEin84: raises $0.50 to $1
GastonLeFort: calls $0.50
*** TURN *** [5s 6s 4h] [Qc]
SteigEin84: bets $2
GastonLeFort: calls $2
*** RIVER *** [5s 6s 4h Qc] [Kd]
SteigEin84: bets $4
GastonLeFort: folds 
Uncalled bet ($4) returned to SteigEin84
SteigEin84 collected $7.50 from pot
SteigEin84: doesn't show hand 
*** SUMMARY ***
Total pot $8 | Rake $0.50 
Board [5s 6s 4h Qc Kd]
Seat 1: GastonLeFort (big blind) folded on the River
Seat 2: UpNDownNS folded before Flop (didn't bet)
Seat 4: christyirish folded before Flop (didn't bet)
Seat 5: jantheman222 folded before Flop (didn't bet)
Seat 6: maisit* folded before Flop (didn't bet)
Seat 7: whitecillar3 (button) folded before Flop (didn't bet)
Seat 8: SteigEin84 (small blind) collected ($7.50)



PokerStars Hand #228695163885:  Hold'em No Limit ($0.25/$0.50 USD) - 2021/07/30 21:24:32 ET
Table 'Aitne III' 9-max Seat #8 is the button
Seat 1: GastonLeFort ($85.21 in chips) 
Seat 2: UpNDownNS ($50 in chips) 
Seat 4: christyirish ($50 in chips) 
Seat 5: jantheman222 ($46.75 in chips) 
Seat 6: maisit* ($119.24 in chips) 
Seat 7: whitecillar3 ($54.75 in chips) 
Seat 8: SteigEin84 ($61.60 in chips) 
GastonLeFort: posts small blind $0.25
UpNDownNS: posts big blind $0.50
*** HOLE CARDS ***
christyirish: folds 
jantheman222: folds 
maisit*: folds 
whitecillar3: folds 
SteigEin84: folds 
GastonLeFort: raises $1 to $1.50
UpNDownNS: folds 
Uncalled bet ($1) returned to GastonLeFort
GastonLeFort collected $1 from pot
GastonLeFort: doesn't show hand 
*** SUMMARY ***
Total pot $1 | Rake $0 
Seat 1: GastonLeFort (small blind) collected ($1)
Seat 2: UpNDownNS (big blind) folded before Flop
Seat 4: christyirish folded before Flop (didn't bet)
Seat 5: jantheman222 folded before Flop (didn't bet)
Seat 6: maisit* folded before Flop (didn't bet)
Seat 7: whitecillar3 folded before Flop (didn't bet)
Seat 8: SteigEin84 (button) folded before Flop (didn't bet)



PokerStars Hand #228695167969:  Hold'em No Limit ($0.25/$0.50 USD) - 2021/07/30 21:24:48 ET
Table 'Aitne III' 9-max Seat #1 is the button
Seat 1: GastonLeFort ($85.71 in chips) 
Seat 2: UpNDownNS ($49.50 in chips) 
Seat 4: christyirish ($50 in chips) 
Seat 5: jantheman222 ($46.75 in chips) 
Seat 6: maisit* ($119.24 in chips) 
Seat 7: whitecillar3 ($54.75 in chips) 
Seat 8: SteigEin84 ($61.60 in chips) 
UpNDownNS: posts small blind $0.25
christyirish: posts big blind $0.50
*** HOLE CARDS ***
Dragonclawss joins the table at seat #3 
jantheman222 has timed out
jantheman222: folds 
maisit*: folds 
whitecillar3: folds 
SteigEin84: folds 
GastonLeFort: folds 
UpNDownNS: calls $0.25
christyirish: raises $1 to $1.50
UpNDownNS: folds 
Uncalled bet ($1) returned to christyirish
christyirish collected $1 from pot
*** SUMMARY ***
Total pot $1 | Rake $0 
Seat 1: GastonLeFort (button) folded before Flop (didn't bet)
Seat 2: UpNDownNS (small blind) folded before Flop
Seat 4: christyirish (big blind) collected ($1)
Seat 5: jantheman222 folded before Flop (didn't bet)
Seat 6: maisit* folded before Flop (didn't bet)
Seat 7: whitecillar3 folded before Flop (didn't bet)
Seat 8: SteigEin84 folded before Flop (didn't bet)



PokerStars Hand #228695175645:  Hold'em No Limit ($0.25/$0.50 USD) - 2021/07/30 21:25:19 ET
Table 'Aitne III' 9-max Seat #2 is the button
Seat 1: GastonLeFort ($85.71 in chips) 
Seat 2: UpNDownNS ($49 in chips) 
Seat 4: christyirish ($50.50 in chips) 
Seat 5: jantheman222 ($46.75 in chips) 
Seat 6: maisit* ($119.24 in chips) 
Seat 7: whitecillar3 ($54.75 in chips) 
Seat 8: SteigEin84 ($61.60 in chips) 
christyirish: posts small blind $0.25
jantheman222: posts big blind $0.50
*** HOLE CARDS ***
maisit*: folds 
whitecillar3: folds 
SteigEin84: folds 
GastonLeFort: folds 
UpNDownNS: raises $1 to $1.50
christyirish: raises $3.50 to $5
jantheman222: folds 
UpNDownNS: folds 
Uncalled bet ($3.50) returned to christyirish
christyirish collected $3.50 from pot
*** SUMMARY ***
Total pot $3.50 | Rake $0 
Seat 1: GastonLeFort folded before Flop (didn't bet)
Seat 2: UpNDownNS (button) folded before Flop
Seat 4: christyirish (small blind) collected ($3.50)
Seat 5: jantheman222 (big blind) folded before Flop
Seat 6: maisit* folded before Flop (didn't bet)
Seat 7: whitecillar3 folded before Flop (didn't bet)
Seat 8: SteigEin84 folded before Flop (didn't bet)



PokerStars Hand #228695181009:  Hold'em No Limit ($0.25/$0.50 USD) - 2021/07/30 21:25:40 ET
Table 'Aitne III' 9-max Seat #4 is the button
Seat 1: GastonLeFort ($85.71 in chips) 
Seat 2: UpNDownNS ($47.50 in chips) 
Seat 4: christyirish ($52.50 in chips) 
Seat 5: jantheman222 ($46.25 in chips) 
Seat 6: maisit* ($119.24 in chips) 
Seat 7: whitecillar3 ($54.75 in chips) 
Seat 8: SteigEin84 ($61.60 in chips) 
jantheman222: posts small blind $0.25
maisit*: posts big blind $0.50
Dragonclawss: sits out 
*** HOLE CARDS ***
whitecillar3: folds 
SteigEin84: folds 
GastonLeFort: folds 
UpNDownNS: folds 
christyirish: raises $1 to $1.50
jantheman222: folds 
maisit*: folds 
Uncalled bet ($1) returned to christyirish
christyirish collected $1.25 from pot
*** SUMMARY ***
Total pot $1.25 | Rake $0 
Seat 1: GastonLeFort folded before Flop (didn't bet)
Seat 2: UpNDownNS folded before Flop (didn't bet)
Seat 4: christyirish (button) collected ($1.25)
Seat 5: jantheman222 (small blind) folded before Flop
Seat 6: maisit* (big blind) folded before Flop
Seat 7: whitecillar3 folded before Flop (didn't bet)
Seat 8: SteigEin84 folded before Flop (didn't bet)



PokerStars Hand #228695185336:  Hold'em No Limit ($0.25/$0.50 USD) - 2021/07/30 21:25:58 ET
Table 'Aitne III' 9-max Seat #5 is the button
Seat 1: GastonLeFort ($85.71 in chips) 
Seat 2: UpNDownNS ($47.50 in chips) 
Seat 4: christyirish ($53.25 in chips) 
Seat 5: jantheman222 ($46 in chips) 
Seat 6: maisit* ($118.74 in chips) 
Seat 7: whitecillar3 ($54.75 in chips) 
Seat 8: SteigEin84 ($61.60 in chips) 
maisit*: posts small blind $0.25
whitecillar3: posts big blind $0.50
Dragonclawss: sits out 
*** HOLE CARDS ***
SteigEin84: raises $0.50 to $1
GastonLeFort: folds 
UpNDownNS: folds 
christyirish: folds 
jantheman222: calls $1
maisit*: raises $4 to $5
whitecillar3: folds 
SteigEin84: folds 
jantheman222: raises $9 to $14
Lago Madjore joins the table at seat #9 
maisit*: folds 
Uncalled bet ($9) returned to jantheman222
jantheman222 collected $11.50 from pot
jantheman222: doesn't show hand 
*** SUMMARY ***
Total pot $11.50 | Rake $0 
Seat 1: GastonLeFort folded before Flop (didn't bet)
Seat 2: UpNDownNS folded before Flop (didn't bet)
Seat 4: christyirish folded before Flop (didn't bet)
Seat 5: jantheman222 (button) collected ($11.50)
Seat 6: maisit* (small blind) folded before Flop
Seat 7: whitecillar3 (big blind) folded before Flop
Seat 8: SteigEin84 folded before Flop



PokerStars Hand #228695207684:  Hold'em No Limit ($0.25/$0.50 USD) - 2021/07/30 21:27:29 ET
Table 'Aitne III' 9-max Seat #6 is the button
Seat 1: GastonLeFort ($85.71 in chips) 
Seat 2: UpNDownNS ($47.50 in chips) 
Seat 4: christyirish ($53.25 in chips) 
Seat 5: jantheman222 ($52.50 in chips) 
Seat 6: maisit* ($113.74 in chips) 
Seat 7: whitecillar3 ($54.25 in chips) 
Seat 8: SteigEin84 ($60.60 in chips) 
whitecillar3: posts small blind $0.25
SteigEin84: posts big blind $0.50
Lago Madjore: sits out 
*** HOLE CARDS ***
GastonLeFort: folds 
UpNDownNS: folds 
christyirish: raises $1 to $1.50
jantheman222: folds 
maisit*: folds 
whitecillar3: folds 
SteigEin84: calls $1
*** FLOP *** [8d Kd 8s]
Dragonclawss leaves the table
SteigEin84: checks 
christyirish: bets $0.93
SteigEin84: calls $0.93
*** TURN *** [8d Kd 8s] [3c]
SteigEin84: checks 
christyirish: checks 
*** RIVER *** [8d Kd 8s 3c] [8c]
SteigEin84: bets $1.50
christyirish: calls $1.50
*** SHOW DOWN ***
SteigEin84: shows [3h Ah] (a full house, Eights full of Threes)
christyirish: shows [6d 6c] (a full house, Eights full of Sixes)
christyirish collected $7.70 from pot
*** SUMMARY ***
Total pot $8.11 | Rake $0.41 
Board [8d Kd 8s 3c 8c]
Seat 1: GastonLeFort folded before Flop (didn't bet)
Seat 2: UpNDownNS folded before Flop (didn't bet)
Seat 4: christyirish showed [6d 6c] and won ($7.70) with a full house, Eights full of Sixes
Seat 5: jantheman222 folded before Flop (didn't bet)
Seat 6: maisit* (button) folded before Flop (didn't bet)
Seat 7: whitecillar3 (small blind) folded before Flop
Seat 8: SteigEin84 (big blind) showed [3h Ah] and lost with a full house, Eights full of Threes



PokerStars Hand #228695216613:  Hold'em No Limit ($0.25/$0.50 USD) - 2021/07/30 21:28:05 ET
Table 'Aitne III' 9-max Seat #7 is the button
Seat 1: GastonLeFort ($85.71 in chips) 
Seat 2: UpNDownNS ($47.50 in chips) 
Seat 4: christyirish ($57.02 in chips) 
Seat 5: jantheman222 ($52.50 in chips) 
Seat 6: maisit* ($113.74 in chips) 
Seat 7: whitecillar3 ($54 in chips) 
Seat 8: SteigEin84 ($56.67 in chips) 
Seat 9: Lago Madjore ($50 in chips) 
SteigEin84: posts small blind $0.25
Lago Madjore: posts big blind $0.50
*** HOLE CARDS ***
GastonLeFort: folds 
UpNDownNS: folds 
christyirish: folds 
jantheman222: folds 
maisit*: raises $1 to $1.50
whitecillar3: folds 
SteigEin84: calls $1.25
Lago Madjore: folds 
*** FLOP *** [8s 8c Ad]
SteigEin84: checks 
maisit*: bets $1
SteigEin84: calls $1
*** TURN *** [8s 8c Ad] [Jh]
SteigEin84: checks 
maisit*: checks 
*** RIVER *** [8s 8c Ad Jh] [9h]
SteigEin84: bets $3
maisit*: folds 
Uncalled bet ($3) returned to SteigEin84
SteigEin84 collected $5.15 from pot
SteigEin84: doesn't show hand 
*** SUMMARY ***
Total pot $5.50 | Rake $0.35 
Board [8s 8c Ad Jh 9h]
Seat 1: GastonLeFort folded before Flop (didn't bet)
Seat 2: UpNDownNS folded before Flop (didn't bet)
Seat 4: christyirish folded before Flop (didn't bet)
Seat 5: jantheman222 folded before Flop (didn't bet)
Seat 6: maisit* folded on the River
Seat 7: whitecillar3 (button) folded before Flop (didn't bet)
Seat 8: SteigEin84 (small blind) collected ($5.15)
Seat 9: Lago Madjore (big blind) folded before Flop



PokerStars Hand #228695242078:  Hold'em No Limit ($0.25/$0.50 USD) - 2021/07/30 21:29:10 ET
Table 'Aitne III' 9-max Seat #8 is the button
Seat 2: UpNDownNS ($47.50 in chips) 
Seat 4: christyirish ($57.02 in chips) 
Seat 5: jantheman222 ($52.50 in chips) 
Seat 6: maisit* ($111.24 in chips) 
Seat 7: whitecillar3 ($54 in chips) 
Seat 8: SteigEin84 ($59.32 in chips) 
Seat 9: Lago Madjore ($50 in chips) 
Lago Madjore: posts small blind $0.25
GastonLeFort: is sitting out 
UpNDownNS: posts big blind $0.50
*** HOLE CARDS ***
GastonLeFort leaves the table
christyirish: folds 
jantheman222: folds 
maisit*: folds 
whitecillar3: folds 
SteigEin84: calls $0.50
Lago Madjore: calls $0.25
UpNDownNS: checks 
*** FLOP *** [Qs Jd 3s]
Lago Madjore: checks 
UpNDownNS: checks 
SteigEin84: checks 
*** TURN *** [Qs Jd 3s] [5s]
Lago Madjore: checks 
UpNDownNS: checks 
SteigEin84: bets $1
Lago Madjore: folds 
bellisimo212 joins the table at seat #3 
UpNDownNS: folds 
Uncalled bet ($1) returned to SteigEin84
SteigEin84 collected $1.40 from pot
SteigEin84: doesn't show hand 
*** SUMMARY ***
Total pot $1.50 | Rake $0.10 
Board [Qs Jd 3s 5s]
Seat 2: UpNDownNS (big blind) folded on the Turn
Seat 4: christyirish folded before Flop (didn't bet)
Seat 5: jantheman222 folded before Flop (didn't bet)
Seat 6: maisit* folded before Flop (didn't bet)
Seat 7: whitecillar3 folded before Flop (didn't bet)
Seat 8: SteigEin84 (button) collected ($1.40)
Seat 9: Lago Madjore (small blind) folded on the Turn



PokerStars Hand #228695251698:  Hold'em No Limit ($0.25/$0.50 USD) - 2021/07/30 21:29:49 ET
Table 'Aitne III' 9-max Seat #9 is the button
Seat 2: UpNDownNS ($47 in chips) 
Seat 3: bellisimo212 ($50 in chips) 
Seat 4: christyirish ($57.02 in chips) 
Seat 5: jantheman222 ($52.50 in chips) 
Seat 6: maisit* ($111.24 in chips) 
Seat 7: whitecillar3 ($54 in chips) 
Seat 8: SteigEin84 ($60.22 in chips) 
Seat 9: Lago Madjore ($50 in chips) 
UpNDownNS: posts small blind $0.25
bellisimo212: posts big blind $0.50
*** HOLE CARDS ***
christyirish: folds 
i$BamboBlady$i joins the table at seat #1 
jantheman222: folds 
maisit*: folds 
whitecillar3: folds 
SteigEin84: raises $1 to $1.50
Lago Madjore: folds 
UpNDownNS: folds 
bellisimo212: folds 
Uncalled bet ($1) returned to SteigEin84
SteigEin84 collected $1.25 from pot
SteigEin84: doesn't show hand 
*** SUMMARY ***
Total pot $1.25 | Rake $0 
Seat 2: UpNDownNS (small blind) folded before Flop
Seat 3: bellisimo212 (big blind) folded before Flop
Seat 4: christyirish folded before Flop (didn't bet)
Seat 5: jantheman222 folded before Flop (didn't bet)
Seat 6: maisit* folded before Flop (didn't bet)
Seat 7: whitecillar3 folded before Flop (didn't bet)
Seat 8: SteigEin84 collected ($1.25)
Seat 9: Lago Madjore (button) folded before Flop (didn't bet)



PokerStars Hand #228695260866:  Hold'em No Limit ($0.25/$0.50 USD) - 2021/07/30 21:30:27 ET
Table 'Aitne III' 9-max Seat #2 is the button
Seat 1: i$BamboBlady$i ($27.67 in chips) 
Seat 2: UpNDownNS ($46.75 in chips) 
Seat 3: bellisimo212 ($49.50 in chips) 
Seat 4: christyirish ($57.02 in chips) 
Seat 5: jantheman222 ($52.50 in chips) 
Seat 6: maisit* ($111.24 in chips) 
Seat 7: whitecillar3 ($54 in chips) 
Seat 8: SteigEin84 ($60.97 in chips) 
Seat 9: Lago Madjore ($50 in chips) 
bellisimo212: posts small blind $0.25
christyirish: posts big blind $0.50
i$BamboBlady$i: posts big blind $0.50
*** HOLE CARDS ***
jantheman222: folds 
maisit*: raises $1.50 to $2
whitecillar3: folds 
SteigEin84: folds 
Lago Madjore: folds 
i$BamboBlady$i: folds 
UpNDownNS: folds 
bellisimo212: folds 
christyirish: folds 
Uncalled bet ($1.50) returned to maisit*
maisit* collected $1.75 from pot
maisit*: doesn't show hand 
*** SUMMARY ***
Total pot $1.75 | Rake $0 
Seat 1: i$BamboBlady$i folded before Flop (didn't bet)
Seat 2: UpNDownNS (button) folded before Flop (didn't bet)
Seat 3: bellisimo212 (small blind) folded before Flop
Seat 4: christyirish (big blind) folded before Flop
Seat 5: jantheman222 folded before Flop (didn't bet)
Seat 6: maisit* collected ($1.75)
Seat 7: whitecillar3 folded before Flop (didn't bet)
Seat 8: SteigEin84 folded before Flop (didn't bet)
Seat 9: Lago Madjore folded before Flop (didn't bet)



PokerStars Hand #228695268424:  Hold'em No Limit ($0.25/$0.50 USD) - 2021/07/30 21:30:57 ET
Table 'Aitne III' 9-max Seat #3 is the button
Seat 1: i$BamboBlady$i ($27.17 in chips) 
Seat 2: UpNDownNS ($46.75 in chips) 
Seat 3: bellisimo212 ($49.25 in chips) 
Seat 4: christyirish ($56.52 in chips) 
Seat 5: jantheman222 ($52.50 in chips) 
Seat 6: maisit* ($112.49 in chips) 
Seat 7: whitecillar3 ($54 in chips) 
Seat 8: SteigEin84 ($60.97 in chips) 
Seat 9: Lago Madjore ($50 in chips) 
christyirish: posts small blind $0.25
jantheman222: posts big blind $0.50
*** HOLE CARDS ***
maisit*: folds 
whitecillar3: folds 
SteigEin84: raises $0.50 to $1
Lago Madjore: folds 
i$BamboBlady$i: folds 
UpNDownNS: folds 
bellisimo212: calls $1
christyirish: folds 
jantheman222: calls $0.50
*** FLOP *** [7s 3s Ah]
jantheman222: checks 
SteigEin84: bets $2
bellisimo212: calls $2
jantheman222: calls $2
*** TURN *** [7s 3s Ah] [4h]
jantheman222: checks 
SteigEin84: checks 
bellisimo212: checks 
*** RIVER *** [7s 3s Ah 4h] [Tc]
jantheman222: checks 
SteigEin84: checks 
bellisimo212: checks 
*** SHOW DOWN ***
jantheman222: shows [4d 5s] (a pair of Fours)
SteigEin84: mucks hand 
bellisimo212: shows [Qs Ts] (a pair of Tens)
bellisimo212 collected $8.79 from pot
*** SUMMARY ***
Total pot $9.25 | Rake $0.46 
Board [7s 3s Ah 4h Tc]
Seat 1: i$BamboBlady$i folded before Flop (didn't bet)
Seat 2: UpNDownNS folded before Flop (didn't bet)
Seat 3: bellisimo212 (button) showed [Qs Ts] and won ($8.79) with a pair of Tens
Seat 4: christyirish (small blind) folded before Flop
Seat 5: jantheman222 (big blind) showed [4d 5s] and lost with a pair of Fours
Seat 6: maisit* folded before Flop (didn't bet)
Seat 7: whitecillar3 folded before Flop (didn't bet)
Seat 8: SteigEin84 mucked
Seat 9: Lago Madjore folded before Flop (didn't bet)



PokerStars Hand #228695287656:  Hold'em No Limit ($0.25/$0.50 USD) - 2021/07/30 21:32:15 ET
Table 'Aitne III' 9-max Seat #4 is the button
Seat 1: i$BamboBlady$i ($27.17 in chips) 
Seat 2: UpNDownNS ($46.75 in chips) 
Seat 3: bellisimo212 ($55.04 in chips) 
Seat 4: christyirish ($56.27 in chips) 
Seat 5: jantheman222 ($49.50 in chips) 
Seat 6: maisit* ($112.49 in chips) 
Seat 7: whitecillar3 ($54 in chips) 
Seat 8: SteigEin84 ($57.97 in chips) 
Seat 9: Lago Madjore ($50 in chips) 
jantheman222: posts small blind $0.25
maisit*: posts big blind $0.50
*** HOLE CARDS ***
whitecillar3: folds 
SteigEin84: folds 
Lago Madjore: folds 
i$BamboBlady$i: raises $1 to $1.50
UpNDownNS: folds 
bellisimo212: folds 
christyirish: folds 
jantheman222: raises $4.25 to $5.75
maisit*: folds 
i$BamboBlady$i: calls $4.25
*** FLOP *** [Jh 5s 6c]
jantheman222: checks 
i$BamboBlady$i: bets $5.70
jantheman222: calls $5.70
*** TURN *** [Jh 5s 6c] [4c]
jantheman222: checks 
i$BamboBlady$i: bets $15.72 and is all-in
jantheman222: calls $15.72
*** RIVER *** [Jh 5s 6c 4c] [9d]
*** SHOW DOWN ***
jantheman222: shows [8h 8c] (a pair of Eights)
i$BamboBlady$i: shows [Ks Js] (a pair of Jacks)
i$BamboBlady$i collected $52.34 from pot
*** SUMMARY ***
Total pot $54.84 | Rake $2.50 
Board [Jh 5s 6c 4c 9d]
Seat 1: i$BamboBlady$i showed [Ks Js] and won ($52.34) with a pair of Jacks
Seat 2: UpNDownNS folded before Flop (didn't bet)
Seat 3: bellisimo212 folded before Flop (didn't bet)
Seat 4: christyirish (button) folded before Flop (didn't bet)
Seat 5: jantheman222 (small blind) showed [8h 8c] and lost with a pair of Eights
Seat 6: maisit* (big blind) folded before Flop
Seat 7: whitecillar3 folded before Flop (didn't bet)
Seat 8: SteigEin84 folded before Flop (didn't bet)
Seat 9: Lago Madjore folded before Flop (didn't bet)



PokerStars Hand #228695310799:  Hold'em No Limit ($0.25/$0.50 USD) - 2021/07/30 21:33:35 ET
Table 'Aitne III' 9-max Seat #5 is the button
Seat 1: i$BamboBlady$i ($52.34 in chips) 
Seat 2: UpNDownNS ($46.75 in chips) 
Seat 3: bellisimo212 ($55.04 in chips) 
Seat 4: christyirish ($56.27 in chips) 
Seat 5: jantheman222 ($22.33 in chips) 
Seat 6: maisit* ($111.99 in chips) 
Seat 7: whitecillar3 ($54 in chips) 
Seat 8: SteigEin84 ($57.97 in chips) 
Seat 9: Lago Madjore ($50 in chips) 
maisit*: posts small blind $0.25
whitecillar3: posts big blind $0.50
*** HOLE CARDS ***
SteigEin84: folds 
Lago Madjore: raises $0.56 to $1.06
i$BamboBlady$i: calls $1.06
UpNDownNS: folds 
bellisimo212: calls $1.06
christyirish: folds 
jantheman222: folds 
maisit*: folds 
whitecillar3: folds 
*** FLOP *** [2h 7s 5d]
Lago Madjore: bets $2.54
i$BamboBlady$i: folds 
bellisimo212: folds 
Uncalled bet ($2.54) returned to Lago Madjore
Lago Madjore collected $3.73 from pot
*** SUMMARY ***
Total pot $3.93 | Rake $0.20 
Board [2h 7s 5d]
Seat 1: i$BamboBlady$i folded on the Flop
Seat 2: UpNDownNS folded before Flop (didn't bet)
Seat 3: bellisimo212 folded on the Flop
Seat 4: christyirish folded before Flop (didn't bet)
Seat 5: jantheman222 (button) folded before Flop (didn't bet)
Seat 6: maisit* (small blind) folded before Flop
Seat 7: whitecillar3 (big blind) folded before Flop
Seat 8: SteigEin84 folded before Flop (didn't bet)
Seat 9: Lago Madjore collected ($3.73)



PokerStars Hand #228695328989:  Hold'em No Limit ($0.25/$0.50 USD) - 2021/07/30 21:34:34 ET
Table 'Aitne III' 9-max Seat #6 is the button
Seat 1: i$BamboBlady$i ($51.28 in chips) 
Seat 2: UpNDownNS ($46.75 in chips) 
Seat 3: bellisimo212 ($53.98 in chips) 
Seat 4: christyirish ($56.27 in chips) 
Seat 5: jantheman222 ($22.33 in chips) 
Seat 6: maisit* ($111.74 in chips) 
Seat 7: whitecillar3 ($53.50 in chips) 
Seat 8: SteigEin84 ($57.97 in chips) 
Seat 9: Lago Madjore ($52.67 in chips) 
whitecillar3: posts small blind $0.25
SteigEin84: posts big blind $0.50
*** HOLE CARDS ***
Lago Madjore: folds 
i$BamboBlady$i: folds 
UpNDownNS: folds 
bellisimo212: folds 
christyirish: folds 
jantheman222: folds 
maisit*: folds 
whitecillar3: folds 
Uncalled bet ($0.25) returned to SteigEin84
SteigEin84 collected $0.50 from pot
SteigEin84: doesn't show hand 
*** SUMMARY ***
Total pot $0.50 | Rake $0 
Seat 1: i$BamboBlady$i folded before Flop (didn't bet)
Seat 2: UpNDownNS folded before Flop (didn't bet)
Seat 3: bellisimo212 folded before Flop (didn't bet)
Seat 4: christyirish folded before Flop (didn't bet)
Seat 5: jantheman222 folded before Flop (didn't bet)
Seat 6: maisit* (button) folded before Flop (didn't bet)
Seat 7: whitecillar3 (small blind) folded before Flop
Seat 8: SteigEin84 (big blind) collected ($0.50)
Seat 9: Lago Madjore folded before Flop (didn't bet)



PokerStars Hand #228695333987:  Hold'em No Limit ($0.25/$0.50 USD) - 2021/07/30 21:34:54 ET
Table 'Aitne III' 9-max Seat #7 is the button
Seat 1: i$BamboBlady$i ($51.28 in chips) 
Seat 2: UpNDownNS ($46.75 in chips) 
Seat 3: bellisimo212 ($53.98 in chips) 
Seat 4: christyirish ($56.27 in chips) 
Seat 5: jantheman222 ($22.33 in chips) 
Seat 6: maisit* ($111.74 in chips) 
Seat 7: whitecillar3 ($53.25 in chips) 
Seat 8: SteigEin84 ($58.22 in chips) 
Seat 9: Lago Madjore ($52.67 in chips) 
SteigEin84: posts small blind $0.25
Lago Madjore: posts big blind $0.50
*** HOLE CARDS ***
i$BamboBlady$i: calls $0.50
UpNDownNS: folds 
bellisimo212: folds 
christyirish: folds 
jantheman222: folds 
maisit*: raises $1.50 to $2
whitecillar3: folds 
SteigEin84: folds 
Lago Madjore: folds 
i$BamboBlady$i: calls $1.50
*** FLOP *** [2s 3d 3c]
i$BamboBlady$i: checks 
maisit*: bets $1.49
i$BamboBlady$i: calls $1.49
*** TURN *** [2s 3d 3c] [7c]
i$BamboBlady$i: checks 
maisit*: bets $5.51
i$BamboBlady$i: folds 
Uncalled bet ($5.51) returned to maisit*
maisit* collected $7.34 from pot
maisit*: doesn't show hand 
*** SUMMARY ***
Total pot $7.73 | Rake $0.39 
Board [2s 3d 3c 7c]
Seat 1: i$BamboBlady$i folded on the Turn
Seat 2: UpNDownNS folded before Flop (didn't bet)
Seat 3: bellisimo212 folded before Flop (didn't bet)
Seat 4: christyirish folded before Flop (didn't bet)
Seat 5: jantheman222 folded before Flop (didn't bet)
Seat 6: maisit* collected ($7.34)
Seat 7: whitecillar3 (button) folded before Flop (didn't bet)
Seat 8: SteigEin84 (small blind) folded before Flop
Seat 9: Lago Madjore (big blind) folded before Flop



PokerStars Hand #228695346132:  Hold'em No Limit ($0.25/$0.50 USD) - 2021/07/30 21:35:42 ET
Table 'Aitne III' 9-max Seat #8 is the button
Seat 1: i$BamboBlady$i ($47.79 in chips) 
Seat 2: UpNDownNS ($46.75 in chips) 
Seat 3: bellisimo212 ($53.98 in chips) 
Seat 4: christyirish ($56.27 in chips) 
Seat 5: jantheman222 ($22.33 in chips) 
Seat 6: maisit* ($115.59 in chips) 
Seat 7: whitecillar3 ($53.25 in chips) 
Seat 8: SteigEin84 ($57.97 in chips) 
Seat 9: Lago Madjore ($52.17 in chips) 
Lago Madjore: posts small blind $0.25
i$BamboBlady$i: posts big blind $0.50
*** HOLE CARDS ***
UpNDownNS: folds 
bellisimo212: folds 
christyirish: folds 
jantheman222: folds 
maisit*: raises $1 to $1.50
whitecillar3: folds 
SteigEin84: folds 
Lago Madjore: folds 
i$BamboBlady$i: calls $1
*** FLOP *** [2c Ad 9h]
i$BamboBlady$i: checks 
maisit*: bets $1
i$BamboBlady$i: calls $1
*** TURN *** [2c Ad 9h] [Ks]
i$BamboBlady$i: bets $2.49
maisit*: calls $2.49
*** RIVER *** [2c Ad 9h Ks] [4s]
i$BamboBlady$i: bets $5.36
maisit*: folds 
Uncalled bet ($5.36) returned to i$BamboBlady$i
i$BamboBlady$i collected $9.59 from pot
i$BamboBlady$i: doesn't show hand 
*** SUMMARY ***
Total pot $10.23 | Rake $0.64 
Board [2c Ad 9h Ks 4s]
Seat 1: i$BamboBlady$i (big blind) collected ($9.59)
Seat 2: UpNDownNS folded before Flop (didn't bet)
Seat 3: bellisimo212 folded before Flop (didn't bet)
Seat 4: christyirish folded before Flop (didn't bet)
Seat 5: jantheman222 folded before Flop (didn't bet)
Seat 6: maisit* folded on the River
Seat 7: whitecillar3 folded before Flop (didn't bet)
Seat 8: SteigEin84 (button) folded before Flop (didn't bet)
Seat 9: Lago Madjore (small blind) folded before Flop



PokerStars Hand #228695362822:  Hold'em No Limit ($0.25/$0.50 USD) - 2021/07/30 21:36:48 ET
Table 'Aitne III' 9-max Seat #9 is the button
Seat 1: i$BamboBlady$i ($52.39 in chips) 
Seat 2: UpNDownNS ($46.75 in chips) 
Seat 3: bellisimo212 ($53.98 in chips) 
Seat 4: christyirish ($56.27 in chips) 
Seat 5: jantheman222 ($22.33 in chips) 
Seat 6: maisit* ($110.60 in chips) 
Seat 7: whitecillar3 ($53.25 in chips) 
Seat 8: SteigEin84 ($57.97 in chips) 
Seat 9: Lago Madjore ($51.92 in chips) 
i$BamboBlady$i: posts small blind $0.25
UpNDownNS: posts big blind $0.50
*** HOLE CARDS ***
bellisimo212: folds 
christyirish: folds 
jantheman222: folds 
maisit*: folds 
whitecillar3: folds 
SteigEin84: raises $1 to $1.50
Lago Madjore: folds 
i$BamboBlady$i: folds 
UpNDownNS: calls $1
*** FLOP *** [6h Ts Jc]
UpNDownNS: checks 
SteigEin84: bets $2
UpNDownNS: calls $2
*** TURN *** [6h Ts Jc] [Ah]
UpNDownNS: checks 
SteigEin84: bets $4
UpNDownNS: folds 
Uncalled bet ($4) returned to SteigEin84
SteigEin84 collected $6.80 from pot
SteigEin84: doesn't show hand 
*** SUMMARY ***
Total pot $7.25 | Rake $0.45 
Board [6h Ts Jc Ah]
Seat 1: i$BamboBlady$i (small blind) folded before Flop
Seat 2: UpNDownNS (big blind) folded on the Turn
Seat 3: bellisimo212 folded before Flop (didn't bet)
Seat 4: christyirish folded before Flop (didn't bet)
Seat 5: jantheman222 folded before Flop (didn't bet)
Seat 6: maisit* folded before Flop (didn't bet)
Seat 7: whitecillar3 folded before Flop (didn't bet)
Seat 8: SteigEin84 collected ($6.80)
Seat 9: Lago Madjore (button) folded before Flop (didn't bet)



PokerStars Hand #228695373313:  Hold'em No Limit ($0.25/$0.50 USD) - 2021/07/30 21:37:30 ET
Table 'Aitne III' 9-max Seat #1 is the button
Seat 1: i$BamboBlady$i ($52.14 in chips) 
Seat 2: UpNDownNS ($43.25 in chips) 
Seat 3: bellisimo212 ($53.98 in chips) 
Seat 4: christyirish ($56.27 in chips) 
Seat 5: jantheman222 ($22.33 in chips) 
Seat 6: maisit* ($110.60 in chips) 
Seat 7: whitecillar3 ($53.25 in chips) 
Seat 8: SteigEin84 ($61.27 in chips) 
Seat 9: Lago Madjore ($51.92 in chips) 
UpNDownNS: posts small blind $0.25
bellisimo212: posts big blind $0.50
*** HOLE CARDS ***
christyirish: folds 
jantheman222: folds 
maisit*: folds 
whitecillar3: folds 
SteigEin84: calls $0.50
Lago Madjore: folds 
i$BamboBlady$i: calls $0.50
UpNDownNS: calls $0.25
bellisimo212: checks 
*** FLOP *** [Qc Th Qh]
UpNDownNS: checks 
bellisimo212: checks 
SteigEin84: bets $1
i$BamboBlady$i: folds 
UpNDownNS: calls $1
bellisimo212: folds 
*** TURN *** [Qc Th Qh] [4s]
UpNDownNS: bets $3.50
SteigEin84: calls $3.50
*** RIVER *** [Qc Th Qh 4s] [Js]
UpNDownNS: checks 
SteigEin84: bets $6
UpNDownNS: calls $6
*** SHOW DOWN ***
SteigEin84: shows [7d Qd] (three of a kind, Queens)
UpNDownNS: mucks hand 
SteigEin84 collected $21.56 from pot
*** SUMMARY ***
Total pot $23 | Rake $1.44 
Board [Qc Th Qh 4s Js]
Seat 1: i$BamboBlady$i (button) folded on the Flop
Seat 2: UpNDownNS (small blind) mucked
Seat 3: bellisimo212 (big blind) folded on the Flop
Seat 4: christyirish folded before Flop (didn't bet)
Seat 5: jantheman222 folded before Flop (didn't bet)
Seat 6: maisit* folded before Flop (didn't bet)
Seat 7: whitecillar3 folded before Flop (didn't bet)
Seat 8: SteigEin84 showed [7d Qd] and won ($21.56) with three of a kind, Queens
Seat 9: Lago Madjore folded before Flop (didn't bet)



PokerStars Hand #228695389114:  Hold'em No Limit ($0.25/$0.50 USD) - 2021/07/30 21:38:34 ET
Table 'Aitne III' 9-max Seat #2 is the button
Seat 1: i$BamboBlady$i ($51.64 in chips) 
Seat 2: UpNDownNS ($32.25 in chips) 
Seat 3: bellisimo212 ($53.48 in chips) 
Seat 4: christyirish ($56.27 in chips) 
Seat 5: jantheman222 ($22.33 in chips) 
Seat 6: maisit* ($110.60 in chips) 
Seat 7: whitecillar3 ($53.25 in chips) 
Seat 8: SteigEin84 ($71.83 in chips) 
Seat 9: Lago Madjore ($51.92 in chips) 
bellisimo212: posts small blind $0.25
christyirish: posts big blind $0.50
*** HOLE CARDS ***
jantheman222: folds 
maisit*: folds 
whitecillar3: folds 
SteigEin84: folds 
Lago Madjore: folds 
i$BamboBlady$i: folds 
UpNDownNS: folds 
bellisimo212: calls $0.25
christyirish: raises $1 to $1.50
bellisimo212: calls $1
*** FLOP *** [Kc Jc 3s]
bellisimo212: checks 
christyirish: checks 
*** TURN *** [Kc Jc 3s] [9h]
bellisimo212: checks 
christyirish: bets $1.43
bellisimo212: folds 
Uncalled bet ($1.43) returned to christyirish
christyirish collected $2.85 from pot
*** SUMMARY ***
Total pot $3 | Rake $0.15 
Board [Kc Jc 3s 9h]
Seat 1: i$BamboBlady$i folded before Flop (didn't bet)
Seat 2: UpNDownNS (button) folded before Flop (didn't bet)
Seat 3: bellisimo212 (small blind) folded on the Turn
Seat 4: christyirish (big blind) collected ($2.85)
Seat 5: jantheman222 folded before Flop (didn't bet)
Seat 6: maisit* folded before Flop (didn't bet)
Seat 7: whitecillar3 folded before Flop (didn't bet)
Seat 8: SteigEin84 folded before Flop (didn't bet)
Seat 9: Lago Madjore folded before Flop (didn't bet)



PokerStars Hand #228695400666:  Hold'em No Limit ($0.25/$0.50 USD) - 2021/07/30 21:39:20 ET
Table 'Aitne III' 9-max Seat #3 is the button
Seat 1: i$BamboBlady$i ($51.64 in chips) 
Seat 2: UpNDownNS ($32.25 in chips) 
Seat 3: bellisimo212 ($51.98 in chips) 
Seat 4: christyirish ($57.62 in chips) 
Seat 5: jantheman222 ($22.33 in chips) 
Seat 6: maisit* ($110.60 in chips) 
Seat 7: whitecillar3 ($53.25 in chips) 
Seat 8: SteigEin84 ($71.83 in chips) 
Seat 9: Lago Madjore ($51.92 in chips) 
christyirish: posts small blind $0.25
jantheman222: posts big blind $0.50
*** HOLE CARDS ***
maisit*: folds 
whitecillar3: folds 
SteigEin84: calls $0.50
Lago Madjore: folds 
i$BamboBlady$i: folds 
UpNDownNS: folds 
bellisimo212: folds 
christyirish: folds 
jantheman222: checks 
*** FLOP *** [5s Ad As]
jantheman222: checks 
SteigEin84: checks 
*** TURN *** [5s Ad As] [2c]
jantheman222: bets $0.50
SteigEin84: calls $0.50
*** RIVER *** [5s Ad As 2c] [Ac]
jantheman222: bets $1.75
SteigEin84: raises $1.75 to $3.50
jantheman222: calls $1.75
*** SHOW DOWN ***
SteigEin84: shows [3s Ah] (four of a kind, Aces)
jantheman222: mucks hand 
SteigEin84 collected $8.67 from pot
*** SUMMARY ***
Total pot $9.25 | Rake $0.58 
Board [5s Ad As 2c Ac]
Seat 1: i$BamboBlady$i folded before Flop (didn't bet)
Seat 2: UpNDownNS folded before Flop (didn't bet)
Seat 3: bellisimo212 (button) folded before Flop (didn't bet)
Seat 4: christyirish (small blind) folded before Flop
Seat 5: jantheman222 (big blind) mucked
Seat 6: maisit* folded before Flop (didn't bet)
Seat 7: whitecillar3 folded before Flop (didn't bet)
Seat 8: SteigEin84 showed [3s Ah] and won ($8.67) with four of a kind, Aces
Seat 9: Lago Madjore folded before Flop (didn't bet)



PokerStars Hand #228695412417:  Hold'em No Limit ($0.25/$0.50 USD) - 2021/07/30 21:40:07 ET
Table 'Aitne III' 9-max Seat #4 is the button
Seat 1: i$BamboBlady$i ($51.64 in chips) 
Seat 2: UpNDownNS ($32.25 in chips) 
Seat 3: bellisimo212 ($51.98 in chips) 
Seat 4: christyirish ($57.37 in chips) 
Seat 5: jantheman222 ($17.83 in chips) 
Seat 6: maisit* ($110.60 in chips) 
Seat 7: whitecillar3 ($53.25 in chips) 
Seat 8: SteigEin84 ($76 in chips) 
Seat 9: Lago Madjore ($51.92 in chips) 
jantheman222: posts small blind $0.25
maisit*: posts big blind $0.50
*** HOLE CARDS ***
whitecillar3: folds 
SteigEin84: folds 
Lago Madjore: folds 
i$BamboBlady$i: calls $0.50
UpNDownNS: folds 
bellisimo212: folds 
christyirish: folds 
jantheman222: calls $0.25
maisit*: checks 
*** FLOP *** [4s Qh Kd]
jantheman222: checks 
maisit*: checks 
i$BamboBlady$i: bets $0.71
jantheman222: folds 
maisit*: folds 
Uncalled bet ($0.71) returned to i$BamboBlady$i
i$BamboBlady$i collected $1.40 from pot
i$BamboBlady$i: doesn't show hand 
*** SUMMARY ***
Total pot $1.50 | Rake $0.10 
Board [4s Qh Kd]
Seat 1: i$BamboBlady$i collected ($1.40)
Seat 2: UpNDownNS folded before Flop (didn't bet)
Seat 3: bellisimo212 folded before Flop (didn't bet)
Seat 4: christyirish (button) folded before Flop (didn't bet)
Seat 5: jantheman222 (small blind) folded on the Flop
Seat 6: maisit* (big blind) folded on the Flop
Seat 7: whitecillar3 folded before Flop (didn't bet)
Seat 8: SteigEin84 folded before Flop (didn't bet)
Seat 9: Lago Madjore folded before Flop (didn't bet)



PokerStars Hand #228695426368:  Hold'em No Limit ($0.25/$0.50 USD) - 2021/07/30 21:41:03 ET
Table 'Aitne III' 9-max Seat #5 is the button
Seat 1: i$BamboBlady$i ($52.54 in chips) 
Seat 2: UpNDownNS ($32.25 in chips) 
Seat 3: bellisimo212 ($51.98 in chips) 
Seat 4: christyirish ($57.37 in chips) 
Seat 5: jantheman222 ($17.33 in chips) 
Seat 6: maisit* ($110.10 in chips) 
Seat 8: SteigEin84 ($76 in chips) 
Seat 9: Lago Madjore ($51.92 in chips) 
maisit*: posts small blind $0.25
SteigEin84: posts big blind $0.50
*** HOLE CARDS ***
Lago Madjore: folds 
i$BamboBlady$i: folds 
UpNDownNS: folds 
bellisimo212: folds 
christyirish: raises $1 to $1.50
jantheman222: raises $15.83 to $17.33 and is all-in
maisit*: folds 
SteigEin84: folds 
christyirish: folds 
Uncalled bet ($15.83) returned to jantheman222
jantheman222 collected $3.75 from pot
jantheman222: doesn't show hand 
*** SUMMARY ***
Total pot $3.75 | Rake $0 
Seat 1: i$BamboBlady$i folded before Flop (didn't bet)
Seat 2: UpNDownNS folded before Flop (didn't bet)
Seat 3: bellisimo212 folded before Flop (didn't bet)
Seat 4: christyirish folded before Flop
Seat 5: jantheman222 (button) collected ($3.75)
Seat 6: maisit* (small blind) folded before Flop
Seat 8: SteigEin84 (big blind) folded before Flop
Seat 9: Lago Madjore folded before Flop (didn't bet)



PokerStars Hand #228695433312:  Hold'em No Limit ($0.25/$0.50 USD) - 2021/07/30 21:41:31 ET
Table 'Aitne III' 9-max Seat #6 is the button
Seat 1: i$BamboBlady$i ($52.54 in chips) 
Seat 2: UpNDownNS ($32.25 in chips) 
Seat 3: bellisimo212 ($51.98 in chips) 
Seat 4: christyirish ($55.87 in chips) 
Seat 5: jantheman222 ($19.58 in chips) 
Seat 6: maisit* ($109.85 in chips) 
Seat 8: SteigEin84 ($75.50 in chips) 
Seat 9: Lago Madjore ($51.92 in chips) 
SteigEin84: posts small blind $0.25
Lago Madjore: posts big blind $0.50
*** HOLE CARDS ***
i$BamboBlady$i: folds 
UpNDownNS: folds 
bellisimo212: calls $0.50
christyirish: folds 
jantheman222: folds 
maisit*: folds 
SteigEin84: calls $0.25
Lago Madjore: checks 
*** FLOP *** [5h 4s 8c]
SteigEin84: checks 
Lago Madjore: checks 
bellisimo212: checks 
*** TURN *** [5h 4s 8c] [2s]
SteigEin84: checks 
Lago Madjore: checks 
bellisimo212: checks 
*** RIVER *** [5h 4s 8c 2s] [2d]
SteigEin84: checks 
Lago Madjore: checks 
bellisimo212: checks 
*** SHOW DOWN ***
SteigEin84: shows [3d Tc] (a pair of Deuces)
Lago Madjore: shows [Ac 7d] (a pair of Deuces - Ace kicker)
bellisimo212: shows [Ah Jc] (a pair of Deuces - Ace+Jack kicker)
bellisimo212 collected $1.42 from pot
*** SUMMARY ***
Total pot $1.50 | Rake $0.08 
Board [5h 4s 8c 2s 2d]
Seat 1: i$BamboBlady$i folded before Flop (didn't bet)
Seat 2: UpNDownNS folded before Flop (didn't bet)
Seat 3: bellisimo212 showed [Ah Jc] and won ($1.42) with a pair of Deuces
Seat 4: christyirish folded before Flop (didn't bet)
Seat 5: jantheman222 folded before Flop (didn't bet)
Seat 6: maisit* (button) folded before Flop (didn't bet)
Seat 8: SteigEin84 (small blind) showed [3d Tc] and lost with a pair of Deuces
Seat 9: Lago Madjore (big blind) showed [Ac 7d] and lost with a pair of Deuces



PokerStars Hand #228695454537:  Hold'em No Limit ($0.25/$0.50 USD) - 2021/07/30 21:42:27 ET
Table 'Aitne III' 9-max Seat #8 is the button
Seat 1: i$BamboBlady$i ($52.54 in chips) 
Seat 2: UpNDownNS ($32.25 in chips) 
Seat 3: bellisimo212 ($52.90 in chips) 
Seat 4: christyirish ($55.87 in chips) 
Seat 5: jantheman222 ($19.58 in chips) 
Seat 6: maisit* ($109.85 in chips) 
Seat 8: SteigEin84 ($75 in chips) 
Seat 9: Lago Madjore ($51.42 in chips) 
Lago Madjore: posts small blind $0.25
i$BamboBlady$i: posts big blind $0.50
*** HOLE CARDS ***
UpNDownNS: folds 
bellisimo212: folds 
christyirish: folds 
jantheman222: folds 
maisit*: raises $1 to $1.50
SteigEin84: folds 
Lago Madjore: folds 
i$BamboBlady$i: calls $1
*** FLOP *** [4c Kc 8d]
i$BamboBlady$i: checks 
maisit*: bets $1.02
i$BamboBlady$i: calls $1.02
*** TURN *** [4c Kc 8d] [9d]
i$BamboBlady$i: checks 
maisit*: checks 
*** RIVER *** [4c Kc 8d 9d] [7h]
i$BamboBlady$i: bets $2.51
maisit*: calls $2.51
*** SHOW DOWN ***
i$BamboBlady$i: shows [8h 7c] (two pair, Eights and Sevens)
maisit*: mucks hand 
i$BamboBlady$i collected $9.66 from pot
*** SUMMARY ***
Total pot $10.31 | Rake $0.65 
Board [4c Kc 8d 9d 7h]
Seat 1: i$BamboBlady$i (big blind) showed [8h 7c] and won ($9.66) with two pair, Eights and Sevens
Seat 2: UpNDownNS folded before Flop (didn't bet)
Seat 3: bellisimo212 folded before Flop (didn't bet)
Seat 4: christyirish folded before Flop (didn't bet)
Seat 5: jantheman222 folded before Flop (didn't bet)
Seat 6: maisit* mucked
Seat 8: SteigEin84 (button) folded before Flop (didn't bet)
Seat 9: Lago Madjore (small blind) folded before Flop



PokerStars Hand #228695487533:  Hold'em No Limit ($0.25/$0.50 USD) - 2021/07/30 21:44:01 ET
Table 'Aitne III' 9-max Seat #9 is the button
Seat 1: i$BamboBlady$i ($57.17 in chips) 
Seat 2: UpNDownNS ($32.25 in chips) 
Seat 3: bellisimo212 ($52.90 in chips) 
Seat 4: christyirish ($55.87 in chips) 
Seat 5: jantheman222 ($19.58 in chips) 
Seat 6: maisit* ($104.82 in chips) 
Seat 8: SteigEin84 ($75 in chips) 
Seat 9: Lago Madjore ($51.17 in chips) 
i$BamboBlady$i: posts small blind $0.25
UpNDownNS: posts big blind $0.50
*** HOLE CARDS ***
bellisimo212: folds 
christyirish: folds 
jantheman222: folds 
maisit*: raises $1 to $1.50
SteigEin84: calls $1.50
Lago Madjore: folds 
i$BamboBlady$i: folds 
UpNDownNS: folds 
*** FLOP *** [Qs 8s 6h]
maisit*: checks 
SteigEin84: bets $1
maisit*: calls $1
*** TURN *** [Qs 8s 6h] [Kc]
maisit*: checks 
SteigEin84: checks 
*** RIVER *** [Qs 8s 6h Kc] [5h]
maisit*: bets $4.50
SteigEin84: calls $4.50
*** SHOW DOWN ***
maisit*: shows [5s As] (a pair of Fives)
SteigEin84: shows [9h Qd] (a pair of Queens)
SteigEin84 collected $13.83 from pot
*** SUMMARY ***
Total pot $14.75 | Rake $0.92 
Board [Qs 8s 6h Kc 5h]
Seat 1: i$BamboBlady$i (small blind) folded before Flop
Seat 2: UpNDownNS (big blind) folded before Flop
Seat 3: bellisimo212 folded before Flop (didn't bet)
Seat 4: christyirish folded before Flop (didn't bet)
Seat 5: jantheman222 folded before Flop (didn't bet)
Seat 6: maisit* showed [5s As] and lost with a pair of Fives
Seat 8: SteigEin84 showed [9h Qd] and won ($13.83) with a pair of Queens
Seat 9: Lago Madjore (button) folded before Flop (didn't bet)



PokerStars Hand #228695500813:  Hold'em No Limit ($0.25/$0.50 USD) - 2021/07/30 21:44:54 ET
Table 'Aitne III' 9-max Seat #1 is the button
Seat 1: i$BamboBlady$i ($56.92 in chips) 
Seat 2: UpNDownNS ($31.75 in chips) 
Seat 3: bellisimo212 ($52.90 in chips) 
Seat 4: christyirish ($55.87 in chips) 
Seat 5: jantheman222 ($19.58 in chips) 
Seat 6: maisit* ($97.82 in chips) 
Seat 8: SteigEin84 ($81.83 in chips) 
Seat 9: Lago Madjore ($51.17 in chips) 
UpNDownNS: posts small blind $0.25
bellisimo212: posts big blind $0.50
*** HOLE CARDS ***
christyirish: folds 
jantheman222: folds 
maisit*: folds 
SteigEin84: raises $1 to $1.50
Lago Madjore: folds 
i$BamboBlady$i: folds 
UpNDownNS: folds 
bellisimo212: folds 
Uncalled bet ($1) returned to SteigEin84
SteigEin84 collected $1.25 from pot
SteigEin84: doesn't show hand 
*** SUMMARY ***
Total pot $1.25 | Rake $0 
Seat 1: i$BamboBlady$i (button) folded before Flop (didn't bet)
Seat 2: UpNDownNS (small blind) folded before Flop
Seat 3: bellisimo212 (big blind) folded before Flop
Seat 4: christyirish folded before Flop (didn't bet)
Seat 5: jantheman222 folded before Flop (didn't bet)
Seat 6: maisit* folded before Flop (didn't bet)
Seat 8: SteigEin84 collected ($1.25)
Seat 9: Lago Madjore folded before Flop (didn't bet)



PokerStars Hand #228695504730:  Hold'em No Limit ($0.25/$0.50 USD) - 2021/07/30 21:45:10 ET
Table 'Aitne III' 9-max Seat #2 is the button
Seat 1: i$BamboBlady$i ($56.92 in chips) 
Seat 2: UpNDownNS ($31.50 in chips) 
Seat 3: bellisimo212 ($52.40 in chips) 
Seat 4: christyirish ($55.87 in chips) 
Seat 5: jantheman222 ($19.58 in chips) 
Seat 6: maisit* ($97.82 in chips) 
Seat 8: SteigEin84 ($82.58 in chips) 
Seat 9: Lago Madjore ($51.17 in chips) 
bellisimo212: posts small blind $0.25
christyirish: posts big blind $0.50
*** HOLE CARDS ***
jantheman222: folds 
maisit*: folds 
SteigEin84: raises $0.50 to $1
Lago Madjore: folds 
i$BamboBlady$i: folds 
UpNDownNS: folds 
bellisimo212: folds 
christyirish: folds 
Uncalled bet ($0.50) returned to SteigEin84
SteigEin84 collected $1.25 from pot
SteigEin84: doesn't show hand 
*** SUMMARY ***
Total pot $1.25 | Rake $0 
Seat 1: i$BamboBlady$i folded before Flop (didn't bet)
Seat 2: UpNDownNS (button) folded before Flop (didn't bet)
Seat 3: bellisimo212 (small blind) folded before Flop
Seat 4: christyirish (big blind) folded before Flop
Seat 5: jantheman222 folded before Flop (didn't bet)
Seat 6: maisit* folded before Flop (didn't bet)
Seat 8: SteigEin84 collected ($1.25)
Seat 9: Lago Madjore folded before Flop (didn't bet)



PokerStars Hand #228695509464:  Hold'em No Limit ($0.25/$0.50 USD) - 2021/07/30 21:45:30 ET
Table 'Aitne III' 9-max Seat #3 is the button
Seat 1: i$BamboBlady$i ($56.92 in chips) 
Seat 2: UpNDownNS ($31.50 in chips) 
Seat 3: bellisimo212 ($52.15 in chips) 
Seat 4: christyirish ($55.37 in chips) 
Seat 5: jantheman222 ($19.58 in chips) 
Seat 6: maisit* ($97.82 in chips) 
Seat 8: SteigEin84 ($83.33 in chips) 
Seat 9: Lago Madjore ($51.17 in chips) 
christyirish: posts small blind $0.25
jantheman222: posts big blind $0.50
*** HOLE CARDS ***
maisit*: raises $1 to $1.50
SteigEin84: folds 
Lago Madjore: folds 
i$BamboBlady$i: folds 
UpNDownNS: folds 
bellisimo212: folds 
christyirish: folds 
jantheman222: folds 
Uncalled bet ($1) returned to maisit*
maisit* collected $1.25 from pot
maisit*: doesn't show hand 
*** SUMMARY ***
Total pot $1.25 | Rake $0 
Seat 1: i$BamboBlady$i folded before Flop (didn't bet)
Seat 2: UpNDownNS folded before Flop (didn't bet)
Seat 3: bellisimo212 (button) folded before Flop (didn't bet)
Seat 4: christyirish (small blind) folded before Flop
Seat 5: jantheman222 (big blind) folded before Flop
Seat 6: maisit* collected ($1.25)
Seat 8: SteigEin84 folded before Flop (didn't bet)
Seat 9: Lago Madjore folded before Flop (didn't bet)



PokerStars Hand #228695515707:  Hold'em No Limit ($0.25/$0.50 USD) - 2021/07/30 21:45:55 ET
Table 'Aitne III' 9-max Seat #4 is the button
Seat 1: i$BamboBlady$i ($56.92 in chips) 
Seat 2: UpNDownNS ($31.50 in chips) 
Seat 3: bellisimo212 ($52.15 in chips) 
Seat 4: christyirish ($55.12 in chips) 
Seat 5: jantheman222 ($19.08 in chips) 
Seat 6: maisit* ($98.57 in chips) 
Seat 8: SteigEin84 ($83.33 in chips) 
Seat 9: Lago Madjore ($51.17 in chips) 
jantheman222: posts small blind $0.25
maisit*: posts big blind $0.50
*** HOLE CARDS ***
SteigEin84: folds 
Lago Madjore: folds 
i$BamboBlady$i: folds 
UpNDownNS: folds 
bellisimo212: folds 
christyirish: folds 
jantheman222: raises $1 to $1.50
maisit*: calls $1
*** FLOP *** [5c 2s 8d]
jantheman222: checks 
maisit*: bets $1
jantheman222: calls $1
*** TURN *** [5c 2s 8d] [Tc]
jantheman222: checks 
maisit*: bets $3.56
jantheman222: raises $13.02 to $16.58 and is all-in
maisit*: calls $13.02
*** RIVER *** [5c 2s 8d Tc] [Ts]
*** SHOW DOWN ***
jantheman222: shows [Th Ah] (three of a kind, Tens)
maisit*: shows [Qd 8s] (two pair, Tens and Eights)
jantheman222 cashed out the hand for $31.82 | Cash Out Fee $0.32
*** SUMMARY ***
Total pot $38.16 | Rake $1.91 
Board [5c 2s 8d Tc Ts]
Seat 1: i$BamboBlady$i folded before Flop (didn't bet)
Seat 2: UpNDownNS folded before Flop (didn't bet)
Seat 3: bellisimo212 folded before Flop (didn't bet)
Seat 4: christyirish (button) folded before Flop (didn't bet)
Seat 5: jantheman222 (small blind) showed [Th Ah] and won ($36.25) with three of a kind, Tens (pot not awarded as player cashed out)
Seat 6: maisit* (big blind) showed [Qd 8s] and lost with two pair, Tens and Eights
Seat 8: SteigEin84 folded before Flop (didn't bet)
Seat 9: Lago Madjore folded before Flop (didn't bet)



PokerStars Hand #228695536874:  Hold'em No Limit ($0.25/$0.50 USD) - 2021/07/30 21:47:22 ET
Table 'Aitne III' 9-max Seat #5 is the button
Seat 1: i$BamboBlady$i ($56.92 in chips) 
Seat 2: UpNDownNS ($31.50 in chips) 
Seat 3: bellisimo212 ($52.15 in chips) 
Seat 4: christyirish ($55.12 in chips) 
Seat 5: jantheman222 ($31.82 in chips) 
Seat 6: maisit* ($79.49 in chips) 
Seat 8: SteigEin84 ($83.33 in chips) 
Seat 9: Lago Madjore ($51.17 in chips) 
maisit*: posts small blind $0.25
SteigEin84: posts big blind $0.50
*** HOLE CARDS ***
Lago Madjore: folds 
i$BamboBlady$i: folds 
UpNDownNS: folds 
bellisimo212: folds 
christyirish: folds 
jantheman222: folds 
maisit*: raises $1 to $1.50
SteigEin84: calls $1
*** FLOP *** [3d 4d Ac]
maisit*: checks 
SteigEin84: bets $1.50
maisit*: calls $1.50
*** TURN *** [3d 4d Ac] [5h]
maisit*: checks 
Lago Madjore leaves the table
SteigEin84: bets $4
maisit*: raises $10 to $14
SteigEin84: folds 
Uncalled bet ($10) returned to maisit*
maisit* collected $13.30 from pot
maisit*: doesn't show hand 
*** SUMMARY ***
Total pot $14 | Rake $0.70 
Board [3d 4d Ac 5h]
Seat 1: i$BamboBlady$i folded before Flop (didn't bet)
Seat 2: UpNDownNS folded before Flop (didn't bet)
Seat 3: bellisimo212 folded before Flop (didn't bet)
Seat 4: christyirish folded before Flop (didn't bet)
Seat 5: jantheman222 (button) folded before Flop (didn't bet)
Seat 6: maisit* (small blind) collected ($13.30)
Seat 8: SteigEin84 (big blind) folded on the Turn
Seat 9: Lago Madjore folded before Flop (didn't bet)



PokerStars Hand #228695553925:  Hold'em No Limit ($0.25/$0.50 USD) - 2021/07/30 21:48:32 ET
Table 'Aitne III' 9-max Seat #6 is the button
Seat 1: i$BamboBlady$i ($56.92 in chips) 
Seat 2: UpNDownNS ($31.50 in chips) 
Seat 3: bellisimo212 ($52.15 in chips) 
Seat 4: christyirish ($55.12 in chips) 
Seat 5: jantheman222 ($31.82 in chips) 
Seat 6: maisit* ($85.79 in chips) 
Seat 8: SteigEin84 ($76.33 in chips) 
SteigEin84: posts small blind $0.25
i$BamboBlady$i: posts big blind $0.50
*** HOLE CARDS ***
UpNDownNS: raises $1 to $1.50
bellisimo212: calls $1.50
christyirish: folds 
jantheman222: folds 
maisit*: folds 
SteigEin84: folds 
i$BamboBlady$i: folds 
*** FLOP *** [7d 9h Ts]
UpNDownNS: bets $2
bellisimo212: folds 
Uncalled bet ($2) returned to UpNDownNS
UpNDownNS collected $3.56 from pot
UpNDownNS: doesn't show hand 
*** SUMMARY ***
Total pot $3.75 | Rake $0.19 
Board [7d 9h Ts]
Seat 1: i$BamboBlady$i (big blind) folded before Flop
Seat 2: UpNDownNS collected ($3.56)
Seat 3: bellisimo212 folded on the Flop
Seat 4: christyirish folded before Flop (didn't bet)
Seat 5: jantheman222 folded before Flop (didn't bet)
Seat 6: maisit* (button) folded before Flop (didn't bet)
Seat 8: SteigEin84 (small blind) folded before Flop



PokerStars Hand #228695561096:  Hold'em No Limit ($0.25/$0.50 USD) - 2021/07/30 21:49:01 ET
Table 'Aitne III' 9-max Seat #8 is the button
Seat 1: i$BamboBlady$i ($56.42 in chips) 
Seat 3: bellisimo212 ($50.65 in chips) 
Seat 4: christyirish ($55.12 in chips) 
Seat 5: jantheman222 ($31.82 in chips) 
Seat 6: maisit* ($85.79 in chips) 
Seat 8: SteigEin84 ($76.08 in chips) 
i$BamboBlady$i: posts small blind $0.25
UpNDownNS: is sitting out 
bellisimo212: posts big blind $0.50
*** HOLE CARDS ***
christyirish: folds 
jantheman222: folds 
maisit*: folds 
UpNDownNS leaves the table
WrongButton joins the table at seat #9 
SteigEin84 has timed out
SteigEin84: folds 
i$BamboBlady$i: raises $1 to $1.50
bellisimo212: folds 
Uncalled bet ($1) returned to i$BamboBlady$i
i$BamboBlady$i collected $1 from pot
i$BamboBlady$i: doesn't show hand 
*** SUMMARY ***
Total pot $1 | Rake $0 
Seat 1: i$BamboBlady$i (small blind) collected ($1)
Seat 3: bellisimo212 (big blind) folded before Flop
Seat 4: christyirish folded before Flop (didn't bet)
Seat 5: jantheman222 folded before Flop (didn't bet)
Seat 6: maisit* folded before Flop (didn't bet)
Seat 8: SteigEin84 (button) folded before Flop (didn't bet)



PokerStars Hand #228695569299:  Hold'em No Limit ($0.25/$0.50 USD) - 2021/07/30 21:49:34 ET
Table 'Aitne III' 9-max Seat #1 is the button
Seat 1: i$BamboBlady$i ($56.92 in chips) 
Seat 3: bellisimo212 ($50.15 in chips) 
Seat 4: christyirish ($55.12 in chips) 
Seat 5: jantheman222 ($31.82 in chips) 
Seat 6: maisit* ($85.79 in chips) 
Seat 8: SteigEin84 ($76.08 in chips) 
bellisimo212: posts small blind $0.25
christyirish: posts big blind $0.50
WrongButton: sits out 
*** HOLE CARDS ***
jantheman222: folds 
maisit*: folds 
SteigEin84: folds 
i$BamboBlady$i: calls $0.50
bellisimo212: calls $0.25
christyirish: raises $1.50 to $2
i$BamboBlady$i: folds 
bellisimo212: calls $1.50
*** FLOP *** [4d Ts 8c]
bellisimo212: checks 
christyirish: bets $2.14
bellisimo212: calls $2.14
*** TURN *** [4d Ts 8c] [Jc]
bellisimo212: checks 
christyirish: checks 
*** RIVER *** [4d Ts 8c Jc] [2h]
bellisimo212: bets $2
christyirish: folds 
Uncalled bet ($2) returned to bellisimo212
bellisimo212 collected $8.34 from pot
bellisimo212: doesn't show hand 
*** SUMMARY ***
Total pot $8.78 | Rake $0.44 
Board [4d Ts 8c Jc 2h]
Seat 1: i$BamboBlady$i (button) folded before Flop
Seat 3: bellisimo212 (small blind) collected ($8.34)
Seat 4: christyirish (big blind) folded on the River
Seat 5: jantheman222 folded before Flop (didn't bet)
Seat 6: maisit* folded before Flop (didn't bet)
Seat 8: SteigEin84 folded before Flop (didn't bet)



PokerStars Hand #228695582134:  Hold'em No Limit ($0.25/$0.50 USD) - 2021/07/30 21:50:27 ET
Table 'Aitne III' 9-max Seat #3 is the button
Seat 1: i$BamboBlady$i ($56.42 in chips) 
Seat 3: bellisimo212 ($54.35 in chips) 
Seat 4: christyirish ($50.98 in chips) 
Seat 5: jantheman222 ($31.82 in chips) 
Seat 6: maisit* ($85.79 in chips) 
Seat 8: SteigEin84 ($76.08 in chips) 
christyirish: posts small blind $0.25
jantheman222: posts big blind $0.50
WrongButton: sits out 
*** HOLE CARDS ***
maisit*: raises $1 to $1.50
SteigEin84: folds 
i$BamboBlady$i: calls $1.50
bellisimo212: calls $1.50
christyirish: folds 
jantheman222: calls $1
*** FLOP *** [Tc Ah Jd]
jantheman222: checks 
maisit*: checks 
i$BamboBlady$i: checks 
bellisimo212: checks 
*** TURN *** [Tc Ah Jd] [4s]
jantheman222: bets $1.50
maisit*: calls $1.50
i$BamboBlady$i: folds 
bellisimo212: calls $1.50
*** RIVER *** [Tc Ah Jd 4s] [4h]
jantheman222: bets $8.17
maisit*: folds 
bellisimo212: folds 
Uncalled bet ($8.17) returned to jantheman222
jantheman222 collected $10.21 from pot
jantheman222: doesn't show hand 
*** SUMMARY ***
Total pot $10.75 | Rake $0.54 
Board [Tc Ah Jd 4s 4h]
Seat 1: i$BamboBlady$i folded on the Turn
Seat 3: bellisimo212 (button) folded on the River
Seat 4: christyirish (small blind) folded before Flop
Seat 5: jantheman222 (big blind) collected ($10.21)
Seat 6: maisit* folded on the River
Seat 8: SteigEin84 folded before Flop (didn't bet)



PokerStars Hand #228695598709:  Hold'em No Limit ($0.25/$0.50 USD) - 2021/07/30 21:51:34 ET
Table 'Aitne III' 9-max Seat #4 is the button
Seat 1: i$BamboBlady$i ($54.92 in chips) 
Seat 3: bellisimo212 ($51.35 in chips) 
Seat 4: christyirish ($50.73 in chips) 
Seat 5: jantheman222 ($39.03 in chips) 
Seat 6: maisit* ($82.79 in chips) 
Seat 8: SteigEin84 ($76.08 in chips) 
jantheman222: posts small blind $0.25
maisit*: posts big blind $0.50
WrongButton: sits out 
*** HOLE CARDS ***
SteigEin84: raises $0.50 to $1
i$BamboBlady$i: folds 
bellisimo212: folds 
christyirish: folds 
jantheman222: folds 
maisit*: calls $0.50
*** FLOP *** [3c 6h 2h]
maisit*: checks 
SteigEin84: bets $1
maisit*: folds 
Uncalled bet ($1) returned to SteigEin84
SteigEin84 collected $2.11 from pot
SteigEin84: doesn't show hand 
*** SUMMARY ***
Total pot $2.25 | Rake $0.14 
Board [3c 6h 2h]
Seat 1: i$BamboBlady$i folded before Flop (didn't bet)
Seat 3: bellisimo212 folded before Flop (didn't bet)
Seat 4: christyirish (button) folded before Flop (didn't bet)
Seat 5: jantheman222 (small blind) folded before Flop
Seat 6: maisit* (big blind) folded on the Flop
Seat 8: SteigEin84 collected ($2.11)



PokerStars Hand #228695604471:  Hold'em No Limit ($0.25/$0.50 USD) - 2021/07/30 21:51:58 ET
Table 'Aitne III' 9-max Seat #5 is the button
Seat 1: i$BamboBlady$i ($54.92 in chips) 
Seat 4: christyirish ($50.73 in chips) 
Seat 5: jantheman222 ($38.78 in chips) 
Seat 6: maisit* ($81.79 in chips) 
Seat 8: SteigEin84 ($77.19 in chips) 
maisit*: posts small blind $0.25
SteigEin84: posts big blind $0.50
WrongButton: sits out 
*** HOLE CARDS ***
i$BamboBlady$i: folds 
christyirish: folds 
jantheman222: folds 
maisit*: raises $1 to $1.50
SteigEin84: calls $1
*** FLOP *** [7s 4c Ts]
maisit*: checks 
SteigEin84: checks 
*** TURN *** [7s 4c Ts] [6s]
maisit*: bets $2.14
SteigEin84: calls $2.14
*** RIVER *** [7s 4c Ts 6s] [6d]
maisit*: bets $5.19
SteigEin84: folds 
Uncalled bet ($5.19) returned to maisit*
maisit* collected $6.92 from pot
maisit*: doesn't show hand 
*** SUMMARY ***
Total pot $7.28 | Rake $0.36 
Board [7s 4c Ts 6s 6d]
Seat 1: i$BamboBlady$i folded before Flop (didn't bet)
Seat 4: christyirish folded before Flop (didn't bet)
Seat 5: jantheman222 (button) folded before Flop (didn't bet)
Seat 6: maisit* (small blind) collected ($6.92)
Seat 8: SteigEin84 (big blind) folded on the River



PokerStars Hand #228695614653:  Hold'em No Limit ($0.25/$0.50 USD) - 2021/07/30 21:52:39 ET
Table 'Aitne III' 9-max Seat #6 is the button
Seat 1: i$BamboBlady$i ($54.92 in chips) 
Seat 3: bellisimo212 ($51.35 in chips) 
Seat 4: christyirish ($50.73 in chips) 
Seat 5: jantheman222 ($38.78 in chips) 
Seat 6: maisit* ($85.07 in chips) 
Seat 8: SteigEin84 ($73.55 in chips) 
Seat 9: WrongButton ($50 in chips) 
SteigEin84: posts small blind $0.25
WrongButton: posts big blind $0.50
*** HOLE CARDS ***
i$BamboBlady$i: folds 
bellisimo212: calls $0.50
christyirish: folds 
jantheman222: folds 
maisit*: folds 
SteigEin84: calls $0.25
WrongButton: checks 
*** FLOP *** [4c 3h 2d]
SteigEin84: checks 
WrongButton: checks 
bellisimo212: checks 
*** TURN *** [4c 3h 2d] [Jd]
SteigEin84: checks 
WrongButton: checks 
bellisimo212: bets $0.50
SteigEin84: calls $0.50
Chernovsky joins the table at seat #2 
WrongButton: folds 
*** RIVER *** [4c 3h 2d Jd] [8d]
SteigEin84: checks 
bellisimo212: bets $1
SteigEin84: folds 
Uncalled bet ($1) returned to bellisimo212
bellisimo212 collected $2.38 from pot
bellisimo212: doesn't show hand 
*** SUMMARY ***
Total pot $2.50 | Rake $0.12 
Board [4c 3h 2d Jd 8d]
Seat 1: i$BamboBlady$i folded before Flop (didn't bet)
Seat 3: bellisimo212 collected ($2.38)
Seat 4: christyirish folded before Flop (didn't bet)
Seat 5: jantheman222 folded before Flop (didn't bet)
Seat 6: maisit* (button) folded before Flop (didn't bet)
Seat 8: SteigEin84 (small blind) folded on the River
Seat 9: WrongButton (big blind) folded on the Turn



PokerStars Hand #228695627165:  Hold'em No Limit ($0.25/$0.50 USD) - 2021/07/30 21:53:31 ET
Table 'Aitne III' 9-max Seat #8 is the button
Seat 1: i$BamboBlady$i ($54.92 in chips) 
Seat 3: bellisimo212 ($52.73 in chips) 
Seat 4: christyirish ($50.73 in chips) 
Seat 5: jantheman222 ($38.78 in chips) 
Seat 6: maisit* ($85.07 in chips) 
Seat 8: SteigEin84 ($72.55 in chips) 
Seat 9: WrongButton ($50 in chips) 
WrongButton: posts small blind $0.25
i$BamboBlady$i: posts big blind $0.50
Chernovsky: sits out 
whitecillar3: sits out 
*** HOLE CARDS ***
bellisimo212: calls $0.50
christyirish: folds 
jantheman222: folds 
maisit*: folds 
SteigEin84: calls $0.50
WrongButton: folds 
i$BamboBlady$i: checks 
*** FLOP *** [4h Ah Js]
i$BamboBlady$i: checks 
bellisimo212: bets $1.50
SteigEin84: calls $1.50
i$BamboBlady$i: folds 
*** TURN *** [4h Ah Js] [Kd]
bellisimo212: checks 
SteigEin84: bets $2
bellisimo212: calls $2
*** RIVER *** [4h Ah Js Kd] [As]
bellisimo212: checks 
SteigEin84: bets $5
bellisimo212: folds 
Uncalled bet ($5) returned to SteigEin84
SteigEin84 collected $8.20 from pot
SteigEin84: doesn't show hand 
*** SUMMARY ***
Total pot $8.75 | Rake $0.55 
Board [4h Ah Js Kd As]
Seat 1: i$BamboBlady$i (big blind) folded on the Flop
Seat 3: bellisimo212 folded on the River
Seat 4: christyirish folded before Flop (didn't bet)
Seat 5: jantheman222 folded before Flop (didn't bet)
Seat 6: maisit* folded before Flop (didn't bet)
Seat 8: SteigEin84 (button) collected ($8.20)
Seat 9: WrongButton (small blind) folded before Flop



PokerStars Hand #228695643828:  Hold'em No Limit ($0.25/$0.50 USD) - 2021/07/30 21:54:39 ET
Table 'Aitne III' 9-max Seat #9 is the button
Seat 1: i$BamboBlady$i ($54.42 in chips) 
Seat 2: Chernovsky ($50 in chips) 
Seat 3: bellisimo212 ($48.73 in chips) 
Seat 4: christyirish ($50.73 in chips) 
Seat 5: jantheman222 ($38.78 in chips) 
Seat 6: maisit* ($85.07 in chips) 
Seat 8: SteigEin84 ($76.75 in chips) 
Seat 9: WrongButton ($50 in chips) 
i$BamboBlady$i: posts small blind $0.25
Chernovsky: posts big blind $0.50
whitecillar3: sits out 
*** HOLE CARDS ***
bellisimo212: calls $0.50
christyirish: folds 
jantheman222: folds 
maisit*: folds 
SteigEin84: folds 
WrongButton: folds 
i$BamboBlady$i: calls $0.25
Chernovsky: checks 
*** FLOP *** [7c 3h 5h]
i$BamboBlady$i: bets $0.71
Chernovsky: calls $0.71
bellisimo212: folds 
*** TURN *** [7c 3h 5h] [Tc]
i$BamboBlady$i: bets $1.38
Chernovsky: folds 
Uncalled bet ($1.38) returned to i$BamboBlady$i
i$BamboBlady$i collected $2.73 from pot
i$BamboBlady$i: doesn't show hand 
*** SUMMARY ***
Total pot $2.92 | Rake $0.19 
Board [7c 3h 5h Tc]
Seat 1: i$BamboBlady$i (small blind) collected ($2.73)
Seat 2: Chernovsky (big blind) folded on the Turn
Seat 3: bellisimo212 folded on the Flop
Seat 4: christyirish folded before Flop (didn't bet)
Seat 5: jantheman222 folded before Flop (didn't bet)
Seat 6: maisit* folded before Flop (didn't bet)
Seat 8: SteigEin84 folded before Flop (didn't bet)
Seat 9: WrongButton (button) folded before Flop (didn't bet)



PokerStars Hand #228695652898:  Hold'em No Limit ($0.25/$0.50 USD) - 2021/07/30 21:55:18 ET
Table 'Aitne III' 9-max Seat #1 is the button
Seat 1: i$BamboBlady$i ($55.94 in chips) 
Seat 2: Chernovsky ($50 in chips) 
Seat 3: bellisimo212 ($48.23 in chips) 
Seat 4: christyirish ($50.73 in chips) 
Seat 5: jantheman222 ($38.78 in chips) 
Seat 6: maisit* ($85.07 in chips) 
Seat 8: SteigEin84 ($76.75 in chips) 
Seat 9: WrongButton ($50 in chips) 
Chernovsky: posts small blind $0.25
bellisimo212: posts big blind $0.50
whitecillar3: sits out 
*** HOLE CARDS ***
christyirish has timed out
christyirish: folds 
jantheman222: folds 
maisit*: folds 
SteigEin84: folds 
WrongButton: raises $0.50 to $1
i$BamboBlady$i: calls $1
Chernovsky: folds 
bellisimo212: calls $0.50
*** FLOP *** [9s Ks Jc]
bellisimo212: checks 
WrongButton: checks 
i$BamboBlady$i: bets $1.54
bellisimo212: calls $1.54
WrongButton: folds 
*** TURN *** [9s Ks Jc] [6c]
bellisimo212: checks 
i$BamboBlady$i: bets $3
bellisimo212: calls $3
*** RIVER *** [9s Ks Jc 6c] [8s]
bellisimo212: checks 
i$BamboBlady$i: checks 
*** SHOW DOWN ***
bellisimo212: shows [4s Qs] (a flush, King high)
i$BamboBlady$i: mucks hand 
bellisimo212 collected $11.71 from pot
*** SUMMARY ***
Total pot $12.33 | Rake $0.62 
Board [9s Ks Jc 6c 8s]
Seat 1: i$BamboBlady$i (button) mucked
Seat 2: Chernovsky (small blind) folded before Flop
Seat 3: bellisimo212 (big blind) showed [4s Qs] and won ($11.71) with a flush, King high
Seat 4: christyirish folded before Flop (didn't bet)
Seat 5: jantheman222 folded before Flop (didn't bet)
Seat 6: maisit* folded before Flop (didn't bet)
Seat 8: SteigEin84 folded before Flop (didn't bet)
Seat 9: WrongButton folded on the Flop



PokerStars Hand #228695665983:  Hold'em No Limit ($0.25/$0.50 USD) - 2021/07/30 21:56:27 ET
Table 'Aitne III' 9-max Seat #2 is the button
Seat 1: i$BamboBlady$i ($50.40 in chips) 
Seat 2: Chernovsky ($50 in chips) 
Seat 3: bellisimo212 ($54.40 in chips) 
Seat 4: christyirish ($50.73 in chips) 
Seat 5: jantheman222 ($38.78 in chips) 
Seat 6: maisit* ($85.07 in chips) 
Seat 8: SteigEin84 ($76.75 in chips) 
Seat 9: WrongButton ($50 in chips) 
bellisimo212: posts small blind $0.25
christyirish: posts big blind $0.50
whitecillar3: sits out 
*** HOLE CARDS ***
jantheman222: folds 
maisit*: raises $1 to $1.50
SteigEin84: folds 
WrongButton: folds 
i$BamboBlady$i: folds 
Chernovsky: folds 
bellisimo212: folds 
christyirish: folds 
Uncalled bet ($1) returned to maisit*
maisit* collected $1.25 from pot
maisit*: doesn't show hand 
*** SUMMARY ***
Total pot $1.25 | Rake $0 
Seat 1: i$BamboBlady$i folded before Flop (didn't bet)
Seat 2: Chernovsky (button) folded before Flop (didn't bet)
Seat 3: bellisimo212 (small blind) folded before Flop
Seat 4: christyirish (big blind) folded before Flop
Seat 5: jantheman222 folded before Flop (didn't bet)
Seat 6: maisit* collected ($1.25)
Seat 8: SteigEin84 folded before Flop (didn't bet)
Seat 9: WrongButton folded before Flop (didn't bet)



PokerStars Hand #228695671551:  Hold'em No Limit ($0.25/$0.50 USD) - 2021/07/30 21:56:56 ET
Table 'Aitne III' 9-max Seat #3 is the button
Seat 1: i$BamboBlady$i ($50.40 in chips) 
Seat 2: Chernovsky ($50 in chips) 
Seat 3: bellisimo212 ($54.15 in chips) 
Seat 4: christyirish ($50.23 in chips) 
Seat 5: jantheman222 ($38.78 in chips) 
Seat 6: maisit* ($85.82 in chips) 
Seat 8: SteigEin84 ($76.75 in chips) 
Seat 9: WrongButton ($50 in chips) 
christyirish: posts small blind $0.25
jantheman222: posts big blind $0.50
whitecillar3: sits out 
*** HOLE CARDS ***
maisit*: folds 
SteigEin84: folds 
WrongButton: folds 
i$BamboBlady$i: folds 
Chernovsky: folds 
bellisimo212: folds 
christyirish: calls $0.25
jantheman222: checks 
*** FLOP *** [Jd 8s 9h]
christyirish: checks 
jantheman222: bets $0.50
christyirish: calls $0.50
*** TURN *** [Jd 8s 9h] [As]
christyirish: checks 
jantheman222: checks 
*** RIVER *** [Jd 8s 9h As] [Qs]
christyirish: checks 
jantheman222: checks 
*** SHOW DOWN ***
christyirish: shows [Jh 5h] (a pair of Jacks)
jantheman222: shows [3c Jc] (a pair of Jacks)
christyirish collected $0.95 from pot
jantheman222 collected $0.95 from pot
*** SUMMARY ***
Total pot $2 | Rake $0.10 
Board [Jd 8s 9h As Qs]
Seat 1: i$BamboBlady$i folded before Flop (didn't bet)
Seat 2: Chernovsky folded before Flop (didn't bet)
Seat 3: bellisimo212 (button) folded before Flop (didn't bet)
Seat 4: christyirish (small blind) showed [Jh 5h] and won ($0.95) with a pair of Jacks
Seat 5: jantheman222 (big blind) showed [3c Jc] and won ($0.95) with a pair of Jacks
Seat 6: maisit* folded before Flop (didn't bet)
Seat 8: SteigEin84 folded before Flop (didn't bet)
Seat 9: WrongButton folded before Flop (didn't bet)



PokerStars Hand #228695687559:  Hold'em No Limit ($0.25/$0.50 USD) - 2021/07/30 21:57:50 ET
Table 'Aitne III' 9-max Seat #4 is the button
Seat 1: i$BamboBlady$i ($50.40 in chips) 
Seat 2: Chernovsky ($50 in chips) 
Seat 3: bellisimo212 ($54.15 in chips) 
Seat 4: christyirish ($50.18 in chips) 
Seat 5: jantheman222 ($38.73 in chips) 
Seat 6: maisit* ($85.82 in chips) 
Seat 8: SteigEin84 ($76.75 in chips) 
Seat 9: WrongButton ($50 in chips) 
jantheman222: posts small blind $0.25
maisit*: posts big blind $0.50
whitecillar3: sits out 
*** HOLE CARDS ***
SteigEin84: folds 
WrongButton: folds 
i$BamboBlady$i: folds 
Chernovsky: raises $0.75 to $1.25
bellisimo212: calls $1.25
christyirish: folds 
jantheman222: folds 
maisit*: folds 
*** FLOP *** [Js Tc Td]
Chernovsky: bets $1.05
bellisimo212: folds 
Uncalled bet ($1.05) returned to Chernovsky
Chernovsky collected $3.09 from pot
Chernovsky: doesn't show hand 
*** SUMMARY ***
Total pot $3.25 | Rake $0.16 
Board [Js Tc Td]
Seat 1: i$BamboBlady$i folded before Flop (didn't bet)
Seat 2: Chernovsky collected ($3.09)
Seat 3: bellisimo212 folded on the Flop
Seat 4: christyirish (button) folded before Flop (didn't bet)
Seat 5: jantheman222 (small blind) folded before Flop
Seat 6: maisit* (big blind) folded before Flop
Seat 8: SteigEin84 folded before Flop (didn't bet)
Seat 9: WrongButton folded before Flop (didn't bet)



PokerStars Hand #228695696466:  Hold'em No Limit ($0.25/$0.50 USD) - 2021/07/30 21:58:36 ET
Table 'Aitne III' 9-max Seat #5 is the button
Seat 1: i$BamboBlady$i ($50.40 in chips) 
Seat 2: Chernovsky ($51.84 in chips) 
Seat 3: bellisimo212 ($52.90 in chips) 
Seat 4: christyirish ($50.18 in chips) 
Seat 5: jantheman222 ($38.48 in chips) 
Seat 6: maisit* ($85.32 in chips) 
Seat 7: whitecillar3 ($53.25 in chips) 
Seat 8: SteigEin84 ($76.75 in chips) 
Seat 9: WrongButton ($50 in chips) 
maisit*: posts small blind $0.25
whitecillar3: posts big blind $0.50
*** HOLE CARDS ***
SteigEin84: raises $1 to $1.50
WrongButton: folds 
i$BamboBlady$i: folds 
Chernovsky: folds 
bellisimo212: folds 
christyirish: folds 
jantheman222: raises $4 to $5.50
maisit*: folds 
whitecillar3: folds 
SteigEin84: calls $4
*** FLOP *** [2h As Qh]
SteigEin84: checks 
jantheman222: checks 
*** TURN *** [2h As Qh] [3d]
SteigEin84: checks 
jantheman222: checks 
*** RIVER *** [2h As Qh 3d] [Tc]
SteigEin84: checks 
jantheman222: checks 
*** SHOW DOWN ***
SteigEin84: shows [Ah Qc] (two pair, Aces and Queens)
jantheman222: mucks hand 
SteigEin84 collected $11.01 from pot
*** SUMMARY ***
Total pot $11.75 | Rake $0.74 
Board [2h As Qh 3d Tc]
Seat 1: i$BamboBlady$i folded before Flop (didn't bet)
Seat 2: Chernovsky folded before Flop (didn't bet)
Seat 3: bellisimo212 folded before Flop (didn't bet)
Seat 4: christyirish folded before Flop (didn't bet)
Seat 5: jantheman222 (button) mucked
Seat 6: maisit* (small blind) folded before Flop
Seat 7: whitecillar3 (big blind) folded before Flop
Seat 8: SteigEin84 showed [Ah Qc] and won ($11.01) with two pair, Aces and Queens
Seat 9: WrongButton folded before Flop (didn't bet)



PokerStars Hand #228695707127:  Hold'em No Limit ($0.25/$0.50 USD) - 2021/07/30 21:59:32 ET
Table 'Aitne III' 9-max Seat #6 is the button
Seat 1: i$BamboBlady$i ($50.40 in chips) 
Seat 2: Chernovsky ($51.84 in chips) 
Seat 3: bellisimo212 ($52.90 in chips) 
Seat 4: christyirish ($50.18 in chips) 
Seat 5: jantheman222 ($32.98 in chips) 
Seat 6: maisit* ($85.07 in chips) 
Seat 7: whitecillar3 ($52.75 in chips) 
Seat 8: SteigEin84 ($82.26 in chips) 
Seat 9: WrongButton ($50 in chips) 
whitecillar3: posts small blind $0.25
SteigEin84: posts big blind $0.50
*** HOLE CARDS ***
WrongButton: folds 
i$BamboBlady$i: folds 
Chernovsky: folds 
bellisimo212: calls $0.50
christyirish: folds 
jantheman222: folds 
maisit*: folds 
whitecillar3: calls $0.25
SteigEin84: checks 
*** FLOP *** [9d 7d Qs]
whitecillar3: checks 
SteigEin84: checks 
bellisimo212: checks 
*** TURN *** [9d 7d Qs] [3h]
whitecillar3: bets $1.08
SteigEin84: folds 
bellisimo212: calls $1.08
*** RIVER *** [9d 7d Qs 3h] [Js]
whitecillar3: bets $2.64
bellisimo212: folds 
Uncalled bet ($2.64) returned to whitecillar3
whitecillar3 collected $3.48 from pot
*** SUMMARY ***
Total pot $3.66 | Rake $0.18 
Board [9d 7d Qs 3h Js]
Seat 1: i$BamboBlady$i folded before Flop (didn't bet)
Seat 2: Chernovsky folded before Flop (didn't bet)
Seat 3: bellisimo212 folded on the River
Seat 4: christyirish folded before Flop (didn't bet)
Seat 5: jantheman222 folded before Flop (didn't bet)
Seat 6: maisit* (button) folded before Flop (didn't bet)
Seat 7: whitecillar3 (small blind) collected ($3.48)
Seat 8: SteigEin84 (big blind) folded on the Turn
Seat 9: WrongButton folded before Flop (didn't bet)



PokerStars Hand #228695718081:  Hold'em No Limit ($0.25/$0.50 USD) - 2021/07/30 22:00:27 ET
Table 'Aitne III' 9-max Seat #7 is the button
Seat 1: i$BamboBlady$i ($50.40 in chips) 
Seat 2: Chernovsky ($51.84 in chips) 
Seat 3: bellisimo212 ($51.32 in chips) 
Seat 4: christyirish ($50.18 in chips) 
Seat 5: jantheman222 ($32.98 in chips) 
Seat 6: maisit* ($85.07 in chips) 
Seat 7: whitecillar3 ($54.65 in chips) 
Seat 8: SteigEin84 ($81.76 in chips) 
Seat 9: WrongButton ($50 in chips) 
SteigEin84: posts small blind $0.25
WrongButton: posts big blind $0.50
*** HOLE CARDS ***
i$BamboBlady$i: folds 
Chernovsky: raises $0.75 to $1.25
bellisimo212: calls $1.25
christyirish: folds 
jantheman222: folds 
maisit*: folds 
whitecillar3: folds 
SteigEin84: calls $1
WrongButton: folds 
*** FLOP *** [2h 8h 7c]
SteigEin84: checks 
Chernovsky: bets $3.03
bellisimo212: folds 
SteigEin84: folds 
Uncalled bet ($3.03) returned to Chernovsky
Chernovsky collected $4.04 from pot
Chernovsky: doesn't show hand 
*** SUMMARY ***
Total pot $4.25 | Rake $0.21 
Board [2h 8h 7c]
Seat 1: i$BamboBlady$i folded before Flop (didn't bet)
Seat 2: Chernovsky collected ($4.04)
Seat 3: bellisimo212 folded on the Flop
Seat 4: christyirish folded before Flop (didn't bet)
Seat 5: jantheman222 folded before Flop (didn't bet)
Seat 6: maisit* folded before Flop (didn't bet)
Seat 7: whitecillar3 (button) folded before Flop (didn't bet)
Seat 8: SteigEin84 (small blind) folded on the Flop
Seat 9: WrongButton (big blind) folded before Flop



PokerStars Hand #228695725403:  Hold'em No Limit ($0.25/$0.50 USD) - 2021/07/30 22:01:01 ET
Table 'Aitne III' 9-max Seat #8 is the button
Seat 1: i$BamboBlady$i ($50.40 in chips) 
Seat 2: Chernovsky ($54.63 in chips) 
Seat 3: bellisimo212 ($50.07 in chips) 
Seat 4: christyirish ($50.18 in chips) 
Seat 5: jantheman222 ($32.98 in chips) 
Seat 6: maisit* ($85.07 in chips) 
Seat 7: whitecillar3 ($54.65 in chips) 
Seat 8: SteigEin84 ($80.51 in chips) 
Seat 9: WrongButton ($50 in chips) 
WrongButton: posts small blind $0.25
i$BamboBlady$i: posts big blind $0.50
*** HOLE CARDS ***
Chernovsky: folds 
bellisimo212: folds 
christyirish: folds 
jantheman222: raises $0.75 to $1.25
maisit*: folds 
whitecillar3: folds 
SteigEin84: calls $1.25
WrongButton: folds 
i$BamboBlady$i: calls $0.75
*** FLOP *** [8h 5s Js]
i$BamboBlady$i: checks 
jantheman222: bets $1.25
SteigEin84: folds 
i$BamboBlady$i: calls $1.25
*** TURN *** [8h 5s Js] [7d]
i$BamboBlady$i: checks 
jantheman222: bets $3.75
i$BamboBlady$i: raises $5.25 to $9
jantheman222: calls $5.25
*** RIVER *** [8h 5s Js 7d] [9s]
i$BamboBlady$i: bets $12.14
jantheman222: raises $9.34 to $21.48 and is all-in
i$BamboBlady$i: calls $9.34
*** SHOW DOWN ***
jantheman222: shows [Qs Ts] (a flush, Queen high)
i$BamboBlady$i: shows [9c Tc] (a straight, Seven to Jack)
jantheman222 collected $65.46 from pot
*** SUMMARY ***
Total pot $67.46 | Rake $2 
Board [8h 5s Js 7d 9s]
Seat 1: i$BamboBlady$i (big blind) showed [9c Tc] and lost with a straight, Seven to Jack
Seat 2: Chernovsky folded before Flop (didn't bet)
Seat 3: bellisimo212 folded before Flop (didn't bet)
Seat 4: christyirish folded before Flop (didn't bet)
Seat 5: jantheman222 showed [Qs Ts] and won ($65.46) with a flush, Queen high
Seat 6: maisit* folded before Flop (didn't bet)
Seat 7: whitecillar3 folded before Flop (didn't bet)
Seat 8: SteigEin84 (button) folded on the Flop
Seat 9: WrongButton (small blind) folded before Flop



PokerStars Hand #228695744876:  Hold'em No Limit ($0.25/$0.50 USD) - 2021/07/30 22:02:20 ET
Table 'Aitne III' 9-max Seat #9 is the button
Seat 1: i$BamboBlady$i ($17.42 in chips) 
Seat 3: bellisimo212 ($50.07 in chips) 
Seat 4: christyirish ($50.18 in chips) 
Seat 5: jantheman222 ($65.46 in chips) 
Seat 6: maisit* ($85.07 in chips) 
Seat 7: whitecillar3 ($54.65 in chips) 
Seat 8: SteigEin84 ($79.26 in chips) 
Seat 9: WrongButton ($50 in chips) 
i$BamboBlady$i: posts small blind $0.25
Chernovsky: is sitting out 
bellisimo212: posts big blind $0.50
*** HOLE CARDS ***
Chernovsky leaves the table
christyirish: folds 
jantheman222: raises $0.75 to $1.25
maisit*: folds 
whitecillar3: folds 
SteigEin84: folds 
WrongButton: folds 
BoryaKGB joins the table at seat #2 
i$BamboBlady$i: calls $1
bellisimo212: folds 
*** FLOP *** [Ah 7d 5c]
i$BamboBlady$i: checks 
jantheman222: bets $1.25
i$BamboBlady$i: calls $1.25
*** TURN *** [Ah 7d 5c] [5s]
i$BamboBlady$i: checks 
jantheman222: checks 
*** RIVER *** [Ah 7d 5c 5s] [Qd]
i$BamboBlady$i: bets $5.22
jantheman222: calls $5.22
*** SHOW DOWN ***
i$BamboBlady$i: shows [5d 4h] (three of a kind, Fives)
jantheman222: mucks hand 
i$BamboBlady$i collected $14.94 from pot
*** SUMMARY ***
Total pot $15.94 | Rake $1 
Board [Ah 7d 5c 5s Qd]
Seat 1: i$BamboBlady$i (small blind) showed [5d 4h] and won ($14.94) with three of a kind, Fives
Seat 3: bellisimo212 (big blind) folded before Flop
Seat 4: christyirish folded before Flop (didn't bet)
Seat 5: jantheman222 mucked
Seat 6: maisit* folded before Flop (didn't bet)
Seat 7: whitecillar3 folded before Flop (didn't bet)
Seat 8: SteigEin84 folded before Flop (didn't bet)
Seat 9: WrongButton (button) folded before Flop (didn't bet)



PokerStars Hand #228695759090:  Hold'em No Limit ($0.25/$0.50 USD) - 2021/07/30 22:03:19 ET
Table 'Aitne III' 9-max Seat #1 is the button
Seat 1: i$BamboBlady$i ($24.64 in chips) 
Seat 3: bellisimo212 ($49.57 in chips) 
Seat 4: christyirish ($50.18 in chips) 
Seat 5: jantheman222 ($57.74 in chips) 
Seat 6: maisit* ($85.07 in chips) 
Seat 7: whitecillar3 ($54.65 in chips) 
Seat 8: SteigEin84 ($79.26 in chips) 
Seat 9: WrongButton ($50 in chips) 
bellisimo212: posts small blind $0.25
christyirish: posts big blind $0.50
*** HOLE CARDS ***
jantheman222: folds 
maisit*: folds 
whitecillar3: raises $0.75 to $1.25
SteigEin84: folds 
WrongButton: folds 
i$BamboBlady$i: calls $1.25
bellisimo212: folds 
christyirish: folds 
*** FLOP *** [7s Qd 6c]
whitecillar3: checks 
i$BamboBlady$i: bets $1.54
whitecillar3: raises $3.15 to $4.69
i$BamboBlady$i: raises $18.70 to $23.39 and is all-in
whitecillar3: calls $18.70
*** TURN *** [7s Qd 6c] [3h]
*** RIVER *** [7s Qd 6c 3h] [Kc]
*** SHOW DOWN ***
whitecillar3: shows [Qh As] (a pair of Queens)
i$BamboBlady$i: shows [Jc Qs] (a pair of Queens - lower kicker)
whitecillar3 collected $48.03 from pot
*** SUMMARY ***
Total pot $50.03 | Rake $2 
Board [7s Qd 6c 3h Kc]
Seat 1: i$BamboBlady$i (button) showed [Jc Qs] and lost with a pair of Queens
Seat 3: bellisimo212 (small blind) folded before Flop
Seat 4: christyirish (big blind) folded before Flop
Seat 5: jantheman222 folded before Flop (didn't bet)
Seat 6: maisit* folded before Flop (didn't bet)
Seat 7: whitecillar3 showed [Qh As] and won ($48.03) with a pair of Queens
Seat 8: SteigEin84 folded before Flop (didn't bet)
Seat 9: WrongButton folded before Flop (didn't bet)



PokerStars Hand #228695770689:  Hold'em No Limit ($0.25/$0.50 USD) - 2021/07/30 22:04:06 ET
Table 'Aitne III' 9-max Seat #3 is the button
Seat 3: bellisimo212 ($49.32 in chips) 
Seat 4: christyirish ($50 in chips) 
Seat 5: jantheman222 ($57.74 in chips) 
Seat 6: maisit* ($85.07 in chips) 
Seat 7: whitecillar3 ($78.04 in chips) 
Seat 8: SteigEin84 ($79.26 in chips) 
Seat 9: WrongButton ($50 in chips) 
christyirish: posts small blind $0.25
jantheman222: posts big blind $0.50
BoryaKGB: sits out 
*** HOLE CARDS ***
maisit*: folds 
whitecillar3: folds 
SteigEin84: raises $1 to $1.50
WrongButton: folds 
i$BamboBlady$i leaves the table
bellisimo212: calls $1.50
christyirish: folds 
jantheman222: folds 
*** FLOP *** [9s 7s 5s]
SteigEin84: checks 
bellisimo212: checks 
*** TURN *** [9s 7s 5s] [4d]
ccownsu joins the table at seat #1 
SteigEin84: bets $1
bellisimo212: folds 
Uncalled bet ($1) returned to SteigEin84
SteigEin84 collected $3.51 from pot
SteigEin84: doesn't show hand 
*** SUMMARY ***
Total pot $3.75 | Rake $0.24 
Board [9s 7s 5s 4d]
Seat 3: bellisimo212 (button) folded on the Turn
Seat 4: christyirish (small blind) folded before Flop
Seat 5: jantheman222 (big blind) folded before Flop
Seat 6: maisit* folded before Flop (didn't bet)
Seat 7: whitecillar3 folded before Flop (didn't bet)
Seat 8: SteigEin84 collected ($3.51)
Seat 9: WrongButton folded before Flop (didn't bet)



PokerStars Hand #228695778490:  Hold'em No Limit ($0.25/$0.50 USD) - 2021/07/30 22:04:38 ET
Table 'Aitne III' 9-max Seat #4 is the button
Seat 3: bellisimo212 ($47.82 in chips) 
Seat 4: christyirish ($50 in chips) 
Seat 5: jantheman222 ($57.24 in chips) 
Seat 6: maisit* ($85.07 in chips) 
Seat 7: whitecillar3 ($78.04 in chips) 
Seat 8: SteigEin84 ($81.27 in chips) 
Seat 9: WrongButton ($50 in chips) 
jantheman222: posts small blind $0.25
maisit*: posts big blind $0.50
ccownsu: sits out 
BoryaKGB: sits out 
*** HOLE CARDS ***
whitecillar3: folds 
SteigEin84: raises $0.50 to $1
whitecillar3 leaves the table
WrongButton: calls $1
bellisimo212: folds 
christyirish: calls $1
jantheman222: folds 
maisit*: folds 
*** FLOP *** [2h 5h Th]
SteigEin84: bets $0.50
WrongButton: calls $0.50
christyirish: raises $3.80 to $4.30
SteigEin84: calls $3.80
WrongButton: folds 
*** TURN *** [2h 5h Th] [5s]
SteigEin84: checks 
christyirish: bets $6.11
SteigEin84: calls $6.11
*** RIVER *** [2h 5h Th 5s] [9c]
saradb94 joins the table at seat #7 
SteigEin84: bets $11.91
saradb94 leaves the table
christyirish: raises $26.68 to $38.59 and is all-in
SteigEin84: calls $26.68
*** SHOW DOWN ***
christyirish: shows [6h Kh] (a flush, King high)
SteigEin84: shows [As Ad] (two pair, Aces and Fives)
christyirish collected $100.25 from pot
*** SUMMARY ***
Total pot $102.25 | Rake $2 
Board [2h 5h Th 5s 9c]
Seat 3: bellisimo212 folded before Flop (didn't bet)
Seat 4: christyirish (button) showed [6h Kh] and won ($100.25) with a flush, King high
Seat 5: jantheman222 (small blind) folded before Flop
Seat 6: maisit* (big blind) folded before Flop
Seat 7: whitecillar3 folded before Flop (didn't bet)
Seat 8: SteigEin84 showed [As Ad] and lost with two pair, Aces and Fives
Seat 9: WrongButton folded on the Flop



PokerStars Hand #228695794187:  Hold'em No Limit ($0.25/$0.50 USD) - 2021/07/30 22:05:43 ET
Table 'Aitne III' 9-max Seat #5 is the button
Seat 3: bellisimo212 ($47.82 in chips) 
Seat 4: christyirish ($100.25 in chips) 
Seat 5: jantheman222 ($56.99 in chips) 
Seat 6: maisit* ($84.57 in chips) 
Seat 8: SteigEin84 ($31.27 in chips) 
Seat 9: WrongButton ($50 in chips) 
maisit*: posts small blind $0.25
SteigEin84: posts big blind $0.50
ccownsu: sits out 
BoryaKGB: sits out 
*** HOLE CARDS ***
WrongButton: folds 
bellisimo212: folds 
christyirish: raises $1 to $1.50
jantheman222: folds 
maisit*: folds 
SteigEin84: calls $1
*** FLOP *** [3s 7d Jc]
SteigEin84: checks 
christyirish: checks 
*** TURN *** [3s 7d Jc] [6d]
SteigEin84: bets $1.50
maestrodubai joins the table at seat #7 
christyirish: folds 
Uncalled bet ($1.50) returned to SteigEin84
SteigEin84 collected $3.05 from pot
SteigEin84: doesn't show hand 
*** SUMMARY ***
Total pot $3.25 | Rake $0.20 
Board [3s 7d Jc 6d]
Seat 3: bellisimo212 folded before Flop (didn't bet)
Seat 4: christyirish folded on the Turn
Seat 5: jantheman222 (button) folded before Flop (didn't bet)
Seat 6: maisit* (small blind) folded before Flop
Seat 8: SteigEin84 (big blind) collected ($3.05)
Seat 9: WrongButton folded before Flop (didn't bet)



PokerStars Hand #228695804888:  Hold'em No Limit ($0.25/$0.50 USD) - 2021/07/30 22:06:27 ET
Table 'Aitne III' 9-max Seat #6 is the button
Seat 3: bellisimo212 ($47.82 in chips) 
Seat 4: christyirish ($98.75 in chips) 
Seat 5: jantheman222 ($56.99 in chips) 
Seat 6: maisit* ($84.32 in chips) 
Seat 8: SteigEin84 ($32.82 in chips) 
Seat 9: WrongButton ($50 in chips) 
SteigEin84: posts small blind $0.25
WrongButton: posts big blind $0.50
ccownsu: sits out 
BoryaKGB: sits out 
*** HOLE CARDS ***
bellisimo212: calls $0.50
christyirish: calls $0.50
jantheman222: folds 
maisit*: folds 
SteigEin84: calls $0.25
WrongButton: checks 
*** FLOP *** [3c Qd 3s]
SteigEin84: checks 
WrongButton: checks 
bellisimo212: checks 
christyirish: checks 
*** TURN *** [3c Qd 3s] [5c]
SteigEin84: bets $1
WrongButton: calls $1
bellisimo212: raises $1 to $2
christyirish: folds 
SteigEin84: calls $1
WrongButton: folds 
*** RIVER *** [3c Qd 3s 5c] [Ac]
SteigEin84: checks 
bellisimo212: checks 
*** SHOW DOWN ***
SteigEin84: shows [6d 5s] (two pair, Fives and Threes)
bellisimo212: shows [3d Kd] (three of a kind, Threes)
bellisimo212 collected $6.65 from pot
*** SUMMARY ***
Total pot $7 | Rake $0.35 
Board [3c Qd 3s 5c Ac]
Seat 3: bellisimo212 showed [3d Kd] and won ($6.65) with three of a kind, Threes
Seat 4: christyirish folded on the Turn
Seat 5: jantheman222 folded before Flop (didn't bet)
Seat 6: maisit* (button) folded before Flop (didn't bet)
Seat 8: SteigEin84 (small blind) showed [6d 5s] and lost with two pair, Fives and Threes
Seat 9: WrongButton (big blind) folded on the Turn



PokerStars Hand #228695817342:  Hold'em No Limit ($0.25/$0.50 USD) - 2021/07/30 22:07:19 ET
Table 'Aitne III' 9-max Seat #8 is the button
Seat 1: ccownsu ($50 in chips) 
Seat 3: bellisimo212 ($51.97 in chips) 
Seat 4: christyirish ($98.25 in chips) 
Seat 5: jantheman222 ($56.99 in chips) 
Seat 6: maisit* ($84.32 in chips) 
Seat 7: maestrodubai ($47.89 in chips) 
Seat 8: SteigEin84 ($30.32 in chips) 
Seat 9: WrongButton ($50 in chips) 
WrongButton: posts small blind $0.25
ccownsu: posts big blind $0.50
BoryaKGB: sits out 
maestrodubai: posts big blind $0.50
*** HOLE CARDS ***
bellisimo212: folds 
christyirish: folds 
jantheman222: folds 
maisit*: folds 
maestrodubai: checks 
SteigEin84: calls $0.50
WrongButton: folds 
ccownsu: checks 
*** FLOP *** [Js Th 8c]
ccownsu: checks 
maestrodubai: checks 
SteigEin84: bets $1
ccownsu: folds 
maestrodubai: folds 
Uncalled bet ($1) returned to SteigEin84
SteigEin84 collected $1.64 from pot
SteigEin84: doesn't show hand 
*** SUMMARY ***
Total pot $1.75 | Rake $0.11 
Board [Js Th 8c]
Seat 1: ccownsu (big blind) folded on the Flop
Seat 3: bellisimo212 folded before Flop (didn't bet)
Seat 4: christyirish folded before Flop (didn't bet)
Seat 5: jantheman222 folded before Flop (didn't bet)
Seat 6: maisit* folded before Flop (didn't bet)
Seat 7: maestrodubai folded on the Flop (didn't bet)
Seat 8: SteigEin84 (button) collected ($1.64)
Seat 9: WrongButton (small blind) folded before Flop



PokerStars Hand #228695828452:  Hold'em No Limit ($0.25/$0.50 USD) - 2021/07/30 22:08:05 ET
Table 'Aitne III' 9-max Seat #9 is the button
Seat 1: ccownsu ($49.50 in chips) 
Seat 2: BoryaKGB ($50 in chips) 
Seat 3: bellisimo212 ($51.97 in chips) 
Seat 4: christyirish ($98.25 in chips) 
Seat 5: jantheman222 ($56.99 in chips) 
Seat 6: maisit* ($84.32 in chips) 
Seat 7: maestrodubai ($47.39 in chips) 
Seat 8: SteigEin84 ($31.46 in chips) 
Seat 9: WrongButton ($50 in chips) 
ccownsu: posts small blind $0.25
BoryaKGB: posts big blind $0.50
*** HOLE CARDS ***
bellisimo212: folds 
christyirish: folds 
jantheman222: folds 
maisit*: folds 
maestrodubai: raises $1 to $1.50
SteigEin84: folds 
WrongButton: folds 
ccownsu: folds 
BoryaKGB: calls $1
*** FLOP *** [4s 5s Kh]
BoryaKGB: checks 
maestrodubai: checks 
*** TURN *** [4s 5s Kh] [4c]
BoryaKGB: checks 
maestrodubai: bets $1
BoryaKGB: folds 
Uncalled bet ($1) returned to maestrodubai
maestrodubai collected $3.09 from pot
maestrodubai: doesn't show hand 
*** SUMMARY ***
Total pot $3.25 | Rake $0.16 
Board [4s 5s Kh 4c]
Seat 1: ccownsu (small blind) folded before Flop
Seat 2: BoryaKGB (big blind) folded on the Turn
Seat 3: bellisimo212 folded before Flop (didn't bet)
Seat 4: christyirish folded before Flop (didn't bet)
Seat 5: jantheman222 folded before Flop (didn't bet)
Seat 6: maisit* folded before Flop (didn't bet)
Seat 7: maestrodubai collected ($3.09)
Seat 8: SteigEin84 folded before Flop (didn't bet)
Seat 9: WrongButton (button) folded before Flop (didn't bet)



PokerStars Hand #228695836917:  Hold'em No Limit ($0.25/$0.50 USD) - 2021/07/30 22:08:40 ET
Table 'Aitne III' 9-max Seat #1 is the button
Seat 1: ccownsu ($49.25 in chips) 
Seat 2: BoryaKGB ($50 in chips) 
Seat 3: bellisimo212 ($51.97 in chips) 
Seat 5: jantheman222 ($56.99 in chips) 
Seat 6: maisit* ($84.32 in chips) 
Seat 7: maestrodubai ($48.98 in chips) 
Seat 8: SteigEin84 ($31.46 in chips) 
Seat 9: WrongButton ($50 in chips) 
BoryaKGB: posts small blind $0.25
bellisimo212: posts big blind $0.50
*** HOLE CARDS ***
jantheman222: raises $0.75 to $1.25
maisit*: folds 
maestrodubai: folds 
SteigEin84: calls $1.25
WrongButton: raises $3.75 to $5
ccownsu: folds 
BoryaKGB: folds 
bellisimo212: folds 
jantheman222: folds 
SteigEin84: calls $3.75
*** FLOP *** [6d Qs 4d]
SteigEin84: bets $5
WrongButton: raises $14 to $19
SteigEin84: folds 
Uncalled bet ($14) returned to WrongButton
WrongButton collected $20.90 from pot
*** SUMMARY ***
Total pot $22 | Rake $1.10 
Board [6d Qs 4d]
Seat 1: ccownsu (button) folded before Flop (didn't bet)
Seat 2: BoryaKGB (small blind) folded before Flop
Seat 3: bellisimo212 (big blind) folded before Flop
Seat 5: jantheman222 folded before Flop
Seat 6: maisit* folded before Flop (didn't bet)
Seat 7: maestrodubai folded before Flop (didn't bet)
Seat 8: SteigEin84 folded on the Flop
Seat 9: WrongButton collected ($20.90)



PokerStars Hand #228695870577:  Hold'em No Limit ($0.25/$0.50 USD) - 2021/07/30 22:09:48 ET
Table 'Aitne III' 9-max Seat #2 is the button
Seat 1: ccownsu ($49.25 in chips) 
Seat 2: BoryaKGB ($50 in chips) 
Seat 3: bellisimo212 ($51.47 in chips) 
Seat 5: jantheman222 ($55.74 in chips) 
Seat 6: maisit* ($84.32 in chips) 
Seat 7: maestrodubai ($48.98 in chips) 
Seat 8: SteigEin84 ($21.46 in chips) 
Seat 9: WrongButton ($60.90 in chips) 
bellisimo212: posts small blind $0.25
jantheman222: posts big blind $0.50
*** HOLE CARDS ***
maisit*: folds 
maestrodubai: folds 
SteigEin84: folds 
WrongButton: folds 
ccownsu: folds 
BoryaKGB: folds 
bellisimo212: calls $0.25
jantheman222: checks 
*** FLOP *** [9s 6c 8c]
bellisimo212: checks 
jantheman222: bets $0.50
bellisimo212: folds 
Uncalled bet ($0.50) returned to jantheman222
jantheman222 collected $0.95 from pot
jantheman222: doesn't show hand 
*** SUMMARY ***
Total pot $1 | Rake $0.05 
Board [9s 6c 8c]
Seat 1: ccownsu folded before Flop (didn't bet)
Seat 2: BoryaKGB (button) folded before Flop (didn't bet)
Seat 3: bellisimo212 (small blind) folded on the Flop
Seat 5: jantheman222 (big blind) collected ($0.95)
Seat 6: maisit* folded before Flop (didn't bet)
Seat 7: maestrodubai folded before Flop (didn't bet)
Seat 8: SteigEin84 folded before Flop (didn't bet)
Seat 9: WrongButton folded before Flop (didn't bet)



PokerStars Hand #228695877115:  Hold'em No Limit ($0.25/$0.50 USD) - 2021/07/30 22:10:15 ET
Table 'Aitne III' 9-max Seat #3 is the button
Seat 1: ccownsu ($49.25 in chips) 
Seat 2: BoryaKGB ($50 in chips) 
Seat 3: bellisimo212 ($50.97 in chips) 
Seat 5: jantheman222 ($56.19 in chips) 
Seat 6: maisit* ($84.32 in chips) 
Seat 7: maestrodubai ($48.98 in chips) 
Seat 8: SteigEin84 ($21.46 in chips) 
Seat 9: WrongButton ($60.90 in chips) 
jantheman222: posts small blind $0.25
maisit*: posts big blind $0.50
*** HOLE CARDS ***
maestrodubai: folds 
SteigEin84: calls $0.50
WrongButton: raises $1.50 to $2
ccownsu: folds 
BoryaKGB: folds 
bellisimo212: folds 
jantheman222: folds 
maisit*: folds 
SteigEin84: calls $1.50
*** FLOP *** [Ts 2c Ac]
SteigEin84: checks 
WrongButton: bets $3
SteigEin84: calls $3
*** TURN *** [Ts 2c Ac] [Ks]
SteigEin84: checks 
WrongButton: bets $7.25
SteigEin84: folds 
Uncalled bet ($7.25) returned to WrongButton
WrongButton collected $10.21 from pot
*** SUMMARY ***
Total pot $10.75 | Rake $0.54 
Board [Ts 2c Ac Ks]
Seat 1: ccownsu folded before Flop (didn't bet)
Seat 2: BoryaKGB folded before Flop (didn't bet)
Seat 3: bellisimo212 (button) folded before Flop (didn't bet)
Seat 5: jantheman222 (small blind) folded before Flop
Seat 6: maisit* (big blind) folded before Flop
Seat 7: maestrodubai folded before Flop (didn't bet)
Seat 8: SteigEin84 folded on the Turn
Seat 9: WrongButton collected ($10.21)



PokerStars Hand #228695888341:  Hold'em No Limit ($0.25/$0.50 USD) - 2021/07/30 22:11:02 ET
Table 'Aitne III' 9-max Seat #5 is the button
Seat 1: ccownsu ($49.25 in chips) 
Seat 2: BoryaKGB ($50 in chips) 
Seat 3: bellisimo212 ($50.97 in chips) 
Seat 4: christyirish ($98.25 in chips) 
Seat 5: jantheman222 ($55.94 in chips) 
Seat 6: maisit* ($83.82 in chips) 
Seat 7: maestrodubai ($48.98 in chips) 
Seat 8: SteigEin84 ($16.46 in chips) 
Seat 9: WrongButton ($66.11 in chips) 
maisit*: posts small blind $0.25
maestrodubai: posts big blind $0.50
christyirish: posts small & big blinds $0.75
*** HOLE CARDS ***
SteigEin84: folds 
WrongButton: folds 
ccownsu: raises $1 to $1.50
BoryaKGB: folds 
bellisimo212: folds 
christyirish: folds 
jantheman222: calls $1.50
maisit*: raises $6 to $7.50
maestrodubai: folds 
ccownsu: folds 
jantheman222: calls $6
*** FLOP *** [Jd Jc Jh]
maisit*: checks 
jantheman222: bets $5.56
maisit*: calls $5.56
*** TURN *** [Jd Jc Jh] [Qh]
maisit*: checks 
jantheman222: checks 
*** RIVER *** [Jd Jc Jh Qh] [Ts]
maisit*: checks 
jantheman222: checks 
*** SHOW DOWN ***
maisit*: shows [8d 8h] (a full house, Jacks full of Eights)
jantheman222: shows [Td Th] (a full house, Jacks full of Tens)
jantheman222 collected $27.43 from pot
*** SUMMARY ***
Total pot $28.87 | Rake $1.44 
Board [Jd Jc Jh Qh Ts]
Seat 1: ccownsu folded before Flop
Seat 2: BoryaKGB folded before Flop (didn't bet)
Seat 3: bellisimo212 folded before Flop (didn't bet)
Seat 4: christyirish folded before Flop (didn't bet)
Seat 5: jantheman222 (button) showed [Td Th] and won ($27.43) with a full house, Jacks full of Tens
Seat 6: maisit* (small blind) showed [8d 8h] and lost with a full house, Jacks full of Eights
Seat 7: maestrodubai (big blind) folded before Flop
Seat 8: SteigEin84 folded before Flop (didn't bet)
Seat 9: WrongButton folded before Flop (didn't bet)



PokerStars Hand #228695908647:  Hold'em No Limit ($0.25/$0.50 USD) - 2021/07/30 22:12:27 ET
Table 'Aitne III' 9-max Seat #6 is the button
Seat 1: ccownsu ($47.75 in chips) 
Seat 2: BoryaKGB ($50 in chips) 
Seat 3: bellisimo212 ($50.97 in chips) 
Seat 4: christyirish ($97.50 in chips) 
Seat 5: jantheman222 ($70.31 in chips) 
Seat 6: maisit* ($70.76 in chips) 
Seat 7: maestrodubai ($48.48 in chips) 
Seat 8: SteigEin84 ($16.46 in chips) 
Seat 9: WrongButton ($66.11 in chips) 
maestrodubai: posts small blind $0.25
SteigEin84: posts big blind $0.50
*** HOLE CARDS ***
WrongButton: folds 
ccownsu: folds 
BoryaKGB: folds 
bellisimo212: calls $0.50
christyirish: folds 
jantheman222: folds 
maisit*: folds 
maestrodubai: calls $0.25
SteigEin84: checks 
*** FLOP *** [Kd 7s 6c]
maestrodubai: checks 
SteigEin84: checks 
bellisimo212: checks 
*** TURN *** [Kd 7s 6c] [Jc]
maestrodubai: bets $0.71
SteigEin84: folds 
bellisimo212: calls $0.71
*** RIVER *** [Kd 7s 6c Jc] [3h]
maestrodubai: checks 
bellisimo212: checks 
*** SHOW DOWN ***
maestrodubai: shows [Th Qs] (high card King)
bellisimo212: shows [Tc Kc] (a pair of Kings)
bellisimo212 collected $2.77 from pot
*** SUMMARY ***
Total pot $2.92 | Rake $0.15 
Board [Kd 7s 6c Jc 3h]
Seat 1: ccownsu folded before Flop (didn't bet)
Seat 2: BoryaKGB folded before Flop (didn't bet)
Seat 3: bellisimo212 showed [Tc Kc] and won ($2.77) with a pair of Kings
Seat 4: christyirish folded before Flop (didn't bet)
Seat 5: jantheman222 folded before Flop (didn't bet)
Seat 6: maisit* (button) folded before Flop (didn't bet)
Seat 7: maestrodubai (small blind) showed [Th Qs] and lost with high card King
Seat 8: SteigEin84 (big blind) folded on the Turn
Seat 9: WrongButton folded before Flop (didn't bet)



PokerStars Hand #228695919052:  Hold'em No Limit ($0.25/$0.50 USD) - 2021/07/30 22:13:11 ET
Table 'Aitne III' 9-max Seat #7 is the button
Seat 1: ccownsu ($47.75 in chips) 
Seat 2: BoryaKGB ($50 in chips) 
Seat 3: bellisimo212 ($52.53 in chips) 
Seat 4: christyirish ($97.50 in chips) 
Seat 5: jantheman222 ($70.31 in chips) 
Seat 6: maisit* ($70.76 in chips) 
Seat 7: maestrodubai ($47.27 in chips) 
Seat 8: SteigEin84 ($15.96 in chips) 
Seat 9: WrongButton ($66.11 in chips) 
SteigEin84: posts small blind $0.25
WrongButton: posts big blind $0.50
*** HOLE CARDS ***
ccownsu: folds 
BoryaKGB: folds 
bellisimo212: calls $0.50
christyirish: folds 
jantheman222: raises $1.50 to $2
maisit*: folds 
maestrodubai: folds 
SteigEin84: folds 
WrongButton: calls $1.50
bellisimo212: calls $1.50
*** FLOP *** [9d 3h 7c]
WrongButton: checks 
bellisimo212: checks 
jantheman222: checks 
*** TURN *** [9d 3h 7c] [4h]
WrongButton: checks 
bellisimo212: bets $3.50
jantheman222: folds 
WrongButton: folds 
Uncalled bet ($3.50) returned to bellisimo212
bellisimo212 collected $5.94 from pot
bellisimo212: doesn't show hand 
*** SUMMARY ***
Total pot $6.25 | Rake $0.31 
Board [9d 3h 7c 4h]
Seat 1: ccownsu folded before Flop (didn't bet)
Seat 2: BoryaKGB folded before Flop (didn't bet)
Seat 3: bellisimo212 collected ($5.94)
Seat 4: christyirish folded before Flop (didn't bet)
Seat 5: jantheman222 folded on the Turn
Seat 6: maisit* folded before Flop (didn't bet)
Seat 7: maestrodubai (button) folded before Flop (didn't bet)
Seat 8: SteigEin84 (small blind) folded before Flop
Seat 9: WrongButton (big blind) folded on the Turn



PokerStars Hand #228695933509:  Hold'em No Limit ($0.25/$0.50 USD) - 2021/07/30 22:14:11 ET
Table 'Aitne III' 9-max Seat #8 is the button
Seat 1: ccownsu ($47.75 in chips) 
Seat 2: BoryaKGB ($50 in chips) 
Seat 3: bellisimo212 ($56.47 in chips) 
Seat 4: christyirish ($97.50 in chips) 
Seat 5: jantheman222 ($68.31 in chips) 
Seat 6: maisit* ($70.76 in chips) 
Seat 7: maestrodubai ($47.27 in chips) 
Seat 8: SteigEin84 ($15.71 in chips) 
Seat 9: WrongButton ($64.11 in chips) 
WrongButton: posts small blind $0.25
ccownsu: posts big blind $0.50
*** HOLE CARDS ***
BoryaKGB: folds 
bellisimo212: calls $0.50
christyirish: raises $1.75 to $2.25
jantheman222: folds 
maisit*: raises $5.25 to $7.50
maestrodubai: folds 
SteigEin84: calls $7.50
WrongButton: folds 
ccownsu: folds 
bellisimo212: folds 
christyirish: calls $5.25
*** FLOP *** [5c 3d 4h]
christyirish: checks 
maisit*: checks 
SteigEin84: bets $8.21 and is all-in
christyirish: folds 
maisit*: calls $8.21
*** TURN *** [5c 3d 4h] [7s]
*** RIVER *** [5c 3d 4h 7s] [Ad]
*** SHOW DOWN ***
maisit*: shows [As Kd] (a pair of Aces)
SteigEin84: shows [Jc Jh] (a pair of Jacks)
maisit* collected $38.17 from pot
*** SUMMARY ***
Total pot $40.17 | Rake $2 
Board [5c 3d 4h 7s Ad]
Seat 1: ccownsu (big blind) folded before Flop
Seat 2: BoryaKGB folded before Flop (didn't bet)
Seat 3: bellisimo212 folded before Flop
Seat 4: christyirish folded on the Flop
Seat 5: jantheman222 folded before Flop (didn't bet)
Seat 6: maisit* showed [As Kd] and won ($38.17) with a pair of Aces
Seat 7: maestrodubai folded before Flop (didn't bet)
Seat 8: SteigEin84 (button) showed [Jc Jh] and lost with a pair of Jacks
Seat 9: WrongButton (small blind) folded before Flop



PokerStars Hand #228695944868:  Hold'em No Limit ($0.25/$0.50 USD) - 2021/07/30 22:15:00 ET
Table 'Aitne III' 9-max Seat #9 is the button
Seat 1: ccownsu ($47.25 in chips) 
Seat 2: BoryaKGB ($50 in chips) 
Seat 3: bellisimo212 ($55.97 in chips) 
Seat 4: christyirish ($90 in chips) 
Seat 5: jantheman222 ($68.31 in chips) 
Seat 6: maisit* ($93.22 in chips) 
Seat 7: maestrodubai ($47.27 in chips) 
Seat 9: WrongButton ($63.86 in chips) 
ccownsu: posts small blind $0.25
BoryaKGB: posts big blind $0.50
*** HOLE CARDS ***
bellisimo212: calls $0.50
christyirish: folds 
jantheman222: folds 
maisit*: folds 
maestrodubai: folds 
WrongButton: folds 
ccownsu: calls $0.25
BoryaKGB: checks 
*** FLOP *** [5h Ad 7s]
ccownsu: checks 
BoryaKGB: checks 
bellisimo212: checks 
*** TURN *** [5h Ad 7s] [7c]
ccownsu: checks 
BoryaKGB: checks 
bellisimo212: checks 
*** RIVER *** [5h Ad 7s 7c] [4d]
ccownsu: checks 
BoryaKGB: bets $0.71
bellisimo212: folds 
ccownsu: folds 
Uncalled bet ($0.71) returned to BoryaKGB
BoryaKGB collected $1.42 from pot
BoryaKGB: doesn't show hand 
*** SUMMARY ***
Total pot $1.50 | Rake $0.08 
Board [5h Ad 7s 7c 4d]
Seat 1: ccownsu (small blind) folded on the River
Seat 2: BoryaKGB (big blind) collected ($1.42)
Seat 3: bellisimo212 folded on the River
Seat 4: christyirish folded before Flop (didn't bet)
Seat 5: jantheman222 folded before Flop (didn't bet)
Seat 6: maisit* folded before Flop (didn't bet)
Seat 7: maestrodubai folded before Flop (didn't bet)
Seat 9: WrongButton (button) folded before Flop (didn't bet)



PokerStars Hand #228695956640:  Hold'em No Limit ($0.25/$0.50 USD) - 2021/07/30 22:15:50 ET
Table 'Aitne III' 9-max Seat #1 is the button
Seat 1: ccownsu ($46.75 in chips) 
Seat 2: BoryaKGB ($50.92 in chips) 
Seat 3: bellisimo212 ($55.47 in chips) 
Seat 4: christyirish ($90 in chips) 
Seat 5: jantheman222 ($68.31 in chips) 
Seat 6: maisit* ($93.22 in chips) 
Seat 7: maestrodubai ($47.27 in chips) 
Seat 8: SteigEin84 ($40.04 in chips) 
Seat 9: WrongButton ($63.86 in chips) 
BoryaKGB: posts small blind $0.25
bellisimo212: posts big blind $0.50
*** HOLE CARDS ***
christyirish: folds 
jantheman222: raises $0.75 to $1.25
maisit*: folds 
maestrodubai: folds 
SteigEin84: calls $1.25
WrongButton: raises $3.75 to $5
ccownsu: folds 
BoryaKGB: folds 
bellisimo212: folds 
jantheman222: calls $3.75
SteigEin84: folds 
*** FLOP *** [9d Jd 9c]
jantheman222: checks 
WrongButton: bets $4
jantheman222: calls $4
*** TURN *** [9d Jd 9c] [3c]
jantheman222: checks 
WrongButton: checks 
*** RIVER *** [9d Jd 9c 3c] [Jc]
jantheman222: bets $6.27
WrongButton: calls $6.27
*** SHOW DOWN ***
jantheman222: shows [Qd Qh] (two pair, Queens and Jacks)
WrongButton: mucks hand 
jantheman222 collected $30.91 from pot
*** SUMMARY ***
Total pot $32.54 | Rake $1.63 
Board [9d Jd 9c 3c Jc]
Seat 1: ccownsu (button) folded before Flop (didn't bet)
Seat 2: BoryaKGB (small blind) folded before Flop
Seat 3: bellisimo212 (big blind) folded before Flop
Seat 4: christyirish folded before Flop (didn't bet)
Seat 5: jantheman222 showed [Qd Qh] and won ($30.91) with two pair, Queens and Jacks
Seat 6: maisit* folded before Flop (didn't bet)
Seat 7: maestrodubai folded before Flop (didn't bet)
Seat 8: SteigEin84 folded before Flop
Seat 9: WrongButton mucked



PokerStars Hand #228695983237:  Hold'em No Limit ($0.25/$0.50 USD) - 2021/07/30 22:17:43 ET
Table 'Aitne III' 9-max Seat #2 is the button
Seat 1: ccownsu ($46.75 in chips) 
Seat 2: BoryaKGB ($50.67 in chips) 
Seat 3: bellisimo212 ($54.97 in chips) 
Seat 4: christyirish ($90 in chips) 
Seat 5: jantheman222 ($83.95 in chips) 
Seat 6: maisit* ($93.22 in chips) 
Seat 7: maestrodubai ($47.27 in chips) 
Seat 8: SteigEin84 ($38.79 in chips) 
Seat 9: WrongButton ($50 in chips) 
bellisimo212: posts small blind $0.25
christyirish: posts big blind $0.50
*** HOLE CARDS ***
jantheman222: folds 
maisit*: folds 
maestrodubai: folds 
SteigEin84: raises $1 to $1.50
WrongButton: folds 
ccownsu: folds 
BoryaKGB: folds 
bellisimo212: folds 
christyirish: folds 
Uncalled bet ($1) returned to SteigEin84
SteigEin84 collected $1.25 from pot
SteigEin84: doesn't show hand 
*** SUMMARY ***
Total pot $1.25 | Rake $0 
Seat 1: ccownsu folded before Flop (didn't bet)
Seat 2: BoryaKGB (button) folded before Flop (didn't bet)
Seat 3: bellisimo212 (small blind) folded before Flop
Seat 4: christyirish (big blind) folded before Flop
Seat 5: jantheman222 folded before Flop (didn't bet)
Seat 6: maisit* folded before Flop (didn't bet)
Seat 7: maestrodubai folded before Flop (didn't bet)
Seat 8: SteigEin84 collected ($1.25)
Seat 9: WrongButton folded before Flop (didn't bet)



PokerStars Hand #228695988852:  Hold'em No Limit ($0.25/$0.50 USD) - 2021/07/30 22:18:07 ET
Table 'Aitne III' 9-max Seat #3 is the button
Seat 1: ccownsu ($46.75 in chips) 
Seat 2: BoryaKGB ($50.67 in chips) 
Seat 3: bellisimo212 ($54.72 in chips) 
Seat 4: christyirish ($89.50 in chips) 
Seat 5: jantheman222 ($83.95 in chips) 
Seat 6: maisit* ($93.22 in chips) 
Seat 7: maestrodubai ($47.27 in chips) 
Seat 8: SteigEin84 ($39.54 in chips) 
Seat 9: WrongButton ($50 in chips) 
christyirish: posts small blind $0.25
jantheman222: posts big blind $0.50
*** HOLE CARDS ***
maisit*: folds 
maestrodubai: folds 
SteigEin84: folds 
WrongButton: folds 
ccownsu: folds 
BoryaKGB: raises $0.75 to $1.25
bellisimo212: folds 
christyirish: folds 
jantheman222: folds 
Uncalled bet ($0.75) returned to BoryaKGB
BoryaKGB collected $1.25 from pot
BoryaKGB: doesn't show hand 
*** SUMMARY ***
Total pot $1.25 | Rake $0 
Seat 1: ccownsu folded before Flop (didn't bet)
Seat 2: BoryaKGB collected ($1.25)
Seat 3: bellisimo212 (button) folded before Flop (didn't bet)
Seat 4: christyirish (small blind) folded before Flop
Seat 5: jantheman222 (big blind) folded before Flop
Seat 6: maisit* folded before Flop (didn't bet)
Seat 7: maestrodubai folded before Flop (didn't bet)
Seat 8: SteigEin84 folded before Flop (didn't bet)
Seat 9: WrongButton folded before Flop (didn't bet)



PokerStars Hand #228695995450:  Hold'em No Limit ($0.25/$0.50 USD) - 2021/07/30 22:18:35 ET
Table 'Aitne III' 9-max Seat #4 is the button
Seat 1: ccownsu ($46.75 in chips) 
Seat 2: BoryaKGB ($51.42 in chips) 
Seat 3: bellisimo212 ($54.72 in chips) 
Seat 4: christyirish ($89.25 in chips) 
Seat 5: jantheman222 ($83.45 in chips) 
Seat 6: maisit* ($93.22 in chips) 
Seat 7: maestrodubai ($47.27 in chips) 
Seat 8: SteigEin84 ($39.54 in chips) 
Seat 9: WrongButton ($50 in chips) 
jantheman222: posts small blind $0.25
maisit*: posts big blind $0.50
*** HOLE CARDS ***
maestrodubai: folds 
SteigEin84: folds 
WrongButton: folds 
ccownsu: folds 
BoryaKGB: folds 
bellisimo212: folds 
christyirish: raises $1 to $1.50
jantheman222: folds 
maisit*: folds 
Uncalled bet ($1) returned to christyirish
christyirish collected $1.25 from pot
*** SUMMARY ***
Total pot $1.25 | Rake $0 
Seat 1: ccownsu folded before Flop (didn't bet)
Seat 2: BoryaKGB folded before Flop (didn't bet)
Seat 3: bellisimo212 folded before Flop (didn't bet)
Seat 4: christyirish (button) collected ($1.25)
Seat 5: jantheman222 (small blind) folded before Flop
Seat 6: maisit* (big blind) folded before Flop
Seat 7: maestrodubai folded before Flop (didn't bet)
Seat 8: SteigEin84 folded before Flop (didn't bet)
Seat 9: WrongButton folded before Flop (didn't bet)



PokerStars Hand #228696000441:  Hold'em No Limit ($0.25/$0.50 USD) - 2021/07/30 22:18:57 ET
Table 'Aitne III' 9-max Seat #5 is the button
Seat 1: ccownsu ($46.75 in chips) 
Seat 2: BoryaKGB ($51.42 in chips) 
Seat 3: bellisimo212 ($54.72 in chips) 
Seat 4: christyirish ($90 in chips) 
Seat 5: jantheman222 ($83.20 in chips) 
Seat 6: maisit* ($92.72 in chips) 
Seat 7: maestrodubai ($47.27 in chips) 
Seat 8: SteigEin84 ($39.54 in chips) 
Seat 9: WrongButton ($50 in chips) 
maisit*: posts small blind $0.25
maestrodubai: posts big blind $0.50
*** HOLE CARDS ***
SteigEin84: calls $0.50
WrongButton: raises $1 to $1.50
ccownsu: calls $1.50
BoryaKGB: folds 
bellisimo212: folds 
christyirish: folds 
jantheman222: calls $1.50
maisit*: folds 
maestrodubai: folds 
SteigEin84: calls $1
*** FLOP *** [3c 8c 4s]
SteigEin84: checks 
WrongButton: checks 
ccownsu: checks 
jantheman222: checks 
*** TURN *** [3c 8c 4s] [Ad]
SteigEin84: bets $1.50
WrongButton: folds 
ccownsu: calls $1.50
jantheman222: calls $1.50
*** RIVER *** [3c 8c 4s Ad] [6d]
SteigEin84: bets $2
ccownsu: folds 
jantheman222: calls $2
*** SHOW DOWN ***
SteigEin84: shows [Ts 8s] (a pair of Eights)
jantheman222: shows [9c 9h] (a pair of Nines)
jantheman222 collected $14.49 from pot
*** SUMMARY ***
Total pot $15.25 | Rake $0.76 
Board [3c 8c 4s Ad 6d]
Seat 1: ccownsu folded on the River
Seat 2: BoryaKGB folded before Flop (didn't bet)
Seat 3: bellisimo212 folded before Flop (didn't bet)
Seat 4: christyirish folded before Flop (didn't bet)
Seat 5: jantheman222 (button) showed [9c 9h] and won ($14.49) with a pair of Nines
Seat 6: maisit* (small blind) folded before Flop
Seat 7: maestrodubai (big blind) folded before Flop
Seat 8: SteigEin84 showed [Ts 8s] and lost with a pair of Eights
Seat 9: WrongButton folded on the Turn



PokerStars Hand #228696036408:  Hold'em No Limit ($0.25/$0.50 USD) - 2021/07/30 22:21:10 ET
Table 'Aitne III' 9-max Seat #7 is the button
Seat 1: ccownsu ($43.75 in chips) 
Seat 2: BoryaKGB ($66.08 in chips) 
Seat 3: bellisimo212 ($54.72 in chips) 
Seat 4: christyirish ($90 in chips) 
Seat 5: jantheman222 ($92.69 in chips) 
Seat 6: maisit* ($92.47 in chips) 
Seat 7: maestrodubai ($46.52 in chips) 
Seat 8: SteigEin84 ($18.52 in chips) 
Seat 9: WrongButton ($50 in chips) 
SteigEin84: posts small blind $0.25
WrongButton: posts big blind $0.50
*** HOLE CARDS ***
ccownsu: folds 
BoryaKGB: folds 
bellisimo212: folds 
christyirish: raises $1 to $1.50
jantheman222: folds 
maisit*: folds 
maestrodubai: calls $1.50
SteigEin84: calls $1.25
WrongButton: calls $1
*** FLOP *** [2h 7d As]
SteigEin84: bets $1.50
WrongButton: calls $1.50
christyirish: raises $5.10 to $6.60
maestrodubai: folds 
SteigEin84: folds 
WrongButton: folds 
Uncalled bet ($5.10) returned to christyirish
christyirish collected $9.98 from pot
christyirish: doesn't show hand 
*** SUMMARY ***
Total pot $10.50 | Rake $0.52 
Board [2h 7d As]
Seat 1: ccownsu folded before Flop (didn't bet)
Seat 2: BoryaKGB folded before Flop (didn't bet)
Seat 3: bellisimo212 folded before Flop (didn't bet)
Seat 4: christyirish collected ($9.98)
Seat 5: jantheman222 folded before Flop (didn't bet)
Seat 6: maisit* folded before Flop (didn't bet)
Seat 7: maestrodubai (button) folded on the Flop
Seat 8: SteigEin84 (small blind) folded on the Flop
Seat 9: WrongButton (big blind) folded on the Flop



PokerStars Hand #228696020751:  Hold'em No Limit ($0.25/$0.50 USD) - 2021/07/30 22:20:03 ET
Table 'Aitne III' 9-max Seat #6 is the button
Seat 1: ccownsu ($43.75 in chips) 
Seat 2: BoryaKGB ($51.42 in chips) 
Seat 3: bellisimo212 ($54.72 in chips) 
Seat 4: christyirish ($90 in chips) 
Seat 5: jantheman222 ($92.69 in chips) 
Seat 6: maisit* ($92.47 in chips) 
Seat 7: maestrodubai ($46.77 in chips) 
Seat 8: SteigEin84 ($34.54 in chips) 
Seat 9: WrongButton ($50 in chips) 
maestrodubai: posts small blind $0.25
SteigEin84: posts big blind $0.50
*** HOLE CARDS ***
WrongButton: folds 
ccownsu: folds 
BoryaKGB: raises $0.75 to $1.25
bellisimo212: folds 
christyirish: folds 
jantheman222: folds 
maisit*: folds 
maestrodubai: folds 
SteigEin84: calls $0.75
*** FLOP *** [4s 3c Js]
SteigEin84: checks 
BoryaKGB: bets $1.96
SteigEin84: calls $1.96
*** TURN *** [4s 3c Js] [3s]
SteigEin84: checks 
BoryaKGB: bets $4.31
SteigEin84: calls $4.31
*** RIVER *** [4s 3c Js 3s] [5c]
SteigEin84: bets $8.50
BoryaKGB: calls $8.50
*** SHOW DOWN ***
SteigEin84: shows [5s Jh] (two pair, Jacks and Fives)
BoryaKGB: shows [As Ac] (two pair, Aces and Threes)
BoryaKGB collected $30.68 from pot
*** SUMMARY ***
Total pot $32.29 | Rake $1.61 
Board [4s 3c Js 3s 5c]
Seat 1: ccownsu folded before Flop (didn't bet)
Seat 2: BoryaKGB showed [As Ac] and won ($30.68) with two pair, Aces and Threes
Seat 3: bellisimo212 folded before Flop (didn't bet)
Seat 4: christyirish folded before Flop (didn't bet)
Seat 5: jantheman222 folded before Flop (didn't bet)
Seat 6: maisit* (button) folded before Flop (didn't bet)
Seat 7: maestrodubai (small blind) folded before Flop
Seat 8: SteigEin84 (big blind) showed [5s Jh] and lost with two pair, Jacks and Fives
Seat 9: WrongButton folded before Flop (didn't bet)



PokerStars Hand #228696047468:  Hold'em No Limit ($0.25/$0.50 USD) - 2021/07/30 22:21:57 ET
Table 'Aitne III' 9-max Seat #8 is the button
Seat 1: ccownsu ($43.75 in chips) 
Seat 2: BoryaKGB ($66.08 in chips) 
Seat 3: bellisimo212 ($54.72 in chips) 
Seat 4: christyirish ($96.98 in chips) 
Seat 5: jantheman222 ($92.69 in chips) 
Seat 6: maisit* ($92.47 in chips) 
Seat 7: maestrodubai ($45.02 in chips) 
Seat 8: SteigEin84 ($15.52 in chips) 
Seat 9: WrongButton ($50 in chips) 
WrongButton: posts small blind $0.25
ccownsu: posts big blind $0.50
*** HOLE CARDS ***
BoryaKGB: folds 
bellisimo212: calls $0.50
christyirish: folds 
jantheman222: folds 
maisit*: folds 
maestrodubai: folds 
SteigEin84: calls $0.50
WrongButton: raises $2.50 to $3
ccownsu: folds 
bellisimo212: folds 
SteigEin84: calls $2.50
*** FLOP *** [Kd 9c Tc]
WrongButton: checks 
SteigEin84: bets $3
WrongButton: raises $10.75 to $13.75
SteigEin84: folds 
Uncalled bet ($10.75) returned to WrongButton
WrongButton collected $12.35 from pot
*** SUMMARY ***
Total pot $13 | Rake $0.65 
Board [Kd 9c Tc]
Seat 1: ccownsu (big blind) folded before Flop
Seat 2: BoryaKGB folded before Flop (didn't bet)
Seat 3: bellisimo212 folded before Flop
Seat 4: christyirish folded before Flop (didn't bet)
Seat 5: jantheman222 folded before Flop (didn't bet)
Seat 6: maisit* folded before Flop (didn't bet)
Seat 7: maestrodubai folded before Flop (didn't bet)
Seat 8: SteigEin84 (button) folded on the Flop
Seat 9: WrongButton (small blind) collected ($12.35)



PokerStars Hand #228696059760:  Hold'em No Limit ($0.25/$0.50 USD) - 2021/07/30 22:22:50 ET
Table 'Aitne III' 9-max Seat #9 is the button
Seat 1: ccownsu ($43.25 in chips) 
Seat 2: BoryaKGB ($66.08 in chips) 
Seat 3: bellisimo212 ($54.22 in chips) 
Seat 4: christyirish ($96.98 in chips) 
Seat 5: jantheman222 ($92.69 in chips) 
Seat 6: maisit* ($92.47 in chips) 
Seat 7: maestrodubai ($45.02 in chips) 
Seat 8: SteigEin84 ($9.52 in chips) 
Seat 9: WrongButton ($56.35 in chips) 
ccownsu: posts small blind $0.25
BoryaKGB: posts big blind $0.50
*** HOLE CARDS ***
bellisimo212: folds 
christyirish: folds 
jantheman222: folds 
maisit*: raises $1 to $1.50
maestrodubai: folds 
SteigEin84: raises $1 to $2.50
WrongButton: folds 
ccownsu: folds 
BoryaKGB: folds 
maisit*: calls $1
*** FLOP *** [6s 7d 9c]
maisit*: checks 
SteigEin84: bets $2
maisit*: calls $2
*** TURN *** [6s 7d 9c] [As]
maisit*: checks 
SteigEin84: bets $2
maisit*: raises $5 to $7
SteigEin84: calls $3.02 and is all-in
Uncalled bet ($1.98) returned to maisit*
*** RIVER *** [6s 7d 9c As] [Jc]
*** SHOW DOWN ***
maisit*: shows [7s 8s] (a pair of Sevens)
SteigEin84: shows [9d Ah] (two pair, Aces and Nines)
SteigEin84 collected $18.55 from pot
*** SUMMARY ***
Total pot $19.79 | Rake $1.24 
Board [6s 7d 9c As Jc]
Seat 1: ccownsu (small blind) folded before Flop
Seat 2: BoryaKGB (big blind) folded before Flop
Seat 3: bellisimo212 folded before Flop (didn't bet)
Seat 4: christyirish folded before Flop (didn't bet)
Seat 5: jantheman222 folded before Flop (didn't bet)
Seat 6: maisit* showed [7s 8s] and lost with a pair of Sevens
Seat 7: maestrodubai folded before Flop (didn't bet)
Seat 8: SteigEin84 showed [9d Ah] and won ($18.55) with two pair, Aces and Nines
Seat 9: WrongButton (button) folded before Flop (didn't bet)



PokerStars Hand #228696072193:  Hold'em No Limit ($0.25/$0.50 USD) - 2021/07/30 22:23:45 ET
Table 'Aitne III' 9-max Seat #1 is the button
Seat 1: ccownsu ($43 in chips) 
Seat 2: BoryaKGB ($65.58 in chips) 
Seat 3: bellisimo212 ($54.22 in chips) 
Seat 4: christyirish ($96.98 in chips) 
Seat 5: jantheman222 ($92.69 in chips) 
Seat 6: maisit* ($82.95 in chips) 
Seat 7: maestrodubai ($45.02 in chips) 
Seat 8: SteigEin84 ($18.55 in chips) 
Seat 9: WrongButton ($56.35 in chips) 
BoryaKGB: posts small blind $0.25
bellisimo212: posts big blind $0.50
*** HOLE CARDS ***
christyirish: folds 
jantheman222: raises $0.75 to $1.25
maisit*: folds 
maestrodubai: folds 
SteigEin84: calls $1.25
WrongButton: calls $1.25
ccownsu: folds 
BoryaKGB: folds 
bellisimo212: folds 
*** FLOP *** [Kc 2d Ts]
jantheman222: checks 
SteigEin84: bets $1.50
WrongButton: folds 
jantheman222: calls $1.50
*** TURN *** [Kc 2d Ts] [9d]
jantheman222: checks 
SteigEin84: bets $3.56
jantheman222: folds 
Uncalled bet ($3.56) returned to SteigEin84
SteigEin84 collected $7.02 from pot
SteigEin84: doesn't show hand 
*** SUMMARY ***
Total pot $7.50 | Rake $0.48 
Board [Kc 2d Ts 9d]
Seat 1: ccownsu (button) folded before Flop (didn't bet)
Seat 2: BoryaKGB (small blind) folded before Flop
Seat 3: bellisimo212 (big blind) folded before Flop
Seat 4: christyirish folded before Flop (didn't bet)
Seat 5: jantheman222 folded on the Turn
Seat 6: maisit* folded before Flop (didn't bet)
Seat 7: maestrodubai folded before Flop (didn't bet)
Seat 8: SteigEin84 collected ($7.02)
Seat 9: WrongButton folded on the Flop



PokerStars Hand #228696086703:  Hold'em No Limit ($0.25/$0.50 USD) - 2021/07/30 22:24:49 ET
Table 'Aitne III' 9-max Seat #2 is the button
Seat 1: ccownsu ($43 in chips) 
Seat 2: BoryaKGB ($65.33 in chips) 
Seat 3: bellisimo212 ($53.72 in chips) 
Seat 4: christyirish ($96.98 in chips) 
Seat 5: jantheman222 ($89.94 in chips) 
Seat 6: maisit* ($82.95 in chips) 
Seat 7: maestrodubai ($45.02 in chips) 
Seat 8: SteigEin84 ($22.82 in chips) 
Seat 9: WrongButton ($55.10 in chips) 
bellisimo212: posts small blind $0.25
christyirish: posts big blind $0.50
*** HOLE CARDS ***
jantheman222: folds 
maisit*: folds 
maestrodubai: folds 
SteigEin84: folds 
WrongButton: folds 
ccownsu: folds 
BoryaKGB: folds 
bellisimo212: calls $0.25
christyirish: checks 
*** FLOP *** [Qh 5d 8h]
bellisimo212: bets $0.50
christyirish: folds 
Uncalled bet ($0.50) returned to bellisimo212
bellisimo212 collected $0.95 from pot
bellisimo212: doesn't show hand 
*** SUMMARY ***
Total pot $1 | Rake $0.05 
Board [Qh 5d 8h]
Seat 1: ccownsu folded before Flop (didn't bet)
Seat 2: BoryaKGB (button) folded before Flop (didn't bet)
Seat 3: bellisimo212 (small blind) collected ($0.95)
Seat 4: christyirish (big blind) folded on the Flop
Seat 5: jantheman222 folded before Flop (didn't bet)
Seat 6: maisit* folded before Flop (didn't bet)
Seat 7: maestrodubai folded before Flop (didn't bet)
Seat 8: SteigEin84 folded before Flop (didn't bet)
Seat 9: WrongButton folded before Flop (didn't bet)



PokerStars Hand #228696092478:  Hold'em No Limit ($0.25/$0.50 USD) - 2021/07/30 22:25:14 ET
Table 'Aitne III' 9-max Seat #3 is the button
Seat 1: ccownsu ($43 in chips) 
Seat 2: BoryaKGB ($65.33 in chips) 
Seat 3: bellisimo212 ($54.17 in chips) 
Seat 4: christyirish ($96.48 in chips) 
Seat 5: jantheman222 ($89.94 in chips) 
Seat 6: maisit* ($82.95 in chips) 
Seat 7: maestrodubai ($45.02 in chips) 
Seat 8: SteigEin84 ($22.82 in chips) 
Seat 9: WrongButton ($55.10 in chips) 
christyirish: posts small blind $0.25
jantheman222: posts big blind $0.50
*** HOLE CARDS ***
maisit*: folds 
maestrodubai: folds 
SteigEin84: folds 
WrongButton: folds 
ccownsu: raises $1 to $1.50
BoryaKGB: folds 
bellisimo212: folds 
christyirish: folds 
jantheman222: folds 
Uncalled bet ($1) returned to ccownsu
ccownsu collected $1.25 from pot
ccownsu: doesn't show hand 
*** SUMMARY ***
Total pot $1.25 | Rake $0 
Seat 1: ccownsu collected ($1.25)
Seat 2: BoryaKGB folded before Flop (didn't bet)
Seat 3: bellisimo212 (button) folded before Flop (didn't bet)
Seat 4: christyirish (small blind) folded before Flop
Seat 5: jantheman222 (big blind) folded before Flop
Seat 6: maisit* folded before Flop (didn't bet)
Seat 7: maestrodubai folded before Flop (didn't bet)
Seat 8: SteigEin84 folded before Flop (didn't bet)
Seat 9: WrongButton folded before Flop (didn't bet)



PokerStars Hand #228696096698:  Hold'em No Limit ($0.25/$0.50 USD) - 2021/07/30 22:25:33 ET
Table 'Aitne III' 9-max Seat #4 is the button
Seat 1: ccownsu ($43.75 in chips) 
Seat 2: BoryaKGB ($65.33 in chips) 
Seat 3: bellisimo212 ($54.17 in chips) 
Seat 4: christyirish ($96.23 in chips) 
Seat 5: jantheman222 ($89.44 in chips) 
Seat 6: maisit* ($82.95 in chips) 
Seat 7: maestrodubai ($45.02 in chips) 
Seat 8: SteigEin84 ($22.82 in chips) 
Seat 9: WrongButton ($55.10 in chips) 
jantheman222: posts small blind $0.25
maisit*: posts big blind $0.50
*** HOLE CARDS ***
maestrodubai: folds 
SteigEin84: folds 
WrongButton: folds 
ccownsu: folds 
BoryaKGB: folds 
bellisimo212: calls $0.50
christyirish: folds 
jantheman222: calls $0.25
maisit*: checks 
*** FLOP *** [3h 6d Qc]
jantheman222: checks 
maisit*: checks 
bellisimo212: bets $1
jantheman222: folds 
maisit*: folds 
Uncalled bet ($1) returned to bellisimo212
bellisimo212 collected $1.42 from pot
bellisimo212: doesn't show hand 
*** SUMMARY ***
Total pot $1.50 | Rake $0.08 
Board [3h 6d Qc]
Seat 1: ccownsu folded before Flop (didn't bet)
Seat 2: BoryaKGB folded before Flop (didn't bet)
Seat 3: bellisimo212 collected ($1.42)
Seat 4: christyirish (button) folded before Flop (didn't bet)
Seat 5: jantheman222 (small blind) folded on the Flop
Seat 6: maisit* (big blind) folded on the Flop
Seat 7: maestrodubai folded before Flop (didn't bet)
Seat 8: SteigEin84 folded before Flop (didn't bet)
Seat 9: WrongButton folded before Flop (didn't bet)



PokerStars Hand #228696110343:  Hold'em No Limit ($0.25/$0.50 USD) - 2021/07/30 22:26:20 ET
Table 'Aitne III' 9-max Seat #5 is the button
Seat 1: ccownsu ($43.75 in chips) 
Seat 2: BoryaKGB ($65.33 in chips) 
Seat 3: bellisimo212 ($55.09 in chips) 
Seat 4: christyirish ($96.23 in chips) 
Seat 5: jantheman222 ($88.94 in chips) 
Seat 6: maisit* ($82.45 in chips) 
Seat 7: maestrodubai ($45.02 in chips) 
Seat 8: SteigEin84 ($22.82 in chips) 
Seat 9: WrongButton ($55.10 in chips) 
maisit*: posts small blind $0.25
maestrodubai: posts big blind $0.50
*** HOLE CARDS ***
SteigEin84: folds 
WrongButton: folds 
ccownsu: raises $1 to $1.50
BoryaKGB: raises $2.50 to $4
bellisimo212: folds 
christyirish: folds 
jantheman222: folds 
maisit*: folds 
maestrodubai: folds 
ccownsu: folds 
Uncalled bet ($2.50) returned to BoryaKGB
BoryaKGB collected $3.75 from pot
BoryaKGB: doesn't show hand 
*** SUMMARY ***
Total pot $3.75 | Rake $0 
Seat 1: ccownsu folded before Flop
Seat 2: BoryaKGB collected ($3.75)
Seat 3: bellisimo212 folded before Flop (didn't bet)
Seat 4: christyirish folded before Flop (didn't bet)
Seat 5: jantheman222 (button) folded before Flop (didn't bet)
Seat 6: maisit* (small blind) folded before Flop
Seat 7: maestrodubai (big blind) folded before Flop
Seat 8: SteigEin84 folded before Flop (didn't bet)
Seat 9: WrongButton folded before Flop (didn't bet)



PokerStars Hand #228696117720:  Hold'em No Limit ($0.25/$0.50 USD) - 2021/07/30 22:26:53 ET
Table 'Aitne III' 9-max Seat #6 is the button
Seat 1: ccownsu ($42.25 in chips) 
Seat 2: BoryaKGB ($67.58 in chips) 
Seat 3: bellisimo212 ($55.09 in chips) 
Seat 4: christyirish ($96.23 in chips) 
Seat 5: jantheman222 ($88.94 in chips) 
Seat 6: maisit* ($82.20 in chips) 
Seat 7: maestrodubai ($44.52 in chips) 
Seat 8: SteigEin84 ($22.82 in chips) 
Seat 9: WrongButton ($55.10 in chips) 
maestrodubai: posts small blind $0.25
SteigEin84: posts big blind $0.50
*** HOLE CARDS ***
WrongButton: folds 
ccownsu: folds 
BoryaKGB: folds 
bellisimo212: folds 
christyirish: folds 
jantheman222: folds 
maisit*: folds 
maestrodubai: folds 
Uncalled bet ($0.25) returned to SteigEin84
SteigEin84 collected $0.50 from pot
SteigEin84: doesn't show hand 
*** SUMMARY ***
Total pot $0.50 | Rake $0 
Seat 1: ccownsu folded before Flop (didn't bet)
Seat 2: BoryaKGB folded before Flop (didn't bet)
Seat 3: bellisimo212 folded before Flop (didn't bet)
Seat 4: christyirish folded before Flop (didn't bet)
Seat 5: jantheman222 folded before Flop (didn't bet)
Seat 6: maisit* (button) folded before Flop (didn't bet)
Seat 7: maestrodubai (small blind) folded before Flop
Seat 8: SteigEin84 (big blind) collected ($0.50)
Seat 9: WrongButton folded before Flop (didn't bet)



PokerStars Hand #228696121140:  Hold'em No Limit ($0.25/$0.50 USD) - 2021/07/30 22:27:08 ET
Table 'Aitne III' 9-max Seat #7 is the button
Seat 1: ccownsu ($42.25 in chips) 
Seat 2: BoryaKGB ($67.58 in chips) 
Seat 4: christyirish ($96.23 in chips) 
Seat 5: jantheman222 ($88.94 in chips) 
Seat 6: maisit* ($82.20 in chips) 
Seat 7: maestrodubai ($44.27 in chips) 
Seat 8: SteigEin84 ($23.07 in chips) 
Seat 9: WrongButton ($55.10 in chips) 
SteigEin84: posts small blind $0.25
WrongButton: posts big blind $0.50
*** HOLE CARDS ***
ccownsu: folds 
BoryaKGB: folds 
christyirish: folds 
jantheman222: folds 
maisit*: raises $1 to $1.50
maestrodubai: folds 
SteigEin84: calls $1.25
WrongButton: calls $1
*** FLOP *** [Kd 9s Qs]
SteigEin84: checks 
WrongButton: bets $1.75
maisit*: folds 
SteigEin84: folds 
Uncalled bet ($1.75) returned to WrongButton
WrongButton collected $4.28 from pot
*** SUMMARY ***
Total pot $4.50 | Rake $0.22 
Board [Kd 9s Qs]
Seat 1: ccownsu folded before Flop (didn't bet)
Seat 2: BoryaKGB folded before Flop (didn't bet)
Seat 4: christyirish folded before Flop (didn't bet)
Seat 5: jantheman222 folded before Flop (didn't bet)
Seat 6: maisit* folded on the Flop
Seat 7: maestrodubai (button) folded before Flop (didn't bet)
Seat 8: SteigEin84 (small blind) folded on the Flop
Seat 9: WrongButton (big blind) collected ($4.28)



PokerStars Hand #228696130706:  Hold'em No Limit ($0.25/$0.50 USD) - 2021/07/30 22:27:52 ET
Table 'Aitne III' 9-max Seat #8 is the button
Seat 1: ccownsu ($42.25 in chips) 
Seat 2: BoryaKGB ($67.58 in chips) 
Seat 4: christyirish ($96.23 in chips) 
Seat 5: jantheman222 ($88.94 in chips) 
Seat 6: maisit* ($80.70 in chips) 
Seat 7: maestrodubai ($44.27 in chips) 
Seat 8: SteigEin84 ($21.57 in chips) 
Seat 9: WrongButton ($57.88 in chips) 
WrongButton: posts small blind $0.25
ccownsu: posts big blind $0.50
*** HOLE CARDS ***
BoryaKGB: raises $0.60 to $1.10
christyirish: folds 
jantheman222: folds 
maisit*: folds 
maestrodubai: folds 
SteigEin84: calls $1.10
WrongButton: folds 
ccownsu: folds 
*** FLOP *** [2s 4s Qh]
BoryaKGB: bets $0.78
SteigEin84: calls $0.78
*** TURN *** [2s 4s Qh] [3h]
BoryaKGB: bets $2.14
SteigEin84: folds 
Uncalled bet ($2.14) returned to BoryaKGB
BoryaKGB collected $4.28 from pot
BoryaKGB: doesn't show hand 
*** SUMMARY ***
Total pot $4.51 | Rake $0.23 
Board [2s 4s Qh 3h]
Seat 1: ccownsu (big blind) folded before Flop
Seat 2: BoryaKGB collected ($4.28)
Seat 4: christyirish folded before Flop (didn't bet)
Seat 5: jantheman222 folded before Flop (didn't bet)
Seat 6: maisit* folded before Flop (didn't bet)
Seat 7: maestrodubai folded before Flop (didn't bet)
Seat 8: SteigEin84 (button) folded on the Turn
Seat 9: WrongButton (small blind) folded before Flop



PokerStars Hand #228696138074:  Hold'em No Limit ($0.25/$0.50 USD) - 2021/07/30 22:28:25 ET
Table 'Aitne III' 9-max Seat #9 is the button
Seat 1: ccownsu ($41.75 in chips) 
Seat 2: BoryaKGB ($69.98 in chips) 
Seat 3: bellisimo212 ($55.09 in chips) 
Seat 4: christyirish ($96.23 in chips) 
Seat 5: jantheman222 ($88.94 in chips) 
Seat 6: maisit* ($80.70 in chips) 
Seat 7: maestrodubai ($44.27 in chips) 
Seat 8: SteigEin84 ($19.69 in chips) 
Seat 9: WrongButton ($57.63 in chips) 
ccownsu: posts small blind $0.25
BoryaKGB: posts big blind $0.50
*** HOLE CARDS ***
bellisimo212: folds 
christyirish: folds 
jantheman222: folds 
maisit*: folds 
maestrodubai: raises $1 to $1.50
SteigEin84: raises $1 to $2.50
WrongButton: folds 
ccownsu: folds 
BoryaKGB: folds 
maestrodubai: calls $1
*** FLOP *** [7s Td 6d]
maestrodubai: checks 
SteigEin84: bets $2.50
maestrodubai: folds 
Uncalled bet ($2.50) returned to SteigEin84
SteigEin84 collected $5.39 from pot
SteigEin84: doesn't show hand 
*** SUMMARY ***
Total pot $5.75 | Rake $0.36 
Board [7s Td 6d]
Seat 1: ccownsu (small blind) folded before Flop
Seat 2: BoryaKGB (big blind) folded before Flop
Seat 3: bellisimo212 folded before Flop (didn't bet)
Seat 4: christyirish folded before Flop (didn't bet)
Seat 5: jantheman222 folded before Flop (didn't bet)
Seat 6: maisit* folded before Flop (didn't bet)
Seat 7: maestrodubai folded on the Flop
Seat 8: SteigEin84 collected ($5.39)
Seat 9: WrongButton (button) folded before Flop (didn't bet)



PokerStars Hand #228696145653:  Hold'em No Limit ($0.25/$0.50 USD) - 2021/07/30 22:28:59 ET
Table 'Aitne III' 9-max Seat #1 is the button
Seat 1: ccownsu ($41.50 in chips) 
Seat 2: BoryaKGB ($69.48 in chips) 
Seat 3: bellisimo212 ($55.09 in chips) 
Seat 4: christyirish ($96.23 in chips) 
Seat 5: jantheman222 ($88.94 in chips) 
Seat 6: maisit* ($80.70 in chips) 
Seat 7: maestrodubai ($41.77 in chips) 
Seat 8: SteigEin84 ($22.58 in chips) 
Seat 9: WrongButton ($57.63 in chips) 
BoryaKGB: posts small blind $0.25
bellisimo212: posts big blind $0.50
*** HOLE CARDS ***
christyirish: folds 
jantheman222: raises $0.75 to $1.25
maisit*: folds 
maestrodubai: folds 
SteigEin84: folds 
WrongButton: folds 
ccownsu: folds 
BoryaKGB: folds 
bellisimo212: folds 
Uncalled bet ($0.75) returned to jantheman222
jantheman222 collected $1.25 from pot
*** SUMMARY ***
Total pot $1.25 | Rake $0 
Seat 1: ccownsu (button) folded before Flop (didn't bet)
Seat 2: BoryaKGB (small blind) folded before Flop
Seat 3: bellisimo212 (big blind) folded before Flop
Seat 4: christyirish folded before Flop (didn't bet)
Seat 5: jantheman222 collected ($1.25)
Seat 6: maisit* folded before Flop (didn't bet)
Seat 7: maestrodubai folded before Flop (didn't bet)
Seat 8: SteigEin84 folded before Flop (didn't bet)
Seat 9: WrongButton folded before Flop (didn't bet)



PokerStars Hand #228696149981:  Hold'em No Limit ($0.25/$0.50 USD) - 2021/07/30 22:29:18 ET
Table 'Aitne III' 9-max Seat #2 is the button
Seat 1: ccownsu ($41.50 in chips) 
Seat 2: BoryaKGB ($69.23 in chips) 
Seat 3: bellisimo212 ($54.59 in chips) 
Seat 4: christyirish ($96.23 in chips) 
Seat 5: jantheman222 ($89.69 in chips) 
Seat 6: maisit* ($80.70 in chips) 
Seat 7: maestrodubai ($41.77 in chips) 
Seat 8: SteigEin84 ($22.58 in chips) 
Seat 9: WrongButton ($57.63 in chips) 
bellisimo212: posts small blind $0.25
christyirish: posts big blind $0.50
*** HOLE CARDS ***
jantheman222: raises $1 to $1.50
maisit*: folds 
maestrodubai: folds 
SteigEin84: folds 
WrongButton: folds 
ccownsu: calls $1.50
BoryaKGB: folds 
bellisimo212: folds 
christyirish: folds 
*** FLOP *** [5s 9c 4c]
jantheman222: checks 
ccownsu: bets $1.78
jantheman222: calls $1.78
*** TURN *** [5s 9c 4c] [8d]
jantheman222: checks 
ccownsu: checks 
*** RIVER *** [5s 9c 4c 8d] [7d]
jantheman222: checks 
ccownsu: checks 
*** SHOW DOWN ***
jantheman222: shows [Kd Ks] (a pair of Kings)
ccownsu: mucks hand 
jantheman222 collected $6.94 from pot
*** SUMMARY ***
Total pot $7.31 | Rake $0.37 
Board [5s 9c 4c 8d 7d]
Seat 1: ccownsu mucked
Seat 2: BoryaKGB (button) folded before Flop (didn't bet)
Seat 3: bellisimo212 (small blind) folded before Flop
Seat 4: christyirish (big blind) folded before Flop
Seat 5: jantheman222 showed [Kd Ks] and won ($6.94) with a pair of Kings
Seat 6: maisit* folded before Flop (didn't bet)
Seat 7: maestrodubai folded before Flop (didn't bet)
Seat 8: SteigEin84 folded before Flop (didn't bet)
Seat 9: WrongButton folded before Flop (didn't bet)



PokerStars Hand #228696163605:  Hold'em No Limit ($0.25/$0.50 USD) - 2021/07/30 22:30:19 ET
Table 'Aitne III' 9-max Seat #3 is the button
Seat 1: ccownsu ($38.22 in chips) 
Seat 2: BoryaKGB ($69.23 in chips) 
Seat 3: bellisimo212 ($54.34 in chips) 
Seat 4: christyirish ($95.73 in chips) 
Seat 5: jantheman222 ($93.35 in chips) 
Seat 6: maisit* ($80.70 in chips) 
Seat 7: maestrodubai ($41.77 in chips) 
Seat 8: SteigEin84 ($22.58 in chips) 
Seat 9: WrongButton ($57.63 in chips) 
christyirish: posts small blind $0.25
jantheman222: posts big blind $0.50
*** HOLE CARDS ***
maisit*: raises $1 to $1.50
maestrodubai: folds 
SteigEin84: raises $1.50 to $3
WrongButton: folds 
ccownsu: calls $3
BoryaKGB: folds 
bellisimo212: folds 
christyirish: folds 
jantheman222: folds 
maisit*: calls $1.50
*** FLOP *** [4h 3s 2c]
maisit*: checks 
SteigEin84: bets $4
ccownsu: calls $4
maisit*: folds 
*** TURN *** [4h 3s 2c] [Th]
SteigEin84: checks 
ccownsu: bets $8.43
SteigEin84: folds 
Uncalled bet ($8.43) returned to ccownsu
ccownsu collected $16.86 from pot
ccownsu: doesn't show hand 
*** SUMMARY ***
Total pot $17.75 | Rake $0.89 
Board [4h 3s 2c Th]
Seat 1: ccownsu collected ($16.86)
Seat 2: BoryaKGB folded before Flop (didn't bet)
Seat 3: bellisimo212 (button) folded before Flop (didn't bet)
Seat 4: christyirish (small blind) folded before Flop
Seat 5: jantheman222 (big blind) folded before Flop
Seat 6: maisit* folded on the Flop
Seat 7: maestrodubai folded before Flop (didn't bet)
Seat 8: SteigEin84 folded on the Turn
Seat 9: WrongButton folded before Flop (didn't bet)



PokerStars Hand #228696176986:  Hold'em No Limit ($0.25/$0.50 USD) - 2021/07/30 22:31:19 ET
Table 'Aitne III' 9-max Seat #4 is the button
Seat 1: ccownsu ($48.08 in chips) 
Seat 2: BoryaKGB ($69.23 in chips) 
Seat 3: bellisimo212 ($54.34 in chips) 
Seat 4: christyirish ($95.48 in chips) 
Seat 5: jantheman222 ($92.85 in chips) 
Seat 6: maisit* ($77.70 in chips) 
Seat 7: maestrodubai ($41.77 in chips) 
Seat 8: SteigEin84 ($15.58 in chips) 
Seat 9: WrongButton ($57.63 in chips) 
jantheman222: posts small blind $0.25
maisit*: posts big blind $0.50
*** HOLE CARDS ***
maestrodubai: folds 
SteigEin84: folds 
WrongButton: folds 
ccownsu: raises $1 to $1.50
BoryaKGB: folds 
bellisimo212: folds 
christyirish: calls $1.50
jantheman222: folds 
maisit*: folds 
*** FLOP *** [Ac 6s As]
ccownsu: checks 
christyirish: bets $1.07
ccownsu: calls $1.07
*** TURN *** [Ac 6s As] [6d]
ccownsu: checks 
christyirish: checks 
*** RIVER *** [Ac 6s As 6d] [Ks]
ccownsu: checks 
christyirish: checks 
*** SHOW DOWN ***
ccownsu: shows [Js Ts] (a flush, Ace high)
christyirish: mucks hand 
ccownsu collected $5.60 from pot
*** SUMMARY ***
Total pot $5.89 | Rake $0.29 
Board [Ac 6s As 6d Ks]
Seat 1: ccownsu showed [Js Ts] and won ($5.60) with a flush, Ace high
Seat 2: BoryaKGB folded before Flop (didn't bet)
Seat 3: bellisimo212 folded before Flop (didn't bet)
Seat 4: christyirish (button) mucked
Seat 5: jantheman222 (small blind) folded before Flop
Seat 6: maisit* (big blind) folded before Flop
Seat 7: maestrodubai folded before Flop (didn't bet)
Seat 8: SteigEin84 folded before Flop (didn't bet)
Seat 9: WrongButton folded before Flop (didn't bet)



PokerStars Hand #228696186887:  Hold'em No Limit ($0.25/$0.50 USD) - 2021/07/30 22:32:04 ET
Table 'Aitne III' 9-max Seat #5 is the button
Seat 1: ccownsu ($51.11 in chips) 
Seat 2: BoryaKGB ($69.23 in chips) 
Seat 3: bellisimo212 ($54.34 in chips) 
Seat 4: christyirish ($92.91 in chips) 
Seat 5: jantheman222 ($92.60 in chips) 
Seat 6: maisit* ($77.20 in chips) 
Seat 7: maestrodubai ($41.77 in chips) 
Seat 8: SteigEin84 ($45.99 in chips) 
Seat 9: WrongButton ($57.63 in chips) 
maisit*: posts small blind $0.25
maestrodubai: posts big blind $0.50
*** HOLE CARDS ***
SteigEin84: folds 
WrongButton: folds 
ccownsu: folds 
BoryaKGB: folds 
bellisimo212: folds 
christyirish: folds 
jantheman222: folds 
maisit*: folds 
Uncalled bet ($0.25) returned to maestrodubai
maestrodubai collected $0.50 from pot
maestrodubai: doesn't show hand 
*** SUMMARY ***
Total pot $0.50 | Rake $0 
Seat 1: ccownsu folded before Flop (didn't bet)
Seat 2: BoryaKGB folded before Flop (didn't bet)
Seat 3: bellisimo212 folded before Flop (didn't bet)
Seat 4: christyirish folded before Flop (didn't bet)
Seat 5: jantheman222 (button) folded before Flop (didn't bet)
Seat 6: maisit* (small blind) folded before Flop
Seat 7: maestrodubai (big blind) collected ($0.50)
Seat 8: SteigEin84 folded before Flop (didn't bet)
Seat 9: WrongButton folded before Flop (didn't bet)



PokerStars Hand #228696200265:  Hold'em No Limit ($0.25/$0.50 USD) - 2021/07/30 22:32:19 ET
Table 'Aitne III' 9-max Seat #6 is the button
Seat 1: ccownsu ($51.11 in chips) 
Seat 2: BoryaKGB ($69.23 in chips) 
Seat 3: bellisimo212 ($54.34 in chips) 
Seat 4: christyirish ($92.91 in chips) 
Seat 5: jantheman222 ($92.60 in chips) 
Seat 6: maisit* ($76.95 in chips) 
Seat 7: maestrodubai ($42.02 in chips) 
Seat 8: SteigEin84 ($45.99 in chips) 
Seat 9: WrongButton ($57.63 in chips) 
maestrodubai: posts small blind $0.25
SteigEin84: posts big blind $0.50
*** HOLE CARDS ***
WrongButton: folds 
ccownsu: folds 
BoryaKGB: folds 
bellisimo212: folds 
christyirish: folds 
jantheman222: folds 
maisit*: folds 
maestrodubai: folds 
Uncalled bet ($0.25) returned to SteigEin84
SteigEin84 collected $0.50 from pot
SteigEin84: doesn't show hand 
*** SUMMARY ***
Total pot $0.50 | Rake $0 
Seat 1: ccownsu folded before Flop (didn't bet)
Seat 2: BoryaKGB folded before Flop (didn't bet)
Seat 3: bellisimo212 folded before Flop (didn't bet)
Seat 4: christyirish folded before Flop (didn't bet)
Seat 5: jantheman222 folded before Flop (didn't bet)
Seat 6: maisit* (button) folded before Flop (didn't bet)
Seat 7: maestrodubai (small blind) folded before Flop
Seat 8: SteigEin84 (big blind) collected ($0.50)
Seat 9: WrongButton folded before Flop (didn't bet)



PokerStars Hand #228696205297:  Hold'em No Limit ($0.25/$0.50 USD) - 2021/07/30 22:32:42 ET
Table 'Aitne III' 9-max Seat #7 is the button
Seat 1: ccownsu ($51.11 in chips) 
Seat 2: BoryaKGB ($69.23 in chips) 
Seat 3: bellisimo212 ($54.34 in chips) 
Seat 4: christyirish ($92.91 in chips) 
Seat 5: jantheman222 ($92.60 in chips) 
Seat 6: maisit* ($76.95 in chips) 
Seat 7: maestrodubai ($41.77 in chips) 
Seat 8: SteigEin84 ($46.24 in chips) 
Seat 9: WrongButton ($57.63 in chips) 
SteigEin84: posts small blind $0.25
WrongButton: posts big blind $0.50
*** HOLE CARDS ***
ccownsu: folds 
BoryaKGB: folds 
bellisimo212: calls $0.50
christyirish: folds 
jantheman222: folds 
maisit*: folds 
maestrodubai: raises $1.50 to $2
SteigEin84: calls $1.75
WrongButton: folds 
bellisimo212: calls $1.50
*** FLOP *** [2d Ad 8h]
SteigEin84: checks 
bellisimo212: checks 
maestrodubai: checks 
*** TURN *** [2d Ad 8h] [9c]
SteigEin84: bets $3
bellisimo212: folds 
maestrodubai: calls $3
*** RIVER *** [2d Ad 8h 9c] [Tc]
SteigEin84: bets $6.44
maestrodubai: calls $6.44
*** SHOW DOWN ***
SteigEin84: shows [2h 2c] (three of a kind, Deuces)
maestrodubai: mucks hand 
SteigEin84 collected $23.79 from pot
*** SUMMARY ***
Total pot $25.38 | Rake $1.59 
Board [2d Ad 8h 9c Tc]
Seat 1: ccownsu folded before Flop (didn't bet)
Seat 2: BoryaKGB folded before Flop (didn't bet)
Seat 3: bellisimo212 folded on the Turn
Seat 4: christyirish folded before Flop (didn't bet)
Seat 5: jantheman222 folded before Flop (didn't bet)
Seat 6: maisit* folded before Flop (didn't bet)
Seat 7: maestrodubai (button) mucked
Seat 8: SteigEin84 (small blind) showed [2h 2c] and won ($23.79) with three of a kind, Deuces
Seat 9: WrongButton (big blind) folded before Flop



PokerStars Hand #228696228891:  Hold'em No Limit ($0.25/$0.50 USD) - 2021/07/30 22:33:59 ET
Table 'Aitne III' 9-max Seat #8 is the button
Seat 1: ccownsu ($51.11 in chips) 
Seat 2: BoryaKGB ($69.23 in chips) 
Seat 3: bellisimo212 ($52.34 in chips) 
Seat 4: christyirish ($92.91 in chips) 
Seat 5: jantheman222 ($92.60 in chips) 
Seat 6: maisit* ($76.95 in chips) 
Seat 7: maestrodubai ($30.33 in chips) 
Seat 8: SteigEin84 ($58.59 in chips) 
Seat 9: WrongButton ($57.13 in chips) 
WrongButton: posts small blind $0.25
ccownsu: posts big blind $0.50
*** HOLE CARDS ***
BoryaKGB: folds 
bellisimo212: folds 
christyirish: folds 
jantheman222: folds 
maisit* has timed out
maisit*: folds 
maestrodubai: folds 
SteigEin84: calls $0.50
WrongButton: calls $0.25
ccownsu: checks 
*** FLOP *** [5c 4c 5h]
WrongButton: checks 
ccownsu: checks 
SteigEin84: bets $1.50
WrongButton: folds 
ccownsu: folds 
Uncalled bet ($1.50) returned to SteigEin84
SteigEin84 collected $1.40 from pot
SteigEin84: doesn't show hand 
*** SUMMARY ***
Total pot $1.50 | Rake $0.10 
Board [5c 4c 5h]
Seat 1: ccownsu (big blind) folded on the Flop
Seat 2: BoryaKGB folded before Flop (didn't bet)
Seat 3: bellisimo212 folded before Flop (didn't bet)
Seat 4: christyirish folded before Flop (didn't bet)
Seat 5: jantheman222 folded before Flop (didn't bet)
Seat 6: maisit* folded before Flop (didn't bet)
Seat 7: maestrodubai folded before Flop (didn't bet)
Seat 8: SteigEin84 (button) collected ($1.40)
Seat 9: WrongButton (small blind) folded on the Flop



PokerStars Hand #228696240238:  Hold'em No Limit ($0.25/$0.50 USD) - 2021/07/30 22:34:49 ET
Table 'Aitne III' 9-max Seat #9 is the button
Seat 1: ccownsu ($50.61 in chips) 
Seat 2: BoryaKGB ($69.23 in chips) 
Seat 3: bellisimo212 ($52.34 in chips) 
Seat 4: christyirish ($92.91 in chips) 
Seat 5: jantheman222 ($92.60 in chips) 
Seat 6: maisit* ($76.95 in chips) 
Seat 7: maestrodubai ($30.33 in chips) 
Seat 8: SteigEin84 ($59.49 in chips) 
Seat 9: WrongButton ($56.63 in chips) 
ccownsu: posts small blind $0.25
BoryaKGB: posts big blind $0.50
*** HOLE CARDS ***
bellisimo212: calls $0.50
christyirish: raises $1.75 to $2.25
jantheman222: folds 
maisit*: folds 
maestrodubai: folds 
SteigEin84: folds 
WrongButton: calls $2.25
ccownsu: folds 
BoryaKGB: folds 
bellisimo212: folds 
*** FLOP *** [9c 5d 4d]
christyirish: checks 
WrongButton: checks 
*** TURN *** [9c 5d 4d] [Qh]
christyirish: bets $3
WrongButton: folds 
Uncalled bet ($3) returned to christyirish
christyirish collected $5.46 from pot
*** SUMMARY ***
Total pot $5.75 | Rake $0.29 
Board [9c 5d 4d Qh]
Seat 1: ccownsu (small blind) folded before Flop
Seat 2: BoryaKGB (big blind) folded before Flop
Seat 3: bellisimo212 folded before Flop
Seat 4: christyirish collected ($5.46)
Seat 5: jantheman222 folded before Flop (didn't bet)
Seat 6: maisit* folded before Flop (didn't bet)
Seat 7: maestrodubai folded before Flop (didn't bet)
Seat 8: SteigEin84 folded before Flop (didn't bet)
Seat 9: WrongButton (button) folded on the Turn



PokerStars Hand #228696252977:  Hold'em No Limit ($0.25/$0.50 USD) - 2021/07/30 22:35:47 ET
Table 'Aitne III' 9-max Seat #1 is the button
Seat 1: ccownsu ($50.36 in chips) 
Seat 2: BoryaKGB ($68.73 in chips) 
Seat 3: bellisimo212 ($51.84 in chips) 
Seat 4: christyirish ($96.12 in chips) 
Seat 5: jantheman222 ($92.60 in chips) 
Seat 6: maisit* ($76.95 in chips) 
Seat 7: maestrodubai ($30.33 in chips) 
Seat 8: SteigEin84 ($59.49 in chips) 
Seat 9: WrongButton ($54.38 in chips) 
BoryaKGB: posts small blind $0.25
bellisimo212: posts big blind $0.50
*** HOLE CARDS ***
christyirish: folds 
jantheman222: folds 
maisit*: folds 
maestrodubai: folds 
SteigEin84: folds 
WrongButton: raises $0.75 to $1.25
ccownsu has timed out
ccownsu: folds 
BoryaKGB: folds 
bellisimo212: folds 
Uncalled bet ($0.75) returned to WrongButton
WrongButton collected $1.25 from pot
*** SUMMARY ***
Total pot $1.25 | Rake $0 
Seat 1: ccownsu (button) folded before Flop (didn't bet)
Seat 2: BoryaKGB (small blind) folded before Flop
Seat 3: bellisimo212 (big blind) folded before Flop
Seat 4: christyirish folded before Flop (didn't bet)
Seat 5: jantheman222 folded before Flop (didn't bet)
Seat 6: maisit* folded before Flop (didn't bet)
Seat 7: maestrodubai folded before Flop (didn't bet)
Seat 8: SteigEin84 folded before Flop (didn't bet)
Seat 9: WrongButton collected ($1.25)



PokerStars Hand #228696261077:  Hold'em No Limit ($0.25/$0.50 USD) - 2021/07/30 22:36:24 ET
Table 'Aitne III' 9-max Seat #2 is the button
Seat 1: ccownsu ($50.36 in chips) 
Seat 2: BoryaKGB ($68.48 in chips) 
Seat 3: bellisimo212 ($51.34 in chips) 
Seat 4: christyirish ($96.12 in chips) 
Seat 5: jantheman222 ($92.60 in chips) 
Seat 6: maisit* ($76.95 in chips) 
Seat 7: maestrodubai ($30.33 in chips) 
Seat 8: SteigEin84 ($59.49 in chips) 
Seat 9: WrongButton ($55.13 in chips) 
bellisimo212: posts small blind $0.25
christyirish: posts big blind $0.50
*** HOLE CARDS ***
jantheman222: folds 
maisit*: folds 
maestrodubai: raises $1 to $1.50
SteigEin84: folds 
WrongButton: calls $1.50
ccownsu: calls $1.50
BoryaKGB: folds 
bellisimo212: raises $49.84 to $51.34 and is all-in
christyirish: folds 
maestrodubai: folds 
WrongButton: folds 
ccownsu: folds 
Uncalled bet ($49.84) returned to bellisimo212
bellisimo212 collected $6.50 from pot
bellisimo212: doesn't show hand 
*** SUMMARY ***
Total pot $6.50 | Rake $0 
Seat 1: ccownsu folded before Flop
Seat 2: BoryaKGB (button) folded before Flop (didn't bet)
Seat 3: bellisimo212 (small blind) collected ($6.50)
Seat 4: christyirish (big blind) folded before Flop
Seat 5: jantheman222 folded before Flop (didn't bet)
Seat 6: maisit* folded before Flop (didn't bet)
Seat 7: maestrodubai folded before Flop
Seat 8: SteigEin84 folded before Flop (didn't bet)
Seat 9: WrongButton folded before Flop



PokerStars Hand #228696269304:  Hold'em No Limit ($0.25/$0.50 USD) - 2021/07/30 22:37:01 ET
Table 'Aitne III' 9-max Seat #3 is the button
Seat 1: ccownsu ($48.86 in chips) 
Seat 2: BoryaKGB ($68.48 in chips) 
Seat 3: bellisimo212 ($56.34 in chips) 
Seat 4: christyirish ($95.62 in chips) 
Seat 6: maisit* ($76.95 in chips) 
Seat 7: maestrodubai ($28.83 in chips) 
Seat 8: SteigEin84 ($59.49 in chips) 
Seat 9: WrongButton ($53.63 in chips) 
christyirish: posts small blind $0.25
jantheman222: is sitting out 
maisit*: posts big blind $0.50
*** HOLE CARDS ***
maestrodubai: folds 
SteigEin84: calls $0.50
WrongButton: folds 
ccownsu: folds 
BoryaKGB: raises $1.50 to $2
bellisimo212: folds 
christyirish: folds 
maisit*: folds 
SteigEin84: calls $1.50
*** FLOP *** [6d 5c 9h]
SteigEin84: checks 
BoryaKGB: bets $1.26
SteigEin84: raises $1.26 to $2.52
BoryaKGB: calls $1.26
*** TURN *** [6d 5c 9h] [Kc]
SteigEin84: bets $4.15
BoryaKGB: folds 
Uncalled bet ($4.15) returned to SteigEin84
SteigEin84 collected $9.18 from pot
SteigEin84: doesn't show hand 
*** SUMMARY ***
Total pot $9.79 | Rake $0.61 
Board [6d 5c 9h Kc]
Seat 1: ccownsu folded before Flop (didn't bet)
Seat 2: BoryaKGB folded on the Turn
Seat 3: bellisimo212 (button) folded before Flop (didn't bet)
Seat 4: christyirish (small blind) folded before Flop
Seat 6: maisit* (big blind) folded before Flop
Seat 7: maestrodubai folded before Flop (didn't bet)
Seat 8: SteigEin84 collected ($9.18)
Seat 9: WrongButton folded before Flop (didn't bet)



PokerStars Hand #228696282953:  Hold'em No Limit ($0.25/$0.50 USD) - 2021/07/30 22:38:03 ET
Table 'Aitne III' 9-max Seat #4 is the button
Seat 1: ccownsu ($48.86 in chips) 
Seat 2: BoryaKGB ($63.96 in chips) 
Seat 3: bellisimo212 ($56.34 in chips) 
Seat 4: christyirish ($95.37 in chips) 
Seat 6: maisit* ($76.45 in chips) 
Seat 7: maestrodubai ($28.83 in chips) 
Seat 8: SteigEin84 ($64.15 in chips) 
Seat 9: WrongButton ($53.63 in chips) 
maisit*: posts small blind $0.25
maestrodubai: posts big blind $0.50
*** HOLE CARDS ***
SteigEin84: calls $0.50
WrongButton: folds 
ccownsu: folds 
BoryaKGB: folds 
bellisimo212: folds 
christyirish: folds 
maisit*: raises $2 to $2.50
maestrodubai: folds 
SteigEin84: folds 
Uncalled bet ($2) returned to maisit*
maisit* collected $1.50 from pot
maisit*: doesn't show hand 
*** SUMMARY ***
Total pot $1.50 | Rake $0 
Seat 1: ccownsu folded before Flop (didn't bet)
Seat 2: BoryaKGB folded before Flop (didn't bet)
Seat 3: bellisimo212 folded before Flop (didn't bet)
Seat 4: christyirish (button) folded before Flop (didn't bet)
Seat 6: maisit* (small blind) collected ($1.50)
Seat 7: maestrodubai (big blind) folded before Flop
Seat 8: SteigEin84 folded before Flop
Seat 9: WrongButton folded before Flop (didn't bet)



PokerStars Hand #228696287213:  Hold'em No Limit ($0.25/$0.50 USD) - 2021/07/30 22:38:23 ET
Table 'Aitne III' 9-max Seat #6 is the button
Seat 1: ccownsu ($48.86 in chips) 
Seat 2: BoryaKGB ($63.96 in chips) 
Seat 3: bellisimo212 ($56.34 in chips) 
Seat 4: christyirish ($95.37 in chips) 
Seat 6: maisit* ($77.45 in chips) 
Seat 7: maestrodubai ($28.33 in chips) 
Seat 8: SteigEin84 ($63.65 in chips) 
Seat 9: WrongButton ($53.63 in chips) 
maestrodubai: posts small blind $0.25
SteigEin84: posts big blind $0.50
*** HOLE CARDS ***
WrongButton: folds 
ccownsu: folds 
BoryaKGB: raises $0.75 to $1.25
bellisimo212: calls $1.25
christyirish: folds 
maisit*: folds 
maestrodubai: calls $1
SteigEin84: calls $0.75
*** FLOP *** [6d Kd Ks]
maestrodubai: checks 
SteigEin84: checks 
BoryaKGB: checks 
bellisimo212: checks 
*** TURN *** [6d Kd Ks] [2d]
maestrodubai: checks 
SteigEin84: checks 
BoryaKGB: checks 
bellisimo212: checks 
*** RIVER *** [6d Kd Ks 2d] [Qd]
maestrodubai: checks 
SteigEin84: bets $1.50
BoryaKGB: raises $5.27 to $6.77
bellisimo212: folds 
maestrodubai: folds 
SteigEin84: raises $7.27 to $14.04
BoryaKGB: calls $7.27
*** SHOW DOWN ***
SteigEin84: shows [Kh 6s] (a full house, Kings full of Sixes)
BoryaKGB: mucks hand 
SteigEin84 collected $31.02 from pot
*** SUMMARY ***
Total pot $33.08 | Rake $2.06 
Board [6d Kd Ks 2d Qd]
Seat 1: ccownsu folded before Flop (didn't bet)
Seat 2: BoryaKGB mucked
Seat 3: bellisimo212 folded on the River
Seat 4: christyirish folded before Flop (didn't bet)
Seat 6: maisit* (button) folded before Flop (didn't bet)
Seat 7: maestrodubai (small blind) folded on the River
Seat 8: SteigEin84 (big blind) showed [Kh 6s] and won ($31.02) with a full house, Kings full of Sixes
Seat 9: WrongButton folded before Flop (didn't bet)



PokerStars Hand #228696304461:  Hold'em No Limit ($0.25/$0.50 USD) - 2021/07/30 22:39:41 ET
Table 'Aitne III' 9-max Seat #7 is the button
Seat 1: ccownsu ($48.86 in chips) 
Seat 2: BoryaKGB ($50 in chips) 
Seat 3: bellisimo212 ($55.09 in chips) 
Seat 4: christyirish ($95.37 in chips) 
Seat 6: maisit* ($77.45 in chips) 
Seat 7: maestrodubai ($27.08 in chips) 
Seat 8: SteigEin84 ($79.38 in chips) 
Seat 9: WrongButton ($53.63 in chips) 
SteigEin84: posts small blind $0.25
WrongButton: posts big blind $0.50
*** HOLE CARDS ***
ccownsu: folds 
BoryaKGB: folds 
bellisimo212: folds 
christyirish: folds 
maisit*: folds 
maestrodubai: folds 
SteigEin84: raises $0.50 to $1
WrongButton: raises $3.25 to $4.25
SteigEin84: calls $3.25
*** FLOP *** [4h Ac Kd]
SteigEin84: bets $5
WrongButton: calls $5
*** TURN *** [4h Ac Kd] [7s]
SteigEin84: checks 
WrongButton: bets $7.25
SteigEin84: raises $8.75 to $16
WrongButton: calls $8.75
*** RIVER *** [4h Ac Kd 7s] [5h]
SteigEin84: bets $15
WrongButton: raises $13.38 to $28.38 and is all-in
SteigEin84: calls $13.38
*** SHOW DOWN ***
WrongButton: shows [Kc As] (two pair, Aces and Kings)
SteigEin84: shows [7h 7d] (three of a kind, Sevens)
SteigEin84 collected $104.76 from pot
*** SUMMARY ***
Total pot $107.26 | Rake $2.50 
Board [4h Ac Kd 7s 5h]
Seat 1: ccownsu folded before Flop (didn't bet)
Seat 2: BoryaKGB folded before Flop (didn't bet)
Seat 3: bellisimo212 folded before Flop (didn't bet)
Seat 4: christyirish folded before Flop (didn't bet)
Seat 6: maisit* folded before Flop (didn't bet)
Seat 7: maestrodubai (button) folded before Flop (didn't bet)
Seat 8: SteigEin84 (small blind) showed [7h 7d] and won ($104.76) with three of a kind, Sevens
Seat 9: WrongButton (big blind) showed [Kc As] and lost with two pair, Aces and Kings



PokerStars Hand #228696327477:  Hold'em No Limit ($0.25/$0.50 USD) - 2021/07/30 22:41:27 ET
Table 'Aitne III' 9-max Seat #8 is the button
Seat 1: ccownsu ($48.86 in chips) 
Seat 2: BoryaKGB ($50 in chips) 
Seat 3: bellisimo212 ($55.09 in chips) 
Seat 4: christyirish ($95.37 in chips) 
Seat 6: maisit* ($77.45 in chips) 
Seat 7: maestrodubai ($27.08 in chips) 
Seat 8: SteigEin84 ($130.51 in chips) 
Seat 9: WrongButton ($50 in chips) 
WrongButton: posts small blind $0.25
ccownsu: posts big blind $0.50
*** HOLE CARDS ***
BoryaKGB: folds 
bellisimo212: calls $0.50
christyirish: folds 
maisit*: folds 
maestrodubai: folds 
SteigEin84: calls $0.50
WrongButton: folds 
ccownsu: raises $2.50 to $3
bellisimo212: folds 
SteigEin84: calls $2.50
*** FLOP *** [Ks As Qd]
ccownsu: checks 
SteigEin84: checks 
*** TURN *** [Ks As Qd] [9h]
ccownsu: bets $4.50
SteigEin84: calls $4.50
*** RIVER *** [Ks As Qd 9h] [Qh]
ccownsu: checks 
SteigEin84: bets $8
ccownsu: folds 
Uncalled bet ($8) returned to SteigEin84
SteigEin84 collected $14.76 from pot
SteigEin84: doesn't show hand 
*** SUMMARY ***
Total pot $15.75 | Rake $0.99 
Board [Ks As Qd 9h Qh]
Seat 1: ccownsu (big blind) folded on the River
Seat 2: BoryaKGB folded before Flop (didn't bet)
Seat 3: bellisimo212 folded before Flop
Seat 4: christyirish folded before Flop (didn't bet)
Seat 6: maisit* folded before Flop (didn't bet)
Seat 7: maestrodubai folded before Flop (didn't bet)
Seat 8: SteigEin84 (button) collected ($14.76)
Seat 9: WrongButton (small blind) folded before Flop



PokerStars Hand #228696343959:  Hold'em No Limit ($0.25/$0.50 USD) - 2021/07/30 22:42:44 ET
Table 'Aitne III' 9-max Seat #9 is the button
Seat 1: ccownsu ($41.36 in chips) 
Seat 2: BoryaKGB ($50 in chips) 
Seat 3: bellisimo212 ($54.59 in chips) 
Seat 4: christyirish ($95.37 in chips) 
Seat 6: maisit* ($77.45 in chips) 
Seat 7: maestrodubai ($27.08 in chips) 
Seat 8: SteigEin84 ($137.77 in chips) 
Seat 9: WrongButton ($50 in chips) 
ccownsu: posts small blind $0.25
BoryaKGB: posts big blind $0.50
*** HOLE CARDS ***
bellisimo212: folds 
christyirish: folds 
maisit*: raises $1 to $1.50
maestrodubai: folds 
SteigEin84: calls $1.50
WrongButton: folds 
ccownsu: folds 
BoryaKGB: raises $5 to $6.50
maisit*: folds 
SteigEin84: folds 
Uncalled bet ($5) returned to BoryaKGB
BoryaKGB collected $4.75 from pot
BoryaKGB: doesn't show hand 
*** SUMMARY ***
Total pot $4.75 | Rake $0 
Seat 1: ccownsu (small blind) folded before Flop
Seat 2: BoryaKGB (big blind) collected ($4.75)
Seat 3: bellisimo212 folded before Flop (didn't bet)
Seat 4: christyirish folded before Flop (didn't bet)
Seat 6: maisit* folded before Flop
Seat 7: maestrodubai folded before Flop (didn't bet)
Seat 8: SteigEin84 folded before Flop
Seat 9: WrongButton (button) folded before Flop (didn't bet)



PokerStars Hand #228696349775:  Hold'em No Limit ($0.25/$0.50 USD) - 2021/07/30 22:43:11 ET
Table 'Aitne III' 9-max Seat #1 is the button
Seat 1: ccownsu ($41.11 in chips) 
Seat 2: BoryaKGB ($53.25 in chips) 
Seat 3: bellisimo212 ($54.59 in chips) 
Seat 4: christyirish ($95.37 in chips) 
Seat 6: maisit* ($75.95 in chips) 
Seat 7: maestrodubai ($27.08 in chips) 
Seat 8: SteigEin84 ($136.27 in chips) 
Seat 9: WrongButton ($50 in chips) 
BoryaKGB: posts small blind $0.25
bellisimo212: posts big blind $0.50
*** HOLE CARDS ***
christyirish: folds 
maisit*: folds 
maestrodubai: folds 
SteigEin84: raises $1.50 to $2
WrongButton: folds 
ccownsu: raises $1.50 to $3.50
BoryaKGB: folds 
bellisimo212: folds 
SteigEin84: calls $1.50
*** FLOP *** [Qh 2d 8h]
SteigEin84: checks 
ccownsu: bets $3.68
SteigEin84: folds 
Uncalled bet ($3.68) returned to ccownsu
ccownsu collected $7.36 from pot
ccownsu: doesn't show hand 
*** SUMMARY ***
Total pot $7.75 | Rake $0.39 
Board [Qh 2d 8h]
Seat 1: ccownsu (button) collected ($7.36)
Seat 2: BoryaKGB (small blind) folded before Flop
Seat 3: bellisimo212 (big blind) folded before Flop
Seat 4: christyirish folded before Flop (didn't bet)
Seat 6: maisit* folded before Flop (didn't bet)
Seat 7: maestrodubai folded before Flop (didn't bet)
Seat 8: SteigEin84 folded on the Flop
Seat 9: WrongButton folded before Flop (didn't bet)



PokerStars Hand #228696358604:  Hold'em No Limit ($0.25/$0.50 USD) - 2021/07/30 22:43:52 ET
Table 'Aitne III' 9-max Seat #2 is the button
Seat 1: ccownsu ($44.97 in chips) 
Seat 2: BoryaKGB ($53 in chips) 
Seat 3: bellisimo212 ($54.09 in chips) 
Seat 4: christyirish ($95.37 in chips) 
Seat 6: maisit* ($75.95 in chips) 
Seat 7: maestrodubai ($27.08 in chips) 
Seat 8: SteigEin84 ($132.77 in chips) 
Seat 9: WrongButton ($50 in chips) 
bellisimo212: posts small blind $0.25
christyirish: posts big blind $0.50
*** HOLE CARDS ***
maisit* has timed out
maisit*: folds 
maestrodubai: folds 
SteigEin84: raises $0.50 to $1
WrongButton: raises $2.75 to $3.75
ccownsu: folds 
BoryaKGB: folds 
bellisimo212: folds 
christyirish: folds 
SteigEin84: calls $2.75
*** FLOP *** [Jc 8h 6c]
SteigEin84: checks 
WrongButton: checks 
*** TURN *** [Jc 8h 6c] [4c]
SteigEin84: checks 
WrongButton: checks 
*** RIVER *** [Jc 8h 6c 4c] [3s]
SteigEin84: bets $4.92
WrongButton: folds 
Uncalled bet ($4.92) returned to SteigEin84
SteigEin84 collected $7.74 from pot
SteigEin84: doesn't show hand 
*** SUMMARY ***
Total pot $8.25 | Rake $0.51 
Board [Jc 8h 6c 4c 3s]
Seat 1: ccownsu folded before Flop (didn't bet)
Seat 2: BoryaKGB (button) folded before Flop (didn't bet)
Seat 3: bellisimo212 (small blind) folded before Flop
Seat 4: christyirish (big blind) folded before Flop
Seat 6: maisit* folded before Flop (didn't bet)
Seat 7: maestrodubai folded before Flop (didn't bet)
Seat 8: SteigEin84 collected ($7.74)
Seat 9: WrongButton folded on the River



PokerStars Hand #228696373047:  Hold'em No Limit ($0.25/$0.50 USD) - 2021/07/30 22:44:59 ET
Table 'Aitne III' 9-max Seat #3 is the button
Seat 1: ccownsu ($44.97 in chips) 
Seat 2: BoryaKGB ($53 in chips) 
Seat 3: bellisimo212 ($53.84 in chips) 
Seat 4: christyirish ($94.87 in chips) 
Seat 5: jantheman222 ($92.60 in chips) 
Seat 6: maisit* ($75.95 in chips) 
Seat 7: maestrodubai ($27.08 in chips) 
Seat 8: SteigEin84 ($136.76 in chips) 
Seat 9: WrongButton ($50 in chips) 
christyirish: posts small blind $0.25
jantheman222: posts big blind $0.50
*** HOLE CARDS ***
maisit*: folds 
maestrodubai: folds 
SteigEin84: calls $0.50
WrongButton: raises $1 to $1.50
ccownsu: folds 
BoryaKGB: folds 
bellisimo212: folds 
christyirish: folds 
jantheman222: folds 
SteigEin84: calls $1
*** FLOP *** [5d 4s Kc]
SteigEin84: checks 
WrongButton: bets $1.25
SteigEin84: folds 
Uncalled bet ($1.25) returned to WrongButton
WrongButton collected $3.56 from pot
*** SUMMARY ***
Total pot $3.75 | Rake $0.19 
Board [5d 4s Kc]
Seat 1: ccownsu folded before Flop (didn't bet)
Seat 2: BoryaKGB folded before Flop (didn't bet)
Seat 3: bellisimo212 (button) folded before Flop (didn't bet)
Seat 4: christyirish (small blind) folded before Flop
Seat 5: jantheman222 (big blind) folded before Flop
Seat 6: maisit* folded before Flop (didn't bet)
Seat 7: maestrodubai folded before Flop (didn't bet)
Seat 8: SteigEin84 folded on the Flop
Seat 9: WrongButton collected ($3.56)



PokerStars Hand #228696381131:  Hold'em No Limit ($0.25/$0.50 USD) - 2021/07/30 22:45:36 ET
Table 'Aitne III' 9-max Seat #4 is the button
Seat 1: ccownsu ($44.97 in chips) 
Seat 2: BoryaKGB ($53 in chips) 
Seat 3: bellisimo212 ($53.84 in chips) 
Seat 4: christyirish ($94.62 in chips) 
Seat 5: jantheman222 ($92.10 in chips) 
Seat 6: maisit* ($75.95 in chips) 
Seat 7: maestrodubai ($27.08 in chips) 
Seat 8: SteigEin84 ($135.26 in chips) 
Seat 9: WrongButton ($52.06 in chips) 
jantheman222: posts small blind $0.25
maisit*: posts big blind $0.50
*** HOLE CARDS ***
maestrodubai: raises $1 to $1.50
SteigEin84: folds 
WrongButton: folds 
ccownsu: folds 
BoryaKGB: raises $3 to $4.50
bellisimo212: folds 
christyirish: folds 
jantheman222: folds 
maisit*: folds 
maestrodubai: raises $9.75 to $14.25
BoryaKGB: raises $38.75 to $53 and is all-in
maestrodubai: calls $12.83 and is all-in
Uncalled bet ($25.92) returned to BoryaKGB
*** FLOP *** [9c Tc 3s]
*** TURN *** [9c Tc 3s] [Js]
*** RIVER *** [9c Tc 3s Js] [6c]
*** SHOW DOWN ***
maestrodubai: shows [Ac Kh] (high card Ace)
BoryaKGB: shows [Ks Kc] (a pair of Kings)
BoryaKGB collected $52.91 from pot
*** SUMMARY ***
Total pot $54.91 | Rake $2 
Board [9c Tc 3s Js 6c]
Seat 1: ccownsu folded before Flop (didn't bet)
Seat 2: BoryaKGB showed [Ks Kc] and won ($52.91) with a pair of Kings
Seat 3: bellisimo212 folded before Flop (didn't bet)
Seat 4: christyirish (button) folded before Flop (didn't bet)
Seat 5: jantheman222 (small blind) folded before Flop
Seat 6: maisit* (big blind) folded before Flop
Seat 7: maestrodubai showed [Ac Kh] and lost with high card Ace
Seat 8: SteigEin84 folded before Flop (didn't bet)
Seat 9: WrongButton folded before Flop (didn't bet)



PokerStars Hand #228696389916:  Hold'em No Limit ($0.25/$0.50 USD) - 2021/07/30 22:46:17 ET
Table 'Aitne III' 9-max Seat #5 is the button
Seat 1: ccownsu ($44.97 in chips) 
Seat 2: BoryaKGB ($78.83 in chips) 
Seat 3: bellisimo212 ($53.84 in chips) 
Seat 4: christyirish ($94.62 in chips) 
Seat 5: jantheman222 ($91.85 in chips) 
Seat 6: maisit* ($75.45 in chips) 
Seat 8: SteigEin84 ($135.26 in chips) 
Seat 9: WrongButton ($52.06 in chips) 
maisit*: posts small blind $0.25
SteigEin84: posts big blind $0.50
*** HOLE CARDS ***
WrongButton: folds 
ccownsu: folds 
BoryaKGB: folds 
maestrodubai leaves the table
bellisimo212: folds 
Chernovsky joins the table at seat #7 
christyirish: folds 
jantheman222: raises $1 to $1.50
maisit*: folds 
SteigEin84: calls $1
*** FLOP *** [Jh Jc 5s]
SteigEin84: checks 
jantheman222: bets $1.02
SteigEin84: folds 
Uncalled bet ($1.02) returned to jantheman222
jantheman222 collected $3.09 from pot
jantheman222: doesn't show hand 
*** SUMMARY ***
Total pot $3.25 | Rake $0.16 
Board [Jh Jc 5s]
Seat 1: ccownsu folded before Flop (didn't bet)
Seat 2: BoryaKGB folded before Flop (didn't bet)
Seat 3: bellisimo212 folded before Flop (didn't bet)
Seat 4: christyirish folded before Flop (didn't bet)
Seat 5: jantheman222 (button) collected ($3.09)
Seat 6: maisit* (small blind) folded before Flop
Seat 8: SteigEin84 (big blind) folded on the Flop
Seat 9: WrongButton folded before Flop (didn't bet)



PokerStars Hand #228696400704:  Hold'em No Limit ($0.25/$0.50 USD) - 2021/07/30 22:47:01 ET
Table 'Aitne III' 9-max Seat #6 is the button
Seat 1: ccownsu ($44.97 in chips) 
Seat 2: BoryaKGB ($78.83 in chips) 
Seat 3: bellisimo212 ($53.84 in chips) 
Seat 4: christyirish ($94.62 in chips) 
Seat 5: jantheman222 ($93.44 in chips) 
Seat 6: maisit* ($75.20 in chips) 
Seat 8: SteigEin84 ($133.76 in chips) 
Seat 9: WrongButton ($52.06 in chips) 
SteigEin84: posts small blind $0.25
WrongButton: posts big blind $0.50
*** HOLE CARDS ***
ccownsu: folds 
BoryaKGB: folds 
bellisimo212: folds 
christyirish: raises $1 to $1.50
jantheman222: folds 
maisit*: folds 
SteigEin84: folds 
WrongButton: folds 
Uncalled bet ($1) returned to christyirish
christyirish collected $1.25 from pot
*** SUMMARY ***
Total pot $1.25 | Rake $0 
Seat 1: ccownsu folded before Flop (didn't bet)
Seat 2: BoryaKGB folded before Flop (didn't bet)
Seat 3: bellisimo212 folded before Flop (didn't bet)
Seat 4: christyirish collected ($1.25)
Seat 5: jantheman222 folded before Flop (didn't bet)
Seat 6: maisit* (button) folded before Flop (didn't bet)
Seat 8: SteigEin84 (small blind) folded before Flop
Seat 9: WrongButton (big blind) folded before Flop



PokerStars Hand #228696404562:  Hold'em No Limit ($0.25/$0.50 USD) - 2021/07/30 22:47:19 ET
Table 'Aitne III' 9-max Seat #8 is the button
Seat 1: ccownsu ($44.97 in chips) 
Seat 2: BoryaKGB ($78.83 in chips) 
Seat 3: bellisimo212 ($53.84 in chips) 
Seat 4: christyirish ($95.37 in chips) 
Seat 5: jantheman222 ($93.44 in chips) 
Seat 6: maisit* ($75.20 in chips) 
Seat 8: SteigEin84 ($133.51 in chips) 
Seat 9: WrongButton ($51.56 in chips) 
WrongButton: posts small blind $0.25
ccownsu: posts big blind $0.50
Chernovsky: sits out 
*** HOLE CARDS ***
BoryaKGB: folds 
BoryaKGB leaves the table
bellisimo212: folds 
christyirish: folds 
jantheman222: folds 
maisit*: folds 
SteigEin84: folds 
WrongButton: raises $1 to $1.50
ccownsu: folds 
Uncalled bet ($1) returned to WrongButton
WrongButton collected $1 from pot
*** SUMMARY ***
Total pot $1 | Rake $0 
Seat 1: ccownsu (big blind) folded before Flop
Seat 2: BoryaKGB folded before Flop (didn't bet)
Seat 3: bellisimo212 folded before Flop (didn't bet)
Seat 4: christyirish folded before Flop (didn't bet)
Seat 5: jantheman222 folded before Flop (didn't bet)
Seat 6: maisit* folded before Flop (didn't bet)
Seat 8: SteigEin84 (button) folded before Flop (didn't bet)
Seat 9: WrongButton (small blind) collected ($1)



PokerStars Hand #228696408577:  Hold'em No Limit ($0.25/$0.50 USD) - 2021/07/30 22:47:37 ET
Table 'Aitne III' 9-max Seat #9 is the button
Seat 1: ccownsu ($44.47 in chips) 
Seat 3: bellisimo212 ($53.84 in chips) 
Seat 4: christyirish ($95.37 in chips) 
Seat 5: jantheman222 ($93.44 in chips) 
Seat 6: maisit* ($75.20 in chips) 
Seat 8: SteigEin84 ($133.51 in chips) 
Seat 9: WrongButton ($52.06 in chips) 
ccownsu: posts small blind $0.25
bellisimo212: posts big blind $0.50
Chernovsky: sits out 
*** HOLE CARDS ***
christyirish: folds 
jantheman222: folds 
maisit*: folds 
SteigEin84: folds 
WrongButton: folds 
ccownsu: folds 
Uncalled bet ($0.25) returned to bellisimo212
bellisimo212 collected $0.50 from pot
bellisimo212: doesn't show hand 
*** SUMMARY ***
Total pot $0.50 | Rake $0 
Seat 1: ccownsu (small blind) folded before Flop
Seat 3: bellisimo212 (big blind) collected ($0.50)
Seat 4: christyirish folded before Flop (didn't bet)
Seat 5: jantheman222 folded before Flop (didn't bet)
Seat 6: maisit* folded before Flop (didn't bet)
Seat 8: SteigEin84 folded before Flop (didn't bet)
Seat 9: WrongButton (button) folded before Flop (didn't bet)



PokerStars Hand #228696411653:  Hold'em No Limit ($0.25/$0.50 USD) - 2021/07/30 22:47:52 ET
Table 'Aitne III' 9-max Seat #1 is the button
Seat 1: ccownsu ($44.22 in chips) 
Seat 3: bellisimo212 ($54.09 in chips) 
Seat 4: christyirish ($95.37 in chips) 
Seat 5: jantheman222 ($93.44 in chips) 
Seat 6: maisit* ($75.20 in chips) 
Seat 8: SteigEin84 ($133.51 in chips) 
Seat 9: WrongButton ($52.06 in chips) 
bellisimo212: posts small blind $0.25
christyirish: posts big blind $0.50
Chernovsky: sits out 
*** HOLE CARDS ***
jantheman222: folds 
maisit*: folds 
SteigEin84: folds 
WrongButton: folds 
ccownsu: raises $1 to $1.50
bellisimo212: calls $1.25
christyirish: raises $4.50 to $6
ccownsu: folds 
bellisimo212: folds 
Uncalled bet ($4.50) returned to christyirish
christyirish collected $4.50 from pot
christyirish: doesn't show hand 
*** SUMMARY ***
Total pot $4.50 | Rake $0 
Seat 1: ccownsu (button) folded before Flop
Seat 3: bellisimo212 (small blind) folded before Flop
Seat 4: christyirish (big blind) collected ($4.50)
Seat 5: jantheman222 folded before Flop (didn't bet)
Seat 6: maisit* folded before Flop (didn't bet)
Seat 8: SteigEin84 folded before Flop (didn't bet)
Seat 9: WrongButton folded before Flop (didn't bet)



PokerStars Hand #228696417746:  Hold'em No Limit ($0.25/$0.50 USD) - 2021/07/30 22:48:21 ET
Table 'Aitne III' 9-max Seat #3 is the button
Seat 1: ccownsu ($42.72 in chips) 
Seat 3: bellisimo212 ($52.59 in chips) 
Seat 4: christyirish ($98.37 in chips) 
Seat 5: jantheman222 ($93.44 in chips) 
Seat 6: maisit* ($75.20 in chips) 
Seat 8: SteigEin84 ($133.51 in chips) 
Seat 9: WrongButton ($52.06 in chips) 
christyirish: posts small blind $0.25
jantheman222: posts big blind $0.50
Chernovsky: sits out 
*** HOLE CARDS ***
maisit*: raises $1 to $1.50
SteigEin84: calls $1.50
WrongButton: folds 
ccownsu: folds 
bellisimo212: folds 
christyirish: folds 
jantheman222: folds 
*** FLOP *** [6s 9h Qs]
maisit*: checks 
SteigEin84: bets $1
maisit*: calls $1
*** TURN *** [6s 9h Qs] [7h]
maisit*: checks 
SteigEin84: bets $2.50
maisit*: folds 
Uncalled bet ($2.50) returned to SteigEin84
SteigEin84 collected $5.39 from pot
SteigEin84: doesn't show hand 
*** SUMMARY ***
Total pot $5.75 | Rake $0.36 
Board [6s 9h Qs 7h]
Seat 1: ccownsu folded before Flop (didn't bet)
Seat 3: bellisimo212 (button) folded before Flop (didn't bet)
Seat 4: christyirish (small blind) folded before Flop
Seat 5: jantheman222 (big blind) folded before Flop
Seat 6: maisit* folded on the Turn
Seat 8: SteigEin84 collected ($5.39)
Seat 9: WrongButton folded before Flop (didn't bet)



PokerStars Hand #228696426362:  Hold'em No Limit ($0.25/$0.50 USD) - 2021/07/30 22:49:02 ET
Table 'Aitne III' 9-max Seat #4 is the button
Seat 1: ccownsu ($42.72 in chips) 
Seat 3: bellisimo212 ($52.59 in chips) 
Seat 4: christyirish ($98.12 in chips) 
Seat 5: jantheman222 ($92.94 in chips) 
Seat 6: maisit* ($72.70 in chips) 
Seat 8: SteigEin84 ($136.40 in chips) 
Seat 9: WrongButton ($52.06 in chips) 
jantheman222: posts small blind $0.25
maisit*: posts big blind $0.50
Chernovsky: sits out 
*** HOLE CARDS ***
SteigEin84: raises $0.50 to $1
WrongButton: folds 
ccownsu: folds 
bellisimo212: folds 
christyirish: folds 
jantheman222: folds 
maisit*: calls $0.50
*** FLOP *** [Tc Kc Kd]
maisit*: checks 
SteigEin84: bets $1
maisit*: calls $1
*** TURN *** [Tc Kc Kd] [4d]
maisit*: checks 
SteigEin84: bets $2
maisit*: folds 
Uncalled bet ($2) returned to SteigEin84
SteigEin84 collected $3.99 from pot
SteigEin84: doesn't show hand 
*** SUMMARY ***
Total pot $4.25 | Rake $0.26 
Board [Tc Kc Kd 4d]
Seat 1: ccownsu folded before Flop (didn't bet)
Seat 3: bellisimo212 folded before Flop (didn't bet)
Seat 4: christyirish (button) folded before Flop (didn't bet)
Seat 5: jantheman222 (small blind) folded before Flop
Seat 6: maisit* (big blind) folded on the Turn
Seat 8: SteigEin84 collected ($3.99)
Seat 9: WrongButton folded before Flop (didn't bet)



PokerStars Hand #228696436120:  Hold'em No Limit ($0.25/$0.50 USD) - 2021/07/30 22:49:48 ET
Table 'Aitne III' 9-max Seat #5 is the button
Seat 1: ccownsu ($42.72 in chips) 
Seat 3: bellisimo212 ($52.59 in chips) 
Seat 4: christyirish ($98.12 in chips) 
Seat 5: jantheman222 ($92.69 in chips) 
Seat 6: maisit* ($70.70 in chips) 
Seat 7: Chernovsky ($54.63 in chips) 
Seat 8: SteigEin84 ($138.39 in chips) 
Seat 9: WrongButton ($52.06 in chips) 
maisit*: posts small blind $0.25
Chernovsky: posts big blind $0.50
*** HOLE CARDS ***
SteigEin84: folds 
WrongButton: folds 
ccownsu: folds 
bellisimo212: folds 
Rorerzap joins the table at seat #2 
christyirish: raises $1 to $1.50
jantheman222: folds 
maisit*: folds 
Chernovsky: folds 
Uncalled bet ($1) returned to christyirish
christyirish collected $1.25 from pot
*** SUMMARY ***
Total pot $1.25 | Rake $0 
Seat 1: ccownsu folded before Flop (didn't bet)
Seat 3: bellisimo212 folded before Flop (didn't bet)
Seat 4: christyirish collected ($1.25)
Seat 5: jantheman222 (button) folded before Flop (didn't bet)
Seat 6: maisit* (small blind) folded before Flop
Seat 7: Chernovsky (big blind) folded before Flop
Seat 8: SteigEin84 folded before Flop (didn't bet)
Seat 9: WrongButton folded before Flop (didn't bet)



PokerStars Hand #228696442024:  Hold'em No Limit ($0.25/$0.50 USD) - 2021/07/30 22:50:16 ET
Table 'Aitne III' 9-max Seat #6 is the button
Seat 1: ccownsu ($42.72 in chips) 
Seat 3: bellisimo212 ($52.59 in chips) 
Seat 4: christyirish ($98.87 in chips) 
Seat 5: jantheman222 ($92.69 in chips) 
Seat 6: maisit* ($70.45 in chips) 
Seat 7: Chernovsky ($54.13 in chips) 
Seat 9: WrongButton ($52.06 in chips) 
Chernovsky: posts small blind $0.25
SteigEin84 has timed out
SteigEin84: is sitting out 
WrongButton: posts big blind $0.50
Rorerzap: sits out 
*** HOLE CARDS ***
ccownsu: folds 
bellisimo212: folds 
christyirish: raises $1 to $1.50
jantheman222: folds 
maisit*: folds 
Chernovsky: folds 
WrongButton: folds 
Uncalled bet ($1) returned to christyirish
christyirish collected $1.25 from pot
*** SUMMARY ***
Total pot $1.25 | Rake $0 
Seat 1: ccownsu folded before Flop (didn't bet)
Seat 3: bellisimo212 folded before Flop (didn't bet)
Seat 4: christyirish collected ($1.25)
Seat 5: jantheman222 folded before Flop (didn't bet)
Seat 6: maisit* (button) folded before Flop (didn't bet)
Seat 7: Chernovsky (small blind) folded before Flop
Seat 9: WrongButton (big blind) folded before Flop



PokerStars Hand #228696447776:  Hold'em No Limit ($0.25/$0.50 USD) - 2021/07/30 22:50:44 ET
Table 'Aitne III' 9-max Seat #7 is the button
Seat 1: ccownsu ($42.72 in chips) 
Seat 3: bellisimo212 ($52.59 in chips) 
Seat 4: christyirish ($99.62 in chips) 
Seat 5: jantheman222 ($92.69 in chips) 
Seat 6: maisit* ($70.45 in chips) 
Seat 7: Chernovsky ($53.88 in chips) 
Seat 9: WrongButton ($51.56 in chips) 
WrongButton: posts small blind $0.25
ccownsu: posts big blind $0.50
Rorerzap: sits out 
*** HOLE CARDS ***
bellisimo212: folds 
christyirish: raises $1 to $1.50
jantheman222: folds 
maisit*: raises $3 to $4.50
Chernovsky: folds 
WrongButton: folds 
ccownsu: folds 
christyirish: raises $8 to $12.50
maisit*: folds 
Uncalled bet ($8) returned to christyirish
christyirish collected $9.75 from pot
*** SUMMARY ***
Total pot $9.75 | Rake $0 
Seat 1: ccownsu (big blind) folded before Flop
Seat 3: bellisimo212 folded before Flop (didn't bet)
Seat 4: christyirish collected ($9.75)
Seat 5: jantheman222 folded before Flop (didn't bet)
Seat 6: maisit* folded before Flop
Seat 7: Chernovsky (button) folded before Flop (didn't bet)
Seat 9: WrongButton (small blind) folded before Flop



PokerStars Hand #228696461639:  Hold'em No Limit ($0.25/$0.50 USD) - 2021/07/30 22:51:22 ET
Table 'Aitne III' 9-max Seat #9 is the button
Seat 1: ccownsu ($42.22 in chips) 
Seat 2: Rorerzap ($50 in chips) 
Seat 3: bellisimo212 ($52.59 in chips) 
Seat 4: christyirish ($104.87 in chips) 
Seat 5: jantheman222 ($92.69 in chips) 
Seat 6: maisit* ($65.95 in chips) 
Seat 7: Chernovsky ($53.88 in chips) 
Seat 8: SteigEin84 ($138.39 in chips) 
Seat 9: WrongButton ($51.31 in chips) 
ccownsu: posts small blind $0.25
Rorerzap: posts big blind $0.50
SteigEin84: posts small & big blinds $0.75
*** HOLE CARDS ***
bellisimo212: folds 
christyirish: folds 
jantheman222: folds 
maisit*: folds 
Chernovsky: folds 
SteigEin84: checks 
WrongButton: folds 
ccownsu: folds 
Rorerzap: checks 
*** FLOP *** [Jd 4d 2s]
Rorerzap: checks 
SteigEin84: bets $1
Rorerzap: folds 
Uncalled bet ($1) returned to SteigEin84
SteigEin84 collected $1.40 from pot
SteigEin84: doesn't show hand 
*** SUMMARY ***
Total pot $1.50 | Rake $0.10 
Board [Jd 4d 2s]
Seat 1: ccownsu (small blind) folded before Flop
Seat 2: Rorerzap (big blind) folded on the Flop
Seat 3: bellisimo212 folded before Flop (didn't bet)
Seat 4: christyirish folded before Flop (didn't bet)
Seat 5: jantheman222 folded before Flop (didn't bet)
Seat 6: maisit* folded before Flop (didn't bet)
Seat 7: Chernovsky folded before Flop (didn't bet)
Seat 8: SteigEin84 collected ($1.40)
Seat 9: WrongButton (button) folded before Flop (didn't bet)



PokerStars Hand #228696467357:  Hold'em No Limit ($0.25/$0.50 USD) - 2021/07/30 22:51:49 ET
Table 'Aitne III' 9-max Seat #1 is the button
Seat 1: ccownsu ($41.97 in chips) 
Seat 2: Rorerzap ($50 in chips) 
Seat 3: bellisimo212 ($52.59 in chips) 
Seat 4: christyirish ($104.87 in chips) 
Seat 5: jantheman222 ($92.69 in chips) 
Seat 6: maisit* ($65.95 in chips) 
Seat 7: Chernovsky ($53.88 in chips) 
Seat 8: SteigEin84 ($139.04 in chips) 
Seat 9: WrongButton ($51.31 in chips) 
Rorerzap: posts small blind $0.25
bellisimo212: posts big blind $0.50
*** HOLE CARDS ***
christyirish: folds 
jantheman222: raises $0.75 to $1.25
maisit*: folds 
Chernovsky: folds 
SteigEin84: calls $1.25
WrongButton: folds 
ccownsu: folds 
Rorerzap: folds 
bellisimo212: folds 
*** FLOP *** [6s Qc 6c]
jantheman222: checks 
SteigEin84: bets $1.50
jantheman222: calls $1.50
*** TURN *** [6s Qc 6c] [Qh]
jantheman222: checks 
SteigEin84: bets $2.50
jantheman222: calls $2.50
*** RIVER *** [6s Qc 6c Qh] [Qs]
jantheman222: checks 
SteigEin84: bets $4
jantheman222: calls $4
*** SHOW DOWN ***
SteigEin84: shows [Qd 9c] (four of a kind, Queens)
jantheman222: mucks hand 
SteigEin84 collected $18.05 from pot
*** SUMMARY ***
Total pot $19.25 | Rake $1.20 
Board [6s Qc 6c Qh Qs]
Seat 1: ccownsu (button) folded before Flop (didn't bet)
Seat 2: Rorerzap (small blind) folded before Flop
Seat 3: bellisimo212 (big blind) folded before Flop
Seat 4: christyirish folded before Flop (didn't bet)
Seat 5: jantheman222 mucked
Seat 6: maisit* folded before Flop (didn't bet)
Seat 7: Chernovsky folded before Flop (didn't bet)
Seat 8: SteigEin84 showed [Qd 9c] and won ($18.05) with four of a kind, Queens
Seat 9: WrongButton folded before Flop (didn't bet)



PokerStars Hand #228696490099:  Hold'em No Limit ($0.25/$0.50 USD) - 2021/07/30 22:53:05 ET
Table 'Aitne III' 9-max Seat #2 is the button
Seat 1: ccownsu ($41.97 in chips) 
Seat 2: Rorerzap ($50 in chips) 
Seat 3: bellisimo212 ($52.09 in chips) 
Seat 4: christyirish ($104.87 in chips) 
Seat 5: jantheman222 ($83.44 in chips) 
Seat 6: maisit* ($65.95 in chips) 
Seat 7: Chernovsky ($53.88 in chips) 
Seat 8: SteigEin84 ($147.84 in chips) 
Seat 9: WrongButton ($51.31 in chips) 
bellisimo212: posts small blind $0.25
christyirish: posts big blind $0.50
*** HOLE CARDS ***
jantheman222: folds 
maisit*: folds 
Chernovsky: folds 
Chernovsky leaves the table
SteigEin84: calls $0.50
WrongButton: folds 
ccownsu: folds 
Rorerzap: folds 
bellisimo212: folds 
christyirish: checks 
*** FLOP *** [Th 3s 8d]
christyirish: checks 
SteigEin84: bets $0.50
christyirish: calls $0.50
*** TURN *** [Th 3s 8d] [Qc]
christyirish: checks 
perff joins the table at seat #7 
SteigEin84: checks 
*** RIVER *** [Th 3s 8d Qc] [Ah]
christyirish: checks 
SteigEin84: bets $1.50
christyirish: folds 
Uncalled bet ($1.50) returned to SteigEin84
SteigEin84 collected $2.11 from pot
SteigEin84: doesn't show hand 
*** SUMMARY ***
Total pot $2.25 | Rake $0.14 
Board [Th 3s 8d Qc Ah]
Seat 1: ccownsu folded before Flop (didn't bet)
Seat 2: Rorerzap (button) folded before Flop (didn't bet)
Seat 3: bellisimo212 (small blind) folded before Flop
Seat 4: christyirish (big blind) folded on the River
Seat 5: jantheman222 folded before Flop (didn't bet)
Seat 6: maisit* folded before Flop (didn't bet)
Seat 7: Chernovsky folded before Flop (didn't bet)
Seat 8: SteigEin84 collected ($2.11)
Seat 9: WrongButton folded before Flop (didn't bet)



PokerStars Hand #228696502859:  Hold'em No Limit ($0.25/$0.50 USD) - 2021/07/30 22:54:06 ET
Table 'Aitne III' 9-max Seat #3 is the button
Seat 1: ccownsu ($41.97 in chips) 
Seat 2: Rorerzap ($50 in chips) 
Seat 3: bellisimo212 ($51.84 in chips) 
Seat 4: christyirish ($103.87 in chips) 
Seat 5: jantheman222 ($83.44 in chips) 
Seat 6: maisit* ($65.95 in chips) 
Seat 7: perff ($20 in chips) 
Seat 8: SteigEin84 ($148.95 in chips) 
Seat 9: WrongButton ($51.31 in chips) 
christyirish: posts small blind $0.25
jantheman222: posts big blind $0.50
perff: posts big blind $0.50
*** HOLE CARDS ***
maisit* has timed out
maisit*: folds 
perff: checks 
SteigEin84: folds 
WrongButton: folds 
ccownsu: folds 
Rorerzap: folds 
bellisimo212: folds 
christyirish: folds 
jantheman222: checks 
*** FLOP *** [9c 5s Ac]
jantheman222: checks 
perff: checks 
*** TURN *** [9c 5s Ac] [3s]
jantheman222: bets $0.95
perff: folds 
Uncalled bet ($0.95) returned to jantheman222
jantheman222 collected $1.19 from pot
jantheman222: doesn't show hand 
*** SUMMARY ***
Total pot $1.25 | Rake $0.06 
Board [9c 5s Ac 3s]
Seat 1: ccownsu folded before Flop (didn't bet)
Seat 2: Rorerzap folded before Flop (didn't bet)
Seat 3: bellisimo212 (button) folded before Flop (didn't bet)
Seat 4: christyirish (small blind) folded before Flop
Seat 5: jantheman222 (big blind) collected ($1.19)
Seat 6: maisit* folded before Flop (didn't bet)
Seat 7: perff folded on the Turn (didn't bet)
Seat 8: SteigEin84 folded before Flop (didn't bet)
Seat 9: WrongButton folded before Flop (didn't bet)



PokerStars Hand #228696510826:  Hold'em No Limit ($0.25/$0.50 USD) - 2021/07/30 22:54:45 ET
Table 'Aitne III' 9-max Seat #4 is the button
Seat 1: ccownsu ($41.97 in chips) 
Seat 2: Rorerzap ($50 in chips) 
Seat 3: bellisimo212 ($51.84 in chips) 
Seat 4: christyirish ($103.62 in chips) 
Seat 5: jantheman222 ($84.13 in chips) 
Seat 6: maisit* ($65.95 in chips) 
Seat 7: perff ($19.50 in chips) 
Seat 8: SteigEin84 ($148.95 in chips) 
Seat 9: WrongButton ($51.31 in chips) 
jantheman222: posts small blind $0.25
maisit*: posts big blind $0.50
*** HOLE CARDS ***
perff: folds 
SteigEin84: folds 
WrongButton: folds 
ccownsu: folds 
Rorerzap: folds 
bellisimo212: folds 
christyirish: raises $1 to $1.50
jantheman222: folds 
maisit*: folds 
Uncalled bet ($1) returned to christyirish
christyirish collected $1.25 from pot
*** SUMMARY ***
Total pot $1.25 | Rake $0 
Seat 1: ccownsu folded before Flop (didn't bet)
Seat 2: Rorerzap folded before Flop (didn't bet)
Seat 3: bellisimo212 folded before Flop (didn't bet)
Seat 4: christyirish (button) collected ($1.25)
Seat 5: jantheman222 (small blind) folded before Flop
Seat 6: maisit* (big blind) folded before Flop
Seat 7: perff folded before Flop (didn't bet)
Seat 8: SteigEin84 folded before Flop (didn't bet)
Seat 9: WrongButton folded before Flop (didn't bet)



PokerStars Hand #228696521156:  Hold'em No Limit ($0.25/$0.50 USD) - 2021/07/30 22:55:40 ET
Table 'Aitne III' 9-max Seat #5 is the button
Seat 1: ccownsu ($41.97 in chips) 
Seat 2: Rorerzap ($50 in chips) 
Seat 3: bellisimo212 ($51.84 in chips) 
Seat 4: christyirish ($104.37 in chips) 
Seat 5: jantheman222 ($83.88 in chips) 
Seat 6: maisit* ($65.45 in chips) 
Seat 7: perff ($19.50 in chips) 
Seat 8: SteigEin84 ($148.95 in chips) 
Seat 9: WrongButton ($51.31 in chips) 
maisit*: posts small blind $0.25
perff: posts big blind $0.50
*** HOLE CARDS ***
SteigEin84: folds 
WrongButton: folds 
ccownsu: folds 
Rorerzap: folds 
bellisimo212: folds 
christyirish: folds 
SteigEin84 leaves the table
jantheman222: raises $0.75 to $1.25
maisit*: folds 
perff: folds 
Uncalled bet ($0.75) returned to jantheman222
jantheman222 collected $1.25 from pot
*** SUMMARY ***
Total pot $1.25 | Rake $0 
Seat 1: ccownsu folded before Flop (didn't bet)
Seat 2: Rorerzap folded before Flop (didn't bet)
Seat 3: bellisimo212 folded before Flop (didn't bet)
Seat 4: christyirish folded before Flop (didn't bet)
Seat 5: jantheman222 (button) collected ($1.25)
Seat 6: maisit* (small blind) folded before Flop
Seat 7: perff (big blind) folded before Flop
Seat 8: SteigEin84 folded before Flop (didn't bet)
Seat 9: WrongButton folded before Flop (didn't bet)



PokerStars Hand #228696531425:  Hold'em No Limit ($0.25/$0.50 USD) - 2021/07/30 22:56:00 ET
Table 'Aitne III' 9-max Seat #6 is the button
Seat 1: ccownsu ($41.97 in chips) 
Seat 2: Rorerzap ($50 in chips) 
Seat 3: bellisimo212 ($51.84 in chips) 
Seat 4: christyirish ($104.37 in chips) 
Seat 5: jantheman222 ($84.63 in chips) 
Seat 6: maisit* ($65.20 in chips) 
Seat 7: perff ($19 in chips) 
perff: posts small blind $0.25
WrongButton: is sitting out 
ccownsu: posts big blind $0.50
*** HOLE CARDS ***
Rorerzap: folds 
bellisimo212: folds 
christyirish: folds 
jantheman222: folds 
maisit* has timed out
maisit*: folds 
perff: raises $1 to $1.50
ccownsu: folds 
Uncalled bet ($1) returned to perff
perff collected $1 from pot
*** SUMMARY ***
Total pot $1 | Rake $0 
Seat 1: ccownsu (big blind) folded before Flop
Seat 2: Rorerzap folded before Flop (didn't bet)
Seat 3: bellisimo212 folded before Flop (didn't bet)
Seat 4: christyirish folded before Flop (didn't bet)
Seat 5: jantheman222 folded before Flop (didn't bet)
Seat 6: maisit* (button) folded before Flop (didn't bet)
Seat 7: perff (small blind) collected ($1)



PokerStars Hand #228696539093:  Hold'em No Limit ($0.25/$0.50 USD) - 2021/07/30 22:56:45 ET
Table 'Aitne III' 9-max Seat #7 is the button
Seat 1: ccownsu ($41.47 in chips) 
Seat 2: Rorerzap ($50 in chips) 
Seat 3: bellisimo212 ($51.84 in chips) 
Seat 4: christyirish ($104.37 in chips) 
Seat 5: jantheman222 ($84.63 in chips) 
Seat 7: perff ($19.50 in chips) 
ccownsu: posts small blind $0.25
Rorerzap: posts big blind $0.50
*** HOLE CARDS ***
bellisimo212: raises $1 to $1.50
christyirish: folds 
jantheman222: calls $1.50
perff: folds 
ccownsu: raises $3 to $4.50
Rorerzap: folds 
bellisimo212: calls $3
WrongButton leaves the table
jantheman222: calls $3
*** FLOP *** [Jh 3c 2s]
TimmyO1111 joins the table at seat #9 
Chernovsky joins the table at seat #8 
ccownsu: bets $8
bellisimo212: raises $10 to $18
jantheman222: folds 
ccownsu: folds 
Uncalled bet ($10) returned to bellisimo212
bellisimo212 collected $28.50 from pot
bellisimo212: doesn't show hand 
*** SUMMARY ***
Total pot $30 | Rake $1.50 
Board [Jh 3c 2s]
Seat 1: ccownsu (small blind) folded on the Flop
Seat 2: Rorerzap (big blind) folded before Flop
Seat 3: bellisimo212 collected ($28.50)
Seat 4: christyirish folded before Flop (didn't bet)
Seat 5: jantheman222 folded on the Flop
Seat 7: perff (button) folded before Flop (didn't bet)



PokerStars Hand #228696559993:  Hold'em No Limit ($0.25/$0.50 USD) - 2021/07/30 22:58:45 ET
Table 'Aitne III' 9-max Seat #1 is the button
Seat 1: ccownsu ($28.97 in chips) 
Seat 2: Rorerzap ($50 in chips) 
Seat 4: christyirish ($104.37 in chips) 
Seat 5: jantheman222 ($80.13 in chips) 
Seat 6: maisit* ($65.20 in chips) 
Seat 7: perff ($19.50 in chips) 
Seat 9: TimmyO1111 ($29.05 in chips) 
Rorerzap: posts small blind $0.25
bellisimo212: is sitting out 
christyirish: posts big blind $0.50
Chernovsky: sits out 
TimmyO1111: posts big blind $0.50
*** HOLE CARDS ***
jantheman222: folds 
maisit*: folds 
perff: folds 
TimmyO1111: checks 
ccownsu: folds 
Rorerzap: folds 
ccownsu leaves the table
christyirish: checks 
*** FLOP *** [6h Td 5c]
christyirish: checks 
TimmyO1111: checks 
*** TURN *** [6h Td 5c] [4h]
christyirish: bets $0.89
bellisimo212 leaves the table
TimmyO1111: folds 
Uncalled bet ($0.89) returned to christyirish
christyirish collected $1.19 from pot
*** SUMMARY ***
Total pot $1.25 | Rake $0.06 
Board [6h Td 5c 4h]
Seat 1: ccownsu (button) folded before Flop (didn't bet)
Seat 2: Rorerzap (small blind) folded before Flop
Seat 4: christyirish (big blind) collected ($1.19)
Seat 5: jantheman222 folded before Flop (didn't bet)
Seat 6: maisit* folded before Flop (didn't bet)
Seat 7: perff folded before Flop (didn't bet)
Seat 9: TimmyO1111 folded on the Turn (didn't bet)



PokerStars Hand #228696564625:  Hold'em No Limit ($0.25/$0.50 USD) - 2021/07/30 22:59:12 ET
Table 'Aitne III' 9-max Seat #2 is the button
Seat 2: Rorerzap ($50 in chips) 
Seat 4: christyirish ($105.06 in chips) 
Seat 5: jantheman222 ($80.13 in chips) 
Seat 6: maisit* ($65.20 in chips) 
Seat 7: perff ($19.50 in chips) 
Seat 9: TimmyO1111 ($28.55 in chips) 
christyirish: posts small blind $0.25
jantheman222: posts big blind $0.50
Chernovsky: sits out 
*** HOLE CARDS ***
maisit*: folds 
perff: folds 
TimmyO1111: calls $0.50
TeddyKGB865 joins the table at seat #1 
SwimmingPooI joins the table at seat #3 
Rorerzap: raises $2.50 to $3
christyirish: folds 
jantheman222: calls $2.50
TimmyO1111: folds 
*** FLOP *** [Ac Jh Kc]
jantheman222: checks 
Rorerzap: bets $5
jantheman222: folds 
Uncalled bet ($5) returned to Rorerzap
Rorerzap collected $6.41 from pot
Rorerzap: doesn't show hand 
*** SUMMARY ***
Total pot $6.75 | Rake $0.34 
Board [Ac Jh Kc]
Seat 2: Rorerzap (button) collected ($6.41)
Seat 4: christyirish (small blind) folded before Flop
Seat 5: jantheman222 (big blind) folded on the Flop
Seat 6: maisit* folded before Flop (didn't bet)
Seat 7: perff folded before Flop (didn't bet)
Seat 9: TimmyO1111 folded before Flop



PokerStars Hand #228696572255:  Hold'em No Limit ($0.25/$0.50 USD) - 2021/07/30 22:59:57 ET
Table 'Aitne III' 9-max Seat #5 is the button
Seat 1: TeddyKGB865 ($40 in chips) 
Seat 2: Rorerzap ($53.41 in chips) 
Seat 5: jantheman222 ($77.13 in chips) 
Seat 6: maisit* ($65.20 in chips) 
Seat 7: perff ($19.50 in chips) 
Seat 9: TimmyO1111 ($28.05 in chips) 
maisit*: posts small blind $0.25
perff: posts big blind $0.50
Chernovsky: sits out 
TeddyKGB865: posts big blind $0.50
SwimmingPooI: sits out 
*** HOLE CARDS ***
TimmyO1111: calls $0.50
TeddyKGB865: raises $4.50 to $5
Rorerzap: raises $7.50 to $12.50
jantheman222: folds 
maisit*: folds 
perff: folds 
TimmyO1111: folds 
TeddyKGB865: raises $27.50 to $40 and is all-in
Rorerzap: calls $27.50
*** FLOP *** [8d Ac 6h]
*** TURN *** [8d Ac 6h] [Qs]
*** RIVER *** [8d Ac 6h Qs] [4c]
*** SHOW DOWN ***
TeddyKGB865: shows [Kh Kd] (a pair of Kings)
Rorerzap: shows [Qd Qh] (three of a kind, Queens)
Rorerzap collected $79.25 from pot
*** SUMMARY ***
Total pot $81.25 | Rake $2 
Board [8d Ac 6h Qs 4c]
Seat 1: TeddyKGB865 showed [Kh Kd] and lost with a pair of Kings
Seat 2: Rorerzap showed [Qd Qh] and won ($79.25) with three of a kind, Queens
Seat 5: jantheman222 (button) folded before Flop (didn't bet)
Seat 6: maisit* (small blind) folded before Flop
Seat 7: perff (big blind) folded before Flop
Seat 9: TimmyO1111 folded before Flop



PokerStars Hand #228696582260:  Hold'em No Limit ($0.25/$0.50 USD) - 2021/07/30 23:00:50 ET
Table 'Aitne III' 9-max Seat #6 is the button
Seat 2: Rorerzap ($92.66 in chips) 
Seat 4: christyirish ($104.81 in chips) 
Seat 5: jantheman222 ($77.13 in chips) 
Seat 6: maisit* ($64.95 in chips) 
Seat 7: perff ($19 in chips) 
Seat 8: Chernovsky ($53.88 in chips) 
Seat 9: TimmyO1111 ($27.55 in chips) 
perff: posts small blind $0.25
Chernovsky: posts big blind $0.50
SwimmingPooI: sits out 
*** HOLE CARDS ***
TimmyO1111: folds 
Rorerzap: folds 
christyirish: folds 
jantheman222: folds 
maisit*: raises $1 to $1.50
perff: folds 
Chernovsky: folds 
Uncalled bet ($1) returned to maisit*
maisit* collected $1.25 from pot
maisit*: doesn't show hand 
*** SUMMARY ***
Total pot $1.25 | Rake $0 
Seat 2: Rorerzap folded before Flop (didn't bet)
Seat 4: christyirish folded before Flop (didn't bet)
Seat 5: jantheman222 folded before Flop (didn't bet)
Seat 6: maisit* (button) collected ($1.25)
Seat 7: perff (small blind) folded before Flop
Seat 8: Chernovsky (big blind) folded before Flop
Seat 9: TimmyO1111 folded before Flop (didn't bet)



PokerStars Hand #228696584269:  Hold'em No Limit ($0.25/$0.50 USD) - 2021/07/30 23:01:00 ET
Table 'Aitne III' 9-max Seat #7 is the button
Seat 2: Rorerzap ($92.66 in chips) 
Seat 4: christyirish ($104.81 in chips) 
Seat 5: jantheman222 ($77.13 in chips) 
Seat 6: maisit* ($65.70 in chips) 
Seat 7: perff ($18.75 in chips) 
Seat 8: Chernovsky ($53.38 in chips) 
Seat 9: TimmyO1111 ($27.55 in chips) 
Chernovsky: posts small blind $0.25
TimmyO1111: posts big blind $0.50
SwimmingPooI: sits out 
*** HOLE CARDS ***
Rorerzap: folds 
christyirish: folds 
jantheman222: folds 
maisit*: raises $1 to $1.50
perff: folds 
Chernovsky: folds 
TimmyO1111: folds 
Uncalled bet ($1) returned to maisit*
maisit* collected $1.25 from pot
maisit*: doesn't show hand 
*** SUMMARY ***
Total pot $1.25 | Rake $0 
Seat 2: Rorerzap folded before Flop (didn't bet)
Seat 4: christyirish folded before Flop (didn't bet)
Seat 5: jantheman222 folded before Flop (didn't bet)
Seat 6: maisit* collected ($1.25)
Seat 7: perff (button) folded before Flop (didn't bet)
Seat 8: Chernovsky (small blind) folded before Flop
Seat 9: TimmyO1111 (big blind) folded before Flop



PokerStars Hand #228696586652:  Hold'em No Limit ($0.25/$0.50 USD) - 2021/07/30 23:01:12 ET
Table 'Aitne III' 9-max Seat #8 is the button
Seat 2: Rorerzap ($92.66 in chips) 
Seat 4: christyirish ($104.81 in chips) 
Seat 5: jantheman222 ($77.13 in chips) 
Seat 6: maisit* ($66.45 in chips) 
Seat 7: perff ($18.75 in chips) 
Seat 8: Chernovsky ($53.13 in chips) 
Seat 9: TimmyO1111 ($27.05 in chips) 
TimmyO1111: posts small blind $0.25
Rorerzap: posts big blind $0.50
SwimmingPooI: sits out 
*** HOLE CARDS ***
christyirish: folds 
jantheman222: folds 
maisit*: folds 
perff: folds 
Chernovsky: raises $0.75 to $1.25
TimmyO1111: calls $1
Rorerzap: folds 
*** FLOP *** [9s Jd 9h]
TimmyO1111: checks 
Chernovsky: bets $0.97
TimmyO1111: calls $0.97
*** TURN *** [9s Jd 9h] [9c]
TimmyO1111: checks 
Chernovsky: checks 
*** RIVER *** [9s Jd 9h 9c] [4c]
TimmyO1111: bets $3.50
Chernovsky: folds 
Uncalled bet ($3.50) returned to TimmyO1111
TimmyO1111 collected $4.69 from pot
TimmyO1111: doesn't show hand 
*** SUMMARY ***
Total pot $4.94 | Rake $0.25 
Board [9s Jd 9h 9c 4c]
Seat 2: Rorerzap (big blind) folded before Flop
Seat 4: christyirish folded before Flop (didn't bet)
Seat 5: jantheman222 folded before Flop (didn't bet)
Seat 6: maisit* folded before Flop (didn't bet)
Seat 7: perff folded before Flop (didn't bet)
Seat 8: Chernovsky (button) folded on the River
Seat 9: TimmyO1111 (small blind) collected ($4.69)



PokerStars Hand #228696594644:  Hold'em No Limit ($0.25/$0.50 USD) - 2021/07/30 23:01:52 ET
Table 'Aitne III' 9-max Seat #9 is the button
Seat 2: Rorerzap ($92.16 in chips) 
Seat 4: christyirish ($104.81 in chips) 
Seat 5: jantheman222 ($77.13 in chips) 
Seat 6: maisit* ($66.45 in chips) 
Seat 7: perff ($18.75 in chips) 
Seat 8: Chernovsky ($50.91 in chips) 
Seat 9: TimmyO1111 ($29.52 in chips) 
Rorerzap: posts small blind $0.25
SwimmingPooI: is sitting out 
SwimmingPooI leaves the table
christyirish: posts big blind $0.50
*** HOLE CARDS ***
jantheman222: folds 
maisit*: folds 
perff: folds 
TeddyKGB865 leaves the table
Chernovsky: raises $0.75 to $1.25
TimmyO1111: folds 
Rorerzap: folds 
christyirish: calls $0.75
*** FLOP *** [5c 5s Ac]
christyirish: checks 
Chernovsky: bets $0.89
christyirish: folds 
Uncalled bet ($0.89) returned to Chernovsky
Chernovsky collected $2.61 from pot
Chernovsky: doesn't show hand 
*** SUMMARY ***
Total pot $2.75 | Rake $0.14 
Board [5c 5s Ac]
Seat 2: Rorerzap (small blind) folded before Flop
Seat 4: christyirish (big blind) folded on the Flop
Seat 5: jantheman222 folded before Flop (didn't bet)
Seat 6: maisit* folded before Flop (didn't bet)
Seat 7: perff folded before Flop (didn't bet)
Seat 8: Chernovsky collected ($2.61)
Seat 9: TimmyO1111 (button) folded before Flop (didn't bet)



PokerStars Hand #228696599673:  Hold'em No Limit ($0.25/$0.50 USD) - 2021/07/30 23:02:17 ET
Table 'Aitne III' 9-max Seat #2 is the button
Seat 2: Rorerzap ($91.91 in chips) 
Seat 4: christyirish ($103.56 in chips) 
Seat 5: jantheman222 ($77.13 in chips) 
Seat 6: maisit* ($66.45 in chips) 
Seat 7: perff ($18.75 in chips) 
Seat 8: Chernovsky ($52.27 in chips) 
Seat 9: TimmyO1111 ($29.52 in chips) 
christyirish: posts small blind $0.25
jantheman222: posts big blind $0.50
*** HOLE CARDS ***
maisit*: folds 
perff: folds 
Chernovsky: folds 
TimmyO1111: folds 
Rorerzap: folds 
christyirish: folds 
Uncalled bet ($0.25) returned to jantheman222
jantheman222 collected $0.50 from pot
*** SUMMARY ***
Total pot $0.50 | Rake $0 
Seat 2: Rorerzap (button) folded before Flop (didn't bet)
Seat 4: christyirish (small blind) folded before Flop
Seat 5: jantheman222 (big blind) collected ($0.50)
Seat 6: maisit* folded before Flop (didn't bet)
Seat 7: perff folded before Flop (didn't bet)
Seat 8: Chernovsky folded before Flop (didn't bet)
Seat 9: TimmyO1111 folded before Flop (didn't bet)



PokerStars Hand #228696601981:  Hold'em No Limit ($0.25/$0.50 USD) - 2021/07/30 23:02:28 ET
Table 'Aitne III' 9-max Seat #4 is the button
Seat 2: Rorerzap ($91.91 in chips) 
Seat 4: christyirish ($103.31 in chips) 
Seat 5: jantheman222 ($77.38 in chips) 
Seat 6: maisit* ($66.45 in chips) 
Seat 7: perff ($18.75 in chips) 
Seat 8: Chernovsky ($52.27 in chips) 
Seat 9: TimmyO1111 ($29.52 in chips) 
jantheman222: posts small blind $0.25
maisit*: posts big blind $0.50
*** HOLE CARDS ***
perff: folds 
Chernovsky: folds 
TimmyO1111: folds 
Rorerzap: folds 
christyirish: folds 
jantheman222: folds 
Uncalled bet ($0.25) returned to maisit*
Zargmen joins the table at seat #1 
maisit* collected $0.50 from pot
maisit*: doesn't show hand 
*** SUMMARY ***
Total pot $0.50 | Rake $0 
Seat 2: Rorerzap folded before Flop (didn't bet)
Seat 4: christyirish (button) folded before Flop (didn't bet)
Seat 5: jantheman222 (small blind) folded before Flop
Seat 6: maisit* (big blind) collected ($0.50)
Seat 7: perff folded before Flop (didn't bet)
Seat 8: Chernovsky folded before Flop (didn't bet)
Seat 9: TimmyO1111 folded before Flop (didn't bet)



PokerStars Hand #228696604722:  Hold'em No Limit ($0.25/$0.50 USD) - 2021/07/30 23:02:41 ET
Table 'Aitne III' 9-max Seat #5 is the button
Seat 1: Zargmen ($20.21 in chips) 
Seat 2: Rorerzap ($91.91 in chips) 
Seat 4: christyirish ($103.31 in chips) 
Seat 5: jantheman222 ($77.13 in chips) 
Seat 6: maisit* ($66.70 in chips) 
Seat 7: perff ($18.75 in chips) 
Seat 8: Chernovsky ($52.27 in chips) 
Seat 9: TimmyO1111 ($29.52 in chips) 
maisit*: posts small blind $0.25
perff: posts big blind $0.50
Zargmen: posts big blind $0.50
*** HOLE CARDS ***
Chernovsky: folds 
TimmyO1111: folds 
Zargmen: checks 
Rorerzap: folds 
christyirish: raises $1.75 to $2.25
jantheman222: folds 
maisit*: folds 
perff: folds 
Sandalphon42 joins the table at seat #3 
Zargmen: calls $1.75
*** FLOP *** [7d 7h Kc]
Zargmen: checks 
christyirish: bets $2.50
Zargmen: folds 
Uncalled bet ($2.50) returned to christyirish
christyirish collected $4.99 from pot
*** SUMMARY ***
Total pot $5.25 | Rake $0.26 
Board [7d 7h Kc]
Seat 1: Zargmen folded on the Flop
Seat 2: Rorerzap folded before Flop (didn't bet)
Seat 4: christyirish collected ($4.99)
Seat 5: jantheman222 (button) folded before Flop (didn't bet)
Seat 6: maisit* (small blind) folded before Flop
Seat 7: perff (big blind) folded before Flop
Seat 8: Chernovsky folded before Flop (didn't bet)
Seat 9: TimmyO1111 folded before Flop (didn't bet)



PokerStars Hand #228696613448:  Hold'em No Limit ($0.25/$0.50 USD) - 2021/07/30 23:03:24 ET
Table 'Aitne III' 9-max Seat #6 is the button
Seat 1: Zargmen ($17.96 in chips) 
Seat 2: Rorerzap ($91.91 in chips) 
Seat 4: christyirish ($106.05 in chips) 
Seat 5: jantheman222 ($77.13 in chips) 
Seat 6: maisit* ($66.45 in chips) 
Seat 7: perff ($18.25 in chips) 
Seat 8: Chernovsky ($52.27 in chips) 
Seat 9: TimmyO1111 ($29.52 in chips) 
perff: posts small blind $0.25
Chernovsky: posts big blind $0.50
Sandalphon42: sits out 
*** HOLE CARDS ***
TimmyO1111: folds 
Zargmen: folds 
Rorerzap: folds 
christyirish: raises $1 to $1.50
jantheman222: raises $4 to $5.50
maisit*: folds 
perff: folds 
Chernovsky: folds 
christyirish: calls $4
*** FLOP *** [4h 6h Jc]
christyirish: checks 
jantheman222: bets $3.68
christyirish: calls $3.68
*** TURN *** [4h 6h Jc] [Jd]
christyirish: checks 
jantheman222: checks 
*** RIVER *** [4h 6h Jc Jd] [2h]
christyirish: checks 
jantheman222: checks 
*** SHOW DOWN ***
christyirish: shows [7d 7s] (two pair, Jacks and Sevens)
jantheman222: shows [8s 8c] (two pair, Jacks and Eights)
jantheman222 collected $18.15 from pot
*** SUMMARY ***
Total pot $19.11 | Rake $0.96 
Board [4h 6h Jc Jd 2h]
Seat 1: Zargmen folded before Flop (didn't bet)
Seat 2: Rorerzap folded before Flop (didn't bet)
Seat 4: christyirish showed [7d 7s] and lost with two pair, Jacks and Sevens
Seat 5: jantheman222 showed [8s 8c] and won ($18.15) with two pair, Jacks and Eights
Seat 6: maisit* (button) folded before Flop (didn't bet)
Seat 7: perff (small blind) folded before Flop
Seat 8: Chernovsky (big blind) folded before Flop
Seat 9: TimmyO1111 folded before Flop (didn't bet)



PokerStars Hand #228696624422:  Hold'em No Limit ($0.25/$0.50 USD) - 2021/07/30 23:04:17 ET
Table 'Aitne III' 9-max Seat #7 is the button
Seat 1: Zargmen ($17.96 in chips) 
Seat 2: Rorerzap ($91.91 in chips) 
Seat 4: christyirish ($96.87 in chips) 
Seat 5: jantheman222 ($86.10 in chips) 
Seat 6: maisit* ($66.45 in chips) 
Seat 7: perff ($18 in chips) 
Seat 8: Chernovsky ($51.77 in chips) 
Seat 9: TimmyO1111 ($29.52 in chips) 
Chernovsky: posts small blind $0.25
TimmyO1111: posts big blind $0.50
Sandalphon42: sits out 
*** HOLE CARDS ***
Zargmen: raises $0.50 to $1
Rorerzap: folds 
christyirish: folds 
jantheman222: folds 
maisit*: folds 
perff: folds 
Chernovsky: folds 
TimmyO1111: calls $0.50
*** FLOP *** [Qs 7d 6c]
TimmyO1111: checks 
Zargmen: bets $1.50
TimmyO1111: folds 
Uncalled bet ($1.50) returned to Zargmen
Zargmen collected $2.14 from pot
Zargmen: doesn't show hand 
*** SUMMARY ***
Total pot $2.25 | Rake $0.11 
Board [Qs 7d 6c]
Seat 1: Zargmen collected ($2.14)
Seat 2: Rorerzap folded before Flop (didn't bet)
Seat 4: christyirish folded before Flop (didn't bet)
Seat 5: jantheman222 folded before Flop (didn't bet)
Seat 6: maisit* folded before Flop (didn't bet)
Seat 7: perff (button) folded before Flop (didn't bet)
Seat 8: Chernovsky (small blind) folded before Flop
Seat 9: TimmyO1111 (big blind) folded on the Flop



PokerStars Hand #228696632375:  Hold'em No Limit ($0.25/$0.50 USD) - 2021/07/30 23:04:55 ET
Table 'Aitne III' 9-max Seat #8 is the button
Seat 1: Zargmen ($19.10 in chips) 
Seat 2: Rorerzap ($91.91 in chips) 
Seat 4: christyirish ($96.87 in chips) 
Seat 5: jantheman222 ($86.10 in chips) 
Seat 6: maisit* ($66.45 in chips) 
Seat 7: perff ($18 in chips) 
Seat 8: Chernovsky ($51.52 in chips) 
Seat 9: TimmyO1111 ($28.52 in chips) 
TimmyO1111: posts small blind $0.25
Zargmen: posts big blind $0.50
Sandalphon42: sits out 
*** HOLE CARDS ***
Rorerzap: folds 
christyirish: folds 
jantheman222: folds 
maisit*: folds 
perff: folds 
Chernovsky: folds 
TimmyO1111: folds 
Uncalled bet ($0.25) returned to Zargmen
Zargmen collected $0.50 from pot
Zargmen: doesn't show hand 
*** SUMMARY ***
Total pot $0.50 | Rake $0 
Seat 1: Zargmen (big blind) collected ($0.50)
Seat 2: Rorerzap folded before Flop (didn't bet)
Seat 4: christyirish folded before Flop (didn't bet)
Seat 5: jantheman222 folded before Flop (didn't bet)
Seat 6: maisit* folded before Flop (didn't bet)
Seat 7: perff folded before Flop (didn't bet)
Seat 8: Chernovsky (button) folded before Flop (didn't bet)
Seat 9: TimmyO1111 (small blind) folded before Flop



PokerStars Hand #228696634313:  Hold'em No Limit ($0.25/$0.50 USD) - 2021/07/30 23:05:05 ET
Table 'Aitne III' 9-max Seat #9 is the button
Seat 1: Zargmen ($19.35 in chips) 
Seat 2: Rorerzap ($91.91 in chips) 
Seat 4: christyirish ($96.87 in chips) 
Seat 5: jantheman222 ($86.10 in chips) 
Seat 6: maisit* ($66.45 in chips) 
Seat 7: perff ($18 in chips) 
Seat 8: Chernovsky ($51.52 in chips) 
Seat 9: TimmyO1111 ($28.27 in chips) 
Zargmen: posts small blind $0.25
Rorerzap: posts big blind $0.50
Sandalphon42: sits out 
*** HOLE CARDS ***
christyirish: folds 
jantheman222: folds 
maisit*: folds 
perff: raises $1 to $1.50
Chernovsky: folds 
TimmyO1111: calls $1.50
Zargmen: folds 
Rorerzap: folds 
*** FLOP *** [9s 6h Tc]
perff: bets $3.56
TimmyO1111: folds 
Uncalled bet ($3.56) returned to perff
perff collected $3.56 from pot
*** SUMMARY ***
Total pot $3.75 | Rake $0.19 
Board [9s 6h Tc]
Seat 1: Zargmen (small blind) folded before Flop
Seat 2: Rorerzap (big blind) folded before Flop
Seat 4: christyirish folded before Flop (didn't bet)
Seat 5: jantheman222 folded before Flop (didn't bet)
Seat 6: maisit* folded before Flop (didn't bet)
Seat 7: perff collected ($3.56)
Seat 8: Chernovsky folded before Flop (didn't bet)
Seat 9: TimmyO1111 (button) folded on the Flop



PokerStars Hand #228696640736:  Hold'em No Limit ($0.25/$0.50 USD) - 2021/07/30 23:05:36 ET
Table 'Aitne III' 9-max Seat #1 is the button
Seat 1: Zargmen ($19.10 in chips) 
Seat 2: Rorerzap ($91.41 in chips) 
Seat 3: Sandalphon42 ($24.56 in chips) 
Seat 4: christyirish ($96.87 in chips) 
Seat 5: jantheman222 ($86.10 in chips) 
Seat 6: maisit* ($66.45 in chips) 
Seat 7: perff ($20.06 in chips) 
Seat 8: Chernovsky ($51.52 in chips) 
Seat 9: TimmyO1111 ($26.77 in chips) 
Rorerzap: posts small blind $0.25
Sandalphon42: posts big blind $0.50
*** HOLE CARDS ***
christyirish: raises $1 to $1.50
jantheman222: folds 
maisit*: folds 
perff: folds 
Chernovsky: folds 
TimmyO1111: folds 
Zargmen: folds 
Rorerzap: folds 
Sandalphon42: folds 
Uncalled bet ($1) returned to christyirish
christyirish collected $1.25 from pot
*** SUMMARY ***
Total pot $1.25 | Rake $0 
Seat 1: Zargmen (button) folded before Flop (didn't bet)
Seat 2: Rorerzap (small blind) folded before Flop
Seat 3: Sandalphon42 (big blind) folded before Flop
Seat 4: christyirish collected ($1.25)
Seat 5: jantheman222 folded before Flop (didn't bet)
Seat 6: maisit* folded before Flop (didn't bet)
Seat 7: perff folded before Flop (didn't bet)
Seat 8: Chernovsky folded before Flop (didn't bet)
Seat 9: TimmyO1111 folded before Flop (didn't bet)



PokerStars Hand #228696644437:  Hold'em No Limit ($0.25/$0.50 USD) - 2021/07/30 23:05:54 ET
Table 'Aitne III' 9-max Seat #2 is the button
Seat 1: Zargmen ($19.10 in chips) 
Seat 2: Rorerzap ($91.16 in chips) 
Seat 3: Sandalphon42 ($24.06 in chips) 
Seat 4: christyirish ($97.62 in chips) 
Seat 5: jantheman222 ($86.10 in chips) 
Seat 6: maisit* ($66.45 in chips) 
Seat 7: perff ($20.06 in chips) 
Seat 8: Chernovsky ($51.52 in chips) 
Seat 9: TimmyO1111 ($26.77 in chips) 
Sandalphon42: posts small blind $0.25
christyirish: posts big blind $0.50
*** HOLE CARDS ***
jantheman222: raises $0.75 to $1.25
maisit*: raises $2.75 to $4
perff: folds 
Chernovsky: folds 
TimmyO1111: folds 
Zargmen: folds 
Rorerzap: folds 
Sandalphon42: folds 
christyirish: folds 
jantheman222: folds 
Uncalled bet ($2.75) returned to maisit*
maisit* collected $3.25 from pot
maisit*: doesn't show hand 
*** SUMMARY ***
Total pot $3.25 | Rake $0 
Seat 1: Zargmen folded before Flop (didn't bet)
Seat 2: Rorerzap (button) folded before Flop (didn't bet)
Seat 3: Sandalphon42 (small blind) folded before Flop
Seat 4: christyirish (big blind) folded before Flop
Seat 5: jantheman222 folded before Flop
Seat 6: maisit* collected ($3.25)
Seat 7: perff folded before Flop (didn't bet)
Seat 8: Chernovsky folded before Flop (didn't bet)
Seat 9: TimmyO1111 folded before Flop (didn't bet)



PokerStars Hand #228696649324:  Hold'em No Limit ($0.25/$0.50 USD) - 2021/07/30 23:06:17 ET
Table 'Aitne III' 9-max Seat #3 is the button
Seat 1: Zargmen ($19.10 in chips) 
Seat 2: Rorerzap ($91.16 in chips) 
Seat 3: Sandalphon42 ($23.81 in chips) 
Seat 4: christyirish ($97.12 in chips) 
Seat 5: jantheman222 ($84.85 in chips) 
Seat 6: maisit* ($68.45 in chips) 
Seat 7: perff ($20.06 in chips) 
Seat 8: Chernovsky ($51.52 in chips) 
Seat 9: TimmyO1111 ($26.77 in chips) 
christyirish: posts small blind $0.25
jantheman222: posts big blind $0.50
*** HOLE CARDS ***
maisit*: folds 
perff: folds 
perff leaves the table
Chernovsky: folds 
TimmyO1111: folds 
Zargmen: raises $1 to $1.50
Rorerzap: folds 
Sandalphon42: folds 
christyirish: folds 
jantheman222: raises $4.25 to $5.75
Zargmen: folds 
Uncalled bet ($4.25) returned to jantheman222
jantheman222 collected $3.25 from pot
*** SUMMARY ***
Total pot $3.25 | Rake $0 
Seat 1: Zargmen folded before Flop
Seat 2: Rorerzap folded before Flop (didn't bet)
Seat 3: Sandalphon42 (button) folded before Flop (didn't bet)
Seat 4: christyirish (small blind) folded before Flop
Seat 5: jantheman222 (big blind) collected ($3.25)
Seat 6: maisit* folded before Flop (didn't bet)
Seat 7: perff folded before Flop (didn't bet)
Seat 8: Chernovsky folded before Flop (didn't bet)
Seat 9: TimmyO1111 folded before Flop (didn't bet)



PokerStars Hand #228696657364:  Hold'em No Limit ($0.25/$0.50 USD) - 2021/07/30 23:06:56 ET
Table 'Aitne III' 9-max Seat #4 is the button
Seat 1: Zargmen ($17.60 in chips) 
Seat 2: Rorerzap ($91.16 in chips) 
Seat 3: Sandalphon42 ($23.81 in chips) 
Seat 4: christyirish ($96.87 in chips) 
Seat 5: jantheman222 ($86.60 in chips) 
Seat 6: maisit* ($68.45 in chips) 
Seat 8: Chernovsky ($51.52 in chips) 
Seat 9: TimmyO1111 ($26.77 in chips) 
jantheman222: posts small blind $0.25
maisit*: posts big blind $0.50
*** HOLE CARDS ***
Chernovsky: folds 
TimmyO1111: folds 
Zargmen: folds 
Rorerzap: folds 
Sandalphon42: folds 
christyirish: folds 
jantheman222: raises $0.75 to $1.25
maisit*: folds 
Uncalled bet ($0.75) returned to jantheman222
jantheman222 collected $1 from pot
*** SUMMARY ***
Total pot $1 | Rake $0 
Seat 1: Zargmen folded before Flop (didn't bet)
Seat 2: Rorerzap folded before Flop (didn't bet)
Seat 3: Sandalphon42 folded before Flop (didn't bet)
Seat 4: christyirish (button) folded before Flop (didn't bet)
Seat 5: jantheman222 (small blind) collected ($1)
Seat 6: maisit* (big blind) folded before Flop
Seat 8: Chernovsky folded before Flop (didn't bet)
Seat 9: TimmyO1111 folded before Flop (didn't bet)



PokerStars Hand #228696661279:  Hold'em No Limit ($0.25/$0.50 USD) - 2021/07/30 23:07:15 ET
Table 'Aitne III' 9-max Seat #5 is the button
Seat 1: Zargmen ($17.60 in chips) 
Seat 2: Rorerzap ($91.16 in chips) 
Seat 3: Sandalphon42 ($23.81 in chips) 
Seat 4: christyirish ($96.87 in chips) 
Seat 5: jantheman222 ($87.10 in chips) 
Seat 6: maisit* ($67.95 in chips) 
Seat 8: Chernovsky ($51.52 in chips) 
Seat 9: TimmyO1111 ($26.77 in chips) 
maisit*: posts small blind $0.25
Chernovsky: posts big blind $0.50
*** HOLE CARDS ***
TimmyO1111: calls $0.50
Zargmen: folds 
Rorerzap: folds 
Sandalphon42: folds 
christyirish: raises $1 to $1.50
jantheman222: folds 
maisit*: folds 
G4888 joins the table at seat #7 
Chernovsky: folds 
TimmyO1111: calls $1
*** FLOP *** [Ks 5h 4s]
TimmyO1111: checks 
christyirish: bets $1.78
TimmyO1111: calls $1.78
*** TURN *** [Ks 5h 4s] [9d]
TimmyO1111: checks 
christyirish: bets $5.21
TimmyO1111: folds 
Uncalled bet ($5.21) returned to christyirish
christyirish collected $6.94 from pot
*** SUMMARY ***
Total pot $7.31 | Rake $0.37 
Board [Ks 5h 4s 9d]
Seat 1: Zargmen folded before Flop (didn't bet)
Seat 2: Rorerzap folded before Flop (didn't bet)
Seat 3: Sandalphon42 folded before Flop (didn't bet)
Seat 4: christyirish collected ($6.94)
Seat 5: jantheman222 (button) folded before Flop (didn't bet)
Seat 6: maisit* (small blind) folded before Flop
Seat 8: Chernovsky (big blind) folded before Flop
Seat 9: TimmyO1111 folded on the Turn



PokerStars Hand #228696669162:  Hold'em No Limit ($0.25/$0.50 USD) - 2021/07/30 23:07:53 ET
Table 'Aitne III' 9-max Seat #6 is the button
Seat 1: Zargmen ($17.60 in chips) 
Seat 2: Rorerzap ($91.16 in chips) 
Seat 3: Sandalphon42 ($23.81 in chips) 
Seat 4: christyirish ($100.53 in chips) 
Seat 5: jantheman222 ($87.10 in chips) 
Seat 6: maisit* ($67.70 in chips) 
Seat 8: Chernovsky ($51.02 in chips) 
Seat 9: TimmyO1111 ($23.49 in chips) 
Chernovsky: posts small blind $0.25
TimmyO1111: posts big blind $0.50
*** HOLE CARDS ***
Zargmen: folds 
Rorerzap: folds 
Sandalphon42: folds 
christyirish: folds 
jantheman222: raises $0.75 to $1.25
maisit*: folds 
Chernovsky: folds 
TimmyO1111: folds 
Uncalled bet ($0.75) returned to jantheman222
jantheman222 collected $1.25 from pot
jantheman222: doesn't show hand 
*** SUMMARY ***
Total pot $1.25 | Rake $0 
Seat 1: Zargmen folded before Flop (didn't bet)
Seat 2: Rorerzap folded before Flop (didn't bet)
Seat 3: Sandalphon42 folded before Flop (didn't bet)
Seat 4: christyirish folded before Flop (didn't bet)
Seat 5: jantheman222 collected ($1.25)
Seat 6: maisit* (button) folded before Flop (didn't bet)
Seat 8: Chernovsky (small blind) folded before Flop
Seat 9: TimmyO1111 (big blind) folded before Flop



PokerStars Hand #228696672376:  Hold'em No Limit ($0.25/$0.50 USD) - 2021/07/30 23:08:09 ET
Table 'Aitne III' 9-max Seat #8 is the button
Seat 1: Zargmen ($17.60 in chips) 
Seat 2: Rorerzap ($91.16 in chips) 
Seat 3: Sandalphon42 ($23.81 in chips) 
Seat 4: christyirish ($100.53 in chips) 
Seat 5: jantheman222 ($87.85 in chips) 
Seat 6: maisit* ($67.70 in chips) 
Seat 8: Chernovsky ($50.77 in chips) 
Seat 9: TimmyO1111 ($22.99 in chips) 
TimmyO1111: posts small blind $0.25
Zargmen: posts big blind $0.50
G4888: sits out 
*** HOLE CARDS ***
Rorerzap: folds 
Sandalphon42: folds 
G4888 leaves the table
christyirish: folds 
jantheman222: folds 
maisit*: folds 
Chernovsky: folds 
TimmyO1111: calls $0.25
Zargmen: checks 
*** FLOP *** [Kd 6h Ad]
TimmyO1111: bets $0.95
Zargmen: folds 
Uncalled bet ($0.95) returned to TimmyO1111
TimmyO1111 collected $0.95 from pot
TimmyO1111: doesn't show hand 
*** SUMMARY ***
Total pot $1 | Rake $0.05 
Board [Kd 6h Ad]
Seat 1: Zargmen (big blind) folded on the Flop
Seat 2: Rorerzap folded before Flop (didn't bet)
Seat 3: Sandalphon42 folded before Flop (didn't bet)
Seat 4: christyirish folded before Flop (didn't bet)
Seat 5: jantheman222 folded before Flop (didn't bet)
Seat 6: maisit* folded before Flop (didn't bet)
Seat 8: Chernovsky (button) folded before Flop (didn't bet)
Seat 9: TimmyO1111 (small blind) collected ($0.95)



PokerStars Hand #228696677164:  Hold'em No Limit ($0.25/$0.50 USD) - 2021/07/30 23:08:32 ET
Table 'Aitne III' 9-max Seat #9 is the button
Seat 1: Zargmen ($17.10 in chips) 
Seat 2: Rorerzap ($91.16 in chips) 
Seat 3: Sandalphon42 ($23.81 in chips) 
Seat 4: christyirish ($100.53 in chips) 
Seat 5: jantheman222 ($87.85 in chips) 
Seat 6: maisit* ($67.70 in chips) 
Seat 8: Chernovsky ($50.77 in chips) 
Seat 9: TimmyO1111 ($23.44 in chips) 
Zargmen: posts small blind $0.25
Rorerzap: posts big blind $0.50
*** HOLE CARDS ***
Hotstove420 joins the table at seat #7 
Sandalphon42: calls $0.50
christyirish: raises $1.75 to $2.25
jantheman222: folds 
maisit*: folds 
Chernovsky: folds 
TimmyO1111: folds 
Zargmen: folds 
Rorerzap: folds 
Sandalphon42: raises $21.56 to $23.81 and is all-in
christyirish: folds 
Uncalled bet ($21.56) returned to Sandalphon42
Sandalphon42 collected $5.25 from pot
*** SUMMARY ***
Total pot $5.25 | Rake $0 
Seat 1: Zargmen (small blind) folded before Flop
Seat 2: Rorerzap (big blind) folded before Flop
Seat 3: Sandalphon42 collected ($5.25)
Seat 4: christyirish folded before Flop
Seat 5: jantheman222 folded before Flop (didn't bet)
Seat 6: maisit* folded before Flop (didn't bet)
Seat 8: Chernovsky folded before Flop (didn't bet)
Seat 9: TimmyO1111 (button) folded before Flop (didn't bet)



PokerStars Hand #228696682312:  Hold'em No Limit ($0.25/$0.50 USD) - 2021/07/30 23:08:58 ET
Table 'Aitne III' 9-max Seat #1 is the button
Seat 1: Zargmen ($16.85 in chips) 
Seat 2: Rorerzap ($90.66 in chips) 
Seat 3: Sandalphon42 ($26.81 in chips) 
Seat 4: christyirish ($98.28 in chips) 
Seat 5: jantheman222 ($87.85 in chips) 
Seat 6: maisit* ($67.70 in chips) 
Seat 8: Chernovsky ($50.77 in chips) 
Seat 9: TimmyO1111 ($23.44 in chips) 
Rorerzap: posts small blind $0.25
Sandalphon42: posts big blind $0.50
Hotstove420: sits out 
*** HOLE CARDS ***
christyirish: folds 
jantheman222: folds 
maisit*: folds 
Chernovsky: folds 
TimmyO1111: folds 
Zargmen: folds 
Rorerzap: folds 
Uncalled bet ($0.25) returned to Sandalphon42
Sandalphon42 collected $0.50 from pot
*** SUMMARY ***
Total pot $0.50 | Rake $0 
Seat 1: Zargmen (button) folded before Flop (didn't bet)
Seat 2: Rorerzap (small blind) folded before Flop
Seat 3: Sandalphon42 (big blind) collected ($0.50)
Seat 4: christyirish folded before Flop (didn't bet)
Seat 5: jantheman222 folded before Flop (didn't bet)
Seat 6: maisit* folded before Flop (didn't bet)
Seat 8: Chernovsky folded before Flop (didn't bet)
Seat 9: TimmyO1111 folded before Flop (didn't bet)



PokerStars Hand #228696684153:  Hold'em No Limit ($0.25/$0.50 USD) - 2021/07/30 23:09:07 ET
Table 'Aitne III' 9-max Seat #2 is the button
Seat 1: Zargmen ($16.85 in chips) 
Seat 2: Rorerzap ($90.41 in chips) 
Seat 3: Sandalphon42 ($27.06 in chips) 
Seat 4: christyirish ($98.28 in chips) 
Seat 5: jantheman222 ($87.85 in chips) 
Seat 6: maisit* ($67.70 in chips) 
Seat 8: Chernovsky ($50.77 in chips) 
Seat 9: TimmyO1111 ($23.44 in chips) 
Sandalphon42: posts small blind $0.25
christyirish: posts big blind $0.50
Hotstove420: sits out 
*** HOLE CARDS ***
jantheman222: folds 
maisit*: folds 
Chernovsky: folds 
TimmyO1111: folds 
Zargmen: folds 
Rorerzap: folds 
Sandalphon42: calls $0.25
christyirish: checks 
*** FLOP *** [5h Kc 8s]
Sandalphon42: checks 
christyirish: checks 
*** TURN *** [5h Kc 8s] [Kd]
Sandalphon42: checks 
christyirish: checks 
*** RIVER *** [5h Kc 8s Kd] [6h]
Sandalphon42: checks 
christyirish: checks 
*** SHOW DOWN ***
Sandalphon42: shows [Jh Tc] (a pair of Kings)
christyirish: shows [Td Js] (a pair of Kings)
Sandalphon42 collected $0.48 from pot
christyirish collected $0.47 from pot
*** SUMMARY ***
Total pot $1 | Rake $0.05 
Board [5h Kc 8s Kd 6h]
Seat 1: Zargmen folded before Flop (didn't bet)
Seat 2: Rorerzap (button) folded before Flop (didn't bet)
Seat 3: Sandalphon42 (small blind) showed [Jh Tc] and won ($0.48) with a pair of Kings
Seat 4: christyirish (big blind) showed [Td Js] and won ($0.47) with a pair of Kings
Seat 5: jantheman222 folded before Flop (didn't bet)
Seat 6: maisit* folded before Flop (didn't bet)
Seat 8: Chernovsky folded before Flop (didn't bet)
Seat 9: TimmyO1111 folded before Flop (didn't bet)



PokerStars Hand #228696693551:  Hold'em No Limit ($0.25/$0.50 USD) - 2021/07/30 23:09:53 ET
Table 'Aitne III' 9-max Seat #3 is the button
Seat 1: Zargmen ($16.85 in chips) 
Seat 2: Rorerzap ($90.41 in chips) 
Seat 3: Sandalphon42 ($27.04 in chips) 
Seat 4: christyirish ($98.25 in chips) 
Seat 5: jantheman222 ($87.85 in chips) 
Seat 6: maisit* ($67.70 in chips) 
Seat 8: Chernovsky ($50.77 in chips) 
Seat 9: TimmyO1111 ($23.44 in chips) 
christyirish: posts small blind $0.25
jantheman222: posts big blind $0.50
Hotstove420: sits out 
*** HOLE CARDS ***
maisit*: folds 
Chernovsky: folds 
TimmyO1111: folds 
Zargmen: folds 
Rorerzap: folds 
Sandalphon42: calls $0.50
christyirish: folds 
jantheman222: checks 
*** FLOP *** [3c 7h 6d]
jantheman222: checks 
Sandalphon42: checks 
*** TURN *** [3c 7h 6d] [Th]
jantheman222: bets $0.50
Sandalphon42: raises $0.50 to $1
jantheman222: calls $0.50
*** RIVER *** [3c 7h 6d Th] [Js]
jantheman222: checks 
Sandalphon42: bets $1.55
jantheman222: folds 
Uncalled bet ($1.55) returned to Sandalphon42
Sandalphon42 collected $3.09 from pot
*** SUMMARY ***
Total pot $3.25 | Rake $0.16 
Board [3c 7h 6d Th Js]
Seat 1: Zargmen folded before Flop (didn't bet)
Seat 2: Rorerzap folded before Flop (didn't bet)
Seat 3: Sandalphon42 (button) collected ($3.09)
Seat 4: christyirish (small blind) folded before Flop
Seat 5: jantheman222 (big blind) folded on the River
Seat 6: maisit* folded before Flop (didn't bet)
Seat 8: Chernovsky folded before Flop (didn't bet)
Seat 9: TimmyO1111 folded before Flop (didn't bet)



PokerStars Hand #228696706757:  Hold'em No Limit ($0.25/$0.50 USD) - 2021/07/30 23:10:49 ET
Table 'Aitne III' 9-max Seat #4 is the button
Seat 1: Zargmen ($16.85 in chips) 
Seat 2: Rorerzap ($90.41 in chips) 
Seat 3: Sandalphon42 ($28.63 in chips) 
Seat 4: christyirish ($98 in chips) 
Seat 5: jantheman222 ($86.35 in chips) 
Seat 6: maisit* ($67.70 in chips) 
Seat 8: Chernovsky ($50.77 in chips) 
Seat 9: TimmyO1111 ($23.44 in chips) 
jantheman222: posts small blind $0.25
maisit*: posts big blind $0.50
Hotstove420: sits out 
*** HOLE CARDS ***
Chernovsky has timed out
Chernovsky: folds 
TimmyO1111: raises $1 to $1.50
Zargmen: folds 
Rorerzap: folds 
Sandalphon42: folds 
christyirish: folds 
jantheman222: folds 
maisit*: folds 
Uncalled bet ($1) returned to TimmyO1111
TimmyO1111 collected $1.25 from pot
TimmyO1111: doesn't show hand 
*** SUMMARY ***
Total pot $1.25 | Rake $0 
Seat 1: Zargmen folded before Flop (didn't bet)
Seat 2: Rorerzap folded before Flop (didn't bet)
Seat 3: Sandalphon42 folded before Flop (didn't bet)
Seat 4: christyirish (button) folded before Flop (didn't bet)
Seat 5: jantheman222 (small blind) folded before Flop
Seat 6: maisit* (big blind) folded before Flop
Seat 8: Chernovsky folded before Flop (didn't bet)
Seat 9: TimmyO1111 collected ($1.25)



PokerStars Hand #228696714919:  Hold'em No Limit ($0.25/$0.50 USD) - 2021/07/30 23:11:16 ET
Table 'Aitne III' 9-max Seat #5 is the button
Seat 1: Zargmen ($16.85 in chips) 
Seat 2: Rorerzap ($90.41 in chips) 
Seat 3: Sandalphon42 ($28.63 in chips) 
Seat 4: christyirish ($98 in chips) 
Seat 5: jantheman222 ($86.10 in chips) 
Seat 6: maisit* ($67.20 in chips) 
Seat 7: Hotstove420 ($50 in chips) 
Seat 9: TimmyO1111 ($24.19 in chips) 
maisit*: posts small blind $0.25
Hotstove420: posts big blind $0.50
*** HOLE CARDS ***
TimmyO1111: folds 
Zargmen: folds 
Rorerzap: folds 
Sandalphon42: folds 
christyirish: raises $1 to $1.50
jantheman222: folds 
maisit*: folds 
Hotstove420: folds 
Uncalled bet ($1) returned to christyirish
christyirish collected $1.25 from pot
*** SUMMARY ***
Total pot $1.25 | Rake $0 
Seat 1: Zargmen folded before Flop (didn't bet)
Seat 2: Rorerzap folded before Flop (didn't bet)
Seat 3: Sandalphon42 folded before Flop (didn't bet)
Seat 4: christyirish collected ($1.25)
Seat 5: jantheman222 (button) folded before Flop (didn't bet)
Seat 6: maisit* (small blind) folded before Flop
Seat 7: Hotstove420 (big blind) folded before Flop
Seat 9: TimmyO1111 folded before Flop (didn't bet)



PokerStars Hand #228696720090:  Hold'em No Limit ($0.25/$0.50 USD) - 2021/07/30 23:11:42 ET
Table 'Aitne III' 9-max Seat #6 is the button
Seat 1: Zargmen ($16.85 in chips) 
Seat 2: Rorerzap ($90.41 in chips) 
Seat 3: Sandalphon42 ($28.63 in chips) 
Seat 4: christyirish ($98.75 in chips) 
Seat 5: jantheman222 ($86.10 in chips) 
Seat 6: maisit* ($66.95 in chips) 
Seat 7: Hotstove420 ($49.50 in chips) 
Seat 9: TimmyO1111 ($24.19 in chips) 
Hotstove420: posts small blind $0.25
TimmyO1111: posts big blind $0.50
*** HOLE CARDS ***
Zargmen: folds 
Rorerzap: folds 
Sandalphon42: folds 
christyirish: folds 
jantheman222: raises $0.75 to $1.25
maisit*: raises $3.25 to $4.50
Hotstove420: folds 
TimmyO1111: folds 
jantheman222: folds 
Uncalled bet ($3.25) returned to maisit*
maisit* collected $3.25 from pot
maisit*: doesn't show hand 
*** SUMMARY ***
Total pot $3.25 | Rake $0 
Seat 1: Zargmen folded before Flop (didn't bet)
Seat 2: Rorerzap folded before Flop (didn't bet)
Seat 3: Sandalphon42 folded before Flop (didn't bet)
Seat 4: christyirish folded before Flop (didn't bet)
Seat 5: jantheman222 folded before Flop
Seat 6: maisit* (button) collected ($3.25)
Seat 7: Hotstove420 (small blind) folded before Flop
Seat 9: TimmyO1111 (big blind) folded before Flop



PokerStars Hand #228696728615:  Hold'em No Limit ($0.25/$0.50 USD) - 2021/07/30 23:12:25 ET
Table 'Aitne III' 9-max Seat #7 is the button
Seat 1: Zargmen ($16.85 in chips) 
Seat 2: Rorerzap ($90.41 in chips) 
Seat 3: Sandalphon42 ($28.63 in chips) 
Seat 4: christyirish ($98.75 in chips) 
Seat 5: jantheman222 ($84.85 in chips) 
Seat 6: maisit* ($68.95 in chips) 
Seat 7: Hotstove420 ($49.25 in chips) 
Seat 9: TimmyO1111 ($23.69 in chips) 
TimmyO1111: posts small blind $0.25
Zargmen: posts big blind $0.50
*** HOLE CARDS ***
Rorerzap: folds 
Sandalphon42: folds 
christyirish: folds 
jantheman222: folds 
maisit*: folds 
Hotstove420: folds 
TimmyO1111: calls $0.25
Zargmen: checks 
*** FLOP *** [8c 3s 9s]
TimmyO1111: checks 
Zargmen: checks 
*** TURN *** [8c 3s 9s] [3h]
TimmyO1111: checks 
Zargmen: checks 
*** RIVER *** [8c 3s 9s 3h] [7s]
TimmyO1111: bets $1
Zargmen: folds 
Uncalled bet ($1) returned to TimmyO1111
TimmyO1111 collected $0.95 from pot
TimmyO1111: doesn't show hand 
*** SUMMARY ***
Total pot $1 | Rake $0.05 
Board [8c 3s 9s 3h 7s]
Seat 1: Zargmen (big blind) folded on the River
Seat 2: Rorerzap folded before Flop (didn't bet)
Seat 3: Sandalphon42 folded before Flop (didn't bet)
Seat 4: christyirish folded before Flop (didn't bet)
Seat 5: jantheman222 folded before Flop (didn't bet)
Seat 6: maisit* folded before Flop (didn't bet)
Seat 7: Hotstove420 (button) folded before Flop (didn't bet)
Seat 9: TimmyO1111 (small blind) collected ($0.95)



PokerStars Hand #228696735483:  Hold'em No Limit ($0.25/$0.50 USD) - 2021/07/30 23:12:59 ET
Table 'Aitne III' 9-max Seat #9 is the button
Seat 1: Zargmen ($16.35 in chips) 
Seat 2: Rorerzap ($90.41 in chips) 
Seat 3: Sandalphon42 ($28.63 in chips) 
Seat 4: christyirish ($98.75 in chips) 
Seat 5: jantheman222 ($84.85 in chips) 
Seat 6: maisit* ($68.95 in chips) 
Seat 7: Hotstove420 ($49.25 in chips) 
Seat 9: TimmyO1111 ($24.14 in chips) 
Zargmen: posts small blind $0.25
Rorerzap: posts big blind $0.50
Chernovsky: sits out 
*** HOLE CARDS ***
Sandalphon42: folds 
christyirish: folds 
jantheman222: raises $0.75 to $1.25
maisit*: folds 
Hotstove420: folds 
TimmyO1111: folds 
Zargmen: folds 
Rorerzap: folds 
Uncalled bet ($0.75) returned to jantheman222
jantheman222 collected $1.25 from pot
*** SUMMARY ***
Total pot $1.25 | Rake $0 
Seat 1: Zargmen (small blind) folded before Flop
Seat 2: Rorerzap (big blind) folded before Flop
Seat 3: Sandalphon42 folded before Flop (didn't bet)
Seat 4: christyirish folded before Flop (didn't bet)
Seat 5: jantheman222 collected ($1.25)
Seat 6: maisit* folded before Flop (didn't bet)
Seat 7: Hotstove420 folded before Flop (didn't bet)
Seat 9: TimmyO1111 (button) folded before Flop (didn't bet)



PokerStars Hand #228696739218:  Hold'em No Limit ($0.25/$0.50 USD) - 2021/07/30 23:13:18 ET
Table 'Aitne III' 9-max Seat #1 is the button
Seat 1: Zargmen ($16.10 in chips) 
Seat 2: Rorerzap ($89.91 in chips) 
Seat 4: christyirish ($98.75 in chips) 
Seat 5: jantheman222 ($85.60 in chips) 
Seat 6: maisit* ($68.95 in chips) 
Seat 7: Hotstove420 ($49.25 in chips) 
Seat 9: TimmyO1111 ($24.14 in chips) 
Rorerzap: posts small blind $0.25
Sandalphon42: is sitting out 
christyirish: posts big blind $0.50
Chernovsky: sits out 
*** HOLE CARDS ***
jantheman222: folds 
Sandalphon42 leaves the table
maisit* has timed out
maisit*: folds 
Hotstove420: folds 
TimmyO1111: calls $0.50
Zargmen: folds 
Rorerzap: folds 
christyirish: checks 
*** FLOP *** [9h Ad 5h]
christyirish: checks 
TimmyO1111: checks 
*** TURN *** [9h Ad 5h] [7h]
christyirish: bets $0.50
TimmyO1111: calls $0.50
*** RIVER *** [9h Ad 5h 7h] [Ac]
christyirish: checks 
TimmyO1111: checks 
*** SHOW DOWN ***
christyirish: shows [Jh Qd] (a pair of Aces)
TimmyO1111: mucks hand 
christyirish collected $2.14 from pot
*** SUMMARY ***
Total pot $2.25 | Rake $0.11 
Board [9h Ad 5h 7h Ac]
Seat 1: Zargmen (button) folded before Flop (didn't bet)
Seat 2: Rorerzap (small blind) folded before Flop
Seat 4: christyirish (big blind) showed [Jh Qd] and won ($2.14) with a pair of Aces
Seat 5: jantheman222 folded before Flop (didn't bet)
Seat 6: maisit* folded before Flop (didn't bet)
Seat 7: Hotstove420 folded before Flop (didn't bet)
Seat 9: TimmyO1111 mucked



PokerStars Hand #228696746985:  Hold'em No Limit ($0.25/$0.50 USD) - 2021/07/30 23:13:57 ET
Table 'Aitne III' 9-max Seat #2 is the button
Seat 1: Zargmen ($16.10 in chips) 
Seat 2: Rorerzap ($89.66 in chips) 
Seat 4: christyirish ($99.89 in chips) 
Seat 5: jantheman222 ($85.60 in chips) 
Seat 6: maisit* ($68.95 in chips) 
Seat 7: Hotstove420 ($49.25 in chips) 
Seat 9: TimmyO1111 ($23.14 in chips) 
christyirish: posts small blind $0.25
jantheman222: posts big blind $0.50
Chernovsky: sits out 
*** HOLE CARDS ***
maisit*: folds 
Hotstove420: folds 
TimmyO1111: raises $1 to $1.50
Zargmen: folds 
Rorerzap: folds 
christyirish: calls $1.25
jantheman222: folds 
*** FLOP *** [6h 3s 2h]
christyirish: checks 
TimmyO1111: checks 
*** TURN *** [6h 3s 2h] [5c]
christyirish: checks 
TimmyO1111: checks 
*** RIVER *** [6h 3s 2h 5c] [2d]
christyirish: checks 
TimmyO1111: checks 
*** SHOW DOWN ***
christyirish: shows [Jc Qc] (a pair of Deuces)
TimmyO1111: shows [Kd Ad] (a pair of Deuces - Ace kicker)
TimmyO1111 collected $3.32 from pot
*** SUMMARY ***
Total pot $3.50 | Rake $0.18 
Board [6h 3s 2h 5c 2d]
Seat 1: Zargmen folded before Flop (didn't bet)
Seat 2: Rorerzap (button) folded before Flop (didn't bet)
Seat 4: christyirish (small blind) showed [Jc Qc] and lost with a pair of Deuces
Seat 5: jantheman222 (big blind) folded before Flop
Seat 6: maisit* folded before Flop (didn't bet)
Seat 7: Hotstove420 folded before Flop (didn't bet)
Seat 9: TimmyO1111 showed [Kd Ad] and won ($3.32) with a pair of Deuces



PokerStars Hand #228696753907:  Hold'em No Limit ($0.25/$0.50 USD) - 2021/07/30 23:14:32 ET
Table 'Aitne III' 9-max Seat #4 is the button
Seat 1: Zargmen ($16.10 in chips) 
Seat 2: Rorerzap ($89.66 in chips) 
Seat 4: christyirish ($98.39 in chips) 
Seat 5: jantheman222 ($85.10 in chips) 
Seat 6: maisit* ($68.95 in chips) 
Seat 7: Hotstove420 ($49.25 in chips) 
jantheman222: posts small blind $0.25
maisit*: posts big blind $0.50
Chernovsky: sits out 
*** HOLE CARDS ***
Hotstove420: folds 
Zargmen: folds 
Rorerzap: folds 
TimmyO1111 leaves the table
christyirish: folds 
jantheman222: raises $1 to $1.50
maisit*: calls $1
*** FLOP *** [5d 4h Kh]
jantheman222: checks 
maisit*: checks 
*** TURN *** [5d 4h Kh] [5c]
jantheman222: bets $0.94
maisit*: folds 
Uncalled bet ($0.94) returned to jantheman222
jantheman222 collected $2.85 from pot
jantheman222: doesn't show hand 
*** SUMMARY ***
Total pot $3 | Rake $0.15 
Board [5d 4h Kh 5c]
Seat 1: Zargmen folded before Flop (didn't bet)
Seat 2: Rorerzap folded before Flop (didn't bet)
Seat 4: christyirish (button) folded before Flop (didn't bet)
Seat 5: jantheman222 (small blind) collected ($2.85)
Seat 6: maisit* (big blind) folded on the Turn
Seat 7: Hotstove420 folded before Flop (didn't bet)



PokerStars Hand #228696759845:  Hold'em No Limit ($0.25/$0.50 USD) - 2021/07/30 23:15:01 ET
Table 'Aitne III' 9-max Seat #5 is the button
Seat 1: Zargmen ($16.10 in chips) 
Seat 2: Rorerzap ($89.66 in chips) 
Seat 4: christyirish ($98.39 in chips) 
Seat 5: jantheman222 ($86.45 in chips) 
Seat 6: maisit* ($67.45 in chips) 
Seat 7: Hotstove420 ($49.25 in chips) 
maisit*: posts small blind $0.25
Hotstove420: posts big blind $0.50
Chernovsky: sits out 
*** HOLE CARDS ***
Zargmen: folds 
Rorerzap: folds 
christyirish: folds 
jantheman222: folds 
maisit*: raises $1 to $1.50
Hotstove420: folds 
Uncalled bet ($1) returned to maisit*
maisit* collected $1 from pot
maisit*: doesn't show hand 
*** SUMMARY ***
Total pot $1 | Rake $0 
Seat 1: Zargmen folded before Flop (didn't bet)
Seat 2: Rorerzap folded before Flop (didn't bet)
Seat 4: christyirish folded before Flop (didn't bet)
Seat 5: jantheman222 (button) folded before Flop (didn't bet)
Seat 6: maisit* (small blind) collected ($1)
Seat 7: Hotstove420 (big blind) folded before Flop



PokerStars Hand #228696765703:  Hold'em No Limit ($0.25/$0.50 USD) - 2021/07/30 23:15:30 ET
Table 'Aitne III' 9-max Seat #6 is the button
Seat 1: Zargmen ($16.10 in chips) 
Seat 2: Rorerzap ($89.66 in chips) 
Seat 4: christyirish ($98.39 in chips) 
Seat 5: jantheman222 ($86.45 in chips) 
Seat 6: maisit* ($67.95 in chips) 
Seat 7: Hotstove420 ($48.75 in chips) 
Seat 8: Chernovsky ($50.77 in chips) 
Hotstove420: posts small blind $0.25
Chernovsky: posts big blind $0.50
*** HOLE CARDS ***
Zargmen: folds 
Rorerzap: folds 
christyirish: folds 
jantheman222: folds 
maisit*: folds 
Hotstove420: raises $1 to $1.50
Chernovsky: folds 
Uncalled bet ($1) returned to Hotstove420
Hotstove420 collected $1 from pot
Hotstove420: doesn't show hand 
*** SUMMARY ***
Total pot $1 | Rake $0 
Seat 1: Zargmen folded before Flop (didn't bet)
Seat 2: Rorerzap folded before Flop (didn't bet)
Seat 4: christyirish folded before Flop (didn't bet)
Seat 5: jantheman222 folded before Flop (didn't bet)
Seat 6: maisit* (button) folded before Flop (didn't bet)
Seat 7: Hotstove420 (small blind) collected ($1)
Seat 8: Chernovsky (big blind) folded before Flop



PokerStars Hand #228696770029:  Hold'em No Limit ($0.25/$0.50 USD) - 2021/07/30 23:15:51 ET
Table 'Aitne III' 9-max Seat #7 is the button
Seat 1: Zargmen ($16.10 in chips) 
Seat 2: Rorerzap ($89.66 in chips) 
Seat 4: christyirish ($98.39 in chips) 
Seat 5: jantheman222 ($86.45 in chips) 
Seat 6: maisit* ($67.95 in chips) 
Seat 7: Hotstove420 ($49.25 in chips) 
Seat 8: Chernovsky ($50.27 in chips) 
Chernovsky: posts small blind $0.25
Zargmen: posts big blind $0.50
*** HOLE CARDS ***
Rorerzap: folds 
christyirish: folds 
jantheman222: folds 
maisit*: folds 
Hotstove420: calls $0.50
Chernovsky: folds 
Zargmen: raises $1.25 to $1.75
Hotstove420: calls $1.25
*** FLOP *** [6s Tc Jh]
Zargmen: bets $3
Hotstove420: calls $3
*** TURN *** [6s Tc Jh] [8c]
Zargmen: bets $11.35 and is all-in
Hotstove420: calls $11.35
*** RIVER *** [6s Tc Jh 8c] [6h]
*** SHOW DOWN ***
Zargmen: shows [As Jd] (two pair, Jacks and Sixes)
Hotstove420: shows [7d Td] (two pair, Tens and Sixes)
Zargmen collected $30.83 from pot
*** SUMMARY ***
Total pot $32.45 | Rake $1.62 
Board [6s Tc Jh 8c 6h]
Seat 1: Zargmen (big blind) showed [As Jd] and won ($30.83) with two pair, Jacks and Sixes
Seat 2: Rorerzap folded before Flop (didn't bet)
Seat 4: christyirish folded before Flop (didn't bet)
Seat 5: jantheman222 folded before Flop (didn't bet)
Seat 6: maisit* folded before Flop (didn't bet)
Seat 7: Hotstove420 (button) showed [7d Td] and lost with two pair, Tens and Sixes
Seat 8: Chernovsky (small blind) folded before Flop



PokerStars Hand #228696791095:  Hold'em No Limit ($0.25/$0.50 USD) - 2021/07/30 23:17:01 ET
Table 'Aitne III' 9-max Seat #8 is the button
Seat 1: Zargmen ($30.83 in chips) 
Seat 2: Rorerzap ($89.66 in chips) 
Seat 4: christyirish ($98.39 in chips) 
Seat 5: jantheman222 ($86.45 in chips) 
Seat 6: maisit* ($67.95 in chips) 
Seat 7: Hotstove420 ($33.15 in chips) 
Seat 8: Chernovsky ($50.02 in chips) 
Zargmen: posts small blind $0.25
Rorerzap: posts big blind $0.50
*** HOLE CARDS ***
christyirish: raises $1 to $1.50
jantheman222: folds 
maisit*: folds 
Hotstove420: folds 
Chernovsky: folds 
Zargmen: folds 
Rorerzap: folds 
Uncalled bet ($1) returned to christyirish
christyirish collected $1.25 from pot
christyirish: doesn't show hand 
*** SUMMARY ***
Total pot $1.25 | Rake $0 
Seat 1: Zargmen (small blind) folded before Flop
Seat 2: Rorerzap (big blind) folded before Flop
Seat 4: christyirish collected ($1.25)
Seat 5: jantheman222 folded before Flop (didn't bet)
Seat 6: maisit* folded before Flop (didn't bet)
Seat 7: Hotstove420 folded before Flop (didn't bet)
Seat 8: Chernovsky (button) folded before Flop (didn't bet)



PokerStars Hand #228696793900:  Hold'em No Limit ($0.25/$0.50 USD) - 2021/07/30 23:17:14 ET
Table 'Aitne III' 9-max Seat #1 is the button
Seat 1: Zargmen ($30.58 in chips) 
Seat 2: Rorerzap ($89.16 in chips) 
Seat 4: christyirish ($99.14 in chips) 
Seat 5: jantheman222 ($86.45 in chips) 
Seat 6: maisit* ($67.95 in chips) 
Seat 7: Hotstove420 ($33.15 in chips) 
Seat 8: Chernovsky ($50.02 in chips) 
Rorerzap: posts small blind $0.25
christyirish: posts big blind $0.50
*** HOLE CARDS ***
jantheman222: folds 
maisit*: folds 
Hotstove420: raises $1 to $1.50
Chernovsky: folds 
Zargmen: folds 
Rorerzap: folds 
christyirish: folds 
Uncalled bet ($1) returned to Hotstove420
Hotstove420 collected $1.25 from pot
Hotstove420: doesn't show hand 
*** SUMMARY ***
Total pot $1.25 | Rake $0 
Seat 1: Zargmen (button) folded before Flop (didn't bet)
Seat 2: Rorerzap (small blind) folded before Flop
Seat 4: christyirish (big blind) folded before Flop
Seat 5: jantheman222 folded before Flop (didn't bet)
Seat 6: maisit* folded before Flop (didn't bet)
Seat 7: Hotstove420 collected ($1.25)
Seat 8: Chernovsky folded before Flop (didn't bet)



PokerStars Hand #228696796597:  Hold'em No Limit ($0.25/$0.50 USD) - 2021/07/30 23:17:28 ET
Table 'Aitne III' 9-max Seat #2 is the button
Seat 1: Zargmen ($30.58 in chips) 
Seat 2: Rorerzap ($88.91 in chips) 
Seat 4: christyirish ($98.64 in chips) 
Seat 5: jantheman222 ($86.45 in chips) 
Seat 6: maisit* ($67.95 in chips) 
Seat 7: Hotstove420 ($33.90 in chips) 
Seat 8: Chernovsky ($50.02 in chips) 
christyirish: posts small blind $0.25
jantheman222: posts big blind $0.50
*** HOLE CARDS ***
maisit*: folds 
Hotstove420: folds 
Chernovsky: folds 
Zargmen: folds 
Rorerzap: raises $0.60 to $1.10
christyirish: folds 
jantheman222: folds 
Uncalled bet ($0.60) returned to Rorerzap
Rorerzap collected $1.25 from pot
Rorerzap: doesn't show hand 
*** SUMMARY ***
Total pot $1.25 | Rake $0 
Seat 1: Zargmen folded before Flop (didn't bet)
Seat 2: Rorerzap (button) collected ($1.25)
Seat 4: christyirish (small blind) folded before Flop
Seat 5: jantheman222 (big blind) folded before Flop
Seat 6: maisit* folded before Flop (didn't bet)
Seat 7: Hotstove420 folded before Flop (didn't bet)
Seat 8: Chernovsky folded before Flop (didn't bet)



PokerStars Hand #228696801291:  Hold'em No Limit ($0.25/$0.50 USD) - 2021/07/30 23:17:41 ET
Table 'Aitne III' 9-max Seat #4 is the button
Seat 1: Zargmen ($30.58 in chips) 
Seat 2: Rorerzap ($89.66 in chips) 
Seat 4: christyirish ($98.39 in chips) 
Seat 5: jantheman222 ($85.95 in chips) 
Seat 6: maisit* ($67.95 in chips) 
Seat 7: Hotstove420 ($33.90 in chips) 
Seat 8: Chernovsky ($50.02 in chips) 
jantheman222: posts small blind $0.25
maisit*: posts big blind $0.50
*** HOLE CARDS ***
Hotstove420: folds 
Chernovsky: folds 
Zargmen: calls $0.50
Rorerzap: folds 
christyirish: folds 
jantheman222: calls $0.25
maisit*: checks 
*** FLOP *** [Jh 7d 7c]
jantheman222: checks 
maisit*: checks 
Zargmen: bets $1
jantheman222: calls $1
maisit*: folds 
*** TURN *** [Jh 7d 7c] [6d]
jantheman222: checks 
Zargmen: checks 
*** RIVER *** [Jh 7d 7c 6d] [4h]
jantheman222: bets $1.25
Zargmen: calls $1.25
*** SHOW DOWN ***
jantheman222: shows [Jc 6h] (two pair, Jacks and Sevens)
Zargmen: mucks hand 
jantheman222 collected $5.70 from pot
*** SUMMARY ***
Total pot $6 | Rake $0.30 
Board [Jh 7d 7c 6d 4h]
Seat 1: Zargmen mucked
Seat 2: Rorerzap folded before Flop (didn't bet)
Seat 4: christyirish (button) folded before Flop (didn't bet)
Seat 5: jantheman222 (small blind) showed [Jc 6h] and won ($5.70) with two pair, Jacks and Sevens
Seat 6: maisit* (big blind) folded on the Flop
Seat 7: Hotstove420 folded before Flop (didn't bet)
Seat 8: Chernovsky folded before Flop (didn't bet)



PokerStars Hand #228696811941:  Hold'em No Limit ($0.25/$0.50 USD) - 2021/07/30 23:18:34 ET
Table 'Aitne III' 9-max Seat #5 is the button
Seat 1: Zargmen ($27.83 in chips) 
Seat 2: Rorerzap ($89.66 in chips) 
Seat 4: christyirish ($98.39 in chips) 
Seat 5: jantheman222 ($88.90 in chips) 
Seat 6: maisit* ($67.45 in chips) 
Seat 7: Hotstove420 ($33.90 in chips) 
Seat 8: Chernovsky ($50.02 in chips) 
maisit*: posts small blind $0.25
Hotstove420: posts big blind $0.50
*** HOLE CARDS ***
Chernovsky: folds 
Zargmen: folds 
Rorerzap: raises $1 to $1.50
christyirish: raises $3.75 to $5.25
jantheman222: folds 
maisit*: folds 
Hotstove420: folds 
Rorerzap: folds 
Uncalled bet ($3.75) returned to christyirish
christyirish collected $3.75 from pot
*** SUMMARY ***
Total pot $3.75 | Rake $0 
Seat 1: Zargmen folded before Flop (didn't bet)
Seat 2: Rorerzap folded before Flop
Seat 4: christyirish collected ($3.75)
Seat 5: jantheman222 (button) folded before Flop (didn't bet)
Seat 6: maisit* (small blind) folded before Flop
Seat 7: Hotstove420 (big blind) folded before Flop
Seat 8: Chernovsky folded before Flop (didn't bet)



PokerStars Hand #228696817450:  Hold'em No Limit ($0.25/$0.50 USD) - 2021/07/30 23:19:02 ET
Table 'Aitne III' 9-max Seat #6 is the button
Seat 2: Rorerzap ($88.16 in chips) 
Seat 4: christyirish ($100.64 in chips) 
Seat 5: jantheman222 ($88.90 in chips) 
Seat 6: maisit* ($67.20 in chips) 
Seat 7: Hotstove420 ($33.40 in chips) 
Seat 8: Chernovsky ($50.02 in chips) 
kars0n joins the table at seat #3 
Hotstove420: posts small blind $0.25
Chernovsky: posts big blind $0.50
*** HOLE CARDS ***
Rorerzap: raises $1 to $1.50
christyirish: folds 
jantheman222: folds 
maisit*: folds 
Hotstove420: folds 
Chernovsky: folds 
Uncalled bet ($1) returned to Rorerzap
Rorerzap collected $1.25 from pot
Rorerzap: doesn't show hand 
*** SUMMARY ***
Total pot $1.25 | Rake $0 
Seat 2: Rorerzap collected ($1.25)
Seat 4: christyirish folded before Flop (didn't bet)
Seat 5: jantheman222 folded before Flop (didn't bet)
Seat 6: maisit* (button) folded before Flop (didn't bet)
Seat 7: Hotstove420 (small blind) folded before Flop
Seat 8: Chernovsky (big blind) folded before Flop



PokerStars Hand #228696821371:  Hold'em No Limit ($0.25/$0.50 USD) - 2021/07/30 23:19:22 ET
Table 'Aitne III' 9-max Seat #7 is the button
Seat 2: Rorerzap ($88.91 in chips) 
Seat 4: christyirish ($100.64 in chips) 
Seat 5: jantheman222 ($88.90 in chips) 
Seat 6: maisit* ($67.20 in chips) 
Seat 7: Hotstove420 ($33.15 in chips) 
Seat 8: Chernovsky ($50 in chips) 
Chernovsky: posts small blind $0.25
Rorerzap: posts big blind $0.50
kars0n: sits out 
*** HOLE CARDS ***
christyirish: folds 
jantheman222: raises $0.75 to $1.25
maisit*: folds 
Hotstove420: calls $1.25
Chernovsky: folds 
Rorerzap: folds 
*** FLOP *** [2c Qh 5d]
jantheman222: checks 
Hotstove420: checks 
*** TURN *** [2c Qh 5d] [8d]
jantheman222: bets $2.47
Hotstove420: calls $2.47
*** RIVER *** [2c Qh 5d 8d] [Th]
jantheman222: bets $9.73
Hotstove420: calls $9.73
*** SHOW DOWN ***
jantheman222: shows [5c 5s] (three of a kind, Fives)
Hotstove420: mucks hand 
jantheman222 collected $26.27 from pot
*** SUMMARY ***
Total pot $27.65 | Rake $1.38 
Board [2c Qh 5d 8d Th]
Seat 2: Rorerzap (big blind) folded before Flop
Seat 4: christyirish folded before Flop (didn't bet)
Seat 5: jantheman222 showed [5c 5s] and won ($26.27) with three of a kind, Fives
Seat 6: maisit* folded before Flop (didn't bet)
Seat 7: Hotstove420 (button) mucked
Seat 8: Chernovsky (small blind) folded before Flop



PokerStars Hand #228696829484:  Hold'em No Limit ($0.25/$0.50 USD) - 2021/07/30 23:20:01 ET
Table 'Aitne III' 9-max Seat #8 is the button
Seat 2: Rorerzap ($88.41 in chips) 
Seat 3: kars0n ($50 in chips) 
Seat 4: christyirish ($100.64 in chips) 
Seat 5: jantheman222 ($101.72 in chips) 
Seat 6: maisit* ($67.20 in chips) 
Seat 7: Hotstove420 ($19.70 in chips) 
Seat 8: Chernovsky ($50 in chips) 
Rorerzap: posts small blind $0.25
kars0n: posts big blind $0.50
*** HOLE CARDS ***
christyirish: folds 
jantheman222: folds 
maisit*: folds 
Hotstove420: folds 
Chernovsky: raises $0.75 to $1.25
Hotstove420 leaves the table
Rorerzap: folds 
i$BamboBlady$i joins the table at seat #9 
gustguaira joins the table at seat #7 
kars0n: folds 
Uncalled bet ($0.75) returned to Chernovsky
Chernovsky collected $1.25 from pot
Chernovsky: doesn't show hand 
*** SUMMARY ***
Total pot $1.25 | Rake $0 
Seat 2: Rorerzap (small blind) folded before Flop
Seat 3: kars0n (big blind) folded before Flop
Seat 4: christyirish folded before Flop (didn't bet)
Seat 5: jantheman222 folded before Flop (didn't bet)
Seat 6: maisit* folded before Flop (didn't bet)
Seat 7: Hotstove420 folded before Flop (didn't bet)
Seat 8: Chernovsky (button) collected ($1.25)



PokerStars Hand #228696835216:  Hold'em No Limit ($0.25/$0.50 USD) - 2021/07/30 23:20:30 ET
Table 'Aitne III' 9-max Seat #2 is the button
Seat 2: Rorerzap ($88.16 in chips) 
Seat 3: kars0n ($50 in chips) 
Seat 4: christyirish ($100.64 in chips) 
Seat 5: jantheman222 ($101.72 in chips) 
Seat 6: maisit* ($67.20 in chips) 
Seat 7: gustguaira ($50 in chips) 
Seat 8: Chernovsky ($50.75 in chips) 
Seat 9: i$BamboBlady$i ($40 in chips) 
kars0n: posts small blind $0.25
christyirish: posts big blind $0.50
gustguaira: posts big blind $0.50
i$BamboBlady$i: posts big blind $0.50
*** HOLE CARDS ***
jantheman222: folds 
maisit*: raises $2 to $2.50
gustguaira: folds 
Chernovsky: folds 
i$BamboBlady$i: folds 
Rorerzap: folds 
kars0n: folds 
christyirish: calls $2
*** FLOP *** [As Qs 2s]
christyirish: checks 
maisit*: checks 
*** TURN *** [As Qs 2s] [Jh]
christyirish: bets $1.78
Zargmen leaves the table
maisit*: calls $1.78
*** RIVER *** [As Qs 2s Jh] [8d]
christyirish: checks 
maisit*: checks 
*** SHOW DOWN ***
christyirish: shows [2h 2c] (three of a kind, Deuces)
maisit*: mucks hand 
christyirish collected $9.32 from pot
*** SUMMARY ***
Total pot $9.81 | Rake $0.49 
Board [As Qs 2s Jh 8d]
Seat 2: Rorerzap (button) folded before Flop (didn't bet)
Seat 3: kars0n (small blind) folded before Flop
Seat 4: christyirish (big blind) showed [2h 2c] and won ($9.32) with three of a kind, Deuces
Seat 5: jantheman222 folded before Flop (didn't bet)
Seat 6: maisit* mucked
Seat 7: gustguaira folded before Flop (didn't bet)
Seat 8: Chernovsky folded before Flop (didn't bet)
Seat 9: i$BamboBlady$i folded before Flop (didn't bet)



PokerStars Hand #228696845236:  Hold'em No Limit ($0.25/$0.50 USD) - 2021/07/30 23:21:20 ET
Table 'Aitne III' 9-max Seat #3 is the button
Seat 2: Rorerzap ($88.16 in chips) 
Seat 3: kars0n ($50 in chips) 
Seat 4: christyirish ($105.68 in chips) 
Seat 5: jantheman222 ($101.72 in chips) 
Seat 6: maisit* ($62.92 in chips) 
Seat 7: gustguaira ($49.50 in chips) 
Seat 8: Chernovsky ($50.75 in chips) 
Seat 9: i$BamboBlady$i ($39.50 in chips) 
christyirish: posts small blind $0.25
jantheman222: posts big blind $0.50
*** HOLE CARDS ***
maisit*: folds 
gustguaira: raises $0.50 to $1
Chernovsky: folds 
i$BamboBlady$i: calls $1
AceKingxx joins the table at seat #1 
Rorerzap: calls $1
kars0n: folds 
christyirish: calls $0.75
jantheman222: calls $0.50
*** FLOP *** [6s 7d 5h]
christyirish: checks 
jantheman222: checks 
gustguaira: checks 
i$BamboBlady$i: bets $2.37
Rorerzap: calls $2.37
christyirish: raises $11.86 to $14.23
jantheman222: calls $14.23
gustguaira: folds 
i$BamboBlady$i: folds 
Rorerzap: folds 
*** TURN *** [6s 7d 5h] [5s]
christyirish: checks 
jantheman222: checks 
*** RIVER *** [6s 7d 5h 5s] [6h]
christyirish: checks 
jantheman222: checks 
*** SHOW DOWN ***
christyirish: shows [3d 4d] (a straight, Three to Seven)
jantheman222: shows [4h 3c] (a straight, Three to Seven)
christyirish collected $18.15 from pot
jantheman222 collected $18.14 from pot
*** SUMMARY ***
Total pot $38.20 | Rake $1.91 
Board [6s 7d 5h 5s 6h]
Seat 2: Rorerzap folded on the Flop
Seat 3: kars0n (button) folded before Flop (didn't bet)
Seat 4: christyirish (small blind) showed [3d 4d] and won ($18.15) with a straight, Three to Seven
Seat 5: jantheman222 (big blind) showed [4h 3c] and won ($18.14) with a straight, Three to Seven
Seat 6: maisit* folded before Flop (didn't bet)
Seat 7: gustguaira folded on the Flop
Seat 8: Chernovsky folded before Flop (didn't bet)
Seat 9: i$BamboBlady$i folded on the Flop



PokerStars Hand #228696873089:  Hold'em No Limit ($0.25/$0.50 USD) - 2021/07/30 23:23:27 ET
Table 'Aitne III' 9-max Seat #4 is the button
Seat 1: AceKingxx ($30.06 in chips) 
Seat 2: Rorerzap ($84.79 in chips) 
Seat 3: kars0n ($50 in chips) 
Seat 4: christyirish ($108.60 in chips) 
Seat 5: jantheman222 ($104.63 in chips) 
Seat 6: maisit* ($62.92 in chips) 
Seat 7: gustguaira ($48.50 in chips) 
Seat 8: Chernovsky ($50.75 in chips) 
Seat 9: i$BamboBlady$i ($36.13 in chips) 
jantheman222: posts small blind $0.25
maisit*: posts big blind $0.50
AceKingxx: posts big blind $0.50
*** HOLE CARDS ***
gustguaira: folds 
Chernovsky: folds 
i$BamboBlady$i: calls $0.50
AceKingxx: checks 
Rorerzap: folds 
kars0n: raises $2.25 to $2.75
christyirish: folds 
jantheman222: folds 
maisit*: folds 
i$BamboBlady$i: calls $2.25
AceKingxx: folds 
*** FLOP *** [7s Qs 7c]
i$BamboBlady$i: checks 
kars0n: bets $2.25
i$BamboBlady$i: calls $2.25
*** TURN *** [7s Qs 7c] [Td]
i$BamboBlady$i: checks 
kars0n: bets $7.06
i$BamboBlady$i: folds 
Uncalled bet ($7.06) returned to kars0n
kars0n collected $10.69 from pot
*** SUMMARY ***
Total pot $11.25 | Rake $0.56 
Board [7s Qs 7c Td]
Seat 1: AceKingxx folded before Flop (didn't bet)
Seat 2: Rorerzap folded before Flop (didn't bet)
Seat 3: kars0n collected ($10.69)
Seat 4: christyirish (button) folded before Flop (didn't bet)
Seat 5: jantheman222 (small blind) folded before Flop
Seat 6: maisit* (big blind) folded before Flop
Seat 7: gustguaira folded before Flop (didn't bet)
Seat 8: Chernovsky folded before Flop (didn't bet)
Seat 9: i$BamboBlady$i folded on the Turn



PokerStars Hand #228696884840:  Hold'em No Limit ($0.25/$0.50 USD) - 2021/07/30 23:24:26 ET
Table 'Aitne III' 9-max Seat #5 is the button
Seat 1: AceKingxx ($29.56 in chips) 
Seat 2: Rorerzap ($84.79 in chips) 
Seat 3: kars0n ($55.69 in chips) 
Seat 4: christyirish ($108.60 in chips) 
Seat 5: jantheman222 ($104.38 in chips) 
Seat 6: maisit* ($62.42 in chips) 
Seat 7: gustguaira ($48.50 in chips) 
Seat 8: Chernovsky ($50.75 in chips) 
Seat 9: i$BamboBlady$i ($31.13 in chips) 
maisit*: posts small blind $0.25
gustguaira: posts big blind $0.50
*** HOLE CARDS ***
Chernovsky: folds 
i$BamboBlady$i: folds 
AceKingxx: calls $0.50
Rorerzap: folds 
kars0n: folds 
christyirish: calls $0.50
jantheman222: folds 
maisit*: raises $3 to $3.50
gustguaira: folds 
AceKingxx: calls $3
christyirish: folds 
*** FLOP *** [Qs Ad 8h]
maisit*: checks 
AceKingxx: bets $5.80
maisit*: calls $5.80
*** TURN *** [Qs Ad 8h] [2d]
maisit*: checks 
AceKingxx: bets $9.31
maisit*: raises $27.93 to $37.24
AceKingxx: calls $10.95 and is all-in
Uncalled bet ($16.98) returned to maisit*
*** RIVER *** [Qs Ad 8h 2d] [2s]
*** SHOW DOWN ***
maisit*: shows [Ac Kh] (two pair, Aces and Deuces)
AceKingxx: shows [Kd As] (two pair, Aces and Deuces)
maisit* collected $29.06 from pot
AceKingxx collected $29.06 from pot
*** SUMMARY ***
Total pot $60.12 | Rake $2 
Board [Qs Ad 8h 2d 2s]
Seat 1: AceKingxx showed [Kd As] and won ($29.06) with two pair, Aces and Deuces
Seat 2: Rorerzap folded before Flop (didn't bet)
Seat 3: kars0n folded before Flop (didn't bet)
Seat 4: christyirish folded before Flop
Seat 5: jantheman222 (button) folded before Flop (didn't bet)
Seat 6: maisit* (small blind) showed [Ac Kh] and won ($29.06) with two pair, Aces and Deuces
Seat 7: gustguaira (big blind) folded before Flop
Seat 8: Chernovsky folded before Flop (didn't bet)
Seat 9: i$BamboBlady$i folded before Flop (didn't bet)



PokerStars Hand #228696897976:  Hold'em No Limit ($0.25/$0.50 USD) - 2021/07/30 23:25:32 ET
Table 'Aitne III' 9-max Seat #6 is the button
Seat 1: AceKingxx ($29.06 in chips) 
Seat 2: Rorerzap ($84.79 in chips) 
Seat 3: kars0n ($55.69 in chips) 
Seat 4: christyirish ($108.10 in chips) 
Seat 5: jantheman222 ($104.38 in chips) 
Seat 6: maisit* ($61.92 in chips) 
Seat 7: gustguaira ($48 in chips) 
Seat 8: Chernovsky ($50.75 in chips) 
Seat 9: i$BamboBlady$i ($31.13 in chips) 
gustguaira: posts small blind $0.25
Chernovsky: posts big blind $0.50
*** HOLE CARDS ***
i$BamboBlady$i: raises $1 to $1.50
AceKingxx: calls $1.50
Rorerzap: folds 
kars0n: folds 
christyirish: folds 
jantheman222: folds 
maisit*: folds 
gustguaira: calls $1.25
Chernovsky: folds 
*** FLOP *** [Ks 6d Ac]
gustguaira: checks 
i$BamboBlady$i: bets $2.37
AceKingxx: calls $2.37
gustguaira: folds 
*** TURN *** [Ks 6d Ac] [6s]
i$BamboBlady$i: checks 
AceKingxx: bets $4.62
i$BamboBlady$i: calls $4.62
*** RIVER *** [Ks 6d Ac 6s] [Ah]
i$BamboBlady$i: bets $22.64 and is all-in
AceKingxx: folds 
Uncalled bet ($22.64) returned to i$BamboBlady$i
i$BamboBlady$i collected $17.79 from pot
i$BamboBlady$i: doesn't show hand 
*** SUMMARY ***
Total pot $18.98 | Rake $1.19 
Board [Ks 6d Ac 6s Ah]
Seat 1: AceKingxx folded on the River
Seat 2: Rorerzap folded before Flop (didn't bet)
Seat 3: kars0n folded before Flop (didn't bet)
Seat 4: christyirish folded before Flop (didn't bet)
Seat 5: jantheman222 folded before Flop (didn't bet)
Seat 6: maisit* (button) folded before Flop (didn't bet)
Seat 7: gustguaira (small blind) folded on the Flop
Seat 8: Chernovsky (big blind) folded before Flop
Seat 9: i$BamboBlady$i collected ($17.79)



PokerStars Hand #228696909069:  Hold'em No Limit ($0.25/$0.50 USD) - 2021/07/30 23:26:28 ET
Table 'Aitne III' 9-max Seat #7 is the button
Seat 1: AceKingxx ($20.57 in chips) 
Seat 2: Rorerzap ($84.79 in chips) 
Seat 3: kars0n ($55.69 in chips) 
Seat 4: christyirish ($108.10 in chips) 
Seat 5: jantheman222 ($104.38 in chips) 
Seat 6: maisit* ($61.92 in chips) 
Seat 7: gustguaira ($46.50 in chips) 
Seat 8: Chernovsky ($50.25 in chips) 
Seat 9: i$BamboBlady$i ($40.43 in chips) 
Chernovsky: posts small blind $0.25
i$BamboBlady$i: posts big blind $0.50
*** HOLE CARDS ***
AceKingxx: folds 
Rorerzap: folds 
kars0n: folds 
christyirish: folds 
jantheman222: folds 
maisit*: raises $1 to $1.50
gustguaira: calls $1.50
Chernovsky: folds 
i$BamboBlady$i: calls $1
*** FLOP *** [Qh Ad 5h]
i$BamboBlady$i: checks 
maisit*: checks 
gustguaira: bets $2.25
i$BamboBlady$i: calls $2.25
maisit*: calls $2.25
*** TURN *** [Qh Ad 5h] [Qd]
i$BamboBlady$i: checks 
maisit*: checks 
gustguaira: bets $5.46
i$BamboBlady$i: calls $5.46
maisit*: folds 
*** RIVER *** [Qh Ad 5h Qd] [2h]
i$BamboBlady$i: checks 
gustguaira: bets $10.65
i$BamboBlady$i: calls $10.65
*** SHOW DOWN ***
gustguaira: shows [Tc Qc] (three of a kind, Queens)
i$BamboBlady$i: mucks hand 
gustguaira collected $41.72 from pot
*** SUMMARY ***
Total pot $43.72 | Rake $2 
Board [Qh Ad 5h Qd 2h]
Seat 1: AceKingxx folded before Flop (didn't bet)
Seat 2: Rorerzap folded before Flop (didn't bet)
Seat 3: kars0n folded before Flop (didn't bet)
Seat 4: christyirish folded before Flop (didn't bet)
Seat 5: jantheman222 folded before Flop (didn't bet)
Seat 6: maisit* folded on the Turn
Seat 7: gustguaira (button) showed [Tc Qc] and won ($41.72) with three of a kind, Queens
Seat 8: Chernovsky (small blind) folded before Flop
Seat 9: i$BamboBlady$i (big blind) mucked



PokerStars Hand #228696925624:  Hold'em No Limit ($0.25/$0.50 USD) - 2021/07/30 23:27:50 ET
Table 'Aitne III' 9-max Seat #8 is the button
Seat 1: AceKingxx ($20.57 in chips) 
Seat 2: Rorerzap ($84.79 in chips) 
Seat 3: kars0n ($55.69 in chips) 
Seat 4: christyirish ($108.10 in chips) 
Seat 5: jantheman222 ($104.38 in chips) 
Seat 6: maisit* ($58.17 in chips) 
Seat 7: gustguaira ($68.36 in chips) 
Seat 8: Chernovsky ($50 in chips) 
Seat 9: i$BamboBlady$i ($20.57 in chips) 
i$BamboBlady$i: posts small blind $0.25
AceKingxx: posts big blind $0.50
*** HOLE CARDS ***
Rorerzap: folds 
kars0n: folds 
christyirish: folds 
jantheman222: folds 
maisit*: folds 
gustguaira: calls $0.50
Chernovsky: folds 
i$BamboBlady$i: folds 
AceKingxx: checks 
*** FLOP *** [Qs Ks 5c]
AceKingxx: checks 
gustguaira: checks 
*** TURN *** [Qs Ks 5c] [3s]
AceKingxx: bets $1.19
gustguaira: folds 
Uncalled bet ($1.19) returned to AceKingxx
AceKingxx collected $1.19 from pot
AceKingxx: doesn't show hand 
*** SUMMARY ***
Total pot $1.25 | Rake $0.06 
Board [Qs Ks 5c 3s]
Seat 1: AceKingxx (big blind) collected ($1.19)
Seat 2: Rorerzap folded before Flop (didn't bet)
Seat 3: kars0n folded before Flop (didn't bet)
Seat 4: christyirish folded before Flop (didn't bet)
Seat 5: jantheman222 folded before Flop (didn't bet)
Seat 6: maisit* folded before Flop (didn't bet)
Seat 7: gustguaira folded on the Turn
Seat 8: Chernovsky (button) folded before Flop (didn't bet)
Seat 9: i$BamboBlady$i (small blind) folded before Flop



PokerStars Hand #228696932507:  Hold'em No Limit ($0.25/$0.50 USD) - 2021/07/30 23:28:25 ET
Table 'Aitne III' 9-max Seat #9 is the button
Seat 1: AceKingxx ($21.26 in chips) 
Seat 2: Rorerzap ($84.79 in chips) 
Seat 3: kars0n ($55.69 in chips) 
Seat 4: christyirish ($108.10 in chips) 
Seat 5: jantheman222 ($104.38 in chips) 
Seat 6: maisit* ($58.17 in chips) 
Seat 7: gustguaira ($67.86 in chips) 
Seat 8: Chernovsky ($50 in chips) 
Seat 9: i$BamboBlady$i ($20.32 in chips) 
AceKingxx: posts small blind $0.25
Rorerzap: posts big blind $0.50
*** HOLE CARDS ***
kars0n: raises $1 to $1.50
christyirish has timed out
christyirish: folds 
jantheman222: folds 
maisit*: folds 
gustguaira: folds 
Chernovsky: folds 
i$BamboBlady$i: folds 
AceKingxx: folds 
Rorerzap: folds 
Uncalled bet ($1) returned to kars0n
kars0n collected $1.25 from pot
*** SUMMARY ***
Total pot $1.25 | Rake $0 
Seat 1: AceKingxx (small blind) folded before Flop
Seat 2: Rorerzap (big blind) folded before Flop
Seat 3: kars0n collected ($1.25)
Seat 4: christyirish folded before Flop (didn't bet)
Seat 5: jantheman222 folded before Flop (didn't bet)
Seat 6: maisit* folded before Flop (didn't bet)
Seat 7: gustguaira folded before Flop (didn't bet)
Seat 8: Chernovsky folded before Flop (didn't bet)
Seat 9: i$BamboBlady$i (button) folded before Flop (didn't bet)



PokerStars Hand #228696939157:  Hold'em No Limit ($0.25/$0.50 USD) - 2021/07/30 23:28:58 ET
Table 'Aitne III' 9-max Seat #1 is the button
Seat 1: AceKingxx ($21.01 in chips) 
Seat 2: Rorerzap ($84.29 in chips) 
Seat 3: kars0n ($56.44 in chips) 
Seat 5: jantheman222 ($104.38 in chips) 
Seat 6: maisit* ($58.17 in chips) 
Seat 7: gustguaira ($67.86 in chips) 
Seat 8: Chernovsky ($50 in chips) 
Seat 9: i$BamboBlady$i ($20.32 in chips) 
Rorerzap: posts small blind $0.25
kars0n: posts big blind $0.50
*** HOLE CARDS ***
jantheman222: folds 
maisit* has timed out
maisit*: folds 
gustguaira: folds 
Chernovsky: folds 
i$BamboBlady$i: folds 
AceKingxx: folds 
Rorerzap: raises $1 to $1.50
kars0n: raises $3.25 to $4.75
Rorerzap: folds 
Uncalled bet ($3.25) returned to kars0n
kars0n collected $3 from pot
*** SUMMARY ***
Total pot $3 | Rake $0 
Seat 1: AceKingxx (button) folded before Flop (didn't bet)
Seat 2: Rorerzap (small blind) folded before Flop
Seat 3: kars0n (big blind) collected ($3)
Seat 5: jantheman222 folded before Flop (didn't bet)
Seat 6: maisit* folded before Flop (didn't bet)
Seat 7: gustguaira folded before Flop (didn't bet)
Seat 8: Chernovsky folded before Flop (didn't bet)
Seat 9: i$BamboBlady$i folded before Flop (didn't bet)



PokerStars Hand #228696944859:  Hold'em No Limit ($0.25/$0.50 USD) - 2021/07/30 23:29:26 ET
Table 'Aitne III' 9-max Seat #2 is the button
Seat 1: AceKingxx ($21.01 in chips) 
Seat 2: Rorerzap ($82.79 in chips) 
Seat 3: kars0n ($57.94 in chips) 
Seat 4: christyirish ($108.10 in chips) 
Seat 5: jantheman222 ($104.38 in chips) 
Seat 7: gustguaira ($67.86 in chips) 
Seat 8: Chernovsky ($50 in chips) 
Seat 9: i$BamboBlady$i ($20.32 in chips) 
kars0n: posts small blind $0.25
christyirish: posts big blind $0.50
*** HOLE CARDS ***
jantheman222: raises $0.75 to $1.25
gustguaira: calls $1.25
Chernovsky: folds 
i$BamboBlady$i: raises $3.75 to $5
AceKingxx: folds 
Rorerzap: folds 
kars0n: folds 
christyirish: folds 
jantheman222: folds 
gustguaira: folds 
Uncalled bet ($3.75) returned to i$BamboBlady$i
i$BamboBlady$i collected $4.50 from pot
i$BamboBlady$i: doesn't show hand 
*** SUMMARY ***
Total pot $4.50 | Rake $0 
Seat 1: AceKingxx folded before Flop (didn't bet)
Seat 2: Rorerzap (button) folded before Flop (didn't bet)
Seat 3: kars0n (small blind) folded before Flop
Seat 4: christyirish (big blind) folded before Flop
Seat 5: jantheman222 folded before Flop
Seat 7: gustguaira folded before Flop
Seat 8: Chernovsky folded before Flop (didn't bet)
Seat 9: i$BamboBlady$i collected ($4.50)



PokerStars Hand #228696958285:  Hold'em No Limit ($0.25/$0.50 USD) - 2021/07/30 23:30:11 ET
Table 'Aitne III' 9-max Seat #3 is the button
Seat 1: AceKingxx ($21.01 in chips) 
Seat 2: Rorerzap ($82.79 in chips) 
Seat 3: kars0n ($57.69 in chips) 
Seat 4: christyirish ($107.60 in chips) 
Seat 5: jantheman222 ($103.13 in chips) 
Seat 7: gustguaira ($66.61 in chips) 
Seat 8: Chernovsky ($50 in chips) 
Seat 9: i$BamboBlady$i ($23.57 in chips) 
christyirish: posts small blind $0.25
jantheman222: posts big blind $0.50
*** HOLE CARDS ***
gustguaira: folds 
Chernovsky: folds 
i$BamboBlady$i: folds 
AceKingxx: raises $1 to $1.50
Rorerzap: folds 
kars0n: folds 
christyirish: folds 
jantheman222: folds 
Uncalled bet ($1) returned to AceKingxx
AceKingxx collected $1.25 from pot
AceKingxx: doesn't show hand 
*** SUMMARY ***
Total pot $1.25 | Rake $0 
Seat 1: AceKingxx collected ($1.25)
Seat 2: Rorerzap folded before Flop (didn't bet)
Seat 3: kars0n (button) folded before Flop (didn't bet)
Seat 4: christyirish (small blind) folded before Flop
Seat 5: jantheman222 (big blind) folded before Flop
Seat 7: gustguaira folded before Flop (didn't bet)
Seat 8: Chernovsky folded before Flop (didn't bet)
Seat 9: i$BamboBlady$i folded before Flop (didn't bet)



PokerStars Hand #228696962319:  Hold'em No Limit ($0.25/$0.50 USD) - 2021/07/30 23:30:31 ET
Table 'Aitne III' 9-max Seat #4 is the button
Seat 1: AceKingxx ($21.76 in chips) 
Seat 2: Rorerzap ($82.79 in chips) 
Seat 3: kars0n ($57.69 in chips) 
Seat 4: christyirish ($107.35 in chips) 
Seat 5: jantheman222 ($102.63 in chips) 
Seat 7: gustguaira ($66.61 in chips) 
Seat 8: Chernovsky ($50 in chips) 
Seat 9: i$BamboBlady$i ($23.57 in chips) 
jantheman222: posts small blind $0.25
gustguaira: posts big blind $0.50
*** HOLE CARDS ***
Chernovsky: folds 
i$BamboBlady$i: folds 
AceKingxx: folds 
Rorerzap: raises $1 to $1.50
kars0n: folds 
christyirish: folds 
jantheman222: folds 
gustguaira: folds 
Uncalled bet ($1) returned to Rorerzap
gustguaira leaves the table
Rorerzap collected $1.25 from pot
Rorerzap: doesn't show hand 
*** SUMMARY ***
Total pot $1.25 | Rake $0 
Seat 1: AceKingxx folded before Flop (didn't bet)
Seat 2: Rorerzap collected ($1.25)
Seat 3: kars0n folded before Flop (didn't bet)
Seat 4: christyirish (button) folded before Flop (didn't bet)
Seat 5: jantheman222 (small blind) folded before Flop
Seat 7: gustguaira (big blind) folded before Flop
Seat 8: Chernovsky folded before Flop (didn't bet)
Seat 9: i$BamboBlady$i folded before Flop (didn't bet)



PokerStars Hand #228696966479:  Hold'em No Limit ($0.25/$0.50 USD) - 2021/07/30 23:30:52 ET
Table 'Aitne III' 9-max Seat #5 is the button
Seat 1: AceKingxx ($21.76 in chips) 
Seat 2: Rorerzap ($83.54 in chips) 
Seat 3: kars0n ($57.69 in chips) 
Seat 4: christyirish ($107.35 in chips) 
Seat 5: jantheman222 ($102.38 in chips) 
Seat 8: Chernovsky ($50 in chips) 
Seat 9: i$BamboBlady$i ($23.57 in chips) 
Chernovsky: posts small blind $0.25
i$BamboBlady$i: posts big blind $0.50
*** HOLE CARDS ***
AceKingxx: folds 
Rorerzap: folds 
kars0n: folds 
christyirish: folds 
jantheman222: raises $0.75 to $1.25
Chernovsky: folds 
i$BamboBlady$i: folds 
Uncalled bet ($0.75) returned to jantheman222
jantheman222 collected $1.25 from pot
*** SUMMARY ***
Total pot $1.25 | Rake $0 
Seat 1: AceKingxx folded before Flop (didn't bet)
Seat 2: Rorerzap folded before Flop (didn't bet)
Seat 3: kars0n folded before Flop (didn't bet)
Seat 4: christyirish folded before Flop (didn't bet)
Seat 5: jantheman222 (button) collected ($1.25)
Seat 8: Chernovsky (small blind) folded before Flop
Seat 9: i$BamboBlady$i (big blind) folded before Flop



PokerStars Hand #228696970078:  Hold'em No Limit ($0.25/$0.50 USD) - 2021/07/30 23:31:10 ET
Table 'Aitne III' 9-max Seat #8 is the button
Seat 1: AceKingxx ($21.76 in chips) 
Seat 2: Rorerzap ($83.54 in chips) 
Seat 3: kars0n ($57.69 in chips) 
Seat 4: christyirish ($107.35 in chips) 
Seat 5: jantheman222 ($103.13 in chips) 
Seat 8: Chernovsky ($50 in chips) 
Seat 9: i$BamboBlady$i ($23.07 in chips) 
i$BamboBlady$i: posts small blind $0.25
AceKingxx: posts big blind $0.50
*** HOLE CARDS ***
Rorerzap: folds 
kars0n: folds 
christyirish: raises $1 to $1.50
jantheman222: folds 
Chernovsky: folds 
i$BamboBlady$i: folds 
AceKingxx: folds 
Uncalled bet ($1) returned to christyirish
christyirish collected $1.25 from pot
*** SUMMARY ***
Total pot $1.25 | Rake $0 
Seat 1: AceKingxx (big blind) folded before Flop
Seat 2: Rorerzap folded before Flop (didn't bet)
Seat 3: kars0n folded before Flop (didn't bet)
Seat 4: christyirish collected ($1.25)
Seat 5: jantheman222 folded before Flop (didn't bet)
Seat 8: Chernovsky (button) folded before Flop (didn't bet)
Seat 9: i$BamboBlady$i (small blind) folded before Flop



PokerStars Hand #228696972665:  Hold'em No Limit ($0.25/$0.50 USD) - 2021/07/30 23:31:23 ET
Table 'Aitne III' 9-max Seat #9 is the button
Seat 1: AceKingxx ($21.26 in chips) 
Seat 2: Rorerzap ($83.54 in chips) 
Seat 3: kars0n ($57.69 in chips) 
Seat 4: christyirish ($108.10 in chips) 
Seat 5: jantheman222 ($103.13 in chips) 
Seat 8: Chernovsky ($50 in chips) 
Seat 9: i$BamboBlady$i ($22.82 in chips) 
AceKingxx: posts small blind $0.25
Rorerzap: posts big blind $0.50
*** HOLE CARDS ***
kars0n: folds 
christyirish: folds 
jantheman222: raises $0.75 to $1.25
Chernovsky: folds 
i$BamboBlady$i: calls $1.25
AceKingxx: folds 
Rorerzap: folds 
*** FLOP *** [Qh 2d Ks]
jantheman222: checks 
i$BamboBlady$i: checks 
*** TURN *** [Qh 2d Ks] [8d]
jantheman222: bets $1.50
i$BamboBlady$i: calls $1.50
*** RIVER *** [Qh 2d Ks 8d] [Js]
Quotes-bio joins the table at seat #7 
jantheman222: bets $2.75
i$BamboBlady$i: calls $2.75
*** SHOW DOWN ***
jantheman222: shows [Jd Kc] (two pair, Kings and Jacks)
i$BamboBlady$i: mucks hand 
jantheman222 collected $11.16 from pot
*** SUMMARY ***
Total pot $11.75 | Rake $0.59 
Board [Qh 2d Ks 8d Js]
Seat 1: AceKingxx (small blind) folded before Flop
Seat 2: Rorerzap (big blind) folded before Flop
Seat 3: kars0n folded before Flop (didn't bet)
Seat 4: christyirish folded before Flop (didn't bet)
Seat 5: jantheman222 showed [Jd Kc] and won ($11.16) with two pair, Kings and Jacks
Seat 8: Chernovsky folded before Flop (didn't bet)
Seat 9: i$BamboBlady$i (button) mucked



PokerStars Hand #228696998705:  Hold'em No Limit ($0.25/$0.50 USD) - 2021/07/30 23:33:36 ET
Table 'Aitne III' 9-max Seat #3 is the button
Seat 1: AceKingxx ($19.76 in chips) 
Seat 2: Rorerzap ($92.70 in chips) 
Seat 3: kars0n ($60.19 in chips) 
Seat 4: christyirish ($107.60 in chips) 
Seat 5: jantheman222 ($108.79 in chips) 
Seat 8: Chernovsky ($50 in chips) 
Seat 9: i$BamboBlady$i ($7.10 in chips) 
christyirish: posts small blind $0.25
jantheman222: posts big blind $0.50
maisit*: sits out 
Quotes-bio: sits out 
*** HOLE CARDS ***
Chernovsky: folds 
i$BamboBlady$i: folds 
AceKingxx: folds 
Rorerzap: folds 
kars0n: folds 
christyirish: folds 
Uncalled bet ($0.25) returned to jantheman222
jantheman222 collected $0.50 from pot
*** SUMMARY ***
Total pot $0.50 | Rake $0 
Seat 1: AceKingxx folded before Flop (didn't bet)
Seat 2: Rorerzap folded before Flop (didn't bet)
Seat 3: kars0n (button) folded before Flop (didn't bet)
Seat 4: christyirish (small blind) folded before Flop
Seat 5: jantheman222 (big blind) collected ($0.50)
Seat 8: Chernovsky folded before Flop (didn't bet)
Seat 9: i$BamboBlady$i folded before Flop (didn't bet)



PokerStars Hand #228697001171:  Hold'em No Limit ($0.25/$0.50 USD) - 2021/07/30 23:33:49 ET
Table 'Aitne III' 9-max Seat #4 is the button
Seat 1: AceKingxx ($19.76 in chips) 
Seat 2: Rorerzap ($92.70 in chips) 
Seat 3: kars0n ($60.19 in chips) 
Seat 4: christyirish ($107.35 in chips) 
Seat 5: jantheman222 ($109.04 in chips) 
Seat 6: maisit* ($58.17 in chips) 
Seat 8: Chernovsky ($50 in chips) 
Seat 9: i$BamboBlady$i ($7.10 in chips) 
jantheman222: posts small blind $0.25
maisit*: posts big blind $0.50
Quotes-bio: sits out 
*** HOLE CARDS ***
Chernovsky: raises $0.75 to $1.25
i$BamboBlady$i: folds 
AceKingxx: folds 
Rorerzap: folds 
kars0n: folds 
christyirish: folds 
jantheman222: folds 
maisit*: folds 
Uncalled bet ($0.75) returned to Chernovsky
Chernovsky collected $1.25 from pot
Chernovsky: doesn't show hand 
*** SUMMARY ***
Total pot $1.25 | Rake $0 
Seat 1: AceKingxx folded before Flop (didn't bet)
Seat 2: Rorerzap folded before Flop (didn't bet)
Seat 3: kars0n folded before Flop (didn't bet)
Seat 4: christyirish (button) folded before Flop (didn't bet)
Seat 5: jantheman222 (small blind) folded before Flop
Seat 6: maisit* (big blind) folded before Flop
Seat 8: Chernovsky collected ($1.25)
Seat 9: i$BamboBlady$i folded before Flop (didn't bet)



PokerStars Hand #228697005152:  Hold'em No Limit ($0.25/$0.50 USD) - 2021/07/30 23:34:09 ET
Table 'Aitne III' 9-max Seat #5 is the button
Seat 1: AceKingxx ($19.76 in chips) 
Seat 2: Rorerzap ($92.70 in chips) 
Seat 3: kars0n ($60.19 in chips) 
Seat 4: christyirish ($107.35 in chips) 
Seat 5: jantheman222 ($108.79 in chips) 
Seat 6: maisit* ($57.67 in chips) 
Seat 7: Quotes-bio ($50 in chips) 
Seat 8: Chernovsky ($50.75 in chips) 
Seat 9: i$BamboBlady$i ($7.10 in chips) 
maisit*: posts small blind $0.25
Quotes-bio: posts big blind $0.50
*** HOLE CARDS ***
Chernovsky: raises $0.75 to $1.25
i$BamboBlady$i: calls $1.25
AceKingxx: calls $1.25
Rorerzap: folds 
kars0n: folds 
christyirish: folds 
jantheman222: folds 
maisit*: folds 
Quotes-bio: calls $0.75
*** FLOP *** [6c 3c Tc]
Quotes-bio: checks 
Chernovsky: bets $3
i$BamboBlady$i: folds 
AceKingxx: folds 
Quotes-bio: folds 
Uncalled bet ($3) returned to Chernovsky
Chernovsky collected $4.99 from pot
Chernovsky: doesn't show hand 
*** SUMMARY ***
Total pot $5.25 | Rake $0.26 
Board [6c 3c Tc]
Seat 1: AceKingxx folded on the Flop
Seat 2: Rorerzap folded before Flop (didn't bet)
Seat 3: kars0n folded before Flop (didn't bet)
Seat 4: christyirish folded before Flop (didn't bet)
Seat 5: jantheman222 (button) folded before Flop (didn't bet)
Seat 6: maisit* (small blind) folded before Flop
Seat 7: Quotes-bio (big blind) folded on the Flop
Seat 8: Chernovsky collected ($4.99)
Seat 9: i$BamboBlady$i folded on the Flop



PokerStars Hand #228697011077:  Hold'em No Limit ($0.25/$0.50 USD) - 2021/07/30 23:34:38 ET
Table 'Aitne III' 9-max Seat #6 is the button
Seat 1: AceKingxx ($18.51 in chips) 
Seat 2: Rorerzap ($92.70 in chips) 
Seat 3: kars0n ($60.19 in chips) 
Seat 4: christyirish ($107.35 in chips) 
Seat 5: jantheman222 ($108.79 in chips) 
Seat 6: maisit* ($57.42 in chips) 
Seat 7: Quotes-bio ($48.75 in chips) 
Seat 9: i$BamboBlady$i ($5.85 in chips) 
Quotes-bio: posts small blind $0.25
Chernovsky: is sitting out 
i$BamboBlady$i: posts big blind $0.50
*** HOLE CARDS ***
AceKingxx: folds 
Rorerzap: folds 
Chernovsky leaves the table
kars0n: folds 
AceKingxx leaves the table
christyirish: folds 
jantheman222: folds 
maisit*: folds 
Quotes-bio: calls $0.25
i$BamboBlady$i: checks 
*** FLOP *** [5h Ac 2c]
Quotes-bio: checks 
i$BamboBlady$i: checks 
*** TURN *** [5h Ac 2c] [6s]
Quotes-bio: checks 
ANCTIL111 joins the table at seat #1 
i$BamboBlady$i: checks 
*** RIVER *** [5h Ac 2c 6s] [9s]
pl@netskii joins the table at seat #8 
Quotes-bio: checks 
i$BamboBlady$i: bets $0.50
Quotes-bio: folds 
Uncalled bet ($0.50) returned to i$BamboBlady$i
i$BamboBlady$i collected $0.94 from pot
i$BamboBlady$i: doesn't show hand 
*** SUMMARY ***
Total pot $1 | Rake $0.06 
Board [5h Ac 2c 6s 9s]
Seat 1: AceKingxx folded before Flop (didn't bet)
Seat 2: Rorerzap folded before Flop (didn't bet)
Seat 3: kars0n folded before Flop (didn't bet)
Seat 4: christyirish folded before Flop (didn't bet)
Seat 5: jantheman222 folded before Flop (didn't bet)
Seat 6: maisit* (button) folded before Flop (didn't bet)
Seat 7: Quotes-bio (small blind) folded on the River
Seat 9: i$BamboBlady$i (big blind) collected ($0.94)



PokerStars Hand #228697056823:  Hold'em No Limit ($0.25/$0.50 USD) - 2021/07/30 23:38:01 ET
Table 'Aitne III' 9-max Seat #3 is the button
Seat 1: ANCTIL111 ($25.25 in chips) 
Seat 2: Rorerzap ($106.22 in chips) 
Seat 3: kars0n ($59.44 in chips) 
Seat 4: christyirish ($106.85 in chips) 
Seat 5: jantheman222 ($115.27 in chips) 
Seat 6: maisit* ($53.42 in chips) 
Seat 7: Quotes-bio ($48.25 in chips) 
christyirish: posts small blind $0.25
jantheman222: posts big blind $0.50
pl@netskii: sits out 
*** HOLE CARDS ***
maisit*: folds 
Quotes-bio: folds 
ANCTIL111: folds 
Rorerzap: folds 
kars0n: raises $0.75 to $1.25
christyirish: folds 
jantheman222: folds 
Uncalled bet ($0.75) returned to kars0n
kars0n collected $1.25 from pot
*** SUMMARY ***
Total pot $1.25 | Rake $0 
Seat 1: ANCTIL111 folded before Flop (didn't bet)
Seat 2: Rorerzap folded before Flop (didn't bet)
Seat 3: kars0n (button) collected ($1.25)
Seat 4: christyirish (small blind) folded before Flop
Seat 5: jantheman222 (big blind) folded before Flop
Seat 6: maisit* folded before Flop (didn't bet)
Seat 7: Quotes-bio folded before Flop (didn't bet)



PokerStars Hand #228697059701:  Hold'em No Limit ($0.25/$0.50 USD) - 2021/07/30 23:38:16 ET
Table 'Aitne III' 9-max Seat #4 is the button
Seat 1: ANCTIL111 ($25.25 in chips) 
Seat 2: Rorerzap ($106.22 in chips) 
Seat 3: kars0n ($60.19 in chips) 
Seat 4: christyirish ($106.60 in chips) 
Seat 5: jantheman222 ($114.77 in chips) 
Seat 6: maisit* ($53.42 in chips) 
Seat 7: Quotes-bio ($48.25 in chips) 
Seat 9: i$BamboBlady$i ($40.26 in chips) 
jantheman222: posts small blind $0.25
maisit*: posts big blind $0.50
pl@netskii: sits out 
*** HOLE CARDS ***
Quotes-bio: folds 
i$BamboBlady$i: calls $0.50
ANCTIL111: folds 
Rorerzap: folds 
kars0n: folds 
christyirish: folds 
jantheman222: calls $0.25
maisit*: checks 
*** FLOP *** [As Qc Jd]
jantheman222: checks 
maisit*: checks 
i$BamboBlady$i: checks 
*** TURN *** [As Qc Jd] [Ad]
jantheman222: bets $0.50
maisit*: folds 
i$BamboBlady$i: calls $0.50
*** RIVER *** [As Qc Jd Ad] [Jc]
jantheman222: bets $2.98
i$BamboBlady$i: folds 
Uncalled bet ($2.98) returned to jantheman222
jantheman222 collected $2.38 from pot
jantheman222: doesn't show hand 
*** SUMMARY ***
Total pot $2.50 | Rake $0.12 
Board [As Qc Jd Ad Jc]
Seat 1: ANCTIL111 folded before Flop (didn't bet)
Seat 2: Rorerzap folded before Flop (didn't bet)
Seat 3: kars0n folded before Flop (didn't bet)
Seat 4: christyirish (button) folded before Flop (didn't bet)
Seat 5: jantheman222 (small blind) collected ($2.38)
Seat 6: maisit* (big blind) folded on the Turn
Seat 7: Quotes-bio folded before Flop (didn't bet)
Seat 9: i$BamboBlady$i folded on the River



PokerStars Hand #228697069166:  Hold'em No Limit ($0.25/$0.50 USD) - 2021/07/30 23:39:05 ET
Table 'Aitne III' 9-max Seat #5 is the button
Seat 1: ANCTIL111 ($25.25 in chips) 
Seat 2: Rorerzap ($106.22 in chips) 
Seat 3: kars0n ($60.19 in chips) 
Seat 4: christyirish ($106.60 in chips) 
Seat 5: jantheman222 ($116.15 in chips) 
Seat 6: maisit* ($52.92 in chips) 
Seat 8: pl@netskii ($50 in chips) 
Seat 9: i$BamboBlady$i ($39.26 in chips) 
maisit*: posts small blind $0.25
Quotes-bio: is sitting out 
pl@netskii: posts big blind $0.50
*** HOLE CARDS ***
i$BamboBlady$i: folds 
ANCTIL111: calls $0.50
Rorerzap: folds 
kars0n: raises $1.75 to $2.25
christyirish: folds 
jantheman222: folds 
maisit*: folds 
pl@netskii: folds 
ANCTIL111: calls $1.75
*** FLOP *** [5c Js 7h]
ANCTIL111: checks 
kars0n: bets $1.50
ANCTIL111: folds 
Uncalled bet ($1.50) returned to kars0n
kars0n collected $4.99 from pot
*** SUMMARY ***
Total pot $5.25 | Rake $0.26 
Board [5c Js 7h]
Seat 1: ANCTIL111 folded on the Flop
Seat 2: Rorerzap folded before Flop (didn't bet)
Seat 3: kars0n collected ($4.99)
Seat 4: christyirish folded before Flop (didn't bet)
Seat 5: jantheman222 (button) folded before Flop (didn't bet)
Seat 6: maisit* (small blind) folded before Flop
Seat 8: pl@netskii (big blind) folded before Flop
Seat 9: i$BamboBlady$i folded before Flop (didn't bet)



PokerStars Hand #228697083755:  Hold'em No Limit ($0.25/$0.50 USD) - 2021/07/30 23:39:45 ET
Table 'Aitne III' 9-max Seat #6 is the button
Seat 1: ANCTIL111 ($23 in chips) 
Seat 2: Rorerzap ($106.22 in chips) 
Seat 3: kars0n ($62.93 in chips) 
Seat 4: christyirish ($106.60 in chips) 
Seat 5: jantheman222 ($116.15 in chips) 
Seat 6: maisit* ($52.67 in chips) 
Seat 8: pl@netskii ($50 in chips) 
Seat 9: i$BamboBlady$i ($39.26 in chips) 
pl@netskii: posts small blind $0.25
i$BamboBlady$i: posts big blind $0.50
*** HOLE CARDS ***
ANCTIL111: raises $0.50 to $1
Rorerzap: folds 
kars0n: folds 
christyirish: folds 
jantheman222: folds 
maisit*: raises $2 to $3
pl@netskii: folds 
i$BamboBlady$i: calls $2.50
ANCTIL111: calls $2
*** FLOP *** [Jd 9c 2d]
i$BamboBlady$i: checks 
ANCTIL111: checks 
maisit*: bets $2.90
i$BamboBlady$i: calls $2.90
ANCTIL111: calls $2.90
*** TURN *** [Jd 9c 2d] [7h]
i$BamboBlady$i: bets $8.52
ANCTIL111: folds 
maisit*: folds 
Uncalled bet ($8.52) returned to i$BamboBlady$i
i$BamboBlady$i collected $16.83 from pot
i$BamboBlady$i: doesn't show hand 
*** SUMMARY ***
Total pot $17.95 | Rake $1.12 
Board [Jd 9c 2d 7h]
Seat 1: ANCTIL111 folded on the Turn
Seat 2: Rorerzap folded before Flop (didn't bet)
Seat 3: kars0n folded before Flop (didn't bet)
Seat 4: christyirish folded before Flop (didn't bet)
Seat 5: jantheman222 folded before Flop (didn't bet)
Seat 6: maisit* (button) folded on the Turn
Seat 8: pl@netskii (small blind) folded before Flop
Seat 9: i$BamboBlady$i (big blind) collected ($16.83)



PokerStars Hand #228697095731:  Hold'em No Limit ($0.25/$0.50 USD) - 2021/07/30 23:40:47 ET
Table 'Aitne III' 9-max Seat #8 is the button
Seat 1: ANCTIL111 ($17.10 in chips) 
Seat 2: Rorerzap ($106.22 in chips) 
Seat 3: kars0n ($62.93 in chips) 
Seat 4: christyirish ($106.60 in chips) 
Seat 5: jantheman222 ($116.15 in chips) 
Seat 6: maisit* ($50 in chips) 
Seat 8: pl@netskii ($50 in chips) 
Seat 9: i$BamboBlady$i ($50.19 in chips) 
i$BamboBlady$i: posts small blind $0.25
ANCTIL111: posts big blind $0.50
*** HOLE CARDS ***
Rorerzap: raises $1 to $1.50
kars0n: folds 
christyirish: folds 
jantheman222: folds 
maisit*: folds 
pl@netskii: folds 
i$BamboBlady$i: folds 
ANCTIL111: calls $1
*** FLOP *** [8d 9c 7d]
ANCTIL111: checks 
Rorerzap: checks 
*** TURN *** [8d 9c 7d] [3c]
ANCTIL111: checks 
Rorerzap: bets $1.50
ANCTIL111: folds 
Uncalled bet ($1.50) returned to Rorerzap
Rorerzap collected $3.09 from pot
Rorerzap: doesn't show hand 
*** SUMMARY ***
Total pot $3.25 | Rake $0.16 
Board [8d 9c 7d 3c]
Seat 1: ANCTIL111 (big blind) folded on the Turn
Seat 2: Rorerzap collected ($3.09)
Seat 3: kars0n folded before Flop (didn't bet)
Seat 4: christyirish folded before Flop (didn't bet)
Seat 5: jantheman222 folded before Flop (didn't bet)
Seat 6: maisit* folded before Flop (didn't bet)
Seat 8: pl@netskii (button) folded before Flop (didn't bet)
Seat 9: i$BamboBlady$i (small blind) folded before Flop



PokerStars Hand #228697101093:  Hold'em No Limit ($0.25/$0.50 USD) - 2021/07/30 23:41:15 ET
Table 'Aitne III' 9-max Seat #9 is the button
Seat 1: ANCTIL111 ($15.60 in chips) 
Seat 2: Rorerzap ($107.81 in chips) 
Seat 3: kars0n ($62.93 in chips) 
Seat 4: christyirish ($106.60 in chips) 
Seat 5: jantheman222 ($116.15 in chips) 
Seat 6: maisit* ($50 in chips) 
Seat 8: pl@netskii ($50 in chips) 
Seat 9: i$BamboBlady$i ($49.94 in chips) 
ANCTIL111: posts small blind $0.25
Rorerzap: posts big blind $0.50
*** HOLE CARDS ***
kars0n: folds 
christyirish: folds 
jantheman222: folds 
maisit*: folds 
pl@netskii: folds 
i$BamboBlady$i: raises $1 to $1.50
ANCTIL111: calls $1.25
Rorerzap: raises $5.50 to $7
i$BamboBlady$i: raises $10 to $17
ANCTIL111: folds 
Rorerzap: raises $90.81 to $107.81 and is all-in
i$BamboBlady$i: calls $32.94 and is all-in
Uncalled bet ($57.87) returned to Rorerzap
Rorerzap:  
i$BamboBlady$i:  
*** FLOP *** [As 3c 4c]
*** TURN *** [As 3c 4c] [Qs]
*** RIVER *** [As 3c 4c Qs] [Kh]
*** SHOW DOWN ***
Rorerzap: shows [Kd Ks] (three of a kind, Kings)
i$BamboBlady$i: shows [Ad Ac] (three of a kind, Aces)
i$BamboBlady$i collected $98.88 from pot
*** SUMMARY ***
Total pot $101.38 | Rake $2.50 
Board [As 3c 4c Qs Kh]
Seat 1: ANCTIL111 (small blind) folded before Flop
Seat 2: Rorerzap (big blind) showed [Kd Ks] and lost with three of a kind, Kings
Seat 3: kars0n folded before Flop (didn't bet)
Seat 4: christyirish folded before Flop (didn't bet)
Seat 5: jantheman222 folded before Flop (didn't bet)
Seat 6: maisit* folded before Flop (didn't bet)
Seat 8: pl@netskii folded before Flop (didn't bet)
Seat 9: i$BamboBlady$i (button) showed [Ad Ac] and won ($98.88) with three of a kind, Aces



PokerStars Hand #228697140989:  Hold'em No Limit ($0.25/$0.50 USD) - 2021/07/30 23:44:10 ET
Table 'Aitne III' 9-max Seat #3 is the button
Seat 1: ANCTIL111 ($29.83 in chips) 
Seat 2: Rorerzap ($57.62 in chips) 
Seat 3: kars0n ($61.93 in chips) 
Seat 4: christyirish ($110.68 in chips) 
Seat 5: jantheman222 ($126.71 in chips) 
Seat 6: maisit* ($50 in chips) 
Seat 8: pl@netskii ($50 in chips) 
Seat 9: i$BamboBlady$i ($96.93 in chips) 
christyirish: posts small blind $0.25
jantheman222: posts big blind $0.50
Quotes-bio: sits out 
*** HOLE CARDS ***
maisit*: folds 
pl@netskii: folds 
i$BamboBlady$i: calls $0.50
ANCTIL111: calls $0.50
Rorerzap: folds 
kars0n: folds 
christyirish: calls $0.25
jantheman222: checks 
*** FLOP *** [3s Qd 6d]
christyirish: checks 
jantheman222: checks 
i$BamboBlady$i: checks 
ANCTIL111: checks 
*** TURN *** [3s Qd 6d] [9s]
christyirish: checks 
jantheman222: checks 
i$BamboBlady$i: checks 
ANCTIL111: bets $1.90
christyirish: folds 
jantheman222: folds 
i$BamboBlady$i: folds 
Uncalled bet ($1.90) returned to ANCTIL111
ANCTIL111 collected $1.90 from pot
ANCTIL111: doesn't show hand 
*** SUMMARY ***
Total pot $2 | Rake $0.10 
Board [3s Qd 6d 9s]
Seat 1: ANCTIL111 collected ($1.90)
Seat 2: Rorerzap folded before Flop (didn't bet)
Seat 3: kars0n (button) folded before Flop (didn't bet)
Seat 4: christyirish (small blind) folded on the Turn
Seat 5: jantheman222 (big blind) folded on the Turn
Seat 6: maisit* folded before Flop (didn't bet)
Seat 8: pl@netskii folded before Flop (didn't bet)
Seat 9: i$BamboBlady$i folded on the Turn



PokerStars Hand #228697155492:  Hold'em No Limit ($0.25/$0.50 USD) - 2021/07/30 23:45:27 ET
Table 'Aitne III' 9-max Seat #4 is the button
Seat 1: ANCTIL111 ($31.23 in chips) 
Seat 2: Rorerzap ($57.62 in chips) 
Seat 3: kars0n ($61.93 in chips) 
Seat 4: christyirish ($110.18 in chips) 
Seat 5: jantheman222 ($126.21 in chips) 
Seat 6: maisit* ($50 in chips) 
Seat 8: pl@netskii ($50 in chips) 
jantheman222: posts small blind $0.25
maisit*: posts big blind $0.50
Quotes-bio: sits out 
*** HOLE CARDS ***
i$BamboBlady$i leaves the table
pl@netskii: folds 
ANCTIL111: raises $0.50 to $1
Rorerzap: folds 
kars0n: folds 
christyirish: folds 
jantheman222: folds 
SparkYLive joins the table at seat #9 
maisit*: folds 
Uncalled bet ($0.50) returned to ANCTIL111
ANCTIL111 collected $1.25 from pot
ANCTIL111: doesn't show hand 
SparkYLive leaves the table
*** SUMMARY ***
Total pot $1.25 | Rake $0 
Seat 1: ANCTIL111 collected ($1.25)
Seat 2: Rorerzap folded before Flop (didn't bet)
Seat 3: kars0n folded before Flop (didn't bet)
Seat 4: christyirish (button) folded before Flop (didn't bet)
Seat 5: jantheman222 (small blind) folded before Flop
Seat 6: maisit* (big blind) folded before Flop
Seat 8: pl@netskii folded before Flop (didn't bet)



PokerStars Hand #228697161134:  Hold'em No Limit ($0.25/$0.50 USD) - 2021/07/30 23:45:57 ET
Table 'Aitne III' 9-max Seat #5 is the button
Seat 1: ANCTIL111 ($31.98 in chips) 
Seat 2: Rorerzap ($57.62 in chips) 
Seat 3: kars0n ($61.93 in chips) 
Seat 4: christyirish ($110.18 in chips) 
Seat 5: jantheman222 ($125.96 in chips) 
Seat 6: maisit* ($50 in chips) 
Seat 7: Quotes-bio ($48.25 in chips) 
Seat 8: pl@netskii ($50 in chips) 
maisit*: posts small blind $0.25
Quotes-bio: posts big blind $0.50
*** HOLE CARDS ***
pl@netskii: raises $1 to $1.50
ANCTIL111: calls $1.50
Rorerzap: folds 
kars0n: folds 
christyirish: folds 
jantheman222: folds 
maisit*: calls $1.25
Quotes-bio: folds 
*** FLOP *** [Jd 5c Td]
maisit*: checks 
pl@netskii: checks 
ANCTIL111: bets $1.50
maisit*: calls $1.50
pl@netskii: folds 
*** TURN *** [Jd 5c Td] [3d]
maisit*: checks 
ANCTIL111: checks 
*** RIVER *** [Jd 5c Td 3d] [As]
maisit*: bets $4.50
ANCTIL111: folds 
Uncalled bet ($4.50) returned to maisit*
maisit* collected $7.60 from pot
maisit*: doesn't show hand 
*** SUMMARY ***
Total pot $8 | Rake $0.40 
Board [Jd 5c Td 3d As]
Seat 1: ANCTIL111 folded on the River
Seat 2: Rorerzap folded before Flop (didn't bet)
Seat 3: kars0n folded before Flop (didn't bet)
Seat 4: christyirish folded before Flop (didn't bet)
Seat 5: jantheman222 (button) folded before Flop (didn't bet)
Seat 6: maisit* (small blind) collected ($7.60)
Seat 7: Quotes-bio (big blind) folded before Flop
Seat 8: pl@netskii folded on the Flop



PokerStars Hand #228697172270:  Hold'em No Limit ($0.25/$0.50 USD) - 2021/07/30 23:46:57 ET
Table 'Aitne III' 9-max Seat #6 is the button
Seat 1: ANCTIL111 ($28.98 in chips) 
Seat 2: Rorerzap ($57.62 in chips) 
Seat 3: kars0n ($61.93 in chips) 
Seat 4: christyirish ($110.18 in chips) 
Seat 5: jantheman222 ($125.96 in chips) 
Seat 6: maisit* ($54.60 in chips) 
Seat 7: Quotes-bio ($47.75 in chips) 
Quotes-bio: posts small blind $0.25
pl@netskii: is sitting out 
ANCTIL111: posts big blind $0.50
*** HOLE CARDS ***
Rorerzap: raises $1 to $1.50
kars0n: folds 
christyirish: folds 
jantheman222: folds 
maisit* has timed out
maisit*: folds 
Quotes-bio: folds 
ANCTIL111: calls $1
*** FLOP *** [5d 6d 7d]
ANCTIL111: bets $3.09
Rorerzap: folds 
Uncalled bet ($3.09) returned to ANCTIL111
ANCTIL111 collected $3.09 from pot
ANCTIL111: doesn't show hand 
*** SUMMARY ***
Total pot $3.25 | Rake $0.16 
Board [5d 6d 7d]
Seat 1: ANCTIL111 (big blind) collected ($3.09)
Seat 2: Rorerzap folded on the Flop
Seat 3: kars0n folded before Flop (didn't bet)
Seat 4: christyirish folded before Flop (didn't bet)
Seat 5: jantheman222 folded before Flop (didn't bet)
Seat 6: maisit* (button) folded before Flop (didn't bet)
Seat 7: Quotes-bio (small blind) folded before Flop



PokerStars Hand #228697178726:  Hold'em No Limit ($0.25/$0.50 USD) - 2021/07/30 23:47:30 ET
Table 'Aitne III' 9-max Seat #7 is the button
Seat 1: ANCTIL111 ($30.57 in chips) 
Seat 2: Rorerzap ($56.12 in chips) 
Seat 3: kars0n ($61.93 in chips) 
Seat 4: christyirish ($110.18 in chips) 
Seat 5: jantheman222 ($125.96 in chips) 
Seat 7: Quotes-bio ($47.50 in chips) 
ANCTIL111: posts small blind $0.25
Rorerzap: posts big blind $0.50
*** HOLE CARDS ***
kars0n: folds 
christyirish: folds 
jantheman222: folds 
Quotes-bio: folds 
ANCTIL111: calls $0.25
Rorerzap: raises $2 to $2.50
ANCTIL111: calls $2
*** FLOP *** [7d 5c 5s]
ANCTIL111: checks 
Rorerzap: bets $2.50
ANCTIL111: folds 
Uncalled bet ($2.50) returned to Rorerzap
Rorerzap collected $4.75 from pot
Rorerzap: doesn't show hand 
*** SUMMARY ***
Total pot $5 | Rake $0.25 
Board [7d 5c 5s]
Seat 1: ANCTIL111 (small blind) folded on the Flop
Seat 2: Rorerzap (big blind) collected ($4.75)
Seat 3: kars0n folded before Flop (didn't bet)
Seat 4: christyirish folded before Flop (didn't bet)
Seat 5: jantheman222 folded before Flop (didn't bet)
Seat 7: Quotes-bio (button) folded before Flop (didn't bet)



PokerStars Hand #228697183349:  Hold'em No Limit ($0.25/$0.50 USD) - 2021/07/30 23:47:55 ET
Table 'Aitne III' 9-max Seat #1 is the button
Seat 1: ANCTIL111 ($28.07 in chips) 
Seat 2: Rorerzap ($58.37 in chips) 
Seat 3: kars0n ($61.93 in chips) 
Seat 4: christyirish ($110.18 in chips) 
Seat 5: jantheman222 ($125.96 in chips) 
Seat 6: maisit* ($54.60 in chips) 
Seat 7: Quotes-bio ($47.50 in chips) 
Rorerzap: posts small blind $0.25
kars0n: posts big blind $0.50
*** HOLE CARDS ***
christyirish: folds 
jantheman222: raises $0.75 to $1.25
maisit*: folds 
Quotes-bio: folds 
ANCTIL111: folds 
Rorerzap: folds 
kars0n: folds 
Uncalled bet ($0.75) returned to jantheman222
jantheman222 collected $1.25 from pot
jantheman222: doesn't show hand 
*** SUMMARY ***
Total pot $1.25 | Rake $0 
Seat 1: ANCTIL111 (button) folded before Flop (didn't bet)
Seat 2: Rorerzap (small blind) folded before Flop
Seat 3: kars0n (big blind) folded before Flop
Seat 4: christyirish folded before Flop (didn't bet)
Seat 5: jantheman222 collected ($1.25)
Seat 6: maisit* folded before Flop (didn't bet)
Seat 7: Quotes-bio folded before Flop (didn't bet)



PokerStars Hand #228697187389:  Hold'em No Limit ($0.25/$0.50 USD) - 2021/07/30 23:48:17 ET
Table 'Aitne III' 9-max Seat #2 is the button
Seat 1: ANCTIL111 ($28.07 in chips) 
Seat 2: Rorerzap ($58.12 in chips) 
Seat 3: kars0n ($61.43 in chips) 
Seat 4: christyirish ($110.18 in chips) 
Seat 5: jantheman222 ($126.71 in chips) 
Seat 6: maisit* ($54.60 in chips) 
Seat 7: Quotes-bio ($47.50 in chips) 
kars0n: posts small blind $0.25
christyirish: posts big blind $0.50
*** HOLE CARDS ***
jantheman222: folds 
maisit*: folds 
Quotes-bio: folds 
ANCTIL111: folds 
Rorerzap: folds 
kars0n: raises $1 to $1.50
christyirish: folds 
Uncalled bet ($1) returned to kars0n
kars0n collected $1 from pot
*** SUMMARY ***
Total pot $1 | Rake $0 
Seat 1: ANCTIL111 folded before Flop (didn't bet)
Seat 2: Rorerzap (button) folded before Flop (didn't bet)
Seat 3: kars0n (small blind) collected ($1)
Seat 4: christyirish (big blind) folded before Flop
Seat 5: jantheman222 folded before Flop (didn't bet)
Seat 6: maisit* folded before Flop (didn't bet)
Seat 7: Quotes-bio folded before Flop (didn't bet)



PokerStars Hand #228697190709:  Hold'em No Limit ($0.25/$0.50 USD) - 2021/07/30 23:48:35 ET
Table 'Aitne III' 9-max Seat #3 is the button
Seat 1: ANCTIL111 ($28.07 in chips) 
Seat 2: Rorerzap ($58.12 in chips) 
Seat 3: kars0n ($61.93 in chips) 
Seat 4: christyirish ($109.68 in chips) 
Seat 5: jantheman222 ($126.71 in chips) 
Seat 6: maisit* ($54.60 in chips) 
Seat 7: Quotes-bio ($47.50 in chips) 
christyirish: posts small blind $0.25
jantheman222: posts big blind $0.50
*** HOLE CARDS ***
maisit*: folds 
Quotes-bio: folds 
ANCTIL111: folds 
Rorerzap: folds 
kars0n: folds 
christyirish: folds 
Uncalled bet ($0.25) returned to jantheman222
jantheman222 collected $0.50 from pot
jantheman222: doesn't show hand 
*** SUMMARY ***
Total pot $0.50 | Rake $0 
Seat 1: ANCTIL111 folded before Flop (didn't bet)
Seat 2: Rorerzap folded before Flop (didn't bet)
Seat 3: kars0n (button) folded before Flop (didn't bet)
Seat 4: christyirish (small blind) folded before Flop
Seat 5: jantheman222 (big blind) collected ($0.50)
Seat 6: maisit* folded before Flop (didn't bet)
Seat 7: Quotes-bio folded before Flop (didn't bet)



PokerStars Hand #228697193345:  Hold'em No Limit ($0.25/$0.50 USD) - 2021/07/30 23:48:49 ET
Table 'Aitne III' 9-max Seat #4 is the button
Seat 1: ANCTIL111 ($28.07 in chips) 
Seat 2: Rorerzap ($58.12 in chips) 
Seat 3: kars0n ($61.93 in chips) 
Seat 4: christyirish ($109.43 in chips) 
Seat 5: jantheman222 ($126.96 in chips) 
Seat 6: maisit* ($54.60 in chips) 
Seat 7: Quotes-bio ($47.50 in chips) 
jantheman222: posts small blind $0.25
maisit*: posts big blind $0.50
*** HOLE CARDS ***
Quotes-bio: folds 
ANCTIL111: folds 
Rorerzap: folds 
kars0n: folds 
christyirish: raises $1 to $1.50
jantheman222: folds 
maisit*: folds 
Uncalled bet ($1) returned to christyirish
christyirish collected $1.25 from pot
*** SUMMARY ***
Total pot $1.25 | Rake $0 
Seat 1: ANCTIL111 folded before Flop (didn't bet)
Seat 2: Rorerzap folded before Flop (didn't bet)
Seat 3: kars0n folded before Flop (didn't bet)
Seat 4: christyirish (button) collected ($1.25)
Seat 5: jantheman222 (small blind) folded before Flop
Seat 6: maisit* (big blind) folded before Flop
Seat 7: Quotes-bio folded before Flop (didn't bet)



PokerStars Hand #228697197325:  Hold'em No Limit ($0.25/$0.50 USD) - 2021/07/30 23:49:10 ET
Table 'Aitne III' 9-max Seat #5 is the button
Seat 1: ANCTIL111 ($28.07 in chips) 
Seat 2: Rorerzap ($58.12 in chips) 
Seat 3: kars0n ($61.93 in chips) 
Seat 4: christyirish ($110.18 in chips) 
Seat 5: jantheman222 ($126.71 in chips) 
Seat 6: maisit* ($54.10 in chips) 
Seat 7: Quotes-bio ($47.50 in chips) 
maisit*: posts small blind $0.25
Quotes-bio: posts big blind $0.50
*** HOLE CARDS ***
ANCTIL111: raises $3 to $3.50
Rorerzap: folds 
kars0n: folds 
christyirish: folds 
jantheman222: folds 
maisit*: folds 
Quotes-bio: folds 
Uncalled bet ($3) returned to ANCTIL111
ANCTIL111 collected $1.25 from pot
ANCTIL111: doesn't show hand 
*** SUMMARY ***
Total pot $1.25 | Rake $0 
Seat 1: ANCTIL111 collected ($1.25)
Seat 2: Rorerzap folded before Flop (didn't bet)
Seat 3: kars0n folded before Flop (didn't bet)
Seat 4: christyirish folded before Flop (didn't bet)
Seat 5: jantheman222 (button) folded before Flop (didn't bet)
Seat 6: maisit* (small blind) folded before Flop
Seat 7: Quotes-bio (big blind) folded before Flop



PokerStars Hand #228697202305:  Hold'em No Limit ($0.25/$0.50 USD) - 2021/07/30 23:49:37 ET
Table 'Aitne III' 9-max Seat #6 is the button
Seat 1: ANCTIL111 ($28.82 in chips) 
Seat 2: Rorerzap ($58.12 in chips) 
Seat 3: kars0n ($61.93 in chips) 
Seat 4: christyirish ($110.18 in chips) 
Seat 5: jantheman222 ($126.71 in chips) 
Seat 6: maisit* ($53.85 in chips) 
Seat 7: Quotes-bio ($47 in chips) 
Quotes-bio: posts small blind $0.25
ANCTIL111: posts big blind $0.50
*** HOLE CARDS ***
Rorerzap: folds 
kars0n: raises $1 to $1.50
christyirish: folds 
jantheman222: folds 
maisit*: folds 
Quotes-bio: folds 
takakensu joins the table at seat #9 
ANCTIL111: folds 
Uncalled bet ($1) returned to kars0n
kars0n collected $1.25 from pot
*** SUMMARY ***
Total pot $1.25 | Rake $0 
Seat 1: ANCTIL111 (big blind) folded before Flop
Seat 2: Rorerzap folded before Flop (didn't bet)
Seat 3: kars0n collected ($1.25)
Seat 4: christyirish folded before Flop (didn't bet)
Seat 5: jantheman222 folded before Flop (didn't bet)
Seat 6: maisit* (button) folded before Flop (didn't bet)
Seat 7: Quotes-bio (small blind) folded before Flop



PokerStars Hand #228697204205:  Hold'em No Limit ($0.25/$0.50 USD) - 2021/07/30 23:49:47 ET
Table 'Aitne III' 9-max Seat #7 is the button
Seat 1: ANCTIL111 ($28.32 in chips) 
Seat 2: Rorerzap ($58.12 in chips) 
Seat 3: kars0n ($62.68 in chips) 
Seat 4: christyirish ($110.18 in chips) 
Seat 5: jantheman222 ($126.71 in chips) 
Seat 6: maisit* ($53.85 in chips) 
Seat 7: Quotes-bio ($46.75 in chips) 
ANCTIL111: posts small blind $0.25
Rorerzap: posts big blind $0.50
*** HOLE CARDS ***
kars0n: folds 
christyirish: folds 
jantheman222: folds 
maisit*: raises $1 to $1.50
Quotes-bio: folds 
ANCTIL111: folds 
Rorerzap: raises $3.50 to $5
maisit*: calls $3.50
*** FLOP *** [As 7s Js]
Rorerzap: bets $3
maisit*: folds 
Uncalled bet ($3) returned to Rorerzap
Rorerzap collected $9.74 from pot
Rorerzap: doesn't show hand 
*** SUMMARY ***
Total pot $10.25 | Rake $0.51 
Board [As 7s Js]
Seat 1: ANCTIL111 (small blind) folded before Flop
Seat 2: Rorerzap (big blind) collected ($9.74)
Seat 3: kars0n folded before Flop (didn't bet)
Seat 4: christyirish folded before Flop (didn't bet)
Seat 5: jantheman222 folded before Flop (didn't bet)
Seat 6: maisit* folded on the Flop
Seat 7: Quotes-bio (button) folded before Flop (didn't bet)



