PokerStars Hand #228688384601:  Hold'em No Limit ($0.25/$0.50 USD) - 2021/07/30 16:23:32 ET
Table 'Knysna II' 9-max Seat #9 is the button
Seat 2: RRBAGGIO77 ($108.27 in chips) 
Seat 3: $lavik88 ($76.99 in chips) 
Seat 4: lulu19911991 ($60.02 in chips) 
Seat 5: artemxxl ($50 in chips) 
Seat 6: An1an1 ($50 in chips) 
Seat 7: dikanmax ($50 in chips) 
Seat 8: danthaur ($52.02 in chips) 
Seat 9: PleBeY95 ($64.85 in chips) 
RRBAGGIO77: posts small blind $0.25
$lavik88: posts big blind $0.50
*** HOLE CARDS ***
lulu19911991: folds 
artemxxl: folds 
An1an1: folds 
dikanmax: folds 
danthaur: folds 
PleBeY95: raises $0.75 to $1.25
RRBAGGIO77: folds 
$lavik88: folds 
Uncalled bet ($0.75) returned to PleBeY95
PleBeY95 collected $1.25 from pot
*** SUMMARY ***
Total pot $1.25 | Rake $0 
Seat 2: RRBAGGIO77 (small blind) folded before Flop
Seat 3: $lavik88 (big blind) folded before Flop
Seat 4: lulu19911991 folded before Flop (didn't bet)
Seat 5: artemxxl folded before Flop (didn't bet)
Seat 6: An1an1 folded before Flop (didn't bet)
Seat 7: dikanmax folded before Flop (didn't bet)
Seat 8: danthaur folded before Flop (didn't bet)
Seat 9: PleBeY95 (button) collected ($1.25)



PokerStars Hand #228688397896:  Hold'em No Limit ($0.25/$0.50 USD) - 2021/07/30 16:23:59 ET
Table 'Knysna II' 9-max Seat #2 is the button
Seat 2: RRBAGGIO77 ($108.02 in chips) 
Seat 3: $lavik88 ($76.49 in chips) 
Seat 4: lulu19911991 ($60.02 in chips) 
Seat 5: artemxxl ($50 in chips) 
Seat 6: An1an1 ($50 in chips) 
Seat 7: dikanmax ($50 in chips) 
Seat 8: danthaur ($52.02 in chips) 
Seat 9: PleBeY95 ($65.60 in chips) 
$lavik88: posts small blind $0.25
lulu19911991: posts big blind $0.50
*** HOLE CARDS ***
artemxxl: folds 
An1an1: folds 
dikanmax: folds 
danthaur: folds 
PleBeY95: folds 
RRBAGGIO77: folds 
$lavik88: raises $1 to $1.50
lulu19911991: calls $1
*** FLOP *** [2c 8c 3c]
$lavik88: checks 
lulu19911991: checks 
*** TURN *** [2c 8c 3c] [6d]
$lavik88: checks 
lulu19911991: bets $1.91
$lavik88: folds 
Uncalled bet ($1.91) returned to lulu19911991
lulu19911991 collected $2.85 from pot
lulu19911991: doesn't show hand 
*** SUMMARY ***
Total pot $3 | Rake $0.15 
Board [2c 8c 3c 6d]
Seat 2: RRBAGGIO77 (button) folded before Flop (didn't bet)
Seat 3: $lavik88 (small blind) folded on the Turn
Seat 4: lulu19911991 (big blind) collected ($2.85)
Seat 5: artemxxl folded before Flop (didn't bet)
Seat 6: An1an1 folded before Flop (didn't bet)
Seat 7: dikanmax folded before Flop (didn't bet)
Seat 8: danthaur folded before Flop (didn't bet)
Seat 9: PleBeY95 folded before Flop (didn't bet)



PokerStars Hand #228688434008:  Hold'em No Limit ($0.25/$0.50 USD) - 2021/07/30 16:25:13 ET
Table 'Knysna II' 9-max Seat #3 is the button
Seat 1: FrankDuxe1 ($22.48 in chips) 
Seat 2: RRBAGGIO77 ($108.02 in chips) 
Seat 3: $lavik88 ($74.99 in chips) 
Seat 4: lulu19911991 ($61.37 in chips) 
Seat 5: artemxxl ($50 in chips) 
Seat 6: An1an1 ($50 in chips) 
Seat 7: dikanmax ($50 in chips) 
Seat 8: danthaur ($52.02 in chips) 
Seat 9: PleBeY95 ($65.60 in chips) 
lulu19911991: posts small blind $0.25
artemxxl: posts big blind $0.50
FrankDuxe1: posts small blind $0.25
*** HOLE CARDS ***
An1an1: folds 
dikanmax: folds 
danthaur: folds 
PleBeY95: folds 
FrankDuxe1: raises $1 to $1.50
RRBAGGIO77: calls $1.50
$lavik88: raises $4.50 to $6
lulu19911991: folds 
artemxxl: folds 
FrankDuxe1: calls $4.50
RRBAGGIO77: folds 
*** FLOP *** [Ks Qc 7h]
FrankDuxe1: checks 
$lavik88: bets $4.13
FrankDuxe1: calls $4.13
*** TURN *** [Ks Qc 7h] [6d]
FrankDuxe1: checks 
$lavik88: checks 
*** RIVER *** [Ks Qc 7h 6d] [Ah]
FrankDuxe1: checks 
$lavik88: bets $12.50
FrankDuxe1: folds 
Uncalled bet ($12.50) returned to $lavik88
$lavik88 collected $21.62 from pot
$lavik88: doesn't show hand 
*** SUMMARY ***
Total pot $22.76 | Rake $1.14 
Board [Ks Qc 7h 6d Ah]
Seat 1: FrankDuxe1 folded on the River
Seat 2: RRBAGGIO77 folded before Flop
Seat 3: $lavik88 (button) collected ($21.62)
Seat 4: lulu19911991 (small blind) folded before Flop
Seat 5: artemxxl (big blind) folded before Flop
Seat 6: An1an1 folded before Flop (didn't bet)
Seat 7: dikanmax folded before Flop (didn't bet)
Seat 8: danthaur folded before Flop (didn't bet)
Seat 9: PleBeY95 folded before Flop (didn't bet)



PokerStars Hand #228688461845:  Hold'em No Limit ($0.25/$0.50 USD) - 2021/07/30 16:26:11 ET
Table 'Knysna II' 9-max Seat #4 is the button
Seat 1: FrankDuxe1 ($12.10 in chips) 
Seat 2: RRBAGGIO77 ($106.52 in chips) 
Seat 3: $lavik88 ($86.48 in chips) 
Seat 4: lulu19911991 ($61.12 in chips) 
Seat 5: artemxxl ($50 in chips) 
Seat 6: An1an1 ($50 in chips) 
Seat 7: dikanmax ($50 in chips) 
Seat 8: danthaur ($52.02 in chips) 
Seat 9: PleBeY95 ($65.60 in chips) 
artemxxl: posts small blind $0.25
An1an1: posts big blind $0.50
*** HOLE CARDS ***
dikanmax: folds 
danthaur: raises $1 to $1.50
PleBeY95: folds 
FrankDuxe1: calls $1.50
RRBAGGIO77: folds 
$lavik88: folds 
lulu19911991: folds 
artemxxl: raises $5.75 to $7.25
An1an1: folds 
danthaur: folds 
FrankDuxe1: folds 
Uncalled bet ($5.75) returned to artemxxl
artemxxl collected $5 from pot
*** SUMMARY ***
Total pot $5 | Rake $0 
Seat 1: FrankDuxe1 folded before Flop
Seat 2: RRBAGGIO77 folded before Flop (didn't bet)
Seat 3: $lavik88 folded before Flop (didn't bet)
Seat 4: lulu19911991 (button) folded before Flop (didn't bet)
Seat 5: artemxxl (small blind) collected ($5)
Seat 6: An1an1 (big blind) folded before Flop
Seat 7: dikanmax folded before Flop (didn't bet)
Seat 8: danthaur folded before Flop
Seat 9: PleBeY95 folded before Flop (didn't bet)



PokerStars Hand #228688474835:  Hold'em No Limit ($0.25/$0.50 USD) - 2021/07/30 16:26:38 ET
Table 'Knysna II' 9-max Seat #5 is the button
Seat 1: FrankDuxe1 ($10.60 in chips) 
Seat 2: RRBAGGIO77 ($106.52 in chips) 
Seat 3: $lavik88 ($86.48 in chips) 
Seat 4: lulu19911991 ($61.12 in chips) 
Seat 5: artemxxl ($53.50 in chips) 
Seat 6: An1an1 ($50 in chips) 
Seat 7: dikanmax ($50 in chips) 
Seat 8: danthaur ($50.52 in chips) 
Seat 9: PleBeY95 ($65.60 in chips) 
An1an1: posts small blind $0.25
dikanmax: posts big blind $0.50
*** HOLE CARDS ***
danthaur: folds 
PleBeY95: folds 
FrankDuxe1: raises $1.50 to $2
RRBAGGIO77: calls $2
$lavik88: folds 
lulu19911991: folds 
artemxxl has timed out
artemxxl: folds 
An1an1: folds 
dikanmax: raises $6.50 to $8.50
FrankDuxe1: calls $6.50
RRBAGGIO77: folds 
*** FLOP *** [Kc 7c 3h]
dikanmax: bets $4.57
FrankDuxe1: calls $2.10 and is all-in
Uncalled bet ($2.47) returned to dikanmax
dikanmax:  
FrankDuxe1:  
*** TURN *** [Kc 7c 3h] [4c]
*** RIVER *** [Kc 7c 3h 4c] [4h]
*** SHOW DOWN ***
dikanmax: shows [Qd Ah] (a pair of Fours)
FrankDuxe1: shows [Td Kh] (two pair, Kings and Fours)
FrankDuxe1 collected $22.28 from pot
*** SUMMARY ***
Total pot $23.45 | Rake $1.17 
Board [Kc 7c 3h 4c 4h]
Seat 1: FrankDuxe1 showed [Td Kh] and won ($22.28) with two pair, Kings and Fours
Seat 2: RRBAGGIO77 folded before Flop
Seat 3: $lavik88 folded before Flop (didn't bet)
Seat 4: lulu19911991 folded before Flop (didn't bet)
Seat 5: artemxxl (button) folded before Flop (didn't bet)
Seat 6: An1an1 (small blind) folded before Flop
Seat 7: dikanmax (big blind) showed [Qd Ah] and lost with a pair of Fours
Seat 8: danthaur folded before Flop (didn't bet)
Seat 9: PleBeY95 folded before Flop (didn't bet)



PokerStars Hand #228688512108:  Hold'em No Limit ($0.25/$0.50 USD) - 2021/07/30 16:27:55 ET
Table 'Knysna II' 9-max Seat #6 is the button
Seat 1: FrankDuxe1 ($22.28 in chips) 
Seat 2: RRBAGGIO77 ($104.52 in chips) 
Seat 3: $lavik88 ($86.48 in chips) 
Seat 4: lulu19911991 ($61.12 in chips) 
Seat 6: An1an1 ($50 in chips) 
Seat 7: dikanmax ($50 in chips) 
Seat 8: danthaur ($50.52 in chips) 
Seat 9: PleBeY95 ($65.60 in chips) 
dikanmax: posts small blind $0.25
danthaur: posts big blind $0.50
*** HOLE CARDS ***
PleBeY95: raises $1 to $1.50
FrankDuxe1: calls $1.50
RRBAGGIO77: folds 
$lavik88: folds 
lulu19911991: calls $1.50
An1an1: folds 
dikanmax: folds 
danthaur: calls $1
*** FLOP *** [9c Jh Kd]
danthaur: checks 
PleBeY95: checks 
FrankDuxe1: bets $4
lulu19911991: folds 
danthaur: folds 
PleBeY95: folds 
Uncalled bet ($4) returned to FrankDuxe1
FrankDuxe1 collected $5.94 from pot
*** SUMMARY ***
Total pot $6.25 | Rake $0.31 
Board [9c Jh Kd]
Seat 1: FrankDuxe1 collected ($5.94)
Seat 2: RRBAGGIO77 folded before Flop (didn't bet)
Seat 3: $lavik88 folded before Flop (didn't bet)
Seat 4: lulu19911991 folded on the Flop
Seat 6: An1an1 (button) folded before Flop (didn't bet)
Seat 7: dikanmax (small blind) folded before Flop
Seat 8: danthaur (big blind) folded on the Flop
Seat 9: PleBeY95 folded on the Flop



PokerStars Hand #228688534413:  Hold'em No Limit ($0.25/$0.50 USD) - 2021/07/30 16:28:42 ET
Table 'Knysna II' 9-max Seat #7 is the button
Seat 1: FrankDuxe1 ($26.72 in chips) 
Seat 2: RRBAGGIO77 ($104.52 in chips) 
Seat 3: $lavik88 ($86.48 in chips) 
Seat 4: lulu19911991 ($59.62 in chips) 
Seat 6: An1an1 ($50 in chips) 
Seat 7: dikanmax ($50 in chips) 
Seat 8: danthaur ($50 in chips) 
Seat 9: PleBeY95 ($64.10 in chips) 
danthaur: posts small blind $0.25
PleBeY95: posts big blind $0.50
*** HOLE CARDS ***
FrankDuxe1: calls $0.50
RRBAGGIO77: folds 
$lavik88: folds 
lulu19911991: raises $1.70 to $2.20
An1an1: folds 
dikanmax: folds 
danthaur: folds 
PleBeY95: folds 
FrankDuxe1: calls $1.70
*** FLOP *** [8h 5s 4s]
FrankDuxe1: checks 
lulu19911991: checks 
*** TURN *** [8h 5s 4s] [As]
FrankDuxe1: bets $3
lulu19911991: calls $3
*** RIVER *** [8h 5s 4s As] [6h]
FrankDuxe1: checks 
lulu19911991: checks 
*** SHOW DOWN ***
FrankDuxe1: shows [Qh Td] (high card Ace)
lulu19911991: shows [Ac Ks] (a pair of Aces)
lulu19911991 collected $10.59 from pot
*** SUMMARY ***
Total pot $11.15 | Rake $0.56 
Board [8h 5s 4s As 6h]
Seat 1: FrankDuxe1 showed [Qh Td] and lost with high card Ace
Seat 2: RRBAGGIO77 folded before Flop (didn't bet)
Seat 3: $lavik88 folded before Flop (didn't bet)
Seat 4: lulu19911991 showed [Ac Ks] and won ($10.59) with a pair of Aces
Seat 6: An1an1 folded before Flop (didn't bet)
Seat 7: dikanmax (button) folded before Flop (didn't bet)
Seat 8: danthaur (small blind) folded before Flop
Seat 9: PleBeY95 (big blind) folded before Flop



PokerStars Hand #228688704847:  Hold'em No Limit ($0.25/$0.50 USD) - 2021/07/30 16:34:30 ET
Table 'Knysna II' 9-max Seat #9 is the button
Seat 1: FrankDuxe1 ($30.13 in chips) 
Seat 2: RRBAGGIO77 ($46.27 in chips) 
Seat 3: $lavik88 ($84.53 in chips) 
Seat 4: lulu19911991 ($66.21 in chips) 
Seat 6: An1an1 ($50 in chips) 
Seat 7: dikanmax ($101.50 in chips) 
Seat 8: danthaur ($50.50 in chips) 
Seat 9: PleBeY95 ($61.85 in chips) 
FrankDuxe1: posts small blind $0.25
RRBAGGIO77: posts big blind $0.50
artemxxl: sits out 
*** HOLE CARDS ***
$lavik88: raises $1 to $1.50
lulu19911991: folds 
An1an1: folds 
dikanmax: folds 
danthaur: folds 
PleBeY95: folds 
FrankDuxe1: calls $1.25
RRBAGGIO77: calls $1
*** FLOP *** [6d 6c 2h]
FrankDuxe1: checks 
RRBAGGIO77: checks 
$lavik88: bets $2.35
FrankDuxe1: calls $2.35
RRBAGGIO77: folds 
*** TURN *** [6d 6c 2h] [Kh]
FrankDuxe1: checks 
$lavik88: checks 
*** RIVER *** [6d 6c 2h Kh] [6h]
FrankDuxe1: bets $4.50
$lavik88: calls $4.50
*** SHOW DOWN ***
FrankDuxe1: shows [7s As] (three of a kind, Sixes)
$lavik88: shows [Qh Qs] (a full house, Sixes full of Queens)
$lavik88 collected $17.29 from pot
*** SUMMARY ***
Total pot $18.20 | Rake $0.91 
Board [6d 6c 2h Kh 6h]
Seat 1: FrankDuxe1 (small blind) showed [7s As] and lost with three of a kind, Sixes
Seat 2: RRBAGGIO77 (big blind) folded on the Flop
Seat 3: $lavik88 showed [Qh Qs] and won ($17.29) with a full house, Sixes full of Queens
Seat 4: lulu19911991 folded before Flop (didn't bet)
Seat 6: An1an1 folded before Flop (didn't bet)
Seat 7: dikanmax folded before Flop (didn't bet)
Seat 8: danthaur folded before Flop (didn't bet)
Seat 9: PleBeY95 (button) folded before Flop (didn't bet)



PokerStars Hand #228688725577:  Hold'em No Limit ($0.25/$0.50 USD) - 2021/07/30 16:35:14 ET
Table 'Knysna II' 9-max Seat #1 is the button
Seat 1: FrankDuxe1 ($21.78 in chips) 
Seat 2: RRBAGGIO77 ($44.77 in chips) 
Seat 3: $lavik88 ($93.47 in chips) 
Seat 4: lulu19911991 ($66.21 in chips) 
Seat 6: An1an1 ($50 in chips) 
Seat 7: dikanmax ($101.50 in chips) 
Seat 8: danthaur ($50.50 in chips) 
Seat 9: PleBeY95 ($61.85 in chips) 
RRBAGGIO77: posts small blind $0.25
$lavik88: posts big blind $0.50
artemxxl: sits out 
*** HOLE CARDS ***
lulu19911991: raises $0.98 to $1.48
An1an1: folds 
dikanmax: folds 
danthaur: folds 
PleBeY95: folds 
FrankDuxe1: folds 
RRBAGGIO77: folds 
$lavik88: folds 
Uncalled bet ($0.98) returned to lulu19911991
lulu19911991 collected $1.25 from pot
lulu19911991: doesn't show hand 
*** SUMMARY ***
Total pot $1.25 | Rake $0 
Seat 1: FrankDuxe1 (button) folded before Flop (didn't bet)
Seat 2: RRBAGGIO77 (small blind) folded before Flop
Seat 3: $lavik88 (big blind) folded before Flop
Seat 4: lulu19911991 collected ($1.25)
Seat 6: An1an1 folded before Flop (didn't bet)
Seat 7: dikanmax folded before Flop (didn't bet)
Seat 8: danthaur folded before Flop (didn't bet)
Seat 9: PleBeY95 folded before Flop (didn't bet)



PokerStars Hand #228688734678:  Hold'em No Limit ($0.25/$0.50 USD) - 2021/07/30 16:35:33 ET
Table 'Knysna II' 9-max Seat #2 is the button
Seat 1: FrankDuxe1 ($21.78 in chips) 
Seat 2: RRBAGGIO77 ($44.52 in chips) 
Seat 3: $lavik88 ($92.97 in chips) 
Seat 4: lulu19911991 ($66.96 in chips) 
Seat 6: An1an1 ($50 in chips) 
Seat 7: dikanmax ($101.50 in chips) 
Seat 8: danthaur ($50.50 in chips) 
Seat 9: PleBeY95 ($61.85 in chips) 
$lavik88: posts small blind $0.25
lulu19911991: posts big blind $0.50
artemxxl: sits out 
*** HOLE CARDS ***
An1an1: folds 
dikanmax: folds 
danthaur: raises $1 to $1.50
PleBeY95: folds 
FrankDuxe1: folds 
RRBAGGIO77: folds 
$lavik88: raises $4 to $5.50
lulu19911991: folds 
danthaur: folds 
Uncalled bet ($4) returned to $lavik88
$lavik88 collected $3.50 from pot
$lavik88: doesn't show hand 
*** SUMMARY ***
Total pot $3.50 | Rake $0 
Seat 1: FrankDuxe1 folded before Flop (didn't bet)
Seat 2: RRBAGGIO77 (button) folded before Flop (didn't bet)
Seat 3: $lavik88 (small blind) collected ($3.50)
Seat 4: lulu19911991 (big blind) folded before Flop
Seat 6: An1an1 folded before Flop (didn't bet)
Seat 7: dikanmax folded before Flop (didn't bet)
Seat 8: danthaur folded before Flop
Seat 9: PleBeY95 folded before Flop (didn't bet)



PokerStars Hand #228688747193:  Hold'em No Limit ($0.25/$0.50 USD) - 2021/07/30 16:35:59 ET
Table 'Knysna II' 9-max Seat #3 is the button
Seat 2: RRBAGGIO77 ($44.52 in chips) 
Seat 3: $lavik88 ($94.97 in chips) 
Seat 4: lulu19911991 ($66.46 in chips) 
Seat 5: artemxxl ($53.50 in chips) 
Seat 6: An1an1 ($50 in chips) 
Seat 7: dikanmax ($101.50 in chips) 
Seat 8: danthaur ($50 in chips) 
Seat 9: PleBeY95 ($61.85 in chips) 
lulu19911991: posts small blind $0.25
artemxxl: posts big blind $0.50
*** HOLE CARDS ***
An1an1: folds 
dikanmax: folds 
danthaur: folds 
PleBeY95: folds 
RRBAGGIO77: folds 
$lavik88: folds 
lulu19911991: raises $0.98 to $1.48
artemxxl: calls $0.98
*** FLOP *** [3d Kd 2s]
lulu19911991: bets $0.93
artemxxl: calls $0.93
*** TURN *** [3d Kd 2s] [Qd]
lulu19911991: checks 
artemxxl: bets $3.44
lulu19911991: calls $3.44
*** RIVER *** [3d Kd 2s Qd] [7d]
lulu19911991: checks 
artemxxl: bets $8.75
lulu19911991: folds 
Uncalled bet ($8.75) returned to artemxxl
artemxxl collected $11.12 from pot
*** SUMMARY ***
Total pot $11.70 | Rake $0.58 
Board [3d Kd 2s Qd 7d]
Seat 2: RRBAGGIO77 folded before Flop (didn't bet)
Seat 3: $lavik88 (button) folded before Flop (didn't bet)
Seat 4: lulu19911991 (small blind) folded on the River
Seat 5: artemxxl (big blind) collected ($11.12)
Seat 6: An1an1 folded before Flop (didn't bet)
Seat 7: dikanmax folded before Flop (didn't bet)
Seat 8: danthaur folded before Flop (didn't bet)
Seat 9: PleBeY95 folded before Flop (didn't bet)



PokerStars Hand #228688777553:  Hold'em No Limit ($0.25/$0.50 USD) - 2021/07/30 16:37:03 ET
Table 'Knysna II' 9-max Seat #4 is the button
Seat 1: FrankDuxe1 ($21.78 in chips) 
Seat 2: RRBAGGIO77 ($44.52 in chips) 
Seat 3: $lavik88 ($94.97 in chips) 
Seat 4: lulu19911991 ($60.61 in chips) 
Seat 5: artemxxl ($58.77 in chips) 
Seat 6: An1an1 ($50 in chips) 
Seat 7: dikanmax ($101.50 in chips) 
Seat 8: danthaur ($50 in chips) 
Seat 9: PleBeY95 ($61.85 in chips) 
artemxxl: posts small blind $0.25
An1an1: posts big blind $0.50
*** HOLE CARDS ***
dikanmax: folds 
danthaur: folds 
PleBeY95: folds 
FrankDuxe1: folds 
RRBAGGIO77: folds 
$lavik88: folds 
lulu19911991: folds 
artemxxl: folds 
Uncalled bet ($0.25) returned to An1an1
An1an1 collected $0.50 from pot
An1an1: doesn't show hand 
*** SUMMARY ***
Total pot $0.50 | Rake $0 
Seat 1: FrankDuxe1 folded before Flop (didn't bet)
Seat 2: RRBAGGIO77 folded before Flop (didn't bet)
Seat 3: $lavik88 folded before Flop (didn't bet)
Seat 4: lulu19911991 (button) folded before Flop (didn't bet)
Seat 5: artemxxl (small blind) folded before Flop
Seat 6: An1an1 (big blind) collected ($0.50)
Seat 7: dikanmax folded before Flop (didn't bet)
Seat 8: danthaur folded before Flop (didn't bet)
Seat 9: PleBeY95 folded before Flop (didn't bet)



PokerStars Hand #228688782647:  Hold'em No Limit ($0.25/$0.50 USD) - 2021/07/30 16:37:13 ET
Table 'Knysna II' 9-max Seat #5 is the button
Seat 1: FrankDuxe1 ($21.78 in chips) 
Seat 2: RRBAGGIO77 ($44.52 in chips) 
Seat 3: $lavik88 ($94.97 in chips) 
Seat 4: lulu19911991 ($60.61 in chips) 
Seat 5: artemxxl ($58.52 in chips) 
Seat 6: An1an1 ($50.25 in chips) 
Seat 7: dikanmax ($101.50 in chips) 
Seat 8: danthaur ($50 in chips) 
Seat 9: PleBeY95 ($61.85 in chips) 
An1an1: posts small blind $0.25
dikanmax: posts big blind $0.50
*** HOLE CARDS ***
danthaur: folds 
PleBeY95: folds 
FrankDuxe1: raises $1 to $1.50
RRBAGGIO77: folds 
$lavik88: folds 
lulu19911991: folds 
artemxxl: folds 
An1an1: folds 
dikanmax: folds 
Uncalled bet ($1) returned to FrankDuxe1
FrankDuxe1 collected $1.25 from pot
*** SUMMARY ***
Total pot $1.25 | Rake $0 
Seat 1: FrankDuxe1 collected ($1.25)
Seat 2: RRBAGGIO77 folded before Flop (didn't bet)
Seat 3: $lavik88 folded before Flop (didn't bet)
Seat 4: lulu19911991 folded before Flop (didn't bet)
Seat 5: artemxxl (button) folded before Flop (didn't bet)
Seat 6: An1an1 (small blind) folded before Flop
Seat 7: dikanmax (big blind) folded before Flop
Seat 8: danthaur folded before Flop (didn't bet)
Seat 9: PleBeY95 folded before Flop (didn't bet)



PokerStars Hand #228688793331:  Hold'em No Limit ($0.25/$0.50 USD) - 2021/07/30 16:37:36 ET
Table 'Knysna II' 9-max Seat #6 is the button
Seat 1: FrankDuxe1 ($22.53 in chips) 
Seat 2: RRBAGGIO77 ($44.52 in chips) 
Seat 3: $lavik88 ($94.97 in chips) 
Seat 4: lulu19911991 ($60.61 in chips) 
Seat 5: artemxxl ($58.52 in chips) 
Seat 6: An1an1 ($50 in chips) 
Seat 7: dikanmax ($101 in chips) 
Seat 8: danthaur ($50 in chips) 
Seat 9: PleBeY95 ($61.85 in chips) 
dikanmax: posts small blind $0.25
danthaur: posts big blind $0.50
*** HOLE CARDS ***
PleBeY95: folds 
FrankDuxe1: folds 
RRBAGGIO77: folds 
$lavik88: raises $1 to $1.50
lulu19911991: folds 
artemxxl: folds 
An1an1: folds 
dikanmax: folds 
danthaur: folds 
Uncalled bet ($1) returned to $lavik88
$lavik88 collected $1.25 from pot
$lavik88: doesn't show hand 
*** SUMMARY ***
Total pot $1.25 | Rake $0 
Seat 1: FrankDuxe1 folded before Flop (didn't bet)
Seat 2: RRBAGGIO77 folded before Flop (didn't bet)
Seat 3: $lavik88 collected ($1.25)
Seat 4: lulu19911991 folded before Flop (didn't bet)
Seat 5: artemxxl folded before Flop (didn't bet)
Seat 6: An1an1 (button) folded before Flop (didn't bet)
Seat 7: dikanmax (small blind) folded before Flop
Seat 8: danthaur (big blind) folded before Flop
Seat 9: PleBeY95 folded before Flop (didn't bet)



PokerStars Hand #228688806945:  Hold'em No Limit ($0.25/$0.50 USD) - 2021/07/30 16:38:05 ET
Table 'Knysna II' 9-max Seat #7 is the button
Seat 1: FrankDuxe1 ($22.53 in chips) 
Seat 2: RRBAGGIO77 ($44.52 in chips) 
Seat 3: $lavik88 ($95.72 in chips) 
Seat 4: lulu19911991 ($60.61 in chips) 
Seat 5: artemxxl ($58.52 in chips) 
Seat 6: An1an1 ($50 in chips) 
Seat 7: dikanmax ($100.75 in chips) 
Seat 8: danthaur ($50 in chips) 
Seat 9: PleBeY95 ($61.85 in chips) 
danthaur: posts small blind $0.25
PleBeY95: posts big blind $0.50
*** HOLE CARDS ***
FrankDuxe1: raises $1 to $1.50
RRBAGGIO77: calls $1.50
$lavik88: folds 
lulu19911991: folds 
artemxxl: folds 
An1an1: folds 
dikanmax: folds 
danthaur: folds 
PleBeY95: folds 
*** FLOP *** [Kd Ac As]
FrankDuxe1: checks 
RRBAGGIO77: checks 
*** TURN *** [Kd Ac As] [Ts]
FrankDuxe1: bets $2
RRBAGGIO77: folds 
Uncalled bet ($2) returned to FrankDuxe1
FrankDuxe1 collected $3.56 from pot
*** SUMMARY ***
Total pot $3.75 | Rake $0.19 
Board [Kd Ac As Ts]
Seat 1: FrankDuxe1 collected ($3.56)
Seat 2: RRBAGGIO77 folded on the Turn
Seat 3: $lavik88 folded before Flop (didn't bet)
Seat 4: lulu19911991 folded before Flop (didn't bet)
Seat 5: artemxxl folded before Flop (didn't bet)
Seat 6: An1an1 folded before Flop (didn't bet)
Seat 7: dikanmax (button) folded before Flop (didn't bet)
Seat 8: danthaur (small blind) folded before Flop
Seat 9: PleBeY95 (big blind) folded before Flop



PokerStars Hand #228688652617:  Hold'em No Limit ($0.25/$0.50 USD) - 2021/07/30 16:32:42 ET
Table 'Knysna II' 9-max Seat #4 is the button
Seat 1: FrankDuxe1 ($23.77 in chips) 
Seat 2: RRBAGGIO77 ($52.27 in chips) 
Seat 3: $lavik88 ($85.73 in chips) 
Seat 4: lulu19911991 ($64.26 in chips) 
Seat 6: An1an1 ($50 in chips) 
Seat 7: dikanmax ($102.25 in chips) 
Seat 8: danthaur ($50 in chips) 
Seat 9: PleBeY95 ($62.60 in chips) 
An1an1: posts small blind $0.25
dikanmax: posts big blind $0.50
*** HOLE CARDS ***
danthaur: folds 
PleBeY95: folds 
FrankDuxe1: folds 
RRBAGGIO77: folds 
$lavik88: raises $0.70 to $1.20
lulu19911991: raises $2.80 to $4
An1an1: folds 
dikanmax: folds 
$lavik88: folds 
Uncalled bet ($2.80) returned to lulu19911991
lulu19911991 collected $3.15 from pot
lulu19911991: doesn't show hand 
*** SUMMARY ***
Total pot $3.15 | Rake $0 
Seat 1: FrankDuxe1 folded before Flop (didn't bet)
Seat 2: RRBAGGIO77 folded before Flop (didn't bet)
Seat 3: $lavik88 folded before Flop
Seat 4: lulu19911991 (button) collected ($3.15)
Seat 6: An1an1 (small blind) folded before Flop
Seat 7: dikanmax (big blind) folded before Flop
Seat 8: danthaur folded before Flop (didn't bet)
Seat 9: PleBeY95 folded before Flop (didn't bet)



PokerStars Hand #228688663580:  Hold'em No Limit ($0.25/$0.50 USD) - 2021/07/30 16:33:05 ET
Table 'Knysna II' 9-max Seat #6 is the button
Seat 1: FrankDuxe1 ($23.77 in chips) 
Seat 2: RRBAGGIO77 ($52.27 in chips) 
Seat 3: $lavik88 ($84.53 in chips) 
Seat 4: lulu19911991 ($66.21 in chips) 
Seat 6: An1an1 ($50 in chips) 
Seat 7: dikanmax ($101.75 in chips) 
Seat 8: danthaur ($50 in chips) 
Seat 9: PleBeY95 ($62.60 in chips) 
dikanmax: posts small blind $0.25
danthaur: posts big blind $0.50
*** HOLE CARDS ***
PleBeY95: folds 
FrankDuxe1: raises $1 to $1.50
RRBAGGIO77: raises $1 to $2.50
$lavik88: folds 
lulu19911991: folds 
An1an1: folds 
dikanmax: folds 
danthaur: folds 
FrankDuxe1: calls $1
*** FLOP *** [4s Qd Ks]
FrankDuxe1: checks 
RRBAGGIO77: bets $3.50
FrankDuxe1: raises $3.50 to $7
RRBAGGIO77: folds 
Uncalled bet ($3.50) returned to FrankDuxe1
FrankDuxe1 collected $12.11 from pot
*** SUMMARY ***
Total pot $12.75 | Rake $0.64 
Board [4s Qd Ks]
Seat 1: FrankDuxe1 collected ($12.11)
Seat 2: RRBAGGIO77 folded on the Flop
Seat 3: $lavik88 folded before Flop (didn't bet)
Seat 4: lulu19911991 folded before Flop (didn't bet)
Seat 6: An1an1 (button) folded before Flop (didn't bet)
Seat 7: dikanmax (small blind) folded before Flop
Seat 8: danthaur (big blind) folded before Flop
Seat 9: PleBeY95 folded before Flop (didn't bet)



PokerStars Hand #228688688973:  Hold'em No Limit ($0.25/$0.50 USD) - 2021/07/30 16:33:57 ET
Table 'Knysna II' 9-max Seat #7 is the button
Seat 1: FrankDuxe1 ($29.88 in chips) 
Seat 2: RRBAGGIO77 ($46.27 in chips) 
Seat 3: $lavik88 ($84.53 in chips) 
Seat 4: lulu19911991 ($66.21 in chips) 
Seat 6: An1an1 ($50 in chips) 
Seat 7: dikanmax ($101.50 in chips) 
Seat 8: danthaur ($50 in chips) 
Seat 9: PleBeY95 ($62.60 in chips) 
danthaur: posts small blind $0.25
PleBeY95: posts big blind $0.50
artemxxl: sits out 
*** HOLE CARDS ***
FrankDuxe1: folds 
RRBAGGIO77: folds 
$lavik88: folds 
lulu19911991: folds 
An1an1: folds 
dikanmax: folds 
danthaur: raises $1 to $1.50
PleBeY95: folds 
Uncalled bet ($1) returned to danthaur
danthaur collected $1 from pot
danthaur: doesn't show hand 
*** SUMMARY ***
Total pot $1 | Rake $0 
Seat 1: FrankDuxe1 folded before Flop (didn't bet)
Seat 2: RRBAGGIO77 folded before Flop (didn't bet)
Seat 3: $lavik88 folded before Flop (didn't bet)
Seat 4: lulu19911991 folded before Flop (didn't bet)
Seat 6: An1an1 folded before Flop (didn't bet)
Seat 7: dikanmax (button) folded before Flop (didn't bet)
Seat 8: danthaur (small blind) collected ($1)
Seat 9: PleBeY95 (big blind) folded before Flop



PokerStars Hand #228688697316:  Hold'em No Limit ($0.25/$0.50 USD) - 2021/07/30 16:34:15 ET
Table 'Knysna II' 9-max Seat #8 is the button
Seat 1: FrankDuxe1 ($29.88 in chips) 
Seat 2: RRBAGGIO77 ($46.27 in chips) 
Seat 3: $lavik88 ($84.53 in chips) 
Seat 4: lulu19911991 ($66.21 in chips) 
Seat 6: An1an1 ($50 in chips) 
Seat 7: dikanmax ($101.50 in chips) 
Seat 8: danthaur ($50.50 in chips) 
Seat 9: PleBeY95 ($62.10 in chips) 
PleBeY95: posts small blind $0.25
FrankDuxe1: posts big blind $0.50
artemxxl: sits out 
*** HOLE CARDS ***
RRBAGGIO77: folds 
$lavik88: folds 
lulu19911991: folds 
An1an1: folds 
dikanmax: folds 
danthaur: folds 
PleBeY95: folds 
Uncalled bet ($0.25) returned to FrankDuxe1
FrankDuxe1 collected $0.50 from pot
*** SUMMARY ***
Total pot $0.50 | Rake $0 
Seat 1: FrankDuxe1 (big blind) collected ($0.50)
Seat 2: RRBAGGIO77 folded before Flop (didn't bet)
Seat 3: $lavik88 folded before Flop (didn't bet)
Seat 4: lulu19911991 folded before Flop (didn't bet)
Seat 6: An1an1 folded before Flop (didn't bet)
Seat 7: dikanmax folded before Flop (didn't bet)
Seat 8: danthaur (button) folded before Flop (didn't bet)
Seat 9: PleBeY95 (small blind) folded before Flop



PokerStars Hand #228688874245:  Hold'em No Limit ($0.25/$0.50 USD) - 2021/07/30 16:40:25 ET
Table 'Knysna II' 9-max Seat #1 is the button
Seat 1: FrankDuxe1 ($18.46 in chips) 
Seat 3: $lavik88 ($102.60 in chips) 
Seat 5: artemxxl ($58.52 in chips) 
Seat 6: An1an1 ($50 in chips) 
Seat 7: dikanmax ($100.75 in chips) 
Seat 8: danthaur ($50 in chips) 
Seat 9: PleBeY95 ($61.10 in chips) 
$lavik88: posts small blind $0.25
artemxxl: posts big blind $0.50
*** HOLE CARDS ***
An1an1: folds 
dikanmax: folds 
danthaur: folds 
PleBeY95: folds 
FrankDuxe1: raises $1.50 to $2
$lavik88: folds 
artemxxl: folds 
Uncalled bet ($1.50) returned to FrankDuxe1
FrankDuxe1 collected $1.25 from pot
*** SUMMARY ***
Total pot $1.25 | Rake $0 
Seat 1: FrankDuxe1 (button) collected ($1.25)
Seat 3: $lavik88 (small blind) folded before Flop
Seat 5: artemxxl (big blind) folded before Flop
Seat 6: An1an1 folded before Flop (didn't bet)
Seat 7: dikanmax folded before Flop (didn't bet)
Seat 8: danthaur folded before Flop (didn't bet)
Seat 9: PleBeY95 folded before Flop (didn't bet)



PokerStars Hand #228688886536:  Hold'em No Limit ($0.25/$0.50 USD) - 2021/07/30 16:40:43 ET
Table 'Knysna II' 9-max Seat #3 is the button
Seat 1: FrankDuxe1 ($19.21 in chips) 
Seat 3: $lavik88 ($102.35 in chips) 
Seat 5: artemxxl ($58.02 in chips) 
Seat 6: An1an1 ($50 in chips) 
Seat 7: dikanmax ($100.75 in chips) 
Seat 8: danthaur ($50 in chips) 
Seat 9: PleBeY95 ($61.10 in chips) 
artemxxl: posts small blind $0.25
An1an1: posts big blind $0.50
RRBAGGIO77: sits out 
*** HOLE CARDS ***
dikanmax: folds 
danthaur: folds 
PleBeY95: folds 
FrankDuxe1: calls $0.50
$lavik88: folds 
artemxxl: calls $0.25
An1an1: checks 
*** FLOP *** [Ks Kc 7c]
artemxxl: checks 
An1an1: bets $0.53
FrankDuxe1: folds 
artemxxl: folds 
Uncalled bet ($0.53) returned to An1an1
An1an1 collected $1.42 from pot
An1an1: doesn't show hand 
*** SUMMARY ***
Total pot $1.50 | Rake $0.08 
Board [Ks Kc 7c]
Seat 1: FrankDuxe1 folded on the Flop
Seat 3: $lavik88 (button) folded before Flop (didn't bet)
Seat 5: artemxxl (small blind) folded on the Flop
Seat 6: An1an1 (big blind) collected ($1.42)
Seat 7: dikanmax folded before Flop (didn't bet)
Seat 8: danthaur folded before Flop (didn't bet)
Seat 9: PleBeY95 folded before Flop (didn't bet)



PokerStars Hand #228688938106:  Hold'em No Limit ($0.25/$0.50 USD) - 2021/07/30 16:42:33 ET
Table 'Knysna II' 9-max Seat #8 is the button
Seat 2: RRBAGGIO77 ($49.25 in chips) 
Seat 3: $lavik88 ($102.35 in chips) 
Seat 6: An1an1 ($50.67 in chips) 
Seat 7: dikanmax ($100 in chips) 
Seat 8: danthaur ($50.50 in chips) 
Seat 9: PleBeY95 ($60.60 in chips) 
PleBeY95: posts small blind $0.25
RRBAGGIO77: posts big blind $0.50
*** HOLE CARDS ***
$lavik88: folds 
An1an1: folds 
dikanmax: folds 
danthaur: raises $0.75 to $1.25
PleBeY95: folds 
RRBAGGIO77: calls $0.75
*** FLOP *** [8h 9h Qd]
RRBAGGIO77: bets $1.50
danthaur: folds 
Uncalled bet ($1.50) returned to RRBAGGIO77
RRBAGGIO77 collected $2.61 from pot
RRBAGGIO77: doesn't show hand 
*** SUMMARY ***
Total pot $2.75 | Rake $0.14 
Board [8h 9h Qd]
Seat 2: RRBAGGIO77 (big blind) collected ($2.61)
Seat 3: $lavik88 folded before Flop (didn't bet)
Seat 6: An1an1 folded before Flop (didn't bet)
Seat 7: dikanmax folded before Flop (didn't bet)
Seat 8: danthaur (button) folded on the Flop
Seat 9: PleBeY95 (small blind) folded before Flop



PokerStars Hand #228688958695:  Hold'em No Limit ($0.25/$0.50 USD) - 2021/07/30 16:43:17 ET
Table 'Knysna II' 9-max Seat #9 is the button
Seat 2: RRBAGGIO77 ($50.61 in chips) 
Seat 3: $lavik88 ($102.35 in chips) 
Seat 6: An1an1 ($50.67 in chips) 
Seat 7: dikanmax ($100 in chips) 
Seat 8: danthaur ($50 in chips) 
Seat 9: PleBeY95 ($60.35 in chips) 
RRBAGGIO77: posts small blind $0.25
$lavik88: posts big blind $0.50
*** HOLE CARDS ***
An1an1: folds 
holdemamn joins the table at seat #5 
dikanmax: folds 
danthaur: folds 
PleBeY95: folds 
RRBAGGIO77: calls $0.25
$lavik88: checks 
*** FLOP *** [3d 2d Jh]
RRBAGGIO77: checks 
$lavik88: checks 
*** TURN *** [3d 2d Jh] [Js]
RRBAGGIO77: checks 
$lavik88: checks 
*** RIVER *** [3d 2d Jh Js] [Tc]
RRBAGGIO77: checks 
$lavik88: bets $0.50
RRBAGGIO77: calls $0.50
*** SHOW DOWN ***
$lavik88: shows [2h Ts] (two pair, Jacks and Tens)
RRBAGGIO77: mucks hand 
$lavik88 collected $1.90 from pot
*** SUMMARY ***
Total pot $2 | Rake $0.10 
Board [3d 2d Jh Js Tc]
Seat 2: RRBAGGIO77 (small blind) mucked
Seat 3: $lavik88 (big blind) showed [2h Ts] and won ($1.90) with two pair, Jacks and Tens
Seat 6: An1an1 folded before Flop (didn't bet)
Seat 7: dikanmax folded before Flop (didn't bet)
Seat 8: danthaur folded before Flop (didn't bet)
Seat 9: PleBeY95 (button) folded before Flop (didn't bet)



PokerStars Hand #228688993341:  Hold'em No Limit ($0.25/$0.50 USD) - 2021/07/30 16:44:31 ET
Table 'Knysna II' 9-max Seat #3 is the button
Seat 1: FrankDuxe1 ($23.22 in chips) 
Seat 2: RRBAGGIO77 ($49.61 in chips) 
Seat 3: $lavik88 ($103 in chips) 
Seat 5: holdemamn ($50 in chips) 
Seat 6: An1an1 ($50.67 in chips) 
Seat 7: dikanmax ($100 in chips) 
Seat 8: danthaur ($50 in chips) 
Seat 9: PleBeY95 ($60.35 in chips) 
holdemamn: posts small blind $0.25
An1an1: posts big blind $0.50
*** HOLE CARDS ***
dikanmax: folds 
danthaur: folds 
PleBeY95: folds 
FrankDuxe1: raises $0.50 to $1
RRBAGGIO77: calls $1
$lavik88: folds 
holdemamn: folds 
An1an1: calls $0.50
*** FLOP *** [Qh 2h 7c]
An1an1: bets $0.93
FrankDuxe1: calls $0.93
RRBAGGIO77: folds 
*** TURN *** [Qh 2h 7c] [9h]
An1an1: bets $3.73
FrankDuxe1: calls $3.73
*** RIVER *** [Qh 2h 7c 9h] [6h]
An1an1: bets $19.94
FrankDuxe1: calls $17.56 and is all-in
Uncalled bet ($2.38) returned to An1an1
*** SHOW DOWN ***
An1an1: shows [7h Ah] (a flush, Ace high)
FrankDuxe1: shows [5h 6s] (a flush, Queen high)
An1an1 collected $45.69 from pot
*** SUMMARY ***
Total pot $47.69 | Rake $2 
Board [Qh 2h 7c 9h 6h]
Seat 1: FrankDuxe1 showed [5h 6s] and lost with a flush, Queen high
Seat 2: RRBAGGIO77 folded on the Flop
Seat 3: $lavik88 (button) folded before Flop (didn't bet)
Seat 5: holdemamn (small blind) folded before Flop
Seat 6: An1an1 (big blind) showed [7h Ah] and won ($45.69) with a flush, Ace high
Seat 7: dikanmax folded before Flop (didn't bet)
Seat 8: danthaur folded before Flop (didn't bet)
Seat 9: PleBeY95 folded before Flop (didn't bet)



PokerStars Hand #228689035559:  Hold'em No Limit ($0.25/$0.50 USD) - 2021/07/30 16:45:41 ET
Table 'Knysna II' 9-max Seat #5 is the button
Seat 2: RRBAGGIO77 ($48.61 in chips) 
Seat 3: $lavik88 ($103 in chips) 
Seat 5: holdemamn ($50 in chips) 
Seat 6: An1an1 ($73.14 in chips) 
Seat 7: dikanmax ($100 in chips) 
Seat 8: danthaur ($50 in chips) 
Seat 9: PleBeY95 ($60.35 in chips) 
An1an1: posts small blind $0.25
dikanmax: posts big blind $0.50
*** HOLE CARDS ***
danthaur: folds 
PleBeY95: folds 
RRBAGGIO77: raises $1 to $1.50
$lavik88: folds 
holdemamn: folds 
An1an1: folds 
dikanmax: folds 
Uncalled bet ($1) returned to RRBAGGIO77
RRBAGGIO77 collected $1.25 from pot
RRBAGGIO77: doesn't show hand 
*** SUMMARY ***
Total pot $1.25 | Rake $0 
Seat 2: RRBAGGIO77 collected ($1.25)
Seat 3: $lavik88 folded before Flop (didn't bet)
Seat 5: holdemamn (button) folded before Flop (didn't bet)
Seat 6: An1an1 (small blind) folded before Flop
Seat 7: dikanmax (big blind) folded before Flop
Seat 8: danthaur folded before Flop (didn't bet)
Seat 9: PleBeY95 folded before Flop (didn't bet)



PokerStars Hand #228689043262:  Hold'em No Limit ($0.25/$0.50 USD) - 2021/07/30 16:45:57 ET
Table 'Knysna II' 9-max Seat #6 is the button
Seat 2: RRBAGGIO77 ($49.36 in chips) 
Seat 3: $lavik88 ($103 in chips) 
Seat 5: holdemamn ($50 in chips) 
Seat 6: An1an1 ($72.89 in chips) 
Seat 7: dikanmax ($99.50 in chips) 
Seat 8: danthaur ($50 in chips) 
Seat 9: PleBeY95 ($60.35 in chips) 
dikanmax: posts small blind $0.25
danthaur: posts big blind $0.50
*** HOLE CARDS ***
PleBeY95: folds 
RRBAGGIO77: folds 
$lavik88: folds 
holdemamn: folds 
An1an1: raises $0.85 to $1.35
dikanmax: raises $3.65 to $5
danthaur: folds 
FrankDuxe1 leaves the table
PleBeY95 leaves the table
An1an1: folds 
Uncalled bet ($3.65) returned to dikanmax
dikanmax collected $3.20 from pot
dikanmax: doesn't show hand 
*** SUMMARY ***
Total pot $3.20 | Rake $0 
Seat 2: RRBAGGIO77 folded before Flop (didn't bet)
Seat 3: $lavik88 folded before Flop (didn't bet)
Seat 5: holdemamn folded before Flop (didn't bet)
Seat 6: An1an1 (button) folded before Flop
Seat 7: dikanmax (small blind) collected ($3.20)
Seat 8: danthaur (big blind) folded before Flop
Seat 9: PleBeY95 folded before Flop (didn't bet)



PokerStars Hand #228689058052:  Hold'em No Limit ($0.25/$0.50 USD) - 2021/07/30 16:46:28 ET
Table 'Knysna II' 9-max Seat #7 is the button
Seat 2: RRBAGGIO77 ($49.36 in chips) 
Seat 3: $lavik88 ($103 in chips) 
Seat 5: holdemamn ($50 in chips) 
Seat 6: An1an1 ($71.54 in chips) 
Seat 7: dikanmax ($101.35 in chips) 
Seat 8: danthaur ($50 in chips) 
danthaur: posts small blind $0.25
RRBAGGIO77: posts big blind $0.50
*** HOLE CARDS ***
$lavik88: folds 
holdemamn: folds 
An1an1: folds 
dikanmax: folds 
danthaur: folds 
Uncalled bet ($0.25) returned to RRBAGGIO77
RRBAGGIO77 collected $0.50 from pot
RRBAGGIO77: doesn't show hand 
*** SUMMARY ***
Total pot $0.50 | Rake $0 
Seat 2: RRBAGGIO77 (big blind) collected ($0.50)
Seat 3: $lavik88 folded before Flop (didn't bet)
Seat 5: holdemamn folded before Flop (didn't bet)
Seat 6: An1an1 folded before Flop (didn't bet)
Seat 7: dikanmax (button) folded before Flop (didn't bet)
Seat 8: danthaur (small blind) folded before Flop



PokerStars Hand #228688251937:  Hold'em No Limit ($0.25/$0.50 USD) - 2021/07/30 16:18:59 ET
Table 'Knysna II' 9-max Seat #2 is the button
Seat 1: FrankDuxe1 ($32.12 in chips) 
Seat 2: RRBAGGIO77 ($115.27 in chips) 
Seat 3: $lavik88 ($77.24 in chips) 
Seat 4: lulu19911991 ($51.57 in chips) 
Seat 5: artemxxl ($50 in chips) 
Seat 6: An1an1 ($53.56 in chips) 
Seat 7: tomekpe ($50.50 in chips) 
Seat 8: danthaur ($52.77 in chips) 
Seat 9: PleBeY95 ($65.85 in chips) 
$lavik88: posts small blind $0.25
lulu19911991: posts big blind $0.50
FrankDuxe1: posts small & big blinds $0.75
*** HOLE CARDS ***
artemxxl: folds 
An1an1: folds 
tomekpe: folds 
danthaur: folds 
PleBeY95: folds 
FrankDuxe1: checks 
RRBAGGIO77: raises $1 to $1.50
$lavik88: folds 
lulu19911991: raises $3.50 to $5
FrankDuxe1: folds 
RRBAGGIO77: calls $3.50
*** FLOP *** [Ts 2d 7h]
lulu19911991: bets $5.33
RRBAGGIO77: folds 
Uncalled bet ($5.33) returned to lulu19911991
lulu19911991 collected $10.45 from pot
lulu19911991: doesn't show hand 
*** SUMMARY ***
Total pot $11 | Rake $0.55 
Board [Ts 2d 7h]
Seat 1: FrankDuxe1 folded before Flop (didn't bet)
Seat 2: RRBAGGIO77 (button) folded on the Flop
Seat 3: $lavik88 (small blind) folded before Flop
Seat 4: lulu19911991 (big blind) collected ($10.45)
Seat 5: artemxxl folded before Flop (didn't bet)
Seat 6: An1an1 folded before Flop (didn't bet)
Seat 7: tomekpe folded before Flop (didn't bet)
Seat 8: danthaur folded before Flop (didn't bet)
Seat 9: PleBeY95 folded before Flop (didn't bet)



PokerStars Hand #228688273908:  Hold'em No Limit ($0.25/$0.50 USD) - 2021/07/30 16:19:45 ET
Table 'Knysna II' 9-max Seat #3 is the button
Seat 1: FrankDuxe1 ($31.37 in chips) 
Seat 2: RRBAGGIO77 ($110.27 in chips) 
Seat 3: $lavik88 ($76.99 in chips) 
Seat 4: lulu19911991 ($57.02 in chips) 
Seat 5: artemxxl ($50 in chips) 
Seat 6: An1an1 ($53.56 in chips) 
Seat 7: tomekpe ($50.50 in chips) 
Seat 8: danthaur ($52.77 in chips) 
Seat 9: PleBeY95 ($65.85 in chips) 
lulu19911991: posts small blind $0.25
artemxxl: posts big blind $0.50
*** HOLE CARDS ***
An1an1: folds 
tomekpe: raises $0.69 to $1.19
danthaur: folds 
PleBeY95: folds 
FrankDuxe1: folds 
RRBAGGIO77: folds 
$lavik88: folds 
lulu19911991: folds 
artemxxl: folds 
Uncalled bet ($0.69) returned to tomekpe
tomekpe collected $1.25 from pot
tomekpe: doesn't show hand 
*** SUMMARY ***
Total pot $1.25 | Rake $0 
Seat 1: FrankDuxe1 folded before Flop (didn't bet)
Seat 2: RRBAGGIO77 folded before Flop (didn't bet)
Seat 3: $lavik88 (button) folded before Flop (didn't bet)
Seat 4: lulu19911991 (small blind) folded before Flop
Seat 5: artemxxl (big blind) folded before Flop
Seat 6: An1an1 folded before Flop (didn't bet)
Seat 7: tomekpe collected ($1.25)
Seat 8: danthaur folded before Flop (didn't bet)
Seat 9: PleBeY95 folded before Flop (didn't bet)



PokerStars Hand #228688348496:  Hold'em No Limit ($0.25/$0.50 USD) - 2021/07/30 16:22:18 ET
Table 'Knysna II' 9-max Seat #7 is the button
Seat 1: FrankDuxe1 ($31.37 in chips) 
Seat 2: RRBAGGIO77 ($108.27 in chips) 
Seat 3: $lavik88 ($76.99 in chips) 
Seat 4: lulu19911991 ($60.02 in chips) 
Seat 5: artemxxl ($50 in chips) 
Seat 6: An1an1 ($52.49 in chips) 
Seat 7: dikanmax ($50 in chips) 
Seat 8: danthaur ($52.27 in chips) 
Seat 9: PleBeY95 ($66.60 in chips) 
danthaur: posts small blind $0.25
PleBeY95: posts big blind $0.50
*** HOLE CARDS ***
FrankDuxe1: raises $1 to $1.50
RRBAGGIO77: folds 
$lavik88: folds 
lulu19911991: folds 
artemxxl: folds 
An1an1: folds 
dikanmax: folds 
danthaur: folds 
PleBeY95: folds 
Uncalled bet ($1) returned to FrankDuxe1
FrankDuxe1 collected $1.25 from pot
*** SUMMARY ***
Total pot $1.25 | Rake $0 
Seat 1: FrankDuxe1 collected ($1.25)
Seat 2: RRBAGGIO77 folded before Flop (didn't bet)
Seat 3: $lavik88 folded before Flop (didn't bet)
Seat 4: lulu19911991 folded before Flop (didn't bet)
Seat 5: artemxxl folded before Flop (didn't bet)
Seat 6: An1an1 folded before Flop (didn't bet)
Seat 7: dikanmax (button) folded before Flop (didn't bet)
Seat 8: danthaur (small blind) folded before Flop
Seat 9: PleBeY95 (big blind) folded before Flop



PokerStars Hand #228688360409:  Hold'em No Limit ($0.25/$0.50 USD) - 2021/07/30 16:22:42 ET
Table 'Knysna II' 9-max Seat #8 is the button
Seat 1: FrankDuxe1 ($32.12 in chips) 
Seat 2: RRBAGGIO77 ($108.27 in chips) 
Seat 3: $lavik88 ($76.99 in chips) 
Seat 4: lulu19911991 ($60.02 in chips) 
Seat 5: artemxxl ($50 in chips) 
Seat 6: An1an1 ($52.49 in chips) 
Seat 7: dikanmax ($50 in chips) 
Seat 8: danthaur ($52.02 in chips) 
Seat 9: PleBeY95 ($66.10 in chips) 
PleBeY95: posts small blind $0.25
FrankDuxe1: posts big blind $0.50
*** HOLE CARDS ***
RRBAGGIO77: folds 
$lavik88: folds 
lulu19911991: folds 
artemxxl: folds 
An1an1: raises $0.75 to $1.25
dikanmax: folds 
danthaur: folds 
PleBeY95: calls $1
FrankDuxe1: raises $4.75 to $6
An1an1: raises $46.49 to $52.49 and is all-in
PleBeY95: folds 
FrankDuxe1: calls $26.12 and is all-in
Uncalled bet ($20.37) returned to An1an1
*** FLOP *** [6s Th 2d]
*** TURN *** [6s Th 2d] [Qh]
*** RIVER *** [6s Th 2d Qh] [Ks]
*** SHOW DOWN ***
FrankDuxe1: shows [Js Jh] (a pair of Jacks)
An1an1: shows [6d 6c] (three of a kind, Sixes)
An1an1 cashed out the hand for $12.38 | Cash Out Fee $0.12
*** SUMMARY ***
Total pot $65.49 | Rake $2 
Board [6s Th 2d Qh Ks]
Seat 1: FrankDuxe1 (big blind) showed [Js Jh] and lost with a pair of Jacks
Seat 2: RRBAGGIO77 folded before Flop (didn't bet)
Seat 3: $lavik88 folded before Flop (didn't bet)
Seat 4: lulu19911991 folded before Flop (didn't bet)
Seat 5: artemxxl folded before Flop (didn't bet)
Seat 6: An1an1 showed [6d 6c] and won ($63.49) with three of a kind, Sixes (pot not awarded as player cashed out)
Seat 7: dikanmax folded before Flop (didn't bet)
Seat 8: danthaur (button) folded before Flop (didn't bet)
Seat 9: PleBeY95 (small blind) folded before Flop



PokerStars Hand #228690770839:  Hold'em No Limit ($0.25/$0.50 USD) - 2021/07/30 17:48:57 ET
Table 'Knysna II' 9-max Seat #8 is the button
Seat 1: nicu4you ($66.66 in chips) 
Seat 2: Seduisant365 ($50 in chips) 
Seat 3: kirsty858 ($61.95 in chips) 
Seat 4: mishkin2010 ($90.53 in chips) 
Seat 5: SwimmingPooI ($64.70 in chips) 
Seat 6: lulu19911991 ($52.76 in chips) 
Seat 7: lexon3 ($52.15 in chips) 
Seat 8: Nestle170 ($50 in chips) 
Seat 9: Kolyan2114 ($50 in chips) 
Kolyan2114: posts small blind $0.25
nicu4you: posts big blind $0.50
*** HOLE CARDS ***
Seduisant365: raises $0.75 to $1.25
kirsty858: folds 
mishkin2010: calls $1.25
SwimmingPooI: folds 
lulu19911991: folds 
lexon3: folds 
Nestle170: folds 
Kolyan2114: folds 
nicu4you: calls $0.75
*** FLOP *** [9c 9d 3d]
nicu4you: checks 
Seduisant365: bets $2.09
mishkin2010: calls $2.09
nicu4you: folds 
*** TURN *** [9c 9d 3d] [Jd]
Seduisant365: checks 
mishkin2010: bets $3.88
Seduisant365: calls $3.88
*** RIVER *** [9c 9d 3d Jd] [6d]
Seduisant365: checks 
mishkin2010: bets $7.57
Seduisant365: calls $7.57
*** SHOW DOWN ***
mishkin2010: shows [Kd 9h] (a flush, King high)
Seduisant365: shows [Ad Ac] (a flush, Ace high)
Seduisant365 collected $29.53 from pot
*** SUMMARY ***
Total pot $31.08 | Rake $1.55 
Board [9c 9d 3d Jd 6d]
Seat 1: nicu4you (big blind) folded on the Flop
Seat 2: Seduisant365 showed [Ad Ac] and won ($29.53) with a flush, Ace high
Seat 3: kirsty858 folded before Flop (didn't bet)
Seat 4: mishkin2010 showed [Kd 9h] and lost with a flush, King high
Seat 5: SwimmingPooI folded before Flop (didn't bet)
Seat 6: lulu19911991 folded before Flop (didn't bet)
Seat 7: lexon3 folded before Flop (didn't bet)
Seat 8: Nestle170 (button) folded before Flop (didn't bet)
Seat 9: Kolyan2114 (small blind) folded before Flop



PokerStars Hand #228690797525:  Hold'em No Limit ($0.25/$0.50 USD) - 2021/07/30 17:50:00 ET
Table 'Knysna II' 9-max Seat #9 is the button
Seat 1: nicu4you ($65.41 in chips) 
Seat 2: Seduisant365 ($64.74 in chips) 
Seat 3: kirsty858 ($61.95 in chips) 
Seat 4: mishkin2010 ($75.74 in chips) 
Seat 5: SwimmingPooI ($64.70 in chips) 
Seat 6: lulu19911991 ($52.76 in chips) 
Seat 7: lexon3 ($52.15 in chips) 
Seat 8: Nestle170 ($50 in chips) 
Seat 9: Kolyan2114 ($50 in chips) 
nicu4you: posts small blind $0.25
Seduisant365: posts big blind $0.50
*** HOLE CARDS ***
kirsty858: folds 
mishkin2010: calls $0.50
SwimmingPooI: raises $2 to $2.50
lulu19911991: folds 
lexon3: folds 
Nestle170: folds 
Kolyan2114: folds 
nicu4you: folds 
Seduisant365: folds 
mishkin2010: calls $2
*** FLOP *** [2s 4h Kh]
mishkin2010: checks 
SwimmingPooI: bets $2.50
mishkin2010: calls $2.50
*** TURN *** [2s 4h Kh] [9h]
mishkin2010: checks 
SwimmingPooI: checks 
*** RIVER *** [2s 4h Kh 9h] [9s]
mishkin2010: bets $10.21
SwimmingPooI: folds 
Uncalled bet ($10.21) returned to mishkin2010
mishkin2010 collected $10.21 from pot
mishkin2010: doesn't show hand 
*** SUMMARY ***
Total pot $10.75 | Rake $0.54 
Board [2s 4h Kh 9h 9s]
Seat 1: nicu4you (small blind) folded before Flop
Seat 2: Seduisant365 (big blind) folded before Flop
Seat 3: kirsty858 folded before Flop (didn't bet)
Seat 4: mishkin2010 collected ($10.21)
Seat 5: SwimmingPooI folded on the River
Seat 6: lulu19911991 folded before Flop (didn't bet)
Seat 7: lexon3 folded before Flop (didn't bet)
Seat 8: Nestle170 folded before Flop (didn't bet)
Seat 9: Kolyan2114 (button) folded before Flop (didn't bet)



PokerStars Hand #228690819765:  Hold'em No Limit ($0.25/$0.50 USD) - 2021/07/30 17:50:52 ET
Table 'Knysna II' 9-max Seat #1 is the button
Seat 1: nicu4you ($65.16 in chips) 
Seat 2: Seduisant365 ($64.24 in chips) 
Seat 3: kirsty858 ($61.95 in chips) 
Seat 4: mishkin2010 ($80.95 in chips) 
Seat 5: SwimmingPooI ($59.70 in chips) 
Seat 6: lulu19911991 ($52.76 in chips) 
Seat 7: lexon3 ($52.15 in chips) 
Seat 8: Nestle170 ($50 in chips) 
Seat 9: Kolyan2114 ($50 in chips) 
Seduisant365: posts small blind $0.25
kirsty858: posts big blind $0.50
*** HOLE CARDS ***
mishkin2010: folds 
SwimmingPooI: folds 
lulu19911991: folds 
lexon3: folds 
Nestle170: folds 
Kolyan2114: folds 
nicu4you: raises $0.75 to $1.25
Seduisant365: folds 
kirsty858: raises $2.75 to $4
nicu4you: folds 
Uncalled bet ($2.75) returned to kirsty858
kirsty858 collected $2.75 from pot
*** SUMMARY ***
Total pot $2.75 | Rake $0 
Seat 1: nicu4you (button) folded before Flop
Seat 2: Seduisant365 (small blind) folded before Flop
Seat 3: kirsty858 (big blind) collected ($2.75)
Seat 4: mishkin2010 folded before Flop (didn't bet)
Seat 5: SwimmingPooI folded before Flop (didn't bet)
Seat 6: lulu19911991 folded before Flop (didn't bet)
Seat 7: lexon3 folded before Flop (didn't bet)
Seat 8: Nestle170 folded before Flop (didn't bet)
Seat 9: Kolyan2114 folded before Flop (didn't bet)



PokerStars Hand #228690216460:  Hold'em No Limit ($0.25/$0.50 USD) - 2021/07/30 17:28:15 ET
Table 'Knysna II' 9-max Seat #5 is the button
Seat 1: nicu4you ($59.58 in chips) 
Seat 2: theMacGuffin ($44.25 in chips) 
Seat 3: pirog766 ($18.22 in chips) 
Seat 4: mishkin2010 ($92.55 in chips) 
Seat 5: SwimmingPooI ($64.70 in chips) 
Seat 6: lulu19911991 ($52.31 in chips) 
Seat 9: BarUnDuck ($20 in chips) 
lulu19911991: posts small blind $0.25
tomekpe: is sitting out 
BarUnDuck: posts big blind $0.50
*** HOLE CARDS ***
tomekpe leaves the table
nicu4you: raises $1 to $1.50
theMacGuffin: calls $1.50
pirog766: calls $1.50
mishkin2010: folds 
SwimmingPooI: folds 
lulu19911991: calls $1.25
BarUnDuck: raises $18.50 to $20 and is all-in
nicu4you: folds 
theMacGuffin: folds 
pirog766: calls $16.72 and is all-in
lulu19911991: folds 
Uncalled bet ($1.78) returned to BarUnDuck
*** FLOP *** [8c Jh 4s]
*** TURN *** [8c Jh 4s] [Ac]
*** RIVER *** [8c Jh 4s Ac] [Ks]
*** SHOW DOWN ***
BarUnDuck: shows [Qs Qd] (a pair of Queens)
pirog766: shows [6h 6d] (a pair of Sixes)
BarUnDuck collected $38.94 from pot
*** SUMMARY ***
Total pot $40.94 | Rake $2 
Board [8c Jh 4s Ac Ks]
Seat 1: nicu4you folded before Flop
Seat 2: theMacGuffin folded before Flop
Seat 3: pirog766 showed [6h 6d] and lost with a pair of Sixes
Seat 4: mishkin2010 folded before Flop (didn't bet)
Seat 5: SwimmingPooI (button) folded before Flop (didn't bet)
Seat 6: lulu19911991 (small blind) folded before Flop
Seat 9: BarUnDuck (big blind) showed [Qs Qd] and won ($38.94) with a pair of Queens



PokerStars Hand #228690234043:  Hold'em No Limit ($0.25/$0.50 USD) - 2021/07/30 17:28:54 ET
Table 'Knysna II' 9-max Seat #6 is the button
Seat 1: nicu4you ($58.08 in chips) 
Seat 2: theMacGuffin ($42.75 in chips) 
Seat 4: mishkin2010 ($92.55 in chips) 
Seat 5: SwimmingPooI ($64.70 in chips) 
Seat 6: lulu19911991 ($50.81 in chips) 
Seat 9: BarUnDuck ($40.72 in chips) 
BarUnDuck: posts small blind $0.25
nicu4you: posts big blind $0.50
*** HOLE CARDS ***
theMacGuffin: folds 
mishkin2010: folds 
SwimmingPooI: folds 
lulu19911991: raises $0.74 to $1.24
BarUnDuck: raises $2.98 to $4.22
nicu4you: folds 
Nestle170 joins the table at seat #8 
pirog766 is disconnected 
lulu19911991: folds 
Uncalled bet ($2.98) returned to BarUnDuck
BarUnDuck collected $2.98 from pot
BarUnDuck: doesn't show hand 
*** SUMMARY ***
Total pot $2.98 | Rake $0 
Seat 1: nicu4you (big blind) folded before Flop
Seat 2: theMacGuffin folded before Flop (didn't bet)
Seat 4: mishkin2010 folded before Flop (didn't bet)
Seat 5: SwimmingPooI folded before Flop (didn't bet)
Seat 6: lulu19911991 (button) folded before Flop
Seat 9: BarUnDuck (small blind) collected ($2.98)



PokerStars Hand #228690247071:  Hold'em No Limit ($0.25/$0.50 USD) - 2021/07/30 17:29:23 ET
Table 'Knysna II' 9-max Seat #9 is the button
Seat 1: nicu4you ($57.58 in chips) 
Seat 2: theMacGuffin ($42.75 in chips) 
Seat 4: mishkin2010 ($92.55 in chips) 
Seat 5: SwimmingPooI ($64.70 in chips) 
Seat 6: lulu19911991 ($50 in chips) 
Seat 9: BarUnDuck ($42.46 in chips) 
nicu4you: posts small blind $0.25
theMacGuffin: posts big blind $0.50
Nestle170: sits out 
*** HOLE CARDS ***
mishkin2010: calls $0.50
SwimmingPooI: folds 
lulu19911991: folds 
BarUnDuck: folds 
nicu4you: calls $0.25
theMacGuffin: raises $1 to $1.50
mishkin2010: calls $1
nicu4you: calls $1
*** FLOP *** [Kh Jd 9s]
nicu4you: checks 
theMacGuffin: checks 
mishkin2010: checks 
*** TURN *** [Kh Jd 9s] [5d]
nicu4you: checks 
theMacGuffin: checks 
mishkin2010: checks 
*** RIVER *** [Kh Jd 9s 5d] [2d]
nicu4you: checks 
theMacGuffin: checks 
mishkin2010: checks 
*** SHOW DOWN ***
nicu4you: shows [Js 8s] (a pair of Jacks)
theMacGuffin: mucks hand 
mishkin2010: mucks hand 
nicu4you collected $4.28 from pot
*** SUMMARY ***
Total pot $4.50 | Rake $0.22 
Board [Kh Jd 9s 5d 2d]
Seat 1: nicu4you (small blind) showed [Js 8s] and won ($4.28) with a pair of Jacks
Seat 2: theMacGuffin (big blind) mucked
Seat 4: mishkin2010 mucked
Seat 5: SwimmingPooI folded before Flop (didn't bet)
Seat 6: lulu19911991 folded before Flop (didn't bet)
Seat 9: BarUnDuck (button) folded before Flop (didn't bet)



PokerStars Hand #228690263172:  Hold'em No Limit ($0.25/$0.50 USD) - 2021/07/30 17:29:58 ET
Table 'Knysna II' 9-max Seat #1 is the button
Seat 1: nicu4you ($60.36 in chips) 
Seat 2: theMacGuffin ($41.25 in chips) 
Seat 4: mishkin2010 ($91.05 in chips) 
Seat 5: SwimmingPooI ($64.70 in chips) 
Seat 6: lulu19911991 ($50 in chips) 
Seat 9: BarUnDuck ($42.46 in chips) 
theMacGuffin: posts small blind $0.25
mishkin2010: posts big blind $0.50
Nestle170: sits out 
*** HOLE CARDS ***
SwimmingPooI: folds 
lulu19911991: folds 
BarUnDuck: folds 
nicu4you: raises $0.75 to $1.25
theMacGuffin: folds 
mishkin2010: calls $0.75
*** FLOP *** [4c 3s Th]
mishkin2010: checks 
nicu4you: checks 
*** TURN *** [4c 3s Th] [8c]
mishkin2010: checks 
nicu4you: checks 
*** RIVER *** [4c 3s Th 8c] [9h]
mishkin2010: bets $0.50
nicu4you: raises $2.49 to $2.99
mishkin2010: folds 
Uncalled bet ($2.49) returned to nicu4you
nicu4you collected $3.56 from pot
nicu4you: doesn't show hand 
*** SUMMARY ***
Total pot $3.75 | Rake $0.19 
Board [4c 3s Th 8c 9h]
Seat 1: nicu4you (button) collected ($3.56)
Seat 2: theMacGuffin (small blind) folded before Flop
Seat 4: mishkin2010 (big blind) folded on the River
Seat 5: SwimmingPooI folded before Flop (didn't bet)
Seat 6: lulu19911991 folded before Flop (didn't bet)
Seat 9: BarUnDuck folded before Flop (didn't bet)



PokerStars Hand #228690286298:  Hold'em No Limit ($0.25/$0.50 USD) - 2021/07/30 17:30:49 ET
Table 'Knysna II' 9-max Seat #2 is the button
Seat 1: nicu4you ($62.17 in chips) 
Seat 2: theMacGuffin ($41 in chips) 
Seat 4: mishkin2010 ($89.30 in chips) 
Seat 5: SwimmingPooI ($64.70 in chips) 
Seat 6: lulu19911991 ($50 in chips) 
Seat 9: BarUnDuck ($42.46 in chips) 
mishkin2010: posts small blind $0.25
SwimmingPooI: posts big blind $0.50
Nestle170: sits out 
*** HOLE CARDS ***
lonely fire leaves the table
lulu19911991: folds 
BarUnDuck: folds 
nicu4you: raises $1 to $1.50
theMacGuffin: raises $3.75 to $5.25
mishkin2010: folds 
SwimmingPooI: folds 
lexon3 joins the table at seat #7 
nicu4you: folds 
Uncalled bet ($3.75) returned to theMacGuffin
theMacGuffin collected $3.75 from pot
theMacGuffin: doesn't show hand 
*** SUMMARY ***
Total pot $3.75 | Rake $0 
Seat 1: nicu4you folded before Flop
Seat 2: theMacGuffin (button) collected ($3.75)
Seat 4: mishkin2010 (small blind) folded before Flop
Seat 5: SwimmingPooI (big blind) folded before Flop
Seat 6: lulu19911991 folded before Flop (didn't bet)
Seat 9: BarUnDuck folded before Flop (didn't bet)



PokerStars Hand #228690299421:  Hold'em No Limit ($0.25/$0.50 USD) - 2021/07/30 17:31:18 ET
Table 'Knysna II' 9-max Seat #4 is the button
Seat 1: nicu4you ($60.67 in chips) 
Seat 2: theMacGuffin ($43.25 in chips) 
Seat 4: mishkin2010 ($89.05 in chips) 
Seat 5: SwimmingPooI ($64.20 in chips) 
Seat 6: lulu19911991 ($50 in chips) 
Seat 9: BarUnDuck ($42.46 in chips) 
SwimmingPooI: posts small blind $0.25
lulu19911991: posts big blind $0.50
lexon3: sits out 
Nestle170: sits out 
*** HOLE CARDS ***
BarUnDuck: folds 
nicu4you: folds 
theMacGuffin: folds 
mishkin2010: folds 
SwimmingPooI: raises $1 to $1.50
lulu19911991: folds 
Uncalled bet ($1) returned to SwimmingPooI
SwimmingPooI collected $1 from pot
SwimmingPooI: doesn't show hand 
*** SUMMARY ***
Total pot $1 | Rake $0 
Seat 1: nicu4you folded before Flop (didn't bet)
Seat 2: theMacGuffin folded before Flop (didn't bet)
Seat 4: mishkin2010 (button) folded before Flop (didn't bet)
Seat 5: SwimmingPooI (small blind) collected ($1)
Seat 6: lulu19911991 (big blind) folded before Flop
Seat 9: BarUnDuck folded before Flop (didn't bet)



PokerStars Hand #228690304485:  Hold'em No Limit ($0.25/$0.50 USD) - 2021/07/30 17:31:29 ET
Table 'Knysna II' 9-max Seat #5 is the button
Seat 1: nicu4you ($60.67 in chips) 
Seat 2: theMacGuffin ($43.25 in chips) 
Seat 4: mishkin2010 ($89.05 in chips) 
Seat 5: SwimmingPooI ($64.70 in chips) 
Seat 6: lulu19911991 ($50 in chips) 
Seat 7: lexon3 ($50 in chips) 
Seat 9: BarUnDuck ($42.46 in chips) 
lulu19911991: posts small blind $0.25
lexon3: posts big blind $0.50
Nestle170: sits out 
*** HOLE CARDS ***
BarUnDuck has timed out
BarUnDuck: folds 
nicu4you: folds 
theMacGuffin: raises $1 to $1.50
mishkin2010: folds 
SwimmingPooI: folds 
lulu19911991: folds 
lexon3: folds 
Uncalled bet ($1) returned to theMacGuffin
theMacGuffin collected $1.25 from pot
theMacGuffin: doesn't show hand 
*** SUMMARY ***
Total pot $1.25 | Rake $0 
Seat 1: nicu4you folded before Flop (didn't bet)
Seat 2: theMacGuffin collected ($1.25)
Seat 4: mishkin2010 folded before Flop (didn't bet)
Seat 5: SwimmingPooI (button) folded before Flop (didn't bet)
Seat 6: lulu19911991 (small blind) folded before Flop
Seat 7: lexon3 (big blind) folded before Flop
Seat 9: BarUnDuck folded before Flop (didn't bet)



PokerStars Hand #228690320489:  Hold'em No Limit ($0.25/$0.50 USD) - 2021/07/30 17:32:05 ET
Table 'Knysna II' 9-max Seat #6 is the button
Seat 1: nicu4you ($60.67 in chips) 
Seat 2: theMacGuffin ($44 in chips) 
Seat 4: mishkin2010 ($89.05 in chips) 
Seat 5: SwimmingPooI ($64.70 in chips) 
Seat 6: lulu19911991 ($50 in chips) 
Seat 7: lexon3 ($50 in chips) 
Seat 8: Nestle170 ($50 in chips) 
Seat 9: BarUnDuck ($42.46 in chips) 
lexon3: posts small blind $0.25
Nestle170: posts big blind $0.50
*** HOLE CARDS ***
BarUnDuck: folds 
nicu4you: folds 
theMacGuffin: folds 
mishkin2010: folds 
SwimmingPooI: folds 
lulu19911991: folds 
lexon3: raises $1 to $1.50
Nestle170: calls $1
*** FLOP *** [Kc 9c Ts]
lexon3: checks 
Nestle170: bets $1.88
lexon3: folds 
Uncalled bet ($1.88) returned to Nestle170
Nestle170 collected $2.85 from pot
Nestle170: doesn't show hand 
*** SUMMARY ***
Total pot $3 | Rake $0.15 
Board [Kc 9c Ts]
Seat 1: nicu4you folded before Flop (didn't bet)
Seat 2: theMacGuffin folded before Flop (didn't bet)
Seat 4: mishkin2010 folded before Flop (didn't bet)
Seat 5: SwimmingPooI folded before Flop (didn't bet)
Seat 6: lulu19911991 (button) folded before Flop (didn't bet)
Seat 7: lexon3 (small blind) folded on the Flop
Seat 8: Nestle170 (big blind) collected ($2.85)
Seat 9: BarUnDuck folded before Flop (didn't bet)



PokerStars Hand #228690343811:  Hold'em No Limit ($0.25/$0.50 USD) - 2021/07/30 17:32:56 ET
Table 'Knysna II' 9-max Seat #7 is the button
Seat 1: nicu4you ($60.67 in chips) 
Seat 2: theMacGuffin ($44 in chips) 
Seat 4: mishkin2010 ($89.05 in chips) 
Seat 5: SwimmingPooI ($64.70 in chips) 
Seat 6: lulu19911991 ($50 in chips) 
Seat 7: lexon3 ($50 in chips) 
Seat 8: Nestle170 ($51.35 in chips) 
Seat 9: BarUnDuck ($42.46 in chips) 
Nestle170: posts small blind $0.25
BarUnDuck: posts big blind $0.50
*** HOLE CARDS ***
nicu4you: folds 
theMacGuffin: raises $1 to $1.50
mishkin2010: folds 
SwimmingPooI: folds 
lulu19911991: folds 
lexon3: folds 
Nestle170: folds 
BarUnDuck: folds 
Uncalled bet ($1) returned to theMacGuffin
theMacGuffin collected $1.25 from pot
theMacGuffin: doesn't show hand 
*** SUMMARY ***
Total pot $1.25 | Rake $0 
Seat 1: nicu4you folded before Flop (didn't bet)
Seat 2: theMacGuffin collected ($1.25)
Seat 4: mishkin2010 folded before Flop (didn't bet)
Seat 5: SwimmingPooI folded before Flop (didn't bet)
Seat 6: lulu19911991 folded before Flop (didn't bet)
Seat 7: lexon3 (button) folded before Flop (didn't bet)
Seat 8: Nestle170 (small blind) folded before Flop
Seat 9: BarUnDuck (big blind) folded before Flop



PokerStars Hand #228690352067:  Hold'em No Limit ($0.25/$0.50 USD) - 2021/07/30 17:33:14 ET
Table 'Knysna II' 9-max Seat #8 is the button
Seat 1: nicu4you ($60.67 in chips) 
Seat 2: theMacGuffin ($44.75 in chips) 
Seat 4: mishkin2010 ($89.05 in chips) 
Seat 5: SwimmingPooI ($64.70 in chips) 
Seat 6: lulu19911991 ($50 in chips) 
Seat 7: lexon3 ($50 in chips) 
Seat 8: Nestle170 ($51.10 in chips) 
Seat 9: BarUnDuck ($41.96 in chips) 
BarUnDuck: posts small blind $0.25
nicu4you: posts big blind $0.50
*** HOLE CARDS ***
theMacGuffin: folds 
mishkin2010: folds 
SwimmingPooI: folds 
theMacGuffin leaves the table
lulu19911991: raises $0.98 to $1.48
lexon3: folds 
Nestle170: folds 
BarUnDuck: calls $1.23
nicu4you: calls $0.98
*** FLOP *** [2d 3c 6h]
Seduisant365 joins the table at seat #2 
BarUnDuck: checks 
nicu4you: checks 
lulu19911991: bets $1.39
BarUnDuck: calls $1.39
nicu4you: raises $4.11 to $5.50
lulu19911991: folds 
BarUnDuck: folds 
Uncalled bet ($4.11) returned to nicu4you
nicu4you collected $8.18 from pot
nicu4you: doesn't show hand 
*** SUMMARY ***
Total pot $8.61 | Rake $0.43 
Board [2d 3c 6h]
Seat 1: nicu4you (big blind) collected ($8.18)
Seat 2: theMacGuffin folded before Flop (didn't bet)
Seat 4: mishkin2010 folded before Flop (didn't bet)
Seat 5: SwimmingPooI folded before Flop (didn't bet)
Seat 6: lulu19911991 folded on the Flop
Seat 7: lexon3 folded before Flop (didn't bet)
Seat 8: Nestle170 (button) folded before Flop (didn't bet)
Seat 9: BarUnDuck (small blind) folded on the Flop



PokerStars Hand #228690387306:  Hold'em No Limit ($0.25/$0.50 USD) - 2021/07/30 17:34:32 ET
Table 'Knysna II' 9-max Seat #9 is the button
Seat 1: nicu4you ($65.98 in chips) 
Seat 2: Seduisant365 ($50 in chips) 
Seat 4: mishkin2010 ($89.05 in chips) 
Seat 5: SwimmingPooI ($64.70 in chips) 
Seat 6: lulu19911991 ($50 in chips) 
Seat 7: lexon3 ($50 in chips) 
Seat 8: Nestle170 ($51.10 in chips) 
Seat 9: BarUnDuck ($39.09 in chips) 
nicu4you: posts small blind $0.25
Seduisant365: posts big blind $0.50
*** HOLE CARDS ***
mishkin2010: calls $0.50
SwimmingPooI: folds 
lulu19911991: folds 
lexon3: folds 
Nestle170: folds 
BarUnDuck: folds 
nicu4you: calls $0.25
Seduisant365: checks 
*** FLOP *** [9d 2c 6c]
BarUnDuck leaves the table
nicu4you: checks 
Seduisant365: checks 
mishkin2010: checks 
*** TURN *** [9d 2c 6c] [2h]
nicu4you: checks 
Seduisant365: checks 
mishkin2010: checks 
*** RIVER *** [9d 2c 6c 2h] [2d]
nicu4you: checks 
Seduisant365: checks 
mishkin2010: bets $0.50
nicu4you: folds 
Kolyan2114 joins the table at seat #9 
Seduisant365: folds 
Uncalled bet ($0.50) returned to mishkin2010
mishkin2010 collected $1.42 from pot
mishkin2010: doesn't show hand 
*** SUMMARY ***
Total pot $1.50 | Rake $0.08 
Board [9d 2c 6c 2h 2d]
Seat 1: nicu4you (small blind) folded on the River
Seat 2: Seduisant365 (big blind) folded on the River
Seat 4: mishkin2010 collected ($1.42)
Seat 5: SwimmingPooI folded before Flop (didn't bet)
Seat 6: lulu19911991 folded before Flop (didn't bet)
Seat 7: lexon3 folded before Flop (didn't bet)
Seat 8: Nestle170 folded before Flop (didn't bet)
Seat 9: BarUnDuck (button) folded before Flop (didn't bet)



PokerStars Hand #228690410200:  Hold'em No Limit ($0.25/$0.50 USD) - 2021/07/30 17:35:23 ET
Table 'Knysna II' 9-max Seat #1 is the button
Seat 1: nicu4you ($65.48 in chips) 
Seat 2: Seduisant365 ($50 in chips) 
Seat 4: mishkin2010 ($89.97 in chips) 
Seat 5: SwimmingPooI ($64.70 in chips) 
Seat 6: lulu19911991 ($50 in chips) 
Seat 7: lexon3 ($50 in chips) 
Seat 8: Nestle170 ($51.10 in chips) 
Seduisant365: posts small blind $0.25
mishkin2010: posts big blind $0.50
Kolyan2114: sits out 
*** HOLE CARDS ***
SwimmingPooI: folds 
lulu19911991: folds 
lexon3: folds 
Nestle170: folds 
nicu4you: folds 
Seduisant365: raises $1 to $1.50
mishkin2010: calls $1
*** FLOP *** [4s As 9c]
Seduisant365: bets $0.94
mishkin2010: calls $0.94
*** TURN *** [4s As 9c] [4d]
Seduisant365: checks 
mishkin2010: bets $2.32
Seduisant365: folds 
Uncalled bet ($2.32) returned to mishkin2010
mishkin2010 collected $4.64 from pot
mishkin2010: doesn't show hand 
*** SUMMARY ***
Total pot $4.88 | Rake $0.24 
Board [4s As 9c 4d]
Seat 1: nicu4you (button) folded before Flop (didn't bet)
Seat 2: Seduisant365 (small blind) folded on the Turn
Seat 4: mishkin2010 (big blind) collected ($4.64)
Seat 5: SwimmingPooI folded before Flop (didn't bet)
Seat 6: lulu19911991 folded before Flop (didn't bet)
Seat 7: lexon3 folded before Flop (didn't bet)
Seat 8: Nestle170 folded before Flop (didn't bet)



PokerStars Hand #228690428323:  Hold'em No Limit ($0.25/$0.50 USD) - 2021/07/30 17:36:03 ET
Table 'Knysna II' 9-max Seat #2 is the button
Seat 1: nicu4you ($65.48 in chips) 
Seat 2: Seduisant365 ($50 in chips) 
Seat 4: mishkin2010 ($92.17 in chips) 
Seat 5: SwimmingPooI ($64.70 in chips) 
Seat 6: lulu19911991 ($50 in chips) 
Seat 7: lexon3 ($50 in chips) 
Seat 8: Nestle170 ($51.10 in chips) 
mishkin2010: posts small blind $0.25
SwimmingPooI: posts big blind $0.50
Kolyan2114: sits out 
*** HOLE CARDS ***
lulu19911991: raises $0.98 to $1.48
lexon3: folds 
Nestle170: folds 
nicu4you: calls $1.48
Seduisant365: folds 
mishkin2010: folds 
SwimmingPooI: folds 
*** FLOP *** [5s 3d Js]
lulu19911991: bets $1.80
nicu4you: raises $4.70 to $6.50
lulu19911991: folds 
Uncalled bet ($4.70) returned to nicu4you
nicu4you collected $6.94 from pot
nicu4you: doesn't show hand 
*** SUMMARY ***
Total pot $7.31 | Rake $0.37 
Board [5s 3d Js]
Seat 1: nicu4you collected ($6.94)
Seat 2: Seduisant365 (button) folded before Flop (didn't bet)
Seat 4: mishkin2010 (small blind) folded before Flop
Seat 5: SwimmingPooI (big blind) folded before Flop
Seat 6: lulu19911991 folded on the Flop
Seat 7: lexon3 folded before Flop (didn't bet)
Seat 8: Nestle170 folded before Flop (didn't bet)



PokerStars Hand #228690454413:  Hold'em No Limit ($0.25/$0.50 USD) - 2021/07/30 17:37:02 ET
Table 'Knysna II' 9-max Seat #4 is the button
Seat 1: nicu4you ($69.14 in chips) 
Seat 2: Seduisant365 ($50 in chips) 
Seat 4: mishkin2010 ($91.92 in chips) 
Seat 5: SwimmingPooI ($64.20 in chips) 
Seat 6: lulu19911991 ($50 in chips) 
Seat 7: lexon3 ($50 in chips) 
Seat 8: Nestle170 ($51.10 in chips) 
SwimmingPooI: posts small blind $0.25
lulu19911991: posts big blind $0.50
Kolyan2114: sits out 
*** HOLE CARDS ***
lexon3: folds 
Nestle170: raises $1 to $1.50
nicu4you: folds 
Seduisant365: folds 
mishkin2010: calls $1.50
SwimmingPooI: folds 
lulu19911991: folds 
*** FLOP *** [Kc 6d Ah]
Nestle170: bets $1.17
mishkin2010: calls $1.17
*** TURN *** [Kc 6d Ah] [5d]
Nestle170: checks 
mishkin2010: checks 
*** RIVER *** [Kc 6d Ah 5d] [8s]
Nestle170: checks 
mishkin2010: bets $5.79
Nestle170: calls $5.79
*** SHOW DOWN ***
mishkin2010: shows [8c 6c] (two pair, Eights and Sixes)
Nestle170: mucks hand 
mishkin2010 collected $16.79 from pot
*** SUMMARY ***
Total pot $17.67 | Rake $0.88 
Board [Kc 6d Ah 5d 8s]
Seat 1: nicu4you folded before Flop (didn't bet)
Seat 2: Seduisant365 folded before Flop (didn't bet)
Seat 4: mishkin2010 (button) showed [8c 6c] and won ($16.79) with two pair, Eights and Sixes
Seat 5: SwimmingPooI (small blind) folded before Flop
Seat 6: lulu19911991 (big blind) folded before Flop
Seat 7: lexon3 folded before Flop (didn't bet)
Seat 8: Nestle170 mucked



PokerStars Hand #228690483740:  Hold'em No Limit ($0.25/$0.50 USD) - 2021/07/30 17:38:01 ET
Table 'Knysna II' 9-max Seat #5 is the button
Seat 1: nicu4you ($69.14 in chips) 
Seat 2: Seduisant365 ($50 in chips) 
Seat 4: mishkin2010 ($100.25 in chips) 
Seat 5: SwimmingPooI ($63.95 in chips) 
Seat 6: lulu19911991 ($50 in chips) 
Seat 7: lexon3 ($50 in chips) 
Seat 8: Nestle170 ($50 in chips) 
lulu19911991: posts small blind $0.25
lexon3: posts big blind $0.50
Kolyan2114: sits out 
*** HOLE CARDS ***
Nestle170: folds 
nicu4you: folds 
Seduisant365: folds 
mishkin2010: raises $0.50 to $1
SwimmingPooI: folds 
lulu19911991: folds 
lexon3: folds 
Uncalled bet ($0.50) returned to mishkin2010
mishkin2010 collected $1.25 from pot
mishkin2010: doesn't show hand 
*** SUMMARY ***
Total pot $1.25 | Rake $0 
Seat 1: nicu4you folded before Flop (didn't bet)
Seat 2: Seduisant365 folded before Flop (didn't bet)
Seat 4: mishkin2010 collected ($1.25)
Seat 5: SwimmingPooI (button) folded before Flop (didn't bet)
Seat 6: lulu19911991 (small blind) folded before Flop
Seat 7: lexon3 (big blind) folded before Flop
Seat 8: Nestle170 folded before Flop (didn't bet)



PokerStars Hand #228690489574:  Hold'em No Limit ($0.25/$0.50 USD) - 2021/07/30 17:38:15 ET
Table 'Knysna II' 9-max Seat #6 is the button
Seat 1: nicu4you ($69.14 in chips) 
Seat 2: Seduisant365 ($50 in chips) 
Seat 4: mishkin2010 ($101 in chips) 
Seat 5: SwimmingPooI ($63.95 in chips) 
Seat 6: lulu19911991 ($50 in chips) 
Seat 7: lexon3 ($50 in chips) 
Seat 8: Nestle170 ($50 in chips) 
lexon3: posts small blind $0.25
Nestle170: posts big blind $0.50
Kolyan2114: sits out 
*** HOLE CARDS ***
nicu4you: folds 
Seduisant365: raises $0.75 to $1.25
mishkin2010: folds 
SwimmingPooI: folds 
lulu19911991: folds 
lexon3: folds 
Nestle170: folds 
Uncalled bet ($0.75) returned to Seduisant365
Seduisant365 collected $1.25 from pot
Seduisant365: doesn't show hand 
*** SUMMARY ***
Total pot $1.25 | Rake $0 
Seat 1: nicu4you folded before Flop (didn't bet)
Seat 2: Seduisant365 collected ($1.25)
Seat 4: mishkin2010 folded before Flop (didn't bet)
Seat 5: SwimmingPooI folded before Flop (didn't bet)
Seat 6: lulu19911991 (button) folded before Flop (didn't bet)
Seat 7: lexon3 (small blind) folded before Flop
Seat 8: Nestle170 (big blind) folded before Flop



PokerStars Hand #228690499658:  Hold'em No Limit ($0.25/$0.50 USD) - 2021/07/30 17:38:37 ET
Table 'Knysna II' 9-max Seat #7 is the button
Seat 1: nicu4you ($69.14 in chips) 
Seat 2: Seduisant365 ($50.75 in chips) 
Seat 4: mishkin2010 ($101 in chips) 
Seat 5: SwimmingPooI ($63.95 in chips) 
Seat 6: lulu19911991 ($50 in chips) 
Seat 7: lexon3 ($50 in chips) 
Seat 8: Nestle170 ($50 in chips) 
Seat 9: Kolyan2114 ($50 in chips) 
Nestle170: posts small blind $0.25
Kolyan2114: posts big blind $0.50
*** HOLE CARDS ***
nicu4you: folds 
Seduisant365: folds 
mishkin2010: folds 
SwimmingPooI: folds 
lulu19911991: folds 
lexon3: folds 
Nestle170: folds 
Uncalled bet ($0.25) returned to Kolyan2114
Kolyan2114 collected $0.50 from pot
*** SUMMARY ***
Total pot $0.50 | Rake $0 
Seat 1: nicu4you folded before Flop (didn't bet)
Seat 2: Seduisant365 folded before Flop (didn't bet)
Seat 4: mishkin2010 folded before Flop (didn't bet)
Seat 5: SwimmingPooI folded before Flop (didn't bet)
Seat 6: lulu19911991 folded before Flop (didn't bet)
Seat 7: lexon3 (button) folded before Flop (didn't bet)
Seat 8: Nestle170 (small blind) folded before Flop
Seat 9: Kolyan2114 (big blind) collected ($0.50)



PokerStars Hand #228690507780:  Hold'em No Limit ($0.25/$0.50 USD) - 2021/07/30 17:38:56 ET
Table 'Knysna II' 9-max Seat #8 is the button
Seat 1: nicu4you ($69.14 in chips) 
Seat 2: Seduisant365 ($50.75 in chips) 
Seat 4: mishkin2010 ($101 in chips) 
Seat 5: SwimmingPooI ($63.95 in chips) 
Seat 6: lulu19911991 ($50 in chips) 
Seat 7: lexon3 ($50 in chips) 
Seat 8: Nestle170 ($50 in chips) 
Seat 9: Kolyan2114 ($50.25 in chips) 
Kolyan2114: posts small blind $0.25
nicu4you: posts big blind $0.50
*** HOLE CARDS ***
Seduisant365: folds 
mishkin2010: folds 
SwimmingPooI: folds 
lulu19911991: raises $0.98 to $1.48
lexon3: folds 
Nestle170: folds 
Kolyan2114: folds 
nicu4you: calls $0.98
*** FLOP *** [Qh 6c Kd]
pirog766 was removed from the table for failing to post
pirog766 leaves the table
nicu4you: checks 
lulu19911991: bets $1.01
nicu4you: folds 
Uncalled bet ($1.01) returned to lulu19911991
lulu19911991 collected $3.05 from pot
lulu19911991: doesn't show hand 
*** SUMMARY ***
Total pot $3.21 | Rake $0.16 
Board [Qh 6c Kd]
Seat 1: nicu4you (big blind) folded on the Flop
Seat 2: Seduisant365 folded before Flop (didn't bet)
Seat 4: mishkin2010 folded before Flop (didn't bet)
Seat 5: SwimmingPooI folded before Flop (didn't bet)
Seat 6: lulu19911991 collected ($3.05)
Seat 7: lexon3 folded before Flop (didn't bet)
Seat 8: Nestle170 (button) folded before Flop (didn't bet)
Seat 9: Kolyan2114 (small blind) folded before Flop



PokerStars Hand #228690518740:  Hold'em No Limit ($0.25/$0.50 USD) - 2021/07/30 17:39:20 ET
Table 'Knysna II' 9-max Seat #9 is the button
Seat 1: nicu4you ($67.66 in chips) 
Seat 2: Seduisant365 ($50.75 in chips) 
Seat 4: mishkin2010 ($101 in chips) 
Seat 5: SwimmingPooI ($63.95 in chips) 
Seat 6: lulu19911991 ($51.57 in chips) 
Seat 7: lexon3 ($50 in chips) 
Seat 8: Nestle170 ($50 in chips) 
Seat 9: Kolyan2114 ($50 in chips) 
nicu4you: posts small blind $0.25
Seduisant365: posts big blind $0.50
*** HOLE CARDS ***
mishkin2010: calls $0.50
SwimmingPooI: folds 
lulu19911991: raises $1.70 to $2.20
lexon3: folds 
Nestle170: folds 
Kolyan2114: folds 
nicu4you: folds 
Seduisant365: folds 
mishkin2010: calls $1.70
*** FLOP *** [2c Jc 9d]
mishkin2010: checks 
lulu19911991: bets $3.28
mishkin2010: folds 
Uncalled bet ($3.28) returned to lulu19911991
lulu19911991 collected $4.89 from pot
lulu19911991: doesn't show hand 
*** SUMMARY ***
Total pot $5.15 | Rake $0.26 
Board [2c Jc 9d]
Seat 1: nicu4you (small blind) folded before Flop
Seat 2: Seduisant365 (big blind) folded before Flop
Seat 4: mishkin2010 folded on the Flop
Seat 5: SwimmingPooI folded before Flop (didn't bet)
Seat 6: lulu19911991 collected ($4.89)
Seat 7: lexon3 folded before Flop (didn't bet)
Seat 8: Nestle170 folded before Flop (didn't bet)
Seat 9: Kolyan2114 (button) folded before Flop (didn't bet)



PokerStars Hand #228690533282:  Hold'em No Limit ($0.25/$0.50 USD) - 2021/07/30 17:39:53 ET
Table 'Knysna II' 9-max Seat #1 is the button
Seat 1: nicu4you ($67.41 in chips) 
Seat 2: Seduisant365 ($50.25 in chips) 
Seat 4: mishkin2010 ($98.80 in chips) 
Seat 5: SwimmingPooI ($63.95 in chips) 
Seat 6: lulu19911991 ($54.26 in chips) 
Seat 7: lexon3 ($50 in chips) 
Seat 8: Nestle170 ($50 in chips) 
Seat 9: Kolyan2114 ($50 in chips) 
Seduisant365: posts small blind $0.25
mishkin2010: posts big blind $0.50
*** HOLE CARDS ***
SwimmingPooI: folds 
lulu19911991: folds 
lexon3: raises $1 to $1.50
Nestle170: folds 
Kolyan2114: folds 
nicu4you: folds 
Seduisant365: folds 
mishkin2010: calls $1
*** FLOP *** [3h Qs Jd]
mishkin2010: checks 
lexon3: checks 
*** TURN *** [3h Qs Jd] [4h]
mishkin2010: checks 
kirsty858 joins the table at seat #3 
lexon3: checks 
*** RIVER *** [3h Qs Jd 4h] [3c]
mishkin2010: checks 
lexon3: checks 
*** SHOW DOWN ***
mishkin2010: shows [9s Td] (a pair of Threes)
lexon3: shows [5s 5h] (two pair, Fives and Threes)
lexon3 collected $3.09 from pot
*** SUMMARY ***
Total pot $3.25 | Rake $0.16 
Board [3h Qs Jd 4h 3c]
Seat 1: nicu4you (button) folded before Flop (didn't bet)
Seat 2: Seduisant365 (small blind) folded before Flop
Seat 4: mishkin2010 (big blind) showed [9s Td] and lost with a pair of Threes
Seat 5: SwimmingPooI folded before Flop (didn't bet)
Seat 6: lulu19911991 folded before Flop (didn't bet)
Seat 7: lexon3 showed [5s 5h] and won ($3.09) with two pair, Fives and Threes
Seat 8: Nestle170 folded before Flop (didn't bet)
Seat 9: Kolyan2114 folded before Flop (didn't bet)



PokerStars Hand #228690553506:  Hold'em No Limit ($0.25/$0.50 USD) - 2021/07/30 17:40:39 ET
Table 'Knysna II' 9-max Seat #2 is the button
Seat 1: nicu4you ($67.41 in chips) 
Seat 2: Seduisant365 ($50 in chips) 
Seat 4: mishkin2010 ($97.30 in chips) 
Seat 5: SwimmingPooI ($63.95 in chips) 
Seat 6: lulu19911991 ($54.26 in chips) 
Seat 7: lexon3 ($51.59 in chips) 
Seat 8: Nestle170 ($50 in chips) 
Seat 9: Kolyan2114 ($50 in chips) 
mishkin2010: posts small blind $0.25
SwimmingPooI: posts big blind $0.50
*** HOLE CARDS ***
lulu19911991: folds 
lexon3: folds 
Nestle170: folds 
Kolyan2114: folds 
nicu4you: folds 
Seduisant365: folds 
mishkin2010: folds 
Uncalled bet ($0.25) returned to SwimmingPooI
SwimmingPooI collected $0.50 from pot
SwimmingPooI: doesn't show hand 
*** SUMMARY ***
Total pot $0.50 | Rake $0 
Seat 1: nicu4you folded before Flop (didn't bet)
Seat 2: Seduisant365 (button) folded before Flop (didn't bet)
Seat 4: mishkin2010 (small blind) folded before Flop
Seat 5: SwimmingPooI (big blind) collected ($0.50)
Seat 6: lulu19911991 folded before Flop (didn't bet)
Seat 7: lexon3 folded before Flop (didn't bet)
Seat 8: Nestle170 folded before Flop (didn't bet)
Seat 9: Kolyan2114 folded before Flop (didn't bet)



PokerStars Hand #228690562065:  Hold'em No Limit ($0.25/$0.50 USD) - 2021/07/30 17:40:58 ET
Table 'Knysna II' 9-max Seat #4 is the button
Seat 1: nicu4you ($67.41 in chips) 
Seat 2: Seduisant365 ($50 in chips) 
Seat 3: kirsty858 ($50 in chips) 
Seat 4: mishkin2010 ($97.05 in chips) 
Seat 5: SwimmingPooI ($64.20 in chips) 
Seat 6: lulu19911991 ($54.26 in chips) 
Seat 7: lexon3 ($51.59 in chips) 
Seat 8: Nestle170 ($50 in chips) 
Seat 9: Kolyan2114 ($50 in chips) 
SwimmingPooI: posts small blind $0.25
lulu19911991: posts big blind $0.50
kirsty858: posts big blind $0.50
*** HOLE CARDS ***
lexon3: folds 
Nestle170: folds 
Kolyan2114: folds 
nicu4you: folds 
Seduisant365: folds 
kirsty858: raises $1 to $1.50
mishkin2010: calls $1.50
SwimmingPooI: folds 
lulu19911991: folds 
*** FLOP *** [9d Ks Th]
kirsty858: bets $1.78
mishkin2010: calls $1.78
*** TURN *** [9d Ks Th] [5c]
kirsty858: bets $4.23
mishkin2010: calls $4.23
*** RIVER *** [9d Ks Th 5c] [6h]
kirsty858: bets $6.26
mishkin2010: calls $6.26
*** SHOW DOWN ***
kirsty858: shows [Ac Kd] (a pair of Kings)
mishkin2010: shows [Kc Ad] (a pair of Kings)
kirsty858 collected $13.44 from pot
mishkin2010 collected $13.44 from pot
*** SUMMARY ***
Total pot $28.29 | Rake $1.41 
Board [9d Ks Th 5c 6h]
Seat 1: nicu4you folded before Flop (didn't bet)
Seat 2: Seduisant365 folded before Flop (didn't bet)
Seat 3: kirsty858 showed [Ac Kd] and won ($13.44) with a pair of Kings
Seat 4: mishkin2010 (button) showed [Kc Ad] and won ($13.44) with a pair of Kings
Seat 5: SwimmingPooI (small blind) folded before Flop
Seat 6: lulu19911991 (big blind) folded before Flop
Seat 7: lexon3 folded before Flop (didn't bet)
Seat 8: Nestle170 folded before Flop (didn't bet)
Seat 9: Kolyan2114 folded before Flop (didn't bet)



PokerStars Hand #228690596709:  Hold'em No Limit ($0.25/$0.50 USD) - 2021/07/30 17:42:16 ET
Table 'Knysna II' 9-max Seat #5 is the button
Seat 1: nicu4you ($67.41 in chips) 
Seat 2: Seduisant365 ($50 in chips) 
Seat 3: kirsty858 ($49.67 in chips) 
Seat 4: mishkin2010 ($96.72 in chips) 
Seat 5: SwimmingPooI ($63.95 in chips) 
Seat 6: lulu19911991 ($53.76 in chips) 
Seat 7: lexon3 ($51.59 in chips) 
Seat 8: Nestle170 ($50 in chips) 
Seat 9: Kolyan2114 ($50 in chips) 
lulu19911991: posts small blind $0.25
lexon3: posts big blind $0.50
*** HOLE CARDS ***
Nestle170: folds 
Kolyan2114: folds 
nicu4you: folds 
Seduisant365: folds 
kirsty858: folds 
mishkin2010: folds 
SwimmingPooI: raises $0.75 to $1.25
lulu19911991: folds 
lexon3: folds 
Uncalled bet ($0.75) returned to SwimmingPooI
SwimmingPooI collected $1.25 from pot
SwimmingPooI: doesn't show hand 
*** SUMMARY ***
Total pot $1.25 | Rake $0 
Seat 1: nicu4you folded before Flop (didn't bet)
Seat 2: Seduisant365 folded before Flop (didn't bet)
Seat 3: kirsty858 folded before Flop (didn't bet)
Seat 4: mishkin2010 folded before Flop (didn't bet)
Seat 5: SwimmingPooI (button) collected ($1.25)
Seat 6: lulu19911991 (small blind) folded before Flop
Seat 7: lexon3 (big blind) folded before Flop
Seat 8: Nestle170 folded before Flop (didn't bet)
Seat 9: Kolyan2114 folded before Flop (didn't bet)



PokerStars Hand #228690606786:  Hold'em No Limit ($0.25/$0.50 USD) - 2021/07/30 17:42:39 ET
Table 'Knysna II' 9-max Seat #6 is the button
Seat 1: nicu4you ($67.41 in chips) 
Seat 2: Seduisant365 ($50 in chips) 
Seat 3: kirsty858 ($49.67 in chips) 
Seat 4: mishkin2010 ($96.72 in chips) 
Seat 5: SwimmingPooI ($64.70 in chips) 
Seat 6: lulu19911991 ($53.51 in chips) 
Seat 7: lexon3 ($51.09 in chips) 
Seat 8: Nestle170 ($50 in chips) 
Seat 9: Kolyan2114 ($50 in chips) 
lexon3: posts small blind $0.25
Nestle170: posts big blind $0.50
*** HOLE CARDS ***
Kolyan2114: folds 
nicu4you: folds 
Seduisant365: raises $0.75 to $1.25
kirsty858: calls $1.25
mishkin2010: calls $1.25
SwimmingPooI: folds 
lulu19911991: folds 
lexon3: folds 
Nestle170: folds 
*** FLOP *** [Td Th 7s]
Seduisant365: checks 
kirsty858: checks 
mishkin2010: bets $3.64
Seduisant365: folds 
kirsty858: calls $3.64
*** TURN *** [Td Th 7s] [4c]
kirsty858: checks 
mishkin2010: checks 
*** RIVER *** [Td Th 7s 4c] [8s]
kirsty858: bets $2
mishkin2010: calls $2
*** SHOW DOWN ***
kirsty858: shows [Ts Ac] (three of a kind, Tens)
mishkin2010: mucks hand 
kirsty858 collected $14.99 from pot
*** SUMMARY ***
Total pot $15.78 | Rake $0.79 
Board [Td Th 7s 4c 8s]
Seat 1: nicu4you folded before Flop (didn't bet)
Seat 2: Seduisant365 folded on the Flop
Seat 3: kirsty858 showed [Ts Ac] and won ($14.99) with three of a kind, Tens
Seat 4: mishkin2010 mucked
Seat 5: SwimmingPooI folded before Flop (didn't bet)
Seat 6: lulu19911991 (button) folded before Flop (didn't bet)
Seat 7: lexon3 (small blind) folded before Flop
Seat 8: Nestle170 (big blind) folded before Flop
Seat 9: Kolyan2114 folded before Flop (didn't bet)



PokerStars Hand #228690640687:  Hold'em No Limit ($0.25/$0.50 USD) - 2021/07/30 17:43:56 ET
Table 'Knysna II' 9-max Seat #7 is the button
Seat 1: nicu4you ($67.41 in chips) 
Seat 2: Seduisant365 ($50 in chips) 
Seat 3: kirsty858 ($57.77 in chips) 
Seat 4: mishkin2010 ($89.83 in chips) 
Seat 5: SwimmingPooI ($64.70 in chips) 
Seat 6: lulu19911991 ($53.51 in chips) 
Seat 7: lexon3 ($50.84 in chips) 
Seat 8: Nestle170 ($50 in chips) 
Seat 9: Kolyan2114 ($50 in chips) 
Nestle170: posts small blind $0.25
Kolyan2114: posts big blind $0.50
*** HOLE CARDS ***
nicu4you: folds 
Seduisant365: folds 
kirsty858: raises $1 to $1.50
mishkin2010: folds 
SwimmingPooI: folds 
lulu19911991: folds 
lexon3: folds 
Nestle170: folds 
Kolyan2114: folds 
Uncalled bet ($1) returned to kirsty858
kirsty858 collected $1.25 from pot
kirsty858: doesn't show hand 
*** SUMMARY ***
Total pot $1.25 | Rake $0 
Seat 1: nicu4you folded before Flop (didn't bet)
Seat 2: Seduisant365 folded before Flop (didn't bet)
Seat 3: kirsty858 collected ($1.25)
Seat 4: mishkin2010 folded before Flop (didn't bet)
Seat 5: SwimmingPooI folded before Flop (didn't bet)
Seat 6: lulu19911991 folded before Flop (didn't bet)
Seat 7: lexon3 (button) folded before Flop (didn't bet)
Seat 8: Nestle170 (small blind) folded before Flop
Seat 9: Kolyan2114 (big blind) folded before Flop



PokerStars Hand #228690659175:  Hold'em No Limit ($0.25/$0.50 USD) - 2021/07/30 17:44:39 ET
Table 'Knysna II' 9-max Seat #8 is the button
Seat 1: nicu4you ($67.41 in chips) 
Seat 2: Seduisant365 ($50 in chips) 
Seat 3: kirsty858 ($58.52 in chips) 
Seat 4: mishkin2010 ($89.83 in chips) 
Seat 5: SwimmingPooI ($64.70 in chips) 
Seat 6: lulu19911991 ($53.51 in chips) 
Seat 7: lexon3 ($50.84 in chips) 
Seat 8: Nestle170 ($50 in chips) 
Seat 9: Kolyan2114 ($50 in chips) 
Kolyan2114: posts small blind $0.25
nicu4you: posts big blind $0.50
*** HOLE CARDS ***
Seduisant365: folds 
kirsty858: folds 
mishkin2010: calls $0.50
SwimmingPooI: folds 
lulu19911991: folds 
lexon3: folds 
Nestle170: raises $1.50 to $2
Kolyan2114: folds 
nicu4you: folds 
mishkin2010: calls $1.50
*** FLOP *** [7d 8d 7s]
mishkin2010: checks 
Nestle170: checks 
*** TURN *** [7d 8d 7s] [7c]
mishkin2010: checks 
Nestle170: checks 
*** RIVER *** [7d 8d 7s 7c] [Ac]
mishkin2010: checks 
Nestle170: checks 
*** SHOW DOWN ***
mishkin2010: shows [8h Kc] (a full house, Sevens full of Eights)
Nestle170: mucks hand 
mishkin2010 collected $4.51 from pot
*** SUMMARY ***
Total pot $4.75 | Rake $0.24 
Board [7d 8d 7s 7c Ac]
Seat 1: nicu4you (big blind) folded before Flop
Seat 2: Seduisant365 folded before Flop (didn't bet)
Seat 3: kirsty858 folded before Flop (didn't bet)
Seat 4: mishkin2010 showed [8h Kc] and won ($4.51) with a full house, Sevens full of Eights
Seat 5: SwimmingPooI folded before Flop (didn't bet)
Seat 6: lulu19911991 folded before Flop (didn't bet)
Seat 7: lexon3 folded before Flop (didn't bet)
Seat 8: Nestle170 (button) mucked
Seat 9: Kolyan2114 (small blind) folded before Flop



PokerStars Hand #228690678085:  Hold'em No Limit ($0.25/$0.50 USD) - 2021/07/30 17:45:22 ET
Table 'Knysna II' 9-max Seat #9 is the button
Seat 1: nicu4you ($66.91 in chips) 
Seat 2: Seduisant365 ($50 in chips) 
Seat 4: mishkin2010 ($92.34 in chips) 
Seat 5: SwimmingPooI ($64.70 in chips) 
Seat 6: lulu19911991 ($53.51 in chips) 
Seat 7: lexon3 ($50.84 in chips) 
Seat 8: Nestle170 ($50 in chips) 
Seat 9: Kolyan2114 ($50 in chips) 
nicu4you: posts small blind $0.25
Seduisant365: posts big blind $0.50
*** HOLE CARDS ***
mishkin2010: raises $0.50 to $1
SwimmingPooI: folds 
lulu19911991: folds 
lexon3: folds 
Nestle170: folds 
Kolyan2114: folds 
nicu4you: folds 
Seduisant365: folds 
Uncalled bet ($0.50) returned to mishkin2010
mishkin2010 collected $1.25 from pot
mishkin2010: doesn't show hand 
*** SUMMARY ***
Total pot $1.25 | Rake $0 
Seat 1: nicu4you (small blind) folded before Flop
Seat 2: Seduisant365 (big blind) folded before Flop
Seat 4: mishkin2010 collected ($1.25)
Seat 5: SwimmingPooI folded before Flop (didn't bet)
Seat 6: lulu19911991 folded before Flop (didn't bet)
Seat 7: lexon3 folded before Flop (didn't bet)
Seat 8: Nestle170 folded before Flop (didn't bet)
Seat 9: Kolyan2114 (button) folded before Flop (didn't bet)



PokerStars Hand #228690687450:  Hold'em No Limit ($0.25/$0.50 USD) - 2021/07/30 17:45:43 ET
Table 'Knysna II' 9-max Seat #1 is the button
Seat 1: nicu4you ($66.66 in chips) 
Seat 2: Seduisant365 ($50 in chips) 
Seat 4: mishkin2010 ($93.09 in chips) 
Seat 5: SwimmingPooI ($64.70 in chips) 
Seat 6: lulu19911991 ($53.51 in chips) 
Seat 7: lexon3 ($50.84 in chips) 
Seat 8: Nestle170 ($50 in chips) 
Seat 9: Kolyan2114 ($50 in chips) 
Seduisant365: posts small blind $0.25
mishkin2010: posts big blind $0.50
*** HOLE CARDS ***
SwimmingPooI: folds 
lulu19911991: folds 
lexon3: folds 
Nestle170: folds 
Kolyan2114: folds 
nicu4you: folds 
Seduisant365: folds 
Uncalled bet ($0.25) returned to mishkin2010
mishkin2010 collected $0.50 from pot
mishkin2010: doesn't show hand 
*** SUMMARY ***
Total pot $0.50 | Rake $0 
Seat 1: nicu4you (button) folded before Flop (didn't bet)
Seat 2: Seduisant365 (small blind) folded before Flop
Seat 4: mishkin2010 (big blind) collected ($0.50)
Seat 5: SwimmingPooI folded before Flop (didn't bet)
Seat 6: lulu19911991 folded before Flop (didn't bet)
Seat 7: lexon3 folded before Flop (didn't bet)
Seat 8: Nestle170 folded before Flop (didn't bet)
Seat 9: Kolyan2114 folded before Flop (didn't bet)



PokerStars Hand #228690700057:  Hold'em No Limit ($0.25/$0.50 USD) - 2021/07/30 17:46:12 ET
Table 'Knysna II' 9-max Seat #2 is the button
Seat 1: nicu4you ($66.66 in chips) 
Seat 2: Seduisant365 ($50 in chips) 
Seat 4: mishkin2010 ($93.34 in chips) 
Seat 5: SwimmingPooI ($64.70 in chips) 
Seat 6: lulu19911991 ($53.51 in chips) 
Seat 7: lexon3 ($50.84 in chips) 
Seat 8: Nestle170 ($50 in chips) 
Seat 9: Kolyan2114 ($50 in chips) 
mishkin2010: posts small blind $0.25
SwimmingPooI: posts big blind $0.50
*** HOLE CARDS ***
lulu19911991: folds 
lexon3: folds 
Nestle170: folds 
Kolyan2114: folds 
nicu4you: folds 
Seduisant365: folds 
mishkin2010: raises $0.50 to $1
SwimmingPooI: folds 
Uncalled bet ($0.50) returned to mishkin2010
mishkin2010 collected $1 from pot
mishkin2010: doesn't show hand 
*** SUMMARY ***
Total pot $1 | Rake $0 
Seat 1: nicu4you folded before Flop (didn't bet)
Seat 2: Seduisant365 (button) folded before Flop (didn't bet)
Seat 4: mishkin2010 (small blind) collected ($1)
Seat 5: SwimmingPooI (big blind) folded before Flop
Seat 6: lulu19911991 folded before Flop (didn't bet)
Seat 7: lexon3 folded before Flop (didn't bet)
Seat 8: Nestle170 folded before Flop (didn't bet)
Seat 9: Kolyan2114 folded before Flop (didn't bet)



PokerStars Hand #228690705708:  Hold'em No Limit ($0.25/$0.50 USD) - 2021/07/30 17:46:25 ET
Table 'Knysna II' 9-max Seat #4 is the button
Seat 1: nicu4you ($66.66 in chips) 
Seat 2: Seduisant365 ($50 in chips) 
Seat 4: mishkin2010 ($93.84 in chips) 
Seat 5: SwimmingPooI ($64.20 in chips) 
Seat 6: lulu19911991 ($53.51 in chips) 
Seat 7: lexon3 ($50.84 in chips) 
Seat 8: Nestle170 ($50 in chips) 
Seat 9: Kolyan2114 ($50 in chips) 
SwimmingPooI: posts small blind $0.25
lulu19911991: posts big blind $0.50
*** HOLE CARDS ***
lexon3: raises $1 to $1.50
Nestle170: folds 
Kolyan2114: folds 
nicu4you: folds 
Seduisant365 is disconnected 
Seduisant365 has timed out while disconnected
Seduisant365: folds 
mishkin2010: calls $1.50
SwimmingPooI: folds 
lulu19911991: folds 
*** FLOP *** [Qc Kc Kd]
lexon3: bets $1.19
mishkin2010: folds 
Uncalled bet ($1.19) returned to lexon3
lexon3 collected $3.56 from pot
lexon3: doesn't show hand 
*** SUMMARY ***
Total pot $3.75 | Rake $0.19 
Board [Qc Kc Kd]
Seat 1: nicu4you folded before Flop (didn't bet)
Seat 2: Seduisant365 folded before Flop (didn't bet)
Seat 4: mishkin2010 (button) folded on the Flop
Seat 5: SwimmingPooI (small blind) folded before Flop
Seat 6: lulu19911991 (big blind) folded before Flop
Seat 7: lexon3 collected ($3.56)
Seat 8: Nestle170 folded before Flop (didn't bet)
Seat 9: Kolyan2114 folded before Flop (didn't bet)



PokerStars Hand #228690733124:  Hold'em No Limit ($0.25/$0.50 USD) - 2021/07/30 17:47:29 ET
Table 'Knysna II' 9-max Seat #5 is the button
Seat 1: nicu4you ($66.66 in chips) 
Seat 4: mishkin2010 ($92.34 in chips) 
Seat 5: SwimmingPooI ($63.95 in chips) 
Seat 6: lulu19911991 ($53.01 in chips) 
Seat 7: lexon3 ($52.90 in chips) 
Seat 8: Nestle170 ($50 in chips) 
Seat 9: Kolyan2114 ($50 in chips) 
lulu19911991: posts small blind $0.25
lexon3: posts big blind $0.50
kirsty858: sits out 
*** HOLE CARDS ***
Nestle170: folds 
Kolyan2114: folds 
nicu4you: folds 
mishkin2010: folds 
SwimmingPooI: raises $0.75 to $1.25
lulu19911991: folds 
lexon3: folds 
Uncalled bet ($0.75) returned to SwimmingPooI
SwimmingPooI collected $1.25 from pot
SwimmingPooI: doesn't show hand 
*** SUMMARY ***
Total pot $1.25 | Rake $0 
Seat 1: nicu4you folded before Flop (didn't bet)
Seat 4: mishkin2010 folded before Flop (didn't bet)
Seat 5: SwimmingPooI (button) collected ($1.25)
Seat 6: lulu19911991 (small blind) folded before Flop
Seat 7: lexon3 (big blind) folded before Flop
Seat 8: Nestle170 folded before Flop (didn't bet)
Seat 9: Kolyan2114 folded before Flop (didn't bet)



PokerStars Hand #228690739273:  Hold'em No Limit ($0.25/$0.50 USD) - 2021/07/30 17:47:43 ET
Table 'Knysna II' 9-max Seat #6 is the button
Seat 1: nicu4you ($66.66 in chips) 
Seat 2: Seduisant365 ($50 in chips) 
Seat 3: kirsty858 ($58.52 in chips) 
Seat 4: mishkin2010 ($92.34 in chips) 
Seat 5: SwimmingPooI ($64.70 in chips) 
Seat 6: lulu19911991 ($52.76 in chips) 
Seat 7: lexon3 ($52.40 in chips) 
Seat 8: Nestle170 ($50 in chips) 
Seat 9: Kolyan2114 ($50 in chips) 
lexon3: posts small blind $0.25
Nestle170: posts big blind $0.50
kirsty858: posts small & big blinds $0.75
*** HOLE CARDS ***
Kolyan2114: folds 
nicu4you: folds 
Seduisant365: folds 
kirsty858: checks 
mishkin2010: raises $0.50 to $1
SwimmingPooI: folds 
lulu19911991: folds 
lexon3: folds 
Nestle170: calls $0.50
kirsty858: calls $0.50
*** FLOP *** [9c 4c 8d]
Nestle170: checks 
kirsty858: bets $1.50
mishkin2010: calls $1.50
Nestle170: folds 
*** TURN *** [9c 4c 8d] [Js]
kirsty858: bets $3.09
mishkin2010: folds 
Uncalled bet ($3.09) returned to kirsty858
kirsty858 collected $6.18 from pot
*** SUMMARY ***
Total pot $6.50 | Rake $0.32 
Board [9c 4c 8d Js]
Seat 1: nicu4you folded before Flop (didn't bet)
Seat 2: Seduisant365 folded before Flop (didn't bet)
Seat 3: kirsty858 collected ($6.18)
Seat 4: mishkin2010 folded on the Turn
Seat 5: SwimmingPooI folded before Flop (didn't bet)
Seat 6: lulu19911991 (button) folded before Flop (didn't bet)
Seat 7: lexon3 (small blind) folded before Flop
Seat 8: Nestle170 (big blind) folded on the Flop
Seat 9: Kolyan2114 folded before Flop (didn't bet)



PokerStars Hand #228690757031:  Hold'em No Limit ($0.25/$0.50 USD) - 2021/07/30 17:48:25 ET
Table 'Knysna II' 9-max Seat #7 is the button
Seat 1: nicu4you ($66.66 in chips) 
Seat 2: Seduisant365 ($50 in chips) 
Seat 3: kirsty858 ($61.95 in chips) 
Seat 4: mishkin2010 ($89.84 in chips) 
Seat 5: SwimmingPooI ($64.70 in chips) 
Seat 6: lulu19911991 ($52.76 in chips) 
Seat 7: lexon3 ($52.15 in chips) 
Seat 8: Nestle170 ($50 in chips) 
Seat 9: Kolyan2114 ($50 in chips) 
Nestle170: posts small blind $0.25
Kolyan2114: posts big blind $0.50
*** HOLE CARDS ***
nicu4you: folds 
Seduisant365: folds 
kirsty858: folds 
mishkin2010: calls $0.50
SwimmingPooI: folds 
lulu19911991: folds 
lexon3: folds 
Nestle170: folds 
Kolyan2114: checks 
*** FLOP *** [4s 3s Jc]
Kolyan2114: checks 
mishkin2010: checks 
*** TURN *** [4s 3s Jc] [8d]
Kolyan2114: checks 
mishkin2010: checks 
*** RIVER *** [4s 3s Jc 8d] [3c]
Kolyan2114: checks 
mishkin2010: bets $3.69
Kolyan2114: folds 
Uncalled bet ($3.69) returned to mishkin2010
mishkin2010 collected $1.19 from pot
mishkin2010: doesn't show hand 
*** SUMMARY ***
Total pot $1.25 | Rake $0.06 
Board [4s 3s Jc 8d 3c]
Seat 1: nicu4you folded before Flop (didn't bet)
Seat 2: Seduisant365 folded before Flop (didn't bet)
Seat 3: kirsty858 folded before Flop (didn't bet)
Seat 4: mishkin2010 collected ($1.19)
Seat 5: SwimmingPooI folded before Flop (didn't bet)
Seat 6: lulu19911991 folded before Flop (didn't bet)
Seat 7: lexon3 (button) folded before Flop (didn't bet)
Seat 8: Nestle170 (small blind) folded before Flop
Seat 9: Kolyan2114 (big blind) folded on the River



PokerStars Hand #228690832120:  Hold'em No Limit ($0.25/$0.50 USD) - 2021/07/30 17:51:21 ET
Table 'Knysna II' 9-max Seat #2 is the button
Seat 1: nicu4you ($63.91 in chips) 
Seat 2: Seduisant365 ($63.99 in chips) 
Seat 3: kirsty858 ($63.45 in chips) 
Seat 4: mishkin2010 ($80.95 in chips) 
Seat 5: SwimmingPooI ($59.70 in chips) 
Seat 6: lulu19911991 ($52.76 in chips) 
Seat 7: lexon3 ($52.15 in chips) 
Seat 8: Nestle170 ($50 in chips) 
Seat 9: Kolyan2114 ($50 in chips) 
kirsty858: posts small blind $0.25
mishkin2010: posts big blind $0.50
*** HOLE CARDS ***
SwimmingPooI: folds 
lulu19911991: folds 
lexon3: raises $1 to $1.50
Nestle170: folds 
Kolyan2114: folds 
nicu4you: folds 
Seduisant365: folds 
kirsty858: folds 
mishkin2010: calls $1
*** FLOP *** [Ts 2h As]
mishkin2010: checks 
lexon3: checks 
*** TURN *** [Ts 2h As] [6h]
mishkin2010: checks 
lexon3: checks 
*** RIVER *** [Ts 2h As 6h] [8s]
mishkin2010: bets $3.09
lexon3: folds 
Uncalled bet ($3.09) returned to mishkin2010
mishkin2010 collected $3.09 from pot
mishkin2010: doesn't show hand 
*** SUMMARY ***
Total pot $3.25 | Rake $0.16 
Board [Ts 2h As 6h 8s]
Seat 1: nicu4you folded before Flop (didn't bet)
Seat 2: Seduisant365 (button) folded before Flop (didn't bet)
Seat 3: kirsty858 (small blind) folded before Flop
Seat 4: mishkin2010 (big blind) collected ($3.09)
Seat 5: SwimmingPooI folded before Flop (didn't bet)
Seat 6: lulu19911991 folded before Flop (didn't bet)
Seat 7: lexon3 folded on the River
Seat 8: Nestle170 folded before Flop (didn't bet)
Seat 9: Kolyan2114 folded before Flop (didn't bet)



PokerStars Hand #228690852180:  Hold'em No Limit ($0.25/$0.50 USD) - 2021/07/30 17:52:01 ET
Table 'Knysna II' 9-max Seat #3 is the button
Seat 1: nicu4you ($63.91 in chips) 
Seat 2: Seduisant365 ($63.99 in chips) 
Seat 3: kirsty858 ($63.20 in chips) 
Seat 4: mishkin2010 ($82.54 in chips) 
Seat 5: SwimmingPooI ($59.70 in chips) 
Seat 6: lulu19911991 ($52.76 in chips) 
Seat 7: lexon3 ($50.65 in chips) 
Seat 8: Nestle170 ($50 in chips) 
Seat 9: Kolyan2114 ($50 in chips) 
mishkin2010: posts small blind $0.25
SwimmingPooI: posts big blind $0.50
*** HOLE CARDS ***
lulu19911991: folds 
lexon3: folds 
Nestle170: folds 
Kolyan2114: folds 
nicu4you: folds 
Seduisant365: folds 
kirsty858: raises $1 to $1.50
mishkin2010: calls $1.25
SwimmingPooI: folds 
*** FLOP *** [4d Kh Tc]
mishkin2010: checks 
kirsty858: checks 
*** TURN *** [4d Kh Tc] [5d]
mishkin2010: bets $3.32
kirsty858: folds 
Uncalled bet ($3.32) returned to mishkin2010
mishkin2010 collected $3.32 from pot
mishkin2010: doesn't show hand 
*** SUMMARY ***
Total pot $3.50 | Rake $0.18 
Board [4d Kh Tc 5d]
Seat 1: nicu4you folded before Flop (didn't bet)
Seat 2: Seduisant365 folded before Flop (didn't bet)
Seat 3: kirsty858 (button) folded on the Turn
Seat 4: mishkin2010 (small blind) collected ($3.32)
Seat 5: SwimmingPooI (big blind) folded before Flop
Seat 6: lulu19911991 folded before Flop (didn't bet)
Seat 7: lexon3 folded before Flop (didn't bet)
Seat 8: Nestle170 folded before Flop (didn't bet)
Seat 9: Kolyan2114 folded before Flop (didn't bet)



PokerStars Hand #228690871222:  Hold'em No Limit ($0.25/$0.50 USD) - 2021/07/30 17:52:43 ET
Table 'Knysna II' 9-max Seat #4 is the button
Seat 1: nicu4you ($63.91 in chips) 
Seat 2: Seduisant365 ($63.99 in chips) 
Seat 3: kirsty858 ($61.70 in chips) 
Seat 4: mishkin2010 ($84.36 in chips) 
Seat 5: SwimmingPooI ($59.20 in chips) 
Seat 6: lulu19911991 ($52.76 in chips) 
Seat 7: lexon3 ($50.65 in chips) 
Seat 8: Nestle170 ($50 in chips) 
Seat 9: Kolyan2114 ($50 in chips) 
SwimmingPooI: posts small blind $0.25
lulu19911991: posts big blind $0.50
*** HOLE CARDS ***
lexon3: folds 
Nestle170: folds 
Kolyan2114: folds 
nicu4you: raises $1 to $1.50
Seduisant365: folds 
kirsty858: folds 
mishkin2010: folds 
SwimmingPooI: folds 
lulu19911991: folds 
Uncalled bet ($1) returned to nicu4you
nicu4you collected $1.25 from pot
nicu4you: doesn't show hand 
*** SUMMARY ***
Total pot $1.25 | Rake $0 
Seat 1: nicu4you collected ($1.25)
Seat 2: Seduisant365 folded before Flop (didn't bet)
Seat 3: kirsty858 folded before Flop (didn't bet)
Seat 4: mishkin2010 (button) folded before Flop (didn't bet)
Seat 5: SwimmingPooI (small blind) folded before Flop
Seat 6: lulu19911991 (big blind) folded before Flop
Seat 7: lexon3 folded before Flop (didn't bet)
Seat 8: Nestle170 folded before Flop (didn't bet)
Seat 9: Kolyan2114 folded before Flop (didn't bet)



PokerStars Hand #228690878944:  Hold'em No Limit ($0.25/$0.50 USD) - 2021/07/30 17:53:01 ET
Table 'Knysna II' 9-max Seat #5 is the button
Seat 1: nicu4you ($64.66 in chips) 
Seat 2: Seduisant365 ($63.99 in chips) 
Seat 3: kirsty858 ($61.70 in chips) 
Seat 4: mishkin2010 ($84.36 in chips) 
Seat 5: SwimmingPooI ($58.95 in chips) 
Seat 6: lulu19911991 ($52.26 in chips) 
Seat 7: lexon3 ($50.65 in chips) 
Seat 8: Nestle170 ($50 in chips) 
Seat 9: Kolyan2114 ($50 in chips) 
lulu19911991: posts small blind $0.25
lexon3: posts big blind $0.50
*** HOLE CARDS ***
Nestle170: folds 
Kolyan2114: folds 
nicu4you: raises $1 to $1.50
Seduisant365: folds 
kirsty858: folds 
mishkin2010: folds 
SwimmingPooI: folds 
lulu19911991: folds 
lexon3: folds 
Uncalled bet ($1) returned to nicu4you
nicu4you collected $1.25 from pot
nicu4you: doesn't show hand 
*** SUMMARY ***
Total pot $1.25 | Rake $0 
Seat 1: nicu4you collected ($1.25)
Seat 2: Seduisant365 folded before Flop (didn't bet)
Seat 3: kirsty858 folded before Flop (didn't bet)
Seat 4: mishkin2010 folded before Flop (didn't bet)
Seat 5: SwimmingPooI (button) folded before Flop (didn't bet)
Seat 6: lulu19911991 (small blind) folded before Flop
Seat 7: lexon3 (big blind) folded before Flop
Seat 8: Nestle170 folded before Flop (didn't bet)
Seat 9: Kolyan2114 folded before Flop (didn't bet)



PokerStars Hand #228690887283:  Hold'em No Limit ($0.25/$0.50 USD) - 2021/07/30 17:53:21 ET
Table 'Knysna II' 9-max Seat #6 is the button
Seat 1: nicu4you ($65.41 in chips) 
Seat 2: Seduisant365 ($63.99 in chips) 
Seat 3: kirsty858 ($61.70 in chips) 
Seat 4: mishkin2010 ($84.36 in chips) 
Seat 5: SwimmingPooI ($58.95 in chips) 
Seat 6: lulu19911991 ($52.01 in chips) 
Seat 7: lexon3 ($50.15 in chips) 
Seat 8: Nestle170 ($50 in chips) 
Seat 9: Kolyan2114 ($50 in chips) 
lexon3: posts small blind $0.25
Nestle170: posts big blind $0.50
*** HOLE CARDS ***
Kolyan2114: folds 
nicu4you: folds 
Seduisant365: folds 
kirsty858: folds 
mishkin2010: folds 
SwimmingPooI: folds 
lulu19911991: folds 
lexon3: raises $1 to $1.50
Nestle170: raises $3.50 to $5
lexon3: folds 
Uncalled bet ($3.50) returned to Nestle170
Nestle170 collected $3 from pot
Nestle170: doesn't show hand 
*** SUMMARY ***
Total pot $3 | Rake $0 
Seat 1: nicu4you folded before Flop (didn't bet)
Seat 2: Seduisant365 folded before Flop (didn't bet)
Seat 3: kirsty858 folded before Flop (didn't bet)
Seat 4: mishkin2010 folded before Flop (didn't bet)
Seat 5: SwimmingPooI folded before Flop (didn't bet)
Seat 6: lulu19911991 (button) folded before Flop (didn't bet)
Seat 7: lexon3 (small blind) folded before Flop
Seat 8: Nestle170 (big blind) collected ($3)
Seat 9: Kolyan2114 folded before Flop (didn't bet)



PokerStars Hand #228690898530:  Hold'em No Limit ($0.25/$0.50 USD) - 2021/07/30 17:53:47 ET
Table 'Knysna II' 9-max Seat #7 is the button
Seat 1: nicu4you ($65.41 in chips) 
Seat 2: Seduisant365 ($63.99 in chips) 
Seat 3: kirsty858 ($61.70 in chips) 
Seat 4: mishkin2010 ($84.36 in chips) 
Seat 5: SwimmingPooI ($58.95 in chips) 
Seat 6: lulu19911991 ($52.01 in chips) 
Seat 7: lexon3 ($50 in chips) 
Seat 8: Nestle170 ($51.50 in chips) 
Seat 9: Kolyan2114 ($50 in chips) 
Nestle170: posts small blind $0.25
Kolyan2114: posts big blind $0.50
*** HOLE CARDS ***
nicu4you: folds 
Seduisant365: folds 
kirsty858: folds 
mishkin2010: calls $0.50
SwimmingPooI: folds 
lulu19911991: folds 
lexon3: raises $1.63 to $2.13
Nestle170: folds 
Kolyan2114: folds 
mishkin2010: folds 
Uncalled bet ($1.63) returned to lexon3
lexon3 collected $1.75 from pot
lexon3: doesn't show hand 
*** SUMMARY ***
Total pot $1.75 | Rake $0 
Seat 1: nicu4you folded before Flop (didn't bet)
Seat 2: Seduisant365 folded before Flop (didn't bet)
Seat 3: kirsty858 folded before Flop (didn't bet)
Seat 4: mishkin2010 folded before Flop
Seat 5: SwimmingPooI folded before Flop (didn't bet)
Seat 6: lulu19911991 folded before Flop (didn't bet)
Seat 7: lexon3 (button) collected ($1.75)
Seat 8: Nestle170 (small blind) folded before Flop
Seat 9: Kolyan2114 (big blind) folded before Flop



PokerStars Hand #228690910611:  Hold'em No Limit ($0.25/$0.50 USD) - 2021/07/30 17:54:15 ET
Table 'Knysna II' 9-max Seat #8 is the button
Seat 1: nicu4you ($65.41 in chips) 
Seat 2: Seduisant365 ($63.99 in chips) 
Seat 3: kirsty858 ($61.70 in chips) 
Seat 4: mishkin2010 ($83.86 in chips) 
Seat 5: SwimmingPooI ($58.95 in chips) 
Seat 6: lulu19911991 ($52.01 in chips) 
Seat 7: lexon3 ($51.25 in chips) 
Seat 8: Nestle170 ($51.25 in chips) 
Seat 9: Kolyan2114 ($50 in chips) 
Kolyan2114: posts small blind $0.25
nicu4you: posts big blind $0.50
*** HOLE CARDS ***
Seduisant365: folds 
kirsty858: folds 
mishkin2010: raises $0.50 to $1
SwimmingPooI: folds 
lulu19911991: folds 
lexon3: folds 
Nestle170: calls $1
Kolyan2114: calls $0.75
nicu4you: calls $0.50
*** FLOP *** [Kh As 2h]
Kolyan2114: checks 
nicu4you: checks 
mishkin2010: checks 
Nestle170: checks 
*** TURN *** [Kh As 2h] [8c]
Kolyan2114: bets $2.89
nicu4you: folds 
mishkin2010: folds 
Nestle170: folds 
Uncalled bet ($2.89) returned to Kolyan2114
Kolyan2114 collected $3.80 from pot
*** SUMMARY ***
Total pot $4 | Rake $0.20 
Board [Kh As 2h 8c]
Seat 1: nicu4you (big blind) folded on the Turn
Seat 2: Seduisant365 folded before Flop (didn't bet)
Seat 3: kirsty858 folded before Flop (didn't bet)
Seat 4: mishkin2010 folded on the Turn
Seat 5: SwimmingPooI folded before Flop (didn't bet)
Seat 6: lulu19911991 folded before Flop (didn't bet)
Seat 7: lexon3 folded before Flop (didn't bet)
Seat 8: Nestle170 (button) folded on the Turn
Seat 9: Kolyan2114 (small blind) collected ($3.80)



PokerStars Hand #228690933462:  Hold'em No Limit ($0.25/$0.50 USD) - 2021/07/30 17:55:10 ET
Table 'Knysna II' 9-max Seat #9 is the button
Seat 1: nicu4you ($64.41 in chips) 
Seat 2: Seduisant365 ($63.99 in chips) 
Seat 3: kirsty858 ($61.70 in chips) 
Seat 4: mishkin2010 ($82.86 in chips) 
Seat 5: SwimmingPooI ($58.95 in chips) 
Seat 6: lulu19911991 ($52.01 in chips) 
Seat 7: lexon3 ($51.25 in chips) 
Seat 8: Nestle170 ($50.25 in chips) 
Seat 9: Kolyan2114 ($52.80 in chips) 
nicu4you: posts small blind $0.25
Seduisant365: posts big blind $0.50
*** HOLE CARDS ***
kirsty858: folds 
mishkin2010: folds 
SwimmingPooI: folds 
lulu19911991: folds 
lexon3: folds 
Nestle170: raises $0.75 to $1.25
Kolyan2114: folds 
nicu4you: folds 
Seduisant365: folds 
Uncalled bet ($0.75) returned to Nestle170
Nestle170 collected $1.25 from pot
Nestle170: doesn't show hand 
*** SUMMARY ***
Total pot $1.25 | Rake $0 
Seat 1: nicu4you (small blind) folded before Flop
Seat 2: Seduisant365 (big blind) folded before Flop
Seat 3: kirsty858 folded before Flop (didn't bet)
Seat 4: mishkin2010 folded before Flop (didn't bet)
Seat 5: SwimmingPooI folded before Flop (didn't bet)
Seat 6: lulu19911991 folded before Flop (didn't bet)
Seat 7: lexon3 folded before Flop (didn't bet)
Seat 8: Nestle170 collected ($1.25)
Seat 9: Kolyan2114 (button) folded before Flop (didn't bet)



PokerStars Hand #228690943359:  Hold'em No Limit ($0.25/$0.50 USD) - 2021/07/30 17:55:41 ET
Table 'Knysna II' 9-max Seat #1 is the button
Seat 1: nicu4you ($64.16 in chips) 
Seat 2: Seduisant365 ($63.49 in chips) 
Seat 3: kirsty858 ($61.70 in chips) 
Seat 4: mishkin2010 ($82.86 in chips) 
Seat 5: SwimmingPooI ($58.95 in chips) 
Seat 6: lulu19911991 ($52.01 in chips) 
Seat 7: lexon3 ($51.25 in chips) 
Seat 8: Nestle170 ($51 in chips) 
Seat 9: Kolyan2114 ($52.80 in chips) 
Seduisant365: posts small blind $0.25
kirsty858: posts big blind $0.50
*** HOLE CARDS ***
mishkin2010: folds 
SwimmingPooI: folds 
lulu19911991: folds 
lexon3: folds 
Nestle170: folds 
Kolyan2114: folds 
nicu4you: folds 
Seduisant365: folds 
Uncalled bet ($0.25) returned to kirsty858
kirsty858 collected $0.50 from pot
*** SUMMARY ***
Total pot $0.50 | Rake $0 
Seat 1: nicu4you (button) folded before Flop (didn't bet)
Seat 2: Seduisant365 (small blind) folded before Flop
Seat 3: kirsty858 (big blind) collected ($0.50)
Seat 4: mishkin2010 folded before Flop (didn't bet)
Seat 5: SwimmingPooI folded before Flop (didn't bet)
Seat 6: lulu19911991 folded before Flop (didn't bet)
Seat 7: lexon3 folded before Flop (didn't bet)
Seat 8: Nestle170 folded before Flop (didn't bet)
Seat 9: Kolyan2114 folded before Flop (didn't bet)



PokerStars Hand #228690950697:  Hold'em No Limit ($0.25/$0.50 USD) - 2021/07/30 17:56:03 ET
Table 'Knysna II' 9-max Seat #2 is the button
Seat 1: nicu4you ($64.16 in chips) 
Seat 2: Seduisant365 ($63.24 in chips) 
Seat 3: kirsty858 ($61.95 in chips) 
Seat 4: mishkin2010 ($82.86 in chips) 
Seat 5: SwimmingPooI ($58.95 in chips) 
Seat 6: lulu19911991 ($52.01 in chips) 
Seat 7: lexon3 ($51.25 in chips) 
Seat 8: Nestle170 ($51 in chips) 
Seat 9: Kolyan2114 ($52.80 in chips) 
kirsty858: posts small blind $0.25
mishkin2010: posts big blind $0.50
*** HOLE CARDS ***
SwimmingPooI: folds 
lulu19911991: folds 
lexon3: folds 
Nestle170: raises $1 to $1.50
Kolyan2114: folds 
nicu4you: folds 
Seduisant365: folds 
kirsty858: folds 
mishkin2010: folds 
Uncalled bet ($1) returned to Nestle170
Nestle170 collected $1.25 from pot
Nestle170: doesn't show hand 
*** SUMMARY ***
Total pot $1.25 | Rake $0 
Seat 1: nicu4you folded before Flop (didn't bet)
Seat 2: Seduisant365 (button) folded before Flop (didn't bet)
Seat 3: kirsty858 (small blind) folded before Flop
Seat 4: mishkin2010 (big blind) folded before Flop
Seat 5: SwimmingPooI folded before Flop (didn't bet)
Seat 6: lulu19911991 folded before Flop (didn't bet)
Seat 7: lexon3 folded before Flop (didn't bet)
Seat 8: Nestle170 collected ($1.25)
Seat 9: Kolyan2114 folded before Flop (didn't bet)



PokerStars Hand #228690958664:  Hold'em No Limit ($0.25/$0.50 USD) - 2021/07/30 17:56:28 ET
Table 'Knysna II' 9-max Seat #3 is the button
Seat 1: nicu4you ($64.16 in chips) 
Seat 2: Seduisant365 ($63.24 in chips) 
Seat 3: kirsty858 ($61.70 in chips) 
Seat 4: mishkin2010 ($82.36 in chips) 
Seat 5: SwimmingPooI ($58.95 in chips) 
Seat 6: lulu19911991 ($52.01 in chips) 
Seat 7: lexon3 ($51.25 in chips) 
Seat 8: Nestle170 ($51.75 in chips) 
Seat 9: Kolyan2114 ($52.80 in chips) 
mishkin2010: posts small blind $0.25
SwimmingPooI: posts big blind $0.50
*** HOLE CARDS ***
lulu19911991: folds 
lexon3: folds 
Nestle170: folds 
Kolyan2114: folds 
nicu4you: folds 
Seduisant365: folds 
kirsty858: raises $1 to $1.50
mishkin2010: calls $1.25
SwimmingPooI: folds 
*** FLOP *** [4c 6c 8h]
mishkin2010: checks 
kirsty858: checks 
*** TURN *** [4c 6c 8h] [Ah]
mishkin2010: bets $0.50
kirsty858: folds 
Uncalled bet ($0.50) returned to mishkin2010
mishkin2010 collected $3.32 from pot
mishkin2010: doesn't show hand 
*** SUMMARY ***
Total pot $3.50 | Rake $0.18 
Board [4c 6c 8h Ah]
Seat 1: nicu4you folded before Flop (didn't bet)
Seat 2: Seduisant365 folded before Flop (didn't bet)
Seat 3: kirsty858 (button) folded on the Turn
Seat 4: mishkin2010 (small blind) collected ($3.32)
Seat 5: SwimmingPooI (big blind) folded before Flop
Seat 6: lulu19911991 folded before Flop (didn't bet)
Seat 7: lexon3 folded before Flop (didn't bet)
Seat 8: Nestle170 folded before Flop (didn't bet)
Seat 9: Kolyan2114 folded before Flop (didn't bet)



PokerStars Hand #228690966532:  Hold'em No Limit ($0.25/$0.50 USD) - 2021/07/30 17:56:52 ET
Table 'Knysna II' 9-max Seat #4 is the button
Seat 1: nicu4you ($64.16 in chips) 
Seat 2: Seduisant365 ($63.24 in chips) 
Seat 3: kirsty858 ($60.20 in chips) 
Seat 4: mishkin2010 ($84.18 in chips) 
Seat 5: SwimmingPooI ($58.45 in chips) 
Seat 6: lulu19911991 ($52.01 in chips) 
Seat 7: lexon3 ($51.25 in chips) 
Seat 8: Nestle170 ($51.75 in chips) 
Seat 9: Kolyan2114 ($52.80 in chips) 
SwimmingPooI: posts small blind $0.25
lulu19911991: posts big blind $0.50
*** HOLE CARDS ***
lexon3: folds 
Nestle170: folds 
Kolyan2114: folds 
nicu4you: folds 
Seduisant365: folds 
kirsty858: folds 
mishkin2010: raises $0.50 to $1
SwimmingPooI: folds 
lulu19911991: folds 
Uncalled bet ($0.50) returned to mishkin2010
mishkin2010 collected $1.25 from pot
mishkin2010: doesn't show hand 
*** SUMMARY ***
Total pot $1.25 | Rake $0 
Seat 1: nicu4you folded before Flop (didn't bet)
Seat 2: Seduisant365 folded before Flop (didn't bet)
Seat 3: kirsty858 folded before Flop (didn't bet)
Seat 4: mishkin2010 (button) collected ($1.25)
Seat 5: SwimmingPooI (small blind) folded before Flop
Seat 6: lulu19911991 (big blind) folded before Flop
Seat 7: lexon3 folded before Flop (didn't bet)
Seat 8: Nestle170 folded before Flop (didn't bet)
Seat 9: Kolyan2114 folded before Flop (didn't bet)



PokerStars Hand #228690973972:  Hold'em No Limit ($0.25/$0.50 USD) - 2021/07/30 17:57:15 ET
Table 'Knysna II' 9-max Seat #5 is the button
Seat 1: nicu4you ($64.16 in chips) 
Seat 2: Seduisant365 ($63.24 in chips) 
Seat 3: kirsty858 ($60.20 in chips) 
Seat 4: mishkin2010 ($84.93 in chips) 
Seat 5: SwimmingPooI ($58.20 in chips) 
Seat 6: lulu19911991 ($51.51 in chips) 
Seat 7: lexon3 ($51.25 in chips) 
Seat 8: Nestle170 ($51.75 in chips) 
Seat 9: Kolyan2114 ($52.80 in chips) 
lulu19911991: posts small blind $0.25
lexon3: posts big blind $0.50
*** HOLE CARDS ***
Nestle170: folds 
Kolyan2114: folds 
nicu4you: raises $1 to $1.50
Seduisant365: folds 
kirsty858: folds 
mishkin2010: calls $1.50
SwimmingPooI: folds 
lulu19911991: folds 
lexon3: folds 
*** FLOP *** [5s 7c 9h]
nicu4you: checks 
mishkin2010: bets $1.50
nicu4you: folds 
Uncalled bet ($1.50) returned to mishkin2010
mishkin2010 collected $3.56 from pot
mishkin2010: doesn't show hand 
*** SUMMARY ***
Total pot $3.75 | Rake $0.19 
Board [5s 7c 9h]
Seat 1: nicu4you folded on the Flop
Seat 2: Seduisant365 folded before Flop (didn't bet)
Seat 3: kirsty858 folded before Flop (didn't bet)
Seat 4: mishkin2010 collected ($3.56)
Seat 5: SwimmingPooI (button) folded before Flop (didn't bet)
Seat 6: lulu19911991 (small blind) folded before Flop
Seat 7: lexon3 (big blind) folded before Flop
Seat 8: Nestle170 folded before Flop (didn't bet)
Seat 9: Kolyan2114 folded before Flop (didn't bet)



PokerStars Hand #228690982760:  Hold'em No Limit ($0.25/$0.50 USD) - 2021/07/30 17:57:42 ET
Table 'Knysna II' 9-max Seat #6 is the button
Seat 1: nicu4you ($62.66 in chips) 
Seat 2: Seduisant365 ($63.24 in chips) 
Seat 3: kirsty858 ($60.20 in chips) 
Seat 4: mishkin2010 ($86.99 in chips) 
Seat 5: SwimmingPooI ($58.20 in chips) 
Seat 6: lulu19911991 ($51.26 in chips) 
Seat 7: lexon3 ($50.75 in chips) 
Seat 8: Nestle170 ($51.75 in chips) 
Seat 9: Kolyan2114 ($52.80 in chips) 
lexon3: posts small blind $0.25
Nestle170: posts big blind $0.50
*** HOLE CARDS ***
Kolyan2114: folds 
nicu4you: folds 
Seduisant365: folds 
kirsty858: folds 
mishkin2010: raises $1 to $1.50
SwimmingPooI: folds 
lulu19911991: folds 
lexon3: folds 
Nestle170: calls $1
*** FLOP *** [2h Tc 2d]
Nestle170: checks 
mishkin2010: checks 
*** TURN *** [2h Tc 2d] [5h]
Nestle170: bets $1.70
mishkin2010: folds 
Uncalled bet ($1.70) returned to Nestle170
Nestle170 collected $3.09 from pot
Nestle170: doesn't show hand 
*** SUMMARY ***
Total pot $3.25 | Rake $0.16 
Board [2h Tc 2d 5h]
Seat 1: nicu4you folded before Flop (didn't bet)
Seat 2: Seduisant365 folded before Flop (didn't bet)
Seat 3: kirsty858 folded before Flop (didn't bet)
Seat 4: mishkin2010 folded on the Turn
Seat 5: SwimmingPooI folded before Flop (didn't bet)
Seat 6: lulu19911991 (button) folded before Flop (didn't bet)
Seat 7: lexon3 (small blind) folded before Flop
Seat 8: Nestle170 (big blind) collected ($3.09)
Seat 9: Kolyan2114 folded before Flop (didn't bet)



PokerStars Hand #228691008042:  Hold'em No Limit ($0.25/$0.50 USD) - 2021/07/30 17:58:14 ET
Table 'Knysna II' 9-max Seat #7 is the button
Seat 1: nicu4you ($62.66 in chips) 
Seat 2: Seduisant365 ($63.24 in chips) 
Seat 3: kirsty858 ($60.20 in chips) 
Seat 4: mishkin2010 ($85.49 in chips) 
Seat 5: SwimmingPooI ($58.20 in chips) 
Seat 6: lulu19911991 ($51.26 in chips) 
Seat 7: lexon3 ($50.50 in chips) 
Seat 8: Nestle170 ($53.34 in chips) 
Seat 9: Kolyan2114 ($52.80 in chips) 
Nestle170: posts small blind $0.25
Kolyan2114: posts big blind $0.50
*** HOLE CARDS ***
nicu4you: folds 
Seduisant365: folds 
kirsty858: folds 
mishkin2010: raises $1 to $1.50
SwimmingPooI: folds 
lulu19911991: folds 
lexon3: folds 
Nestle170: folds 
Kolyan2114: folds 
Uncalled bet ($1) returned to mishkin2010
mishkin2010 collected $1.25 from pot
mishkin2010: doesn't show hand 
*** SUMMARY ***
Total pot $1.25 | Rake $0 
Seat 1: nicu4you folded before Flop (didn't bet)
Seat 2: Seduisant365 folded before Flop (didn't bet)
Seat 3: kirsty858 folded before Flop (didn't bet)
Seat 4: mishkin2010 collected ($1.25)
Seat 5: SwimmingPooI folded before Flop (didn't bet)
Seat 6: lulu19911991 folded before Flop (didn't bet)
Seat 7: lexon3 (button) folded before Flop (didn't bet)
Seat 8: Nestle170 (small blind) folded before Flop
Seat 9: Kolyan2114 (big blind) folded before Flop



PokerStars Hand #228691018059:  Hold'em No Limit ($0.25/$0.50 USD) - 2021/07/30 17:58:44 ET
Table 'Knysna II' 9-max Seat #8 is the button
Seat 1: nicu4you ($62.66 in chips) 
Seat 3: kirsty858 ($60.20 in chips) 
Seat 4: mishkin2010 ($86.24 in chips) 
Seat 5: SwimmingPooI ($58.20 in chips) 
Seat 6: lulu19911991 ($51.26 in chips) 
Seat 7: lexon3 ($50.50 in chips) 
Seat 8: Nestle170 ($53.09 in chips) 
nicu4you: posts small blind $0.25
Seduisant365: is sitting out 
kirsty858: posts big blind $0.50
*** HOLE CARDS ***
Seduisant365 leaves the table
Kolyan2114 leaves the table
mishkin2010: folds 
SwimmingPooI: folds 
lulu19911991: folds 
lexon3: folds 
Nestle170: folds 
nicu4you: folds 
Uncalled bet ($0.25) returned to kirsty858
kirsty858 collected $0.50 from pot
*** SUMMARY ***
Total pot $0.50 | Rake $0 
Seat 1: nicu4you (small blind) folded before Flop
Seat 3: kirsty858 (big blind) collected ($0.50)
Seat 4: mishkin2010 folded before Flop (didn't bet)
Seat 5: SwimmingPooI folded before Flop (didn't bet)
Seat 6: lulu19911991 folded before Flop (didn't bet)
Seat 7: lexon3 folded before Flop (didn't bet)
Seat 8: Nestle170 (button) folded before Flop (didn't bet)



PokerStars Hand #228691022271:  Hold'em No Limit ($0.25/$0.50 USD) - 2021/07/30 17:58:57 ET
Table 'Knysna II' 9-max Seat #1 is the button
Seat 1: nicu4you ($62.41 in chips) 
Seat 3: kirsty858 ($60.45 in chips) 
Seat 4: mishkin2010 ($86.24 in chips) 
Seat 5: SwimmingPooI ($58.20 in chips) 
Seat 6: lulu19911991 ($51.26 in chips) 
Seat 7: lexon3 ($50.50 in chips) 
Seat 8: Nestle170 ($53.09 in chips) 
kirsty858: posts small blind $0.25
mishkin2010: posts big blind $0.50
*** HOLE CARDS ***
SwimmingPooI: folds 
Schwimbob80 joins the table at seat #2 
lulu19911991: folds 
lexon3: folds 
Nestle170: folds 
nicu4you: folds 
kirsty858: folds 
Uncalled bet ($0.25) returned to mishkin2010
mishkin2010 collected $0.50 from pot
mishkin2010: doesn't show hand 
*** SUMMARY ***
Total pot $0.50 | Rake $0 
Seat 1: nicu4you (button) folded before Flop (didn't bet)
Seat 3: kirsty858 (small blind) folded before Flop
Seat 4: mishkin2010 (big blind) collected ($0.50)
Seat 5: SwimmingPooI folded before Flop (didn't bet)
Seat 6: lulu19911991 folded before Flop (didn't bet)
Seat 7: lexon3 folded before Flop (didn't bet)
Seat 8: Nestle170 folded before Flop (didn't bet)



PokerStars Hand #228691028316:  Hold'em No Limit ($0.25/$0.50 USD) - 2021/07/30 17:59:16 ET
Table 'Knysna II' 9-max Seat #3 is the button
Seat 1: nicu4you ($62.41 in chips) 
Seat 3: kirsty858 ($60.20 in chips) 
Seat 4: mishkin2010 ($86.49 in chips) 
Seat 5: SwimmingPooI ($58.20 in chips) 
Seat 6: lulu19911991 ($51.26 in chips) 
Seat 7: lexon3 ($50.50 in chips) 
Seat 8: Nestle170 ($53.09 in chips) 
mishkin2010: posts small blind $0.25
SwimmingPooI: posts big blind $0.50
Schwimbob80: sits out 
*** HOLE CARDS ***
lulu19911991: folds 
lexon3: raises $1 to $1.50
Nestle170: folds 
nicu4you: folds 
kirsty858: folds 
Infinities4 joins the table at seat #9 
mishkin2010: calls $1.25
SwimmingPooI: folds 
*** FLOP *** [6s 5d Kc]
mishkin2010: checks 
lexon3: checks 
*** TURN *** [6s 5d Kc] [3d]
mishkin2010: checks 
lexon3: checks 
*** RIVER *** [6s 5d Kc 3d] [7c]
mishkin2010: bets $2.16
lexon3: folds 
Uncalled bet ($2.16) returned to mishkin2010
mishkin2010 collected $3.32 from pot
mishkin2010: doesn't show hand 
*** SUMMARY ***
Total pot $3.50 | Rake $0.18 
Board [6s 5d Kc 3d 7c]
Seat 1: nicu4you folded before Flop (didn't bet)
Seat 3: kirsty858 (button) folded before Flop (didn't bet)
Seat 4: mishkin2010 (small blind) collected ($3.32)
Seat 5: SwimmingPooI (big blind) folded before Flop
Seat 6: lulu19911991 folded before Flop (didn't bet)
Seat 7: lexon3 folded on the River
Seat 8: Nestle170 folded before Flop (didn't bet)



PokerStars Hand #228691055143:  Hold'em No Limit ($0.25/$0.50 USD) - 2021/07/30 18:00:36 ET
Table 'Knysna II' 9-max Seat #4 is the button
Seat 1: nicu4you ($62.41 in chips) 
Seat 2: Schwimbob80 ($30.29 in chips) 
Seat 3: kirsty858 ($60.20 in chips) 
Seat 4: mishkin2010 ($88.31 in chips) 
Seat 5: SwimmingPooI ($57.70 in chips) 
Seat 7: lexon3 ($50 in chips) 
Seat 8: Nestle170 ($53.09 in chips) 
SwimmingPooI: posts small blind $0.25
lulu19911991: is sitting out 
lexon3: posts big blind $0.50
Infinities4: sits out 
Schwimbob80: posts big blind $0.50
*** HOLE CARDS ***
Nestle170: folds 
nicu4you: folds 
Schwimbob80: checks 
kirsty858: folds 
mishkin2010: calls $0.50
SwimmingPooI: raises $2.50 to $3
lexon3: folds 
Schwimbob80: folds 
mishkin2010: folds 
Uncalled bet ($2.50) returned to SwimmingPooI
SwimmingPooI collected $2 from pot
SwimmingPooI: doesn't show hand 
*** SUMMARY ***
Total pot $2 | Rake $0 
Seat 1: nicu4you folded before Flop (didn't bet)
Seat 2: Schwimbob80 folded before Flop (didn't bet)
Seat 3: kirsty858 folded before Flop (didn't bet)
Seat 4: mishkin2010 (button) folded before Flop
Seat 5: SwimmingPooI (small blind) collected ($2)
Seat 7: lexon3 (big blind) folded before Flop
Seat 8: Nestle170 folded before Flop (didn't bet)



PokerStars Hand #228691062270:  Hold'em No Limit ($0.25/$0.50 USD) - 2021/07/30 18:00:55 ET
Table 'Knysna II' 9-max Seat #5 is the button
Seat 1: nicu4you ($62.41 in chips) 
Seat 2: Schwimbob80 ($29.79 in chips) 
Seat 3: kirsty858 ($60.20 in chips) 
Seat 4: mishkin2010 ($87.81 in chips) 
Seat 5: SwimmingPooI ($59.20 in chips) 
Seat 7: lexon3 ($50 in chips) 
Seat 8: Nestle170 ($53.09 in chips) 
lexon3: posts small blind $0.25
Nestle170: posts big blind $0.50
Infinities4: sits out 
*** HOLE CARDS ***
nicu4you: folds 
Schwimbob80: calls $0.50
kirsty858: folds 
mishkin2010: folds 
SwimmingPooI: folds 
lexon3: folds 
Nestle170: raises $2 to $2.50
Schwimbob80: calls $2
*** FLOP *** [6h 4d Ah]
Nestle170: bets $1.65
Schwimbob80: raises $1.65 to $3.30
Nestle170: calls $1.65
*** TURN *** [6h 4d Ah] [7d]
Nestle170: checks 
Schwimbob80: bets $2.50
Nestle170: folds 
Uncalled bet ($2.50) returned to Schwimbob80
Schwimbob80 collected $11.26 from pot
Schwimbob80: doesn't show hand 
*** SUMMARY ***
Total pot $11.85 | Rake $0.59 
Board [6h 4d Ah 7d]
Seat 1: nicu4you folded before Flop (didn't bet)
Seat 2: Schwimbob80 collected ($11.26)
Seat 3: kirsty858 folded before Flop (didn't bet)
Seat 4: mishkin2010 folded before Flop (didn't bet)
Seat 5: SwimmingPooI (button) folded before Flop (didn't bet)
Seat 7: lexon3 (small blind) folded before Flop
Seat 8: Nestle170 (big blind) folded on the Turn



PokerStars Hand #228691080168:  Hold'em No Limit ($0.25/$0.50 USD) - 2021/07/30 18:01:41 ET
Table 'Knysna II' 9-max Seat #7 is the button
Seat 1: nicu4you ($62.41 in chips) 
Seat 2: Schwimbob80 ($35.25 in chips) 
Seat 3: kirsty858 ($60.20 in chips) 
Seat 4: mishkin2010 ($87.81 in chips) 
Seat 5: SwimmingPooI ($59.20 in chips) 
Seat 7: lexon3 ($50 in chips) 
Seat 8: Nestle170 ($50 in chips) 
Seat 9: Infinities4 ($50 in chips) 
Nestle170: posts small blind $0.25
Infinities4: posts big blind $0.50
*** HOLE CARDS ***
nicu4you: folds 
Schwimbob80: folds 
kirsty858: folds 
mishkin2010: raises $0.50 to $1
SwimmingPooI: folds 
lexon3: folds 
Nestle170: folds 
Infinities4: calls $0.50
*** FLOP *** [9d 3d Ks]
Infinities4: checks 
mishkin2010: bets $1.07
Infinities4: calls $1.07
*** TURN *** [9d 3d Ks] [2s]
Infinities4: checks 
mishkin2010: checks 
*** RIVER *** [9d 3d Ks 2s] [Qc]
Infinities4: bets $1.46
mishkin2010: folds 
Uncalled bet ($1.46) returned to Infinities4
Infinities4 collected $4.17 from pot
Infinities4: doesn't show hand 
*** SUMMARY ***
Total pot $4.39 | Rake $0.22 
Board [9d 3d Ks 2s Qc]
Seat 1: nicu4you folded before Flop (didn't bet)
Seat 2: Schwimbob80 folded before Flop (didn't bet)
Seat 3: kirsty858 folded before Flop (didn't bet)
Seat 4: mishkin2010 folded on the River
Seat 5: SwimmingPooI folded before Flop (didn't bet)
Seat 7: lexon3 (button) folded before Flop (didn't bet)
Seat 8: Nestle170 (small blind) folded before Flop
Seat 9: Infinities4 (big blind) collected ($4.17)



PokerStars Hand #228691113319:  Hold'em No Limit ($0.25/$0.50 USD) - 2021/07/30 18:03:00 ET
Table 'Knysna II' 9-max Seat #8 is the button
Seat 2: Schwimbob80 ($35.25 in chips) 
Seat 3: kirsty858 ($60.20 in chips) 
Seat 4: mishkin2010 ($85.74 in chips) 
Seat 5: SwimmingPooI ($59.20 in chips) 
Seat 7: lexon3 ($50 in chips) 
Seat 8: Nestle170 ($50 in chips) 
Seat 9: Infinities4 ($52.10 in chips) 
Infinities4: posts small blind $0.25
nicu4you: is sitting out 
Schwimbob80: posts big blind $0.50
*** HOLE CARDS ***
nicu4you leaves the table
kirsty858: folds 
mishkin2010: folds 
SwimmingPooI: raises $1 to $1.50
lexon3: folds 
Nestle170: folds 
Infinities4: folds 
MarsMiland joins the table at seat #1 
Schwimbob80: calls $1
*** FLOP *** [9h Ts Qs]
Schwimbob80: bets $1
SwimmingPooI: raises $2.50 to $3.50
Schwimbob80: calls $2.50
*** TURN *** [9h Ts Qs] [9c]
Schwimbob80: bets $3
SwimmingPooI: calls $3
*** RIVER *** [9h Ts Qs 9c] [7d]
Schwimbob80: bets $2
SwimmingPooI: calls $2
*** SHOW DOWN ***
Schwimbob80: shows [Ah Qc] (two pair, Queens and Nines)
SwimmingPooI: mucks hand 
Schwimbob80 collected $19.24 from pot
*** SUMMARY ***
Total pot $20.25 | Rake $1.01 
Board [9h Ts Qs 9c 7d]
Seat 2: Schwimbob80 (big blind) showed [Ah Qc] and won ($19.24) with two pair, Queens and Nines
Seat 3: kirsty858 folded before Flop (didn't bet)
Seat 4: mishkin2010 folded before Flop (didn't bet)
Seat 5: SwimmingPooI mucked
Seat 7: lexon3 folded before Flop (didn't bet)
Seat 8: Nestle170 (button) folded before Flop (didn't bet)
Seat 9: Infinities4 (small blind) folded before Flop



PokerStars Hand #228691139840:  Hold'em No Limit ($0.25/$0.50 USD) - 2021/07/30 18:04:01 ET
Table 'Knysna II' 9-max Seat #9 is the button
Seat 2: Schwimbob80 ($44.49 in chips) 
Seat 3: kirsty858 ($60.20 in chips) 
Seat 4: mishkin2010 ($85.74 in chips) 
Seat 5: SwimmingPooI ($50 in chips) 
Seat 7: lexon3 ($50 in chips) 
Seat 8: Nestle170 ($50 in chips) 
Seat 9: Infinities4 ($51.85 in chips) 
Schwimbob80: posts small blind $0.25
kirsty858: posts big blind $0.50
*** HOLE CARDS ***
mishkin2010: calls $0.50
SwimmingPooI: raises $1 to $1.50
lexon3: folds 
Nestle170: folds 
Infinities4: folds 
Schwimbob80: calls $1.25
kirsty858: folds 
mishkin2010 is disconnected 
mishkin2010 is connected 
mishkin2010: calls $1
*** FLOP *** [5c Td 6d]
Schwimbob80: bets $5
mishkin2010: folds 
SwimmingPooI: folds 
Uncalled bet ($5) returned to Schwimbob80
Schwimbob80 collected $4.75 from pot
Schwimbob80: doesn't show hand 
*** SUMMARY ***
Total pot $5 | Rake $0.25 
Board [5c Td 6d]
Seat 2: Schwimbob80 (small blind) collected ($4.75)
Seat 3: kirsty858 (big blind) folded before Flop
Seat 4: mishkin2010 folded on the Flop
Seat 5: SwimmingPooI folded on the Flop
Seat 7: lexon3 folded before Flop (didn't bet)
Seat 8: Nestle170 folded before Flop (didn't bet)
Seat 9: Infinities4 (button) folded before Flop (didn't bet)



PokerStars Hand #228691163365:  Hold'em No Limit ($0.25/$0.50 USD) - 2021/07/30 18:04:57 ET
Table 'Knysna II' 9-max Seat #2 is the button
Seat 2: Schwimbob80 ($47.74 in chips) 
Seat 3: kirsty858 ($59.70 in chips) 
Seat 4: mishkin2010 ($84.24 in chips) 
Seat 5: SwimmingPooI ($50 in chips) 
Seat 7: lexon3 ($50 in chips) 
Seat 8: Nestle170 ($50 in chips) 
Seat 9: Infinities4 ($51.85 in chips) 
kirsty858: posts small blind $0.25
mishkin2010: posts big blind $0.50
MarsMiland: sits out 
*** HOLE CARDS ***
SwimmingPooI: folds 
lexon3: folds 
Nestle170: raises $1 to $1.50
Infinities4: folds 
Schwimbob80: calls $1.50
kirsty858: raises $2 to $3.50
mishkin2010: folds 
Nestle170: calls $2
Schwimbob80: calls $2
*** FLOP *** [Kc 6h Jc]
kirsty858: bets $5
Nestle170: folds 
Schwimbob80: calls $5
*** TURN *** [Kc 6h Jc] [5c]
kirsty858: checks 
Schwimbob80: bets $7
kirsty858: calls $7
*** RIVER *** [Kc 6h Jc 5c] [Qs]
kirsty858: checks 
Schwimbob80: checks 
*** SHOW DOWN ***
kirsty858: shows [As Js] (a pair of Jacks)
Schwimbob80: shows [2s Ks] (a pair of Kings)
Schwimbob80 collected $33.25 from pot
*** SUMMARY ***
Total pot $35 | Rake $1.75 
Board [Kc 6h Jc 5c Qs]
Seat 2: Schwimbob80 (button) showed [2s Ks] and won ($33.25) with a pair of Kings
Seat 3: kirsty858 (small blind) showed [As Js] and lost with a pair of Jacks
Seat 4: mishkin2010 (big blind) folded before Flop
Seat 5: SwimmingPooI folded before Flop (didn't bet)
Seat 7: lexon3 folded before Flop (didn't bet)
Seat 8: Nestle170 folded on the Flop
Seat 9: Infinities4 folded before Flop (didn't bet)



PokerStars Hand #228691192901:  Hold'em No Limit ($0.25/$0.50 USD) - 2021/07/30 18:06:07 ET
Table 'Knysna II' 9-max Seat #3 is the button
Seat 2: Schwimbob80 ($65.49 in chips) 
Seat 3: kirsty858 ($44.20 in chips) 
Seat 4: mishkin2010 ($83.74 in chips) 
Seat 5: SwimmingPooI ($50 in chips) 
Seat 7: lexon3 ($50 in chips) 
Seat 8: Nestle170 ($50 in chips) 
Seat 9: Infinities4 ($51.85 in chips) 
mishkin2010: posts small blind $0.25
SwimmingPooI: posts big blind $0.50
MarsMiland: sits out 
*** HOLE CARDS ***
lexon3: folds 
Nestle170: folds 
Infinities4: raises $0.74 to $1.24
Schwimbob80: folds 
kirsty858 has timed out
kirsty858: folds 
mishkin2010: folds 
SwimmingPooI: folds 
Uncalled bet ($0.74) returned to Infinities4
Infinities4 collected $1.25 from pot
Infinities4: doesn't show hand 
*** SUMMARY ***
Total pot $1.25 | Rake $0 
Seat 2: Schwimbob80 folded before Flop (didn't bet)
Seat 3: kirsty858 (button) folded before Flop (didn't bet)
Seat 4: mishkin2010 (small blind) folded before Flop
Seat 5: SwimmingPooI (big blind) folded before Flop
Seat 7: lexon3 folded before Flop (didn't bet)
Seat 8: Nestle170 folded before Flop (didn't bet)
Seat 9: Infinities4 collected ($1.25)



PokerStars Hand #228691208642:  Hold'em No Limit ($0.25/$0.50 USD) - 2021/07/30 18:06:44 ET
Table 'Knysna II' 9-max Seat #4 is the button
Seat 2: Schwimbob80 ($65.49 in chips) 
Seat 4: mishkin2010 ($83.49 in chips) 
Seat 5: SwimmingPooI ($50 in chips) 
Seat 7: lexon3 ($50 in chips) 
Seat 8: Nestle170 ($50 in chips) 
Seat 9: Infinities4 ($52.60 in chips) 
SwimmingPooI: posts small blind $0.25
lexon3: posts big blind $0.50
MarsMiland: sits out 
*** HOLE CARDS ***
Nestle170: folds 
Infinities4: folds 
Schwimbob80: calls $0.50
mishkin2010: raises $0.50 to $1
SwimmingPooI: folds 
lexon3: calls $0.50
Schwimbob80: calls $0.50
*** FLOP *** [3c 9d Kd]
lexon3: checks 
Schwimbob80: bets $1.50
mishkin2010: calls $1.50
lexon3: folds 
*** TURN *** [3c 9d Kd] [Qh]
Schwimbob80: checks 
mishkin2010: bets $2.97
Schwimbob80: folds 
Uncalled bet ($2.97) returned to mishkin2010
mishkin2010 collected $5.94 from pot
mishkin2010: doesn't show hand 
*** SUMMARY ***
Total pot $6.25 | Rake $0.31 
Board [3c 9d Kd Qh]
Seat 2: Schwimbob80 folded on the Turn
Seat 4: mishkin2010 (button) collected ($5.94)
Seat 5: SwimmingPooI (small blind) folded before Flop
Seat 7: lexon3 (big blind) folded on the Flop
Seat 8: Nestle170 folded before Flop (didn't bet)
Seat 9: Infinities4 folded before Flop (didn't bet)



PokerStars Hand #228691226702:  Hold'em No Limit ($0.25/$0.50 USD) - 2021/07/30 18:07:27 ET
Table 'Knysna II' 9-max Seat #5 is the button
Seat 2: Schwimbob80 ($62.99 in chips) 
Seat 4: mishkin2010 ($86.93 in chips) 
Seat 5: SwimmingPooI ($50 in chips) 
Seat 7: lexon3 ($50 in chips) 
Seat 8: Nestle170 ($50 in chips) 
Seat 9: Infinities4 ($52.60 in chips) 
lexon3: posts small blind $0.25
Nestle170: posts big blind $0.50
MarsMiland: sits out 
*** HOLE CARDS ***
Infinities4: raises $0.74 to $1.24
Schwimbob80: calls $1.24
mishkin2010: folds 
SwimmingPooI: folds 
mishkin2010 leaves the table
kirsty858 leaves the table
lonely fire joins the table at seat #4 
lexon3: calls $0.99
Nestle170: calls $0.74
*** FLOP *** [Js 3h 4d]
lexon3: bets $3.49
MarsMiland leaves the table
MarinaKraken joins the table at seat #1 
Nestle170: calls $3.49
goldenpig666 joins the table at seat #3 
Infinities4: folds 
Schwimbob80: folds 
*** TURN *** [Js 3h 4d] [Td]
lexon3: bets $8.58
Nestle170: folds 
Uncalled bet ($8.58) returned to lexon3
lexon3 collected $11.34 from pot
lexon3: doesn't show hand 
*** SUMMARY ***
Total pot $11.94 | Rake $0.60 
Board [Js 3h 4d Td]
Seat 2: Schwimbob80 folded on the Flop
Seat 4: mishkin2010 folded before Flop (didn't bet)
Seat 5: SwimmingPooI (button) folded before Flop (didn't bet)
Seat 7: lexon3 (small blind) collected ($11.34)
Seat 8: Nestle170 (big blind) folded on the Turn
Seat 9: Infinities4 folded on the Flop



PokerStars Hand #228691261585:  Hold'em No Limit ($0.25/$0.50 USD) - 2021/07/30 18:08:33 ET
Table 'Knysna II' 9-max Seat #7 is the button
Seat 2: Schwimbob80 ($61.75 in chips) 
Seat 5: SwimmingPooI ($50 in chips) 
Seat 7: lexon3 ($56.61 in chips) 
Seat 8: Nestle170 ($50 in chips) 
Seat 9: Infinities4 ($51.36 in chips) 
Nestle170: posts small blind $0.25
Infinities4: posts big blind $0.50
MarinaKraken: sits out 
goldenpig666: sits out 
lonely fire: sits out 
*** HOLE CARDS ***
Schwimbob80: calls $0.50
SwimmingPooI: folds 
lexon3: folds 
Nestle170: raises $2 to $2.50
Infinities4: folds 
Schwimbob80: calls $2
*** FLOP *** [9d Ah 4h]
Nestle170: bets $2.87
Schwimbob80: folds 
Uncalled bet ($2.87) returned to Nestle170
Nestle170 collected $5.22 from pot
Nestle170: doesn't show hand 
*** SUMMARY ***
Total pot $5.50 | Rake $0.28 
Board [9d Ah 4h]
Seat 2: Schwimbob80 folded on the Flop
Seat 5: SwimmingPooI folded before Flop (didn't bet)
Seat 7: lexon3 (button) folded before Flop (didn't bet)
Seat 8: Nestle170 (small blind) collected ($5.22)
Seat 9: Infinities4 (big blind) folded before Flop



PokerStars Hand #228691281409:  Hold'em No Limit ($0.25/$0.50 USD) - 2021/07/30 18:09:20 ET
Table 'Knysna II' 9-max Seat #8 is the button
Seat 1: MarinaKraken ($50 in chips) 
Seat 2: Schwimbob80 ($59.25 in chips) 
Seat 5: SwimmingPooI ($50 in chips) 
Seat 7: lexon3 ($56.61 in chips) 
Seat 8: Nestle170 ($52.72 in chips) 
Seat 9: Infinities4 ($50.86 in chips) 
Infinities4: posts small blind $0.25
MarinaKraken: posts big blind $0.50
goldenpig666: sits out 
lonely fire: sits out 
lulu19911991: sits out 
*** HOLE CARDS ***
Schwimbob80: folds 
SwimmingPooI: folds 
lexon3: folds 
Nestle170: folds 
Infinities4: raises $0.99 to $1.49
MarinaKraken: raises $3.76 to $5.25
Infinities4: folds 
Uncalled bet ($3.76) returned to MarinaKraken
MarinaKraken collected $2.98 from pot
MarinaKraken: doesn't show hand 
*** SUMMARY ***
Total pot $2.98 | Rake $0 
Seat 1: MarinaKraken (big blind) collected ($2.98)
Seat 2: Schwimbob80 folded before Flop (didn't bet)
Seat 5: SwimmingPooI folded before Flop (didn't bet)
Seat 7: lexon3 folded before Flop (didn't bet)
Seat 8: Nestle170 (button) folded before Flop (didn't bet)
Seat 9: Infinities4 (small blind) folded before Flop



PokerStars Hand #228691291062:  Hold'em No Limit ($0.25/$0.50 USD) - 2021/07/30 18:09:43 ET
Table 'Knysna II' 9-max Seat #9 is the button
Seat 1: MarinaKraken ($51.49 in chips) 
Seat 2: Schwimbob80 ($59.25 in chips) 
Seat 5: SwimmingPooI ($50 in chips) 
Seat 7: lexon3 ($56.61 in chips) 
Seat 8: Nestle170 ($52.72 in chips) 
Seat 9: Infinities4 ($50 in chips) 
MarinaKraken: posts small blind $0.25
Schwimbob80: posts big blind $0.50
goldenpig666: sits out 
lonely fire: sits out 
lulu19911991: sits out 
*** HOLE CARDS ***
SwimmingPooI: folds 
lexon3: folds 
Nestle170: raises $0.75 to $1.25
Infinities4: folds 
MarinaKraken: folds 
Schwimbob80: calls $0.75
*** FLOP *** [3c 5c Tc]
Schwimbob80: bets $1.50
Nestle170: folds 
Uncalled bet ($1.50) returned to Schwimbob80
Schwimbob80 collected $2.61 from pot
Schwimbob80: doesn't show hand 
*** SUMMARY ***
Total pot $2.75 | Rake $0.14 
Board [3c 5c Tc]
Seat 1: MarinaKraken (small blind) folded before Flop
Seat 2: Schwimbob80 (big blind) collected ($2.61)
Seat 5: SwimmingPooI folded before Flop (didn't bet)
Seat 7: lexon3 folded before Flop (didn't bet)
Seat 8: Nestle170 folded on the Flop
Seat 9: Infinities4 (button) folded before Flop (didn't bet)



PokerStars Hand #228691302781:  Hold'em No Limit ($0.25/$0.50 USD) - 2021/07/30 18:10:11 ET
Table 'Knysna II' 9-max Seat #1 is the button
Seat 1: MarinaKraken ($51.24 in chips) 
Seat 2: Schwimbob80 ($60.61 in chips) 
Seat 3: goldenpig666 ($50 in chips) 
Seat 5: SwimmingPooI ($50 in chips) 
Seat 7: lexon3 ($56.61 in chips) 
Seat 8: Nestle170 ($51.47 in chips) 
Seat 9: Infinities4 ($50 in chips) 
Schwimbob80: posts small blind $0.25
goldenpig666: posts big blind $0.50
lonely fire: sits out 
lulu19911991: sits out 
*** HOLE CARDS ***
SwimmingPooI: folds 
lexon3: raises $1 to $1.50
Nestle170: folds 
Infinities4: folds 
MarinaKraken: folds 
Schwimbob80: calls $1.25
goldenpig666: raises $5.50 to $7
lexon3: folds 
Schwimbob80: folds 
Uncalled bet ($5.50) returned to goldenpig666
goldenpig666 collected $4.50 from pot
goldenpig666: doesn't show hand 
*** SUMMARY ***
Total pot $4.50 | Rake $0 
Seat 1: MarinaKraken (button) folded before Flop (didn't bet)
Seat 2: Schwimbob80 (small blind) folded before Flop
Seat 3: goldenpig666 (big blind) collected ($4.50)
Seat 5: SwimmingPooI folded before Flop (didn't bet)
Seat 7: lexon3 folded before Flop
Seat 8: Nestle170 folded before Flop (didn't bet)
Seat 9: Infinities4 folded before Flop (didn't bet)



PokerStars Hand #228691316536:  Hold'em No Limit ($0.25/$0.50 USD) - 2021/07/30 18:10:44 ET
Table 'Knysna II' 9-max Seat #2 is the button
Seat 1: MarinaKraken ($51.24 in chips) 
Seat 2: Schwimbob80 ($59.11 in chips) 
Seat 3: goldenpig666 ($53 in chips) 
Seat 4: lonely fire ($50 in chips) 
Seat 5: SwimmingPooI ($50 in chips) 
Seat 7: lexon3 ($55.11 in chips) 
Seat 8: Nestle170 ($51.47 in chips) 
Seat 9: Infinities4 ($50 in chips) 
goldenpig666: posts small blind $0.25
lonely fire: posts big blind $0.50
lulu19911991: sits out 
*** HOLE CARDS ***
SwimmingPooI: raises $1 to $1.50
lexon3: folds 
Nestle170: folds 
Infinities4: folds 
MarinaKraken: folds 
Schwimbob80: calls $1.50
goldenpig666: folds 
lonely fire: folds 
*** FLOP *** [Jc 5c 3h]
SwimmingPooI: bets $1.82
Schwimbob80: raises $1.82 to $3.64
SwimmingPooI: folds 
Uncalled bet ($1.82) returned to Schwimbob80
Schwimbob80 collected $7.02 from pot
Schwimbob80: doesn't show hand 
*** SUMMARY ***
Total pot $7.39 | Rake $0.37 
Board [Jc 5c 3h]
Seat 1: MarinaKraken folded before Flop (didn't bet)
Seat 2: Schwimbob80 (button) collected ($7.02)
Seat 3: goldenpig666 (small blind) folded before Flop
Seat 4: lonely fire (big blind) folded before Flop
Seat 5: SwimmingPooI folded on the Flop
Seat 7: lexon3 folded before Flop (didn't bet)
Seat 8: Nestle170 folded before Flop (didn't bet)
Seat 9: Infinities4 folded before Flop (didn't bet)



PokerStars Hand #228691331430:  Hold'em No Limit ($0.25/$0.50 USD) - 2021/07/30 18:11:20 ET
Table 'Knysna II' 9-max Seat #3 is the button
Seat 1: MarinaKraken ($51.24 in chips) 
Seat 2: Schwimbob80 ($62.81 in chips) 
Seat 3: goldenpig666 ($52.75 in chips) 
Seat 4: lonely fire ($50 in chips) 
Seat 5: SwimmingPooI ($50 in chips) 
Seat 7: lexon3 ($55.11 in chips) 
Seat 8: Nestle170 ($51.47 in chips) 
Seat 9: Infinities4 ($50 in chips) 
lonely fire: posts small blind $0.25
SwimmingPooI: posts big blind $0.50
lulu19911991: sits out 
*** HOLE CARDS ***
lexon3: folds 
Nestle170: folds 
Infinities4: folds 
MarinaKraken: folds 
Schwimbob80: calls $0.50
goldenpig666: raises $1.50 to $2
lonely fire: raises $4.50 to $6.50
SwimmingPooI: folds 
Schwimbob80: folds 
goldenpig666: calls $4.50
*** FLOP *** [8h 7s 9h]
lonely fire: checks 
goldenpig666: checks 
*** TURN *** [8h 7s 9h] [3h]
lonely fire: checks 
goldenpig666: bets $8.65
SwimmingPooI leaves the table
lonely fire: folds 
Uncalled bet ($8.65) returned to goldenpig666
goldenpig666 collected $13.12 from pot
goldenpig666: doesn't show hand 
*** SUMMARY ***
Total pot $14 | Rake $0.88 
Board [8h 7s 9h 3h]
Seat 1: MarinaKraken folded before Flop (didn't bet)
Seat 2: Schwimbob80 folded before Flop
Seat 3: goldenpig666 (button) collected ($13.12)
Seat 4: lonely fire (small blind) folded on the Turn
Seat 5: SwimmingPooI (big blind) folded before Flop
Seat 7: lexon3 folded before Flop (didn't bet)
Seat 8: Nestle170 folded before Flop (didn't bet)
Seat 9: Infinities4 folded before Flop (didn't bet)



PokerStars Hand #228691359951:  Hold'em No Limit ($0.25/$0.50 USD) - 2021/07/30 18:12:30 ET
Table 'Knysna II' 9-max Seat #4 is the button
Seat 1: MarinaKraken ($51.24 in chips) 
Seat 2: Schwimbob80 ($62.31 in chips) 
Seat 3: goldenpig666 ($59.37 in chips) 
Seat 4: lonely fire ($50 in chips) 
Seat 7: lexon3 ($55.11 in chips) 
Seat 8: Nestle170 ($51.47 in chips) 
Seat 9: Infinities4 ($50 in chips) 
lexon3: posts small blind $0.25
Nestle170: posts big blind $0.50
*** HOLE CARDS ***
MarsMiland joins the table at seat #5 
Infinities4: folds 
MarinaKraken: folds 
Schwimbob80: calls $0.50
goldenpig666: folds 
lonely fire: folds 
lexon3: folds 
Nestle170: checks 
*** FLOP *** [4h 4s 2c]
Nestle170: checks 
Schwimbob80: bets $1.19
Nestle170: folds 
Uncalled bet ($1.19) returned to Schwimbob80
Schwimbob80 collected $1.19 from pot
Schwimbob80: doesn't show hand 
*** SUMMARY ***
Total pot $1.25 | Rake $0.06 
Board [4h 4s 2c]
Seat 1: MarinaKraken folded before Flop (didn't bet)
Seat 2: Schwimbob80 collected ($1.19)
Seat 3: goldenpig666 folded before Flop (didn't bet)
Seat 4: lonely fire (button) folded before Flop (didn't bet)
Seat 7: lexon3 (small blind) folded before Flop
Seat 8: Nestle170 (big blind) folded on the Flop
Seat 9: Infinities4 folded before Flop (didn't bet)



PokerStars Hand #228691372884:  Hold'em No Limit ($0.25/$0.50 USD) - 2021/07/30 18:13:01 ET
Table 'Knysna II' 9-max Seat #7 is the button
Seat 1: MarinaKraken ($51.24 in chips) 
Seat 2: Schwimbob80 ($63 in chips) 
Seat 3: goldenpig666 ($59.37 in chips) 
Seat 4: lonely fire ($50 in chips) 
Seat 7: lexon3 ($54.86 in chips) 
Seat 8: Nestle170 ($50.97 in chips) 
Seat 9: Infinities4 ($50 in chips) 
Nestle170: posts small blind $0.25
Infinities4: posts big blind $0.50
MarsMiland: sits out 
lulu19911991: sits out 
*** HOLE CARDS ***
MarinaKraken: folds 
Schwimbob80: raises $1 to $1.50
goldenpig666: folds 
lonely fire: folds 
lexon3: folds 
Nestle170: folds 
Infinities4: folds 
Uncalled bet ($1) returned to Schwimbob80
Schwimbob80 collected $1.25 from pot
Schwimbob80: doesn't show hand 
*** SUMMARY ***
Total pot $1.25 | Rake $0 
Seat 1: MarinaKraken folded before Flop (didn't bet)
Seat 2: Schwimbob80 collected ($1.25)
Seat 3: goldenpig666 folded before Flop (didn't bet)
Seat 4: lonely fire folded before Flop (didn't bet)
Seat 7: lexon3 (button) folded before Flop (didn't bet)
Seat 8: Nestle170 (small blind) folded before Flop
Seat 9: Infinities4 (big blind) folded before Flop



PokerStars Hand #228691381993:  Hold'em No Limit ($0.25/$0.50 USD) - 2021/07/30 18:13:23 ET
Table 'Knysna II' 9-max Seat #8 is the button
Seat 1: MarinaKraken ($51.24 in chips) 
Seat 2: Schwimbob80 ($63.75 in chips) 
Seat 3: goldenpig666 ($59.37 in chips) 
Seat 4: lonely fire ($50 in chips) 
Seat 7: lexon3 ($54.86 in chips) 
Seat 8: Nestle170 ($50.72 in chips) 
Seat 9: Infinities4 ($50 in chips) 
Infinities4: posts small blind $0.25
MarinaKraken: posts big blind $0.50
MarsMiland: sits out 
lulu19911991: sits out 
*** HOLE CARDS ***
Schwimbob80: raises $1 to $1.50
goldenpig666: folds 
lonely fire: folds 
lexon3: folds 
Nestle170: folds 
Infinities4: folds 
MarinaKraken: folds 
Uncalled bet ($1) returned to Schwimbob80
Schwimbob80 collected $1.25 from pot
Schwimbob80: doesn't show hand 
*** SUMMARY ***
Total pot $1.25 | Rake $0 
Seat 1: MarinaKraken (big blind) folded before Flop
Seat 2: Schwimbob80 collected ($1.25)
Seat 3: goldenpig666 folded before Flop (didn't bet)
Seat 4: lonely fire folded before Flop (didn't bet)
Seat 7: lexon3 folded before Flop (didn't bet)
Seat 8: Nestle170 (button) folded before Flop (didn't bet)
Seat 9: Infinities4 (small blind) folded before Flop



PokerStars Hand #228691396825:  Hold'em No Limit ($0.25/$0.50 USD) - 2021/07/30 18:13:59 ET
Table 'Knysna II' 9-max Seat #9 is the button
Seat 1: MarinaKraken ($50.74 in chips) 
Seat 2: Schwimbob80 ($64.50 in chips) 
Seat 3: goldenpig666 ($59.37 in chips) 
Seat 4: lonely fire ($50 in chips) 
Seat 7: lexon3 ($54.86 in chips) 
Seat 8: Nestle170 ($50.72 in chips) 
Seat 9: Infinities4 ($50 in chips) 
MarinaKraken: posts small blind $0.25
Schwimbob80: posts big blind $0.50
MarsMiland: sits out 
lulu19911991: sits out 
*** HOLE CARDS ***
goldenpig666: raises $1 to $1.50
lonely fire: folds 
lexon3: folds 
Nestle170: folds 
Infinities4: folds 
MarinaKraken: raises $4 to $5.50
Schwimbob80: folds 
goldenpig666: folds 
Uncalled bet ($4) returned to MarinaKraken
MarinaKraken collected $3.50 from pot
MarinaKraken: doesn't show hand 
*** SUMMARY ***
Total pot $3.50 | Rake $0 
Seat 1: MarinaKraken (small blind) collected ($3.50)
Seat 2: Schwimbob80 (big blind) folded before Flop
Seat 3: goldenpig666 folded before Flop
Seat 4: lonely fire folded before Flop (didn't bet)
Seat 7: lexon3 folded before Flop (didn't bet)
Seat 8: Nestle170 folded before Flop (didn't bet)
Seat 9: Infinities4 (button) folded before Flop (didn't bet)



PokerStars Hand #228691405885:  Hold'em No Limit ($0.25/$0.50 USD) - 2021/07/30 18:14:22 ET
Table 'Knysna II' 9-max Seat #1 is the button
Seat 1: MarinaKraken ($52.74 in chips) 
Seat 2: Schwimbob80 ($64 in chips) 
Seat 3: goldenpig666 ($57.87 in chips) 
Seat 4: lonely fire ($50 in chips) 
Seat 7: lexon3 ($54.86 in chips) 
Seat 8: Nestle170 ($50.72 in chips) 
Seat 9: Infinities4 ($50 in chips) 
Schwimbob80: posts small blind $0.25
goldenpig666: posts big blind $0.50
MarsMiland: sits out 
lulu19911991: sits out 
*** HOLE CARDS ***
lonely fire: raises $1 to $1.50
lexon3: folds 
Nestle170: folds 
Infinities4: folds 
MarinaKraken: folds 
Schwimbob80: calls $1.25
goldenpig666: folds 
*** FLOP *** [Jd 2c 7c]
Schwimbob80: bets $1.66
lonely fire: calls $1.66
*** TURN *** [Jd 2c 7c] [8h]
Schwimbob80: bets $2
lonely fire: raises $4 to $6
Schwimbob80: calls $4
*** RIVER *** [Jd 2c 7c 8h] [Kh]
Schwimbob80: bets $6
lonely fire: calls $6
*** SHOW DOWN ***
Schwimbob80: shows [7s 5c] (a pair of Sevens)
lonely fire: shows [Qs Js] (a pair of Jacks)
lonely fire collected $29.28 from pot
*** SUMMARY ***
Total pot $30.82 | Rake $1.54 
Board [Jd 2c 7c 8h Kh]
Seat 1: MarinaKraken (button) folded before Flop (didn't bet)
Seat 2: Schwimbob80 (small blind) showed [7s 5c] and lost with a pair of Sevens
Seat 3: goldenpig666 (big blind) folded before Flop
Seat 4: lonely fire showed [Qs Js] and won ($29.28) with a pair of Jacks
Seat 7: lexon3 folded before Flop (didn't bet)
Seat 8: Nestle170 folded before Flop (didn't bet)
Seat 9: Infinities4 folded before Flop (didn't bet)



PokerStars Hand #228691426191:  Hold'em No Limit ($0.25/$0.50 USD) - 2021/07/30 18:15:11 ET
Table 'Knysna II' 9-max Seat #2 is the button
Seat 1: MarinaKraken ($52.74 in chips) 
Seat 2: Schwimbob80 ($48.84 in chips) 
Seat 3: goldenpig666 ($57.37 in chips) 
Seat 4: lonely fire ($64.12 in chips) 
Seat 7: lexon3 ($54.86 in chips) 
Seat 8: Nestle170 ($50.72 in chips) 
Seat 9: Infinities4 ($50 in chips) 
goldenpig666: posts small blind $0.25
lonely fire: posts big blind $0.50
MarsMiland: sits out 
lulu19911991: sits out 
*** HOLE CARDS ***
lexon3: folds 
Nestle170: folds 
Infinities4: folds 
MarinaKraken: raises $1 to $1.50
Schwimbob80: calls $1.50
goldenpig666: folds 
lonely fire: folds 
*** FLOP *** [Tc 4d 9c]
MarinaKraken: checks 
Schwimbob80: bets $3.56
MarinaKraken: folds 
Uncalled bet ($3.56) returned to Schwimbob80
Schwimbob80 collected $3.56 from pot
Schwimbob80: doesn't show hand 
*** SUMMARY ***
Total pot $3.75 | Rake $0.19 
Board [Tc 4d 9c]
Seat 1: MarinaKraken folded on the Flop
Seat 2: Schwimbob80 (button) collected ($3.56)
Seat 3: goldenpig666 (small blind) folded before Flop
Seat 4: lonely fire (big blind) folded before Flop
Seat 7: lexon3 folded before Flop (didn't bet)
Seat 8: Nestle170 folded before Flop (didn't bet)
Seat 9: Infinities4 folded before Flop (didn't bet)



PokerStars Hand #228691443407:  Hold'em No Limit ($0.25/$0.50 USD) - 2021/07/30 18:15:53 ET
Table 'Knysna II' 9-max Seat #3 is the button
Seat 1: MarinaKraken ($51.24 in chips) 
Seat 2: Schwimbob80 ($50.90 in chips) 
Seat 3: goldenpig666 ($57.12 in chips) 
Seat 4: lonely fire ($63.62 in chips) 
Seat 5: MarsMiland ($50 in chips) 
Seat 7: lexon3 ($54.86 in chips) 
Seat 8: Nestle170 ($50.72 in chips) 
Seat 9: Infinities4 ($50 in chips) 
lonely fire: posts small blind $0.25
MarsMiland: posts big blind $0.50
lulu19911991: sits out 
*** HOLE CARDS ***
lexon3: folds 
Nestle170: raises $1 to $1.50
Infinities4: folds 
MarinaKraken: folds 
Schwimbob80: calls $1.50
goldenpig666: folds 
lonely fire: folds 
MarsMiland: folds 
*** FLOP *** [Tc Ts Ah]
Nestle170: checks 
Schwimbob80: bets $1.78
Nestle170: folds 
Uncalled bet ($1.78) returned to Schwimbob80
Schwimbob80 collected $3.56 from pot
Schwimbob80: doesn't show hand 
*** SUMMARY ***
Total pot $3.75 | Rake $0.19 
Board [Tc Ts Ah]
Seat 1: MarinaKraken folded before Flop (didn't bet)
Seat 2: Schwimbob80 collected ($3.56)
Seat 3: goldenpig666 (button) folded before Flop (didn't bet)
Seat 4: lonely fire (small blind) folded before Flop
Seat 5: MarsMiland (big blind) folded before Flop
Seat 7: lexon3 folded before Flop (didn't bet)
Seat 8: Nestle170 folded on the Flop
Seat 9: Infinities4 folded before Flop (didn't bet)



PokerStars Hand #228691462880:  Hold'em No Limit ($0.25/$0.50 USD) - 2021/07/30 18:16:41 ET
Table 'Knysna II' 9-max Seat #4 is the button
Seat 1: MarinaKraken ($51.24 in chips) 
Seat 2: Schwimbob80 ($52.96 in chips) 
Seat 3: goldenpig666 ($57.12 in chips) 
Seat 4: lonely fire ($63.37 in chips) 
Seat 5: MarsMiland ($50 in chips) 
Seat 6: lulu19911991 ($51.26 in chips) 
Seat 7: lexon3 ($54.86 in chips) 
Seat 8: Nestle170 ($50 in chips) 
Seat 9: Infinities4 ($50 in chips) 
MarsMiland: posts small blind $0.25
lulu19911991: posts big blind $0.50
*** HOLE CARDS ***
lexon3: folds 
Nestle170: folds 
Infinities4: raises $0.74 to $1.24
MarinaKraken: folds 
Schwimbob80: folds 
goldenpig666: folds 
lonely fire: folds 
MarsMiland: folds 
lulu19911991: folds 
Uncalled bet ($0.74) returned to Infinities4
Infinities4 collected $1.25 from pot
Infinities4: doesn't show hand 
*** SUMMARY ***
Total pot $1.25 | Rake $0 
Seat 1: MarinaKraken folded before Flop (didn't bet)
Seat 2: Schwimbob80 folded before Flop (didn't bet)
Seat 3: goldenpig666 folded before Flop (didn't bet)
Seat 4: lonely fire (button) folded before Flop (didn't bet)
Seat 5: MarsMiland (small blind) folded before Flop
Seat 6: lulu19911991 (big blind) folded before Flop
Seat 7: lexon3 folded before Flop (didn't bet)
Seat 8: Nestle170 folded before Flop (didn't bet)
Seat 9: Infinities4 collected ($1.25)



PokerStars Hand #228691473499:  Hold'em No Limit ($0.25/$0.50 USD) - 2021/07/30 18:17:07 ET
Table 'Knysna II' 9-max Seat #5 is the button
Seat 1: MarinaKraken ($51.24 in chips) 
Seat 2: Schwimbob80 ($52.96 in chips) 
Seat 3: goldenpig666 ($57.12 in chips) 
Seat 4: lonely fire ($63.37 in chips) 
Seat 5: MarsMiland ($50 in chips) 
Seat 6: lulu19911991 ($50.76 in chips) 
Seat 7: lexon3 ($54.86 in chips) 
Seat 8: Nestle170 ($50 in chips) 
Seat 9: Infinities4 ($50.75 in chips) 
lulu19911991: posts small blind $0.25
lexon3: posts big blind $0.50
*** HOLE CARDS ***
Nestle170: folds 
Infinities4: folds 
MarinaKraken: folds 
Schwimbob80: folds 
goldenpig666: folds 
lonely fire: folds 
MarsMiland: raises $0.60 to $1.10
lulu19911991: folds 
lexon3: folds 
Uncalled bet ($0.60) returned to MarsMiland
MarsMiland collected $1.25 from pot
MarsMiland: doesn't show hand 
*** SUMMARY ***
Total pot $1.25 | Rake $0 
Seat 1: MarinaKraken folded before Flop (didn't bet)
Seat 2: Schwimbob80 folded before Flop (didn't bet)
Seat 3: goldenpig666 folded before Flop (didn't bet)
Seat 4: lonely fire folded before Flop (didn't bet)
Seat 5: MarsMiland (button) collected ($1.25)
Seat 6: lulu19911991 (small blind) folded before Flop
Seat 7: lexon3 (big blind) folded before Flop
Seat 8: Nestle170 folded before Flop (didn't bet)
Seat 9: Infinities4 folded before Flop (didn't bet)



PokerStars Hand #228691489775:  Hold'em No Limit ($0.25/$0.50 USD) - 2021/07/30 18:17:46 ET
Table 'Knysna II' 9-max Seat #6 is the button
Seat 1: MarinaKraken ($51.24 in chips) 
Seat 2: Schwimbob80 ($52.96 in chips) 
Seat 3: goldenpig666 ($57.12 in chips) 
Seat 4: lonely fire ($63.37 in chips) 
Seat 5: MarsMiland ($50.75 in chips) 
Seat 6: lulu19911991 ($50.51 in chips) 
Seat 7: lexon3 ($54.36 in chips) 
Seat 8: Nestle170 ($50 in chips) 
Seat 9: Infinities4 ($50.75 in chips) 
lexon3: posts small blind $0.25
Nestle170: posts big blind $0.50
*** HOLE CARDS ***
Infinities4: folds 
MarinaKraken: folds 
Schwimbob80: calls $0.50
goldenpig666: raises $1.50 to $2
lonely fire: folds 
MarsMiland: folds 
lulu19911991: folds 
lexon3: folds 
Nestle170: folds 
Schwimbob80: calls $1.50
*** FLOP *** [Jc 5h 2h]
Schwimbob80: bets $2.26
goldenpig666: raises $4.99 to $7.25
Schwimbob80: calls $4.99
*** TURN *** [Jc 5h 2h] [Td]
Schwimbob80: bets $4.50
goldenpig666: raises $4.50 to $9
Schwimbob80: calls $4.50
*** RIVER *** [Jc 5h 2h Td] [Jh]
Schwimbob80: bets $17.70
goldenpig666: folds 
Uncalled bet ($17.70) returned to Schwimbob80
Schwimbob80 collected $35.39 from pot
Schwimbob80: doesn't show hand 
*** SUMMARY ***
Total pot $37.25 | Rake $1.86 
Board [Jc 5h 2h Td Jh]
Seat 1: MarinaKraken folded before Flop (didn't bet)
Seat 2: Schwimbob80 collected ($35.39)
Seat 3: goldenpig666 folded on the River
Seat 4: lonely fire folded before Flop (didn't bet)
Seat 5: MarsMiland folded before Flop (didn't bet)
Seat 6: lulu19911991 (button) folded before Flop (didn't bet)
Seat 7: lexon3 (small blind) folded before Flop
Seat 8: Nestle170 (big blind) folded before Flop
Seat 9: Infinities4 folded before Flop (didn't bet)



PokerStars Hand #228691519253:  Hold'em No Limit ($0.25/$0.50 USD) - 2021/07/30 18:18:59 ET
Table 'Knysna II' 9-max Seat #7 is the button
Seat 1: MarinaKraken ($51.24 in chips) 
Seat 2: Schwimbob80 ($70.10 in chips) 
Seat 3: goldenpig666 ($50 in chips) 
Seat 4: lonely fire ($63.37 in chips) 
Seat 5: MarsMiland ($50.75 in chips) 
Seat 6: lulu19911991 ($50.51 in chips) 
Seat 7: lexon3 ($54.11 in chips) 
Seat 8: Nestle170 ($50 in chips) 
Seat 9: Infinities4 ($50.75 in chips) 
Nestle170: posts small blind $0.25
Infinities4: posts big blind $0.50
*** HOLE CARDS ***
MarinaKraken: folds 
Schwimbob80: calls $0.50
goldenpig666: folds 
lonely fire: folds 
MarsMiland: folds 
lulu19911991: folds 
lexon3: folds 
Nestle170: folds 
Infinities4: checks 
*** FLOP *** [3h 8c Kc]
Infinities4: checks 
Schwimbob80: bets $1.19
Infinities4: folds 
Uncalled bet ($1.19) returned to Schwimbob80
Schwimbob80 collected $1.19 from pot
Schwimbob80: doesn't show hand 
*** SUMMARY ***
Total pot $1.25 | Rake $0.06 
Board [3h 8c Kc]
Seat 1: MarinaKraken folded before Flop (didn't bet)
Seat 2: Schwimbob80 collected ($1.19)
Seat 3: goldenpig666 folded before Flop (didn't bet)
Seat 4: lonely fire folded before Flop (didn't bet)
Seat 5: MarsMiland folded before Flop (didn't bet)
Seat 6: lulu19911991 folded before Flop (didn't bet)
Seat 7: lexon3 (button) folded before Flop (didn't bet)
Seat 8: Nestle170 (small blind) folded before Flop
Seat 9: Infinities4 (big blind) folded on the Flop



PokerStars Hand #228691533124:  Hold'em No Limit ($0.25/$0.50 USD) - 2021/07/30 18:19:34 ET
Table 'Knysna II' 9-max Seat #8 is the button
Seat 1: MarinaKraken ($51.24 in chips) 
Seat 2: Schwimbob80 ($70.79 in chips) 
Seat 3: goldenpig666 ($50 in chips) 
Seat 4: lonely fire ($63.37 in chips) 
Seat 5: MarsMiland ($50.75 in chips) 
Seat 6: lulu19911991 ($50.51 in chips) 
Seat 7: lexon3 ($54.11 in chips) 
Seat 8: Nestle170 ($50 in chips) 
Seat 9: Infinities4 ($50.25 in chips) 
Infinities4: posts small blind $0.25
MarinaKraken: posts big blind $0.50
*** HOLE CARDS ***
Schwimbob80: raises $1.50 to $2
goldenpig666: folds 
lonely fire: folds 
MarsMiland: folds 
lulu19911991: folds 
lexon3: folds 
Nestle170: raises $4 to $6
Infinities4: folds 
MarinaKraken: folds 
Schwimbob80: calls $4
*** FLOP *** [9s Kh Jd]
Schwimbob80: bets $1
Nestle170: raises $7.76 to $8.76
Schwimbob80: folds 
Uncalled bet ($7.76) returned to Nestle170
Nestle170 collected $14.01 from pot
Nestle170: doesn't show hand 
*** SUMMARY ***
Total pot $14.75 | Rake $0.74 
Board [9s Kh Jd]
Seat 1: MarinaKraken (big blind) folded before Flop
Seat 2: Schwimbob80 folded on the Flop
Seat 3: goldenpig666 folded before Flop (didn't bet)
Seat 4: lonely fire folded before Flop (didn't bet)
Seat 5: MarsMiland folded before Flop (didn't bet)
Seat 6: lulu19911991 folded before Flop (didn't bet)
Seat 7: lexon3 folded before Flop (didn't bet)
Seat 8: Nestle170 (button) collected ($14.01)
Seat 9: Infinities4 (small blind) folded before Flop



PokerStars Hand #228691549679:  Hold'em No Limit ($0.25/$0.50 USD) - 2021/07/30 18:20:15 ET
Table 'Knysna II' 9-max Seat #9 is the button
Seat 1: MarinaKraken ($50.74 in chips) 
Seat 2: Schwimbob80 ($63.79 in chips) 
Seat 3: goldenpig666 ($50 in chips) 
Seat 4: lonely fire ($63.37 in chips) 
Seat 5: MarsMiland ($50.75 in chips) 
Seat 6: lulu19911991 ($50.51 in chips) 
Seat 7: lexon3 ($54.11 in chips) 
Seat 8: Nestle170 ($57.01 in chips) 
Seat 9: Infinities4 ($50 in chips) 
MarinaKraken: posts small blind $0.25
Schwimbob80: posts big blind $0.50
*** HOLE CARDS ***
goldenpig666: folds 
lonely fire: folds 
MarsMiland: raises $0.80 to $1.30
lulu19911991: folds 
lexon3: folds 
Nestle170: folds 
Infinities4: folds 
Infinities4 leaves the table
KpNZ12 joins the table at seat #9 
MarinaKraken: folds 
Schwimbob80: calls $0.80
*** FLOP *** [7h 8c 4s]
Schwimbob80: bets $1.50
MarsMiland: calls $1.50
*** TURN *** [7h 8c 4s] [Kc]
Schwimbob80: bets $2.78
MarsMiland: calls $2.78
*** RIVER *** [7h 8c 4s Kc] [As]
Schwimbob80: bets $5.42
MarsMiland: folds 
Uncalled bet ($5.42) returned to Schwimbob80
Schwimbob80 collected $10.84 from pot
Schwimbob80: doesn't show hand 
*** SUMMARY ***
Total pot $11.41 | Rake $0.57 
Board [7h 8c 4s Kc As]
Seat 1: MarinaKraken (small blind) folded before Flop
Seat 2: Schwimbob80 (big blind) collected ($10.84)
Seat 3: goldenpig666 folded before Flop (didn't bet)
Seat 4: lonely fire folded before Flop (didn't bet)
Seat 5: MarsMiland folded on the River
Seat 6: lulu19911991 folded before Flop (didn't bet)
Seat 7: lexon3 folded before Flop (didn't bet)
Seat 8: Nestle170 folded before Flop (didn't bet)
Seat 9: Infinities4 (button) folded before Flop (didn't bet)



PokerStars Hand #228689373374:  Hold'em No Limit ($0.25/$0.50 USD) - 2021/07/30 16:57:56 ET
Table 'Knysna II' 9-max Seat #6 is the button
Seat 1: nicu4you ($51.50 in chips) 
Seat 2: RRBAGGIO77 ($61.89 in chips) 
Seat 3: pirog766 ($35.51 in chips) 
Seat 4: Harley275 ($26.75 in chips) 
Seat 5: SwimmingPooI ($50 in chips) 
Seat 6: lulu19911991 ($61.07 in chips) 
Seat 7: lonely fire ($50 in chips) 
Seat 8: tomekpe ($51.25 in chips) 
Seat 9: wildermorph ($49.11 in chips) 
lonely fire: posts small blind $0.25
tomekpe: posts big blind $0.50
*** HOLE CARDS ***
wildermorph: folds 
nicu4you: folds 
RRBAGGIO77: raises $1 to $1.50
pirog766: folds 
Harley275: calls $1.50
SwimmingPooI: folds 
lulu19911991: calls $1.50
lonely fire: folds 
tomekpe: folds 
*** FLOP *** [9d 9s Ah]
RRBAGGIO77: bets $3.50
Harley275: folds 
lulu19911991: folds 
Uncalled bet ($3.50) returned to RRBAGGIO77
RRBAGGIO77 collected $4.99 from pot
RRBAGGIO77: doesn't show hand 
*** SUMMARY ***
Total pot $5.25 | Rake $0.26 
Board [9d 9s Ah]
Seat 1: nicu4you folded before Flop (didn't bet)
Seat 2: RRBAGGIO77 collected ($4.99)
Seat 3: pirog766 folded before Flop (didn't bet)
Seat 4: Harley275 folded on the Flop
Seat 5: SwimmingPooI folded before Flop (didn't bet)
Seat 6: lulu19911991 (button) folded on the Flop
Seat 7: lonely fire (small blind) folded before Flop
Seat 8: tomekpe (big blind) folded before Flop
Seat 9: wildermorph folded before Flop (didn't bet)



PokerStars Hand #228689391720:  Hold'em No Limit ($0.25/$0.50 USD) - 2021/07/30 16:58:49 ET
Table 'Knysna II' 9-max Seat #7 is the button
Seat 1: nicu4you ($51.50 in chips) 
Seat 2: RRBAGGIO77 ($65.38 in chips) 
Seat 3: pirog766 ($35.51 in chips) 
Seat 4: Harley275 ($25.25 in chips) 
Seat 5: SwimmingPooI ($50 in chips) 
Seat 6: lulu19911991 ($59.57 in chips) 
Seat 7: lonely fire ($50 in chips) 
Seat 8: tomekpe ($50.75 in chips) 
Seat 9: wildermorph ($49.11 in chips) 
tomekpe: posts small blind $0.25
wildermorph: posts big blind $0.50
*** HOLE CARDS ***
nicu4you: folds 
RRBAGGIO77: folds 
pirog766: raises $0.50 to $1
Harley275: folds 
SwimmingPooI: folds 
Harley275 leaves the table
lulu19911991: folds 
lonely fire: folds 
tomekpe: folds 
wildermorph: calls $0.50
*** FLOP *** [Kd 8c 3s]
wildermorph: checks 
pirog766: bets $1.07
wildermorph: folds 
Uncalled bet ($1.07) returned to pirog766
pirog766 collected $2.14 from pot
pirog766: doesn't show hand 
*** SUMMARY ***
Total pot $2.25 | Rake $0.11 
Board [Kd 8c 3s]
Seat 1: nicu4you folded before Flop (didn't bet)
Seat 2: RRBAGGIO77 folded before Flop (didn't bet)
Seat 3: pirog766 collected ($2.14)
Seat 4: Harley275 folded before Flop (didn't bet)
Seat 5: SwimmingPooI folded before Flop (didn't bet)
Seat 6: lulu19911991 folded before Flop (didn't bet)
Seat 7: lonely fire (button) folded before Flop (didn't bet)
Seat 8: tomekpe (small blind) folded before Flop
Seat 9: wildermorph (big blind) folded on the Flop



PokerStars Hand #228689404870:  Hold'em No Limit ($0.25/$0.50 USD) - 2021/07/30 16:59:27 ET
Table 'Knysna II' 9-max Seat #8 is the button
Seat 1: nicu4you ($51.50 in chips) 
Seat 2: RRBAGGIO77 ($65.38 in chips) 
Seat 3: pirog766 ($36.65 in chips) 
Seat 6: lulu19911991 ($59.57 in chips) 
Seat 7: lonely fire ($50 in chips) 
Seat 8: tomekpe ($50.50 in chips) 
Seat 9: wildermorph ($48.11 in chips) 
wildermorph: posts small blind $0.25
nicu4you: posts big blind $0.50
*** HOLE CARDS ***
RRBAGGIO77: folds 
pirog766: folds 
lulu19911991: folds 
lonely fire: folds 
tomekpe: folds 
wildermorph: folds 
Uncalled bet ($0.25) returned to nicu4you
nicu4you collected $0.50 from pot
nicu4you: doesn't show hand 
*** SUMMARY ***
Total pot $0.50 | Rake $0 
Seat 1: nicu4you (big blind) collected ($0.50)
Seat 2: RRBAGGIO77 folded before Flop (didn't bet)
Seat 3: pirog766 folded before Flop (didn't bet)
Seat 6: lulu19911991 folded before Flop (didn't bet)
Seat 7: lonely fire folded before Flop (didn't bet)
Seat 8: tomekpe (button) folded before Flop (didn't bet)
Seat 9: wildermorph (small blind) folded before Flop



PokerStars Hand #228689409356:  Hold'em No Limit ($0.25/$0.50 USD) - 2021/07/30 16:59:40 ET
Table 'Knysna II' 9-max Seat #9 is the button
Seat 1: nicu4you ($51.75 in chips) 
Seat 2: RRBAGGIO77 ($65.38 in chips) 
Seat 3: pirog766 ($36.65 in chips) 
Seat 6: lulu19911991 ($59.57 in chips) 
Seat 7: lonely fire ($50 in chips) 
Seat 8: tomekpe ($50.50 in chips) 
Seat 9: wildermorph ($47.86 in chips) 
nicu4you: posts small blind $0.25
RRBAGGIO77: posts big blind $0.50
*** HOLE CARDS ***
pirog766: folds 
lulu19911991: folds 
lonely fire: folds 
tomekpe: folds 
wildermorph: raises $1 to $1.50
nicu4you: calls $1.25
RRBAGGIO77: calls $1
*** FLOP *** [3h Js 7d]
nicu4you: checks 
RRBAGGIO77: checks 
wildermorph: bets $2.14
nicu4you: calls $2.14
RRBAGGIO77: folds 
*** TURN *** [3h Js 7d] [8s]
mishkin2010 joins the table at seat #4 
nicu4you: checks 
wildermorph: bets $3.67
nicu4you: calls $3.67
*** RIVER *** [3h Js 7d 8s] [Kh]
nicu4you: bets $8.42
wildermorph: calls $8.42
*** SHOW DOWN ***
nicu4you: shows [Jd Kd] (two pair, Kings and Jacks)
wildermorph: mucks hand 
nicu4you collected $31.31 from pot
*** SUMMARY ***
Total pot $32.96 | Rake $1.65 
Board [3h Js 7d 8s Kh]
Seat 1: nicu4you (small blind) showed [Jd Kd] and won ($31.31) with two pair, Kings and Jacks
Seat 2: RRBAGGIO77 (big blind) folded on the Flop
Seat 3: pirog766 folded before Flop (didn't bet)
Seat 6: lulu19911991 folded before Flop (didn't bet)
Seat 7: lonely fire folded before Flop (didn't bet)
Seat 8: tomekpe folded before Flop (didn't bet)
Seat 9: wildermorph (button) mucked



PokerStars Hand #228689439142:  Hold'em No Limit ($0.25/$0.50 USD) - 2021/07/30 17:01:01 ET
Table 'Knysna II' 9-max Seat #1 is the button
Seat 1: nicu4you ($67.33 in chips) 
Seat 2: RRBAGGIO77 ($63.88 in chips) 
Seat 3: pirog766 ($36.65 in chips) 
Seat 4: mishkin2010 ($50 in chips) 
Seat 6: lulu19911991 ($59.57 in chips) 
Seat 7: lonely fire ($50 in chips) 
Seat 8: tomekpe ($50.50 in chips) 
Seat 9: wildermorph ($32.13 in chips) 
RRBAGGIO77: posts small blind $0.25
pirog766: posts big blind $0.50
mishkin2010: posts big blind $0.50
*** HOLE CARDS ***
mishkin2010: checks 
lulu19911991: folds 
lonely fire: folds 
tomekpe: folds 
wildermorph: folds 
nicu4you: folds 
RRBAGGIO77: folds 
pirog766: raises $0.50 to $1
mishkin2010: calls $0.50
*** FLOP *** [8d 8c Tc]
pirog766: checks 
mishkin2010: checks 
*** TURN *** [8d 8c Tc] [8s]
pirog766: checks 
mishkin2010: checks 
*** RIVER *** [8d 8c Tc 8s] [Kc]
pirog766: checks 
mishkin2010: bets $3.14
pirog766: folds 
Uncalled bet ($3.14) returned to mishkin2010
mishkin2010 collected $2.14 from pot
mishkin2010: doesn't show hand 
*** SUMMARY ***
Total pot $2.25 | Rake $0.11 
Board [8d 8c Tc 8s Kc]
Seat 1: nicu4you (button) folded before Flop (didn't bet)
Seat 2: RRBAGGIO77 (small blind) folded before Flop
Seat 3: pirog766 (big blind) folded on the River
Seat 4: mishkin2010 collected ($2.14)
Seat 6: lulu19911991 folded before Flop (didn't bet)
Seat 7: lonely fire folded before Flop (didn't bet)
Seat 8: tomekpe folded before Flop (didn't bet)
Seat 9: wildermorph folded before Flop (didn't bet)



PokerStars Hand #228689458204:  Hold'em No Limit ($0.25/$0.50 USD) - 2021/07/30 17:01:45 ET
Table 'Knysna II' 9-max Seat #2 is the button
Seat 1: nicu4you ($67.33 in chips) 
Seat 2: RRBAGGIO77 ($63.63 in chips) 
Seat 3: pirog766 ($35.65 in chips) 
Seat 4: mishkin2010 ($51.14 in chips) 
Seat 6: lulu19911991 ($59.57 in chips) 
Seat 7: lonely fire ($50 in chips) 
Seat 8: tomekpe ($50.50 in chips) 
Seat 9: wildermorph ($50 in chips) 
pirog766: posts small blind $0.25
mishkin2010: posts big blind $0.50
*** HOLE CARDS ***
lulu19911991: folds 
lonely fire: folds 
tomekpe: folds 
wildermorph: folds 
nicu4you: folds 
RRBAGGIO77 has timed out
RRBAGGIO77: folds 
pirog766: raises $0.50 to $1
mishkin2010: folds 
Uncalled bet ($0.50) returned to pirog766
pirog766 collected $1 from pot
pirog766: doesn't show hand 
*** SUMMARY ***
Total pot $1 | Rake $0 
Seat 1: nicu4you folded before Flop (didn't bet)
Seat 2: RRBAGGIO77 (button) folded before Flop (didn't bet)
Seat 3: pirog766 (small blind) collected ($1)
Seat 4: mishkin2010 (big blind) folded before Flop
Seat 6: lulu19911991 folded before Flop (didn't bet)
Seat 7: lonely fire folded before Flop (didn't bet)
Seat 8: tomekpe folded before Flop (didn't bet)
Seat 9: wildermorph folded before Flop (didn't bet)



PokerStars Hand #228689473103:  Hold'em No Limit ($0.25/$0.50 USD) - 2021/07/30 17:02:17 ET
Table 'Knysna II' 9-max Seat #3 is the button
Seat 1: nicu4you ($67.33 in chips) 
Seat 2: RRBAGGIO77 ($63.63 in chips) 
Seat 3: pirog766 ($36.15 in chips) 
Seat 4: mishkin2010 ($50.64 in chips) 
Seat 6: lulu19911991 ($59.57 in chips) 
Seat 7: lonely fire ($50 in chips) 
Seat 8: tomekpe ($50.50 in chips) 
Seat 9: wildermorph ($50 in chips) 
mishkin2010: posts small blind $0.25
lulu19911991: posts big blind $0.50
*** HOLE CARDS ***
lonely fire: folds 
tomekpe: folds 
wildermorph has timed out
wildermorph: folds 
nicu4you: folds 
RRBAGGIO77: calls $0.50
pirog766: folds 
mishkin2010: calls $0.25
lulu19911991: checks 
*** FLOP *** [5c Js 8s]
mishkin2010: checks 
lulu19911991: bets $1.29
RRBAGGIO77: calls $1.29
mishkin2010: calls $1.29
*** TURN *** [5c Js 8s] [Tc]
wildermorph leaves the table
mishkin2010: checks 
lulu19911991: bets $3.82
RRBAGGIO77: calls $3.82
mishkin2010: calls $3.82
*** RIVER *** [5c Js 8s Tc] [4h]
mishkin2010: checks 
lulu19911991: bets $10.71
RRBAGGIO77: calls $10.71
mishkin2010: raises $34.32 to $45.03 and is all-in
lulu19911991: folds 
BarUnDuck joins the table at seat #9 
RRBAGGIO77: folds 
Uncalled bet ($34.32) returned to mishkin2010
mishkin2010 collected $46.96 from pot
mishkin2010: doesn't show hand 
*** SUMMARY ***
Total pot $48.96 | Rake $2 
Board [5c Js 8s Tc 4h]
Seat 1: nicu4you folded before Flop (didn't bet)
Seat 2: RRBAGGIO77 folded on the River
Seat 3: pirog766 (button) folded before Flop (didn't bet)
Seat 4: mishkin2010 (small blind) collected ($46.96)
Seat 6: lulu19911991 (big blind) folded on the River
Seat 7: lonely fire folded before Flop (didn't bet)
Seat 8: tomekpe folded before Flop (didn't bet)
Seat 9: wildermorph folded before Flop (didn't bet)



PokerStars Hand #228689527882:  Hold'em No Limit ($0.25/$0.50 USD) - 2021/07/30 17:04:14 ET
Table 'Knysna II' 9-max Seat #4 is the button
Seat 1: nicu4you ($67.33 in chips) 
Seat 2: RRBAGGIO77 ($47.31 in chips) 
Seat 3: pirog766 ($36.15 in chips) 
Seat 4: mishkin2010 ($81.28 in chips) 
Seat 6: lulu19911991 ($50 in chips) 
Seat 7: lonely fire ($50 in chips) 
Seat 8: tomekpe ($50.50 in chips) 
lulu19911991: posts small blind $0.25
lonely fire: posts big blind $0.50
BarUnDuck: sits out 
*** HOLE CARDS ***
tomekpe: folds 
nicu4you: raises $0.75 to $1.25
RRBAGGIO77: folds 
pirog766: folds 
mishkin2010: folds 
lulu19911991: folds 
lonely fire: folds 
Uncalled bet ($0.75) returned to nicu4you
nicu4you collected $1.25 from pot
nicu4you: doesn't show hand 
*** SUMMARY ***
Total pot $1.25 | Rake $0 
Seat 1: nicu4you collected ($1.25)
Seat 2: RRBAGGIO77 folded before Flop (didn't bet)
Seat 3: pirog766 folded before Flop (didn't bet)
Seat 4: mishkin2010 (button) folded before Flop (didn't bet)
Seat 6: lulu19911991 (small blind) folded before Flop
Seat 7: lonely fire (big blind) folded before Flop
Seat 8: tomekpe folded before Flop (didn't bet)



PokerStars Hand #228689550924:  Hold'em No Limit ($0.25/$0.50 USD) - 2021/07/30 17:04:57 ET
Table 'Knysna II' 9-max Seat #6 is the button
Seat 1: nicu4you ($68.08 in chips) 
Seat 2: RRBAGGIO77 ($47.31 in chips) 
Seat 3: pirog766 ($36.15 in chips) 
Seat 4: mishkin2010 ($81.28 in chips) 
Seat 6: lulu19911991 ($50 in chips) 
Seat 7: lonely fire ($50 in chips) 
Seat 8: tomekpe ($50.50 in chips) 
lonely fire: posts small blind $0.25
tomekpe: posts big blind $0.50
BarUnDuck: sits out 
SwimmingPooI: sits out 
*** HOLE CARDS ***
nicu4you: folds 
RRBAGGIO77: folds 
pirog766: raises $1 to $1.50
mishkin2010: folds 
RRBAGGIO77 leaves the table
lulu19911991: raises $2.75 to $4.25
lonely fire: folds 
tomekpe: folds 
pirog766: calls $2.75
*** FLOP *** [Ts 8c 2h]
pirog766: checks 
lulu19911991: bets $2.90
pirog766: calls $2.90
*** TURN *** [Ts 8c 2h] [7s]
pirog766: checks 
lulu19911991: checks 
*** RIVER *** [Ts 8c 2h 7s] [2d]
pirog766: bets $29 and is all-in
lulu19911991: folds 
Uncalled bet ($29) returned to pirog766
pirog766 collected $14.30 from pot
pirog766: doesn't show hand 
*** SUMMARY ***
Total pot $15.05 | Rake $0.75 
Board [Ts 8c 2h 7s 2d]
Seat 1: nicu4you folded before Flop (didn't bet)
Seat 2: RRBAGGIO77 folded before Flop (didn't bet)
Seat 3: pirog766 collected ($14.30)
Seat 4: mishkin2010 folded before Flop (didn't bet)
Seat 6: lulu19911991 (button) folded on the River
Seat 7: lonely fire (small blind) folded before Flop
Seat 8: tomekpe (big blind) folded before Flop



PokerStars Hand #228689578932:  Hold'em No Limit ($0.25/$0.50 USD) - 2021/07/30 17:05:56 ET
Table 'Knysna II' 9-max Seat #7 is the button
Seat 1: nicu4you ($68.08 in chips) 
Seat 3: pirog766 ($43.30 in chips) 
Seat 4: mishkin2010 ($81.28 in chips) 
Seat 6: lulu19911991 ($50 in chips) 
Seat 7: lonely fire ($50 in chips) 
Seat 8: tomekpe ($50 in chips) 
Seat 9: BarUnDuck ($20 in chips) 
tomekpe: posts small blind $0.25
BarUnDuck: posts big blind $0.50
SwimmingPooI: sits out 
*** HOLE CARDS ***
nicu4you: folds 
pirog766: raises $0.50 to $1
mishkin2010: folds 
lulu19911991: folds 
lonely fire: folds 
tomekpe: folds 
BarUnDuck: folds 
Uncalled bet ($0.50) returned to pirog766
pirog766 collected $1.25 from pot
pirog766: doesn't show hand 
*** SUMMARY ***
Total pot $1.25 | Rake $0 
Seat 1: nicu4you folded before Flop (didn't bet)
Seat 3: pirog766 collected ($1.25)
Seat 4: mishkin2010 folded before Flop (didn't bet)
Seat 6: lulu19911991 folded before Flop (didn't bet)
Seat 7: lonely fire (button) folded before Flop (didn't bet)
Seat 8: tomekpe (small blind) folded before Flop
Seat 9: BarUnDuck (big blind) folded before Flop



PokerStars Hand #228689585410:  Hold'em No Limit ($0.25/$0.50 USD) - 2021/07/30 17:06:10 ET
Table 'Knysna II' 9-max Seat #8 is the button
Seat 1: nicu4you ($68.08 in chips) 
Seat 3: pirog766 ($44.05 in chips) 
Seat 4: mishkin2010 ($81.28 in chips) 
Seat 6: lulu19911991 ($50 in chips) 
Seat 7: lonely fire ($50 in chips) 
Seat 8: tomekpe ($50 in chips) 
Seat 9: BarUnDuck ($19.50 in chips) 
BarUnDuck: posts small blind $0.25
nicu4you: posts big blind $0.50
SwimmingPooI: sits out 
*** HOLE CARDS ***
pirog766: folds 
mishkin2010: calls $0.50
lulu19911991: raises $1.70 to $2.20
lonely fire: folds 
tomekpe: folds 
BarUnDuck: folds 
theMacGuffin joins the table at seat #2 
nicu4you: raises $5.15 to $7.35
mishkin2010: folds 
lulu19911991: folds 
Uncalled bet ($5.15) returned to nicu4you
nicu4you collected $5.15 from pot
nicu4you: doesn't show hand 
*** SUMMARY ***
Total pot $5.15 | Rake $0 
Seat 1: nicu4you (big blind) collected ($5.15)
Seat 3: pirog766 folded before Flop (didn't bet)
Seat 4: mishkin2010 folded before Flop
Seat 6: lulu19911991 folded before Flop
Seat 7: lonely fire folded before Flop (didn't bet)
Seat 8: tomekpe (button) folded before Flop (didn't bet)
Seat 9: BarUnDuck (small blind) folded before Flop



PokerStars Hand #228689608278:  Hold'em No Limit ($0.25/$0.50 USD) - 2021/07/30 17:06:58 ET
Table 'Knysna II' 9-max Seat #9 is the button
Seat 1: nicu4you ($71.03 in chips) 
Seat 2: theMacGuffin ($50 in chips) 
Seat 3: pirog766 ($44.05 in chips) 
Seat 4: mishkin2010 ($80.78 in chips) 
Seat 6: lulu19911991 ($50 in chips) 
Seat 7: lonely fire ($50 in chips) 
Seat 8: tomekpe ($50 in chips) 
Seat 9: BarUnDuck ($20 in chips) 
nicu4you: posts small blind $0.25
theMacGuffin: posts big blind $0.50
SwimmingPooI: sits out 
*** HOLE CARDS ***
pirog766: folds 
mishkin2010: calls $0.50
lulu19911991: folds 
lonely fire: folds 
tomekpe: raises $1.57 to $2.07
BarUnDuck: folds 
nicu4you: folds 
theMacGuffin: folds 
mishkin2010: calls $1.57
*** FLOP *** [3h As 2h]
mishkin2010: checks 
tomekpe: bets $2.56
mishkin2010: calls $2.56
*** TURN *** [3h As 2h] [3s]
mishkin2010: checks 
tomekpe: bets $6.75
mishkin2010: calls $6.75
*** RIVER *** [3h As 2h 3s] [Ac]
mishkin2010: checks 
tomekpe: bets $4.75
mishkin2010: folds 
Uncalled bet ($4.75) returned to tomekpe
tomekpe collected $22.33 from pot
tomekpe: doesn't show hand 
*** SUMMARY ***
Total pot $23.51 | Rake $1.18 
Board [3h As 2h 3s Ac]
Seat 1: nicu4you (small blind) folded before Flop
Seat 2: theMacGuffin (big blind) folded before Flop
Seat 3: pirog766 folded before Flop (didn't bet)
Seat 4: mishkin2010 folded on the River
Seat 6: lulu19911991 folded before Flop (didn't bet)
Seat 7: lonely fire folded before Flop (didn't bet)
Seat 8: tomekpe collected ($22.33)
Seat 9: BarUnDuck (button) folded before Flop (didn't bet)



PokerStars Hand #228689658700:  Hold'em No Limit ($0.25/$0.50 USD) - 2021/07/30 17:08:45 ET
Table 'Knysna II' 9-max Seat #1 is the button
Seat 1: nicu4you ($70.78 in chips) 
Seat 2: theMacGuffin ($49.50 in chips) 
Seat 3: pirog766 ($44.05 in chips) 
Seat 4: mishkin2010 ($69.40 in chips) 
Seat 6: lulu19911991 ($50 in chips) 
Seat 7: lonely fire ($50 in chips) 
Seat 8: tomekpe ($60.95 in chips) 
Seat 9: BarUnDuck ($20 in chips) 
theMacGuffin: posts small blind $0.25
pirog766: posts big blind $0.50
SwimmingPooI: sits out 
*** HOLE CARDS ***
mishkin2010: calls $0.50
lulu19911991: folds 
lonely fire: folds 
tomekpe: folds 
BarUnDuck: folds 
nicu4you: folds 
theMacGuffin: calls $0.25
pirog766: checks 
*** FLOP *** [6c 3d Td]
theMacGuffin: checks 
pirog766: checks 
mishkin2010: bets $1.92
theMacGuffin: folds 
pirog766: calls $1.92
*** TURN *** [6c 3d Td] [Kd]
pirog766: checks 
mishkin2010: bets $2.53
pirog766: folds 
Uncalled bet ($2.53) returned to mishkin2010
mishkin2010 collected $5.07 from pot
mishkin2010: doesn't show hand 
*** SUMMARY ***
Total pot $5.34 | Rake $0.27 
Board [6c 3d Td Kd]
Seat 1: nicu4you (button) folded before Flop (didn't bet)
Seat 2: theMacGuffin (small blind) folded on the Flop
Seat 3: pirog766 (big blind) folded on the Turn
Seat 4: mishkin2010 collected ($5.07)
Seat 6: lulu19911991 folded before Flop (didn't bet)
Seat 7: lonely fire folded before Flop (didn't bet)
Seat 8: tomekpe folded before Flop (didn't bet)
Seat 9: BarUnDuck folded before Flop (didn't bet)



PokerStars Hand #228689676563:  Hold'em No Limit ($0.25/$0.50 USD) - 2021/07/30 17:09:23 ET
Table 'Knysna II' 9-max Seat #2 is the button
Seat 1: nicu4you ($70.78 in chips) 
Seat 2: theMacGuffin ($49 in chips) 
Seat 3: pirog766 ($41.63 in chips) 
Seat 4: mishkin2010 ($72.05 in chips) 
Seat 6: lulu19911991 ($50 in chips) 
Seat 7: lonely fire ($50 in chips) 
Seat 8: tomekpe ($60.95 in chips) 
Seat 9: BarUnDuck ($20 in chips) 
pirog766: posts small blind $0.25
mishkin2010: posts big blind $0.50
SwimmingPooI: sits out 
*** HOLE CARDS ***
lulu19911991: folds 
lonely fire: raises $1 to $1.50
tomekpe: folds 
BarUnDuck: folds 
nicu4you: folds 
theMacGuffin: folds 
pirog766: calls $1.25
mishkin2010: calls $1
*** FLOP *** [6d 4s 7c]
pirog766: checks 
mishkin2010: checks 
lonely fire: checks 
*** TURN *** [6d 4s 7c] [4h]
pirog766: checks 
mishkin2010: checks 
lonely fire: checks 
*** RIVER *** [6d 4s 7c 4h] [Jh]
pirog766: checks 
mishkin2010: bets $2.14
lonely fire: folds 
pirog766: folds 
Uncalled bet ($2.14) returned to mishkin2010
mishkin2010 collected $4.28 from pot
mishkin2010: doesn't show hand 
*** SUMMARY ***
Total pot $4.50 | Rake $0.22 
Board [6d 4s 7c 4h Jh]
Seat 1: nicu4you folded before Flop (didn't bet)
Seat 2: theMacGuffin (button) folded before Flop (didn't bet)
Seat 3: pirog766 (small blind) folded on the River
Seat 4: mishkin2010 (big blind) collected ($4.28)
Seat 6: lulu19911991 folded before Flop (didn't bet)
Seat 7: lonely fire folded on the River
Seat 8: tomekpe folded before Flop (didn't bet)
Seat 9: BarUnDuck folded before Flop (didn't bet)



PokerStars Hand #228689698440:  Hold'em No Limit ($0.25/$0.50 USD) - 2021/07/30 17:10:09 ET
Table 'Knysna II' 9-max Seat #3 is the button
Seat 1: nicu4you ($70.78 in chips) 
Seat 2: theMacGuffin ($49 in chips) 
Seat 3: pirog766 ($40.13 in chips) 
Seat 4: mishkin2010 ($74.83 in chips) 
Seat 5: SwimmingPooI ($50 in chips) 
Seat 6: lulu19911991 ($50 in chips) 
Seat 7: lonely fire ($50 in chips) 
Seat 8: tomekpe ($60.95 in chips) 
Seat 9: BarUnDuck ($20 in chips) 
mishkin2010: posts small blind $0.25
SwimmingPooI: posts big blind $0.50
*** HOLE CARDS ***
lulu19911991: folds 
lonely fire: folds 
tomekpe: folds 
BarUnDuck: folds 
nicu4you: folds 
theMacGuffin: raises $1 to $1.50
pirog766: folds 
mishkin2010: calls $1.25
SwimmingPooI: calls $1
*** FLOP *** [2h 3d 9s]
mishkin2010: checks 
SwimmingPooI: checks 
theMacGuffin: checks 
*** TURN *** [2h 3d 9s] [4h]
mishkin2010: checks 
SwimmingPooI: bets $2.50
theMacGuffin: calls $2.50
mishkin2010: folds 
*** RIVER *** [2h 3d 9s 4h] [2c]
SwimmingPooI: bets $6.50
theMacGuffin: folds 
Uncalled bet ($6.50) returned to SwimmingPooI
SwimmingPooI collected $9.02 from pot
SwimmingPooI: doesn't show hand 
*** SUMMARY ***
Total pot $9.50 | Rake $0.48 
Board [2h 3d 9s 4h 2c]
Seat 1: nicu4you folded before Flop (didn't bet)
Seat 2: theMacGuffin folded on the River
Seat 3: pirog766 (button) folded before Flop (didn't bet)
Seat 4: mishkin2010 (small blind) folded on the Turn
Seat 5: SwimmingPooI (big blind) collected ($9.02)
Seat 6: lulu19911991 folded before Flop (didn't bet)
Seat 7: lonely fire folded before Flop (didn't bet)
Seat 8: tomekpe folded before Flop (didn't bet)
Seat 9: BarUnDuck folded before Flop (didn't bet)



PokerStars Hand #228689722933:  Hold'em No Limit ($0.25/$0.50 USD) - 2021/07/30 17:11:02 ET
Table 'Knysna II' 9-max Seat #4 is the button
Seat 1: nicu4you ($70.78 in chips) 
Seat 2: theMacGuffin ($45 in chips) 
Seat 3: pirog766 ($40.13 in chips) 
Seat 4: mishkin2010 ($73.33 in chips) 
Seat 5: SwimmingPooI ($55.02 in chips) 
Seat 6: lulu19911991 ($50 in chips) 
Seat 7: lonely fire ($50 in chips) 
Seat 8: tomekpe ($60.95 in chips) 
Seat 9: BarUnDuck ($20 in chips) 
SwimmingPooI: posts small blind $0.25
lulu19911991: posts big blind $0.50
*** HOLE CARDS ***
lonely fire: folds 
tomekpe: folds 
BarUnDuck: folds 
nicu4you: folds 
theMacGuffin: folds 
pirog766: folds 
mishkin2010: raises $1 to $1.50
SwimmingPooI: folds 
lulu19911991: folds 
Uncalled bet ($1) returned to mishkin2010
mishkin2010 collected $1.25 from pot
mishkin2010: doesn't show hand 
*** SUMMARY ***
Total pot $1.25 | Rake $0 
Seat 1: nicu4you folded before Flop (didn't bet)
Seat 2: theMacGuffin folded before Flop (didn't bet)
Seat 3: pirog766 folded before Flop (didn't bet)
Seat 4: mishkin2010 (button) collected ($1.25)
Seat 5: SwimmingPooI (small blind) folded before Flop
Seat 6: lulu19911991 (big blind) folded before Flop
Seat 7: lonely fire folded before Flop (didn't bet)
Seat 8: tomekpe folded before Flop (didn't bet)
Seat 9: BarUnDuck folded before Flop (didn't bet)



PokerStars Hand #228689729401:  Hold'em No Limit ($0.25/$0.50 USD) - 2021/07/30 17:11:16 ET
Table 'Knysna II' 9-max Seat #5 is the button
Seat 1: nicu4you ($70.78 in chips) 
Seat 2: theMacGuffin ($45 in chips) 
Seat 3: pirog766 ($40.13 in chips) 
Seat 4: mishkin2010 ($74.08 in chips) 
Seat 5: SwimmingPooI ($54.77 in chips) 
Seat 6: lulu19911991 ($50 in chips) 
Seat 7: lonely fire ($50 in chips) 
Seat 8: tomekpe ($60.95 in chips) 
Seat 9: BarUnDuck ($20 in chips) 
lulu19911991: posts small blind $0.25
lonely fire: posts big blind $0.50
*** HOLE CARDS ***
tomekpe: raises $0.69 to $1.19
BarUnDuck: folds 
nicu4you: folds 
theMacGuffin: folds 
pirog766: calls $1.19
mishkin2010: calls $1.19
SwimmingPooI: folds 
lulu19911991: folds 
lonely fire: calls $0.69
*** FLOP *** [4h Ac Jc]
lonely fire: checks 
tomekpe: bets $3.38
pirog766: folds 
mishkin2010: calls $3.38
lonely fire: folds 
*** TURN *** [4h Ac Jc] [Td]
tomekpe: bets $7.94
mishkin2010: folds 
Uncalled bet ($7.94) returned to tomekpe
tomekpe collected $11.18 from pot
tomekpe: doesn't show hand 
*** SUMMARY ***
Total pot $11.77 | Rake $0.59 
Board [4h Ac Jc Td]
Seat 1: nicu4you folded before Flop (didn't bet)
Seat 2: theMacGuffin folded before Flop (didn't bet)
Seat 3: pirog766 folded on the Flop
Seat 4: mishkin2010 folded on the Turn
Seat 5: SwimmingPooI (button) folded before Flop (didn't bet)
Seat 6: lulu19911991 (small blind) folded before Flop
Seat 7: lonely fire (big blind) folded on the Flop
Seat 8: tomekpe collected ($11.18)
Seat 9: BarUnDuck folded before Flop (didn't bet)



PokerStars Hand #228689753147:  Hold'em No Limit ($0.25/$0.50 USD) - 2021/07/30 17:12:07 ET
Table 'Knysna II' 9-max Seat #6 is the button
Seat 1: nicu4you ($70.78 in chips) 
Seat 2: theMacGuffin ($45 in chips) 
Seat 3: pirog766 ($38.94 in chips) 
Seat 4: mishkin2010 ($69.51 in chips) 
Seat 5: SwimmingPooI ($54.77 in chips) 
Seat 6: lulu19911991 ($50 in chips) 
Seat 7: lonely fire ($50 in chips) 
Seat 8: tomekpe ($67.56 in chips) 
Seat 9: BarUnDuck ($20 in chips) 
lonely fire: posts small blind $0.25
tomekpe: posts big blind $0.50
*** HOLE CARDS ***
BarUnDuck: folds 
nicu4you: folds 
theMacGuffin: folds 
pirog766: raises $1 to $1.50
mishkin2010: calls $1.50
SwimmingPooI: folds 
lulu19911991: calls $1.50
lonely fire: folds 
tomekpe: folds 
*** FLOP *** [7s Qd Jd]
pirog766: bets $2.49
mishkin2010: calls $2.49
lulu19911991: folds 
*** TURN *** [7s Qd Jd] [6d]
pirog766: bets $9.72
mishkin2010: calls $9.72
*** RIVER *** [7s Qd Jd 6d] [4s]
pirog766: bets $14.09
mishkin2010: raises $14.09 to $28.18
pirog766: folds 
Uncalled bet ($14.09) returned to mishkin2010
mishkin2010 collected $55.85 from pot
mishkin2010: doesn't show hand 
*** SUMMARY ***
Total pot $57.85 | Rake $2 
Board [7s Qd Jd 6d 4s]
Seat 1: nicu4you folded before Flop (didn't bet)
Seat 2: theMacGuffin folded before Flop (didn't bet)
Seat 3: pirog766 folded on the River
Seat 4: mishkin2010 collected ($55.85)
Seat 5: SwimmingPooI folded before Flop (didn't bet)
Seat 6: lulu19911991 (button) folded on the Flop
Seat 7: lonely fire (small blind) folded before Flop
Seat 8: tomekpe (big blind) folded before Flop
Seat 9: BarUnDuck folded before Flop (didn't bet)



PokerStars Hand #228689787663:  Hold'em No Limit ($0.25/$0.50 USD) - 2021/07/30 17:13:21 ET
Table 'Knysna II' 9-max Seat #7 is the button
Seat 1: nicu4you ($70.78 in chips) 
Seat 2: theMacGuffin ($45 in chips) 
Seat 3: pirog766 ($11.14 in chips) 
Seat 4: mishkin2010 ($97.56 in chips) 
Seat 5: SwimmingPooI ($54.77 in chips) 
Seat 6: lulu19911991 ($50 in chips) 
Seat 7: lonely fire ($50 in chips) 
Seat 8: tomekpe ($67.06 in chips) 
Seat 9: BarUnDuck ($20 in chips) 
tomekpe: posts small blind $0.25
BarUnDuck: posts big blind $0.50
*** HOLE CARDS ***
nicu4you: folds 
theMacGuffin: folds 
pirog766: folds 
mishkin2010: calls $0.50
SwimmingPooI: folds 
lulu19911991: folds 
lonely fire: folds 
tomekpe: folds 
BarUnDuck: checks 
*** FLOP *** [Kd 5h Ts]
BarUnDuck: checks 
mishkin2010: checks 
*** TURN *** [Kd 5h Ts] [2d]
BarUnDuck: checks 
mishkin2010: checks 
*** RIVER *** [Kd 5h Ts 2d] [Js]
BarUnDuck: checks 
mishkin2010: bets $97.06 and is all-in
BarUnDuck: folds 
Uncalled bet ($97.06) returned to mishkin2010
mishkin2010 collected $1.19 from pot
*** SUMMARY ***
Total pot $1.25 | Rake $0.06 
Board [Kd 5h Ts 2d Js]
Seat 1: nicu4you folded before Flop (didn't bet)
Seat 2: theMacGuffin folded before Flop (didn't bet)
Seat 3: pirog766 folded before Flop (didn't bet)
Seat 4: mishkin2010 collected ($1.19)
Seat 5: SwimmingPooI folded before Flop (didn't bet)
Seat 6: lulu19911991 folded before Flop (didn't bet)
Seat 7: lonely fire (button) folded before Flop (didn't bet)
Seat 8: tomekpe (small blind) folded before Flop
Seat 9: BarUnDuck (big blind) folded on the River



PokerStars Hand #228689819730:  Hold'em No Limit ($0.25/$0.50 USD) - 2021/07/30 17:14:09 ET
Table 'Knysna II' 9-max Seat #8 is the button
Seat 1: nicu4you ($70.78 in chips) 
Seat 2: theMacGuffin ($45 in chips) 
Seat 3: pirog766 ($11.14 in chips) 
Seat 4: mishkin2010 ($98.25 in chips) 
Seat 5: SwimmingPooI ($54.77 in chips) 
Seat 6: lulu19911991 ($50 in chips) 
Seat 7: lonely fire ($50 in chips) 
Seat 8: tomekpe ($66.81 in chips) 
Seat 9: BarUnDuck ($19.50 in chips) 
BarUnDuck: posts small blind $0.25
nicu4you: posts big blind $0.50
*** HOLE CARDS ***
theMacGuffin: folds 
pirog766: folds 
mishkin2010 is disconnected 
mishkin2010 is connected 
mishkin2010: folds 
SwimmingPooI: raises $1 to $1.50
lulu19911991: folds 
lonely fire: folds 
tomekpe: folds 
BarUnDuck: folds 
nicu4you: folds 
Uncalled bet ($1) returned to SwimmingPooI
SwimmingPooI collected $1.25 from pot
SwimmingPooI: doesn't show hand 
*** SUMMARY ***
Total pot $1.25 | Rake $0 
Seat 1: nicu4you (big blind) folded before Flop
Seat 2: theMacGuffin folded before Flop (didn't bet)
Seat 3: pirog766 folded before Flop (didn't bet)
Seat 4: mishkin2010 folded before Flop (didn't bet)
Seat 5: SwimmingPooI collected ($1.25)
Seat 6: lulu19911991 folded before Flop (didn't bet)
Seat 7: lonely fire folded before Flop (didn't bet)
Seat 8: tomekpe (button) folded before Flop (didn't bet)
Seat 9: BarUnDuck (small blind) folded before Flop



PokerStars Hand #228689836574:  Hold'em No Limit ($0.25/$0.50 USD) - 2021/07/30 17:14:45 ET
Table 'Knysna II' 9-max Seat #9 is the button
Seat 1: nicu4you ($70.28 in chips) 
Seat 2: theMacGuffin ($45 in chips) 
Seat 3: pirog766 ($11.14 in chips) 
Seat 4: mishkin2010 ($98.25 in chips) 
Seat 5: SwimmingPooI ($55.52 in chips) 
Seat 6: lulu19911991 ($50 in chips) 
Seat 7: lonely fire ($50 in chips) 
Seat 8: tomekpe ($66.81 in chips) 
Seat 9: BarUnDuck ($20 in chips) 
nicu4you: posts small blind $0.25
theMacGuffin: posts big blind $0.50
*** HOLE CARDS ***
pirog766: folds 
mishkin2010: calls $0.50
SwimmingPooI: raises $2 to $2.50
lulu19911991: folds 
lonely fire: folds 
tomekpe: folds 
BarUnDuck: folds 
nicu4you: folds 
theMacGuffin: folds 
mishkin2010: calls $2
*** FLOP *** [7c Kc 2s]
mishkin2010: checks 
SwimmingPooI: checks 
*** TURN *** [7c Kc 2s] [Tc]
mishkin2010: checks 
SwimmingPooI: bets $2.50
mishkin2010: calls $2.50
*** RIVER *** [7c Kc 2s Tc] [7h]
mishkin2010: checks 
SwimmingPooI: checks 
*** SHOW DOWN ***
mishkin2010: shows [Ac Jh] (a pair of Sevens)
SwimmingPooI: shows [Jd Jc] (two pair, Jacks and Sevens)
SwimmingPooI collected $10.21 from pot
*** SUMMARY ***
Total pot $10.75 | Rake $0.54 
Board [7c Kc 2s Tc 7h]
Seat 1: nicu4you (small blind) folded before Flop
Seat 2: theMacGuffin (big blind) folded before Flop
Seat 3: pirog766 folded before Flop (didn't bet)
Seat 4: mishkin2010 showed [Ac Jh] and lost with a pair of Sevens
Seat 5: SwimmingPooI showed [Jd Jc] and won ($10.21) with two pair, Jacks and Sevens
Seat 6: lulu19911991 folded before Flop (didn't bet)
Seat 7: lonely fire folded before Flop (didn't bet)
Seat 8: tomekpe folded before Flop (didn't bet)
Seat 9: BarUnDuck (button) folded before Flop (didn't bet)



PokerStars Hand #228689869516:  Hold'em No Limit ($0.25/$0.50 USD) - 2021/07/30 17:15:55 ET
Table 'Knysna II' 9-max Seat #1 is the button
Seat 1: nicu4you ($70.03 in chips) 
Seat 2: theMacGuffin ($44.50 in chips) 
Seat 3: pirog766 ($11.14 in chips) 
Seat 4: mishkin2010 ($93.25 in chips) 
Seat 5: SwimmingPooI ($60.73 in chips) 
Seat 6: lulu19911991 ($50 in chips) 
Seat 7: lonely fire ($50 in chips) 
Seat 8: tomekpe ($66.81 in chips) 
Seat 9: BarUnDuck ($20 in chips) 
theMacGuffin: posts small blind $0.25
pirog766: posts big blind $0.50
*** HOLE CARDS ***
mishkin2010: calls $0.50
SwimmingPooI: folds 
lulu19911991: raises $1.70 to $2.20
lonely fire: folds 
tomekpe: folds 
BarUnDuck: folds 
nicu4you: folds 
theMacGuffin: folds 
pirog766: calls $1.70
mishkin2010: calls $1.70
*** FLOP *** [Jd As 2d]
pirog766: checks 
mishkin2010: checks 
lulu19911991: bets $4.88
pirog766: folds 
mishkin2010: folds 
Uncalled bet ($4.88) returned to lulu19911991
lulu19911991 collected $6.51 from pot
lulu19911991: doesn't show hand 
*** SUMMARY ***
Total pot $6.85 | Rake $0.34 
Board [Jd As 2d]
Seat 1: nicu4you (button) folded before Flop (didn't bet)
Seat 2: theMacGuffin (small blind) folded before Flop
Seat 3: pirog766 (big blind) folded on the Flop
Seat 4: mishkin2010 folded on the Flop
Seat 5: SwimmingPooI folded before Flop (didn't bet)
Seat 6: lulu19911991 collected ($6.51)
Seat 7: lonely fire folded before Flop (didn't bet)
Seat 8: tomekpe folded before Flop (didn't bet)
Seat 9: BarUnDuck folded before Flop (didn't bet)



PokerStars Hand #228689884598:  Hold'em No Limit ($0.25/$0.50 USD) - 2021/07/30 17:16:27 ET
Table 'Knysna II' 9-max Seat #2 is the button
Seat 1: nicu4you ($70.03 in chips) 
Seat 2: theMacGuffin ($44.25 in chips) 
Seat 3: pirog766 ($8.94 in chips) 
Seat 4: mishkin2010 ($91.05 in chips) 
Seat 5: SwimmingPooI ($60.73 in chips) 
Seat 6: lulu19911991 ($54.31 in chips) 
Seat 7: lonely fire ($50 in chips) 
Seat 8: tomekpe ($66.81 in chips) 
Seat 9: BarUnDuck ($20 in chips) 
pirog766: posts small blind $0.25
mishkin2010: posts big blind $0.50
*** HOLE CARDS ***
SwimmingPooI: folds 
lulu19911991: folds 
lonely fire: folds 
tomekpe: folds 
BarUnDuck: folds 
nicu4you: raises $1 to $1.50
theMacGuffin: folds 
pirog766: raises $7.44 to $8.94 and is all-in
mishkin2010: folds 
nicu4you: calls $7.44
*** FLOP *** [Jd 9h Th]
*** TURN *** [Jd 9h Th] [6c]
*** RIVER *** [Jd 9h Th 6c] [Qs]
*** SHOW DOWN ***
pirog766: shows [Ks Ad] (a straight, Ten to Ace)
nicu4you: shows [Qc Kd] (a straight, Nine to King)
pirog766 collected $17.46 from pot
*** SUMMARY ***
Total pot $18.38 | Rake $0.92 
Board [Jd 9h Th 6c Qs]
Seat 1: nicu4you showed [Qc Kd] and lost with a straight, Nine to King
Seat 2: theMacGuffin (button) folded before Flop (didn't bet)
Seat 3: pirog766 (small blind) showed [Ks Ad] and won ($17.46) with a straight, Ten to Ace
Seat 4: mishkin2010 (big blind) folded before Flop
Seat 5: SwimmingPooI folded before Flop (didn't bet)
Seat 6: lulu19911991 folded before Flop (didn't bet)
Seat 7: lonely fire folded before Flop (didn't bet)
Seat 8: tomekpe folded before Flop (didn't bet)
Seat 9: BarUnDuck folded before Flop (didn't bet)



PokerStars Hand #228689906196:  Hold'em No Limit ($0.25/$0.50 USD) - 2021/07/30 17:17:13 ET
Table 'Knysna II' 9-max Seat #3 is the button
Seat 1: nicu4you ($61.09 in chips) 
Seat 2: theMacGuffin ($44.25 in chips) 
Seat 3: pirog766 ($17.46 in chips) 
Seat 4: mishkin2010 ($90.55 in chips) 
Seat 5: SwimmingPooI ($60.73 in chips) 
Seat 6: lulu19911991 ($54.31 in chips) 
Seat 7: lonely fire ($50 in chips) 
Seat 8: tomekpe ($66.81 in chips) 
Seat 9: BarUnDuck ($20 in chips) 
mishkin2010: posts small blind $0.25
SwimmingPooI: posts big blind $0.50
*** HOLE CARDS ***
lulu19911991: folds 
lonely fire: folds 
tomekpe: folds 
BarUnDuck: folds 
nicu4you: folds 
theMacGuffin: folds 
pirog766: folds 
mishkin2010: calls $0.25
SwimmingPooI: raises $1 to $1.50
mishkin2010: calls $1
*** FLOP *** [3s Td Jd]
mishkin2010: checks 
SwimmingPooI: bets $1.45
mishkin2010: folds 
Uncalled bet ($1.45) returned to SwimmingPooI
SwimmingPooI collected $2.85 from pot
SwimmingPooI: doesn't show hand 
*** SUMMARY ***
Total pot $3 | Rake $0.15 
Board [3s Td Jd]
Seat 1: nicu4you folded before Flop (didn't bet)
Seat 2: theMacGuffin folded before Flop (didn't bet)
Seat 3: pirog766 (button) folded before Flop (didn't bet)
Seat 4: mishkin2010 (small blind) folded on the Flop
Seat 5: SwimmingPooI (big blind) collected ($2.85)
Seat 6: lulu19911991 folded before Flop (didn't bet)
Seat 7: lonely fire folded before Flop (didn't bet)
Seat 8: tomekpe folded before Flop (didn't bet)
Seat 9: BarUnDuck folded before Flop (didn't bet)



PokerStars Hand #228689925878:  Hold'em No Limit ($0.25/$0.50 USD) - 2021/07/30 17:17:56 ET
Table 'Knysna II' 9-max Seat #4 is the button
Seat 1: nicu4you ($61.09 in chips) 
Seat 2: theMacGuffin ($44.25 in chips) 
Seat 3: pirog766 ($17.46 in chips) 
Seat 4: mishkin2010 ($89.05 in chips) 
Seat 5: SwimmingPooI ($62.08 in chips) 
Seat 6: lulu19911991 ($54.31 in chips) 
Seat 7: lonely fire ($50 in chips) 
Seat 8: tomekpe ($66.81 in chips) 
Seat 9: BarUnDuck ($20 in chips) 
SwimmingPooI: posts small blind $0.25
lulu19911991: posts big blind $0.50
*** HOLE CARDS ***
lonely fire: folds 
tomekpe: raises $0.69 to $1.19
BarUnDuck: folds 
nicu4you: folds 
theMacGuffin: folds 
pirog766: folds 
mishkin2010: calls $1.19
SwimmingPooI: folds 
lulu19911991: folds 
*** FLOP *** [Ah 2d 6s]
tomekpe: checks 
mishkin2010: checks 
*** TURN *** [Ah 2d 6s] [8s]
tomekpe: bets $2.11
mishkin2010: calls $2.11
*** RIVER *** [Ah 2d 6s 8s] [2c]
tomekpe: bets $4.96
mishkin2010: folds 
Uncalled bet ($4.96) returned to tomekpe
tomekpe collected $6.98 from pot
tomekpe: doesn't show hand 
*** SUMMARY ***
Total pot $7.35 | Rake $0.37 
Board [Ah 2d 6s 8s 2c]
Seat 1: nicu4you folded before Flop (didn't bet)
Seat 2: theMacGuffin folded before Flop (didn't bet)
Seat 3: pirog766 folded before Flop (didn't bet)
Seat 4: mishkin2010 (button) folded on the River
Seat 5: SwimmingPooI (small blind) folded before Flop
Seat 6: lulu19911991 (big blind) folded before Flop
Seat 7: lonely fire folded before Flop (didn't bet)
Seat 8: tomekpe collected ($6.98)
Seat 9: BarUnDuck folded before Flop (didn't bet)



PokerStars Hand #228689954221:  Hold'em No Limit ($0.25/$0.50 USD) - 2021/07/30 17:18:57 ET
Table 'Knysna II' 9-max Seat #5 is the button
Seat 1: nicu4you ($61.09 in chips) 
Seat 2: theMacGuffin ($44.25 in chips) 
Seat 3: pirog766 ($17.46 in chips) 
Seat 4: mishkin2010 ($85.75 in chips) 
Seat 5: SwimmingPooI ($61.83 in chips) 
Seat 6: lulu19911991 ($53.81 in chips) 
Seat 8: tomekpe ($70.49 in chips) 
Seat 9: BarUnDuck ($20 in chips) 
lulu19911991: posts small blind $0.25
lonely fire: is sitting out 
tomekpe: posts big blind $0.50
*** HOLE CARDS ***
BarUnDuck: folds 
nicu4you: raises $0.75 to $1.25
theMacGuffin: folds 
pirog766: folds 
mishkin2010: folds 
SwimmingPooI: folds 
lulu19911991: folds 
tomekpe: calls $0.75
*** FLOP *** [Jd Qd 9c]
tomekpe: checks 
nicu4you: checks 
*** TURN *** [Jd Qd 9c] [Ac]
tomekpe: bets $1.85
nicu4you: folds 
Uncalled bet ($1.85) returned to tomekpe
tomekpe collected $2.61 from pot
tomekpe: doesn't show hand 
*** SUMMARY ***
Total pot $2.75 | Rake $0.14 
Board [Jd Qd 9c Ac]
Seat 1: nicu4you folded on the Turn
Seat 2: theMacGuffin folded before Flop (didn't bet)
Seat 3: pirog766 folded before Flop (didn't bet)
Seat 4: mishkin2010 folded before Flop (didn't bet)
Seat 5: SwimmingPooI (button) folded before Flop (didn't bet)
Seat 6: lulu19911991 (small blind) folded before Flop
Seat 8: tomekpe (big blind) collected ($2.61)
Seat 9: BarUnDuck folded before Flop (didn't bet)



PokerStars Hand #228689965703:  Hold'em No Limit ($0.25/$0.50 USD) - 2021/07/30 17:19:22 ET
Table 'Knysna II' 9-max Seat #6 is the button
Seat 1: nicu4you ($59.84 in chips) 
Seat 2: theMacGuffin ($44.25 in chips) 
Seat 3: pirog766 ($17.46 in chips) 
Seat 4: mishkin2010 ($85.75 in chips) 
Seat 5: SwimmingPooI ($61.83 in chips) 
Seat 6: lulu19911991 ($53.56 in chips) 
Seat 8: tomekpe ($71.85 in chips) 
Seat 9: BarUnDuck ($20 in chips) 
tomekpe: posts small blind $0.25
BarUnDuck: posts big blind $0.50
*** HOLE CARDS ***
nicu4you: folds 
theMacGuffin: folds 
pirog766: raises $1.25 to $1.75
mishkin2010: folds 
SwimmingPooI: folds 
lulu19911991: folds 
tomekpe: folds 
BarUnDuck: folds 
Uncalled bet ($1.25) returned to pirog766
pirog766 collected $1.25 from pot
pirog766: doesn't show hand 
*** SUMMARY ***
Total pot $1.25 | Rake $0 
Seat 1: nicu4you folded before Flop (didn't bet)
Seat 2: theMacGuffin folded before Flop (didn't bet)
Seat 3: pirog766 collected ($1.25)
Seat 4: mishkin2010 folded before Flop (didn't bet)
Seat 5: SwimmingPooI folded before Flop (didn't bet)
Seat 6: lulu19911991 (button) folded before Flop (didn't bet)
Seat 8: tomekpe (small blind) folded before Flop
Seat 9: BarUnDuck (big blind) folded before Flop



PokerStars Hand #228689973654:  Hold'em No Limit ($0.25/$0.50 USD) - 2021/07/30 17:19:40 ET
Table 'Knysna II' 9-max Seat #8 is the button
Seat 1: nicu4you ($59.84 in chips) 
Seat 2: theMacGuffin ($44.25 in chips) 
Seat 3: pirog766 ($18.21 in chips) 
Seat 4: mishkin2010 ($85.75 in chips) 
Seat 5: SwimmingPooI ($61.83 in chips) 
Seat 6: lulu19911991 ($53.56 in chips) 
Seat 8: tomekpe ($71.60 in chips) 
Seat 9: BarUnDuck ($19.50 in chips) 
BarUnDuck: posts small blind $0.25
nicu4you: posts big blind $0.50
*** HOLE CARDS ***
theMacGuffin: folds 
pirog766: folds 
mishkin2010: calls $0.50
SwimmingPooI: folds 
lulu19911991 has timed out
lulu19911991: folds 
tomekpe: folds 
BarUnDuck: folds 
nicu4you: checks 
*** FLOP *** [Qc 3s 3h]
nicu4you: checks 
mishkin2010: bets $0.50
nicu4you: folds 
Uncalled bet ($0.50) returned to mishkin2010
mishkin2010 collected $1.19 from pot
mishkin2010: doesn't show hand 
*** SUMMARY ***
Total pot $1.25 | Rake $0.06 
Board [Qc 3s 3h]
Seat 1: nicu4you (big blind) folded on the Flop
Seat 2: theMacGuffin folded before Flop (didn't bet)
Seat 3: pirog766 folded before Flop (didn't bet)
Seat 4: mishkin2010 collected ($1.19)
Seat 5: SwimmingPooI folded before Flop (didn't bet)
Seat 6: lulu19911991 folded before Flop (didn't bet)
Seat 8: tomekpe (button) folded before Flop (didn't bet)
Seat 9: BarUnDuck (small blind) folded before Flop



PokerStars Hand #228689999919:  Hold'em No Limit ($0.25/$0.50 USD) - 2021/07/30 17:20:36 ET
Table 'Knysna II' 9-max Seat #9 is the button
Seat 1: nicu4you ($59.34 in chips) 
Seat 2: theMacGuffin ($44.25 in chips) 
Seat 3: pirog766 ($18.21 in chips) 
Seat 4: mishkin2010 ($86.44 in chips) 
Seat 5: SwimmingPooI ($61.83 in chips) 
Seat 6: lulu19911991 ($53.56 in chips) 
Seat 8: tomekpe ($71.60 in chips) 
Seat 9: BarUnDuck ($20 in chips) 
nicu4you: posts small blind $0.25
theMacGuffin: posts big blind $0.50
*** HOLE CARDS ***
pirog766: folds 
mishkin2010: folds 
SwimmingPooI: folds 
lulu19911991 has timed out
lulu19911991: folds 
tomekpe: folds 
BarUnDuck: folds 
nicu4you: folds 
Uncalled bet ($0.25) returned to theMacGuffin
theMacGuffin collected $0.50 from pot
theMacGuffin: doesn't show hand 
*** SUMMARY ***
Total pot $0.50 | Rake $0 
Seat 1: nicu4you (small blind) folded before Flop
Seat 2: theMacGuffin (big blind) collected ($0.50)
Seat 3: pirog766 folded before Flop (didn't bet)
Seat 4: mishkin2010 folded before Flop (didn't bet)
Seat 5: SwimmingPooI folded before Flop (didn't bet)
Seat 6: lulu19911991 folded before Flop (didn't bet)
Seat 8: tomekpe folded before Flop (didn't bet)
Seat 9: BarUnDuck (button) folded before Flop (didn't bet)



PokerStars Hand #228690010131:  Hold'em No Limit ($0.25/$0.50 USD) - 2021/07/30 17:20:59 ET
Table 'Knysna II' 9-max Seat #1 is the button
Seat 1: nicu4you ($59.09 in chips) 
Seat 2: theMacGuffin ($44.50 in chips) 
Seat 3: pirog766 ($18.21 in chips) 
Seat 4: mishkin2010 ($86.44 in chips) 
Seat 5: SwimmingPooI ($61.83 in chips) 
Seat 8: tomekpe ($71.60 in chips) 
Seat 9: BarUnDuck ($20 in chips) 
theMacGuffin: posts small blind $0.25
pirog766: posts big blind $0.50
*** HOLE CARDS ***
mishkin2010: folds 
SwimmingPooI: folds 
tomekpe: folds 
BarUnDuck: folds 
nicu4you: raises $1 to $1.50
theMacGuffin: folds 
pirog766: calls $1
*** FLOP *** [Ks 6h Qd]
pirog766: checks 
nicu4you: bets $1.02
pirog766: calls $1.02
*** TURN *** [Ks 6h Qd] [5d]
pirog766: checks 
nicu4you: checks 
*** RIVER *** [Ks 6h Qd 5d] [Kd]
pirog766: checks 
nicu4you: checks 
*** SHOW DOWN ***
pirog766: shows [Td Qs] (two pair, Kings and Queens)
nicu4you: mucks hand 
pirog766 collected $5.03 from pot
*** SUMMARY ***
Total pot $5.29 | Rake $0.26 
Board [Ks 6h Qd 5d Kd]
Seat 1: nicu4you (button) mucked
Seat 2: theMacGuffin (small blind) folded before Flop
Seat 3: pirog766 (big blind) showed [Td Qs] and won ($5.03) with two pair, Kings and Queens
Seat 4: mishkin2010 folded before Flop (didn't bet)
Seat 5: SwimmingPooI folded before Flop (didn't bet)
Seat 8: tomekpe folded before Flop (didn't bet)
Seat 9: BarUnDuck folded before Flop (didn't bet)



PokerStars Hand #228690034077:  Hold'em No Limit ($0.25/$0.50 USD) - 2021/07/30 17:21:50 ET
Table 'Knysna II' 9-max Seat #2 is the button
Seat 1: nicu4you ($56.57 in chips) 
Seat 2: theMacGuffin ($44.25 in chips) 
Seat 3: pirog766 ($20.72 in chips) 
Seat 4: mishkin2010 ($86.44 in chips) 
Seat 5: SwimmingPooI ($61.83 in chips) 
Seat 8: tomekpe ($71.60 in chips) 
Seat 9: BarUnDuck ($20 in chips) 
pirog766: posts small blind $0.25
mishkin2010: posts big blind $0.50
*** HOLE CARDS ***
SwimmingPooI: folds 
tomekpe: folds 
BarUnDuck has timed out
BarUnDuck: folds 
nicu4you: folds 
theMacGuffin: raises $1 to $1.50
pirog766: folds 
mishkin2010: folds 
Uncalled bet ($1) returned to theMacGuffin
theMacGuffin collected $1.25 from pot
theMacGuffin: doesn't show hand 
*** SUMMARY ***
Total pot $1.25 | Rake $0 
Seat 1: nicu4you folded before Flop (didn't bet)
Seat 2: theMacGuffin (button) collected ($1.25)
Seat 3: pirog766 (small blind) folded before Flop
Seat 4: mishkin2010 (big blind) folded before Flop
Seat 5: SwimmingPooI folded before Flop (didn't bet)
Seat 8: tomekpe folded before Flop (didn't bet)
Seat 9: BarUnDuck folded before Flop (didn't bet)



PokerStars Hand #228690048174:  Hold'em No Limit ($0.25/$0.50 USD) - 2021/07/30 17:22:21 ET
Table 'Knysna II' 9-max Seat #3 is the button
Seat 1: nicu4you ($56.57 in chips) 
Seat 2: theMacGuffin ($45 in chips) 
Seat 3: pirog766 ($20.47 in chips) 
Seat 4: mishkin2010 ($85.94 in chips) 
Seat 5: SwimmingPooI ($61.83 in chips) 
Seat 6: lulu19911991 ($53.56 in chips) 
Seat 8: tomekpe ($71.60 in chips) 
Seat 9: BarUnDuck ($20 in chips) 
mishkin2010: posts small blind $0.25
SwimmingPooI: posts big blind $0.50
*** HOLE CARDS ***
lulu19911991: folds 
tomekpe: raises $0.69 to $1.19
BarUnDuck: folds 
nicu4you: folds 
theMacGuffin: folds 
pirog766: folds 
mishkin2010: calls $0.94
SwimmingPooI: folds 
*** FLOP *** [As 8s Ac]
mishkin2010: checks 
tomekpe: checks 
*** TURN *** [As 8s Ac] [9h]
mishkin2010: checks 
tomekpe: checks 
*** RIVER *** [As 8s Ac 9h] [5d]
mishkin2010: checks 
tomekpe: checks 
*** SHOW DOWN ***
mishkin2010: shows [5s 3s] (two pair, Aces and Fives)
tomekpe: mucks hand 
mishkin2010 collected $2.74 from pot
*** SUMMARY ***
Total pot $2.88 | Rake $0.14 
Board [As 8s Ac 9h 5d]
Seat 1: nicu4you folded before Flop (didn't bet)
Seat 2: theMacGuffin folded before Flop (didn't bet)
Seat 3: pirog766 (button) folded before Flop (didn't bet)
Seat 4: mishkin2010 (small blind) showed [5s 3s] and won ($2.74) with two pair, Aces and Fives
Seat 5: SwimmingPooI (big blind) folded before Flop
Seat 6: lulu19911991 folded before Flop (didn't bet)
Seat 8: tomekpe mucked
Seat 9: BarUnDuck folded before Flop (didn't bet)



PokerStars Hand #228690070022:  Hold'em No Limit ($0.25/$0.50 USD) - 2021/07/30 17:23:08 ET
Table 'Knysna II' 9-max Seat #4 is the button
Seat 1: nicu4you ($56.57 in chips) 
Seat 2: theMacGuffin ($45 in chips) 
Seat 3: pirog766 ($20.47 in chips) 
Seat 4: mishkin2010 ($87.49 in chips) 
Seat 5: SwimmingPooI ($61.33 in chips) 
Seat 6: lulu19911991 ($53.56 in chips) 
Seat 8: tomekpe ($70.41 in chips) 
Seat 9: BarUnDuck ($20 in chips) 
SwimmingPooI: posts small blind $0.25
lulu19911991: posts big blind $0.50
*** HOLE CARDS ***
tomekpe: folds 
BarUnDuck: folds 
nicu4you has timed out
nicu4you: folds 
theMacGuffin: folds 
pirog766: folds 
mishkin2010: calls $0.50
SwimmingPooI: raises $2 to $2.50
lulu19911991: folds 
mishkin2010: calls $2
*** FLOP *** [Ad Jd 5s]
SwimmingPooI: bets $2.50
mishkin2010: folds 
Uncalled bet ($2.50) returned to SwimmingPooI
SwimmingPooI collected $5.22 from pot
SwimmingPooI: doesn't show hand 
*** SUMMARY ***
Total pot $5.50 | Rake $0.28 
Board [Ad Jd 5s]
Seat 1: nicu4you folded before Flop (didn't bet)
Seat 2: theMacGuffin folded before Flop (didn't bet)
Seat 3: pirog766 folded before Flop (didn't bet)
Seat 4: mishkin2010 (button) folded on the Flop
Seat 5: SwimmingPooI (small blind) collected ($5.22)
Seat 6: lulu19911991 (big blind) folded before Flop
Seat 8: tomekpe folded before Flop (didn't bet)
Seat 9: BarUnDuck folded before Flop (didn't bet)



PokerStars Hand #228690088984:  Hold'em No Limit ($0.25/$0.50 USD) - 2021/07/30 17:23:49 ET
Table 'Knysna II' 9-max Seat #5 is the button
Seat 1: nicu4you ($56.57 in chips) 
Seat 2: theMacGuffin ($45 in chips) 
Seat 3: pirog766 ($20.47 in chips) 
Seat 4: mishkin2010 ($84.99 in chips) 
Seat 5: SwimmingPooI ($64.05 in chips) 
Seat 6: lulu19911991 ($53.06 in chips) 
Seat 8: tomekpe ($70.41 in chips) 
Seat 9: BarUnDuck ($20 in chips) 
lulu19911991: posts small blind $0.25
tomekpe: posts big blind $0.50
*** HOLE CARDS ***
BarUnDuck: folds 
nicu4you: raises $1 to $1.50
theMacGuffin: folds 
pirog766: calls $1.50
mishkin2010: folds 
SwimmingPooI: folds 
lulu19911991: folds 
tomekpe: calls $1
*** FLOP *** [7c 5h Tc]
tomekpe: checks 
nicu4you: bets $2.48
pirog766: folds 
tomekpe: folds 
Uncalled bet ($2.48) returned to nicu4you
nicu4you collected $4.51 from pot
nicu4you: doesn't show hand 
*** SUMMARY ***
Total pot $4.75 | Rake $0.24 
Board [7c 5h Tc]
Seat 1: nicu4you collected ($4.51)
Seat 2: theMacGuffin folded before Flop (didn't bet)
Seat 3: pirog766 folded on the Flop
Seat 4: mishkin2010 folded before Flop (didn't bet)
Seat 5: SwimmingPooI (button) folded before Flop (didn't bet)
Seat 6: lulu19911991 (small blind) folded before Flop
Seat 8: tomekpe (big blind) folded on the Flop
Seat 9: BarUnDuck folded before Flop (didn't bet)



PokerStars Hand #228690113377:  Hold'em No Limit ($0.25/$0.50 USD) - 2021/07/30 17:24:42 ET
Table 'Knysna II' 9-max Seat #6 is the button
Seat 1: nicu4you ($59.58 in chips) 
Seat 2: theMacGuffin ($45 in chips) 
Seat 3: pirog766 ($18.97 in chips) 
Seat 4: mishkin2010 ($84.99 in chips) 
Seat 5: SwimmingPooI ($64.05 in chips) 
Seat 6: lulu19911991 ($52.81 in chips) 
Seat 8: tomekpe ($68.91 in chips) 
Seat 9: BarUnDuck ($20 in chips) 
tomekpe: posts small blind $0.25
BarUnDuck: posts big blind $0.50
*** HOLE CARDS ***
nicu4you: folds 
theMacGuffin: folds 
pirog766: folds 
mishkin2010: folds 
SwimmingPooI: folds 
lulu19911991: folds 
tomekpe: folds 
Uncalled bet ($0.25) returned to BarUnDuck
BarUnDuck collected $0.50 from pot
BarUnDuck: doesn't show hand 
*** SUMMARY ***
Total pot $0.50 | Rake $0 
Seat 1: nicu4you folded before Flop (didn't bet)
Seat 2: theMacGuffin folded before Flop (didn't bet)
Seat 3: pirog766 folded before Flop (didn't bet)
Seat 4: mishkin2010 folded before Flop (didn't bet)
Seat 5: SwimmingPooI folded before Flop (didn't bet)
Seat 6: lulu19911991 (button) folded before Flop (didn't bet)
Seat 8: tomekpe (small blind) folded before Flop
Seat 9: BarUnDuck (big blind) collected ($0.50)



PokerStars Hand #228690121376:  Hold'em No Limit ($0.25/$0.50 USD) - 2021/07/30 17:24:59 ET
Table 'Knysna II' 9-max Seat #8 is the button
Seat 1: nicu4you ($59.58 in chips) 
Seat 2: theMacGuffin ($45 in chips) 
Seat 3: pirog766 ($18.97 in chips) 
Seat 4: mishkin2010 ($84.99 in chips) 
Seat 5: SwimmingPooI ($64.05 in chips) 
Seat 6: lulu19911991 ($52.81 in chips) 
Seat 8: tomekpe ($68.66 in chips) 
Seat 9: BarUnDuck ($20.25 in chips) 
BarUnDuck: posts small blind $0.25
nicu4you: posts big blind $0.50
*** HOLE CARDS ***
theMacGuffin: folds 
pirog766: folds 
mishkin2010: folds 
SwimmingPooI: folds 
lulu19911991: folds 
tomekpe: raises $0.69 to $1.19
BarUnDuck: folds 
nicu4you: folds 
Uncalled bet ($0.69) returned to tomekpe
tomekpe collected $1.25 from pot
tomekpe: doesn't show hand 
*** SUMMARY ***
Total pot $1.25 | Rake $0 
Seat 1: nicu4you (big blind) folded before Flop
Seat 2: theMacGuffin folded before Flop (didn't bet)
Seat 3: pirog766 folded before Flop (didn't bet)
Seat 4: mishkin2010 folded before Flop (didn't bet)
Seat 5: SwimmingPooI folded before Flop (didn't bet)
Seat 6: lulu19911991 folded before Flop (didn't bet)
Seat 8: tomekpe (button) collected ($1.25)
Seat 9: BarUnDuck (small blind) folded before Flop



PokerStars Hand #228690134731:  Hold'em No Limit ($0.25/$0.50 USD) - 2021/07/30 17:25:29 ET
Table 'Knysna II' 9-max Seat #9 is the button
Seat 1: nicu4you ($59.08 in chips) 
Seat 2: theMacGuffin ($45 in chips) 
Seat 3: pirog766 ($18.97 in chips) 
Seat 4: mishkin2010 ($84.99 in chips) 
Seat 5: SwimmingPooI ($64.05 in chips) 
Seat 6: lulu19911991 ($52.81 in chips) 
Seat 8: tomekpe ($69.41 in chips) 
Seat 9: BarUnDuck ($20 in chips) 
nicu4you: posts small blind $0.25
theMacGuffin: posts big blind $0.50
*** HOLE CARDS ***
pirog766: folds 
mishkin2010: calls $0.50
SwimmingPooI: folds 
lulu19911991: folds 
tomekpe: folds 
BarUnDuck: folds 
nicu4you: folds 
theMacGuffin: checks 
*** FLOP *** [2h 6h 9c]
theMacGuffin: checks 
mishkin2010: bets $0.50
theMacGuffin: folds 
Uncalled bet ($0.50) returned to mishkin2010
mishkin2010 collected $1.19 from pot
mishkin2010: doesn't show hand 
*** SUMMARY ***
Total pot $1.25 | Rake $0.06 
Board [2h 6h 9c]
Seat 1: nicu4you (small blind) folded before Flop
Seat 2: theMacGuffin (big blind) folded on the Flop
Seat 3: pirog766 folded before Flop (didn't bet)
Seat 4: mishkin2010 collected ($1.19)
Seat 5: SwimmingPooI folded before Flop (didn't bet)
Seat 6: lulu19911991 folded before Flop (didn't bet)
Seat 8: tomekpe folded before Flop (didn't bet)
Seat 9: BarUnDuck (button) folded before Flop (didn't bet)



PokerStars Hand #228690147337:  Hold'em No Limit ($0.25/$0.50 USD) - 2021/07/30 17:25:56 ET
Table 'Knysna II' 9-max Seat #1 is the button
Seat 1: nicu4you ($58.83 in chips) 
Seat 2: theMacGuffin ($44.50 in chips) 
Seat 3: pirog766 ($18.97 in chips) 
Seat 4: mishkin2010 ($85.68 in chips) 
Seat 5: SwimmingPooI ($64.05 in chips) 
Seat 6: lulu19911991 ($52.81 in chips) 
Seat 8: tomekpe ($69.41 in chips) 
Seat 9: BarUnDuck ($20 in chips) 
theMacGuffin: posts small blind $0.25
pirog766: posts big blind $0.50
*** HOLE CARDS ***
mishkin2010: raises $0.50 to $1
SwimmingPooI: folds 
lulu19911991: folds 
tomekpe: folds 
BarUnDuck: raises $2.75 to $3.75
nicu4you: folds 
theMacGuffin: folds 
pirog766: folds 
mishkin2010: calls $2.75
*** FLOP *** [Jh 2c 3h]
mishkin2010: checks 
BarUnDuck: checks 
*** TURN *** [Jh 2c 3h] [3c]
mishkin2010: bets $3.92
BarUnDuck: calls $3.92
*** RIVER *** [Jh 2c 3h 3c] [Td]
mishkin2010: checks 
BarUnDuck: checks 
*** SHOW DOWN ***
mishkin2010: shows [Qc Jd] (two pair, Jacks and Threes)
BarUnDuck: mucks hand 
mishkin2010 collected $15.29 from pot
*** SUMMARY ***
Total pot $16.09 | Rake $0.80 
Board [Jh 2c 3h 3c Td]
Seat 1: nicu4you (button) folded before Flop (didn't bet)
Seat 2: theMacGuffin (small blind) folded before Flop
Seat 3: pirog766 (big blind) folded before Flop
Seat 4: mishkin2010 showed [Qc Jd] and won ($15.29) with two pair, Jacks and Threes
Seat 5: SwimmingPooI folded before Flop (didn't bet)
Seat 6: lulu19911991 folded before Flop (didn't bet)
Seat 8: tomekpe folded before Flop (didn't bet)
Seat 9: BarUnDuck mucked



PokerStars Hand #228690176148:  Hold'em No Limit ($0.25/$0.50 USD) - 2021/07/30 17:26:47 ET
Table 'Knysna II' 9-max Seat #2 is the button
Seat 1: nicu4you ($58.83 in chips) 
Seat 2: theMacGuffin ($44.25 in chips) 
Seat 3: pirog766 ($18.47 in chips) 
Seat 4: mishkin2010 ($93.30 in chips) 
Seat 5: SwimmingPooI ($64.05 in chips) 
Seat 6: lulu19911991 ($52.81 in chips) 
Seat 8: tomekpe ($69.41 in chips) 
Seat 9: BarUnDuck ($20 in chips) 
pirog766: posts small blind $0.25
mishkin2010: posts big blind $0.50
*** HOLE CARDS ***
SwimmingPooI: folds 
lulu19911991: folds 
tomekpe: folds 
BarUnDuck: folds 
nicu4you: folds 
theMacGuffin: folds 
pirog766: folds 
Uncalled bet ($0.25) returned to mishkin2010
mishkin2010 collected $0.50 from pot
mishkin2010: doesn't show hand 
*** SUMMARY ***
Total pot $0.50 | Rake $0 
Seat 1: nicu4you folded before Flop (didn't bet)
Seat 2: theMacGuffin (button) folded before Flop (didn't bet)
Seat 3: pirog766 (small blind) folded before Flop
Seat 4: mishkin2010 (big blind) collected ($0.50)
Seat 5: SwimmingPooI folded before Flop (didn't bet)
Seat 6: lulu19911991 folded before Flop (didn't bet)
Seat 8: tomekpe folded before Flop (didn't bet)
Seat 9: BarUnDuck folded before Flop (didn't bet)



PokerStars Hand #228691573344:  Hold'em No Limit ($0.25/$0.50 USD) - 2021/07/30 18:21:14 ET
Table 'Knysna II' 9-max Seat #1 is the button
Seat 1: MarinaKraken ($50.49 in chips) 
Seat 2: Schwimbob80 ($69.05 in chips) 
Seat 3: goldenpig666 ($50 in chips) 
Seat 4: lonely fire ($63.37 in chips) 
Seat 5: MarsMiland ($50 in chips) 
Seat 6: lulu19911991 ($50.51 in chips) 
Seat 7: lexon3 ($54.11 in chips) 
Seat 8: Nestle170 ($57.01 in chips) 
Seat 9: KpNZ12 ($31.05 in chips) 
Schwimbob80: posts small blind $0.25
goldenpig666: posts big blind $0.50
KpNZ12: posts big blind $0.50
*** HOLE CARDS ***
lonely fire: folds 
MarsMiland: folds 
lulu19911991: folds 
lexon3: folds 
Nestle170: folds 
KpNZ12: checks 
MarinaKraken: folds 
Schwimbob80: calls $0.25
goldenpig666: checks 
*** FLOP *** [Qh Ac As]
Schwimbob80: checks 
goldenpig666: checks 
KpNZ12: checks 
*** TURN *** [Qh Ac As] [2h]
Schwimbob80: bets $1
goldenpig666: folds 
KpNZ12: calls $1
*** RIVER *** [Qh Ac As 2h] [6d]
Schwimbob80: bets $1
KpNZ12: calls $1
*** SHOW DOWN ***
Schwimbob80: shows [6c Js] (two pair, Aces and Sixes)
KpNZ12: shows [Ah 5s] (three of a kind, Aces)
KpNZ12 collected $5.22 from pot
*** SUMMARY ***
Total pot $5.50 | Rake $0.28 
Board [Qh Ac As 2h 6d]
Seat 1: MarinaKraken (button) folded before Flop (didn't bet)
Seat 2: Schwimbob80 (small blind) showed [6c Js] and lost with two pair, Aces and Sixes
Seat 3: goldenpig666 (big blind) folded on the Turn
Seat 4: lonely fire folded before Flop (didn't bet)
Seat 5: MarsMiland folded before Flop (didn't bet)
Seat 6: lulu19911991 folded before Flop (didn't bet)
Seat 7: lexon3 folded before Flop (didn't bet)
Seat 8: Nestle170 folded before Flop (didn't bet)
Seat 9: KpNZ12 showed [Ah 5s] and won ($5.22) with three of a kind, Aces



PokerStars Hand #228691594878:  Hold'em No Limit ($0.25/$0.50 USD) - 2021/07/30 18:22:07 ET
Table 'Knysna II' 9-max Seat #2 is the button
Seat 1: MarinaKraken ($50.49 in chips) 
Seat 2: Schwimbob80 ($66.55 in chips) 
Seat 3: goldenpig666 ($50 in chips) 
Seat 4: lonely fire ($63.37 in chips) 
Seat 5: MarsMiland ($50 in chips) 
Seat 6: lulu19911991 ($50.51 in chips) 
Seat 7: lexon3 ($54.11 in chips) 
Seat 8: Nestle170 ($57.01 in chips) 
Seat 9: KpNZ12 ($33.77 in chips) 
goldenpig666: posts small blind $0.25
lonely fire: posts big blind $0.50
*** HOLE CARDS ***
MarsMiland: folds 
lulu19911991: folds 
lexon3: raises $1 to $1.50
Nestle170: folds 
KpNZ12: folds 
MarinaKraken: folds 
Schwimbob80: calls $1.50
goldenpig666: folds 
lonely fire: folds 
*** FLOP *** [Jh 8h 3d]
lexon3: bets $2.63
Schwimbob80: raises $2.63 to $5.26
lexon3: raises $7.19 to $12.45
Schwimbob80: folds 
Uncalled bet ($7.19) returned to lexon3
lexon3 collected $13.56 from pot
lexon3: doesn't show hand 
*** SUMMARY ***
Total pot $14.27 | Rake $0.71 
Board [Jh 8h 3d]
Seat 1: MarinaKraken folded before Flop (didn't bet)
Seat 2: Schwimbob80 (button) folded on the Flop
Seat 3: goldenpig666 (small blind) folded before Flop
Seat 4: lonely fire (big blind) folded before Flop
Seat 5: MarsMiland folded before Flop (didn't bet)
Seat 6: lulu19911991 folded before Flop (didn't bet)
Seat 7: lexon3 collected ($13.56)
Seat 8: Nestle170 folded before Flop (didn't bet)
Seat 9: KpNZ12 folded before Flop (didn't bet)



PokerStars Hand #228691618465:  Hold'em No Limit ($0.25/$0.50 USD) - 2021/07/30 18:23:07 ET
Table 'Knysna II' 9-max Seat #3 is the button
Seat 1: MarinaKraken ($50.49 in chips) 
Seat 2: Schwimbob80 ($59.79 in chips) 
Seat 3: goldenpig666 ($50 in chips) 
Seat 4: lonely fire ($62.87 in chips) 
Seat 6: lulu19911991 ($50.51 in chips) 
Seat 7: lexon3 ($60.91 in chips) 
Seat 8: Nestle170 ($57.01 in chips) 
Seat 9: KpNZ12 ($33.77 in chips) 
lonely fire: posts small blind $0.25
lulu19911991: posts big blind $0.50
*** HOLE CARDS ***
lexon3: folds 
Nestle170: folds 
KpNZ12: folds 
MarinaKraken: folds 
Schwimbob80: folds 
goldenpig666: folds 
lonely fire: raises $0.75 to $1.25
lulu19911991: folds 
Uncalled bet ($0.75) returned to lonely fire
lonely fire collected $1 from pot
lonely fire: doesn't show hand 
*** SUMMARY ***
Total pot $1 | Rake $0 
Seat 1: MarinaKraken folded before Flop (didn't bet)
Seat 2: Schwimbob80 folded before Flop (didn't bet)
Seat 3: goldenpig666 (button) folded before Flop (didn't bet)
Seat 4: lonely fire (small blind) collected ($1)
Seat 6: lulu19911991 (big blind) folded before Flop
Seat 7: lexon3 folded before Flop (didn't bet)
Seat 8: Nestle170 folded before Flop (didn't bet)
Seat 9: KpNZ12 folded before Flop (didn't bet)



PokerStars Hand #228691629372:  Hold'em No Limit ($0.25/$0.50 USD) - 2021/07/30 18:23:34 ET
Table 'Knysna II' 9-max Seat #4 is the button
Seat 1: MarinaKraken ($50.49 in chips) 
Seat 2: Schwimbob80 ($59.79 in chips) 
Seat 3: goldenpig666 ($50 in chips) 
Seat 4: lonely fire ($63.37 in chips) 
Seat 6: lulu19911991 ($50.01 in chips) 
Seat 7: lexon3 ($60.91 in chips) 
Seat 8: Nestle170 ($57.01 in chips) 
Seat 9: KpNZ12 ($33.77 in chips) 
lulu19911991: posts small blind $0.25
lexon3: posts big blind $0.50
*** HOLE CARDS ***
Nestle170: folds 
KpNZ12: folds 
MarinaKraken: folds 
Schwimbob80: raises $0.50 to $1
goldenpig666: raises $3 to $4
lonely fire: folds 
lulu19911991: folds 
lexon3: folds 
Schwimbob80: calls $3
*** FLOP *** [4h Js 8d]
Schwimbob80: bets $4
goldenpig666: raises $9 to $13
Schwimbob80: folds 
Uncalled bet ($9) returned to goldenpig666
goldenpig666 collected $15.70 from pot
goldenpig666: doesn't show hand 
*** SUMMARY ***
Total pot $16.75 | Rake $1.05 
Board [4h Js 8d]
Seat 1: MarinaKraken folded before Flop (didn't bet)
Seat 2: Schwimbob80 folded on the Flop
Seat 3: goldenpig666 collected ($15.70)
Seat 4: lonely fire (button) folded before Flop (didn't bet)
Seat 6: lulu19911991 (small blind) folded before Flop
Seat 7: lexon3 (big blind) folded before Flop
Seat 8: Nestle170 folded before Flop (didn't bet)
Seat 9: KpNZ12 folded before Flop (didn't bet)



PokerStars Hand #228691643170:  Hold'em No Limit ($0.25/$0.50 USD) - 2021/07/30 18:24:09 ET
Table 'Knysna II' 9-max Seat #6 is the button
Seat 1: MarinaKraken ($50.49 in chips) 
Seat 2: Schwimbob80 ($51.79 in chips) 
Seat 3: goldenpig666 ($57.70 in chips) 
Seat 4: lonely fire ($63.37 in chips) 
Seat 6: lulu19911991 ($50 in chips) 
Seat 7: lexon3 ($60.41 in chips) 
Seat 8: Nestle170 ($57.01 in chips) 
Seat 9: KpNZ12 ($33.77 in chips) 
lexon3: posts small blind $0.25
Nestle170: posts big blind $0.50
*** HOLE CARDS ***
KpNZ12: calls $0.50
MarinaKraken: folds 
Schwimbob80: calls $0.50
goldenpig666: folds 
lonely fire: folds 
lulu19911991: folds 
lexon3: folds 
Nestle170: checks 
*** FLOP *** [3s 7h 4d]
Nestle170: checks 
KpNZ12: checks 
Schwimbob80: checks 
*** TURN *** [3s 7h 4d] [Ks]
Nestle170: checks 
KpNZ12: bets $0.50
Schwimbob80: calls $0.50
Nestle170: folds 
*** RIVER *** [3s 7h 4d Ks] [9s]
KpNZ12: bets $0.50
Schwimbob80: raises $1.50 to $2
KpNZ12: calls $1.50
*** SHOW DOWN ***
Schwimbob80: shows [8h Td] (high card King)
KpNZ12: shows [8c Kc] (a pair of Kings)
KpNZ12 collected $6.41 from pot
*** SUMMARY ***
Total pot $6.75 | Rake $0.34 
Board [3s 7h 4d Ks 9s]
Seat 1: MarinaKraken folded before Flop (didn't bet)
Seat 2: Schwimbob80 showed [8h Td] and lost with high card King
Seat 3: goldenpig666 folded before Flop (didn't bet)
Seat 4: lonely fire folded before Flop (didn't bet)
Seat 6: lulu19911991 (button) folded before Flop (didn't bet)
Seat 7: lexon3 (small blind) folded before Flop
Seat 8: Nestle170 (big blind) folded on the Turn
Seat 9: KpNZ12 showed [8c Kc] and won ($6.41) with a pair of Kings



PokerStars Hand #228691668185:  Hold'em No Limit ($0.25/$0.50 USD) - 2021/07/30 18:25:12 ET
Table 'Knysna II' 9-max Seat #7 is the button
Seat 1: MarinaKraken ($50.49 in chips) 
Seat 2: Schwimbob80 ($48.79 in chips) 
Seat 3: goldenpig666 ($57.70 in chips) 
Seat 4: lonely fire ($63.37 in chips) 
Seat 6: lulu19911991 ($50 in chips) 
Seat 7: lexon3 ($60.16 in chips) 
Seat 8: Nestle170 ($56.51 in chips) 
Seat 9: KpNZ12 ($37.18 in chips) 
Nestle170: posts small blind $0.25
KpNZ12: posts big blind $0.50
*** HOLE CARDS ***
MarinaKraken: folds 
Schwimbob80: raises $1 to $1.50
goldenpig666: folds 
lonely fire: folds 
lulu19911991: folds 
lexon3: folds 
Nestle170: calls $1.25
KpNZ12: folds 
*** FLOP *** [2c 6c Kd]
Nestle170: checks 
Schwimbob80: bets $1.66
Nestle170: calls $1.66
*** TURN *** [2c 6c Kd] [2d]
Nestle170: checks 
Schwimbob80: bets $1.50
Nestle170: raises $5.21 to $6.71
Schwimbob80: calls $5.21
*** RIVER *** [2c 6c Kd 2d] [4h]
Nestle170: checks 
Schwimbob80: bets $6
Nestle170: calls $6
*** SHOW DOWN ***
Schwimbob80: shows [Jd Ad] (a pair of Deuces)
Nestle170: shows [9h Kh] (two pair, Kings and Deuces)
Nestle170 collected $30.63 from pot
*** SUMMARY ***
Total pot $32.24 | Rake $1.61 
Board [2c 6c Kd 2d 4h]
Seat 1: MarinaKraken folded before Flop (didn't bet)
Seat 2: Schwimbob80 showed [Jd Ad] and lost with a pair of Deuces
Seat 3: goldenpig666 folded before Flop (didn't bet)
Seat 4: lonely fire folded before Flop (didn't bet)
Seat 6: lulu19911991 folded before Flop (didn't bet)
Seat 7: lexon3 (button) folded before Flop (didn't bet)
Seat 8: Nestle170 (small blind) showed [9h Kh] and won ($30.63) with two pair, Kings and Deuces
Seat 9: KpNZ12 (big blind) folded before Flop



PokerStars Hand #228691696382:  Hold'em No Limit ($0.25/$0.50 USD) - 2021/07/30 18:26:23 ET
Table 'Knysna II' 9-max Seat #8 is the button
Seat 1: MarinaKraken ($50.49 in chips) 
Seat 2: Schwimbob80 ($32.92 in chips) 
Seat 3: goldenpig666 ($57.70 in chips) 
Seat 4: lonely fire ($63.37 in chips) 
Seat 6: lulu19911991 ($50 in chips) 
Seat 7: lexon3 ($60.16 in chips) 
Seat 8: Nestle170 ($71.27 in chips) 
Seat 9: KpNZ12 ($36.68 in chips) 
KpNZ12: posts small blind $0.25
MarinaKraken: posts big blind $0.50
*** HOLE CARDS ***
Schwimbob80: calls $0.50
goldenpig666: folds 
lonely fire: folds 
lulu19911991 has timed out
lulu19911991: folds 
lexon3: raises $1.63 to $2.13
Nestle170: folds 
KpNZ12: calls $1.88
MarinaKraken: folds 
Schwimbob80: calls $1.63
*** FLOP *** [8h 9h 3c]
KpNZ12: checks 
Schwimbob80: bets $1
lexon3: calls $1
KpNZ12: calls $1
*** TURN *** [8h 9h 3c] [Qd]
KpNZ12: checks 
Schwimbob80: bets $1.50
lexon3: folds 
KpNZ12: calls $1.50
*** RIVER *** [8h 9h 3c Qd] [Jd]
KpNZ12: checks 
Schwimbob80: checks 
*** SHOW DOWN ***
KpNZ12: shows [Js 9s] (two pair, Jacks and Nines)
Schwimbob80: mucks hand 
KpNZ12 collected $12.25 from pot
*** SUMMARY ***
Total pot $12.89 | Rake $0.64 
Board [8h 9h 3c Qd Jd]
Seat 1: MarinaKraken (big blind) folded before Flop
Seat 2: Schwimbob80 mucked
Seat 3: goldenpig666 folded before Flop (didn't bet)
Seat 4: lonely fire folded before Flop (didn't bet)
Seat 6: lulu19911991 folded before Flop (didn't bet)
Seat 7: lexon3 folded on the Turn
Seat 8: Nestle170 (button) folded before Flop (didn't bet)
Seat 9: KpNZ12 (small blind) showed [Js 9s] and won ($12.25) with two pair, Jacks and Nines



PokerStars Hand #228691745492:  Hold'em No Limit ($0.25/$0.50 USD) - 2021/07/30 18:28:15 ET
Table 'Knysna II' 9-max Seat #9 is the button
Seat 1: MarinaKraken ($50 in chips) 
Seat 2: Schwimbob80 ($28.29 in chips) 
Seat 3: goldenpig666 ($57.70 in chips) 
Seat 4: lonely fire ($63.37 in chips) 
Seat 6: lulu19911991 ($50 in chips) 
Seat 7: lexon3 ($57.03 in chips) 
Seat 8: Nestle170 ($71.27 in chips) 
Seat 9: KpNZ12 ($44.30 in chips) 
MarinaKraken: posts small blind $0.25
Schwimbob80: posts big blind $0.50
*** HOLE CARDS ***
goldenpig666: folds 
lonely fire: raises $1 to $1.50
lulu19911991: folds 
lexon3: folds 
Nestle170: folds 
KpNZ12: folds 
MarinaKraken: folds 
Schwimbob80: calls $1
*** FLOP *** [5s 7c Jc]
Schwimbob80: bets $1.55
lonely fire: folds 
Uncalled bet ($1.55) returned to Schwimbob80
Schwimbob80 collected $3.09 from pot
Schwimbob80: doesn't show hand 
*** SUMMARY ***
Total pot $3.25 | Rake $0.16 
Board [5s 7c Jc]
Seat 1: MarinaKraken (small blind) folded before Flop
Seat 2: Schwimbob80 (big blind) collected ($3.09)
Seat 3: goldenpig666 folded before Flop (didn't bet)
Seat 4: lonely fire folded on the Flop
Seat 6: lulu19911991 folded before Flop (didn't bet)
Seat 7: lexon3 folded before Flop (didn't bet)
Seat 8: Nestle170 folded before Flop (didn't bet)
Seat 9: KpNZ12 (button) folded before Flop (didn't bet)



PokerStars Hand #228691760285:  Hold'em No Limit ($0.25/$0.50 USD) - 2021/07/30 18:28:53 ET
Table 'Knysna II' 9-max Seat #1 is the button
Seat 1: MarinaKraken ($50 in chips) 
Seat 2: Schwimbob80 ($29.88 in chips) 
Seat 3: goldenpig666 ($57.70 in chips) 
Seat 4: lonely fire ($61.87 in chips) 
Seat 6: lulu19911991 ($50 in chips) 
Seat 7: lexon3 ($57.03 in chips) 
Seat 8: Nestle170 ($71.27 in chips) 
Seat 9: KpNZ12 ($44.30 in chips) 
Schwimbob80: posts small blind $0.25
goldenpig666: posts big blind $0.50
MarsMiland: sits out 
*** HOLE CARDS ***
lonely fire: folds 
lulu19911991: folds 
lexon3: folds 
Nestle170: folds 
KpNZ12: calls $0.50
MarinaKraken: folds 
Schwimbob80: calls $0.25
goldenpig666: checks 
*** FLOP *** [Kd 7s 4c]
Schwimbob80: bets $1
goldenpig666: raises $1 to $2
KpNZ12: folds 
Schwimbob80: folds 
Uncalled bet ($1) returned to goldenpig666
goldenpig666 collected $3.28 from pot
goldenpig666: doesn't show hand 
*** SUMMARY ***
Total pot $3.50 | Rake $0.22 
Board [Kd 7s 4c]
Seat 1: MarinaKraken (button) folded before Flop (didn't bet)
Seat 2: Schwimbob80 (small blind) folded on the Flop
Seat 3: goldenpig666 (big blind) collected ($3.28)
Seat 4: lonely fire folded before Flop (didn't bet)
Seat 6: lulu19911991 folded before Flop (didn't bet)
Seat 7: lexon3 folded before Flop (didn't bet)
Seat 8: Nestle170 folded before Flop (didn't bet)
Seat 9: KpNZ12 folded on the Flop



PokerStars Hand #228691776437:  Hold'em No Limit ($0.25/$0.50 USD) - 2021/07/30 18:29:34 ET
Table 'Knysna II' 9-max Seat #2 is the button
Seat 1: MarinaKraken ($50 in chips) 
Seat 2: Schwimbob80 ($28.38 in chips) 
Seat 3: goldenpig666 ($59.48 in chips) 
Seat 4: lonely fire ($61.87 in chips) 
Seat 6: lulu19911991 ($50 in chips) 
Seat 7: lexon3 ($57.03 in chips) 
Seat 8: Nestle170 ($71.27 in chips) 
Seat 9: KpNZ12 ($43.80 in chips) 
goldenpig666: posts small blind $0.25
lonely fire: posts big blind $0.50
MarsMiland: sits out 
*** HOLE CARDS ***
lulu19911991 has timed out
lulu19911991: folds 
lexon3: folds 
Nestle170: folds 
KpNZ12: folds 
MarinaKraken: folds 
Schwimbob80: folds 
goldenpig666: raises $1 to $1.50
lonely fire: calls $1
*** FLOP *** [As Jd Th]
goldenpig666: bets $1
lonely fire: calls $1
*** TURN *** [As Jd Th] [Ad]
goldenpig666: bets $3.50
lonely fire: calls $3.50
*** RIVER *** [As Jd Th Ad] [5h]
goldenpig666: bets $8.50
lonely fire: calls $8.50
*** SHOW DOWN ***
goldenpig666: shows [7d 7h] (two pair, Aces and Sevens)
lonely fire: shows [Ah 8s] (three of a kind, Aces)
lonely fire collected $27.55 from pot
*** SUMMARY ***
Total pot $29 | Rake $1.45 
Board [As Jd Th Ad 5h]
Seat 1: MarinaKraken folded before Flop (didn't bet)
Seat 2: Schwimbob80 (button) folded before Flop (didn't bet)
Seat 3: goldenpig666 (small blind) showed [7d 7h] and lost with two pair, Aces and Sevens
Seat 4: lonely fire (big blind) showed [Ah 8s] and won ($27.55) with three of a kind, Aces
Seat 6: lulu19911991 folded before Flop (didn't bet)
Seat 7: lexon3 folded before Flop (didn't bet)
Seat 8: Nestle170 folded before Flop (didn't bet)
Seat 9: KpNZ12 folded before Flop (didn't bet)



PokerStars Hand #228691795872:  Hold'em No Limit ($0.25/$0.50 USD) - 2021/07/30 18:30:23 ET
Table 'Knysna II' 9-max Seat #3 is the button
Seat 1: MarinaKraken ($50 in chips) 
Seat 2: Schwimbob80 ($28.38 in chips) 
Seat 3: goldenpig666 ($50 in chips) 
Seat 4: lonely fire ($74.92 in chips) 
Seat 5: MarsMiland ($50 in chips) 
Seat 6: lulu19911991 ($50 in chips) 
Seat 7: lexon3 ($57.03 in chips) 
Seat 8: Nestle170 ($71.27 in chips) 
Seat 9: KpNZ12 ($43.80 in chips) 
lonely fire: posts small blind $0.25
MarsMiland: posts big blind $0.50
*** HOLE CARDS ***
lulu19911991: folds 
lexon3: folds 
Nestle170: folds 
KpNZ12: folds 
MarinaKraken: folds 
Schwimbob80: calls $0.50
goldenpig666: folds 
lonely fire: raises $1.50 to $2
MarsMiland: folds 
Schwimbob80: calls $1.50
*** FLOP *** [7h 6h Th]
lonely fire: checks 
Schwimbob80: bets $4.28
lonely fire: folds 
Uncalled bet ($4.28) returned to Schwimbob80
Schwimbob80 collected $4.28 from pot
Schwimbob80: doesn't show hand 
*** SUMMARY ***
Total pot $4.50 | Rake $0.22 
Board [7h 6h Th]
Seat 1: MarinaKraken folded before Flop (didn't bet)
Seat 2: Schwimbob80 collected ($4.28)
Seat 3: goldenpig666 (button) folded before Flop (didn't bet)
Seat 4: lonely fire (small blind) folded on the Flop
Seat 5: MarsMiland (big blind) folded before Flop
Seat 6: lulu19911991 folded before Flop (didn't bet)
Seat 7: lexon3 folded before Flop (didn't bet)
Seat 8: Nestle170 folded before Flop (didn't bet)
Seat 9: KpNZ12 folded before Flop (didn't bet)



PokerStars Hand #228691814495:  Hold'em No Limit ($0.25/$0.50 USD) - 2021/07/30 18:31:09 ET
Table 'Knysna II' 9-max Seat #4 is the button
Seat 1: MarinaKraken ($50 in chips) 
Seat 2: Schwimbob80 ($30.66 in chips) 
Seat 3: goldenpig666 ($50 in chips) 
Seat 4: lonely fire ($72.92 in chips) 
Seat 5: MarsMiland ($50 in chips) 
Seat 6: lulu19911991 ($50 in chips) 
Seat 7: lexon3 ($57.03 in chips) 
Seat 8: Nestle170 ($71.27 in chips) 
Seat 9: KpNZ12 ($43.80 in chips) 
MarsMiland: posts small blind $0.25
lulu19911991: posts big blind $0.50
*** HOLE CARDS ***
lexon3: folds 
Nestle170: folds 
KpNZ12: folds 
MarinaKraken: folds 
Schwimbob80: calls $0.50
goldenpig666: folds 
lonely fire: folds 
MarsMiland: calls $0.25
lulu19911991: checks 
*** FLOP *** [6d 7c Ad]
MarsMiland: checks 
lulu19911991: checks 
Schwimbob80: bets $1.42
MarsMiland: folds 
lulu19911991: folds 
Uncalled bet ($1.42) returned to Schwimbob80
Schwimbob80 collected $1.42 from pot
Schwimbob80: doesn't show hand 
*** SUMMARY ***
Total pot $1.50 | Rake $0.08 
Board [6d 7c Ad]
Seat 1: MarinaKraken folded before Flop (didn't bet)
Seat 2: Schwimbob80 collected ($1.42)
Seat 3: goldenpig666 folded before Flop (didn't bet)
Seat 4: lonely fire (button) folded before Flop (didn't bet)
Seat 5: MarsMiland (small blind) folded on the Flop
Seat 6: lulu19911991 (big blind) folded on the Flop
Seat 7: lexon3 folded before Flop (didn't bet)
Seat 8: Nestle170 folded before Flop (didn't bet)
Seat 9: KpNZ12 folded before Flop (didn't bet)



PokerStars Hand #228691836562:  Hold'em No Limit ($0.25/$0.50 USD) - 2021/07/30 18:32:05 ET
Table 'Knysna II' 9-max Seat #5 is the button
Seat 1: MarinaKraken ($50 in chips) 
Seat 2: Schwimbob80 ($31.58 in chips) 
Seat 3: goldenpig666 ($50 in chips) 
Seat 4: lonely fire ($72.92 in chips) 
Seat 5: MarsMiland ($50 in chips) 
Seat 6: lulu19911991 ($50 in chips) 
Seat 7: lexon3 ($57.03 in chips) 
Seat 8: Nestle170 ($71.27 in chips) 
Seat 9: KpNZ12 ($43.80 in chips) 
lulu19911991: posts small blind $0.25
lexon3: posts big blind $0.50
*** HOLE CARDS ***
Nestle170: folds 
KpNZ12: calls $0.50
MarinaKraken: folds 
Schwimbob80: raises $1 to $1.50
goldenpig666: folds 
lonely fire: folds 
MarsMiland: folds 
lulu19911991: folds 
lexon3: folds 
KpNZ12: calls $1
*** FLOP *** [4s 6c 4c]
KpNZ12: checks 
Schwimbob80: bets $3.56
KpNZ12: folds 
Uncalled bet ($3.56) returned to Schwimbob80
Schwimbob80 collected $3.56 from pot
Schwimbob80: doesn't show hand 
*** SUMMARY ***
Total pot $3.75 | Rake $0.19 
Board [4s 6c 4c]
Seat 1: MarinaKraken folded before Flop (didn't bet)
Seat 2: Schwimbob80 collected ($3.56)
Seat 3: goldenpig666 folded before Flop (didn't bet)
Seat 4: lonely fire folded before Flop (didn't bet)
Seat 5: MarsMiland (button) folded before Flop (didn't bet)
Seat 6: lulu19911991 (small blind) folded before Flop
Seat 7: lexon3 (big blind) folded before Flop
Seat 8: Nestle170 folded before Flop (didn't bet)
Seat 9: KpNZ12 folded on the Flop



PokerStars Hand #228691851517:  Hold'em No Limit ($0.25/$0.50 USD) - 2021/07/30 18:32:42 ET
Table 'Knysna II' 9-max Seat #6 is the button
Seat 1: MarinaKraken ($50 in chips) 
Seat 2: Schwimbob80 ($33.64 in chips) 
Seat 3: goldenpig666 ($50 in chips) 
Seat 4: lonely fire ($72.92 in chips) 
Seat 5: MarsMiland ($50 in chips) 
Seat 6: lulu19911991 ($50 in chips) 
Seat 7: lexon3 ($56.53 in chips) 
Seat 8: Nestle170 ($71.27 in chips) 
Seat 9: KpNZ12 ($42.30 in chips) 
lexon3: posts small blind $0.25
Nestle170: posts big blind $0.50
*** HOLE CARDS ***
KpNZ12: calls $0.50
MarinaKraken: folds 
Schwimbob80: calls $0.50
goldenpig666: raises $2.50 to $3
lonely fire: folds 
MarsMiland: calls $3
lulu19911991: calls $3
lexon3: folds 
Nestle170: folds 
KpNZ12: calls $2.50
Schwimbob80: calls $2.50
*** FLOP *** [8s Js Ac]
KpNZ12: checks 
Schwimbob80: bets $30.64 and is all-in
goldenpig666: folds 
MarsMiland: raises $16.36 to $47 and is all-in
lulu19911991: calls $47 and is all-in
KpNZ12: folds 
*** TURN *** [8s Js Ac] [2s]
*** RIVER *** [8s Js Ac 2s] [Ah]
*** SHOW DOWN ***
MarsMiland: shows [Td Ad] (three of a kind, Aces)
lulu19911991: shows [Jc Jd] (a full house, Jacks full of Aces)
Schwimbob80: shows [Jh 8d] (two pair, Aces and Jacks)
lulu19911991 cashed out the hand for $127.93 | Cash Out Fee $1.29
*** SUMMARY ***
Total pot $140.39 Main pot $105.67. Side pot $32.72. | Rake $2 
Board [8s Js Ac 2s Ah]
Seat 1: MarinaKraken folded before Flop (didn't bet)
Seat 2: Schwimbob80 showed [Jh 8d] and lost with two pair, Aces and Jacks
Seat 3: goldenpig666 folded on the Flop
Seat 4: lonely fire folded before Flop (didn't bet)
Seat 5: MarsMiland showed [Td Ad] and lost with three of a kind, Aces
Seat 6: lulu19911991 (button) showed [Jc Jd] and won ($138.39) with a full house, Jacks full of Aces (pot not awarded as player cashed out)
Seat 7: lexon3 (small blind) folded before Flop
Seat 8: Nestle170 (big blind) folded before Flop
Seat 9: KpNZ12 folded on the Flop



PokerStars Hand #228691910244:  Hold'em No Limit ($0.25/$0.50 USD) - 2021/07/30 18:34:57 ET
Table 'Knysna II' 9-max Seat #7 is the button
Seat 1: MarinaKraken ($50 in chips) 
Seat 3: goldenpig666 ($50 in chips) 
Seat 4: lonely fire ($72.92 in chips) 
Seat 5: MarsMiland ($50 in chips) 
Seat 6: lulu19911991 ($127.93 in chips) 
Seat 7: lexon3 ($56.28 in chips) 
Seat 8: Nestle170 ($70.77 in chips) 
Seat 9: KpNZ12 ($39.30 in chips) 
Nestle170: posts small blind $0.25
KpNZ12: posts big blind $0.50
*** HOLE CARDS ***
MarinaKraken: folds 
goldenpig666: folds 
lonely fire: folds 
MarsMiland: folds 
lulu19911991: folds 
lexon3: folds 
Nestle170: folds 
Uncalled bet ($0.25) returned to KpNZ12
KpNZ12 collected $0.50 from pot
KpNZ12: doesn't show hand 
*** SUMMARY ***
Total pot $0.50 | Rake $0 
Seat 1: MarinaKraken folded before Flop (didn't bet)
Seat 3: goldenpig666 folded before Flop (didn't bet)
Seat 4: lonely fire folded before Flop (didn't bet)
Seat 5: MarsMiland folded before Flop (didn't bet)
Seat 6: lulu19911991 folded before Flop (didn't bet)
Seat 7: lexon3 (button) folded before Flop (didn't bet)
Seat 8: Nestle170 (small blind) folded before Flop
Seat 9: KpNZ12 (big blind) collected ($0.50)



PokerStars Hand #228691917918:  Hold'em No Limit ($0.25/$0.50 USD) - 2021/07/30 18:35:16 ET
Table 'Knysna II' 9-max Seat #8 is the button
Seat 1: MarinaKraken ($50 in chips) 
Seat 3: goldenpig666 ($50 in chips) 
Seat 4: lonely fire ($72.92 in chips) 
Seat 5: MarsMiland ($50 in chips) 
Seat 6: lulu19911991 ($127.93 in chips) 
Seat 7: lexon3 ($56.28 in chips) 
Seat 8: Nestle170 ($70.52 in chips) 
Seat 9: KpNZ12 ($39.55 in chips) 
KpNZ12: posts small blind $0.25
MarinaKraken: posts big blind $0.50
*** HOLE CARDS ***
goldenpig666: folds 
lonely fire: folds 
MarsMiland: folds 
lulu19911991: folds 
lexon3: folds 
Nestle170: folds 
KpNZ12: calls $0.25
MarinaKraken: checks 
*** FLOP *** [5c Jd Js]
KpNZ12: bets $0.50
MarinaKraken: raises $2.50 to $3
KpNZ12: calls $2.50
*** TURN *** [5c Jd Js] [7d]
KpNZ12: bets $0.50
MarinaKraken: raises $5.74 to $6.24
KpNZ12: calls $5.74
*** RIVER *** [5c Jd Js 7d] [4s]
KpNZ12: bets $0.50
MarinaKraken: calls $0.50
*** SHOW DOWN ***
KpNZ12: shows [Jc Th] (three of a kind, Jacks)
MarinaKraken: shows [Ac Jh] (three of a kind, Jacks - Ace kicker)
MarinaKraken collected $19.46 from pot
*** SUMMARY ***
Total pot $20.48 | Rake $1.02 
Board [5c Jd Js 7d 4s]
Seat 1: MarinaKraken (big blind) showed [Ac Jh] and won ($19.46) with three of a kind, Jacks
Seat 3: goldenpig666 folded before Flop (didn't bet)
Seat 4: lonely fire folded before Flop (didn't bet)
Seat 5: MarsMiland folded before Flop (didn't bet)
Seat 6: lulu19911991 folded before Flop (didn't bet)
Seat 7: lexon3 folded before Flop (didn't bet)
Seat 8: Nestle170 (button) folded before Flop (didn't bet)
Seat 9: KpNZ12 (small blind) showed [Jc Th] and lost with three of a kind, Jacks



PokerStars Hand #228691954704:  Hold'em No Limit ($0.25/$0.50 USD) - 2021/07/30 18:36:49 ET
Table 'Knysna II' 9-max Seat #9 is the button
Seat 1: MarinaKraken ($59.22 in chips) 
Seat 4: lonely fire ($72.92 in chips) 
Seat 5: MarsMiland ($50 in chips) 
Seat 6: lulu19911991 ($127.93 in chips) 
Seat 7: lexon3 ($56.28 in chips) 
Seat 8: Nestle170 ($70.52 in chips) 
Seat 9: KpNZ12 ($29.31 in chips) 
MarinaKraken: posts small blind $0.25
goldenpig666: is sitting out 
lonely fire: posts big blind $0.50
*** HOLE CARDS ***
MarsMiland: folds 
lulu19911991: folds 
lexon3: folds 
Nestle170: folds 
KpNZ12: folds 
MarinaKraken: folds 
Uncalled bet ($0.25) returned to lonely fire
lonely fire collected $0.50 from pot
lonely fire: doesn't show hand 
*** SUMMARY ***
Total pot $0.50 | Rake $0 
Seat 1: MarinaKraken (small blind) folded before Flop
Seat 4: lonely fire (big blind) collected ($0.50)
Seat 5: MarsMiland folded before Flop (didn't bet)
Seat 6: lulu19911991 folded before Flop (didn't bet)
Seat 7: lexon3 folded before Flop (didn't bet)
Seat 8: Nestle170 folded before Flop (didn't bet)
Seat 9: KpNZ12 (button) folded before Flop (didn't bet)



PokerStars Hand #228691959850:  Hold'em No Limit ($0.25/$0.50 USD) - 2021/07/30 18:37:02 ET
Table 'Knysna II' 9-max Seat #1 is the button
Seat 1: MarinaKraken ($58.97 in chips) 
Seat 4: lonely fire ($73.17 in chips) 
Seat 5: MarsMiland ($50 in chips) 
Seat 6: lulu19911991 ($127.93 in chips) 
Seat 7: lexon3 ($56.28 in chips) 
Seat 8: Nestle170 ($70.52 in chips) 
Seat 9: KpNZ12 ($29.31 in chips) 
lonely fire: posts small blind $0.25
MarsMiland: posts big blind $0.50
*** HOLE CARDS ***
lulu19911991: folds 
lexon3: folds 
Schwimbob80 leaves the table
Nestle170: folds 
KpNZ12: folds 
KpNZ12 leaves the table
goldenpig666 leaves the table
MarinaKraken: raises $0.75 to $1.25
lonely fire: folds 
MarsMiland: folds 
Uncalled bet ($0.75) returned to MarinaKraken
MarinaKraken collected $1.25 from pot
MarinaKraken: doesn't show hand 
*** SUMMARY ***
Total pot $1.25 | Rake $0 
Seat 1: MarinaKraken (button) collected ($1.25)
Seat 4: lonely fire (small blind) folded before Flop
Seat 5: MarsMiland (big blind) folded before Flop
Seat 6: lulu19911991 folded before Flop (didn't bet)
Seat 7: lexon3 folded before Flop (didn't bet)
Seat 8: Nestle170 folded before Flop (didn't bet)
Seat 9: KpNZ12 folded before Flop (didn't bet)



PokerStars Hand #228691976573:  Hold'em No Limit ($0.25/$0.50 USD) - 2021/07/30 18:37:44 ET
Table 'Knysna II' 9-max Seat #4 is the button
Seat 1: MarinaKraken ($59.72 in chips) 
Seat 4: lonely fire ($72.92 in chips) 
Seat 5: MarsMiland ($50 in chips) 
Seat 6: lulu19911991 ($127.93 in chips) 
Seat 7: lexon3 ($56.28 in chips) 
Seat 8: Nestle170 ($70.52 in chips) 
MarsMiland: posts small blind $0.25
lulu19911991: posts big blind $0.50
*** HOLE CARDS ***
lexon3: folds 
Nestle170: folds 
MarinaKraken: folds 
lonely fire: raises $0.75 to $1.25
MarsMiland: folds 
lulu19911991: raises $3.25 to $4.50
lonely fire: folds 
Uncalled bet ($3.25) returned to lulu19911991
lulu19911991 collected $2.75 from pot
lulu19911991: doesn't show hand 
*** SUMMARY ***
Total pot $2.75 | Rake $0 
Seat 1: MarinaKraken folded before Flop (didn't bet)
Seat 4: lonely fire (button) folded before Flop
Seat 5: MarsMiland (small blind) folded before Flop
Seat 6: lulu19911991 (big blind) collected ($2.75)
Seat 7: lexon3 folded before Flop (didn't bet)
Seat 8: Nestle170 folded before Flop (didn't bet)



PokerStars Hand #228691986465:  Hold'em No Limit ($0.25/$0.50 USD) - 2021/07/30 18:38:09 ET
Table 'Knysna II' 9-max Seat #5 is the button
Seat 1: MarinaKraken ($59.72 in chips) 
Seat 4: lonely fire ($71.67 in chips) 
Seat 5: MarsMiland ($50 in chips) 
Seat 6: lulu19911991 ($129.43 in chips) 
Seat 7: lexon3 ($56.28 in chips) 
Seat 8: Nestle170 ($70.52 in chips) 
lulu19911991: posts small blind $0.25
lexon3: posts big blind $0.50
*** HOLE CARDS ***
Nestle170: raises $1 to $1.50
MarinaKraken: folds 
lonely fire: folds 
MarsMiland: folds 
lulu19911991: folds 
lexon3: raises $3.50 to $5
MarsMiland leaves the table
Nestle170: calls $3.50
*** FLOP *** [6d Ac Jh]
lexon3: bets $3.24
Nestle170: folds 
Uncalled bet ($3.24) returned to lexon3
lexon3 collected $9.74 from pot
lexon3: doesn't show hand 
*** SUMMARY ***
Total pot $10.25 | Rake $0.51 
Board [6d Ac Jh]
Seat 1: MarinaKraken folded before Flop (didn't bet)
Seat 4: lonely fire folded before Flop (didn't bet)
Seat 5: MarsMiland (button) folded before Flop (didn't bet)
Seat 6: lulu19911991 (small blind) folded before Flop
Seat 7: lexon3 (big blind) collected ($9.74)
Seat 8: Nestle170 folded on the Flop



PokerStars Hand #228692005520:  Hold'em No Limit ($0.25/$0.50 USD) - 2021/07/30 18:38:57 ET
Table 'Knysna II' 9-max Seat #6 is the button
Seat 1: MarinaKraken ($59.72 in chips) 
Seat 4: lonely fire ($71.67 in chips) 
Seat 6: lulu19911991 ($129.18 in chips) 
Seat 7: lexon3 ($61.02 in chips) 
lexon3: posts small blind $0.25
Nestle170: is sitting out 
MarinaKraken: posts big blind $0.50
*** HOLE CARDS ***
lonely fire: folds 
Nestle170 leaves the table
lulu19911991: folds 
lexon3: folds 
Uncalled bet ($0.25) returned to MarinaKraken
MarinaKraken collected $0.50 from pot
MarinaKraken: doesn't show hand 
*** SUMMARY ***
Total pot $0.50 | Rake $0 
Seat 1: MarinaKraken (big blind) collected ($0.50)
Seat 4: lonely fire folded before Flop (didn't bet)
Seat 6: lulu19911991 (button) folded before Flop (didn't bet)
Seat 7: lexon3 (small blind) folded before Flop



