PokerStars Hand #228684906561:  Hold'em No Limit ($0.25/$0.50 USD) - 2021/07/30 14:14:01 ET
Table 'Gorgo III' 9-max Seat #9 is the button
Seat 1: v.sting ($50 in chips) 
Seat 2: wami1981 ($49.25 in chips) 
Seat 3: pokermasse ($50.50 in chips) 
Seat 5: grampysix ($40.20 in chips) 
Seat 6: finstrel ($50 in chips) 
Seat 9: strannikac ($77.05 in chips) 
v.sting: posts small blind $0.25
wami1981: posts big blind $0.50
Kolyan2114: sits out 
finstrel: posts big blind $0.50
Medved219: sits out 
StudentRB: sits out 
*** HOLE CARDS ***
pokermasse: folds 
grampysix: folds 
finstrel: checks 
strannikac: calls $0.50
v.sting: calls $0.25
wami1981: checks 
*** FLOP *** [Jh 8d Qh]
v.sting: checks 
wami1981: bets $1.90
finstrel: folds 
strannikac: folds 
v.sting: folds 
Uncalled bet ($1.90) returned to wami1981
wami1981 collected $1.88 from pot
wami1981: doesn't show hand 
*** SUMMARY ***
Total pot $2 | Rake $0.12 
Board [Jh 8d Qh]
Seat 1: v.sting (small blind) folded on the Flop
Seat 2: wami1981 (big blind) collected ($1.88)
Seat 3: pokermasse folded before Flop (didn't bet)
Seat 5: grampysix folded before Flop (didn't bet)
Seat 6: finstrel folded on the Flop (didn't bet)
Seat 9: strannikac (button) folded on the Flop



PokerStars Hand #228684927652:  Hold'em No Limit ($0.25/$0.50 USD) - 2021/07/30 14:14:50 ET
Table 'Gorgo III' 9-max Seat #1 is the button
Seat 1: v.sting ($50 in chips) 
Seat 2: wami1981 ($50.63 in chips) 
Seat 3: pokermasse ($50.50 in chips) 
Seat 5: grampysix ($40.20 in chips) 
Seat 6: finstrel ($49.50 in chips) 
Seat 9: strannikac ($76.55 in chips) 
wami1981: posts small blind $0.25
pokermasse: posts big blind $0.50
Kolyan2114: sits out 
Medved219: sits out 
StudentRB: sits out 
*** HOLE CARDS ***
grampysix: calls $0.50
finstrel: folds 
strannikac: folds 
v.sting: folds 
wami1981: raises $1.50 to $2
pokermasse: folds 
grampysix: raises $2 to $4
wami1981: calls $2
*** FLOP *** [Td Qh Ad]
wami1981: bets $5
grampysix: calls $5
*** TURN *** [Td Qh Ad] [2h]
wami1981: bets $11.50
grampysix: raises $11.50 to $23
wami1981: raises $11.50 to $34.50
grampysix: calls $8.20 and is all-in
Uncalled bet ($3.30) returned to wami1981
*** RIVER *** [Td Qh Ad 2h] [5c]
*** SHOW DOWN ***
wami1981: shows [Kd Jh] (a straight, Ten to Ace)
grampysix: shows [As Ac] (three of a kind, Aces)
wami1981 collected $78.40 from pot
*** SUMMARY ***
Total pot $80.90 | Rake $2.50 
Board [Td Qh Ad 2h 5c]
Seat 1: v.sting (button) folded before Flop (didn't bet)
Seat 2: wami1981 (small blind) showed [Kd Jh] and won ($78.40) with a straight, Ten to Ace
Seat 3: pokermasse (big blind) folded before Flop
Seat 5: grampysix showed [As Ac] and lost with three of a kind, Aces
Seat 6: finstrel folded before Flop (didn't bet)
Seat 9: strannikac folded before Flop (didn't bet)



PokerStars Hand #228684958142:  Hold'em No Limit ($0.25/$0.50 USD) - 2021/07/30 14:16:02 ET
Table 'Gorgo III' 9-max Seat #2 is the button
Seat 1: v.sting ($50 in chips) 
Seat 2: wami1981 ($88.83 in chips) 
Seat 3: pokermasse ($50 in chips) 
Seat 4: Kolyan2114 ($62.58 in chips) 
Seat 6: finstrel ($49.50 in chips) 
Seat 9: strannikac ($76.55 in chips) 
pokermasse: posts small blind $0.25
Kolyan2114: posts big blind $0.50
Medved219: sits out 
StudentRB: sits out 
*** HOLE CARDS ***
finstrel: folds 
strannikac: folds 
v.sting: folds 
grampysix leaves the table
wami1981: raises $1.25 to $1.75
pokermasse: folds 
Kolyan2114: folds 
Uncalled bet ($1.25) returned to wami1981
wami1981 collected $1.25 from pot
wami1981: doesn't show hand 
*** SUMMARY ***
Total pot $1.25 | Rake $0 
Seat 1: v.sting folded before Flop (didn't bet)
Seat 2: wami1981 (button) collected ($1.25)
Seat 3: pokermasse (small blind) folded before Flop
Seat 4: Kolyan2114 (big blind) folded before Flop
Seat 6: finstrel folded before Flop (didn't bet)
Seat 9: strannikac folded before Flop (didn't bet)



PokerStars Hand #228684965093:  Hold'em No Limit ($0.25/$0.50 USD) - 2021/07/30 14:16:18 ET
Table 'Gorgo III' 9-max Seat #3 is the button
Seat 1: v.sting ($50 in chips) 
Seat 2: wami1981 ($89.58 in chips) 
Seat 3: pokermasse ($49.75 in chips) 
Seat 4: Kolyan2114 ($62.08 in chips) 
Seat 6: finstrel ($49.50 in chips) 
Seat 9: strannikac ($76.55 in chips) 
Kolyan2114: posts small blind $0.25
finstrel: posts big blind $0.50
Medved219: sits out 
StudentRB: sits out 
*** HOLE CARDS ***
PleBeY95 joins the table at seat #5 
strannikac: raises $1 to $1.50
v.sting: raises $3 to $4.50
wami1981: folds 
pokermasse: folds 
Kolyan2114: folds 
finstrel: folds 
strannikac: calls $3
*** FLOP *** [5s 6c Jd]
strannikac: checks 
v.sting: bets $3.06
strannikac: folds 
Uncalled bet ($3.06) returned to v.sting
v.sting collected $9.26 from pot
v.sting: doesn't show hand 
*** SUMMARY ***
Total pot $9.75 | Rake $0.49 
Board [5s 6c Jd]
Seat 1: v.sting collected ($9.26)
Seat 2: wami1981 folded before Flop (didn't bet)
Seat 3: pokermasse (button) folded before Flop (didn't bet)
Seat 4: Kolyan2114 (small blind) folded before Flop
Seat 6: finstrel (big blind) folded before Flop
Seat 9: strannikac folded on the Flop



PokerStars Hand #228684981801:  Hold'em No Limit ($0.25/$0.50 USD) - 2021/07/30 14:16:58 ET
Table 'Gorgo III' 9-max Seat #4 is the button
Seat 1: v.sting ($54.76 in chips) 
Seat 2: wami1981 ($89.58 in chips) 
Seat 3: pokermasse ($49.75 in chips) 
Seat 4: Kolyan2114 ($61.83 in chips) 
Seat 6: finstrel ($49 in chips) 
Seat 7: Medved219 ($50 in chips) 
Seat 9: strannikac ($72.05 in chips) 
finstrel: posts small blind $0.25
Medved219: posts big blind $0.50
StudentRB: sits out 
*** HOLE CARDS ***
strannikac: folds 
v.sting: folds 
wami1981: raises $1.25 to $1.75
pokermasse: folds 
Kolyan2114: folds 
finstrel: raises $2.25 to $4
Medved219: folds 
wami1981: calls $2.25
*** FLOP *** [Jh 7h Qh]
finstrel: checks 
wami1981: bets $5
finstrel: raises $11.50 to $16.50
wami1981: raises $69.08 to $85.58 and is all-in
finstrel: folds 
Uncalled bet ($69.08) returned to wami1981
wami1981 collected $39 from pot
wami1981: doesn't show hand 
*** SUMMARY ***
Total pot $41.50 | Rake $2.50 
Board [Jh 7h Qh]
Seat 1: v.sting folded before Flop (didn't bet)
Seat 2: wami1981 collected ($39)
Seat 3: pokermasse folded before Flop (didn't bet)
Seat 4: Kolyan2114 (button) folded before Flop (didn't bet)
Seat 6: finstrel (small blind) folded on the Flop
Seat 7: Medved219 (big blind) folded before Flop
Seat 9: strannikac folded before Flop (didn't bet)



PokerStars Hand #228685019139:  Hold'em No Limit ($0.25/$0.50 USD) - 2021/07/30 14:18:26 ET
Table 'Gorgo III' 9-max Seat #6 is the button
Seat 1: v.sting ($54.76 in chips) 
Seat 3: pokermasse ($49.75 in chips) 
Seat 4: Kolyan2114 ($61.83 in chips) 
Seat 5: PleBeY95 ($50 in chips) 
Seat 6: finstrel ($28.50 in chips) 
Seat 7: Medved219 ($50 in chips) 
Seat 8: StudentRB ($50 in chips) 
Seat 9: strannikac ($72.05 in chips) 
Medved219: posts small blind $0.25
StudentRB: posts big blind $0.50
PleBeY95: posts big blind $0.50
*** HOLE CARDS ***
strannikac: folds 
v.sting: folds 
pokermasse: folds 
Kolyan2114: folds 
PleBeY95: raises $1 to $1.50
finstrel: folds 
Medved219: raises $4 to $5.50
StudentRB: folds 
PleBeY95: calls $4
*** FLOP *** [Js 9h 2s]
Medved219: checks 
PleBeY95: bets $3.60
Medved219: calls $3.60
*** TURN *** [Js 9h 2s] [Qs]
Medved219: checks 
PleBeY95: bets $13.32
Medved219: folds 
Uncalled bet ($13.32) returned to PleBeY95
PleBeY95 collected $17.76 from pot
*** SUMMARY ***
Total pot $18.70 | Rake $0.94 
Board [Js 9h 2s Qs]
Seat 1: v.sting folded before Flop (didn't bet)
Seat 3: pokermasse folded before Flop (didn't bet)
Seat 4: Kolyan2114 folded before Flop (didn't bet)
Seat 5: PleBeY95 collected ($17.76)
Seat 6: finstrel (button) folded before Flop (didn't bet)
Seat 7: Medved219 (small blind) folded on the Turn
Seat 8: StudentRB (big blind) folded before Flop
Seat 9: strannikac folded before Flop (didn't bet)



PokerStars Hand #228685043253:  Hold'em No Limit ($0.25/$0.50 USD) - 2021/07/30 14:19:23 ET
Table 'Gorgo III' 9-max Seat #7 is the button
Seat 1: v.sting ($54.76 in chips) 
Seat 3: pokermasse ($49.75 in chips) 
Seat 4: Kolyan2114 ($61.83 in chips) 
Seat 5: PleBeY95 ($58.66 in chips) 
Seat 6: finstrel ($45.90 in chips) 
Seat 7: Medved219 ($50 in chips) 
Seat 8: StudentRB ($50 in chips) 
Seat 9: strannikac ($72.05 in chips) 
StudentRB: posts small blind $0.25
strannikac: posts big blind $0.50
*** HOLE CARDS ***
v.sting: folds 
pokermasse: folds 
Kolyan2114: raises $0.75 to $1.25
PleBeY95: folds 
finstrel: calls $1.25
Medved219: folds 
StudentRB: folds 
strannikac: calls $0.75
*** FLOP *** [3s 5c 7s]
strannikac: checks 
Kolyan2114: checks 
finstrel: bets $1.50
strannikac: folds 
Kolyan2114: folds 
Uncalled bet ($1.50) returned to finstrel
finstrel collected $3.80 from pot
*** SUMMARY ***
Total pot $4 | Rake $0.20 
Board [3s 5c 7s]
Seat 1: v.sting folded before Flop (didn't bet)
Seat 3: pokermasse folded before Flop (didn't bet)
Seat 4: Kolyan2114 folded on the Flop
Seat 5: PleBeY95 folded before Flop (didn't bet)
Seat 6: finstrel collected ($3.80)
Seat 7: Medved219 (button) folded before Flop (didn't bet)
Seat 8: StudentRB (small blind) folded before Flop
Seat 9: strannikac (big blind) folded on the Flop



PokerStars Hand #228685064279:  Hold'em No Limit ($0.25/$0.50 USD) - 2021/07/30 14:20:12 ET
Table 'Gorgo III' 9-max Seat #8 is the button
Seat 1: v.sting ($54.76 in chips) 
Seat 3: pokermasse ($49.75 in chips) 
Seat 4: Kolyan2114 ($60.58 in chips) 
Seat 5: PleBeY95 ($58.66 in chips) 
Seat 6: finstrel ($48.45 in chips) 
Seat 7: Medved219 ($50 in chips) 
Seat 8: StudentRB ($50 in chips) 
Seat 9: strannikac ($70.80 in chips) 
strannikac: posts small blind $0.25
v.sting: posts big blind $0.50
*** HOLE CARDS ***
pokermasse: folds 
Kolyan2114: folds 
PleBeY95: folds 
finstrel: raises $1 to $1.50
Medved219: folds 
StudentRB: folds 
strannikac: folds 
v.sting: calls $1
*** FLOP *** [8h 3h 5h]
v.sting: checks 
finstrel: checks 
*** TURN *** [8h 3h 5h] [6s]
v.sting: checks 
finstrel: bets $1.55
v.sting: calls $1.55
*** RIVER *** [8h 3h 5h 6s] [Kc]
v.sting: checks 
finstrel: bets $3.50
v.sting: calls $3.50
*** SHOW DOWN ***
finstrel: shows [Kd As] (a pair of Kings)
v.sting: mucks hand 
finstrel collected $12.68 from pot
*** SUMMARY ***
Total pot $13.35 | Rake $0.67 
Board [8h 3h 5h 6s Kc]
Seat 1: v.sting (big blind) mucked
Seat 3: pokermasse folded before Flop (didn't bet)
Seat 4: Kolyan2114 folded before Flop (didn't bet)
Seat 5: PleBeY95 folded before Flop (didn't bet)
Seat 6: finstrel showed [Kd As] and won ($12.68) with a pair of Kings
Seat 7: Medved219 folded before Flop (didn't bet)
Seat 8: StudentRB (button) folded before Flop (didn't bet)
Seat 9: strannikac (small blind) folded before Flop



PokerStars Hand #228685097160:  Hold'em No Limit ($0.25/$0.50 USD) - 2021/07/30 14:21:30 ET
Table 'Gorgo III' 9-max Seat #9 is the button
Seat 1: v.sting ($50 in chips) 
Seat 3: pokermasse ($49.75 in chips) 
Seat 4: Kolyan2114 ($60.58 in chips) 
Seat 5: PleBeY95 ($58.66 in chips) 
Seat 6: finstrel ($54.58 in chips) 
Seat 7: Medved219 ($50 in chips) 
Seat 8: StudentRB ($50 in chips) 
Seat 9: strannikac ($70.55 in chips) 
v.sting: posts small blind $0.25
pokermasse: posts big blind $0.50
*** HOLE CARDS ***
Kolyan2114: folds 
PleBeY95: folds 
finstrel: folds 
Medved219: folds 
StudentRB: folds 
strannikac: folds 
v.sting: folds 
Uncalled bet ($0.25) returned to pokermasse
pokermasse collected $0.50 from pot
pokermasse: doesn't show hand 
*** SUMMARY ***
Total pot $0.50 | Rake $0 
Seat 1: v.sting (small blind) folded before Flop
Seat 3: pokermasse (big blind) collected ($0.50)
Seat 4: Kolyan2114 folded before Flop (didn't bet)
Seat 5: PleBeY95 folded before Flop (didn't bet)
Seat 6: finstrel folded before Flop (didn't bet)
Seat 7: Medved219 folded before Flop (didn't bet)
Seat 8: StudentRB folded before Flop (didn't bet)
Seat 9: strannikac (button) folded before Flop (didn't bet)



PokerStars Hand #228685100834:  Hold'em No Limit ($0.25/$0.50 USD) - 2021/07/30 14:21:39 ET
Table 'Gorgo III' 9-max Seat #1 is the button
Seat 1: v.sting ($50 in chips) 
Seat 3: pokermasse ($50 in chips) 
Seat 4: Kolyan2114 ($60.58 in chips) 
Seat 5: PleBeY95 ($58.66 in chips) 
Seat 6: finstrel ($54.58 in chips) 
Seat 7: Medved219 ($50 in chips) 
Seat 8: StudentRB ($50 in chips) 
Seat 9: strannikac ($70.55 in chips) 
pokermasse: posts small blind $0.25
Kolyan2114: posts big blind $0.50
*** HOLE CARDS ***
PleBeY95: folds 
finstrel: folds 
Medved219: folds 
StudentRB: folds 
strannikac: folds 
v.sting: raises $0.60 to $1.10
pokermasse: folds 
Kolyan2114: raises $3.90 to $5
v.sting: calls $3.90
*** FLOP *** [7d 4c Ks]
Kolyan2114: checks 
v.sting: checks 
*** TURN *** [7d 4c Ks] [2d]
Kolyan2114: bets $3.90
v.sting: calls $3.90
*** RIVER *** [7d 4c Ks 2d] [Jh]
Kolyan2114: checks 
v.sting: checks 
*** SHOW DOWN ***
Kolyan2114: shows [7c 6c] (a pair of Sevens)
v.sting: mucks hand 
Kolyan2114 collected $17.15 from pot
*** SUMMARY ***
Total pot $18.05 | Rake $0.90 
Board [7d 4c Ks 2d Jh]
Seat 1: v.sting (button) mucked
Seat 3: pokermasse (small blind) folded before Flop
Seat 4: Kolyan2114 (big blind) showed [7c 6c] and won ($17.15) with a pair of Sevens
Seat 5: PleBeY95 folded before Flop (didn't bet)
Seat 6: finstrel folded before Flop (didn't bet)
Seat 7: Medved219 folded before Flop (didn't bet)
Seat 8: StudentRB folded before Flop (didn't bet)
Seat 9: strannikac folded before Flop (didn't bet)



PokerStars Hand #228685126653:  Hold'em No Limit ($0.25/$0.50 USD) - 2021/07/30 14:22:40 ET
Table 'Gorgo III' 9-max Seat #3 is the button
Seat 1: v.sting ($50 in chips) 
Seat 3: pokermasse ($49.75 in chips) 
Seat 4: Kolyan2114 ($68.83 in chips) 
Seat 5: PleBeY95 ($58.66 in chips) 
Seat 6: finstrel ($54.58 in chips) 
Seat 7: Medved219 ($50 in chips) 
Seat 8: StudentRB ($50 in chips) 
Seat 9: strannikac ($70.55 in chips) 
Kolyan2114: posts small blind $0.25
PleBeY95: posts big blind $0.50
*** HOLE CARDS ***
finstrel: folds 
Medved219: folds 
StudentRB: folds 
strannikac: folds 
v.sting: folds 
pokermasse: folds 
Kolyan2114: folds 
Uncalled bet ($0.25) returned to PleBeY95
PleBeY95 collected $0.50 from pot
*** SUMMARY ***
Total pot $0.50 | Rake $0 
Seat 1: v.sting folded before Flop (didn't bet)
Seat 3: pokermasse (button) folded before Flop (didn't bet)
Seat 4: Kolyan2114 (small blind) folded before Flop
Seat 5: PleBeY95 (big blind) collected ($0.50)
Seat 6: finstrel folded before Flop (didn't bet)
Seat 7: Medved219 folded before Flop (didn't bet)
Seat 8: StudentRB folded before Flop (didn't bet)
Seat 9: strannikac folded before Flop (didn't bet)



PokerStars Hand #228685131693:  Hold'em No Limit ($0.25/$0.50 USD) - 2021/07/30 14:22:52 ET
Table 'Gorgo III' 9-max Seat #4 is the button
Seat 1: v.sting ($50 in chips) 
Seat 3: pokermasse ($49.75 in chips) 
Seat 4: Kolyan2114 ($68.58 in chips) 
Seat 5: PleBeY95 ($58.91 in chips) 
Seat 6: finstrel ($54.58 in chips) 
Seat 7: Medved219 ($50 in chips) 
Seat 8: StudentRB ($50 in chips) 
Seat 9: strannikac ($70.55 in chips) 
PleBeY95: posts small blind $0.25
finstrel: posts big blind $0.50
*** HOLE CARDS ***
Medved219: folds 
StudentRB: folds 
strannikac: folds 
v.sting: folds 
pokermasse: folds 
Kolyan2114: folds 
PleBeY95: folds 
Uncalled bet ($0.25) returned to finstrel
finstrel collected $0.50 from pot
*** SUMMARY ***
Total pot $0.50 | Rake $0 
Seat 1: v.sting folded before Flop (didn't bet)
Seat 3: pokermasse folded before Flop (didn't bet)
Seat 4: Kolyan2114 (button) folded before Flop (didn't bet)
Seat 5: PleBeY95 (small blind) folded before Flop
Seat 6: finstrel (big blind) collected ($0.50)
Seat 7: Medved219 folded before Flop (didn't bet)
Seat 8: StudentRB folded before Flop (didn't bet)
Seat 9: strannikac folded before Flop (didn't bet)



PokerStars Hand #228685138955:  Hold'em No Limit ($0.25/$0.50 USD) - 2021/07/30 14:23:09 ET
Table 'Gorgo III' 9-max Seat #5 is the button
Seat 1: v.sting ($50 in chips) 
Seat 3: pokermasse ($49.75 in chips) 
Seat 4: Kolyan2114 ($68.58 in chips) 
Seat 5: PleBeY95 ($58.66 in chips) 
Seat 6: finstrel ($54.83 in chips) 
Seat 7: Medved219 ($50 in chips) 
Seat 8: StudentRB ($50 in chips) 
Seat 9: strannikac ($70.55 in chips) 
finstrel: posts small blind $0.25
Medved219: posts big blind $0.50
*** HOLE CARDS ***
StudentRB: folds 
strannikac: folds 
v.sting: folds 
pokermasse: folds 
Kolyan2114: folds 
PleBeY95: raises $0.75 to $1.25
finstrel: calls $1
Medved219: folds 
*** FLOP *** [4h 2s 6d]
finstrel: checks 
PleBeY95: checks 
*** TURN *** [4h 2s 6d] [9d]
finstrel: bets $1.43
PleBeY95: folds 
Uncalled bet ($1.43) returned to finstrel
finstrel collected $2.85 from pot
*** SUMMARY ***
Total pot $3 | Rake $0.15 
Board [4h 2s 6d 9d]
Seat 1: v.sting folded before Flop (didn't bet)
Seat 3: pokermasse folded before Flop (didn't bet)
Seat 4: Kolyan2114 folded before Flop (didn't bet)
Seat 5: PleBeY95 (button) folded on the Turn
Seat 6: finstrel (small blind) collected ($2.85)
Seat 7: Medved219 (big blind) folded before Flop
Seat 8: StudentRB folded before Flop (didn't bet)
Seat 9: strannikac folded before Flop (didn't bet)



PokerStars Hand #228685155845:  Hold'em No Limit ($0.25/$0.50 USD) - 2021/07/30 14:23:49 ET
Table 'Gorgo III' 9-max Seat #6 is the button
Seat 1: v.sting ($50 in chips) 
Seat 3: pokermasse ($49.75 in chips) 
Seat 4: Kolyan2114 ($68.58 in chips) 
Seat 5: PleBeY95 ($57.41 in chips) 
Seat 6: finstrel ($56.43 in chips) 
Seat 7: Medved219 ($50 in chips) 
Seat 8: StudentRB ($50 in chips) 
Seat 9: strannikac ($70.55 in chips) 
Medved219: posts small blind $0.25
StudentRB: posts big blind $0.50
*** HOLE CARDS ***
strannikac: raises $0.50 to $1
v.sting: folds 
pokermasse: folds 
Kolyan2114: folds 
PleBeY95: folds 
finstrel: folds 
Medved219: raises $3 to $4
StudentRB: folds 
strannikac: folds 
Uncalled bet ($3) returned to Medved219
Medved219 collected $2.50 from pot
Medved219: doesn't show hand 
*** SUMMARY ***
Total pot $2.50 | Rake $0 
Seat 1: v.sting folded before Flop (didn't bet)
Seat 3: pokermasse folded before Flop (didn't bet)
Seat 4: Kolyan2114 folded before Flop (didn't bet)
Seat 5: PleBeY95 folded before Flop (didn't bet)
Seat 6: finstrel (button) folded before Flop (didn't bet)
Seat 7: Medved219 (small blind) collected ($2.50)
Seat 8: StudentRB (big blind) folded before Flop
Seat 9: strannikac folded before Flop



PokerStars Hand #228685166547:  Hold'em No Limit ($0.25/$0.50 USD) - 2021/07/30 14:24:15 ET
Table 'Gorgo III' 9-max Seat #7 is the button
Seat 1: v.sting ($50 in chips) 
Seat 3: pokermasse ($49.75 in chips) 
Seat 4: Kolyan2114 ($68.58 in chips) 
Seat 5: PleBeY95 ($57.41 in chips) 
Seat 6: finstrel ($56.43 in chips) 
Seat 7: Medved219 ($51.50 in chips) 
Seat 8: StudentRB ($50 in chips) 
Seat 9: strannikac ($69.55 in chips) 
StudentRB: posts small blind $0.25
strannikac: posts big blind $0.50
*** HOLE CARDS ***
v.sting: folds 
pokermasse: folds 
Kolyan2114: folds 
PleBeY95: folds 
finstrel: folds 
Medved219: folds 
StudentRB: folds 
Uncalled bet ($0.25) returned to strannikac
strannikac collected $0.50 from pot
strannikac: doesn't show hand 
*** SUMMARY ***
Total pot $0.50 | Rake $0 
Seat 1: v.sting folded before Flop (didn't bet)
Seat 3: pokermasse folded before Flop (didn't bet)
Seat 4: Kolyan2114 folded before Flop (didn't bet)
Seat 5: PleBeY95 folded before Flop (didn't bet)
Seat 6: finstrel folded before Flop (didn't bet)
Seat 7: Medved219 (button) folded before Flop (didn't bet)
Seat 8: StudentRB (small blind) folded before Flop
Seat 9: strannikac (big blind) collected ($0.50)



PokerStars Hand #228685172404:  Hold'em No Limit ($0.25/$0.50 USD) - 2021/07/30 14:24:29 ET
Table 'Gorgo III' 9-max Seat #8 is the button
Seat 1: v.sting ($50 in chips) 
Seat 3: pokermasse ($49.75 in chips) 
Seat 4: Kolyan2114 ($68.58 in chips) 
Seat 5: PleBeY95 ($57.41 in chips) 
Seat 6: finstrel ($56.43 in chips) 
Seat 7: Medved219 ($51.50 in chips) 
Seat 8: StudentRB ($50 in chips) 
Seat 9: strannikac ($69.80 in chips) 
strannikac: posts small blind $0.25
v.sting: posts big blind $0.50
*** HOLE CARDS ***
pokermasse: folds 
Kolyan2114: folds 
PleBeY95: folds 
finstrel: raises $1 to $1.50
Medved219: folds 
StudentRB: folds 
strannikac: calls $1.25
v.sting: folds 
*** FLOP *** [Ts 2d Jd]
strannikac: checks 
finstrel: bets $1.66
strannikac: calls $1.66
*** TURN *** [Ts 2d Jd] [3s]
strannikac: checks 
finstrel: bets $3.24
strannikac: calls $3.24
*** RIVER *** [Ts 2d Jd 3s] [Qc]
strannikac: checks 
finstrel: bets $12.64
strannikac: folds 
Uncalled bet ($12.64) returned to finstrel
finstrel collected $12.64 from pot
*** SUMMARY ***
Total pot $13.30 | Rake $0.66 
Board [Ts 2d Jd 3s Qc]
Seat 1: v.sting (big blind) folded before Flop
Seat 3: pokermasse folded before Flop (didn't bet)
Seat 4: Kolyan2114 folded before Flop (didn't bet)
Seat 5: PleBeY95 folded before Flop (didn't bet)
Seat 6: finstrel collected ($12.64)
Seat 7: Medved219 folded before Flop (didn't bet)
Seat 8: StudentRB (button) folded before Flop (didn't bet)
Seat 9: strannikac (small blind) folded on the River



PokerStars Hand #228685197146:  Hold'em No Limit ($0.25/$0.50 USD) - 2021/07/30 14:25:27 ET
Table 'Gorgo III' 9-max Seat #9 is the button
Seat 1: v.sting ($50 in chips) 
Seat 3: pokermasse ($49.75 in chips) 
Seat 4: Kolyan2114 ($68.58 in chips) 
Seat 5: PleBeY95 ($57.41 in chips) 
Seat 6: finstrel ($62.67 in chips) 
Seat 7: Medved219 ($51.50 in chips) 
Seat 8: StudentRB ($50 in chips) 
Seat 9: strannikac ($63.40 in chips) 
v.sting: posts small blind $0.25
pokermasse: posts big blind $0.50
*** HOLE CARDS ***
Kolyan2114: folds 
PleBeY95: folds 
finstrel: folds 
Medved219: raises $1 to $1.50
StudentRB: folds 
strannikac: folds 
v.sting: folds 
pokermasse: folds 
Uncalled bet ($1) returned to Medved219
Medved219 collected $1.25 from pot
Medved219: doesn't show hand 
*** SUMMARY ***
Total pot $1.25 | Rake $0 
Seat 1: v.sting (small blind) folded before Flop
Seat 3: pokermasse (big blind) folded before Flop
Seat 4: Kolyan2114 folded before Flop (didn't bet)
Seat 5: PleBeY95 folded before Flop (didn't bet)
Seat 6: finstrel folded before Flop (didn't bet)
Seat 7: Medved219 collected ($1.25)
Seat 8: StudentRB folded before Flop (didn't bet)
Seat 9: strannikac (button) folded before Flop (didn't bet)



PokerStars Hand #228685204787:  Hold'em No Limit ($0.25/$0.50 USD) - 2021/07/30 14:25:45 ET
Table 'Gorgo III' 9-max Seat #1 is the button
Seat 1: v.sting ($50 in chips) 
Seat 3: pokermasse ($49.25 in chips) 
Seat 4: Kolyan2114 ($68.58 in chips) 
Seat 5: PleBeY95 ($57.41 in chips) 
Seat 6: finstrel ($62.67 in chips) 
Seat 7: Medved219 ($52.25 in chips) 
Seat 8: StudentRB ($50 in chips) 
Seat 9: strannikac ($63.40 in chips) 
pokermasse: posts small blind $0.25
Kolyan2114: posts big blind $0.50
*** HOLE CARDS ***
PleBeY95: folds 
finstrel: raises $1 to $1.50
Medved219: folds 
StudentRB: raises $3 to $4.50
strannikac: folds 
v.sting: folds 
pokermasse: folds 
Kolyan2114: folds 
finstrel: calls $3
*** FLOP *** [2c Qd 2s]
finstrel: checks 
StudentRB: bets $3.06
finstrel: calls $3.06
*** TURN *** [2c Qd 2s] [Kd]
finstrel: checks 
StudentRB: checks 
*** RIVER *** [2c Qd 2s Kd] [Ad]
finstrel: checks 
StudentRB: checks 
*** SHOW DOWN ***
finstrel: shows [As Qc] (two pair, Aces and Queens)
StudentRB: mucks hand 
finstrel collected $15.08 from pot
*** SUMMARY ***
Total pot $15.87 | Rake $0.79 
Board [2c Qd 2s Kd Ad]
Seat 1: v.sting (button) folded before Flop (didn't bet)
Seat 3: pokermasse (small blind) folded before Flop
Seat 4: Kolyan2114 (big blind) folded before Flop
Seat 5: PleBeY95 folded before Flop (didn't bet)
Seat 6: finstrel showed [As Qc] and won ($15.08) with two pair, Aces and Queens
Seat 7: Medved219 folded before Flop (didn't bet)
Seat 8: StudentRB mucked
Seat 9: strannikac folded before Flop (didn't bet)



PokerStars Hand #228685244710:  Hold'em No Limit ($0.25/$0.50 USD) - 2021/07/30 14:27:20 ET
Table 'Gorgo III' 9-max Seat #3 is the button
Seat 1: v.sting ($50 in chips) 
Seat 3: pokermasse ($49 in chips) 
Seat 4: Kolyan2114 ($68.08 in chips) 
Seat 5: PleBeY95 ($57.41 in chips) 
Seat 6: finstrel ($70.19 in chips) 
Seat 7: Medved219 ($52.25 in chips) 
Seat 8: StudentRB ($50 in chips) 
Seat 9: strannikac ($63.40 in chips) 
Kolyan2114: posts small blind $0.25
PleBeY95: posts big blind $0.50
wami1981: sits out 
*** HOLE CARDS ***
finstrel: folds 
Medved219: folds 
StudentRB: folds 
strannikac: folds 
v.sting: raises $0.75 to $1.25
pokermasse: folds 
Kolyan2114: folds 
PleBeY95: folds 
Uncalled bet ($0.75) returned to v.sting
v.sting collected $1.25 from pot
v.sting: doesn't show hand 
*** SUMMARY ***
Total pot $1.25 | Rake $0 
Seat 1: v.sting collected ($1.25)
Seat 3: pokermasse (button) folded before Flop (didn't bet)
Seat 4: Kolyan2114 (small blind) folded before Flop
Seat 5: PleBeY95 (big blind) folded before Flop
Seat 6: finstrel folded before Flop (didn't bet)
Seat 7: Medved219 folded before Flop (didn't bet)
Seat 8: StudentRB folded before Flop (didn't bet)
Seat 9: strannikac folded before Flop (didn't bet)



PokerStars Hand #228685253856:  Hold'em No Limit ($0.25/$0.50 USD) - 2021/07/30 14:27:33 ET
Table 'Gorgo III' 9-max Seat #4 is the button
Seat 1: v.sting ($50.75 in chips) 
Seat 3: pokermasse ($49 in chips) 
Seat 4: Kolyan2114 ($67.83 in chips) 
Seat 5: PleBeY95 ($56.91 in chips) 
Seat 6: finstrel ($70.19 in chips) 
Seat 7: Medved219 ($52.25 in chips) 
Seat 8: StudentRB ($50 in chips) 
Seat 9: strannikac ($63.40 in chips) 
PleBeY95: posts small blind $0.25
finstrel: posts big blind $0.50
wami1981: sits out 
*** HOLE CARDS ***
Medved219: folds 
StudentRB: folds 
strannikac: raises $1 to $1.50
v.sting: folds 
pokermasse: folds 
Kolyan2114: folds 
PleBeY95: folds 
finstrel: calls $1
*** FLOP *** [5d Qc 8d]
finstrel: checks 
strannikac: bets $3.09
finstrel: calls $3.09
*** TURN *** [5d Qc 8d] [Th]
finstrel: checks 
strannikac: bets $8.96
finstrel: raises $8.96 to $17.92
strannikac: calls $8.96
*** RIVER *** [5d Qc 8d Th] [Ac]
finstrel: checks 
strannikac: bets $21.63
finstrel: folds 
Uncalled bet ($21.63) returned to strannikac
strannikac collected $43.27 from pot
strannikac: doesn't show hand 
*** SUMMARY ***
Total pot $45.27 | Rake $2 
Board [5d Qc 8d Th Ac]
Seat 1: v.sting folded before Flop (didn't bet)
Seat 3: pokermasse folded before Flop (didn't bet)
Seat 4: Kolyan2114 (button) folded before Flop (didn't bet)
Seat 5: PleBeY95 (small blind) folded before Flop
Seat 6: finstrel (big blind) folded on the River
Seat 7: Medved219 folded before Flop (didn't bet)
Seat 8: StudentRB folded before Flop (didn't bet)
Seat 9: strannikac collected ($43.27)



PokerStars Hand #228685278399:  Hold'em No Limit ($0.25/$0.50 USD) - 2021/07/30 14:28:31 ET
Table 'Gorgo III' 9-max Seat #5 is the button
Seat 1: v.sting ($50.75 in chips) 
Seat 3: pokermasse ($49 in chips) 
Seat 4: Kolyan2114 ($67.83 in chips) 
Seat 5: PleBeY95 ($56.66 in chips) 
Seat 6: finstrel ($47.68 in chips) 
Seat 7: Medved219 ($52.25 in chips) 
Seat 8: StudentRB ($50 in chips) 
Seat 9: strannikac ($84.16 in chips) 
finstrel: posts small blind $0.25
Medved219: posts big blind $0.50
wami1981: sits out 
*** HOLE CARDS ***
StudentRB: raises $0.75 to $1.25
strannikac: folds 
v.sting: folds 
pokermasse: folds 
Kolyan2114: folds 
PleBeY95: folds 
finstrel: calls $1
Medved219: calls $0.75
*** FLOP *** [6c 4d 6h]
finstrel: checks 
Medved219: checks 
StudentRB: bets $1.17
finstrel: raises $1.17 to $2.34
Medved219: folds 
StudentRB: calls $1.17
*** TURN *** [6c 4d 6h] [2h]
finstrel: checks 
StudentRB: checks 
*** RIVER *** [6c 4d 6h 2h] [7c]
finstrel: bets $3.50
StudentRB: folds 
Uncalled bet ($3.50) returned to finstrel
finstrel collected $8.01 from pot
*** SUMMARY ***
Total pot $8.43 | Rake $0.42 
Board [6c 4d 6h 2h 7c]
Seat 1: v.sting folded before Flop (didn't bet)
Seat 3: pokermasse folded before Flop (didn't bet)
Seat 4: Kolyan2114 folded before Flop (didn't bet)
Seat 5: PleBeY95 (button) folded before Flop (didn't bet)
Seat 6: finstrel (small blind) collected ($8.01)
Seat 7: Medved219 (big blind) folded on the Flop
Seat 8: StudentRB folded on the River
Seat 9: strannikac folded before Flop (didn't bet)



PokerStars Hand #228685306550:  Hold'em No Limit ($0.25/$0.50 USD) - 2021/07/30 14:29:38 ET
Table 'Gorgo III' 9-max Seat #6 is the button
Seat 1: v.sting ($50.75 in chips) 
Seat 3: pokermasse ($49 in chips) 
Seat 4: Kolyan2114 ($67.83 in chips) 
Seat 5: PleBeY95 ($56.66 in chips) 
Seat 6: finstrel ($52.10 in chips) 
Seat 7: Medved219 ($51 in chips) 
Seat 8: StudentRB ($50 in chips) 
Seat 9: strannikac ($84.16 in chips) 
Medved219: posts small blind $0.25
StudentRB: posts big blind $0.50
wami1981: sits out 
*** HOLE CARDS ***
strannikac: folds 
v.sting: folds 
pokermasse: folds 
Kolyan2114: folds 
PleBeY95: raises $1 to $1.50
finstrel: calls $1.50
Medved219: raises $5 to $6.50
StudentRB: folds 
PleBeY95: folds 
finstrel: calls $5
*** FLOP *** [9d 4d 2d]
Medved219: bets $11
finstrel: raises $34.60 to $45.60 and is all-in
Medved219: calls $33.50 and is all-in
Uncalled bet ($1.10) returned to finstrel
finstrel:  
*** TURN *** [9d 4d 2d] [8c]
*** RIVER *** [9d 4d 2d 8c] [Qs]
*** SHOW DOWN ***
Medved219: shows [Ad Ks] (high card Ace)
finstrel: shows [Qc Js] (a pair of Queens)
finstrel collected $102 from pot
*** SUMMARY ***
Total pot $104 | Rake $2 
Board [9d 4d 2d 8c Qs]
Seat 1: v.sting folded before Flop (didn't bet)
Seat 3: pokermasse folded before Flop (didn't bet)
Seat 4: Kolyan2114 folded before Flop (didn't bet)
Seat 5: PleBeY95 folded before Flop
Seat 6: finstrel (button) showed [Qc Js] and won ($102) with a pair of Queens
Seat 7: Medved219 (small blind) showed [Ad Ks] and lost with high card Ace
Seat 8: StudentRB (big blind) folded before Flop
Seat 9: strannikac folded before Flop (didn't bet)



PokerStars Hand #228685333219:  Hold'em No Limit ($0.25/$0.50 USD) - 2021/07/30 14:30:40 ET
Table 'Gorgo III' 9-max Seat #7 is the button
Seat 1: v.sting ($50.75 in chips) 
Seat 3: pokermasse ($49 in chips) 
Seat 4: Kolyan2114 ($67.83 in chips) 
Seat 5: PleBeY95 ($55.16 in chips) 
Seat 6: finstrel ($103.10 in chips) 
Seat 7: Medved219 ($50 in chips) 
Seat 8: StudentRB ($50 in chips) 
Seat 9: strannikac ($84.16 in chips) 
StudentRB: posts small blind $0.25
strannikac: posts big blind $0.50
wami1981: sits out 
*** HOLE CARDS ***
v.sting: folds 
pokermasse: folds 
Kolyan2114: raises $0.75 to $1.25
PleBeY95: folds 
finstrel: folds 
Medved219: folds 
StudentRB: folds 
strannikac: folds 
Uncalled bet ($0.75) returned to Kolyan2114
Kolyan2114 collected $1.25 from pot
*** SUMMARY ***
Total pot $1.25 | Rake $0 
Seat 1: v.sting folded before Flop (didn't bet)
Seat 3: pokermasse folded before Flop (didn't bet)
Seat 4: Kolyan2114 collected ($1.25)
Seat 5: PleBeY95 folded before Flop (didn't bet)
Seat 6: finstrel folded before Flop (didn't bet)
Seat 7: Medved219 (button) folded before Flop (didn't bet)
Seat 8: StudentRB (small blind) folded before Flop
Seat 9: strannikac (big blind) folded before Flop



PokerStars Hand #228685340695:  Hold'em No Limit ($0.25/$0.50 USD) - 2021/07/30 14:30:58 ET
Table 'Gorgo III' 9-max Seat #8 is the button
Seat 1: v.sting ($50.75 in chips) 
Seat 3: pokermasse ($49 in chips) 
Seat 4: Kolyan2114 ($68.58 in chips) 
Seat 5: PleBeY95 ($55.16 in chips) 
Seat 6: finstrel ($103.10 in chips) 
Seat 7: Medved219 ($50 in chips) 
Seat 8: StudentRB ($50 in chips) 
Seat 9: strannikac ($83.66 in chips) 
strannikac: posts small blind $0.25
v.sting: posts big blind $0.50
wami1981: sits out 
*** HOLE CARDS ***
pokermasse: folds 
Kolyan2114: folds 
PleBeY95: folds 
finstrel: raises $1 to $1.50
Medved219: folds 
StudentRB: folds 
strannikac: folds 
v.sting: calls $1
*** FLOP *** [Ks 3c Ad]
v.sting: checks 
finstrel: bets $1
v.sting: calls $1
*** TURN *** [Ks 3c Ad] [Jh]
v.sting: checks 
finstrel: bets $2.50
v.sting: calls $2.50
*** RIVER *** [Ks 3c Ad Jh] [6d]
v.sting: checks 
finstrel: bets $9.74
v.sting: calls $9.74
*** SHOW DOWN ***
finstrel: shows [4d 5d] (high card Ace)
v.sting: shows [9s Ac] (a pair of Aces)
v.sting collected $28.24 from pot
*** SUMMARY ***
Total pot $29.73 | Rake $1.49 
Board [Ks 3c Ad Jh 6d]
Seat 1: v.sting (big blind) showed [9s Ac] and won ($28.24) with a pair of Aces
Seat 3: pokermasse folded before Flop (didn't bet)
Seat 4: Kolyan2114 folded before Flop (didn't bet)
Seat 5: PleBeY95 folded before Flop (didn't bet)
Seat 6: finstrel showed [4d 5d] and lost with high card Ace
Seat 7: Medved219 folded before Flop (didn't bet)
Seat 8: StudentRB (button) folded before Flop (didn't bet)
Seat 9: strannikac (small blind) folded before Flop



PokerStars Hand #228685366863:  Hold'em No Limit ($0.25/$0.50 USD) - 2021/07/30 14:31:59 ET
Table 'Gorgo III' 9-max Seat #9 is the button
Seat 1: v.sting ($64.25 in chips) 
Seat 2: wami1981 ($108.08 in chips) 
Seat 3: pokermasse ($49 in chips) 
Seat 4: Kolyan2114 ($68.58 in chips) 
Seat 5: PleBeY95 ($55.16 in chips) 
Seat 6: finstrel ($88.36 in chips) 
Seat 7: Medved219 ($50 in chips) 
Seat 8: StudentRB ($50 in chips) 
Seat 9: strannikac ($83.41 in chips) 
v.sting: posts small blind $0.25
wami1981: posts big blind $0.50
*** HOLE CARDS ***
pokermasse: calls $0.50
Kolyan2114: folds 
PleBeY95: raises $1 to $1.50
finstrel: folds 
Medved219: folds 
StudentRB: folds 
strannikac: calls $1.50
v.sting: folds 
wami1981: folds 
pokermasse: calls $1
*** FLOP *** [7c 4d 2d]
pokermasse: checks 
PleBeY95: checks 
strannikac: checks 
*** TURN *** [7c 4d 2d] [3s]
pokermasse: checks 
PleBeY95: bets $1.65
strannikac: folds 
pokermasse: folds 
Uncalled bet ($1.65) returned to PleBeY95
PleBeY95 collected $4.99 from pot
*** SUMMARY ***
Total pot $5.25 | Rake $0.26 
Board [7c 4d 2d 3s]
Seat 1: v.sting (small blind) folded before Flop
Seat 2: wami1981 (big blind) folded before Flop
Seat 3: pokermasse folded on the Turn
Seat 4: Kolyan2114 folded before Flop (didn't bet)
Seat 5: PleBeY95 collected ($4.99)
Seat 6: finstrel folded before Flop (didn't bet)
Seat 7: Medved219 folded before Flop (didn't bet)
Seat 8: StudentRB folded before Flop (didn't bet)
Seat 9: strannikac (button) folded on the Turn



PokerStars Hand #228685409361:  Hold'em No Limit ($0.25/$0.50 USD) - 2021/07/30 14:33:39 ET
Table 'Gorgo III' 9-max Seat #3 is the button
Seat 1: v.sting ($64 in chips) 
Seat 2: wami1981 ($105.83 in chips) 
Seat 3: pokermasse ($46.75 in chips) 
Seat 4: Kolyan2114 ($68.08 in chips) 
Seat 5: PleBeY95 ($61.46 in chips) 
Seat 6: finstrel ($88.36 in chips) 
Seat 7: Medved219 ($50 in chips) 
Seat 8: StudentRB ($50 in chips) 
Seat 9: strannikac ($81.91 in chips) 
Kolyan2114: posts small blind $0.25
PleBeY95: posts big blind $0.50
*** HOLE CARDS ***
finstrel: folds 
Medved219: folds 
StudentRB: folds 
strannikac: folds 
v.sting: folds 
wami1981: folds 
pokermasse: folds 
Kolyan2114: raises $1 to $1.50
PleBeY95: folds 
Uncalled bet ($1) returned to Kolyan2114
Kolyan2114 collected $1 from pot
*** SUMMARY ***
Total pot $1 | Rake $0 
Seat 1: v.sting folded before Flop (didn't bet)
Seat 2: wami1981 folded before Flop (didn't bet)
Seat 3: pokermasse (button) folded before Flop (didn't bet)
Seat 4: Kolyan2114 (small blind) collected ($1)
Seat 5: PleBeY95 (big blind) folded before Flop
Seat 6: finstrel folded before Flop (didn't bet)
Seat 7: Medved219 folded before Flop (didn't bet)
Seat 8: StudentRB folded before Flop (didn't bet)
Seat 9: strannikac folded before Flop (didn't bet)



PokerStars Hand #228685419898:  Hold'em No Limit ($0.25/$0.50 USD) - 2021/07/30 14:34:04 ET
Table 'Gorgo III' 9-max Seat #4 is the button
Seat 1: v.sting ($64 in chips) 
Seat 2: wami1981 ($105.83 in chips) 
Seat 3: pokermasse ($46.75 in chips) 
Seat 4: Kolyan2114 ($68.58 in chips) 
Seat 5: PleBeY95 ($60.96 in chips) 
Seat 6: finstrel ($88.36 in chips) 
Seat 7: Medved219 ($50 in chips) 
Seat 8: StudentRB ($50 in chips) 
Seat 9: strannikac ($81.91 in chips) 
PleBeY95: posts small blind $0.25
finstrel: posts big blind $0.50
*** HOLE CARDS ***
Medved219: folds 
StudentRB: folds 
strannikac: folds 
v.sting: folds 
wami1981: folds 
pokermasse: folds 
Kolyan2114: folds 
PleBeY95: folds 
Uncalled bet ($0.25) returned to finstrel
finstrel collected $0.50 from pot
*** SUMMARY ***
Total pot $0.50 | Rake $0 
Seat 1: v.sting folded before Flop (didn't bet)
Seat 2: wami1981 folded before Flop (didn't bet)
Seat 3: pokermasse folded before Flop (didn't bet)
Seat 4: Kolyan2114 (button) folded before Flop (didn't bet)
Seat 5: PleBeY95 (small blind) folded before Flop
Seat 6: finstrel (big blind) collected ($0.50)
Seat 7: Medved219 folded before Flop (didn't bet)
Seat 8: StudentRB folded before Flop (didn't bet)
Seat 9: strannikac folded before Flop (didn't bet)



PokerStars Hand #228685424725:  Hold'em No Limit ($0.25/$0.50 USD) - 2021/07/30 14:34:15 ET
Table 'Gorgo III' 9-max Seat #5 is the button
Seat 1: v.sting ($64 in chips) 
Seat 2: wami1981 ($105.83 in chips) 
Seat 3: pokermasse ($46.75 in chips) 
Seat 4: Kolyan2114 ($68.58 in chips) 
Seat 5: PleBeY95 ($60.71 in chips) 
Seat 6: finstrel ($88.61 in chips) 
Seat 7: Medved219 ($50 in chips) 
Seat 8: StudentRB ($50 in chips) 
Seat 9: strannikac ($81.91 in chips) 
finstrel: posts small blind $0.25
Medved219: posts big blind $0.50
*** HOLE CARDS ***
StudentRB: folds 
strannikac: folds 
v.sting: raises $1 to $1.50
wami1981: calls $1.50
pokermasse: calls $1.50
Kolyan2114: folds 
PleBeY95: folds 
finstrel: calls $1.25
Medved219: folds 
*** FLOP *** [8c 7s Qs]
finstrel: checks 
v.sting: checks 
wami1981: checks 
pokermasse: bets $3.09
finstrel: folds 
v.sting: folds 
wami1981: folds 
Uncalled bet ($3.09) returned to pokermasse
pokermasse collected $6.18 from pot
pokermasse: doesn't show hand 
*** SUMMARY ***
Total pot $6.50 | Rake $0.32 
Board [8c 7s Qs]
Seat 1: v.sting folded on the Flop
Seat 2: wami1981 folded on the Flop
Seat 3: pokermasse collected ($6.18)
Seat 4: Kolyan2114 folded before Flop (didn't bet)
Seat 5: PleBeY95 (button) folded before Flop (didn't bet)
Seat 6: finstrel (small blind) folded on the Flop
Seat 7: Medved219 (big blind) folded before Flop
Seat 8: StudentRB folded before Flop (didn't bet)
Seat 9: strannikac folded before Flop (didn't bet)



PokerStars Hand #228685446897:  Hold'em No Limit ($0.25/$0.50 USD) - 2021/07/30 14:35:08 ET
Table 'Gorgo III' 9-max Seat #6 is the button
Seat 1: v.sting ($62.50 in chips) 
Seat 2: wami1981 ($104.33 in chips) 
Seat 3: pokermasse ($51.43 in chips) 
Seat 4: Kolyan2114 ($68.58 in chips) 
Seat 5: PleBeY95 ($60.71 in chips) 
Seat 6: finstrel ($87.11 in chips) 
Seat 7: Medved219 ($50 in chips) 
Seat 8: StudentRB ($50 in chips) 
Seat 9: strannikac ($81.91 in chips) 
Medved219: posts small blind $0.25
StudentRB: posts big blind $0.50
*** HOLE CARDS ***
strannikac: folds 
v.sting: folds 
wami1981: folds 
pokermasse: folds 
Kolyan2114: raises $0.75 to $1.25
PleBeY95: folds 
finstrel: calls $1.25
Medved219: folds 
StudentRB: folds 
*** FLOP *** [8h 2h 9d]
Kolyan2114: bets $1.70
finstrel: calls $1.70
*** TURN *** [8h 2h 9d] [Ts]
Kolyan2114: checks 
finstrel: bets $3
Kolyan2114: calls $3
*** RIVER *** [8h 2h 9d Ts] [4s]
Kolyan2114: checks 
finstrel: bets $10.50
Kolyan2114: folds 
Uncalled bet ($10.50) returned to finstrel
finstrel collected $12.02 from pot
*** SUMMARY ***
Total pot $12.65 | Rake $0.63 
Board [8h 2h 9d Ts 4s]
Seat 1: v.sting folded before Flop (didn't bet)
Seat 2: wami1981 folded before Flop (didn't bet)
Seat 3: pokermasse folded before Flop (didn't bet)
Seat 4: Kolyan2114 folded on the River
Seat 5: PleBeY95 folded before Flop (didn't bet)
Seat 6: finstrel (button) collected ($12.02)
Seat 7: Medved219 (small blind) folded before Flop
Seat 8: StudentRB (big blind) folded before Flop
Seat 9: strannikac folded before Flop (didn't bet)



PokerStars Hand #228685472997:  Hold'em No Limit ($0.25/$0.50 USD) - 2021/07/30 14:36:09 ET
Table 'Gorgo III' 9-max Seat #7 is the button
Seat 1: v.sting ($62.50 in chips) 
Seat 2: wami1981 ($104.33 in chips) 
Seat 3: pokermasse ($51.43 in chips) 
Seat 4: Kolyan2114 ($62.63 in chips) 
Seat 5: PleBeY95 ($60.71 in chips) 
Seat 6: finstrel ($93.18 in chips) 
Seat 7: Medved219 ($50 in chips) 
Seat 8: StudentRB ($50 in chips) 
Seat 9: strannikac ($81.91 in chips) 
StudentRB: posts small blind $0.25
strannikac: posts big blind $0.50
*** HOLE CARDS ***
v.sting: folds 
wami1981: folds 
pokermasse: folds 
Kolyan2114: folds 
PleBeY95: folds 
finstrel: calls $0.50
Medved219: folds 
StudentRB: raises $2 to $2.50
strannikac: folds 
finstrel: calls $2
*** FLOP *** [4d 4c 7c]
StudentRB: bets $3.92
finstrel: calls $3.92
*** TURN *** [4d 4c 7c] [Kh]
StudentRB: checks 
finstrel: bets $4
StudentRB: folds 
Uncalled bet ($4) returned to finstrel
finstrel collected $12.67 from pot
*** SUMMARY ***
Total pot $13.34 | Rake $0.67 
Board [4d 4c 7c Kh]
Seat 1: v.sting folded before Flop (didn't bet)
Seat 2: wami1981 folded before Flop (didn't bet)
Seat 3: pokermasse folded before Flop (didn't bet)
Seat 4: Kolyan2114 folded before Flop (didn't bet)
Seat 5: PleBeY95 folded before Flop (didn't bet)
Seat 6: finstrel collected ($12.67)
Seat 7: Medved219 (button) folded before Flop (didn't bet)
Seat 8: StudentRB (small blind) folded on the Turn
Seat 9: strannikac (big blind) folded before Flop



PokerStars Hand #228685499170:  Hold'em No Limit ($0.25/$0.50 USD) - 2021/07/30 14:37:12 ET
Table 'Gorgo III' 9-max Seat #8 is the button
Seat 1: v.sting ($62.50 in chips) 
Seat 2: wami1981 ($104.33 in chips) 
Seat 3: pokermasse ($51.43 in chips) 
Seat 4: Kolyan2114 ($62.63 in chips) 
Seat 5: PleBeY95 ($60.71 in chips) 
Seat 6: finstrel ($99.43 in chips) 
Seat 7: Medved219 ($50 in chips) 
Seat 8: StudentRB ($50 in chips) 
Seat 9: strannikac ($81.41 in chips) 
strannikac: posts small blind $0.25
v.sting: posts big blind $0.50
*** HOLE CARDS ***
wami1981: folds 
pokermasse: folds 
Kolyan2114: folds 
PleBeY95: folds 
finstrel: raises $1 to $1.50
Medved219: folds 
StudentRB: folds 
strannikac: folds 
v.sting: calls $1
*** FLOP *** [Qh As Kd]
v.sting: checks 
finstrel: bets $1.55
v.sting: folds 
Uncalled bet ($1.55) returned to finstrel
finstrel collected $3.09 from pot
*** SUMMARY ***
Total pot $3.25 | Rake $0.16 
Board [Qh As Kd]
Seat 1: v.sting (big blind) folded on the Flop
Seat 2: wami1981 folded before Flop (didn't bet)
Seat 3: pokermasse folded before Flop (didn't bet)
Seat 4: Kolyan2114 folded before Flop (didn't bet)
Seat 5: PleBeY95 folded before Flop (didn't bet)
Seat 6: finstrel collected ($3.09)
Seat 7: Medved219 folded before Flop (didn't bet)
Seat 8: StudentRB (button) folded before Flop (didn't bet)
Seat 9: strannikac (small blind) folded before Flop



PokerStars Hand #228685517040:  Hold'em No Limit ($0.25/$0.50 USD) - 2021/07/30 14:37:53 ET
Table 'Gorgo III' 9-max Seat #9 is the button
Seat 1: v.sting ($61 in chips) 
Seat 2: wami1981 ($104.33 in chips) 
Seat 3: pokermasse ($51.43 in chips) 
Seat 4: Kolyan2114 ($62.63 in chips) 
Seat 5: PleBeY95 ($60.71 in chips) 
Seat 6: finstrel ($101.02 in chips) 
Seat 7: Medved219 ($50 in chips) 
Seat 8: StudentRB ($50 in chips) 
Seat 9: strannikac ($81.16 in chips) 
v.sting: posts small blind $0.25
wami1981: posts big blind $0.50
*** HOLE CARDS ***
pokermasse: folds 
Kolyan2114: folds 
PleBeY95: folds 
finstrel: folds 
Medved219: folds 
StudentRB: folds 
strannikac: raises $1 to $1.50
v.sting: folds 
wami1981: folds 
Uncalled bet ($1) returned to strannikac
strannikac collected $1.25 from pot
strannikac: doesn't show hand 
*** SUMMARY ***
Total pot $1.25 | Rake $0 
Seat 1: v.sting (small blind) folded before Flop
Seat 2: wami1981 (big blind) folded before Flop
Seat 3: pokermasse folded before Flop (didn't bet)
Seat 4: Kolyan2114 folded before Flop (didn't bet)
Seat 5: PleBeY95 folded before Flop (didn't bet)
Seat 6: finstrel folded before Flop (didn't bet)
Seat 7: Medved219 folded before Flop (didn't bet)
Seat 8: StudentRB folded before Flop (didn't bet)
Seat 9: strannikac (button) collected ($1.25)



PokerStars Hand #228685526460:  Hold'em No Limit ($0.25/$0.50 USD) - 2021/07/30 14:38:15 ET
Table 'Gorgo III' 9-max Seat #1 is the button
Seat 1: v.sting ($60.75 in chips) 
Seat 2: wami1981 ($103.83 in chips) 
Seat 3: pokermasse ($51.43 in chips) 
Seat 4: Kolyan2114 ($62.63 in chips) 
Seat 5: PleBeY95 ($60.71 in chips) 
Seat 6: finstrel ($101.02 in chips) 
Seat 7: Medved219 ($50 in chips) 
Seat 8: StudentRB ($50 in chips) 
Seat 9: strannikac ($81.91 in chips) 
wami1981: posts small blind $0.25
pokermasse: posts big blind $0.50
*** HOLE CARDS ***
Kolyan2114: folds 
PleBeY95: folds 
finstrel: calls $0.50
Medved219: folds 
StudentRB: folds 
strannikac: folds 
v.sting: folds 
wami1981: raises $1.50 to $2
pokermasse: folds 
finstrel: calls $1.50
*** FLOP *** [5h 5s 6c]
wami1981: checks 
finstrel: checks 
*** TURN *** [5h 5s 6c] [7d]
wami1981: checks 
finstrel: checks 
*** RIVER *** [5h 5s 6c 7d] [Kc]
wami1981: bets $2.50
finstrel: calls $2.50
*** SHOW DOWN ***
wami1981: shows [Ac 2c] (a pair of Fives)
finstrel: shows [Ks Th] (two pair, Kings and Fives)
finstrel collected $9.02 from pot
*** SUMMARY ***
Total pot $9.50 | Rake $0.48 
Board [5h 5s 6c 7d Kc]
Seat 1: v.sting (button) folded before Flop (didn't bet)
Seat 2: wami1981 (small blind) showed [Ac 2c] and lost with a pair of Fives
Seat 3: pokermasse (big blind) folded before Flop
Seat 4: Kolyan2114 folded before Flop (didn't bet)
Seat 5: PleBeY95 folded before Flop (didn't bet)
Seat 6: finstrel showed [Ks Th] and won ($9.02) with two pair, Kings and Fives
Seat 7: Medved219 folded before Flop (didn't bet)
Seat 8: StudentRB folded before Flop (didn't bet)
Seat 9: strannikac folded before Flop (didn't bet)



PokerStars Hand #228685552056:  Hold'em No Limit ($0.25/$0.50 USD) - 2021/07/30 14:39:15 ET
Table 'Gorgo III' 9-max Seat #2 is the button
Seat 1: v.sting ($60.75 in chips) 
Seat 2: wami1981 ($99.33 in chips) 
Seat 3: pokermasse ($50.93 in chips) 
Seat 4: Kolyan2114 ($62.63 in chips) 
Seat 5: PleBeY95 ($60.71 in chips) 
Seat 6: finstrel ($105.54 in chips) 
Seat 7: Medved219 ($50 in chips) 
Seat 8: StudentRB ($50 in chips) 
Seat 9: strannikac ($81.91 in chips) 
pokermasse: posts small blind $0.25
Kolyan2114: posts big blind $0.50
*** HOLE CARDS ***
PleBeY95: folds 
finstrel: calls $0.50
Medved219: folds 
StudentRB: folds 
strannikac: folds 
v.sting: folds 
wami1981: folds 
pokermasse: calls $0.25
Kolyan2114: checks 
*** FLOP *** [5c 4d Kc]
pokermasse: bets $0.50
Kolyan2114: folds 
finstrel: calls $0.50
*** TURN *** [5c 4d Kc] [Jh]
pokermasse: checks 
finstrel: bets $1.19
pokermasse: folds 
Uncalled bet ($1.19) returned to finstrel
finstrel collected $2.38 from pot
*** SUMMARY ***
Total pot $2.50 | Rake $0.12 
Board [5c 4d Kc Jh]
Seat 1: v.sting folded before Flop (didn't bet)
Seat 2: wami1981 (button) folded before Flop (didn't bet)
Seat 3: pokermasse (small blind) folded on the Turn
Seat 4: Kolyan2114 (big blind) folded on the Flop
Seat 5: PleBeY95 folded before Flop (didn't bet)
Seat 6: finstrel collected ($2.38)
Seat 7: Medved219 folded before Flop (didn't bet)
Seat 8: StudentRB folded before Flop (didn't bet)
Seat 9: strannikac folded before Flop (didn't bet)



PokerStars Hand #228685569691:  Hold'em No Limit ($0.25/$0.50 USD) - 2021/07/30 14:39:56 ET
Table 'Gorgo III' 9-max Seat #3 is the button
Seat 1: v.sting ($60.75 in chips) 
Seat 2: wami1981 ($99.33 in chips) 
Seat 3: pokermasse ($49.93 in chips) 
Seat 4: Kolyan2114 ($62.13 in chips) 
Seat 5: PleBeY95 ($60.71 in chips) 
Seat 6: finstrel ($106.92 in chips) 
Seat 7: Medved219 ($50 in chips) 
Seat 8: StudentRB ($50 in chips) 
Seat 9: strannikac ($81.91 in chips) 
Kolyan2114: posts small blind $0.25
PleBeY95: posts big blind $0.50
*** HOLE CARDS ***
finstrel: calls $0.50
Medved219: folds 
StudentRB: folds 
strannikac: calls $0.50
v.sting: folds 
wami1981: folds 
pokermasse: raises $1 to $1.50
Kolyan2114: folds 
PleBeY95: folds 
finstrel: calls $1
strannikac: calls $1
*** FLOP *** [Qd Tc 7d]
finstrel: bets $1
strannikac: calls $1
pokermasse: calls $1
*** TURN *** [Qd Tc 7d] [2c]
finstrel: bets $3.92
strannikac: folds 
pokermasse: folds 
Uncalled bet ($3.92) returned to finstrel
finstrel collected $7.84 from pot
*** SUMMARY ***
Total pot $8.25 | Rake $0.41 
Board [Qd Tc 7d 2c]
Seat 1: v.sting folded before Flop (didn't bet)
Seat 2: wami1981 folded before Flop (didn't bet)
Seat 3: pokermasse (button) folded on the Turn
Seat 4: Kolyan2114 (small blind) folded before Flop
Seat 5: PleBeY95 (big blind) folded before Flop
Seat 6: finstrel collected ($7.84)
Seat 7: Medved219 folded before Flop (didn't bet)
Seat 8: StudentRB folded before Flop (didn't bet)
Seat 9: strannikac folded on the Turn



PokerStars Hand #228685599702:  Hold'em No Limit ($0.25/$0.50 USD) - 2021/07/30 14:41:06 ET
Table 'Gorgo III' 9-max Seat #4 is the button
Seat 1: v.sting ($60.75 in chips) 
Seat 2: wami1981 ($99.33 in chips) 
Seat 3: pokermasse ($47.43 in chips) 
Seat 4: Kolyan2114 ($61.88 in chips) 
Seat 5: PleBeY95 ($60.21 in chips) 
Seat 6: finstrel ($112.26 in chips) 
Seat 7: Medved219 ($50 in chips) 
Seat 8: StudentRB ($50 in chips) 
Seat 9: strannikac ($79.41 in chips) 
PleBeY95: posts small blind $0.25
finstrel: posts big blind $0.50
*** HOLE CARDS ***
Medved219: raises $1 to $1.50
StudentRB: folds 
strannikac: folds 
v.sting: folds 
wami1981: folds 
pokermasse: folds 
Kolyan2114: folds 
PleBeY95: folds 
finstrel: calls $1
*** FLOP *** [7d 3c 6c]
finstrel: checks 
Medved219: checks 
*** TURN *** [7d 3c 6c] [6h]
finstrel: bets $1
Medved219: calls $1
*** RIVER *** [7d 3c 6c 6h] [7c]
finstrel: checks 
Medved219: checks 
*** SHOW DOWN ***
finstrel: shows [2s 4c] (two pair, Sevens and Sixes)
Medved219: shows [Kd Ah] (two pair, Sevens and Sixes - Ace kicker)
Medved219 collected $4.99 from pot
*** SUMMARY ***
Total pot $5.25 | Rake $0.26 
Board [7d 3c 6c 6h 7c]
Seat 1: v.sting folded before Flop (didn't bet)
Seat 2: wami1981 folded before Flop (didn't bet)
Seat 3: pokermasse folded before Flop (didn't bet)
Seat 4: Kolyan2114 (button) folded before Flop (didn't bet)
Seat 5: PleBeY95 (small blind) folded before Flop
Seat 6: finstrel (big blind) showed [2s 4c] and lost with two pair, Sevens and Sixes
Seat 7: Medved219 showed [Kd Ah] and won ($4.99) with two pair, Sevens and Sixes
Seat 8: StudentRB folded before Flop (didn't bet)
Seat 9: strannikac folded before Flop (didn't bet)



PokerStars Hand #228685616867:  Hold'em No Limit ($0.25/$0.50 USD) - 2021/07/30 14:41:46 ET
Table 'Gorgo III' 9-max Seat #5 is the button
Seat 1: v.sting ($60.75 in chips) 
Seat 2: wami1981 ($99.33 in chips) 
Seat 3: pokermasse ($47.43 in chips) 
Seat 4: Kolyan2114 ($61.88 in chips) 
Seat 5: PleBeY95 ($59.96 in chips) 
Seat 6: finstrel ($109.76 in chips) 
Seat 7: Medved219 ($52.49 in chips) 
Seat 8: StudentRB ($50 in chips) 
Seat 9: strannikac ($79.41 in chips) 
finstrel: posts small blind $0.25
Medved219: posts big blind $0.50
*** HOLE CARDS ***
StudentRB: folds 
strannikac: raises $1 to $1.50
v.sting: folds 
wami1981: folds 
pokermasse: folds 
Kolyan2114: folds 
PleBeY95: folds 
finstrel: folds 
Medved219: folds 
Uncalled bet ($1) returned to strannikac
strannikac collected $1.25 from pot
strannikac: doesn't show hand 
*** SUMMARY ***
Total pot $1.25 | Rake $0 
Seat 1: v.sting folded before Flop (didn't bet)
Seat 2: wami1981 folded before Flop (didn't bet)
Seat 3: pokermasse folded before Flop (didn't bet)
Seat 4: Kolyan2114 folded before Flop (didn't bet)
Seat 5: PleBeY95 (button) folded before Flop (didn't bet)
Seat 6: finstrel (small blind) folded before Flop
Seat 7: Medved219 (big blind) folded before Flop
Seat 8: StudentRB folded before Flop (didn't bet)
Seat 9: strannikac collected ($1.25)



PokerStars Hand #228685629446:  Hold'em No Limit ($0.25/$0.50 USD) - 2021/07/30 14:42:16 ET
Table 'Gorgo III' 9-max Seat #6 is the button
Seat 1: v.sting ($60.75 in chips) 
Seat 2: wami1981 ($99.33 in chips) 
Seat 3: pokermasse ($47.43 in chips) 
Seat 4: Kolyan2114 ($61.88 in chips) 
Seat 5: PleBeY95 ($59.96 in chips) 
Seat 6: finstrel ($109.51 in chips) 
Seat 7: Medved219 ($51.99 in chips) 
Seat 8: StudentRB ($50 in chips) 
Seat 9: strannikac ($80.16 in chips) 
Medved219: posts small blind $0.25
StudentRB: posts big blind $0.50
*** HOLE CARDS ***
strannikac: folds 
v.sting: folds 
wami1981: raises $2 to $2.50
pokermasse: folds 
Kolyan2114: folds 
PleBeY95: folds 
finstrel: calls $2.50
Medved219: folds 
StudentRB: folds 
*** FLOP *** [7d Qh Td]
wami1981: bets $5.46
finstrel: folds 
Uncalled bet ($5.46) returned to wami1981
wami1981 collected $5.39 from pot
wami1981: doesn't show hand 
*** SUMMARY ***
Total pot $5.75 | Rake $0.36 
Board [7d Qh Td]
Seat 1: v.sting folded before Flop (didn't bet)
Seat 2: wami1981 collected ($5.39)
Seat 3: pokermasse folded before Flop (didn't bet)
Seat 4: Kolyan2114 folded before Flop (didn't bet)
Seat 5: PleBeY95 folded before Flop (didn't bet)
Seat 6: finstrel (button) folded on the Flop
Seat 7: Medved219 (small blind) folded before Flop
Seat 8: StudentRB (big blind) folded before Flop
Seat 9: strannikac folded before Flop (didn't bet)



PokerStars Hand #228685642684:  Hold'em No Limit ($0.25/$0.50 USD) - 2021/07/30 14:42:46 ET
Table 'Gorgo III' 9-max Seat #7 is the button
Seat 1: v.sting ($60.75 in chips) 
Seat 2: wami1981 ($102.22 in chips) 
Seat 3: pokermasse ($47.43 in chips) 
Seat 4: Kolyan2114 ($61.88 in chips) 
Seat 5: PleBeY95 ($59.96 in chips) 
Seat 6: finstrel ($107.01 in chips) 
Seat 7: Medved219 ($51.74 in chips) 
Seat 8: StudentRB ($50 in chips) 
Seat 9: strannikac ($80.16 in chips) 
StudentRB: posts small blind $0.25
strannikac: posts big blind $0.50
*** HOLE CARDS ***
v.sting: folds 
wami1981: calls $0.50
pokermasse: calls $0.50
Kolyan2114: folds 
PleBeY95: raises $1 to $1.50
finstrel: folds 
Medved219: folds 
StudentRB: folds 
strannikac: folds 
wami1981: calls $1
pokermasse: calls $1
*** FLOP *** [Qd Kh 7c]
wami1981: checks 
pokermasse: checks 
PleBeY95: bets $1.65
wami1981: folds 
pokermasse: raises $8.29 to $9.94
PleBeY95: folds 
Uncalled bet ($8.29) returned to pokermasse
pokermasse collected $8.12 from pot
pokermasse: doesn't show hand 
*** SUMMARY ***
Total pot $8.55 | Rake $0.43 
Board [Qd Kh 7c]
Seat 1: v.sting folded before Flop (didn't bet)
Seat 2: wami1981 folded on the Flop
Seat 3: pokermasse collected ($8.12)
Seat 4: Kolyan2114 folded before Flop (didn't bet)
Seat 5: PleBeY95 folded on the Flop
Seat 6: finstrel folded before Flop (didn't bet)
Seat 7: Medved219 (button) folded before Flop (didn't bet)
Seat 8: StudentRB (small blind) folded before Flop
Seat 9: strannikac (big blind) folded before Flop



PokerStars Hand #228685670248:  Hold'em No Limit ($0.25/$0.50 USD) - 2021/07/30 14:43:50 ET
Table 'Gorgo III' 9-max Seat #8 is the button
Seat 1: v.sting ($60.75 in chips) 
Seat 2: wami1981 ($100.72 in chips) 
Seat 3: pokermasse ($52.40 in chips) 
Seat 4: Kolyan2114 ($61.88 in chips) 
Seat 5: PleBeY95 ($56.81 in chips) 
Seat 6: finstrel ($107.01 in chips) 
Seat 7: Medved219 ($51.74 in chips) 
Seat 8: StudentRB ($50 in chips) 
Seat 9: strannikac ($79.66 in chips) 
strannikac: posts small blind $0.25
v.sting: posts big blind $0.50
*** HOLE CARDS ***
wami1981: folds 
pokermasse: folds 
Kolyan2114: folds 
PleBeY95: folds 
wami1981 leaves the table
finstrel: raises $1 to $1.50
MarsMiland joins the table at seat #2 
Medved219: raises $3 to $4.50
StudentRB: folds 
strannikac: folds 
v.sting: folds 
finstrel: raises $7.50 to $12
Medved219: folds 
Uncalled bet ($7.50) returned to finstrel
finstrel collected $9.75 from pot
*** SUMMARY ***
Total pot $9.75 | Rake $0 
Seat 1: v.sting (big blind) folded before Flop
Seat 2: wami1981 folded before Flop (didn't bet)
Seat 3: pokermasse folded before Flop (didn't bet)
Seat 4: Kolyan2114 folded before Flop (didn't bet)
Seat 5: PleBeY95 folded before Flop (didn't bet)
Seat 6: finstrel collected ($9.75)
Seat 7: Medved219 folded before Flop
Seat 8: StudentRB (button) folded before Flop (didn't bet)
Seat 9: strannikac (small blind) folded before Flop



PokerStars Hand #228685690143:  Hold'em No Limit ($0.25/$0.50 USD) - 2021/07/30 14:44:36 ET
Table 'Gorgo III' 9-max Seat #9 is the button
Seat 1: v.sting ($60.25 in chips) 
Seat 2: MarsMiland ($63.48 in chips) 
Seat 3: pokermasse ($52.40 in chips) 
Seat 4: Kolyan2114 ($61.88 in chips) 
Seat 5: PleBeY95 ($56.81 in chips) 
Seat 6: finstrel ($112.26 in chips) 
Seat 7: Medved219 ($50 in chips) 
Seat 8: StudentRB ($50 in chips) 
Seat 9: strannikac ($79.41 in chips) 
v.sting: posts small blind $0.25
MarsMiland: posts big blind $0.50
*** HOLE CARDS ***
pokermasse: calls $0.50
Kolyan2114: folds 
PleBeY95: folds 
finstrel: calls $0.50
Medved219: folds 
StudentRB: raises $1.50 to $2
strannikac: folds 
v.sting: folds 
MarsMiland: folds 
pokermasse: folds 
finstrel: calls $1.50
*** FLOP *** [8d 5d 2s]
finstrel: checks 
StudentRB: bets $3.74
finstrel: calls $3.74
*** TURN *** [8d 5d 2s] [2c]
finstrel: checks 
StudentRB: bets $9.07
finstrel: calls $9.07
*** RIVER *** [8d 5d 2s 2c] [5h]
finstrel: bets $24.50
StudentRB: calls $24.50
*** SHOW DOWN ***
finstrel: shows [3h 3d] (two pair, Fives and Threes)
StudentRB: shows [Ac 8c] (two pair, Eights and Fives)
StudentRB collected $77.87 from pot
*** SUMMARY ***
Total pot $79.87 | Rake $2 
Board [8d 5d 2s 2c 5h]
Seat 1: v.sting (small blind) folded before Flop
Seat 2: MarsMiland (big blind) folded before Flop
Seat 3: pokermasse folded before Flop
Seat 4: Kolyan2114 folded before Flop (didn't bet)
Seat 5: PleBeY95 folded before Flop (didn't bet)
Seat 6: finstrel showed [3h 3d] and lost with two pair, Fives and Threes
Seat 7: Medved219 folded before Flop (didn't bet)
Seat 8: StudentRB showed [Ac 8c] and won ($77.87) with two pair, Eights and Fives
Seat 9: strannikac (button) folded before Flop (didn't bet)



PokerStars Hand #228685734157:  Hold'em No Limit ($0.25/$0.50 USD) - 2021/07/30 14:46:03 ET
Table 'Gorgo III' 9-max Seat #1 is the button
Seat 1: v.sting ($60 in chips) 
Seat 2: MarsMiland ($62.98 in chips) 
Seat 3: pokermasse ($51.90 in chips) 
Seat 4: Kolyan2114 ($61.88 in chips) 
Seat 5: PleBeY95 ($56.81 in chips) 
Seat 6: finstrel ($72.95 in chips) 
Seat 7: Medved219 ($50 in chips) 
Seat 8: StudentRB ($88.56 in chips) 
Seat 9: strannikac ($79.41 in chips) 
MarsMiland: posts small blind $0.25
pokermasse: posts big blind $0.50
*** HOLE CARDS ***
Kolyan2114: folds 
PleBeY95: folds 
finstrel: folds 
Medved219: folds 
StudentRB: folds 
strannikac: raises $1 to $1.50
v.sting: folds 
MarsMiland: folds 
pokermasse: folds 
Uncalled bet ($1) returned to strannikac
strannikac collected $1.25 from pot
strannikac: doesn't show hand 
*** SUMMARY ***
Total pot $1.25 | Rake $0 
Seat 1: v.sting (button) folded before Flop (didn't bet)
Seat 2: MarsMiland (small blind) folded before Flop
Seat 3: pokermasse (big blind) folded before Flop
Seat 4: Kolyan2114 folded before Flop (didn't bet)
Seat 5: PleBeY95 folded before Flop (didn't bet)
Seat 6: finstrel folded before Flop (didn't bet)
Seat 7: Medved219 folded before Flop (didn't bet)
Seat 8: StudentRB folded before Flop (didn't bet)
Seat 9: strannikac collected ($1.25)



PokerStars Hand #228685742085:  Hold'em No Limit ($0.25/$0.50 USD) - 2021/07/30 14:46:22 ET
Table 'Gorgo III' 9-max Seat #2 is the button
Seat 1: v.sting ($60 in chips) 
Seat 2: MarsMiland ($62.73 in chips) 
Seat 3: pokermasse ($51.40 in chips) 
Seat 4: Kolyan2114 ($61.88 in chips) 
Seat 5: PleBeY95 ($56.81 in chips) 
Seat 6: finstrel ($72.95 in chips) 
Seat 7: Medved219 ($50 in chips) 
Seat 8: StudentRB ($88.56 in chips) 
Seat 9: strannikac ($80.16 in chips) 
pokermasse: posts small blind $0.25
Kolyan2114: posts big blind $0.50
*** HOLE CARDS ***
PleBeY95: folds 
finstrel: calls $0.50
Medved219: folds 
StudentRB: folds 
strannikac: folds 
v.sting: folds 
MarsMiland: folds 
pokermasse: calls $0.25
Kolyan2114: checks 
*** FLOP *** [7h 8s 6c]
pokermasse: checks 
Kolyan2114: checks 
finstrel: bets $1.42
pokermasse: calls $1.42
Kolyan2114: folds 
*** TURN *** [7h 8s 6c] [As]
pokermasse: checks 
finstrel: bets $4.12
pokermasse: calls $4.12
*** RIVER *** [7h 8s 6c As] [2c]
pokermasse: checks 
finstrel: bets $15
pokermasse: folds 
Uncalled bet ($15) returned to finstrel
finstrel collected $11.95 from pot
*** SUMMARY ***
Total pot $12.58 | Rake $0.63 
Board [7h 8s 6c As 2c]
Seat 1: v.sting folded before Flop (didn't bet)
Seat 2: MarsMiland (button) folded before Flop (didn't bet)
Seat 3: pokermasse (small blind) folded on the River
Seat 4: Kolyan2114 (big blind) folded on the Flop
Seat 5: PleBeY95 folded before Flop (didn't bet)
Seat 6: finstrel collected ($11.95)
Seat 7: Medved219 folded before Flop (didn't bet)
Seat 8: StudentRB folded before Flop (didn't bet)
Seat 9: strannikac folded before Flop (didn't bet)



PokerStars Hand #228685766827:  Hold'em No Limit ($0.25/$0.50 USD) - 2021/07/30 14:47:19 ET
Table 'Gorgo III' 9-max Seat #3 is the button
Seat 1: v.sting ($60 in chips) 
Seat 2: MarsMiland ($62.73 in chips) 
Seat 3: pokermasse ($45.36 in chips) 
Seat 4: Kolyan2114 ($61.38 in chips) 
Seat 5: PleBeY95 ($56.81 in chips) 
Seat 6: finstrel ($78.86 in chips) 
Seat 7: Medved219 ($50 in chips) 
Seat 8: StudentRB ($88.56 in chips) 
Seat 9: strannikac ($80.16 in chips) 
Kolyan2114: posts small blind $0.25
PleBeY95: posts big blind $0.50
*** HOLE CARDS ***
finstrel: folds 
Medved219: folds 
StudentRB: folds 
strannikac: folds 
v.sting: folds 
MarsMiland: raises $0.75 to $1.25
pokermasse: calls $1.25
Kolyan2114: folds 
PleBeY95: folds 
*** FLOP *** [8s Kh Jh]
MarsMiland: checks 
pokermasse: bets $3.09
MarsMiland: folds 
Uncalled bet ($3.09) returned to pokermasse
pokermasse collected $3.09 from pot
pokermasse: doesn't show hand 
*** SUMMARY ***
Total pot $3.25 | Rake $0.16 
Board [8s Kh Jh]
Seat 1: v.sting folded before Flop (didn't bet)
Seat 2: MarsMiland folded on the Flop
Seat 3: pokermasse (button) collected ($3.09)
Seat 4: Kolyan2114 (small blind) folded before Flop
Seat 5: PleBeY95 (big blind) folded before Flop
Seat 6: finstrel folded before Flop (didn't bet)
Seat 7: Medved219 folded before Flop (didn't bet)
Seat 8: StudentRB folded before Flop (didn't bet)
Seat 9: strannikac folded before Flop (didn't bet)



PokerStars Hand #228685782618:  Hold'em No Limit ($0.25/$0.50 USD) - 2021/07/30 14:47:55 ET
Table 'Gorgo III' 9-max Seat #4 is the button
Seat 1: v.sting ($60 in chips) 
Seat 2: MarsMiland ($61.48 in chips) 
Seat 3: pokermasse ($47.20 in chips) 
Seat 4: Kolyan2114 ($61.13 in chips) 
Seat 5: PleBeY95 ($56.31 in chips) 
Seat 6: finstrel ($78.86 in chips) 
Seat 7: Medved219 ($50 in chips) 
Seat 8: StudentRB ($88.56 in chips) 
Seat 9: strannikac ($80.16 in chips) 
PleBeY95: posts small blind $0.25
finstrel: posts big blind $0.50
*** HOLE CARDS ***
Medved219: folds 
StudentRB: raises $0.50 to $1
strannikac: folds 
v.sting: folds 
MarsMiland: folds 
pokermasse: calls $1
Kolyan2114: folds 
PleBeY95: calls $0.75
finstrel: calls $0.50
*** FLOP *** [6c 4s As]
PleBeY95: checks 
finstrel: checks 
StudentRB: bets $1.25
pokermasse: calls $1.25
PleBeY95: folds 
finstrel: calls $1.25
*** TURN *** [6c 4s As] [Ac]
finstrel: checks 
StudentRB: bets $2.21
pokermasse: calls $2.21
finstrel: folds 
*** RIVER *** [6c 4s As Ac] [6s]
StudentRB: checks 
pokermasse: bets $7.50
StudentRB: folds 
Uncalled bet ($7.50) returned to pokermasse
pokermasse collected $11.56 from pot
pokermasse: doesn't show hand 
*** SUMMARY ***
Total pot $12.17 | Rake $0.61 
Board [6c 4s As Ac 6s]
Seat 1: v.sting folded before Flop (didn't bet)
Seat 2: MarsMiland folded before Flop (didn't bet)
Seat 3: pokermasse collected ($11.56)
Seat 4: Kolyan2114 (button) folded before Flop (didn't bet)
Seat 5: PleBeY95 (small blind) folded on the Flop
Seat 6: finstrel (big blind) folded on the Turn
Seat 7: Medved219 folded before Flop (didn't bet)
Seat 8: StudentRB folded on the River
Seat 9: strannikac folded before Flop (didn't bet)



PokerStars Hand #228685811001:  Hold'em No Limit ($0.25/$0.50 USD) - 2021/07/30 14:49:01 ET
Table 'Gorgo III' 9-max Seat #5 is the button
Seat 1: v.sting ($60 in chips) 
Seat 2: MarsMiland ($61.48 in chips) 
Seat 3: pokermasse ($54.30 in chips) 
Seat 4: Kolyan2114 ($61.13 in chips) 
Seat 5: PleBeY95 ($55.31 in chips) 
Seat 6: finstrel ($76.61 in chips) 
Seat 7: Medved219 ($50 in chips) 
Seat 8: StudentRB ($84.10 in chips) 
Seat 9: strannikac ($80.16 in chips) 
finstrel: posts small blind $0.25
Medved219: posts big blind $0.50
*** HOLE CARDS ***
StudentRB: folds 
strannikac: folds 
v.sting: folds 
MarsMiland: folds 
pokermasse: folds 
Kolyan2114: folds 
PleBeY95: folds 
finstrel: folds 
Uncalled bet ($0.25) returned to Medved219
Medved219 collected $0.50 from pot
Medved219: doesn't show hand 
*** SUMMARY ***
Total pot $0.50 | Rake $0 
Seat 1: v.sting folded before Flop (didn't bet)
Seat 2: MarsMiland folded before Flop (didn't bet)
Seat 3: pokermasse folded before Flop (didn't bet)
Seat 4: Kolyan2114 folded before Flop (didn't bet)
Seat 5: PleBeY95 (button) folded before Flop (didn't bet)
Seat 6: finstrel (small blind) folded before Flop
Seat 7: Medved219 (big blind) collected ($0.50)
Seat 8: StudentRB folded before Flop (didn't bet)
Seat 9: strannikac folded before Flop (didn't bet)



PokerStars Hand #228685816116:  Hold'em No Limit ($0.25/$0.50 USD) - 2021/07/30 14:49:13 ET
Table 'Gorgo III' 9-max Seat #6 is the button
Seat 1: v.sting ($60 in chips) 
Seat 2: MarsMiland ($61.48 in chips) 
Seat 3: pokermasse ($54.30 in chips) 
Seat 4: Kolyan2114 ($61.13 in chips) 
Seat 5: PleBeY95 ($55.31 in chips) 
Seat 6: finstrel ($76.36 in chips) 
Seat 7: Medved219 ($50.25 in chips) 
Seat 8: StudentRB ($84.10 in chips) 
Seat 9: strannikac ($80.16 in chips) 
Medved219: posts small blind $0.25
StudentRB: posts big blind $0.50
*** HOLE CARDS ***
strannikac: folds 
v.sting: folds 
MarsMiland: folds 
pokermasse: folds 
Kolyan2114: raises $0.75 to $1.25
PleBeY95: folds 
finstrel: folds 
Medved219: folds 
StudentRB: folds 
Uncalled bet ($0.75) returned to Kolyan2114
Kolyan2114 collected $1.25 from pot
*** SUMMARY ***
Total pot $1.25 | Rake $0 
Seat 1: v.sting folded before Flop (didn't bet)
Seat 2: MarsMiland folded before Flop (didn't bet)
Seat 3: pokermasse folded before Flop (didn't bet)
Seat 4: Kolyan2114 collected ($1.25)
Seat 5: PleBeY95 folded before Flop (didn't bet)
Seat 6: finstrel (button) folded before Flop (didn't bet)
Seat 7: Medved219 (small blind) folded before Flop
Seat 8: StudentRB (big blind) folded before Flop
Seat 9: strannikac folded before Flop (didn't bet)



PokerStars Hand #228685826931:  Hold'em No Limit ($0.25/$0.50 USD) - 2021/07/30 14:49:38 ET
Table 'Gorgo III' 9-max Seat #7 is the button
Seat 1: v.sting ($60 in chips) 
Seat 2: MarsMiland ($61.48 in chips) 
Seat 3: pokermasse ($54.30 in chips) 
Seat 4: Kolyan2114 ($61.88 in chips) 
Seat 5: PleBeY95 ($55.31 in chips) 
Seat 6: finstrel ($76.36 in chips) 
Seat 7: Medved219 ($50 in chips) 
Seat 8: StudentRB ($83.60 in chips) 
Seat 9: strannikac ($80.16 in chips) 
StudentRB: posts small blind $0.25
strannikac: posts big blind $0.50
*** HOLE CARDS ***
v.sting: folds 
MarsMiland: folds 
pokermasse: calls $0.50
Kolyan2114: folds 
PleBeY95: folds 
finstrel has timed out
finstrel: folds 
Medved219: folds 
StudentRB: calls $0.25
strannikac: checks 
*** FLOP *** [7d 5h Kc]
StudentRB: checks 
strannikac: checks 
pokermasse: bets $1.42
StudentRB: folds 
strannikac: folds 
Uncalled bet ($1.42) returned to pokermasse
pokermasse collected $1.42 from pot
pokermasse: doesn't show hand 
*** SUMMARY ***
Total pot $1.50 | Rake $0.08 
Board [7d 5h Kc]
Seat 1: v.sting folded before Flop (didn't bet)
Seat 2: MarsMiland folded before Flop (didn't bet)
Seat 3: pokermasse collected ($1.42)
Seat 4: Kolyan2114 folded before Flop (didn't bet)
Seat 5: PleBeY95 folded before Flop (didn't bet)
Seat 6: finstrel folded before Flop (didn't bet)
Seat 7: Medved219 (button) folded before Flop (didn't bet)
Seat 8: StudentRB (small blind) folded on the Flop
Seat 9: strannikac (big blind) folded on the Flop



PokerStars Hand #228685844917:  Hold'em No Limit ($0.25/$0.50 USD) - 2021/07/30 14:50:20 ET
Table 'Gorgo III' 9-max Seat #8 is the button
Seat 1: v.sting ($60 in chips) 
Seat 2: MarsMiland ($61.48 in chips) 
Seat 3: pokermasse ($55.22 in chips) 
Seat 4: Kolyan2114 ($61.88 in chips) 
Seat 5: PleBeY95 ($55.31 in chips) 
Seat 7: Medved219 ($50 in chips) 
Seat 8: StudentRB ($83.10 in chips) 
Seat 9: strannikac ($79.66 in chips) 
strannikac: posts small blind $0.25
v.sting: posts big blind $0.50
*** HOLE CARDS ***
MarsMiland: folds 
pokermasse: folds 
Kolyan2114: raises $0.75 to $1.25
PleBeY95: folds 
Medved219: folds 
StudentRB: folds 
strannikac: folds 
v.sting: folds 
Uncalled bet ($0.75) returned to Kolyan2114
Kolyan2114 collected $1.25 from pot
*** SUMMARY ***
Total pot $1.25 | Rake $0 
Seat 1: v.sting (big blind) folded before Flop
Seat 2: MarsMiland folded before Flop (didn't bet)
Seat 3: pokermasse folded before Flop (didn't bet)
Seat 4: Kolyan2114 collected ($1.25)
Seat 5: PleBeY95 folded before Flop (didn't bet)
Seat 7: Medved219 folded before Flop (didn't bet)
Seat 8: StudentRB (button) folded before Flop (didn't bet)
Seat 9: strannikac (small blind) folded before Flop



PokerStars Hand #228685855368:  Hold'em No Limit ($0.25/$0.50 USD) - 2021/07/30 14:50:44 ET
Table 'Gorgo III' 9-max Seat #9 is the button
Seat 1: v.sting ($59.50 in chips) 
Seat 2: MarsMiland ($61.48 in chips) 
Seat 3: pokermasse ($55.22 in chips) 
Seat 4: Kolyan2114 ($62.63 in chips) 
Seat 5: PleBeY95 ($55.31 in chips) 
Seat 6: finstrel ($76.36 in chips) 
Seat 7: Medved219 ($50 in chips) 
Seat 8: StudentRB ($83.10 in chips) 
Seat 9: strannikac ($79.41 in chips) 
v.sting: posts small blind $0.25
MarsMiland: posts big blind $0.50
*** HOLE CARDS ***
pokermasse: folds 
Kolyan2114: folds 
PleBeY95: raises $1 to $1.50
finstrel: folds 
Medved219: folds 
StudentRB: folds 
strannikac: folds 
v.sting: folds 
MarsMiland: folds 
Uncalled bet ($1) returned to PleBeY95
PleBeY95 collected $1.25 from pot
*** SUMMARY ***
Total pot $1.25 | Rake $0 
Seat 1: v.sting (small blind) folded before Flop
Seat 2: MarsMiland (big blind) folded before Flop
Seat 3: pokermasse folded before Flop (didn't bet)
Seat 4: Kolyan2114 folded before Flop (didn't bet)
Seat 5: PleBeY95 collected ($1.25)
Seat 6: finstrel folded before Flop (didn't bet)
Seat 7: Medved219 folded before Flop (didn't bet)
Seat 8: StudentRB folded before Flop (didn't bet)
Seat 9: strannikac (button) folded before Flop (didn't bet)



PokerStars Hand #228685862205:  Hold'em No Limit ($0.25/$0.50 USD) - 2021/07/30 14:51:00 ET
Table 'Gorgo III' 9-max Seat #1 is the button
Seat 1: v.sting ($59.25 in chips) 
Seat 2: MarsMiland ($60.98 in chips) 
Seat 3: pokermasse ($55.22 in chips) 
Seat 4: Kolyan2114 ($62.63 in chips) 
Seat 5: PleBeY95 ($56.06 in chips) 
Seat 6: finstrel ($76.36 in chips) 
Seat 7: Medved219 ($50 in chips) 
Seat 8: StudentRB ($83.10 in chips) 
Seat 9: strannikac ($79.41 in chips) 
MarsMiland: posts small blind $0.25
pokermasse: posts big blind $0.50
*** HOLE CARDS ***
Kolyan2114: folds 
PleBeY95: folds 
finstrel: folds 
Medved219: raises $1 to $1.50
StudentRB: folds 
strannikac: folds 
v.sting: folds 
MarsMiland: folds 
pokermasse: folds 
Uncalled bet ($1) returned to Medved219
Medved219 collected $1.25 from pot
Medved219: doesn't show hand 
*** SUMMARY ***
Total pot $1.25 | Rake $0 
Seat 1: v.sting (button) folded before Flop (didn't bet)
Seat 2: MarsMiland (small blind) folded before Flop
Seat 3: pokermasse (big blind) folded before Flop
Seat 4: Kolyan2114 folded before Flop (didn't bet)
Seat 5: PleBeY95 folded before Flop (didn't bet)
Seat 6: finstrel folded before Flop (didn't bet)
Seat 7: Medved219 collected ($1.25)
Seat 8: StudentRB folded before Flop (didn't bet)
Seat 9: strannikac folded before Flop (didn't bet)



PokerStars Hand #228685873837:  Hold'em No Limit ($0.25/$0.50 USD) - 2021/07/30 14:51:27 ET
Table 'Gorgo III' 9-max Seat #2 is the button
Seat 1: v.sting ($59.25 in chips) 
Seat 2: MarsMiland ($60.73 in chips) 
Seat 3: pokermasse ($54.72 in chips) 
Seat 4: Kolyan2114 ($62.63 in chips) 
Seat 5: PleBeY95 ($56.06 in chips) 
Seat 6: finstrel ($76.36 in chips) 
Seat 7: Medved219 ($50.75 in chips) 
Seat 8: StudentRB ($83.10 in chips) 
Seat 9: strannikac ($79.41 in chips) 
pokermasse: posts small blind $0.25
Kolyan2114: posts big blind $0.50
*** HOLE CARDS ***
PleBeY95: folds 
finstrel: raises $1 to $1.50
Medved219: folds 
StudentRB: folds 
strannikac: folds 
v.sting: folds 
MarsMiland: raises $3.25 to $4.75
pokermasse: folds 
Kolyan2114: folds 
finstrel: calls $3.25
*** FLOP *** [6c As 2s]
finstrel: checks 
MarsMiland: bets $3.75
finstrel: calls $3.75
*** TURN *** [6c As 2s] [7d]
finstrel: checks 
MarsMiland: bets $11
finstrel: folds 
Uncalled bet ($11) returned to MarsMiland
MarsMiland collected $16.86 from pot
MarsMiland: doesn't show hand 
*** SUMMARY ***
Total pot $17.75 | Rake $0.89 
Board [6c As 2s 7d]
Seat 1: v.sting folded before Flop (didn't bet)
Seat 2: MarsMiland (button) collected ($16.86)
Seat 3: pokermasse (small blind) folded before Flop
Seat 4: Kolyan2114 (big blind) folded before Flop
Seat 5: PleBeY95 folded before Flop (didn't bet)
Seat 6: finstrel folded on the Turn
Seat 7: Medved219 folded before Flop (didn't bet)
Seat 8: StudentRB folded before Flop (didn't bet)
Seat 9: strannikac folded before Flop (didn't bet)



PokerStars Hand #228685916085:  Hold'em No Limit ($0.25/$0.50 USD) - 2021/07/30 14:53:05 ET
Table 'Gorgo III' 9-max Seat #3 is the button
Seat 1: v.sting ($59.25 in chips) 
Seat 2: MarsMiland ($69.09 in chips) 
Seat 3: pokermasse ($54.47 in chips) 
Seat 4: Kolyan2114 ($62.13 in chips) 
Seat 5: PleBeY95 ($56.06 in chips) 
Seat 6: finstrel ($67.86 in chips) 
Seat 7: Medved219 ($50.75 in chips) 
Seat 8: StudentRB ($83.10 in chips) 
Seat 9: strannikac ($79.41 in chips) 
Kolyan2114: posts small blind $0.25
PleBeY95: posts big blind $0.50
*** HOLE CARDS ***
finstrel: folds 
Medved219: folds 
StudentRB: folds 
strannikac: folds 
v.sting: folds 
MarsMiland: folds 
pokermasse: folds 
Kolyan2114: folds 
Uncalled bet ($0.25) returned to PleBeY95
PleBeY95 collected $0.50 from pot
*** SUMMARY ***
Total pot $0.50 | Rake $0 
Seat 1: v.sting folded before Flop (didn't bet)
Seat 2: MarsMiland folded before Flop (didn't bet)
Seat 3: pokermasse (button) folded before Flop (didn't bet)
Seat 4: Kolyan2114 (small blind) folded before Flop
Seat 5: PleBeY95 (big blind) collected ($0.50)
Seat 6: finstrel folded before Flop (didn't bet)
Seat 7: Medved219 folded before Flop (didn't bet)
Seat 8: StudentRB folded before Flop (didn't bet)
Seat 9: strannikac folded before Flop (didn't bet)



PokerStars Hand #228685923791:  Hold'em No Limit ($0.25/$0.50 USD) - 2021/07/30 14:53:23 ET
Table 'Gorgo III' 9-max Seat #4 is the button
Seat 1: v.sting ($59.25 in chips) 
Seat 2: MarsMiland ($69.09 in chips) 
Seat 3: pokermasse ($54.47 in chips) 
Seat 4: Kolyan2114 ($61.88 in chips) 
Seat 5: PleBeY95 ($56.31 in chips) 
Seat 6: finstrel ($67.86 in chips) 
Seat 7: Medved219 ($50.75 in chips) 
Seat 8: StudentRB ($83.10 in chips) 
Seat 9: strannikac ($79.41 in chips) 
PleBeY95: posts small blind $0.25
finstrel: posts big blind $0.50
*** HOLE CARDS ***
Medved219: folds 
StudentRB: folds 
strannikac: folds 
v.sting: folds 
MarsMiland: folds 
pokermasse: folds 
Kolyan2114: raises $0.75 to $1.25
PleBeY95: folds 
finstrel: raises $1.75 to $3
Kolyan2114: folds 
Uncalled bet ($1.75) returned to finstrel
finstrel collected $2.75 from pot
*** SUMMARY ***
Total pot $2.75 | Rake $0 
Seat 1: v.sting folded before Flop (didn't bet)
Seat 2: MarsMiland folded before Flop (didn't bet)
Seat 3: pokermasse folded before Flop (didn't bet)
Seat 4: Kolyan2114 (button) folded before Flop
Seat 5: PleBeY95 (small blind) folded before Flop
Seat 6: finstrel (big blind) collected ($2.75)
Seat 7: Medved219 folded before Flop (didn't bet)
Seat 8: StudentRB folded before Flop (didn't bet)
Seat 9: strannikac folded before Flop (didn't bet)



PokerStars Hand #228685933444:  Hold'em No Limit ($0.25/$0.50 USD) - 2021/07/30 14:53:45 ET
Table 'Gorgo III' 9-max Seat #5 is the button
Seat 1: v.sting ($59.25 in chips) 
Seat 2: MarsMiland ($69.09 in chips) 
Seat 3: pokermasse ($54.47 in chips) 
Seat 4: Kolyan2114 ($60.63 in chips) 
Seat 5: PleBeY95 ($56.06 in chips) 
Seat 6: finstrel ($69.36 in chips) 
Seat 7: Medved219 ($50.75 in chips) 
Seat 8: StudentRB ($83.10 in chips) 
Seat 9: strannikac ($79.41 in chips) 
finstrel: posts small blind $0.25
Medved219: posts big blind $0.50
*** HOLE CARDS ***
StudentRB: folds 
strannikac: folds 
v.sting: folds 
MarsMiland: folds 
pokermasse: folds 
Kolyan2114: raises $0.75 to $1.25
PleBeY95: calls $1.25
finstrel: folds 
Medved219: calls $0.75
*** FLOP *** [Qh 2c 8h]
Medved219: checks 
Kolyan2114: checks 
PleBeY95: bets $1.25
Medved219: calls $1.25
Kolyan2114: folds 
*** TURN *** [Qh 2c 8h] [6s]
Medved219: checks 
PleBeY95: checks 
*** RIVER *** [Qh 2c 8h 6s] [Ts]
Medved219: checks 
PleBeY95: checks 
*** SHOW DOWN ***
Medved219: shows [Qc 6c] (two pair, Queens and Sixes)
PleBeY95: mucks hand 
Medved219 collected $6.18 from pot
*** SUMMARY ***
Total pot $6.50 | Rake $0.32 
Board [Qh 2c 8h 6s Ts]
Seat 1: v.sting folded before Flop (didn't bet)
Seat 2: MarsMiland folded before Flop (didn't bet)
Seat 3: pokermasse folded before Flop (didn't bet)
Seat 4: Kolyan2114 folded on the Flop
Seat 5: PleBeY95 (button) mucked
Seat 6: finstrel (small blind) folded before Flop
Seat 7: Medved219 (big blind) showed [Qc 6c] and won ($6.18) with two pair, Queens and Sixes
Seat 8: StudentRB folded before Flop (didn't bet)
Seat 9: strannikac folded before Flop (didn't bet)



PokerStars Hand #228685952836:  Hold'em No Limit ($0.25/$0.50 USD) - 2021/07/30 14:54:31 ET
Table 'Gorgo III' 9-max Seat #6 is the button
Seat 1: v.sting ($59.25 in chips) 
Seat 2: MarsMiland ($69.09 in chips) 
Seat 3: pokermasse ($54.47 in chips) 
Seat 4: Kolyan2114 ($59.38 in chips) 
Seat 5: PleBeY95 ($53.56 in chips) 
Seat 6: finstrel ($69.11 in chips) 
Seat 7: Medved219 ($54.43 in chips) 
Seat 8: StudentRB ($83.10 in chips) 
Seat 9: strannikac ($79.41 in chips) 
Medved219: posts small blind $0.25
StudentRB: posts big blind $0.50
*** HOLE CARDS ***
strannikac: folds 
v.sting: folds 
MarsMiland: folds 
pokermasse: raises $1 to $1.50
Kolyan2114: folds 
PleBeY95: folds 
finstrel: folds 
Medved219: folds 
StudentRB: folds 
Uncalled bet ($1) returned to pokermasse
pokermasse collected $1.25 from pot
pokermasse: doesn't show hand 
*** SUMMARY ***
Total pot $1.25 | Rake $0 
Seat 1: v.sting folded before Flop (didn't bet)
Seat 2: MarsMiland folded before Flop (didn't bet)
Seat 3: pokermasse collected ($1.25)
Seat 4: Kolyan2114 folded before Flop (didn't bet)
Seat 5: PleBeY95 folded before Flop (didn't bet)
Seat 6: finstrel (button) folded before Flop (didn't bet)
Seat 7: Medved219 (small blind) folded before Flop
Seat 8: StudentRB (big blind) folded before Flop
Seat 9: strannikac folded before Flop (didn't bet)



PokerStars Hand #228685963004:  Hold'em No Limit ($0.25/$0.50 USD) - 2021/07/30 14:54:54 ET
Table 'Gorgo III' 9-max Seat #7 is the button
Seat 1: v.sting ($59.25 in chips) 
Seat 2: MarsMiland ($69.09 in chips) 
Seat 3: pokermasse ($55.22 in chips) 
Seat 4: Kolyan2114 ($59.38 in chips) 
Seat 5: PleBeY95 ($53.56 in chips) 
Seat 6: finstrel ($69.11 in chips) 
Seat 7: Medved219 ($54.18 in chips) 
Seat 8: StudentRB ($82.60 in chips) 
Seat 9: strannikac ($79.41 in chips) 
StudentRB: posts small blind $0.25
strannikac: posts big blind $0.50
*** HOLE CARDS ***
v.sting: folds 
MarsMiland: folds 
pokermasse: folds 
Kolyan2114: folds 
PleBeY95: folds 
finstrel: raises $1 to $1.50
Medved219: folds 
StudentRB: folds 
strannikac: raises $2.50 to $4
finstrel: calls $2.50
*** FLOP *** [7s 9h 5d]
strannikac: bets $3.92
finstrel: calls $3.92
*** TURN *** [7s 9h 5d] [Qs]
strannikac: bets $7.64
finstrel: folds 
Uncalled bet ($7.64) returned to strannikac
strannikac collected $15.29 from pot
strannikac: doesn't show hand 
*** SUMMARY ***
Total pot $16.09 | Rake $0.80 
Board [7s 9h 5d Qs]
Seat 1: v.sting folded before Flop (didn't bet)
Seat 2: MarsMiland folded before Flop (didn't bet)
Seat 3: pokermasse folded before Flop (didn't bet)
Seat 4: Kolyan2114 folded before Flop (didn't bet)
Seat 5: PleBeY95 folded before Flop (didn't bet)
Seat 6: finstrel folded on the Turn
Seat 7: Medved219 (button) folded before Flop (didn't bet)
Seat 8: StudentRB (small blind) folded before Flop
Seat 9: strannikac (big blind) collected ($15.29)



PokerStars Hand #228685983097:  Hold'em No Limit ($0.25/$0.50 USD) - 2021/07/30 14:55:52 ET
Table 'Gorgo III' 9-max Seat #8 is the button
Seat 1: v.sting ($59.25 in chips) 
Seat 2: MarsMiland ($69.09 in chips) 
Seat 3: pokermasse ($55.22 in chips) 
Seat 4: Kolyan2114 ($59.38 in chips) 
Seat 5: PleBeY95 ($53.56 in chips) 
Seat 6: finstrel ($61.19 in chips) 
Seat 7: Medved219 ($54.18 in chips) 
Seat 8: StudentRB ($82.35 in chips) 
Seat 9: strannikac ($86.78 in chips) 
strannikac: posts small blind $0.25
v.sting: posts big blind $0.50
*** HOLE CARDS ***
MarsMiland: folds 
pokermasse: calls $0.50
Kolyan2114: folds 
PleBeY95: folds 
finstrel: raises $1 to $1.50
Medved219: folds 
StudentRB: folds 
strannikac: folds 
v.sting: folds 
pokermasse: calls $1
*** FLOP *** [7c Ah Th]
pokermasse: checks 
finstrel: bets $1.50
pokermasse: raises $3.28 to $4.78
finstrel: calls $3.28
*** TURN *** [7c Ah Th] [5h]
pokermasse: checks 
finstrel: checks 
*** RIVER *** [7c Ah Th 5h] [3h]
pokermasse: checks 
finstrel: bets $7
pokermasse: folds 
Uncalled bet ($7) returned to finstrel
finstrel collected $12.64 from pot
*** SUMMARY ***
Total pot $13.31 | Rake $0.67 
Board [7c Ah Th 5h 3h]
Seat 1: v.sting (big blind) folded before Flop
Seat 2: MarsMiland folded before Flop (didn't bet)
Seat 3: pokermasse folded on the River
Seat 4: Kolyan2114 folded before Flop (didn't bet)
Seat 5: PleBeY95 folded before Flop (didn't bet)
Seat 6: finstrel collected ($12.64)
Seat 7: Medved219 folded before Flop (didn't bet)
Seat 8: StudentRB (button) folded before Flop (didn't bet)
Seat 9: strannikac (small blind) folded before Flop



PokerStars Hand #228686001224:  Hold'em No Limit ($0.25/$0.50 USD) - 2021/07/30 14:56:49 ET
Table 'Gorgo III' 9-max Seat #9 is the button
Seat 1: v.sting ($58.75 in chips) 
Seat 2: MarsMiland ($69.09 in chips) 
Seat 3: pokermasse ($48.94 in chips) 
Seat 4: Kolyan2114 ($59.38 in chips) 
Seat 5: PleBeY95 ($53.56 in chips) 
Seat 6: finstrel ($67.55 in chips) 
Seat 7: Medved219 ($54.18 in chips) 
Seat 8: StudentRB ($82.35 in chips) 
Seat 9: strannikac ($86.53 in chips) 
v.sting: posts small blind $0.25
MarsMiland: posts big blind $0.50
*** HOLE CARDS ***
pokermasse: folds 
pokermasse leaves the table
Kolyan2114: folds 
PleBeY95: folds 
finstrel: raises $1 to $1.50
Medved219: folds 
StudentRB: folds 
strannikac: calls $1.50
fool_rabbit joins the table at seat #3 
v.sting: folds 
MarsMiland: raises $5.50 to $7
finstrel: calls $5.50
strannikac: folds 
*** FLOP *** [3d 7c Jh]
MarsMiland: checks 
finstrel: checks 
*** TURN *** [3d 7c Jh] [5d]
MarsMiland: bets $4.94
finstrel: folds 
Uncalled bet ($4.94) returned to MarsMiland
MarsMiland collected $14.96 from pot
MarsMiland: doesn't show hand 
*** SUMMARY ***
Total pot $15.75 | Rake $0.79 
Board [3d 7c Jh 5d]
Seat 1: v.sting (small blind) folded before Flop
Seat 2: MarsMiland (big blind) collected ($14.96)
Seat 3: pokermasse folded before Flop (didn't bet)
Seat 4: Kolyan2114 folded before Flop (didn't bet)
Seat 5: PleBeY95 folded before Flop (didn't bet)
Seat 6: finstrel folded on the Turn
Seat 7: Medved219 folded before Flop (didn't bet)
Seat 8: StudentRB folded before Flop (didn't bet)
Seat 9: strannikac (button) folded before Flop



PokerStars Hand #228686022990:  Hold'em No Limit ($0.25/$0.50 USD) - 2021/07/30 14:57:58 ET
Table 'Gorgo III' 9-max Seat #1 is the button
Seat 1: v.sting ($58.50 in chips) 
Seat 2: MarsMiland ($77.05 in chips) 
Seat 3: fool_rabbit ($50 in chips) 
Seat 4: Kolyan2114 ($59.38 in chips) 
Seat 5: PleBeY95 ($53.56 in chips) 
Seat 6: finstrel ($60.55 in chips) 
Seat 7: Medved219 ($54.18 in chips) 
Seat 8: StudentRB ($82.35 in chips) 
Seat 9: strannikac ($85.03 in chips) 
MarsMiland: posts small blind $0.25
fool_rabbit: posts big blind $0.50
*** HOLE CARDS ***
Kolyan2114: folds 
PleBeY95: folds 
finstrel: folds 
Medved219: folds 
StudentRB: folds 
strannikac: folds 
v.sting: folds 
MarsMiland: folds 
Uncalled bet ($0.25) returned to fool_rabbit
fool_rabbit collected $0.50 from pot
fool_rabbit: doesn't show hand 
*** SUMMARY ***
Total pot $0.50 | Rake $0 
Seat 1: v.sting (button) folded before Flop (didn't bet)
Seat 2: MarsMiland (small blind) folded before Flop
Seat 3: fool_rabbit (big blind) collected ($0.50)
Seat 4: Kolyan2114 folded before Flop (didn't bet)
Seat 5: PleBeY95 folded before Flop (didn't bet)
Seat 6: finstrel folded before Flop (didn't bet)
Seat 7: Medved219 folded before Flop (didn't bet)
Seat 8: StudentRB folded before Flop (didn't bet)
Seat 9: strannikac folded before Flop (didn't bet)



PokerStars Hand #228686028319:  Hold'em No Limit ($0.25/$0.50 USD) - 2021/07/30 14:58:15 ET
Table 'Gorgo III' 9-max Seat #2 is the button
Seat 1: v.sting ($58.50 in chips) 
Seat 2: MarsMiland ($76.80 in chips) 
Seat 3: fool_rabbit ($50.25 in chips) 
Seat 4: Kolyan2114 ($59.38 in chips) 
Seat 5: PleBeY95 ($53.56 in chips) 
Seat 6: finstrel ($60.55 in chips) 
Seat 7: Medved219 ($54.18 in chips) 
Seat 8: StudentRB ($82.35 in chips) 
Seat 9: strannikac ($85.03 in chips) 
fool_rabbit: posts small blind $0.25
Kolyan2114: posts big blind $0.50
*** HOLE CARDS ***
PleBeY95: raises $1 to $1.50
finstrel: calls $1.50
Medved219: folds 
StudentRB: folds 
strannikac: folds 
v.sting: folds 
MarsMiland: folds 
fool_rabbit: folds 
Kolyan2114: folds 
*** FLOP *** [7d 9s 8s]
PleBeY95: checks 
finstrel: checks 
*** TURN *** [7d 9s 8s] [Qh]
PleBeY95: checks 
finstrel: checks 
*** RIVER *** [7d 9s 8s Qh] [7h]
PleBeY95: bets $6.50
finstrel: folds 
Uncalled bet ($6.50) returned to PleBeY95
PleBeY95 collected $3.56 from pot
*** SUMMARY ***
Total pot $3.75 | Rake $0.19 
Board [7d 9s 8s Qh 7h]
Seat 1: v.sting folded before Flop (didn't bet)
Seat 2: MarsMiland (button) folded before Flop (didn't bet)
Seat 3: fool_rabbit (small blind) folded before Flop
Seat 4: Kolyan2114 (big blind) folded before Flop
Seat 5: PleBeY95 collected ($3.56)
Seat 6: finstrel folded on the River
Seat 7: Medved219 folded before Flop (didn't bet)
Seat 8: StudentRB folded before Flop (didn't bet)
Seat 9: strannikac folded before Flop (didn't bet)



PokerStars Hand #228686053082:  Hold'em No Limit ($0.25/$0.50 USD) - 2021/07/30 14:59:32 ET
Table 'Gorgo III' 9-max Seat #3 is the button
Seat 1: v.sting ($58.50 in chips) 
Seat 2: MarsMiland ($76.80 in chips) 
Seat 3: fool_rabbit ($50 in chips) 
Seat 4: Kolyan2114 ($58.88 in chips) 
Seat 5: PleBeY95 ($55.62 in chips) 
Seat 6: finstrel ($59.05 in chips) 
Seat 7: Medved219 ($54.18 in chips) 
Seat 8: StudentRB ($82.35 in chips) 
Seat 9: strannikac ($85.03 in chips) 
Kolyan2114: posts small blind $0.25
PleBeY95: posts big blind $0.50
*** HOLE CARDS ***
finstrel: folds 
Medved219: folds 
StudentRB: raises $0.75 to $1.25
strannikac: calls $1.25
v.sting: raises $5 to $6.25
MarsMiland: folds 
fool_rabbit: folds 
Kolyan2114: folds 
PleBeY95: folds 
StudentRB: calls $5
strannikac: calls $5
*** FLOP *** [Kd 7c 6h]
StudentRB: checks 
strannikac: checks 
v.sting: bets $6.11
StudentRB: folds 
strannikac: folds 
Uncalled bet ($6.11) returned to v.sting
v.sting collected $18.52 from pot
v.sting: doesn't show hand 
*** SUMMARY ***
Total pot $19.50 | Rake $0.98 
Board [Kd 7c 6h]
Seat 1: v.sting collected ($18.52)
Seat 2: MarsMiland folded before Flop (didn't bet)
Seat 3: fool_rabbit (button) folded before Flop (didn't bet)
Seat 4: Kolyan2114 (small blind) folded before Flop
Seat 5: PleBeY95 (big blind) folded before Flop
Seat 6: finstrel folded before Flop (didn't bet)
Seat 7: Medved219 folded before Flop (didn't bet)
Seat 8: StudentRB folded on the Flop
Seat 9: strannikac folded on the Flop



PokerStars Hand #228686071101:  Hold'em No Limit ($0.25/$0.50 USD) - 2021/07/30 15:00:26 ET
Table 'Gorgo III' 9-max Seat #4 is the button
Seat 1: v.sting ($70.77 in chips) 
Seat 2: MarsMiland ($76.80 in chips) 
Seat 3: fool_rabbit ($50 in chips) 
Seat 4: Kolyan2114 ($58.63 in chips) 
Seat 5: PleBeY95 ($55.12 in chips) 
Seat 6: finstrel ($59.05 in chips) 
Seat 7: Medved219 ($54.18 in chips) 
Seat 8: StudentRB ($76.10 in chips) 
Seat 9: strannikac ($78.78 in chips) 
PleBeY95: posts small blind $0.25
finstrel: posts big blind $0.50
*** HOLE CARDS ***
Medved219: raises $1.50 to $2
StudentRB: folds 
strannikac: folds 
v.sting: folds 
MarsMiland: folds 
fool_rabbit: folds 
Kolyan2114: folds 
PleBeY95: folds 
finstrel: calls $1.50
*** FLOP *** [Qh Td 5c]
finstrel: checks 
Medved219: bets $1.33
finstrel: calls $1.33
*** TURN *** [Qh Td 5c] [8c]
finstrel: checks 
Medved219: checks 
*** RIVER *** [Qh Td 5c 8c] [2d]
finstrel: bets $4.50
Medved219: folds 
Uncalled bet ($4.50) returned to finstrel
finstrel collected $6.56 from pot
*** SUMMARY ***
Total pot $6.91 | Rake $0.35 
Board [Qh Td 5c 8c 2d]
Seat 1: v.sting folded before Flop (didn't bet)
Seat 2: MarsMiland folded before Flop (didn't bet)
Seat 3: fool_rabbit folded before Flop (didn't bet)
Seat 4: Kolyan2114 (button) folded before Flop (didn't bet)
Seat 5: PleBeY95 (small blind) folded before Flop
Seat 6: finstrel (big blind) collected ($6.56)
Seat 7: Medved219 folded on the River
Seat 8: StudentRB folded before Flop (didn't bet)
Seat 9: strannikac folded before Flop (didn't bet)



PokerStars Hand #228686090374:  Hold'em No Limit ($0.25/$0.50 USD) - 2021/07/30 15:01:12 ET
Table 'Gorgo III' 9-max Seat #5 is the button
Seat 1: v.sting ($70.77 in chips) 
Seat 2: MarsMiland ($76.80 in chips) 
Seat 3: fool_rabbit ($50 in chips) 
Seat 4: Kolyan2114 ($58.63 in chips) 
Seat 5: PleBeY95 ($54.87 in chips) 
Seat 6: finstrel ($62.28 in chips) 
Seat 7: Medved219 ($50.85 in chips) 
Seat 8: StudentRB ($76.10 in chips) 
Seat 9: strannikac ($78.78 in chips) 
finstrel: posts small blind $0.25
Medved219: posts big blind $0.50
*** HOLE CARDS ***
StudentRB: raises $0.75 to $1.25
strannikac: folds 
v.sting: folds 
MarsMiland: folds 
fool_rabbit: folds 
Kolyan2114: raises $3.25 to $4.50
PleBeY95: folds 
finstrel: folds 
Medved219: folds 
StudentRB: folds 
Uncalled bet ($3.25) returned to Kolyan2114
Kolyan2114 collected $3.25 from pot
*** SUMMARY ***
Total pot $3.25 | Rake $0 
Seat 1: v.sting folded before Flop (didn't bet)
Seat 2: MarsMiland folded before Flop (didn't bet)
Seat 3: fool_rabbit folded before Flop (didn't bet)
Seat 4: Kolyan2114 collected ($3.25)
Seat 5: PleBeY95 (button) folded before Flop (didn't bet)
Seat 6: finstrel (small blind) folded before Flop
Seat 7: Medved219 (big blind) folded before Flop
Seat 8: StudentRB folded before Flop
Seat 9: strannikac folded before Flop (didn't bet)



PokerStars Hand #228686105786:  Hold'em No Limit ($0.25/$0.50 USD) - 2021/07/30 15:01:51 ET
Table 'Gorgo III' 9-max Seat #6 is the button
Seat 1: v.sting ($70.77 in chips) 
Seat 2: MarsMiland ($76.80 in chips) 
Seat 3: fool_rabbit ($50 in chips) 
Seat 4: Kolyan2114 ($60.63 in chips) 
Seat 5: PleBeY95 ($54.87 in chips) 
Seat 6: finstrel ($62.03 in chips) 
Seat 7: Medved219 ($50.35 in chips) 
Seat 8: StudentRB ($74.85 in chips) 
Seat 9: strannikac ($78.78 in chips) 
Medved219: posts small blind $0.25
StudentRB: posts big blind $0.50
*** HOLE CARDS ***
strannikac: folds 
v.sting: folds 
MarsMiland: folds 
fool_rabbit: folds 
Kolyan2114: raises $0.75 to $1.25
PleBeY95: folds 
finstrel: folds 
Medved219: folds 
StudentRB: folds 
Uncalled bet ($0.75) returned to Kolyan2114
Kolyan2114 collected $1.25 from pot
*** SUMMARY ***
Total pot $1.25 | Rake $0 
Seat 1: v.sting folded before Flop (didn't bet)
Seat 2: MarsMiland folded before Flop (didn't bet)
Seat 3: fool_rabbit folded before Flop (didn't bet)
Seat 4: Kolyan2114 collected ($1.25)
Seat 5: PleBeY95 folded before Flop (didn't bet)
Seat 6: finstrel (button) folded before Flop (didn't bet)
Seat 7: Medved219 (small blind) folded before Flop
Seat 8: StudentRB (big blind) folded before Flop
Seat 9: strannikac folded before Flop (didn't bet)



PokerStars Hand #228686111307:  Hold'em No Limit ($0.25/$0.50 USD) - 2021/07/30 15:02:05 ET
Table 'Gorgo III' 9-max Seat #7 is the button
Seat 1: v.sting ($70.77 in chips) 
Seat 2: MarsMiland ($76.80 in chips) 
Seat 3: fool_rabbit ($50 in chips) 
Seat 4: Kolyan2114 ($61.38 in chips) 
Seat 5: PleBeY95 ($54.87 in chips) 
Seat 6: finstrel ($62.03 in chips) 
Seat 7: Medved219 ($50.10 in chips) 
Seat 8: StudentRB ($74.35 in chips) 
Seat 9: strannikac ($78.78 in chips) 
StudentRB: posts small blind $0.25
strannikac: posts big blind $0.50
*** HOLE CARDS ***
v.sting: folds 
MarsMiland: folds 
fool_rabbit: folds 
Kolyan2114: raises $0.75 to $1.25
PleBeY95: folds 
finstrel: folds 
Medved219: folds 
StudentRB: folds 
strannikac: calls $0.75
*** FLOP *** [9s Td Kd]
strannikac: checks 
Kolyan2114: checks 
*** TURN *** [9s Td Kd] [5d]
strannikac: checks 
Kolyan2114: bets $1.72
strannikac: calls $1.72
*** RIVER *** [9s Td Kd 5d] [Jc]
strannikac: checks 
Kolyan2114: bets $4.47
strannikac: calls $4.47
*** SHOW DOWN ***
Kolyan2114: shows [Ac 7c] (high card Ace)
strannikac: shows [Qc Th] (a straight, Nine to King)
strannikac collected $14.37 from pot
*** SUMMARY ***
Total pot $15.13 | Rake $0.76 
Board [9s Td Kd 5d Jc]
Seat 1: v.sting folded before Flop (didn't bet)
Seat 2: MarsMiland folded before Flop (didn't bet)
Seat 3: fool_rabbit folded before Flop (didn't bet)
Seat 4: Kolyan2114 showed [Ac 7c] and lost with high card Ace
Seat 5: PleBeY95 folded before Flop (didn't bet)
Seat 6: finstrel folded before Flop (didn't bet)
Seat 7: Medved219 (button) folded before Flop (didn't bet)
Seat 8: StudentRB (small blind) folded before Flop
Seat 9: strannikac (big blind) showed [Qc Th] and won ($14.37) with a straight, Nine to King



PokerStars Hand #228686129029:  Hold'em No Limit ($0.25/$0.50 USD) - 2021/07/30 15:02:48 ET
Table 'Gorgo III' 9-max Seat #8 is the button
Seat 1: v.sting ($70.77 in chips) 
Seat 2: MarsMiland ($76.80 in chips) 
Seat 3: fool_rabbit ($50 in chips) 
Seat 4: Kolyan2114 ($53.94 in chips) 
Seat 5: PleBeY95 ($54.87 in chips) 
Seat 6: finstrel ($62.03 in chips) 
Seat 7: Medved219 ($50.10 in chips) 
Seat 8: StudentRB ($74.10 in chips) 
Seat 9: strannikac ($85.71 in chips) 
strannikac: posts small blind $0.25
v.sting: posts big blind $0.50
*** HOLE CARDS ***
MarsMiland: raises $0.90 to $1.40
fool_rabbit: folds 
Kolyan2114: folds 
PleBeY95: folds 
finstrel: calls $1.40
Medved219: folds 
StudentRB: folds 
strannikac: folds 
v.sting: calls $0.90
*** FLOP *** [Jd As Tc]
v.sting: checks 
MarsMiland: checks 
finstrel: bets $1
v.sting: folds 
MarsMiland: folds 
Uncalled bet ($1) returned to finstrel
finstrel collected $4.23 from pot
*** SUMMARY ***
Total pot $4.45 | Rake $0.22 
Board [Jd As Tc]
Seat 1: v.sting (big blind) folded on the Flop
Seat 2: MarsMiland folded on the Flop
Seat 3: fool_rabbit folded before Flop (didn't bet)
Seat 4: Kolyan2114 folded before Flop (didn't bet)
Seat 5: PleBeY95 folded before Flop (didn't bet)
Seat 6: finstrel collected ($4.23)
Seat 7: Medved219 folded before Flop (didn't bet)
Seat 8: StudentRB (button) folded before Flop (didn't bet)
Seat 9: strannikac (small blind) folded before Flop



PokerStars Hand #228685388071:  Hold'em No Limit ($0.25/$0.50 USD) - 2021/07/30 14:32:49 ET
Table 'Gorgo III' 9-max Seat #1 is the button
Seat 1: v.sting ($64 in chips) 
Seat 2: wami1981 ($107.58 in chips) 
Seat 3: pokermasse ($47.50 in chips) 
Seat 4: Kolyan2114 ($68.58 in chips) 
Seat 5: PleBeY95 ($58.65 in chips) 
Seat 6: finstrel ($88.36 in chips) 
Seat 7: Medved219 ($50 in chips) 
Seat 8: StudentRB ($50 in chips) 
Seat 9: strannikac ($81.91 in chips) 
wami1981: posts small blind $0.25
pokermasse: posts big blind $0.50
*** HOLE CARDS ***
Kolyan2114: folds 
PleBeY95: raises $1 to $1.50
finstrel: folds 
Medved219: folds 
StudentRB: folds 
strannikac: folds 
v.sting: folds 
wami1981: folds 
pokermasse: folds 
Uncalled bet ($1) returned to PleBeY95
PleBeY95 collected $1.25 from pot
*** SUMMARY ***
Total pot $1.25 | Rake $0 
Seat 1: v.sting (button) folded before Flop (didn't bet)
Seat 2: wami1981 (small blind) folded before Flop
Seat 3: pokermasse (big blind) folded before Flop
Seat 4: Kolyan2114 folded before Flop (didn't bet)
Seat 5: PleBeY95 collected ($1.25)
Seat 6: finstrel folded before Flop (didn't bet)
Seat 7: Medved219 folded before Flop (didn't bet)
Seat 8: StudentRB folded before Flop (didn't bet)
Seat 9: strannikac folded before Flop (didn't bet)



PokerStars Hand #228685393491:  Hold'em No Limit ($0.25/$0.50 USD) - 2021/07/30 14:33:02 ET
Table 'Gorgo III' 9-max Seat #2 is the button
Seat 1: v.sting ($64 in chips) 
Seat 2: wami1981 ($107.33 in chips) 
Seat 3: pokermasse ($47 in chips) 
Seat 4: Kolyan2114 ($68.58 in chips) 
Seat 5: PleBeY95 ($59.40 in chips) 
Seat 6: finstrel ($88.36 in chips) 
Seat 7: Medved219 ($50 in chips) 
Seat 8: StudentRB ($50 in chips) 
Seat 9: strannikac ($81.91 in chips) 
pokermasse: posts small blind $0.25
Kolyan2114: posts big blind $0.50
*** HOLE CARDS ***
PleBeY95: raises $1 to $1.50
finstrel: folds 
Medved219: folds 
StudentRB: folds 
strannikac: folds 
v.sting: folds 
wami1981: calls $1.50
pokermasse: folds 
Kolyan2114: folds 
*** FLOP *** [7s 8h 4h]
PleBeY95: bets $2.67
wami1981: folds 
Uncalled bet ($2.67) returned to PleBeY95
PleBeY95 collected $3.56 from pot
*** SUMMARY ***
Total pot $3.75 | Rake $0.19 
Board [7s 8h 4h]
Seat 1: v.sting folded before Flop (didn't bet)
Seat 2: wami1981 (button) folded on the Flop
Seat 3: pokermasse (small blind) folded before Flop
Seat 4: Kolyan2114 (big blind) folded before Flop
Seat 5: PleBeY95 collected ($3.56)
Seat 6: finstrel folded before Flop (didn't bet)
Seat 7: Medved219 folded before Flop (didn't bet)
Seat 8: StudentRB folded before Flop (didn't bet)
Seat 9: strannikac folded before Flop (didn't bet)



PokerStars Hand #228686153363:  Hold'em No Limit ($0.25/$0.50 USD) - 2021/07/30 15:03:43 ET
Table 'Gorgo III' 9-max Seat #9 is the button
Seat 1: v.sting ($69.37 in chips) 
Seat 2: MarsMiland ($75.40 in chips) 
Seat 3: fool_rabbit ($50 in chips) 
Seat 4: Kolyan2114 ($53.94 in chips) 
Seat 5: PleBeY95 ($54.87 in chips) 
Seat 6: finstrel ($64.86 in chips) 
Seat 7: Medved219 ($50.10 in chips) 
Seat 8: StudentRB ($74.10 in chips) 
Seat 9: strannikac ($85.46 in chips) 
v.sting: posts small blind $0.25
MarsMiland: posts big blind $0.50
*** HOLE CARDS ***
fool_rabbit: folds 
Kolyan2114: folds 
PleBeY95: folds 
finstrel: folds 
Medved219: folds 
StudentRB: folds 
strannikac: folds 
v.sting: folds 
Uncalled bet ($0.25) returned to MarsMiland
MarsMiland collected $0.50 from pot
MarsMiland: doesn't show hand 
*** SUMMARY ***
Total pot $0.50 | Rake $0 
Seat 1: v.sting (small blind) folded before Flop
Seat 2: MarsMiland (big blind) collected ($0.50)
Seat 3: fool_rabbit folded before Flop (didn't bet)
Seat 4: Kolyan2114 folded before Flop (didn't bet)
Seat 5: PleBeY95 folded before Flop (didn't bet)
Seat 6: finstrel folded before Flop (didn't bet)
Seat 7: Medved219 folded before Flop (didn't bet)
Seat 8: StudentRB folded before Flop (didn't bet)
Seat 9: strannikac (button) folded before Flop (didn't bet)



PokerStars Hand #228686159902:  Hold'em No Limit ($0.25/$0.50 USD) - 2021/07/30 15:03:58 ET
Table 'Gorgo III' 9-max Seat #1 is the button
Seat 1: v.sting ($69.12 in chips) 
Seat 2: MarsMiland ($75.65 in chips) 
Seat 3: fool_rabbit ($50 in chips) 
Seat 4: Kolyan2114 ($53.94 in chips) 
Seat 5: PleBeY95 ($54.87 in chips) 
Seat 6: finstrel ($64.86 in chips) 
Seat 7: Medved219 ($50.10 in chips) 
Seat 8: StudentRB ($74.10 in chips) 
Seat 9: strannikac ($85.46 in chips) 
MarsMiland: posts small blind $0.25
fool_rabbit: posts big blind $0.50
*** HOLE CARDS ***
Kolyan2114: folds 
PleBeY95: folds 
Kolyan2114 leaves the table
finstrel: folds 
Medved219: folds 
StudentRB: folds 
strannikac: raises $1 to $1.50
v.sting: raises $3 to $4.50
MarsMiland: folds 
fool_rabbit: folds 
strannikac: raises $80.96 to $85.46 and is all-in
v.sting: folds 
Uncalled bet ($80.96) returned to strannikac
strannikac collected $9.75 from pot
strannikac: doesn't show hand 
*** SUMMARY ***
Total pot $9.75 | Rake $0 
Seat 1: v.sting (button) folded before Flop
Seat 2: MarsMiland (small blind) folded before Flop
Seat 3: fool_rabbit (big blind) folded before Flop
Seat 4: Kolyan2114 folded before Flop (didn't bet)
Seat 5: PleBeY95 folded before Flop (didn't bet)
Seat 6: finstrel folded before Flop (didn't bet)
Seat 7: Medved219 folded before Flop (didn't bet)
Seat 8: StudentRB folded before Flop (didn't bet)
Seat 9: strannikac collected ($9.75)



PokerStars Hand #228686174140:  Hold'em No Limit ($0.25/$0.50 USD) - 2021/07/30 15:04:30 ET
Table 'Gorgo III' 9-max Seat #2 is the button
Seat 1: v.sting ($64.62 in chips) 
Seat 2: MarsMiland ($75.40 in chips) 
Seat 3: fool_rabbit ($50 in chips) 
Seat 5: PleBeY95 ($54.87 in chips) 
Seat 6: finstrel ($64.86 in chips) 
Seat 7: Medved219 ($50.10 in chips) 
Seat 8: StudentRB ($74.10 in chips) 
Seat 9: strannikac ($90.71 in chips) 
fool_rabbit: posts small blind $0.25
PleBeY95: posts big blind $0.50
*** HOLE CARDS ***
finstrel: folds 
Medved219: folds 
StudentRB: folds 
strannikac: folds 
v.sting: folds 
MarsMiland: folds 
fool_rabbit: folds 
Uncalled bet ($0.25) returned to PleBeY95
PleBeY95 collected $0.50 from pot
*** SUMMARY ***
Total pot $0.50 | Rake $0 
Seat 1: v.sting folded before Flop (didn't bet)
Seat 2: MarsMiland (button) folded before Flop (didn't bet)
Seat 3: fool_rabbit (small blind) folded before Flop
Seat 5: PleBeY95 (big blind) collected ($0.50)
Seat 6: finstrel folded before Flop (didn't bet)
Seat 7: Medved219 folded before Flop (didn't bet)
Seat 8: StudentRB folded before Flop (didn't bet)
Seat 9: strannikac folded before Flop (didn't bet)



PokerStars Hand #228686181906:  Hold'em No Limit ($0.25/$0.50 USD) - 2021/07/30 15:04:47 ET
Table 'Gorgo III' 9-max Seat #3 is the button
Seat 1: v.sting ($64.62 in chips) 
Seat 2: MarsMiland ($75.40 in chips) 
Seat 3: fool_rabbit ($50 in chips) 
Seat 5: PleBeY95 ($55.12 in chips) 
Seat 6: finstrel ($64.86 in chips) 
Seat 7: Medved219 ($50.10 in chips) 
Seat 8: StudentRB ($74.10 in chips) 
Seat 9: strannikac ($90.71 in chips) 
PleBeY95: posts small blind $0.25
finstrel: posts big blind $0.50
*** HOLE CARDS ***
Medved219: folds 
StudentRB: raises $0.75 to $1.25
strannikac: raises $2.75 to $4
v.sting: folds 
MarsMiland: folds 
fool_rabbit: folds 
PleBeY95: folds 
finstrel: calls $3.50
StudentRB: folds 
*** FLOP *** [Kc Th 6s]
finstrel: checks 
strannikac: bets $5.01
Xamil666 joins the table at seat #4 
finstrel: folds 
Uncalled bet ($5.01) returned to strannikac
strannikac collected $9.02 from pot
strannikac: doesn't show hand 
*** SUMMARY ***
Total pot $9.50 | Rake $0.48 
Board [Kc Th 6s]
Seat 1: v.sting folded before Flop (didn't bet)
Seat 2: MarsMiland folded before Flop (didn't bet)
Seat 3: fool_rabbit (button) folded before Flop (didn't bet)
Seat 5: PleBeY95 (small blind) folded before Flop
Seat 6: finstrel (big blind) folded on the Flop
Seat 7: Medved219 folded before Flop (didn't bet)
Seat 8: StudentRB folded before Flop
Seat 9: strannikac collected ($9.02)



PokerStars Hand #228686207837:  Hold'em No Limit ($0.25/$0.50 USD) - 2021/07/30 15:05:35 ET
Table 'Gorgo III' 9-max Seat #5 is the button
Seat 1: v.sting ($64.62 in chips) 
Seat 2: MarsMiland ($75.40 in chips) 
Seat 3: fool_rabbit ($50 in chips) 
Seat 5: PleBeY95 ($54.87 in chips) 
Seat 6: finstrel ($60.86 in chips) 
Seat 7: Medved219 ($50.10 in chips) 
Seat 8: StudentRB ($72.85 in chips) 
Seat 9: strannikac ($95.73 in chips) 
finstrel: posts small blind $0.25
Medved219: posts big blind $0.50
Xamil666: sits out 
*** HOLE CARDS ***
StudentRB: folds 
strannikac: folds 
v.sting: folds 
MarsMiland: folds 
fool_rabbit: folds 
PleBeY95: raises $0.75 to $1.25
finstrel: folds 
Medved219: calls $0.75
*** FLOP *** [Qc 9c 3s]
Medved219: checks 
PleBeY95: bets $0.86
Medved219: folds 
Uncalled bet ($0.86) returned to PleBeY95
PleBeY95 collected $2.61 from pot
*** SUMMARY ***
Total pot $2.75 | Rake $0.14 
Board [Qc 9c 3s]
Seat 1: v.sting folded before Flop (didn't bet)
Seat 2: MarsMiland folded before Flop (didn't bet)
Seat 3: fool_rabbit folded before Flop (didn't bet)
Seat 5: PleBeY95 (button) collected ($2.61)
Seat 6: finstrel (small blind) folded before Flop
Seat 7: Medved219 (big blind) folded on the Flop
Seat 8: StudentRB folded before Flop (didn't bet)
Seat 9: strannikac folded before Flop (didn't bet)



PokerStars Hand #228686220397:  Hold'em No Limit ($0.25/$0.50 USD) - 2021/07/30 15:06:02 ET
Table 'Gorgo III' 9-max Seat #6 is the button
Seat 1: v.sting ($64.62 in chips) 
Seat 2: MarsMiland ($75.40 in chips) 
Seat 3: fool_rabbit ($50 in chips) 
Seat 5: PleBeY95 ($56.23 in chips) 
Seat 6: finstrel ($60.61 in chips) 
Seat 7: Medved219 ($50 in chips) 
Seat 8: StudentRB ($72.85 in chips) 
Seat 9: strannikac ($95.73 in chips) 
Medved219: posts small blind $0.25
StudentRB: posts big blind $0.50
Xamil666: sits out 
*** HOLE CARDS ***
strannikac: folds 
v.sting: folds 
MarsMiland: folds 
fool_rabbit: folds 
PleBeY95: folds 
finstrel: raises $1 to $1.50
Medved219: raises $3.50 to $5
StudentRB: folds 
finstrel: calls $3.50
*** FLOP *** [As 4h Ks]
Medved219: checks 
finstrel: checks 
*** TURN *** [As 4h Ks] [Kc]
Medved219: checks 
finstrel: bets $3
Medved219: calls $3
*** RIVER *** [As 4h Ks Kc] [9c]
Medved219: checks 
finstrel: checks 
*** SHOW DOWN ***
Medved219: shows [9h 9d] (a full house, Nines full of Kings)
finstrel: mucks hand 
Medved219 collected $15.68 from pot
*** SUMMARY ***
Total pot $16.50 | Rake $0.82 
Board [As 4h Ks Kc 9c]
Seat 1: v.sting folded before Flop (didn't bet)
Seat 2: MarsMiland folded before Flop (didn't bet)
Seat 3: fool_rabbit folded before Flop (didn't bet)
Seat 5: PleBeY95 folded before Flop (didn't bet)
Seat 6: finstrel (button) mucked
Seat 7: Medved219 (small blind) showed [9h 9d] and won ($15.68) with a full house, Nines full of Kings
Seat 8: StudentRB (big blind) folded before Flop
Seat 9: strannikac folded before Flop (didn't bet)



PokerStars Hand #228686243154:  Hold'em No Limit ($0.25/$0.50 USD) - 2021/07/30 15:06:52 ET
Table 'Gorgo III' 9-max Seat #7 is the button
Seat 1: v.sting ($64.62 in chips) 
Seat 2: MarsMiland ($75.40 in chips) 
Seat 3: fool_rabbit ($50 in chips) 
Seat 5: PleBeY95 ($56.23 in chips) 
Seat 6: finstrel ($52.61 in chips) 
Seat 7: Medved219 ($57.68 in chips) 
Seat 8: StudentRB ($72.35 in chips) 
Seat 9: strannikac ($95.73 in chips) 
StudentRB: posts small blind $0.25
strannikac: posts big blind $0.50
Xamil666: sits out 
*** HOLE CARDS ***
v.sting: folds 
MarsMiland: folds 
fool_rabbit: folds 
PleBeY95: folds 
finstrel: folds 
Medved219: folds 
StudentRB: raises $1 to $1.50
strannikac: folds 
Uncalled bet ($1) returned to StudentRB
StudentRB collected $1 from pot
*** SUMMARY ***
Total pot $1 | Rake $0 
Seat 1: v.sting folded before Flop (didn't bet)
Seat 2: MarsMiland folded before Flop (didn't bet)
Seat 3: fool_rabbit folded before Flop (didn't bet)
Seat 5: PleBeY95 folded before Flop (didn't bet)
Seat 6: finstrel folded before Flop (didn't bet)
Seat 7: Medved219 (button) folded before Flop (didn't bet)
Seat 8: StudentRB (small blind) collected ($1)
Seat 9: strannikac (big blind) folded before Flop



PokerStars Hand #228686251454:  Hold'em No Limit ($0.25/$0.50 USD) - 2021/07/30 15:07:10 ET
Table 'Gorgo III' 9-max Seat #8 is the button
Seat 1: v.sting ($64.62 in chips) 
Seat 2: MarsMiland ($75.40 in chips) 
Seat 3: fool_rabbit ($50 in chips) 
Seat 5: PleBeY95 ($56.23 in chips) 
Seat 6: finstrel ($52.61 in chips) 
Seat 7: Medved219 ($57.68 in chips) 
Seat 8: StudentRB ($72.85 in chips) 
Seat 9: strannikac ($95.23 in chips) 
strannikac: posts small blind $0.25
v.sting: posts big blind $0.50
Xamil666: sits out 
*** HOLE CARDS ***
MarsMiland: folds 
fool_rabbit: folds 
PleBeY95: folds 
finstrel: raises $1 to $1.50
Medved219: folds 
StudentRB: folds 
strannikac: folds 
v.sting: folds 
Uncalled bet ($1) returned to finstrel
finstrel collected $1.25 from pot
*** SUMMARY ***
Total pot $1.25 | Rake $0 
Seat 1: v.sting (big blind) folded before Flop
Seat 2: MarsMiland folded before Flop (didn't bet)
Seat 3: fool_rabbit folded before Flop (didn't bet)
Seat 5: PleBeY95 folded before Flop (didn't bet)
Seat 6: finstrel collected ($1.25)
Seat 7: Medved219 folded before Flop (didn't bet)
Seat 8: StudentRB (button) folded before Flop (didn't bet)
Seat 9: strannikac (small blind) folded before Flop



PokerStars Hand #228686259754:  Hold'em No Limit ($0.25/$0.50 USD) - 2021/07/30 15:07:28 ET
Table 'Gorgo III' 9-max Seat #9 is the button
Seat 1: v.sting ($64.12 in chips) 
Seat 2: MarsMiland ($75.40 in chips) 
Seat 3: fool_rabbit ($50 in chips) 
Seat 5: PleBeY95 ($56.23 in chips) 
Seat 6: finstrel ($53.36 in chips) 
Seat 7: Medved219 ($57.68 in chips) 
Seat 8: StudentRB ($72.85 in chips) 
Seat 9: strannikac ($94.98 in chips) 
v.sting: posts small blind $0.25
MarsMiland: posts big blind $0.50
Xamil666: sits out 
*** HOLE CARDS ***
fool_rabbit: folds 
PleBeY95: folds 
finstrel: folds 
Medved219: folds 
StudentRB: folds 
strannikac: folds 
v.sting: raises $1 to $1.50
MarsMiland: calls $1
*** FLOP *** [Jh 5d 9s]
v.sting: checks 
MarsMiland: checks 
*** TURN *** [Jh 5d 9s] [2h]
v.sting: bets $0.94
MarsMiland: folds 
Uncalled bet ($0.94) returned to v.sting
v.sting collected $2.85 from pot
v.sting: doesn't show hand 
*** SUMMARY ***
Total pot $3 | Rake $0.15 
Board [Jh 5d 9s 2h]
Seat 1: v.sting (small blind) collected ($2.85)
Seat 2: MarsMiland (big blind) folded on the Turn
Seat 3: fool_rabbit folded before Flop (didn't bet)
Seat 5: PleBeY95 folded before Flop (didn't bet)
Seat 6: finstrel folded before Flop (didn't bet)
Seat 7: Medved219 folded before Flop (didn't bet)
Seat 8: StudentRB folded before Flop (didn't bet)
Seat 9: strannikac (button) folded before Flop (didn't bet)



PokerStars Hand #228686278731:  Hold'em No Limit ($0.25/$0.50 USD) - 2021/07/30 15:08:10 ET
Table 'Gorgo III' 9-max Seat #1 is the button
Seat 1: v.sting ($65.47 in chips) 
Seat 2: MarsMiland ($73.90 in chips) 
Seat 4: Xamil666 ($50 in chips) 
Seat 5: PleBeY95 ($56.23 in chips) 
Seat 6: finstrel ($53.36 in chips) 
Seat 7: Medved219 ($57.68 in chips) 
Seat 8: StudentRB ($72.85 in chips) 
Seat 9: strannikac ($94.98 in chips) 
MarsMiland: posts small blind $0.25
fool_rabbit: is sitting out 
Xamil666: posts big blind $0.50
*** HOLE CARDS ***
PleBeY95: folds 
fool_rabbit leaves the table
finstrel: calls $0.50
Medved219: folds 
StudentRB: raises $2 to $2.50
190K joins the table at seat #3 
strannikac: raises $4.50 to $7
v.sting: folds 
MarsMiland: folds 
Xamil666: folds 
finstrel: calls $6.50
StudentRB: folds 
*** FLOP *** [5s Tc 3h]
finstrel: checks 
strannikac: bets $16.39
finstrel: raises $29.97 to $46.36 and is all-in
strannikac: calls $29.97
*** TURN *** [5s Tc 3h] [Ad]
*** RIVER *** [5s Tc 3h Ad] [Ac]
*** SHOW DOWN ***
finstrel: shows [7s 7c] (two pair, Aces and Sevens)
strannikac: shows [Qc Qs] (two pair, Aces and Queens)
strannikac collected $107.97 from pot
*** SUMMARY ***
Total pot $109.97 | Rake $2 
Board [5s Tc 3h Ad Ac]
Seat 1: v.sting (button) folded before Flop (didn't bet)
Seat 2: MarsMiland (small blind) folded before Flop
Seat 4: Xamil666 (big blind) folded before Flop
Seat 5: PleBeY95 folded before Flop (didn't bet)
Seat 6: finstrel showed [7s 7c] and lost with two pair, Aces and Sevens
Seat 7: Medved219 folded before Flop (didn't bet)
Seat 8: StudentRB folded before Flop
Seat 9: strannikac showed [Qc Qs] and won ($107.97) with two pair, Aces and Queens



PokerStars Hand #228686302996:  Hold'em No Limit ($0.25/$0.50 USD) - 2021/07/30 15:09:02 ET
Table 'Gorgo III' 9-max Seat #2 is the button
Seat 1: v.sting ($65.47 in chips) 
Seat 2: MarsMiland ($73.65 in chips) 
Seat 4: Xamil666 ($50 in chips) 
Seat 5: PleBeY95 ($56.23 in chips) 
Seat 7: Medved219 ($57.68 in chips) 
Seat 8: StudentRB ($70.35 in chips) 
Seat 9: strannikac ($149.59 in chips) 
Xamil666: posts small blind $0.25
PleBeY95: posts big blind $0.50
*** HOLE CARDS ***
Medved219: folds 
StudentRB: raises $0.75 to $1.25
strannikac: folds 
v.sting: folds 
MarsMiland: folds 
Xamil666: folds 
PleBeY95: folds 
Uncalled bet ($0.75) returned to StudentRB
StudentRB collected $1.25 from pot
StudentRB: doesn't show hand 
*** SUMMARY ***
Total pot $1.25 | Rake $0 
Seat 1: v.sting folded before Flop (didn't bet)
Seat 2: MarsMiland (button) folded before Flop (didn't bet)
Seat 4: Xamil666 (small blind) folded before Flop
Seat 5: PleBeY95 (big blind) folded before Flop
Seat 7: Medved219 folded before Flop (didn't bet)
Seat 8: StudentRB collected ($1.25)
Seat 9: strannikac folded before Flop (didn't bet)



PokerStars Hand #228686329949:  Hold'em No Limit ($0.25/$0.50 USD) - 2021/07/30 15:10:01 ET
Table 'Gorgo III' 9-max Seat #4 is the button
Seat 1: v.sting ($65.47 in chips) 
Seat 2: MarsMiland ($73.65 in chips) 
Seat 4: Xamil666 ($50 in chips) 
Seat 5: PleBeY95 ($55.73 in chips) 
Seat 6: finstrel ($50 in chips) 
Seat 7: Medved219 ($57.68 in chips) 
Seat 8: StudentRB ($71.10 in chips) 
Seat 9: strannikac ($149.59 in chips) 
PleBeY95: posts small blind $0.25
finstrel: posts big blind $0.50
190K: sits out 
*** HOLE CARDS ***
Medved219: folds 
StudentRB: folds 
strannikac: folds 
v.sting: folds 
MarsMiland: folds 
Xamil666: folds 
PleBeY95: folds 
Uncalled bet ($0.25) returned to finstrel
finstrel collected $0.50 from pot
*** SUMMARY ***
Total pot $0.50 | Rake $0 
Seat 1: v.sting folded before Flop (didn't bet)
Seat 2: MarsMiland folded before Flop (didn't bet)
Seat 4: Xamil666 (button) folded before Flop (didn't bet)
Seat 5: PleBeY95 (small blind) folded before Flop
Seat 6: finstrel (big blind) collected ($0.50)
Seat 7: Medved219 folded before Flop (didn't bet)
Seat 8: StudentRB folded before Flop (didn't bet)
Seat 9: strannikac folded before Flop (didn't bet)



PokerStars Hand #228686338794:  Hold'em No Limit ($0.25/$0.50 USD) - 2021/07/30 15:10:20 ET
Table 'Gorgo III' 9-max Seat #5 is the button
Seat 1: v.sting ($65.47 in chips) 
Seat 2: MarsMiland ($73.65 in chips) 
Seat 4: Xamil666 ($50 in chips) 
Seat 5: PleBeY95 ($55.48 in chips) 
Seat 6: finstrel ($50.25 in chips) 
Seat 7: Medved219 ($57.68 in chips) 
Seat 8: StudentRB ($71.10 in chips) 
Seat 9: strannikac ($149.59 in chips) 
finstrel: posts small blind $0.25
Medved219: posts big blind $0.50
190K: sits out 
*** HOLE CARDS ***
StudentRB: folds 
strannikac: folds 
v.sting: raises $1 to $1.50
MarsMiland: folds 
Xamil666: calls $1.50
PleBeY95: folds 
finstrel: folds 
Medved219: folds 
*** FLOP *** [3c 6d 3d]
v.sting: bets $1.17
Xamil666: folds 
Uncalled bet ($1.17) returned to v.sting
v.sting collected $3.56 from pot
v.sting: doesn't show hand 
*** SUMMARY ***
Total pot $3.75 | Rake $0.19 
Board [3c 6d 3d]
Seat 1: v.sting collected ($3.56)
Seat 2: MarsMiland folded before Flop (didn't bet)
Seat 4: Xamil666 folded on the Flop
Seat 5: PleBeY95 (button) folded before Flop (didn't bet)
Seat 6: finstrel (small blind) folded before Flop
Seat 7: Medved219 (big blind) folded before Flop
Seat 8: StudentRB folded before Flop (didn't bet)
Seat 9: strannikac folded before Flop (didn't bet)



PokerStars Hand #228686364111:  Hold'em No Limit ($0.25/$0.50 USD) - 2021/07/30 15:11:15 ET
Table 'Gorgo III' 9-max Seat #6 is the button
Seat 1: v.sting ($67.53 in chips) 
Seat 2: MarsMiland ($73.65 in chips) 
Seat 4: Xamil666 ($50 in chips) 
Seat 5: PleBeY95 ($55.48 in chips) 
Seat 6: finstrel ($50 in chips) 
Seat 7: Medved219 ($57.18 in chips) 
Seat 8: StudentRB ($71.10 in chips) 
Seat 9: strannikac ($149.59 in chips) 
Medved219: posts small blind $0.25
StudentRB: posts big blind $0.50
190K: sits out 
*** HOLE CARDS ***
strannikac: folds 
v.sting: folds 
MarsMiland: raises $0.80 to $1.30
Xamil666: folds 
PleBeY95: folds 
finstrel: raises $2.20 to $3.50
Medved219: folds 
StudentRB: folds 
MarsMiland: raises $7.50 to $11
finstrel: calls $7.50
*** FLOP *** [Kc 2h 7h]
MarsMiland: bets $7.13
finstrel: calls $7.13
*** TURN *** [Kc 2h 7h] [8s]
MarsMiland: bets $55.52 and is all-in
finstrel: calls $31.87 and is all-in
Uncalled bet ($23.65) returned to MarsMiland
*** RIVER *** [Kc 2h 7h 8s] [Jh]
*** SHOW DOWN ***
MarsMiland: shows [Ah Ac] (a pair of Aces)
finstrel: shows [Kd Td] (a pair of Kings)
MarsMiland collected $98.75 from pot
*** SUMMARY ***
Total pot $100.75 | Rake $2 
Board [Kc 2h 7h 8s Jh]
Seat 1: v.sting folded before Flop (didn't bet)
Seat 2: MarsMiland showed [Ah Ac] and won ($98.75) with a pair of Aces
Seat 4: Xamil666 folded before Flop (didn't bet)
Seat 5: PleBeY95 folded before Flop (didn't bet)
Seat 6: finstrel (button) showed [Kd Td] and lost with a pair of Kings
Seat 7: Medved219 (small blind) folded before Flop
Seat 8: StudentRB (big blind) folded before Flop
Seat 9: strannikac folded before Flop (didn't bet)



PokerStars Hand #228686407431:  Hold'em No Limit ($0.25/$0.50 USD) - 2021/07/30 15:12:48 ET
Table 'Gorgo III' 9-max Seat #7 is the button
Seat 1: v.sting ($67.53 in chips) 
Seat 2: MarsMiland ($122.40 in chips) 
Seat 4: Xamil666 ($50 in chips) 
Seat 5: PleBeY95 ($55.48 in chips) 
Seat 7: Medved219 ($56.93 in chips) 
Seat 8: StudentRB ($70.60 in chips) 
StudentRB: posts small blind $0.25
strannikac: is sitting out 
v.sting: posts big blind $0.50
190K: sits out 
*** HOLE CARDS ***
MarsMiland: folds 
strannikac leaves the table
Xamil666: raises $0.75 to $1.25
PleBeY95: raises $3.25 to $4.50
Medved219: folds 
StudentRB: folds 
v.sting: folds 
Xamil666: folds 
Uncalled bet ($3.25) returned to PleBeY95
PleBeY95 collected $3.25 from pot
*** SUMMARY ***
Total pot $3.25 | Rake $0 
Seat 1: v.sting (big blind) folded before Flop
Seat 2: MarsMiland folded before Flop (didn't bet)
Seat 4: Xamil666 folded before Flop
Seat 5: PleBeY95 collected ($3.25)
Seat 7: Medved219 (button) folded before Flop (didn't bet)
Seat 8: StudentRB (small blind) folded before Flop



PokerStars Hand #228686417421:  Hold'em No Limit ($0.25/$0.50 USD) - 2021/07/30 15:13:10 ET
Table 'Gorgo III' 9-max Seat #8 is the button
Seat 1: v.sting ($67.03 in chips) 
Seat 2: MarsMiland ($122.40 in chips) 
Seat 4: Xamil666 ($50 in chips) 
Seat 5: PleBeY95 ($57.48 in chips) 
Seat 7: Medved219 ($56.93 in chips) 
Seat 8: StudentRB ($70.35 in chips) 
v.sting: posts small blind $0.25
MarsMiland: posts big blind $0.50
190K: sits out 
*** HOLE CARDS ***
Xamil666: folds 
PleBeY95: folds 
Medved219: folds 
StudentRB: raises $0.75 to $1.25
finstrel leaves the table
v.sting: raises $3.25 to $4.50
MarsMiland: folds 
PleBeY95 leaves the table
StudentRB: raises $6.50 to $11
190K leaves the table
v.sting: folds 
Uncalled bet ($6.50) returned to StudentRB
StudentRB collected $9.50 from pot
StudentRB: doesn't show hand 
*** SUMMARY ***
Total pot $9.50 | Rake $0 
Seat 1: v.sting (small blind) folded before Flop
Seat 2: MarsMiland (big blind) folded before Flop
Seat 4: Xamil666 folded before Flop (didn't bet)
Seat 5: PleBeY95 folded before Flop (didn't bet)
Seat 7: Medved219 folded before Flop (didn't bet)
Seat 8: StudentRB (button) collected ($9.50)



PokerStars Hand #228686452807:  Hold'em No Limit ($0.25/$0.50 USD) - 2021/07/30 15:14:09 ET
Table 'Gorgo III' 9-max Seat #1 is the button
Seat 1: v.sting ($62.53 in chips) 
Seat 2: MarsMiland ($121.90 in chips) 
Seat 4: Xamil666 ($50 in chips) 
Seat 7: Medved219 ($56.93 in chips) 
Seat 8: StudentRB ($75.35 in chips) 
MarsMiland: posts small blind $0.25
Xamil666: posts big blind $0.50
*** HOLE CARDS ***
Medved219: folds 
StudentRB: folds 
v.sting: raises $0.60 to $1.10
MarsMiland: folds 
Xamil666: raises $3.40 to $4.50
v.sting: folds 
Uncalled bet ($3.40) returned to Xamil666
Xamil666 collected $2.45 from pot
*** SUMMARY ***
Total pot $2.45 | Rake $0 
Seat 1: v.sting (button) folded before Flop
Seat 2: MarsMiland (small blind) folded before Flop
Seat 4: Xamil666 (big blind) collected ($2.45)
Seat 7: Medved219 folded before Flop (didn't bet)
Seat 8: StudentRB folded before Flop (didn't bet)



PokerStars Hand #228686623455:  Hold'em No Limit ($0.25/$0.50 USD) - 2021/07/30 15:19:54 ET
Table 'Gorgo III' 9-max Seat #2 is the button
Seat 1: Timme54 ($50 in chips) 
Seat 2: Rulet345 ($50 in chips) 
Seat 3: StudentRB ($75.35 in chips) 
Seat 4: Tigerrr777 ($50 in chips) 
Seat 5: akbloger ($50 in chips) 
StudentRB: posts small blind $0.25
Tigerrr777: posts big blind $0.50
*** HOLE CARDS ***
akbloger: folds 
Timme54: raises $0.50 to $1
Rulet345: folds 
StudentRB: folds 
Tigerrr777: raises $4.75 to $5.75
Timme54: folds 
Uncalled bet ($4.75) returned to Tigerrr777
Tigerrr777 collected $2.25 from pot
Tigerrr777: doesn't show hand 
*** SUMMARY ***
Total pot $2.25 | Rake $0 
Seat 1: Timme54 folded before Flop
Seat 2: Rulet345 (button) folded before Flop (didn't bet)
Seat 3: StudentRB (small blind) folded before Flop
Seat 4: Tigerrr777 (big blind) collected ($2.25)
Seat 5: akbloger folded before Flop (didn't bet)



PokerStars Hand #228686634710:  Hold'em No Limit ($0.25/$0.50 USD) - 2021/07/30 15:20:18 ET
Table 'Gorgo III' 9-max Seat #3 is the button
Seat 1: Timme54 ($49 in chips) 
Seat 2: Rulet345 ($50 in chips) 
Seat 3: StudentRB ($75.10 in chips) 
Seat 4: Tigerrr777 ($51.25 in chips) 
Seat 5: akbloger ($50 in chips) 
Tigerrr777: posts small blind $0.25
akbloger: posts big blind $0.50
*** HOLE CARDS ***
danthaur joins the table at seat #6 
Timme54: folds 
Rulet345: folds 
StudentRB: folds 
Tigerrr777: folds 
Uncalled bet ($0.25) returned to akbloger
akbloger collected $0.50 from pot
akbloger: doesn't show hand 
*** SUMMARY ***
Total pot $0.50 | Rake $0 
Seat 1: Timme54 folded before Flop (didn't bet)
Seat 2: Rulet345 folded before Flop (didn't bet)
Seat 3: StudentRB (button) folded before Flop (didn't bet)
Seat 4: Tigerrr777 (small blind) folded before Flop
Seat 5: akbloger (big blind) collected ($0.50)



PokerStars Hand #228686637637:  Hold'em No Limit ($0.25/$0.50 USD) - 2021/07/30 15:20:24 ET
Table 'Gorgo III' 9-max Seat #4 is the button
Seat 1: Timme54 ($49 in chips) 
Seat 2: Rulet345 ($50 in chips) 
Seat 3: StudentRB ($75.10 in chips) 
Seat 4: Tigerrr777 ($51 in chips) 
Seat 5: akbloger ($50.25 in chips) 
Seat 6: danthaur ($50 in chips) 
akbloger: posts small blind $0.25
danthaur: posts big blind $0.50
*** HOLE CARDS ***
Timme54: folds 
Rulet345: folds 
StudentRB: folds 
Tigerrr777: raises $0.75 to $1.25
akbloger: folds 
danthaur: folds 
Uncalled bet ($0.75) returned to Tigerrr777
Tigerrr777 collected $1.25 from pot
Tigerrr777: doesn't show hand 
*** SUMMARY ***
Total pot $1.25 | Rake $0 
Seat 1: Timme54 folded before Flop (didn't bet)
Seat 2: Rulet345 folded before Flop (didn't bet)
Seat 3: StudentRB folded before Flop (didn't bet)
Seat 4: Tigerrr777 (button) collected ($1.25)
Seat 5: akbloger (small blind) folded before Flop
Seat 6: danthaur (big blind) folded before Flop



PokerStars Hand #228686644622:  Hold'em No Limit ($0.25/$0.50 USD) - 2021/07/30 15:20:39 ET
Table 'Gorgo III' 9-max Seat #5 is the button
Seat 1: Timme54 ($49 in chips) 
Seat 2: Rulet345 ($50 in chips) 
Seat 3: StudentRB ($75.10 in chips) 
Seat 4: Tigerrr777 ($51.75 in chips) 
Seat 5: akbloger ($50 in chips) 
Seat 6: danthaur ($50 in chips) 
danthaur: posts small blind $0.25
Timme54: posts big blind $0.50
*** HOLE CARDS ***
Rulet345: folds 
StudentRB: raises $1 to $1.50
Tigerrr777: folds 
akbloger: folds 
danthaur: folds 
Rennvogel joins the table at seat #7 
Timme54: calls $1
*** FLOP *** [3s Qc 3d]
aksh3n joins the table at seat #8 
Timme54: checks 
StudentRB: bets $1.02
fragonik joins the table at seat #9 
Timme54: raises $1.02 to $2.04
StudentRB: folds 
Uncalled bet ($1.02) returned to Timme54
Timme54 collected $4.97 from pot
Timme54: doesn't show hand 
*** SUMMARY ***
Total pot $5.29 | Rake $0.32 
Board [3s Qc 3d]
Seat 1: Timme54 (big blind) collected ($4.97)
Seat 2: Rulet345 folded before Flop (didn't bet)
Seat 3: StudentRB folded on the Flop
Seat 4: Tigerrr777 folded before Flop (didn't bet)
Seat 5: akbloger (button) folded before Flop (didn't bet)
Seat 6: danthaur (small blind) folded before Flop



PokerStars Hand #228686662142:  Hold'em No Limit ($0.25/$0.50 USD) - 2021/07/30 15:21:17 ET
Table 'Gorgo III' 9-max Seat #6 is the button
Seat 1: Timme54 ($51.45 in chips) 
Seat 2: Rulet345 ($50 in chips) 
Seat 3: StudentRB ($72.58 in chips) 
Seat 4: Tigerrr777 ($51.75 in chips) 
Seat 5: akbloger ($50 in chips) 
Seat 6: danthaur ($50 in chips) 
Timme54: posts small blind $0.25
Rulet345: posts big blind $0.50
*** HOLE CARDS ***
StudentRB: folds 
Tigerrr777: folds 
akbloger: raises $0.75 to $1.25
danthaur: folds 
Timme54: calls $1
Rulet345: folds 
*** FLOP *** [Ks 2h Ts]
Timme54: checks 
akbloger: bets $1.54
Timme54: folds 
Uncalled bet ($1.54) returned to akbloger
akbloger collected $2.85 from pot
akbloger: doesn't show hand 
*** SUMMARY ***
Total pot $3 | Rake $0.15 
Board [Ks 2h Ts]
Seat 1: Timme54 (small blind) folded on the Flop
Seat 2: Rulet345 (big blind) folded before Flop
Seat 3: StudentRB folded before Flop (didn't bet)
Seat 4: Tigerrr777 folded before Flop (didn't bet)
Seat 5: akbloger collected ($2.85)
Seat 6: danthaur (button) folded before Flop (didn't bet)



PokerStars Hand #228686673710:  Hold'em No Limit ($0.25/$0.50 USD) - 2021/07/30 15:21:42 ET
Table 'Gorgo III' 9-max Seat #1 is the button
Seat 1: Timme54 ($50.20 in chips) 
Seat 2: Rulet345 ($50 in chips) 
Seat 3: StudentRB ($72.58 in chips) 
Seat 4: Tigerrr777 ($51.75 in chips) 
Seat 5: akbloger ($51.60 in chips) 
Seat 6: danthaur ($50 in chips) 
Rulet345: posts small blind $0.25
StudentRB: posts big blind $0.50
Rennvogel: sits out 
aksh3n: sits out 
fragonik: sits out 
*** HOLE CARDS ***
Tigerrr777: folds 
akbloger: folds 
danthaur: folds 
Timme54: folds 
Rulet345: folds 
Uncalled bet ($0.25) returned to StudentRB
StudentRB collected $0.50 from pot
StudentRB: doesn't show hand 
*** SUMMARY ***
Total pot $0.50 | Rake $0 
Seat 1: Timme54 (button) folded before Flop (didn't bet)
Seat 2: Rulet345 (small blind) folded before Flop
Seat 3: StudentRB (big blind) collected ($0.50)
Seat 4: Tigerrr777 folded before Flop (didn't bet)
Seat 5: akbloger folded before Flop (didn't bet)
Seat 6: danthaur folded before Flop (didn't bet)



PokerStars Hand #228686676994:  Hold'em No Limit ($0.25/$0.50 USD) - 2021/07/30 15:21:49 ET
Table 'Gorgo III' 9-max Seat #2 is the button
Seat 1: Timme54 ($50.20 in chips) 
Seat 2: Rulet345 ($50 in chips) 
Seat 3: StudentRB ($72.83 in chips) 
Seat 4: Tigerrr777 ($51.75 in chips) 
Seat 5: akbloger ($51.60 in chips) 
Seat 6: danthaur ($50 in chips) 
StudentRB: posts small blind $0.25
Tigerrr777: posts big blind $0.50
Rennvogel: sits out 
aksh3n: sits out 
fragonik: sits out 
*** HOLE CARDS ***
akbloger: raises $0.75 to $1.25
danthaur: folds 
Timme54: folds 
Rulet345: folds 
StudentRB: folds 
Tigerrr777: folds 
Uncalled bet ($0.75) returned to akbloger
akbloger collected $1.25 from pot
akbloger: doesn't show hand 
*** SUMMARY ***
Total pot $1.25 | Rake $0 
Seat 1: Timme54 folded before Flop (didn't bet)
Seat 2: Rulet345 (button) folded before Flop (didn't bet)
Seat 3: StudentRB (small blind) folded before Flop
Seat 4: Tigerrr777 (big blind) folded before Flop
Seat 5: akbloger collected ($1.25)
Seat 6: danthaur folded before Flop (didn't bet)



PokerStars Hand #228686681474:  Hold'em No Limit ($0.25/$0.50 USD) - 2021/07/30 15:21:58 ET
Table 'Gorgo III' 9-max Seat #3 is the button
Seat 1: Timme54 ($50.20 in chips) 
Seat 2: Rulet345 ($50 in chips) 
Seat 3: StudentRB ($72.58 in chips) 
Seat 4: Tigerrr777 ($51.25 in chips) 
Seat 6: danthaur ($50 in chips) 
Tigerrr777: posts small blind $0.25
akbloger: is sitting out 
danthaur: posts big blind $0.50
Rennvogel: sits out 
aksh3n: sits out 
fragonik: sits out 
*** HOLE CARDS ***
Timme54: folds 
akbloger leaves the table
Rulet345: raises $0.75 to $1.25
StudentRB: folds 
Tigerrr777: folds 
danthaur: folds 
Uncalled bet ($0.75) returned to Rulet345
Rulet345 collected $1.25 from pot
Rulet345: doesn't show hand 
*** SUMMARY ***
Total pot $1.25 | Rake $0 
Seat 1: Timme54 folded before Flop (didn't bet)
Seat 2: Rulet345 collected ($1.25)
Seat 3: StudentRB (button) folded before Flop (didn't bet)
Seat 4: Tigerrr777 (small blind) folded before Flop
Seat 6: danthaur (big blind) folded before Flop



PokerStars Hand #228686685651:  Hold'em No Limit ($0.25/$0.50 USD) - 2021/07/30 15:22:07 ET
Table 'Gorgo III' 9-max Seat #4 is the button
Seat 1: Timme54 ($50.20 in chips) 
Seat 2: Rulet345 ($50.75 in chips) 
Seat 3: StudentRB ($72.58 in chips) 
Seat 4: Tigerrr777 ($51 in chips) 
Seat 6: danthaur ($50 in chips) 
Seat 7: Rennvogel ($39.77 in chips) 
danthaur: posts small blind $0.25
Rennvogel: posts big blind $0.50
aksh3n: sits out 
fragonik: sits out 
*** HOLE CARDS ***
Timme54: folds 
Rulet345: folds 
StudentRB: folds 
Tigerrr777: raises $0.75 to $1.25
danthaur: folds 
Rennvogel: folds 
Uncalled bet ($0.75) returned to Tigerrr777
Tigerrr777 collected $1.25 from pot
Tigerrr777: doesn't show hand 
*** SUMMARY ***
Total pot $1.25 | Rake $0 
Seat 1: Timme54 folded before Flop (didn't bet)
Seat 2: Rulet345 folded before Flop (didn't bet)
Seat 3: StudentRB folded before Flop (didn't bet)
Seat 4: Tigerrr777 (button) collected ($1.25)
Seat 6: danthaur (small blind) folded before Flop
Seat 7: Rennvogel (big blind) folded before Flop



PokerStars Hand #228686690393:  Hold'em No Limit ($0.25/$0.50 USD) - 2021/07/30 15:22:18 ET
Table 'Gorgo III' 9-max Seat #6 is the button
Seat 1: Timme54 ($50.20 in chips) 
Seat 2: Rulet345 ($50.75 in chips) 
Seat 3: StudentRB ($72.58 in chips) 
Seat 4: Tigerrr777 ($51.75 in chips) 
Seat 6: danthaur ($50 in chips) 
Seat 7: Rennvogel ($39.27 in chips) 
Seat 8: aksh3n ($50 in chips) 
Rennvogel: posts small blind $0.25
aksh3n: posts big blind $0.50
fragonik: sits out 
*** HOLE CARDS ***
Timme54: calls $0.50
Rulet345: folds 
StudentRB: folds 
Tigerrr777: folds 
danthaur: folds 
Rennvogel: folds 
Xamil666 joins the table at seat #5 
aksh3n: checks 
*** FLOP *** [Kc Jd 4d]
aksh3n: checks 
Timme54: bets $1.19
aksh3n: folds 
Uncalled bet ($1.19) returned to Timme54
Timme54 collected $1.17 from pot
Timme54: doesn't show hand 
*** SUMMARY ***
Total pot $1.25 | Rake $0.08 
Board [Kc Jd 4d]
Seat 1: Timme54 collected ($1.17)
Seat 2: Rulet345 folded before Flop (didn't bet)
Seat 3: StudentRB folded before Flop (didn't bet)
Seat 4: Tigerrr777 folded before Flop (didn't bet)
Seat 6: danthaur (button) folded before Flop (didn't bet)
Seat 7: Rennvogel (small blind) folded before Flop
Seat 8: aksh3n (big blind) folded on the Flop



PokerStars Hand #228686701448:  Hold'em No Limit ($0.25/$0.50 USD) - 2021/07/30 15:22:41 ET
Table 'Gorgo III' 9-max Seat #7 is the button
Seat 1: Timme54 ($50.87 in chips) 
Seat 2: Rulet345 ($50.75 in chips) 
Seat 3: StudentRB ($72.58 in chips) 
Seat 4: Tigerrr777 ($51.75 in chips) 
Seat 6: danthaur ($50 in chips) 
Seat 7: Rennvogel ($39.02 in chips) 
Seat 8: aksh3n ($50 in chips) 
Seat 9: fragonik ($50 in chips) 
aksh3n: posts small blind $0.25
fragonik: posts big blind $0.50
Xamil666: sits out 
*** HOLE CARDS ***
Timme54: calls $0.50
Rulet345: folds 
StudentRB: folds 
Tigerrr777: folds 
danthaur: folds 
Rennvogel: calls $0.50
aksh3n: folds 
fragonik: checks 
*** FLOP *** [Jc Ts Qs]
fragonik: bets $0.81
Timme54: folds 
Rennvogel: calls $0.81
*** TURN *** [Jc Ts Qs] [Ah]
fragonik: checks 
Rennvogel: checks 
*** RIVER *** [Jc Ts Qs Ah] [7h]
fragonik: bets $0.75
Rennvogel: calls $0.75
*** SHOW DOWN ***
fragonik: shows [6c Qh] (a pair of Queens)
Rennvogel: mucks hand 
fragonik collected $4.63 from pot
*** SUMMARY ***
Total pot $4.87 | Rake $0.24 
Board [Jc Ts Qs Ah 7h]
Seat 1: Timme54 folded on the Flop
Seat 2: Rulet345 folded before Flop (didn't bet)
Seat 3: StudentRB folded before Flop (didn't bet)
Seat 4: Tigerrr777 folded before Flop (didn't bet)
Seat 6: danthaur folded before Flop (didn't bet)
Seat 7: Rennvogel (button) mucked
Seat 8: aksh3n (small blind) folded before Flop
Seat 9: fragonik (big blind) showed [6c Qh] and won ($4.63) with a pair of Queens



PokerStars Hand #228686727252:  Hold'em No Limit ($0.25/$0.50 USD) - 2021/07/30 15:23:37 ET
Table 'Gorgo III' 9-max Seat #8 is the button
Seat 1: Timme54 ($50.37 in chips) 
Seat 2: Rulet345 ($50.75 in chips) 
Seat 3: StudentRB ($72.58 in chips) 
Seat 4: Tigerrr777 ($51.75 in chips) 
Seat 6: danthaur ($50 in chips) 
Seat 7: Rennvogel ($36.96 in chips) 
Seat 8: aksh3n ($50 in chips) 
Seat 9: fragonik ($52.57 in chips) 
fragonik: posts small blind $0.25
Timme54: posts big blind $0.50
Xamil666: sits out 
*** HOLE CARDS ***
Rulet345: folds 
StudentRB: folds 
Tigerrr777: folds 
danthaur: folds 
Rennvogel: folds 
aksh3n: raises $0.60 to $1.10
fragonik: folds 
Timme54: calls $0.60
*** FLOP *** [2d 8h 9d]
Timme54: checks 
aksh3n: checks 
*** TURN *** [2d 8h 9d] [4d]
Timme54: bets $2.33
aksh3n: folds 
Uncalled bet ($2.33) returned to Timme54
Timme54 collected $2.30 from pot
Timme54: doesn't show hand 
*** SUMMARY ***
Total pot $2.45 | Rake $0.15 
Board [2d 8h 9d 4d]
Seat 1: Timme54 (big blind) collected ($2.30)
Seat 2: Rulet345 folded before Flop (didn't bet)
Seat 3: StudentRB folded before Flop (didn't bet)
Seat 4: Tigerrr777 folded before Flop (didn't bet)
Seat 6: danthaur folded before Flop (didn't bet)
Seat 7: Rennvogel folded before Flop (didn't bet)
Seat 8: aksh3n (button) folded on the Turn
Seat 9: fragonik (small blind) folded before Flop



PokerStars Hand #228686745744:  Hold'em No Limit ($0.25/$0.50 USD) - 2021/07/30 15:24:17 ET
Table 'Gorgo III' 9-max Seat #9 is the button
Seat 1: Timme54 ($51.57 in chips) 
Seat 2: Rulet345 ($50.75 in chips) 
Seat 3: StudentRB ($72.58 in chips) 
Seat 4: Tigerrr777 ($51.75 in chips) 
Seat 6: danthaur ($50 in chips) 
Seat 7: Rennvogel ($36.96 in chips) 
Seat 8: aksh3n ($50 in chips) 
Seat 9: fragonik ($52.32 in chips) 
Timme54: posts small blind $0.25
Rulet345: posts big blind $0.50
Xamil666: sits out 
*** HOLE CARDS ***
StudentRB: folds 
Tigerrr777: folds 
danthaur: folds 
Rennvogel: folds 
aksh3n: folds 
fragonik: folds 
Timme54: folds 
Uncalled bet ($0.25) returned to Rulet345
Rulet345 collected $0.50 from pot
Rulet345: doesn't show hand 
*** SUMMARY ***
Total pot $0.50 | Rake $0 
Seat 1: Timme54 (small blind) folded before Flop
Seat 2: Rulet345 (big blind) collected ($0.50)
Seat 3: StudentRB folded before Flop (didn't bet)
Seat 4: Tigerrr777 folded before Flop (didn't bet)
Seat 6: danthaur folded before Flop (didn't bet)
Seat 7: Rennvogel folded before Flop (didn't bet)
Seat 8: aksh3n folded before Flop (didn't bet)
Seat 9: fragonik (button) folded before Flop (didn't bet)



PokerStars Hand #228686753226:  Hold'em No Limit ($0.25/$0.50 USD) - 2021/07/30 15:24:33 ET
Table 'Gorgo III' 9-max Seat #1 is the button
Seat 1: Timme54 ($51.32 in chips) 
Seat 2: Rulet345 ($51 in chips) 
Seat 3: StudentRB ($72.58 in chips) 
Seat 4: Tigerrr777 ($51.75 in chips) 
Seat 6: danthaur ($50 in chips) 
Seat 7: Rennvogel ($36.96 in chips) 
Seat 8: aksh3n ($50 in chips) 
Seat 9: fragonik ($52.32 in chips) 
Rulet345: posts small blind $0.25
StudentRB: posts big blind $0.50
Xamil666: sits out 
*** HOLE CARDS ***
Tigerrr777: folds 
danthaur: folds 
Rennvogel: folds 
aksh3n: raises $0.60 to $1.10
fragonik: folds 
Timme54: calls $1.10
Rulet345: folds 
StudentRB: folds 
*** FLOP *** [Th 8c 7d]
aksh3n: checks 
Timme54: bets $1.40
aksh3n: folds 
Uncalled bet ($1.40) returned to Timme54
Timme54 collected $2.76 from pot
Timme54: doesn't show hand 
*** SUMMARY ***
Total pot $2.95 | Rake $0.19 
Board [Th 8c 7d]
Seat 1: Timme54 (button) collected ($2.76)
Seat 2: Rulet345 (small blind) folded before Flop
Seat 3: StudentRB (big blind) folded before Flop
Seat 4: Tigerrr777 folded before Flop (didn't bet)
Seat 6: danthaur folded before Flop (didn't bet)
Seat 7: Rennvogel folded before Flop (didn't bet)
Seat 8: aksh3n folded on the Flop
Seat 9: fragonik folded before Flop (didn't bet)



PokerStars Hand #228686764985:  Hold'em No Limit ($0.25/$0.50 USD) - 2021/07/30 15:24:59 ET
Table 'Gorgo III' 9-max Seat #2 is the button
Seat 1: Timme54 ($52.98 in chips) 
Seat 2: Rulet345 ($50.75 in chips) 
Seat 3: StudentRB ($72.08 in chips) 
Seat 5: Xamil666 ($51.35 in chips) 
Seat 6: danthaur ($50 in chips) 
Seat 7: Rennvogel ($36.96 in chips) 
Seat 8: aksh3n ($50 in chips) 
Seat 9: fragonik ($52.32 in chips) 
StudentRB: posts small blind $0.25
Tigerrr777: is sitting out 
Xamil666: posts big blind $0.50
*** HOLE CARDS ***
danthaur: folds 
Rennvogel: folds 
aksh3n: folds 
fragonik: raises $0.75 to $1.25
Timme54: folds 
Rulet345: folds 
StudentRB: raises $4.25 to $5.50
Xamil666: folds 
fragonik: folds 
Uncalled bet ($4.25) returned to StudentRB
StudentRB collected $3 from pot
StudentRB: doesn't show hand 
*** SUMMARY ***
Total pot $3 | Rake $0 
Seat 1: Timme54 folded before Flop (didn't bet)
Seat 2: Rulet345 (button) folded before Flop (didn't bet)
Seat 3: StudentRB (small blind) collected ($3)
Seat 5: Xamil666 (big blind) folded before Flop
Seat 6: danthaur folded before Flop (didn't bet)
Seat 7: Rennvogel folded before Flop (didn't bet)
Seat 8: aksh3n folded before Flop (didn't bet)
Seat 9: fragonik folded before Flop



PokerStars Hand #228686784284:  Hold'em No Limit ($0.25/$0.50 USD) - 2021/07/30 15:25:41 ET
Table 'Gorgo III' 9-max Seat #3 is the button
Seat 1: Timme54 ($52.98 in chips) 
Seat 2: Rulet345 ($50.75 in chips) 
Seat 3: StudentRB ($73.83 in chips) 
Seat 5: Xamil666 ($50.85 in chips) 
Seat 6: danthaur ($50 in chips) 
Seat 7: Rennvogel ($36.96 in chips) 
Seat 8: aksh3n ($50 in chips) 
Seat 9: fragonik ($51.07 in chips) 
Xamil666: posts small blind $0.25
danthaur: posts big blind $0.50
*** HOLE CARDS ***
Rennvogel: raises $0.50 to $1
aksh3n: folds 
fragonik: calls $1
Timme54: folds 
Rulet345: folds 
StudentRB: raises $5 to $6
Xamil666: folds 
danthaur: folds 
Rennvogel: folds 
fragonik: folds 
Uncalled bet ($5) returned to StudentRB
StudentRB collected $3.75 from pot
StudentRB: doesn't show hand 
*** SUMMARY ***
Total pot $3.75 | Rake $0 
Seat 1: Timme54 folded before Flop (didn't bet)
Seat 2: Rulet345 folded before Flop (didn't bet)
Seat 3: StudentRB (button) collected ($3.75)
Seat 5: Xamil666 (small blind) folded before Flop
Seat 6: danthaur (big blind) folded before Flop
Seat 7: Rennvogel folded before Flop
Seat 8: aksh3n folded before Flop (didn't bet)
Seat 9: fragonik folded before Flop



PokerStars Hand #228686799750:  Hold'em No Limit ($0.25/$0.50 USD) - 2021/07/30 15:26:14 ET
Table 'Gorgo III' 9-max Seat #5 is the button
Seat 1: Timme54 ($52.98 in chips) 
Seat 2: Rulet345 ($50.75 in chips) 
Seat 3: StudentRB ($76.58 in chips) 
Seat 5: Xamil666 ($50.60 in chips) 
Seat 6: danthaur ($50 in chips) 
Seat 7: Rennvogel ($35.96 in chips) 
Seat 8: aksh3n ($50 in chips) 
Seat 9: fragonik ($50.07 in chips) 
danthaur: posts small blind $0.25
Rennvogel: posts big blind $0.50
*** HOLE CARDS ***
aksh3n: folds 
fragonik: folds 
Timme54: folds 
Rulet345: folds 
StudentRB: raises $0.75 to $1.25
Xamil666: folds 
danthaur: folds 
Rennvogel: folds 
Uncalled bet ($0.75) returned to StudentRB
StudentRB collected $1.25 from pot
StudentRB: doesn't show hand 
*** SUMMARY ***
Total pot $1.25 | Rake $0 
Seat 1: Timme54 folded before Flop (didn't bet)
Seat 2: Rulet345 folded before Flop (didn't bet)
Seat 3: StudentRB collected ($1.25)
Seat 5: Xamil666 (button) folded before Flop (didn't bet)
Seat 6: danthaur (small blind) folded before Flop
Seat 7: Rennvogel (big blind) folded before Flop
Seat 8: aksh3n folded before Flop (didn't bet)
Seat 9: fragonik folded before Flop (didn't bet)



PokerStars Hand #228686807023:  Hold'em No Limit ($0.25/$0.50 USD) - 2021/07/30 15:26:30 ET
Table 'Gorgo III' 9-max Seat #6 is the button
Seat 1: Timme54 ($52.98 in chips) 
Seat 2: Rulet345 ($50.75 in chips) 
Seat 3: StudentRB ($77.33 in chips) 
Seat 5: Xamil666 ($50.60 in chips) 
Seat 6: danthaur ($50 in chips) 
Seat 7: Rennvogel ($35.46 in chips) 
Seat 8: aksh3n ($50 in chips) 
Seat 9: fragonik ($50.07 in chips) 
Rennvogel: posts small blind $0.25
aksh3n: posts big blind $0.50
*** HOLE CARDS ***
fragonik: folds 
Timme54: calls $0.50
Rulet345: folds 
StudentRB: folds 
Xamil666: folds 
danthaur: folds 
Rennvogel: folds 
aksh3n: checks 
*** FLOP *** [Tc Th 5h]
aksh3n: checks 
Timme54: checks 
*** TURN *** [Tc Th 5h] [3d]
aksh3n: checks 
Timme54: bets $2.19
aksh3n: folds 
Uncalled bet ($2.19) returned to Timme54
Timme54 collected $1.17 from pot
Timme54: doesn't show hand 
*** SUMMARY ***
Total pot $1.25 | Rake $0.08 
Board [Tc Th 5h 3d]
Seat 1: Timme54 collected ($1.17)
Seat 2: Rulet345 folded before Flop (didn't bet)
Seat 3: StudentRB folded before Flop (didn't bet)
Seat 5: Xamil666 folded before Flop (didn't bet)
Seat 6: danthaur (button) folded before Flop (didn't bet)
Seat 7: Rennvogel (small blind) folded before Flop
Seat 8: aksh3n (big blind) folded on the Turn
Seat 9: fragonik folded before Flop (didn't bet)



PokerStars Hand #228686825656:  Hold'em No Limit ($0.25/$0.50 USD) - 2021/07/30 15:27:10 ET
Table 'Gorgo III' 9-max Seat #7 is the button
Seat 1: Timme54 ($53.65 in chips) 
Seat 2: Rulet345 ($50.75 in chips) 
Seat 3: StudentRB ($77.33 in chips) 
Seat 5: Xamil666 ($50.60 in chips) 
Seat 6: danthaur ($50 in chips) 
Seat 7: Rennvogel ($35.21 in chips) 
Seat 8: aksh3n ($50 in chips) 
Seat 9: fragonik ($50.07 in chips) 
aksh3n: posts small blind $0.25
fragonik: posts big blind $0.50
*** HOLE CARDS ***
Timme54: calls $0.50
Rulet345: folds 
StudentRB: folds 
Xamil666: folds 
danthaur: raises $1.50 to $2
Rennvogel: folds 
aksh3n: folds 
fragonik: folds 
Timme54: calls $1.50
*** FLOP *** [7h As 6s]
Timme54: checks 
danthaur: bets $2.48
Timme54: folds 
Uncalled bet ($2.48) returned to danthaur
danthaur collected $4.51 from pot
danthaur: doesn't show hand 
*** SUMMARY ***
Total pot $4.75 | Rake $0.24 
Board [7h As 6s]
Seat 1: Timme54 folded on the Flop
Seat 2: Rulet345 folded before Flop (didn't bet)
Seat 3: StudentRB folded before Flop (didn't bet)
Seat 5: Xamil666 folded before Flop (didn't bet)
Seat 6: danthaur collected ($4.51)
Seat 7: Rennvogel (button) folded before Flop (didn't bet)
Seat 8: aksh3n (small blind) folded before Flop
Seat 9: fragonik (big blind) folded before Flop



PokerStars Hand #228688224771:  Hold'em No Limit ($0.25/$0.50 USD) - 2021/07/30 16:18:04 ET
Table 'Gorgo III' 9-max Seat #1 is the button
Seat 1: gustguaira ($76.08 in chips) 
Seat 2: inflexiblle ($50 in chips) 
Seat 3: Leason22 ($34.75 in chips) 
Seat 4: nicu4you ($50 in chips) 
Seat 5: funker84 ($40 in chips) 
Seat 6: MR.PATJEW ($31.70 in chips) 
Seat 7: sonova ($105.60 in chips) 
inflexiblle: posts small blind $0.25
Leason22: posts big blind $0.50
Lisenok110: sits out 
fragonik: sits out 
*** HOLE CARDS ***
nicu4you: folds 
funker84: folds 
MR.PATJEW has timed out
MR.PATJEW: folds 
sonova: folds 
gustguaira: raises $1 to $1.50
inflexiblle: folds 
Leason22: folds 
Uncalled bet ($1) returned to gustguaira
gustguaira collected $1.25 from pot
gustguaira: doesn't show hand 
*** SUMMARY ***
Total pot $1.25 | Rake $0 
Seat 1: gustguaira (button) collected ($1.25)
Seat 2: inflexiblle (small blind) folded before Flop
Seat 3: Leason22 (big blind) folded before Flop
Seat 4: nicu4you folded before Flop (didn't bet)
Seat 5: funker84 folded before Flop (didn't bet)
Seat 6: MR.PATJEW folded before Flop (didn't bet)
Seat 7: sonova folded before Flop (didn't bet)



PokerStars Hand #228686846095:  Hold'em No Limit ($0.25/$0.50 USD) - 2021/07/30 15:27:55 ET
Table 'Gorgo III' 9-max Seat #8 is the button
Seat 1: Timme54 ($51.65 in chips) 
Seat 2: Rulet345 ($50.75 in chips) 
Seat 3: StudentRB ($77.33 in chips) 
Seat 5: Xamil666 ($50.60 in chips) 
Seat 6: danthaur ($52.51 in chips) 
Seat 7: Rennvogel ($35.21 in chips) 
Seat 8: aksh3n ($50 in chips) 
Seat 9: fragonik ($50 in chips) 
fragonik: posts small blind $0.25
Timme54: posts big blind $0.50
*** HOLE CARDS ***
Rulet345: folds 
StudentRB: folds 
Xamil666: folds 
danthaur: folds 
Rennvogel: folds 
aksh3n: raises $0.60 to $1.10
fragonik: raises $3.15 to $4.25
Timme54: calls $3.75
aksh3n: folds 
*** FLOP *** [5h 3h Ts]
fragonik: bets $3.01
Timme54: folds 
Uncalled bet ($3.01) returned to fragonik
fragonik collected $9.12 from pot
*** SUMMARY ***
Total pot $9.60 | Rake $0.48 
Board [5h 3h Ts]
Seat 1: Timme54 (big blind) folded on the Flop
Seat 2: Rulet345 folded before Flop (didn't bet)
Seat 3: StudentRB folded before Flop (didn't bet)
Seat 5: Xamil666 folded before Flop (didn't bet)
Seat 6: danthaur folded before Flop (didn't bet)
Seat 7: Rennvogel folded before Flop (didn't bet)
Seat 8: aksh3n (button) folded before Flop
Seat 9: fragonik (small blind) collected ($9.12)



PokerStars Hand #228686874260:  Hold'em No Limit ($0.25/$0.50 USD) - 2021/07/30 15:28:56 ET
Table 'Gorgo III' 9-max Seat #9 is the button
Seat 1: Timme54 ($47.40 in chips) 
Seat 2: Rulet345 ($50.75 in chips) 
Seat 3: StudentRB ($77.33 in chips) 
Seat 5: Xamil666 ($50.60 in chips) 
Seat 6: danthaur ($52.51 in chips) 
Seat 7: Rennvogel ($35.21 in chips) 
Seat 8: aksh3n ($50 in chips) 
Seat 9: fragonik ($54.87 in chips) 
Timme54: posts small blind $0.25
Rulet345: posts big blind $0.50
Tigerrr777: sits out 
*** HOLE CARDS ***
StudentRB: folds 
Xamil666: folds 
danthaur: folds 
Rennvogel: folds 
aksh3n: raises $0.60 to $1.10
fragonik: folds 
Timme54: calls $0.85
Rulet345: folds 
*** FLOP *** [Jh Ad 7h]
Timme54: checks 
aksh3n: checks 
*** TURN *** [Jh Ad 7h] [Kh]
Timme54: checks 
aksh3n: checks 
*** RIVER *** [Jh Ad 7h Kh] [7s]
Timme54: checks 
aksh3n: bets $1.92
Timme54: folds 
Uncalled bet ($1.92) returned to aksh3n
aksh3n collected $2.56 from pot
aksh3n: doesn't show hand 
*** SUMMARY ***
Total pot $2.70 | Rake $0.14 
Board [Jh Ad 7h Kh 7s]
Seat 1: Timme54 (small blind) folded on the River
Seat 2: Rulet345 (big blind) folded before Flop
Seat 3: StudentRB folded before Flop (didn't bet)
Seat 5: Xamil666 folded before Flop (didn't bet)
Seat 6: danthaur folded before Flop (didn't bet)
Seat 7: Rennvogel folded before Flop (didn't bet)
Seat 8: aksh3n collected ($2.56)
Seat 9: fragonik (button) folded before Flop (didn't bet)



PokerStars Hand #228686894567:  Hold'em No Limit ($0.25/$0.50 USD) - 2021/07/30 15:29:40 ET
Table 'Gorgo III' 9-max Seat #1 is the button
Seat 1: Timme54 ($46.30 in chips) 
Seat 2: Rulet345 ($50.25 in chips) 
Seat 3: StudentRB ($77.33 in chips) 
Seat 5: Xamil666 ($50.60 in chips) 
Seat 6: danthaur ($52.51 in chips) 
Seat 7: Rennvogel ($35.21 in chips) 
Seat 8: aksh3n ($51.46 in chips) 
Seat 9: fragonik ($54.87 in chips) 
Rulet345: posts small blind $0.25
StudentRB: posts big blind $0.50
Tigerrr777: sits out 
*** HOLE CARDS ***
Xamil666: raises $1 to $1.50
danthaur: folds 
Rennvogel: folds 
aksh3n: folds 
fragonik: folds 
Timme54: folds 
Rulet345: folds 
StudentRB: folds 
Uncalled bet ($1) returned to Xamil666
Xamil666 collected $1.25 from pot
*** SUMMARY ***
Total pot $1.25 | Rake $0 
Seat 1: Timme54 (button) folded before Flop (didn't bet)
Seat 2: Rulet345 (small blind) folded before Flop
Seat 3: StudentRB (big blind) folded before Flop
Seat 5: Xamil666 collected ($1.25)
Seat 6: danthaur folded before Flop (didn't bet)
Seat 7: Rennvogel folded before Flop (didn't bet)
Seat 8: aksh3n folded before Flop (didn't bet)
Seat 9: fragonik folded before Flop (didn't bet)



PokerStars Hand #228686902247:  Hold'em No Limit ($0.25/$0.50 USD) - 2021/07/30 15:29:57 ET
Table 'Gorgo III' 9-max Seat #2 is the button
Seat 1: Timme54 ($46.30 in chips) 
Seat 2: Rulet345 ($50 in chips) 
Seat 3: StudentRB ($76.83 in chips) 
Seat 4: Tigerrr777 ($51.75 in chips) 
Seat 5: Xamil666 ($51.35 in chips) 
Seat 6: danthaur ($52.51 in chips) 
Seat 7: Rennvogel ($35.21 in chips) 
Seat 8: aksh3n ($51.46 in chips) 
Seat 9: fragonik ($54.87 in chips) 
StudentRB: posts small blind $0.25
Tigerrr777: posts big blind $0.50
*** HOLE CARDS ***
Xamil666: folds 
danthaur: raises $1 to $1.50
Rennvogel: folds 
aksh3n: folds 
fragonik: folds 
Timme54: calls $1.50
Rulet345: folds 
StudentRB: folds 
Tigerrr777: folds 
*** FLOP *** [7h 3h 9s]
danthaur: checks 
Timme54: bets $1.78
danthaur: calls $1.78
*** TURN *** [7h 3h 9s] [Ah]
danthaur: checks 
Timme54: checks 
*** RIVER *** [7h 3h 9s Ah] [9c]
danthaur: checks 
Timme54: bets $2.47
danthaur: folds 
Uncalled bet ($2.47) returned to Timme54
Timme54 collected $6.85 from pot
Timme54: doesn't show hand 
*** SUMMARY ***
Total pot $7.31 | Rake $0.46 
Board [7h 3h 9s Ah 9c]
Seat 1: Timme54 collected ($6.85)
Seat 2: Rulet345 (button) folded before Flop (didn't bet)
Seat 3: StudentRB (small blind) folded before Flop
Seat 4: Tigerrr777 (big blind) folded before Flop
Seat 5: Xamil666 folded before Flop (didn't bet)
Seat 6: danthaur folded on the River
Seat 7: Rennvogel folded before Flop (didn't bet)
Seat 8: aksh3n folded before Flop (didn't bet)
Seat 9: fragonik folded before Flop (didn't bet)



PokerStars Hand #228686953408:  Hold'em No Limit ($0.25/$0.50 USD) - 2021/07/30 15:31:47 ET
Table 'Gorgo III' 9-max Seat #3 is the button
Seat 1: Timme54 ($49.87 in chips) 
Seat 2: Rulet345 ($50 in chips) 
Seat 3: StudentRB ($76.58 in chips) 
Seat 4: Tigerrr777 ($51.25 in chips) 
Seat 5: Xamil666 ($51.35 in chips) 
Seat 6: danthaur ($50 in chips) 
Seat 7: Rennvogel ($35.21 in chips) 
Seat 8: aksh3n ($51.46 in chips) 
Seat 9: fragonik ($54.87 in chips) 
Tigerrr777: posts small blind $0.25
Xamil666: posts big blind $0.50
*** HOLE CARDS ***
danthaur: folds 
Rennvogel: folds 
aksh3n: folds 
fragonik: folds 
Timme54: calls $0.50
Rulet345: folds 
StudentRB: raises $1.50 to $2
Tigerrr777: folds 
Xamil666: folds 
Timme54: calls $1.50
*** FLOP *** [5s 5d 3c]
Timme54: checks 
StudentRB: bets $1.49
Timme54: raises $1.49 to $2.98
StudentRB: folds 
Uncalled bet ($1.49) returned to Timme54
Timme54 collected $7.24 from pot
Timme54: doesn't show hand 
*** SUMMARY ***
Total pot $7.73 | Rake $0.49 
Board [5s 5d 3c]
Seat 1: Timme54 collected ($7.24)
Seat 2: Rulet345 folded before Flop (didn't bet)
Seat 3: StudentRB (button) folded on the Flop
Seat 4: Tigerrr777 (small blind) folded before Flop
Seat 5: Xamil666 (big blind) folded before Flop
Seat 6: danthaur folded before Flop (didn't bet)
Seat 7: Rennvogel folded before Flop (didn't bet)
Seat 8: aksh3n folded before Flop (didn't bet)
Seat 9: fragonik folded before Flop (didn't bet)



PokerStars Hand #228686976390:  Hold'em No Limit ($0.25/$0.50 USD) - 2021/07/30 15:32:36 ET
Table 'Gorgo III' 9-max Seat #4 is the button
Seat 1: Timme54 ($53.62 in chips) 
Seat 2: Rulet345 ($50 in chips) 
Seat 3: StudentRB ($73.09 in chips) 
Seat 4: Tigerrr777 ($51 in chips) 
Seat 5: Xamil666 ($50.85 in chips) 
Seat 6: danthaur ($50 in chips) 
Seat 7: Rennvogel ($35.21 in chips) 
Seat 8: aksh3n ($51.46 in chips) 
Seat 9: fragonik ($54.87 in chips) 
Xamil666: posts small blind $0.25
danthaur: posts big blind $0.50
*** HOLE CARDS ***
Rennvogel: folds 
aksh3n: folds 
fragonik: folds 
Timme54: calls $0.50
Rulet345: folds 
StudentRB: folds 
Tigerrr777: folds 
Xamil666: raises $1.50 to $2
danthaur: folds 
Timme54: folds 
Uncalled bet ($1.50) returned to Xamil666
Xamil666 collected $1.50 from pot
*** SUMMARY ***
Total pot $1.50 | Rake $0 
Seat 1: Timme54 folded before Flop
Seat 2: Rulet345 folded before Flop (didn't bet)
Seat 3: StudentRB folded before Flop (didn't bet)
Seat 4: Tigerrr777 (button) folded before Flop (didn't bet)
Seat 5: Xamil666 (small blind) collected ($1.50)
Seat 6: danthaur (big blind) folded before Flop
Seat 7: Rennvogel folded before Flop (didn't bet)
Seat 8: aksh3n folded before Flop (didn't bet)
Seat 9: fragonik folded before Flop (didn't bet)



PokerStars Hand #228686987789:  Hold'em No Limit ($0.25/$0.50 USD) - 2021/07/30 15:33:01 ET
Table 'Gorgo III' 9-max Seat #5 is the button
Seat 1: Timme54 ($53.12 in chips) 
Seat 2: Rulet345 ($50 in chips) 
Seat 3: StudentRB ($73.09 in chips) 
Seat 4: Tigerrr777 ($51 in chips) 
Seat 5: Xamil666 ($51.85 in chips) 
Seat 6: danthaur ($50 in chips) 
Seat 7: Rennvogel ($35.21 in chips) 
Seat 8: aksh3n ($51.46 in chips) 
Seat 9: fragonik ($54.87 in chips) 
danthaur: posts small blind $0.25
Rennvogel: posts big blind $0.50
*** HOLE CARDS ***
aksh3n: folds 
fragonik: folds 
Timme54: calls $0.50
Rulet345: folds 
StudentRB: folds 
Tigerrr777: folds 
Xamil666: folds 
danthaur: folds 
Rennvogel: checks 
*** FLOP *** [7s Qh 8d]
Rennvogel: checks 
Timme54: bets $1.69
Rennvogel: calls $1.69
*** TURN *** [7s Qh 8d] [2c]
Rennvogel: checks 
Timme54: bets $2.20
Rennvogel: calls $2.20
*** RIVER *** [7s Qh 8d 2c] [2d]
Rennvogel: checks 
Timme54: checks 
*** SHOW DOWN ***
Rennvogel: shows [Qc 6h] (two pair, Queens and Deuces)
Timme54: mucks hand 
Rennvogel collected $8.47 from pot
*** SUMMARY ***
Total pot $9.03 | Rake $0.56 
Board [7s Qh 8d 2c 2d]
Seat 1: Timme54 mucked
Seat 2: Rulet345 folded before Flop (didn't bet)
Seat 3: StudentRB folded before Flop (didn't bet)
Seat 4: Tigerrr777 folded before Flop (didn't bet)
Seat 5: Xamil666 (button) folded before Flop (didn't bet)
Seat 6: danthaur (small blind) folded before Flop
Seat 7: Rennvogel (big blind) showed [Qc 6h] and won ($8.47) with two pair, Queens and Deuces
Seat 8: aksh3n folded before Flop (didn't bet)
Seat 9: fragonik folded before Flop (didn't bet)



PokerStars Hand #228687010396:  Hold'em No Limit ($0.25/$0.50 USD) - 2021/07/30 15:33:49 ET
Table 'Gorgo III' 9-max Seat #6 is the button
Seat 1: Timme54 ($48.73 in chips) 
Seat 2: Rulet345 ($50 in chips) 
Seat 3: StudentRB ($73.09 in chips) 
Seat 4: Tigerrr777 ($51 in chips) 
Seat 5: Xamil666 ($51.85 in chips) 
Seat 6: danthaur ($50 in chips) 
Seat 7: Rennvogel ($39.29 in chips) 
Seat 8: aksh3n ($51.46 in chips) 
Seat 9: fragonik ($54.87 in chips) 
Rennvogel: posts small blind $0.25
aksh3n: posts big blind $0.50
*** HOLE CARDS ***
fragonik: folds 
Timme54: folds 
Rulet345: folds 
StudentRB: folds 
Tigerrr777: folds 
Xamil666: folds 
danthaur: raises $0.75 to $1.25
Rennvogel: folds 
aksh3n: calls $0.75
*** FLOP *** [Ah 8d Ks]
aksh3n: checks 
danthaur: bets $0.86
aksh3n: calls $0.86
*** TURN *** [Ah 8d Ks] [4d]
aksh3n: checks 
danthaur: bets $3.19
aksh3n: folds 
Uncalled bet ($3.19) returned to danthaur
danthaur collected $4.25 from pot
danthaur: doesn't show hand 
*** SUMMARY ***
Total pot $4.47 | Rake $0.22 
Board [Ah 8d Ks 4d]
Seat 1: Timme54 folded before Flop (didn't bet)
Seat 2: Rulet345 folded before Flop (didn't bet)
Seat 3: StudentRB folded before Flop (didn't bet)
Seat 4: Tigerrr777 folded before Flop (didn't bet)
Seat 5: Xamil666 folded before Flop (didn't bet)
Seat 6: danthaur (button) collected ($4.25)
Seat 7: Rennvogel (small blind) folded before Flop
Seat 8: aksh3n (big blind) folded on the Turn
Seat 9: fragonik folded before Flop (didn't bet)



PokerStars Hand #228687031254:  Hold'em No Limit ($0.25/$0.50 USD) - 2021/07/30 15:34:34 ET
Table 'Gorgo III' 9-max Seat #7 is the button
Seat 1: Timme54 ($48.73 in chips) 
Seat 2: Rulet345 ($50 in chips) 
Seat 3: StudentRB ($73.09 in chips) 
Seat 4: Tigerrr777 ($51 in chips) 
Seat 5: Xamil666 ($51.85 in chips) 
Seat 6: danthaur ($52.14 in chips) 
Seat 7: Rennvogel ($39.04 in chips) 
Seat 8: aksh3n ($50 in chips) 
Seat 9: fragonik ($54.87 in chips) 
aksh3n: posts small blind $0.25
fragonik: posts big blind $0.50
*** HOLE CARDS ***
Timme54: folds 
Rulet345: folds 
StudentRB: folds 
Tigerrr777: folds 
Xamil666: raises $1 to $1.50
danthaur: raises $3 to $4.50
Rennvogel: folds 
aksh3n: folds 
fragonik: folds 
Xamil666: raises $7 to $11.50
danthaur: folds 
Uncalled bet ($7) returned to Xamil666
Xamil666 collected $9.75 from pot
*** SUMMARY ***
Total pot $9.75 | Rake $0 
Seat 1: Timme54 folded before Flop (didn't bet)
Seat 2: Rulet345 folded before Flop (didn't bet)
Seat 3: StudentRB folded before Flop (didn't bet)
Seat 4: Tigerrr777 folded before Flop (didn't bet)
Seat 5: Xamil666 collected ($9.75)
Seat 6: danthaur folded before Flop
Seat 7: Rennvogel (button) folded before Flop (didn't bet)
Seat 8: aksh3n (small blind) folded before Flop
Seat 9: fragonik (big blind) folded before Flop



PokerStars Hand #228687051766:  Hold'em No Limit ($0.25/$0.50 USD) - 2021/07/30 15:35:18 ET
Table 'Gorgo III' 9-max Seat #8 is the button
Seat 1: Timme54 ($48.73 in chips) 
Seat 2: Rulet345 ($50 in chips) 
Seat 3: StudentRB ($73.09 in chips) 
Seat 4: Tigerrr777 ($51 in chips) 
Seat 5: Xamil666 ($57.10 in chips) 
Seat 6: danthaur ($50 in chips) 
Seat 7: Rennvogel ($39.04 in chips) 
Seat 8: aksh3n ($50 in chips) 
Seat 9: fragonik ($54.37 in chips) 
fragonik: posts small blind $0.25
Timme54: posts big blind $0.50
*** HOLE CARDS ***
Rulet345: folds 
StudentRB: folds 
Tigerrr777: folds 
Xamil666: folds 
danthaur: folds 
Rennvogel: folds 
aksh3n: raises $0.60 to $1.10
fragonik: folds 
Timme54: calls $0.60
*** FLOP *** [7d 2d Qh]
Timme54: checks 
aksh3n: checks 
*** TURN *** [7d 2d Qh] [3s]
Timme54: checks 
aksh3n: bets $0.77
Timme54: raises $0.77 to $1.54
aksh3n: folds 
Uncalled bet ($0.77) returned to Timme54
Timme54 collected $3.74 from pot
Timme54: doesn't show hand 
*** SUMMARY ***
Total pot $3.99 | Rake $0.25 
Board [7d 2d Qh 3s]
Seat 1: Timme54 (big blind) collected ($3.74)
Seat 2: Rulet345 folded before Flop (didn't bet)
Seat 3: StudentRB folded before Flop (didn't bet)
Seat 4: Tigerrr777 folded before Flop (didn't bet)
Seat 5: Xamil666 folded before Flop (didn't bet)
Seat 6: danthaur folded before Flop (didn't bet)
Seat 7: Rennvogel folded before Flop (didn't bet)
Seat 8: aksh3n (button) folded on the Turn
Seat 9: fragonik (small blind) folded before Flop



PokerStars Hand #228687067161:  Hold'em No Limit ($0.25/$0.50 USD) - 2021/07/30 15:35:51 ET
Table 'Gorgo III' 9-max Seat #9 is the button
Seat 1: Timme54 ($50.60 in chips) 
Seat 2: Rulet345 ($50 in chips) 
Seat 3: StudentRB ($73.09 in chips) 
Seat 4: Tigerrr777 ($51 in chips) 
Seat 5: Xamil666 ($57.10 in chips) 
Seat 6: danthaur ($50 in chips) 
Seat 7: Rennvogel ($39.04 in chips) 
Seat 8: aksh3n ($50 in chips) 
Seat 9: fragonik ($54.12 in chips) 
Timme54: posts small blind $0.25
Rulet345: posts big blind $0.50
*** HOLE CARDS ***
StudentRB: folds 
Tigerrr777: folds 
Xamil666: folds 
danthaur: folds 
Rennvogel: raises $0.50 to $1
aksh3n: folds 
fragonik: calls $1
Timme54: calls $0.75
Rulet345: calls $0.50
*** FLOP *** [8h Ks 8c]
Timme54: checks 
Rulet345: checks 
Rennvogel: checks 
fragonik: checks 
*** TURN *** [8h Ks 8c] [Kd]
Timme54: checks 
Rulet345: checks 
Rennvogel: checks 
fragonik: bets $1.86
Timme54: folds 
Rulet345: folds 
Rennvogel: calls $1.86
*** RIVER *** [8h Ks 8c Kd] [9d]
Rennvogel: checks 
fragonik: checks 
*** SHOW DOWN ***
Rennvogel: shows [As 7s] (two pair, Kings and Eights)
fragonik: shows [Ad 2d] (two pair, Kings and Eights)
Rennvogel collected $3.62 from pot
fragonik collected $3.66 from pot
*** SUMMARY ***
Total pot $7.72 | Rake $0.44 
Board [8h Ks 8c Kd 9d]
Seat 1: Timme54 (small blind) folded on the Turn
Seat 2: Rulet345 (big blind) folded on the Turn
Seat 3: StudentRB folded before Flop (didn't bet)
Seat 4: Tigerrr777 folded before Flop (didn't bet)
Seat 5: Xamil666 folded before Flop (didn't bet)
Seat 6: danthaur folded before Flop (didn't bet)
Seat 7: Rennvogel showed [As 7s] and won ($3.62) with two pair, Kings and Eights
Seat 8: aksh3n folded before Flop (didn't bet)
Seat 9: fragonik (button) showed [Ad 2d] and won ($3.66) with two pair, Kings and Eights



PokerStars Hand #228687093288:  Hold'em No Limit ($0.25/$0.50 USD) - 2021/07/30 15:36:47 ET
Table 'Gorgo III' 9-max Seat #1 is the button
Seat 1: Timme54 ($49.60 in chips) 
Seat 2: Rulet345 ($50 in chips) 
Seat 3: StudentRB ($73.09 in chips) 
Seat 4: Tigerrr777 ($51 in chips) 
Seat 5: Xamil666 ($57.10 in chips) 
Seat 6: danthaur ($50 in chips) 
Seat 7: Rennvogel ($39.80 in chips) 
Seat 8: aksh3n ($50 in chips) 
Seat 9: fragonik ($54.92 in chips) 
Rulet345: posts small blind $0.25
StudentRB: posts big blind $0.50
*** HOLE CARDS ***
Tigerrr777: raises $1 to $1.50
Xamil666: folds 
danthaur: folds 
Rennvogel: calls $1.50
aksh3n: calls $1.50
fragonik: calls $1.50
Timme54: folds 
Rulet345: folds 
StudentRB: calls $1
*** FLOP *** [Kc 3h 6c]
StudentRB: checks 
Tigerrr777: checks 
Rennvogel: checks 
aksh3n: checks 
fragonik: checks 
*** TURN *** [Kc 3h 6c] [6d]
StudentRB: checks 
Tigerrr777: checks 
Rennvogel: checks 
aksh3n: folds 
aksh3n leaves the table
fragonik: bets $3.75
StudentRB: folds 
Tigerrr777: folds 
Rennvogel: folds 
Uncalled bet ($3.75) returned to fragonik
fragonik collected $7.36 from pot
*** SUMMARY ***
Total pot $7.75 | Rake $0.39 
Board [Kc 3h 6c 6d]
Seat 1: Timme54 (button) folded before Flop (didn't bet)
Seat 2: Rulet345 (small blind) folded before Flop
Seat 3: StudentRB (big blind) folded on the Turn
Seat 4: Tigerrr777 folded on the Turn
Seat 5: Xamil666 folded before Flop (didn't bet)
Seat 6: danthaur folded before Flop (didn't bet)
Seat 7: Rennvogel folded on the Turn
Seat 8: aksh3n folded on the Turn
Seat 9: fragonik collected ($7.36)



PokerStars Hand #228687158117:  Hold'em No Limit ($0.25/$0.50 USD) - 2021/07/30 15:39:06 ET
Table 'Gorgo III' 9-max Seat #2 is the button
Seat 1: Timme54 ($49.60 in chips) 
Seat 2: Rulet345 ($50 in chips) 
Seat 3: StudentRB ($71.59 in chips) 
Seat 4: Tigerrr777 ($50 in chips) 
Seat 5: Xamil666 ($57.10 in chips) 
Seat 6: danthaur ($50 in chips) 
Seat 7: Rennvogel ($38.30 in chips) 
Seat 9: fragonik ($60.78 in chips) 
StudentRB: posts small blind $0.25
Tigerrr777: posts big blind $0.50
*** HOLE CARDS ***
Xamil666: folds 
danthaur: folds 
Rennvogel: folds 
fragonik: folds 
Timme54: calls $0.50
Rulet345: raises $1.75 to $2.25
StudentRB: folds 
Tigerrr777: folds 
Timme54: folds 
Uncalled bet ($1.75) returned to Rulet345
Rulet345 collected $1.75 from pot
Rulet345: doesn't show hand 
*** SUMMARY ***
Total pot $1.75 | Rake $0 
Seat 1: Timme54 folded before Flop
Seat 2: Rulet345 (button) collected ($1.75)
Seat 3: StudentRB (small blind) folded before Flop
Seat 4: Tigerrr777 (big blind) folded before Flop
Seat 5: Xamil666 folded before Flop (didn't bet)
Seat 6: danthaur folded before Flop (didn't bet)
Seat 7: Rennvogel folded before Flop (didn't bet)
Seat 9: fragonik folded before Flop (didn't bet)



PokerStars Hand #228687166960:  Hold'em No Limit ($0.25/$0.50 USD) - 2021/07/30 15:39:25 ET
Table 'Gorgo III' 9-max Seat #3 is the button
Seat 1: Timme54 ($49.10 in chips) 
Seat 2: Rulet345 ($51.25 in chips) 
Seat 3: StudentRB ($71.34 in chips) 
Seat 4: Tigerrr777 ($50 in chips) 
Seat 5: Xamil666 ($57.10 in chips) 
Seat 6: danthaur ($50 in chips) 
Seat 7: Rennvogel ($38.30 in chips) 
Seat 9: fragonik ($60.78 in chips) 
Tigerrr777: posts small blind $0.25
Xamil666: posts big blind $0.50
*** HOLE CARDS ***
danthaur: folds 
Rennvogel: folds 
fragonik: raises $0.75 to $1.25
Timme54: folds 
Rulet345: folds 
StudentRB: folds 
Tigerrr777: raises $4.50 to $5.75
Xamil666: folds 
Popokluev joins the table at seat #8 
fragonik: folds 
Uncalled bet ($4.50) returned to Tigerrr777
Tigerrr777 collected $3 from pot
Tigerrr777: doesn't show hand 
*** SUMMARY ***
Total pot $3 | Rake $0 
Seat 1: Timme54 folded before Flop (didn't bet)
Seat 2: Rulet345 folded before Flop (didn't bet)
Seat 3: StudentRB (button) folded before Flop (didn't bet)
Seat 4: Tigerrr777 (small blind) collected ($3)
Seat 5: Xamil666 (big blind) folded before Flop
Seat 6: danthaur folded before Flop (didn't bet)
Seat 7: Rennvogel folded before Flop (didn't bet)
Seat 9: fragonik folded before Flop



PokerStars Hand #228687176342:  Hold'em No Limit ($0.25/$0.50 USD) - 2021/07/30 15:39:45 ET
Table 'Gorgo III' 9-max Seat #4 is the button
Seat 1: Timme54 ($49.10 in chips) 
Seat 2: Rulet345 ($51.25 in chips) 
Seat 3: StudentRB ($71.34 in chips) 
Seat 4: Tigerrr777 ($51.75 in chips) 
Seat 5: Xamil666 ($56.60 in chips) 
Seat 6: danthaur ($50 in chips) 
Seat 7: Rennvogel ($38.30 in chips) 
Seat 9: fragonik ($59.53 in chips) 
Xamil666: posts small blind $0.25
danthaur: posts big blind $0.50
Popokluev: sits out 
*** HOLE CARDS ***
Rennvogel: folds 
fragonik: folds 
Timme54: folds 
Rulet345: raises $1 to $1.50
StudentRB: folds 
Tigerrr777: folds 
Xamil666: raises $4 to $5.50
danthaur: folds 
Rulet345: folds 
Uncalled bet ($4) returned to Xamil666
Xamil666 collected $3.50 from pot
*** SUMMARY ***
Total pot $3.50 | Rake $0 
Seat 1: Timme54 folded before Flop (didn't bet)
Seat 2: Rulet345 folded before Flop
Seat 3: StudentRB folded before Flop (didn't bet)
Seat 4: Tigerrr777 (button) folded before Flop (didn't bet)
Seat 5: Xamil666 (small blind) collected ($3.50)
Seat 6: danthaur (big blind) folded before Flop
Seat 7: Rennvogel folded before Flop (didn't bet)
Seat 9: fragonik folded before Flop (didn't bet)



PokerStars Hand #228687202604:  Hold'em No Limit ($0.25/$0.50 USD) - 2021/07/30 15:40:21 ET
Table 'Gorgo III' 9-max Seat #5 is the button
Seat 1: Timme54 ($49.10 in chips) 
Seat 2: Rulet345 ($50 in chips) 
Seat 3: StudentRB ($71.34 in chips) 
Seat 4: Tigerrr777 ($51.75 in chips) 
Seat 5: Xamil666 ($58.60 in chips) 
Seat 6: danthaur ($50 in chips) 
Seat 7: Rennvogel ($38.30 in chips) 
Seat 9: fragonik ($59.53 in chips) 
danthaur: posts small blind $0.25
Rennvogel: posts big blind $0.50
Popokluev: sits out 
*** HOLE CARDS ***
fragonik: folds 
Timme54: folds 
Rulet345: folds 
StudentRB: raises $0.75 to $1.25
Tigerrr777: folds 
Xamil666: folds 
danthaur: folds 
Rennvogel: folds 
Uncalled bet ($0.75) returned to StudentRB
StudentRB collected $1.25 from pot
StudentRB: doesn't show hand 
*** SUMMARY ***
Total pot $1.25 | Rake $0 
Seat 1: Timme54 folded before Flop (didn't bet)
Seat 2: Rulet345 folded before Flop (didn't bet)
Seat 3: StudentRB collected ($1.25)
Seat 4: Tigerrr777 folded before Flop (didn't bet)
Seat 5: Xamil666 (button) folded before Flop (didn't bet)
Seat 6: danthaur (small blind) folded before Flop
Seat 7: Rennvogel (big blind) folded before Flop
Seat 9: fragonik folded before Flop (didn't bet)



PokerStars Hand #228687209253:  Hold'em No Limit ($0.25/$0.50 USD) - 2021/07/30 15:40:36 ET
Table 'Gorgo III' 9-max Seat #6 is the button
Seat 1: Timme54 ($49.10 in chips) 
Seat 2: Rulet345 ($50 in chips) 
Seat 3: StudentRB ($72.09 in chips) 
Seat 4: Tigerrr777 ($51.75 in chips) 
Seat 5: Xamil666 ($58.60 in chips) 
Seat 6: danthaur ($50 in chips) 
Seat 7: Rennvogel ($37.80 in chips) 
Seat 8: Popokluev ($50 in chips) 
Seat 9: fragonik ($59.53 in chips) 
Rennvogel: posts small blind $0.25
Popokluev: posts big blind $0.50
*** HOLE CARDS ***
fragonik: folds 
Timme54: folds 
Rulet345: folds 
Timme54 leaves the table
StudentRB: folds 
Tigerrr777: folds 
Xamil666: folds 
danthaur: raises $0.75 to $1.25
Rennvogel: folds 
Popokluev: calls $0.75
*** FLOP *** [5h 9h Qh]
Popokluev: checks 
danthaur: checks 
*** TURN *** [5h 9h Qh] [6c]
Popokluev: checks 
danthaur: bets $1.96
Popokluev: calls $1.96
*** RIVER *** [5h 9h Qh 6c] [9c]
Popokluev: checks 
danthaur: checks 
*** SHOW DOWN ***
Popokluev: shows [As 9s] (three of a kind, Nines)
danthaur: mucks hand 
Popokluev collected $6.34 from pot
*** SUMMARY ***
Total pot $6.67 | Rake $0.33 
Board [5h 9h Qh 6c 9c]
Seat 1: Timme54 folded before Flop (didn't bet)
Seat 2: Rulet345 folded before Flop (didn't bet)
Seat 3: StudentRB folded before Flop (didn't bet)
Seat 4: Tigerrr777 folded before Flop (didn't bet)
Seat 5: Xamil666 folded before Flop (didn't bet)
Seat 6: danthaur (button) mucked
Seat 7: Rennvogel (small blind) folded before Flop
Seat 8: Popokluev (big blind) showed [As 9s] and won ($6.34) with three of a kind, Nines
Seat 9: fragonik folded before Flop (didn't bet)



PokerStars Hand #228687237073:  Hold'em No Limit ($0.25/$0.50 USD) - 2021/07/30 15:41:36 ET
Table 'Gorgo III' 9-max Seat #7 is the button
Seat 2: Rulet345 ($50 in chips) 
Seat 3: StudentRB ($72.09 in chips) 
Seat 4: Tigerrr777 ($51.75 in chips) 
Seat 5: Xamil666 ($58.60 in chips) 
Seat 6: danthaur ($50 in chips) 
Seat 7: Rennvogel ($37.55 in chips) 
Seat 8: Popokluev ($53.13 in chips) 
Seat 9: fragonik ($59.53 in chips) 
Popokluev: posts small blind $0.25
fragonik: posts big blind $0.50
*** HOLE CARDS ***
Rulet345: folds 
StudentRB: folds 
Tigerrr777: raises $1 to $1.50
Xamil666: folds 
danthaur: folds 
Rennvogel: folds 
Popokluev: folds 
fragonik: calls $1
*** FLOP *** [Qs 5d 9d]
fragonik: checks 
Tigerrr777: bets $1.25
fragonik: folds 
Uncalled bet ($1.25) returned to Tigerrr777
Tigerrr777 collected $3.09 from pot
Tigerrr777: doesn't show hand 
*** SUMMARY ***
Total pot $3.25 | Rake $0.16 
Board [Qs 5d 9d]
Seat 2: Rulet345 folded before Flop (didn't bet)
Seat 3: StudentRB folded before Flop (didn't bet)
Seat 4: Tigerrr777 collected ($3.09)
Seat 5: Xamil666 folded before Flop (didn't bet)
Seat 6: danthaur folded before Flop (didn't bet)
Seat 7: Rennvogel (button) folded before Flop (didn't bet)
Seat 8: Popokluev (small blind) folded before Flop
Seat 9: fragonik (big blind) folded on the Flop



PokerStars Hand #228687252184:  Hold'em No Limit ($0.25/$0.50 USD) - 2021/07/30 15:42:09 ET
Table 'Gorgo III' 9-max Seat #8 is the button
Seat 2: Rulet345 ($50 in chips) 
Seat 3: StudentRB ($72.09 in chips) 
Seat 4: Tigerrr777 ($53.34 in chips) 
Seat 5: Xamil666 ($58.60 in chips) 
Seat 6: danthaur ($50 in chips) 
Seat 7: Rennvogel ($37.55 in chips) 
Seat 8: Popokluev ($52.88 in chips) 
Seat 9: fragonik ($58.03 in chips) 
fragonik: posts small blind $0.25
Rulet345: posts big blind $0.50
*** HOLE CARDS ***
StudentRB: folds 
Tigerrr777: folds 
Xamil666: folds 
Tigerrr777 leaves the table
danthaur: raises $1 to $1.50
Rennvogel: folds 
Popokluev: folds 
bjolla joins the table at seat #4 
fragonik: folds 
Rulet345: folds 
Uncalled bet ($1) returned to danthaur
Popokluev leaves the table
danthaur collected $1.25 from pot
danthaur: doesn't show hand 
*** SUMMARY ***
Total pot $1.25 | Rake $0 
Seat 2: Rulet345 (big blind) folded before Flop
Seat 3: StudentRB folded before Flop (didn't bet)
Seat 4: Tigerrr777 folded before Flop (didn't bet)
Seat 5: Xamil666 folded before Flop (didn't bet)
Seat 6: danthaur collected ($1.25)
Seat 7: Rennvogel folded before Flop (didn't bet)
Seat 8: Popokluev (button) folded before Flop (didn't bet)
Seat 9: fragonik (small blind) folded before Flop



PokerStars Hand #228687259852:  Hold'em No Limit ($0.25/$0.50 USD) - 2021/07/30 15:42:26 ET
Table 'Gorgo III' 9-max Seat #9 is the button
Seat 2: Rulet345 ($50 in chips) 
Seat 3: StudentRB ($72.09 in chips) 
Seat 5: Xamil666 ($58.60 in chips) 
Seat 6: danthaur ($50.75 in chips) 
Seat 7: Rennvogel ($37.55 in chips) 
Seat 9: fragonik ($57.78 in chips) 
Rulet345: posts small blind $0.25
StudentRB: posts big blind $0.50
bjolla: sits out 
*** HOLE CARDS ***
Xamil666: folds 
danthaur: folds 
Xamil666 leaves the table
Rennvogel: raises $0.50 to $1
fragonik: calls $1
Rulet345: folds 
StudentRB: folds 
*** FLOP *** [Ad 8s Kh]
Rennvogel: checks 
fragonik: bets $0.86
Rennvogel: calls $0.86
*** TURN *** [Ad 8s Kh] [Ac]
Rennvogel: checks 
fragonik: bets $3.19
Rennvogel: folds 
Uncalled bet ($3.19) returned to fragonik
fragonik collected $4.25 from pot
*** SUMMARY ***
Total pot $4.47 | Rake $0.22 
Board [Ad 8s Kh Ac]
Seat 2: Rulet345 (small blind) folded before Flop
Seat 3: StudentRB (big blind) folded before Flop
Seat 5: Xamil666 folded before Flop (didn't bet)
Seat 6: danthaur folded before Flop (didn't bet)
Seat 7: Rennvogel folded on the Turn
Seat 9: fragonik (button) collected ($4.25)



PokerStars Hand #228687272971:  Hold'em No Limit ($0.25/$0.50 USD) - 2021/07/30 15:42:54 ET
Table 'Gorgo III' 9-max Seat #2 is the button
Seat 2: Rulet345 ($50 in chips) 
Seat 3: StudentRB ($71.59 in chips) 
Seat 4: bjolla ($50 in chips) 
Seat 6: danthaur ($50.75 in chips) 
Seat 7: Rennvogel ($35.69 in chips) 
Seat 9: fragonik ($60.17 in chips) 
StudentRB: posts small blind $0.25
bjolla: posts big blind $0.50
*** HOLE CARDS ***
danthaur: folds 
Rennvogel: folds 
fragonik: folds 
Rulet345: raises $0.75 to $1.25
StudentRB: folds 
bjolla: folds 
Uncalled bet ($0.75) returned to Rulet345
Rulet345 collected $1.25 from pot
Rulet345: doesn't show hand 
*** SUMMARY ***
Total pot $1.25 | Rake $0 
Seat 2: Rulet345 (button) collected ($1.25)
Seat 3: StudentRB (small blind) folded before Flop
Seat 4: bjolla (big blind) folded before Flop
Seat 6: danthaur folded before Flop (didn't bet)
Seat 7: Rennvogel folded before Flop (didn't bet)
Seat 9: fragonik folded before Flop (didn't bet)



PokerStars Hand #228687280184:  Hold'em No Limit ($0.25/$0.50 USD) - 2021/07/30 15:43:10 ET
Table 'Gorgo III' 9-max Seat #3 is the button
Seat 2: Rulet345 ($50.75 in chips) 
Seat 3: StudentRB ($71.34 in chips) 
Seat 4: bjolla ($49.50 in chips) 
Seat 7: Rennvogel ($35.69 in chips) 
Seat 9: fragonik ($60.17 in chips) 
bjolla: posts small blind $0.25
danthaur: is sitting out 
Rennvogel: posts big blind $0.50
*** HOLE CARDS ***
danthaur leaves the table
fragonik: folds 
Rulet345: folds 
StudentRB: raises $0.75 to $1.25
bjolla: folds 
Rennvogel: folds 
Uncalled bet ($0.75) returned to StudentRB
StudentRB collected $1.25 from pot
StudentRB: doesn't show hand 
*** SUMMARY ***
Total pot $1.25 | Rake $0 
Seat 2: Rulet345 folded before Flop (didn't bet)
Seat 3: StudentRB (button) collected ($1.25)
Seat 4: bjolla (small blind) folded before Flop
Seat 7: Rennvogel (big blind) folded before Flop
Seat 9: fragonik folded before Flop (didn't bet)



PokerStars Hand #228687289714:  Hold'em No Limit ($0.25/$0.50 USD) - 2021/07/30 15:43:31 ET
Table 'Gorgo III' 9-max Seat #4 is the button
Seat 2: Rulet345 ($50.75 in chips) 
Seat 3: StudentRB ($72.09 in chips) 
Seat 4: bjolla ($49.25 in chips) 
Seat 7: Rennvogel ($35.19 in chips) 
Seat 9: fragonik ($60.17 in chips) 
Rennvogel: posts small blind $0.25
fragonik: posts big blind $0.50
*** HOLE CARDS ***
Rulet345: folds 
StudentRB: folds 
bjolla: folds 
Rennvogel: calls $0.25
fragonik: checks 
*** FLOP *** [4d Th 6s]
Rennvogel: checks 
Sash12578 joins the table at seat #1 
Bolshoy ku33 joins the table at seat #5 
fragonik: bets $0.50
aksh3n joins the table at seat #8 
Rennvogel: calls $0.50
*** TURN *** [4d Th 6s] [2d]
Rennvogel: checks 
fragonik: bets $0.93
Rennvogel: calls $0.93
*** RIVER *** [4d Th 6s 2d] [Kd]
Rennvogel: checks 
fragonik: checks 
*** SHOW DOWN ***
Rennvogel: shows [5s 5d] (a pair of Fives)
MR.PATJEW joins the table at seat #6 
fragonik: mucks hand 
Rennvogel collected $3.62 from pot
*** SUMMARY ***
Total pot $3.86 | Rake $0.24 
Board [4d Th 6s 2d Kd]
Seat 2: Rulet345 folded before Flop (didn't bet)
Seat 3: StudentRB folded before Flop (didn't bet)
Seat 4: bjolla (button) folded before Flop (didn't bet)
Seat 7: Rennvogel (small blind) showed [5s 5d] and won ($3.62) with a pair of Fives
Seat 9: fragonik (big blind) mucked



PokerStars Hand #228687312216:  Hold'em No Limit ($0.25/$0.50 USD) - 2021/07/30 15:44:20 ET
Table 'Gorgo III' 9-max Seat #7 is the button
Seat 1: Sash12578 ($23.27 in chips) 
Seat 2: Rulet345 ($50.75 in chips) 
Seat 3: StudentRB ($72.09 in chips) 
Seat 4: bjolla ($49.25 in chips) 
Seat 7: Rennvogel ($36.88 in chips) 
Seat 9: fragonik ($58.24 in chips) 
fragonik: posts small blind $0.25
Sash12578: posts big blind $0.50
Bolshoy ku33: sits out 
MR.PATJEW: sits out 
*** HOLE CARDS ***
Rulet345: folds 
StudentRB: folds 
bjolla: folds 
Rennvogel: folds 
fragonik: raises $1 to $1.50
Sash12578: calls $1
*** FLOP *** [8c 5d 2d]
fragonik: bets $1.25
Sash12578: calls $1.25
*** TURN *** [8c 5d 2d] [Ts]
fragonik: bets $2.56
Sash12578: calls $2.56
*** RIVER *** [8c 5d 2d Ts] [Td]
fragonik: checks 
Sash12578: checks 
*** SHOW DOWN ***
fragonik: shows [9s Qc] (a pair of Tens)
Sash12578: shows [Qh 2h] (two pair, Tens and Deuces)
Sash12578 collected $9.96 from pot
*** SUMMARY ***
Total pot $10.62 | Rake $0.66 
Board [8c 5d 2d Ts Td]
Seat 1: Sash12578 (big blind) showed [Qh 2h] and won ($9.96) with two pair, Tens and Deuces
Seat 2: Rulet345 folded before Flop (didn't bet)
Seat 3: StudentRB folded before Flop (didn't bet)
Seat 4: bjolla folded before Flop (didn't bet)
Seat 7: Rennvogel (button) folded before Flop (didn't bet)
Seat 9: fragonik (small blind) showed [9s Qc] and lost with a pair of Tens



PokerStars Hand #228687344651:  Hold'em No Limit ($0.25/$0.50 USD) - 2021/07/30 15:45:31 ET
Table 'Gorgo III' 9-max Seat #9 is the button
Seat 1: Sash12578 ($27.92 in chips) 
Seat 2: Rulet345 ($50.75 in chips) 
Seat 3: StudentRB ($72.09 in chips) 
Seat 4: bjolla ($49.25 in chips) 
Seat 6: MR.PATJEW ($50 in chips) 
Seat 7: Rennvogel ($36.88 in chips) 
Seat 9: fragonik ($52.93 in chips) 
Sash12578: posts small blind $0.25
Rulet345: posts big blind $0.50
Bolshoy ku33: sits out 
MR.PATJEW: posts big blind $0.50
aksh3n: sits out 
*** HOLE CARDS ***
StudentRB: folds 
bjolla: folds 
MR.PATJEW: checks 
Rennvogel: folds 
fragonik: folds 
Sash12578: calls $0.25
Rulet345: checks 
*** FLOP *** [Kh Qh 3d]
Sash12578: checks 
Rulet345: checks 
MR.PATJEW: checks 
*** TURN *** [Kh Qh 3d] [4d]
Sash12578: checks 
Rulet345: checks 
MR.PATJEW: checks 
*** RIVER *** [Kh Qh 3d 4d] [Tc]
Sash12578: checks 
Bolshoy ku33 is disconnected 
Rulet345: bets $0.95
MR.PATJEW: folds 
Sash12578: folds 
Uncalled bet ($0.95) returned to Rulet345
Rulet345 collected $1.42 from pot
Rulet345: doesn't show hand 
*** SUMMARY ***
Total pot $1.50 | Rake $0.08 
Board [Kh Qh 3d 4d Tc]
Seat 1: Sash12578 (small blind) folded on the River
Seat 2: Rulet345 (big blind) collected ($1.42)
Seat 3: StudentRB folded before Flop (didn't bet)
Seat 4: bjolla folded before Flop (didn't bet)
Seat 6: MR.PATJEW folded on the River (didn't bet)
Seat 7: Rennvogel folded before Flop (didn't bet)
Seat 9: fragonik (button) folded before Flop (didn't bet)



PokerStars Hand #228687386917:  Hold'em No Limit ($0.25/$0.50 USD) - 2021/07/30 15:46:49 ET
Table 'Gorgo III' 9-max Seat #1 is the button
Seat 1: Sash12578 ($27.42 in chips) 
Seat 2: Rulet345 ($51.67 in chips) 
Seat 4: bjolla ($49.25 in chips) 
Seat 6: MR.PATJEW ($49.50 in chips) 
Seat 7: Rennvogel ($36.88 in chips) 
Seat 9: fragonik ($52.93 in chips) 
Rulet345: posts small blind $0.25
StudentRB: is sitting out 
bjolla: posts big blind $0.50
StudentRB leaves the table
Bolshoy ku33 has timed out while disconnected
Bolshoy ku33: is sitting out 
aksh3n: sits out 
*** HOLE CARDS ***
Leason22 joins the table at seat #3 
MR.PATJEW: raises $1 to $1.50
Rennvogel: folds 
fragonik: folds 
Sash12578: folds 
Rulet345: folds 
bjolla: folds 
Uncalled bet ($1) returned to MR.PATJEW
MR.PATJEW collected $1.25 from pot
MR.PATJEW: doesn't show hand 
*** SUMMARY ***
Total pot $1.25 | Rake $0 
Seat 1: Sash12578 (button) folded before Flop (didn't bet)
Seat 2: Rulet345 (small blind) folded before Flop
Seat 4: bjolla (big blind) folded before Flop
Seat 6: MR.PATJEW collected ($1.25)
Seat 7: Rennvogel folded before Flop (didn't bet)
Seat 9: fragonik folded before Flop (didn't bet)



PokerStars Hand #228687402589:  Hold'em No Limit ($0.25/$0.50 USD) - 2021/07/30 15:47:23 ET
Table 'Gorgo III' 9-max Seat #2 is the button
Seat 1: Sash12578 ($27.42 in chips) 
Seat 2: Rulet345 ($51.42 in chips) 
Seat 4: bjolla ($48.75 in chips) 
Seat 6: MR.PATJEW ($50.25 in chips) 
Seat 7: Rennvogel ($36.88 in chips) 
Seat 9: fragonik ($52.93 in chips) 
bjolla: posts small blind $0.25
MR.PATJEW: posts big blind $0.50
aksh3n: sits out 
*** HOLE CARDS ***
Rennvogel: folds 
fragonik: raises $0.75 to $1.25
Sash12578: calls $1.25
Rulet345: folds 
bjolla: folds 
MR.PATJEW: folds 
*** FLOP *** [Kh 8c 3h]
fragonik: checks 
Sash12578: checks 
*** TURN *** [Kh 8c 3h] [4d]
fragonik: bets $1.51
Sash12578: folds 
Uncalled bet ($1.51) returned to fragonik
fragonik collected $3.09 from pot
*** SUMMARY ***
Total pot $3.25 | Rake $0.16 
Board [Kh 8c 3h 4d]
Seat 1: Sash12578 folded on the Turn
Seat 2: Rulet345 (button) folded before Flop (didn't bet)
Seat 4: bjolla (small blind) folded before Flop
Seat 6: MR.PATJEW (big blind) folded before Flop
Seat 7: Rennvogel folded before Flop (didn't bet)
Seat 9: fragonik collected ($3.09)



PokerStars Hand #228687421230:  Hold'em No Limit ($0.25/$0.50 USD) - 2021/07/30 15:48:03 ET
Table 'Gorgo III' 9-max Seat #4 is the button
Seat 1: Sash12578 ($26.17 in chips) 
Seat 2: Rulet345 ($51.42 in chips) 
Seat 4: bjolla ($48.50 in chips) 
Seat 6: MR.PATJEW ($49.75 in chips) 
Seat 7: Rennvogel ($36.88 in chips) 
Seat 9: fragonik ($54.77 in chips) 
MR.PATJEW: posts small blind $0.25
Rennvogel: posts big blind $0.50
aksh3n: sits out 
Leason22: sits out 
*** HOLE CARDS ***
fragonik: folds 
Sash12578: folds 
Rulet345: folds 
bjolla: folds 
MR.PATJEW: calls $0.25
Rennvogel: checks 
*** FLOP *** [7d Ts 5d]
MR.PATJEW: bets $0.95
Rennvogel: folds 
Uncalled bet ($0.95) returned to MR.PATJEW
MR.PATJEW collected $0.95 from pot
MR.PATJEW: doesn't show hand 
*** SUMMARY ***
Total pot $1 | Rake $0.05 
Board [7d Ts 5d]
Seat 1: Sash12578 folded before Flop (didn't bet)
Seat 2: Rulet345 folded before Flop (didn't bet)
Seat 4: bjolla (button) folded before Flop (didn't bet)
Seat 6: MR.PATJEW (small blind) collected ($0.95)
Seat 7: Rennvogel (big blind) folded on the Flop
Seat 9: fragonik folded before Flop (didn't bet)



PokerStars Hand #228687431879:  Hold'em No Limit ($0.25/$0.50 USD) - 2021/07/30 15:48:27 ET
Table 'Gorgo III' 9-max Seat #6 is the button
Seat 1: Sash12578 ($26.17 in chips) 
Seat 2: Rulet345 ($51.42 in chips) 
Seat 4: bjolla ($48.50 in chips) 
Seat 6: MR.PATJEW ($50.20 in chips) 
Seat 7: Rennvogel ($36.38 in chips) 
Seat 8: aksh3n ($50 in chips) 
Seat 9: fragonik ($54.77 in chips) 
Rennvogel: posts small blind $0.25
aksh3n: posts big blind $0.50
Leason22: sits out 
*** HOLE CARDS ***
fragonik: folds 
Sash12578: folds 
Rulet345: folds 
bjolla: folds 
MR.PATJEW: folds 
Rennvogel: folds 
Uncalled bet ($0.25) returned to aksh3n
aksh3n collected $0.50 from pot
aksh3n: doesn't show hand 
*** SUMMARY ***
Total pot $0.50 | Rake $0 
Seat 1: Sash12578 folded before Flop (didn't bet)
Seat 2: Rulet345 folded before Flop (didn't bet)
Seat 4: bjolla folded before Flop (didn't bet)
Seat 6: MR.PATJEW (button) folded before Flop (didn't bet)
Seat 7: Rennvogel (small blind) folded before Flop
Seat 8: aksh3n (big blind) collected ($0.50)
Seat 9: fragonik folded before Flop (didn't bet)



PokerStars Hand #228687435340:  Hold'em No Limit ($0.25/$0.50 USD) - 2021/07/30 15:48:34 ET
Table 'Gorgo III' 9-max Seat #7 is the button
Seat 1: Sash12578 ($26.17 in chips) 
Seat 2: Rulet345 ($51.42 in chips) 
Seat 4: bjolla ($48.50 in chips) 
Seat 6: MR.PATJEW ($50.20 in chips) 
Seat 7: Rennvogel ($36.13 in chips) 
Seat 8: aksh3n ($50.25 in chips) 
Seat 9: fragonik ($54.77 in chips) 
aksh3n: posts small blind $0.25
fragonik: posts big blind $0.50
Leason22: sits out 
Bolshoy ku33: sits out 
*** HOLE CARDS ***
Sash12578: raises $1 to $1.50
Rulet345: folds 
bjolla: calls $1.50
MR.PATJEW: calls $1.50
Rennvogel: raises $5.50 to $7
aksh3n: folds 
fragonik: folds 
Sash12578: calls $5.50
bjolla: raises $41.50 to $48.50 and is all-in
MR.PATJEW: calls $47
Rennvogel: calls $29.13 and is all-in
Sash12578: calls $19.17 and is all-in
*** FLOP *** [Jc Ad 3s]
*** TURN *** [Jc Ad 3s] [3d]
*** RIVER *** [Jc Ad 3s 3d] [Jd]
*** SHOW DOWN ***
bjolla: shows [Qs Qc] (two pair, Queens and Jacks)
MR.PATJEW: shows [As 8c] (two pair, Aces and Jacks)
MR.PATJEW collected $24.74 from side pot-2 
Rennvogel: shows [Kd Kc] (two pair, Kings and Jacks)
MR.PATJEW collected $29.88 from side pot-1 
Sash12578: shows [9h 9s] (two pair, Jacks and Nines)
MR.PATJEW collected $103.43 from main pot
bjolla cashed out the hand for $39.60 | Cash Out Fee $0.40
*** SUMMARY ***
Total pot $160.05 Main pot $103.43. Side pot-1 $29.88. Side pot-2 $24.74. | Rake $2 
Board [Jc Ad 3s 3d Jd]
Seat 1: Sash12578 showed [9h 9s] and lost with two pair, Jacks and Nines
Seat 2: Rulet345 folded before Flop (didn't bet)
Seat 4: bjolla showed [Qs Qc] and lost with two pair, Queens and Jacks (cashed out).
Seat 6: MR.PATJEW showed [As 8c] and won ($158.05) with two pair, Aces and Jacks
Seat 7: Rennvogel (button) showed [Kd Kc] and lost with two pair, Kings and Jacks
Seat 8: aksh3n (small blind) folded before Flop
Seat 9: fragonik (big blind) folded before Flop



PokerStars Hand #228687474910:  Hold'em No Limit ($0.25/$0.50 USD) - 2021/07/30 15:50:00 ET
Table 'Gorgo III' 9-max Seat #8 is the button
Seat 2: Rulet345 ($51.42 in chips) 
Seat 4: bjolla ($39.60 in chips) 
Seat 6: MR.PATJEW ($159.75 in chips) 
Seat 8: aksh3n ($50 in chips) 
Seat 9: fragonik ($54.27 in chips) 
fragonik: posts small blind $0.25
Rulet345: posts big blind $0.50
Leason22: sits out 
Bolshoy ku33: sits out 
*** HOLE CARDS ***
bjolla: folds 
MR.PATJEW: folds 
Sash12578 leaves the table
aksh3n: raises $0.60 to $1.10
fragonik: folds 
Rennvogel leaves the table
Rulet345: calls $0.60
*** FLOP *** [5d 9s 7c]
Rulet345: checks 
aksh3n: checks 
*** TURN *** [5d 9s 7c] [Jh]
sonova joins the table at seat #7 
Rulet345: bets $1.55
aksh3n: folds 
Uncalled bet ($1.55) returned to Rulet345
Rulet345 collected $2.33 from pot
Rulet345: doesn't show hand 
*** SUMMARY ***
Total pot $2.45 | Rake $0.12 
Board [5d 9s 7c Jh]
Seat 2: Rulet345 (big blind) collected ($2.33)
Seat 4: bjolla folded before Flop (didn't bet)
Seat 6: MR.PATJEW folded before Flop (didn't bet)
Seat 8: aksh3n (button) folded on the Turn
Seat 9: fragonik (small blind) folded before Flop



PokerStars Hand #228687496815:  Hold'em No Limit ($0.25/$0.50 USD) - 2021/07/30 15:50:48 ET
Table 'Gorgo III' 9-max Seat #9 is the button
Seat 2: Rulet345 ($52.65 in chips) 
Seat 3: Leason22 ($25 in chips) 
Seat 4: bjolla ($50 in chips) 
Seat 6: MR.PATJEW ($159.75 in chips) 
Seat 8: aksh3n ($50 in chips) 
Seat 9: fragonik ($54.02 in chips) 
Rulet345: posts small blind $0.25
Leason22: posts big blind $0.50
Bolshoy ku33: sits out 
sonova: sits out 
*** HOLE CARDS ***
bjolla: folds 
MR.PATJEW: folds 
aksh3n: folds 
fragonik: folds 
gustguaira joins the table at seat #1 
Rulet345: raises $1 to $1.50
Leason22: folds 
Uncalled bet ($1) returned to Rulet345
Rulet345 collected $1 from pot
Rulet345: doesn't show hand 
*** SUMMARY ***
Total pot $1 | Rake $0 
Seat 2: Rulet345 (small blind) collected ($1)
Seat 3: Leason22 (big blind) folded before Flop
Seat 4: bjolla folded before Flop (didn't bet)
Seat 6: MR.PATJEW folded before Flop (didn't bet)
Seat 8: aksh3n folded before Flop (didn't bet)
Seat 9: fragonik (button) folded before Flop (didn't bet)



PokerStars Hand #228687512768:  Hold'em No Limit ($0.25/$0.50 USD) - 2021/07/30 15:51:23 ET
Table 'Gorgo III' 9-max Seat #2 is the button
Seat 1: gustguaira ($50 in chips) 
Seat 2: Rulet345 ($53.15 in chips) 
Seat 3: Leason22 ($24.50 in chips) 
Seat 4: bjolla ($50 in chips) 
Seat 6: MR.PATJEW ($159.75 in chips) 
Seat 8: aksh3n ($50 in chips) 
Seat 9: fragonik ($54.02 in chips) 
Leason22: posts small blind $0.25
bjolla: posts big blind $0.50
Bolshoy ku33: sits out 
sonova: sits out 
gustguaira: posts big blind $0.50
*** HOLE CARDS ***
MR.PATJEW: folds 
aksh3n: folds 
fragonik: folds 
gustguaira: raises $1 to $1.50
Rulet345: folds 
Leason22: folds 
bjolla: calls $1
*** FLOP *** [4s 4h 7h]
bjolla: checks 
gustguaira: checks 
*** TURN *** [4s 4h 7h] [7s]
bjolla: checks 
gustguaira: bets $1.54
bjolla: folds 
Uncalled bet ($1.54) returned to gustguaira
gustguaira collected $3.09 from pot
gustguaira: doesn't show hand 
*** SUMMARY ***
Total pot $3.25 | Rake $0.16 
Board [4s 4h 7h 7s]
Seat 1: gustguaira collected ($3.09)
Seat 2: Rulet345 (button) folded before Flop (didn't bet)
Seat 3: Leason22 (small blind) folded before Flop
Seat 4: bjolla (big blind) folded on the Turn
Seat 6: MR.PATJEW folded before Flop (didn't bet)
Seat 8: aksh3n folded before Flop (didn't bet)
Seat 9: fragonik folded before Flop (didn't bet)



PokerStars Hand #228687531246:  Hold'em No Limit ($0.25/$0.50 USD) - 2021/07/30 15:52:03 ET
Table 'Gorgo III' 9-max Seat #3 is the button
Seat 1: gustguaira ($51.59 in chips) 
Seat 2: Rulet345 ($53.15 in chips) 
Seat 3: Leason22 ($24.25 in chips) 
Seat 4: bjolla ($48.50 in chips) 
Seat 6: MR.PATJEW ($159.75 in chips) 
Seat 8: aksh3n ($50 in chips) 
Seat 9: fragonik ($54.02 in chips) 
bjolla: posts small blind $0.25
Bolshoy ku33 has timed out
Bolshoy ku33: is sitting out 
MR.PATJEW: posts big blind $0.50
sonova: sits out 
*** HOLE CARDS ***
aksh3n: folds 
fragonik: folds 
gustguaira: folds 
Rulet345: folds 
Leason22: folds 
bjolla: folds 
Uncalled bet ($0.25) returned to MR.PATJEW
MR.PATJEW collected $0.50 from pot
MR.PATJEW: doesn't show hand 
*** SUMMARY ***
Total pot $0.50 | Rake $0 
Seat 1: gustguaira folded before Flop (didn't bet)
Seat 2: Rulet345 folded before Flop (didn't bet)
Seat 3: Leason22 (button) folded before Flop (didn't bet)
Seat 4: bjolla (small blind) folded before Flop
Seat 6: MR.PATJEW (big blind) collected ($0.50)
Seat 8: aksh3n folded before Flop (didn't bet)
Seat 9: fragonik folded before Flop (didn't bet)



PokerStars Hand #228687542593:  Hold'em No Limit ($0.25/$0.50 USD) - 2021/07/30 15:52:28 ET
Table 'Gorgo III' 9-max Seat #4 is the button
Seat 1: gustguaira ($51.59 in chips) 
Seat 2: Rulet345 ($53.15 in chips) 
Seat 3: Leason22 ($24.25 in chips) 
Seat 4: bjolla ($48.25 in chips) 
Seat 6: MR.PATJEW ($160 in chips) 
Seat 7: sonova ($50 in chips) 
Seat 8: aksh3n ($50 in chips) 
Seat 9: fragonik ($54.02 in chips) 
MR.PATJEW: posts small blind $0.25
sonova: posts big blind $0.50
*** HOLE CARDS ***
Bolshoy ku33 is disconnected 
aksh3n: folds 
fragonik: folds 
gustguaira: folds 
Rulet345: folds 
Leason22: folds 
bjolla: folds 
MR.PATJEW: raises $1 to $1.50
sonova: raises $3.50 to $5
MR.PATJEW: calls $3.50
*** FLOP *** [8c 9s 6c]
MR.PATJEW: checks 
sonova: bets $6.65
MR.PATJEW: calls $6.65
*** TURN *** [8c 9s 6c] [9d]
MR.PATJEW: checks 
sonova: bets $15.50
MR.PATJEW: raises $53.14 to $68.64
sonova: calls $22.85 and is all-in
Uncalled bet ($30.29) returned to MR.PATJEW
*** RIVER *** [8c 9s 6c 9d] [Ah]
*** SHOW DOWN ***
MR.PATJEW: shows [Jc Jh] (two pair, Jacks and Nines)
sonova: shows [Qs Qc] (two pair, Queens and Nines)
sonova collected $98 from pot
*** SUMMARY ***
Total pot $100 | Rake $2 
Board [8c 9s 6c 9d Ah]
Seat 1: gustguaira folded before Flop (didn't bet)
Seat 2: Rulet345 folded before Flop (didn't bet)
Seat 3: Leason22 folded before Flop (didn't bet)
Seat 4: bjolla (button) folded before Flop (didn't bet)
Seat 6: MR.PATJEW (small blind) showed [Jc Jh] and lost with two pair, Jacks and Nines
Seat 7: sonova (big blind) showed [Qs Qc] and won ($98) with two pair, Queens and Nines
Seat 8: aksh3n folded before Flop (didn't bet)
Seat 9: fragonik folded before Flop (didn't bet)



PokerStars Hand #228687565211:  Hold'em No Limit ($0.25/$0.50 USD) - 2021/07/30 15:53:18 ET
Table 'Gorgo III' 9-max Seat #6 is the button
Seat 1: gustguaira ($51.59 in chips) 
Seat 2: Rulet345 ($53.15 in chips) 
Seat 3: Leason22 ($24.25 in chips) 
Seat 4: bjolla ($48.25 in chips) 
Seat 6: MR.PATJEW ($110 in chips) 
Seat 7: sonova ($98 in chips) 
Seat 8: aksh3n ($50 in chips) 
Seat 9: fragonik ($54.02 in chips) 
sonova: posts small blind $0.25
aksh3n: posts big blind $0.50
*** HOLE CARDS ***
fragonik: raises $1 to $1.50
gustguaira: folds 
Rulet345: folds 
Leason22: folds 
bjolla: folds 
MR.PATJEW: folds 
sonova: folds 
aksh3n: calls $1
*** FLOP *** [Ts 6d 8c]
aksh3n: checks 
fragonik: bets $1.51
aksh3n: raises $3.02 to $4.53
fragonik: folds 
Uncalled bet ($3.02) returned to aksh3n
aksh3n collected $5.96 from pot
aksh3n: doesn't show hand 
*** SUMMARY ***
Total pot $6.27 | Rake $0.31 
Board [Ts 6d 8c]
Seat 1: gustguaira folded before Flop (didn't bet)
Seat 2: Rulet345 folded before Flop (didn't bet)
Seat 3: Leason22 folded before Flop (didn't bet)
Seat 4: bjolla folded before Flop (didn't bet)
Seat 6: MR.PATJEW (button) folded before Flop (didn't bet)
Seat 7: sonova (small blind) folded before Flop
Seat 8: aksh3n (big blind) collected ($5.96)
Seat 9: fragonik folded on the Flop



PokerStars Hand #228687588044:  Hold'em No Limit ($0.25/$0.50 USD) - 2021/07/30 15:54:08 ET
Table 'Gorgo III' 9-max Seat #7 is the button
Seat 1: gustguaira ($51.59 in chips) 
Seat 2: Rulet345 ($53.15 in chips) 
Seat 3: Leason22 ($24.25 in chips) 
Seat 4: bjolla ($48.25 in chips) 
Seat 6: MR.PATJEW ($110 in chips) 
Seat 7: sonova ($97.75 in chips) 
Seat 8: aksh3n ($52.95 in chips) 
Seat 9: fragonik ($51.01 in chips) 
aksh3n: posts small blind $0.25
fragonik: posts big blind $0.50
*** HOLE CARDS ***
gustguaira: folds 
Rulet345: folds 
Leason22: folds 
bjolla: folds 
MR.PATJEW: folds 
sonova: folds 
aksh3n: raises $1 to $1.50
fragonik: folds 
Uncalled bet ($1) returned to aksh3n
aksh3n collected $1 from pot
aksh3n: doesn't show hand 
*** SUMMARY ***
Total pot $1 | Rake $0 
Seat 1: gustguaira folded before Flop (didn't bet)
Seat 2: Rulet345 folded before Flop (didn't bet)
Seat 3: Leason22 folded before Flop (didn't bet)
Seat 4: bjolla folded before Flop (didn't bet)
Seat 6: MR.PATJEW folded before Flop (didn't bet)
Seat 7: sonova (button) folded before Flop (didn't bet)
Seat 8: aksh3n (small blind) collected ($1)
Seat 9: fragonik (big blind) folded before Flop



PokerStars Hand #228687595112:  Hold'em No Limit ($0.25/$0.50 USD) - 2021/07/30 15:54:24 ET
Table 'Gorgo III' 9-max Seat #8 is the button
Seat 1: gustguaira ($51.59 in chips) 
Seat 2: Rulet345 ($53.15 in chips) 
Seat 3: Leason22 ($24.25 in chips) 
Seat 4: bjolla ($48.25 in chips) 
Seat 6: MR.PATJEW ($110 in chips) 
Seat 7: sonova ($97.75 in chips) 
Seat 8: aksh3n ($53.45 in chips) 
Seat 9: fragonik ($50.51 in chips) 
fragonik: posts small blind $0.25
gustguaira: posts big blind $0.50
*** HOLE CARDS ***
Rulet345: folds 
Leason22: folds 
bjolla: raises $0.60 to $1.10
MR.PATJEW: folds 
sonova: folds 
aksh3n: folds 
fragonik: folds 
gustguaira: folds 
Uncalled bet ($0.60) returned to bjolla
bjolla collected $1.25 from pot
bjolla: doesn't show hand 
*** SUMMARY ***
Total pot $1.25 | Rake $0 
Seat 1: gustguaira (big blind) folded before Flop
Seat 2: Rulet345 folded before Flop (didn't bet)
Seat 3: Leason22 folded before Flop (didn't bet)
Seat 4: bjolla collected ($1.25)
Seat 6: MR.PATJEW folded before Flop (didn't bet)
Seat 7: sonova folded before Flop (didn't bet)
Seat 8: aksh3n (button) folded before Flop (didn't bet)
Seat 9: fragonik (small blind) folded before Flop



PokerStars Hand #228687607899:  Hold'em No Limit ($0.25/$0.50 USD) - 2021/07/30 15:54:52 ET
Table 'Gorgo III' 9-max Seat #9 is the button
Seat 1: gustguaira ($51.09 in chips) 
Seat 2: Rulet345 ($53.15 in chips) 
Seat 3: Leason22 ($24.25 in chips) 
Seat 4: bjolla ($49 in chips) 
Seat 6: MR.PATJEW ($110 in chips) 
Seat 7: sonova ($97.75 in chips) 
Seat 8: aksh3n ($53.45 in chips) 
Seat 9: fragonik ($50.26 in chips) 
gustguaira: posts small blind $0.25
Rulet345: posts big blind $0.50
*** HOLE CARDS ***
Leason22: folds 
bjolla: folds 
MR.PATJEW: folds 
sonova: folds 
aksh3n: raises $0.60 to $1.10
fragonik: folds 
gustguaira: folds 
Rulet345: folds 
Uncalled bet ($0.60) returned to aksh3n
aksh3n collected $1.25 from pot
aksh3n: doesn't show hand 
*** SUMMARY ***
Total pot $1.25 | Rake $0 
Seat 1: gustguaira (small blind) folded before Flop
Seat 2: Rulet345 (big blind) folded before Flop
Seat 3: Leason22 folded before Flop (didn't bet)
Seat 4: bjolla folded before Flop (didn't bet)
Seat 6: MR.PATJEW folded before Flop (didn't bet)
Seat 7: sonova folded before Flop (didn't bet)
Seat 8: aksh3n collected ($1.25)
Seat 9: fragonik (button) folded before Flop (didn't bet)



PokerStars Hand #228687616936:  Hold'em No Limit ($0.25/$0.50 USD) - 2021/07/30 15:55:13 ET
Table 'Gorgo III' 9-max Seat #1 is the button
Seat 1: gustguaira ($50.84 in chips) 
Seat 2: Rulet345 ($52.65 in chips) 
Seat 3: Leason22 ($24.25 in chips) 
Seat 4: bjolla ($49 in chips) 
Seat 6: MR.PATJEW ($110 in chips) 
Seat 7: sonova ($97.75 in chips) 
Seat 8: aksh3n ($54.20 in chips) 
Seat 9: fragonik ($50.26 in chips) 
Rulet345: posts small blind $0.25
Leason22: posts big blind $0.50
*** HOLE CARDS ***
bjolla: folds 
MR.PATJEW: folds 
sonova: folds 
aksh3n: folds 
fragonik: folds 
gustguaira: folds 
Rulet345: folds 
Uncalled bet ($0.25) returned to Leason22
Leason22 collected $0.50 from pot
*** SUMMARY ***
Total pot $0.50 | Rake $0 
Seat 1: gustguaira (button) folded before Flop (didn't bet)
Seat 2: Rulet345 (small blind) folded before Flop
Seat 3: Leason22 (big blind) collected ($0.50)
Seat 4: bjolla folded before Flop (didn't bet)
Seat 6: MR.PATJEW folded before Flop (didn't bet)
Seat 7: sonova folded before Flop (didn't bet)
Seat 8: aksh3n folded before Flop (didn't bet)
Seat 9: fragonik folded before Flop (didn't bet)



PokerStars Hand #228687623443:  Hold'em No Limit ($0.25/$0.50 USD) - 2021/07/30 15:55:33 ET
Table 'Gorgo III' 9-max Seat #2 is the button
Seat 1: gustguaira ($50.84 in chips) 
Seat 2: Rulet345 ($52.40 in chips) 
Seat 3: Leason22 ($24.50 in chips) 
Seat 4: bjolla ($49 in chips) 
Seat 6: MR.PATJEW ($110 in chips) 
Seat 7: sonova ($97.75 in chips) 
Seat 8: aksh3n ($54.20 in chips) 
Seat 9: fragonik ($50.26 in chips) 
Leason22: posts small blind $0.25
bjolla: posts big blind $0.50
*** HOLE CARDS ***
MR.PATJEW: folds 
sonova: folds 
aksh3n: folds 
fragonik: folds 
gustguaira: folds 
Rulet345: raises $0.75 to $1.25
Leason22: folds 
bjolla: folds 
Uncalled bet ($0.75) returned to Rulet345
Rulet345 collected $1.25 from pot
Rulet345: doesn't show hand 
*** SUMMARY ***
Total pot $1.25 | Rake $0 
Seat 1: gustguaira folded before Flop (didn't bet)
Seat 2: Rulet345 (button) collected ($1.25)
Seat 3: Leason22 (small blind) folded before Flop
Seat 4: bjolla (big blind) folded before Flop
Seat 6: MR.PATJEW folded before Flop (didn't bet)
Seat 7: sonova folded before Flop (didn't bet)
Seat 8: aksh3n folded before Flop (didn't bet)
Seat 9: fragonik folded before Flop (didn't bet)



PokerStars Hand #228687631079:  Hold'em No Limit ($0.25/$0.50 USD) - 2021/07/30 15:55:56 ET
Table 'Gorgo III' 9-max Seat #3 is the button
Seat 1: gustguaira ($50.84 in chips) 
Seat 2: Rulet345 ($53.15 in chips) 
Seat 3: Leason22 ($24.25 in chips) 
Seat 4: bjolla ($48.50 in chips) 
Seat 6: MR.PATJEW ($110 in chips) 
Seat 7: sonova ($97.75 in chips) 
Seat 8: aksh3n ($54.20 in chips) 
Seat 9: fragonik ($50.26 in chips) 
bjolla: posts small blind $0.25
MR.PATJEW: posts big blind $0.50
*** HOLE CARDS ***
sonova: raises $0.65 to $1.15
aksh3n: folds 
fragonik: folds 
gustguaira: folds 
Rulet345: folds 
Leason22: folds 
bjolla: folds 
MR.PATJEW: folds 
Uncalled bet ($0.65) returned to sonova
sonova collected $1.25 from pot
sonova: doesn't show hand 
*** SUMMARY ***
Total pot $1.25 | Rake $0 
Seat 1: gustguaira folded before Flop (didn't bet)
Seat 2: Rulet345 folded before Flop (didn't bet)
Seat 3: Leason22 (button) folded before Flop (didn't bet)
Seat 4: bjolla (small blind) folded before Flop
Seat 6: MR.PATJEW (big blind) folded before Flop
Seat 7: sonova collected ($1.25)
Seat 8: aksh3n folded before Flop (didn't bet)
Seat 9: fragonik folded before Flop (didn't bet)



PokerStars Hand #228687635535:  Hold'em No Limit ($0.25/$0.50 USD) - 2021/07/30 15:56:10 ET
Table 'Gorgo III' 9-max Seat #4 is the button
Seat 1: gustguaira ($50.84 in chips) 
Seat 2: Rulet345 ($53.15 in chips) 
Seat 3: Leason22 ($24.25 in chips) 
Seat 4: bjolla ($48.25 in chips) 
Seat 6: MR.PATJEW ($109.50 in chips) 
Seat 7: sonova ($98.50 in chips) 
Seat 8: aksh3n ($54.20 in chips) 
Seat 9: fragonik ($50.26 in chips) 
MR.PATJEW: posts small blind $0.25
sonova: posts big blind $0.50
*** HOLE CARDS ***
aksh3n: folds 
fragonik: folds 
gustguaira: calls $0.50
Rulet345: folds 
Leason22: folds 
bjolla: folds 
MR.PATJEW: folds 
sonova: raises $1.50 to $2
gustguaira: calls $1.50
*** FLOP *** [8s 9d 3d]
sonova: bets $2.75
gustguaira: calls $2.75
*** TURN *** [8s 9d 3d] [Qc]
sonova: checks 
gustguaira: bets $4.63
sonova: calls $4.63
*** RIVER *** [8s 9d 3d Qc] [8h]
sonova: checks 
gustguaira: bets $9.03
sonova: calls $9.03
*** SHOW DOWN ***
gustguaira: shows [Ts Qd] (two pair, Queens and Eights)
sonova: mucks hand 
gustguaira collected $35.22 from pot
*** SUMMARY ***
Total pot $37.07 | Rake $1.85 
Board [8s 9d 3d Qc 8h]
Seat 1: gustguaira showed [Ts Qd] and won ($35.22) with two pair, Queens and Eights
Seat 2: Rulet345 folded before Flop (didn't bet)
Seat 3: Leason22 folded before Flop (didn't bet)
Seat 4: bjolla (button) folded before Flop (didn't bet)
Seat 6: MR.PATJEW (small blind) folded before Flop
Seat 7: sonova (big blind) mucked
Seat 8: aksh3n folded before Flop (didn't bet)
Seat 9: fragonik folded before Flop (didn't bet)



PokerStars Hand #228687651508:  Hold'em No Limit ($0.25/$0.50 USD) - 2021/07/30 15:56:59 ET
Table 'Gorgo III' 9-max Seat #6 is the button
Seat 1: gustguaira ($67.65 in chips) 
Seat 2: Rulet345 ($53.15 in chips) 
Seat 3: Leason22 ($24.25 in chips) 
Seat 4: bjolla ($48.25 in chips) 
Seat 6: MR.PATJEW ($109.25 in chips) 
Seat 7: sonova ($80.09 in chips) 
Seat 8: aksh3n ($54.20 in chips) 
Seat 9: fragonik ($50.26 in chips) 
sonova: posts small blind $0.25
aksh3n: posts big blind $0.50
*** HOLE CARDS ***
fragonik: folds 
gustguaira: folds 
Rulet345: raises $1 to $1.50
Leason22: folds 
bjolla: folds 
MR.PATJEW: folds 
sonova: calls $1.25
aksh3n: folds 
*** FLOP *** [2s 8d Kc]
sonova: checks 
Rulet345: bets $1.10
sonova: calls $1.10
*** TURN *** [2s 8d Kc] [9h]
sonova: checks 
Rulet345: bets $3.61
sonova: folds 
Uncalled bet ($3.61) returned to Rulet345
Rulet345 collected $5.42 from pot
Rulet345: doesn't show hand 
*** SUMMARY ***
Total pot $5.70 | Rake $0.28 
Board [2s 8d Kc 9h]
Seat 1: gustguaira folded before Flop (didn't bet)
Seat 2: Rulet345 collected ($5.42)
Seat 3: Leason22 folded before Flop (didn't bet)
Seat 4: bjolla folded before Flop (didn't bet)
Seat 6: MR.PATJEW (button) folded before Flop (didn't bet)
Seat 7: sonova (small blind) folded on the Turn
Seat 8: aksh3n (big blind) folded before Flop
Seat 9: fragonik folded before Flop (didn't bet)



PokerStars Hand #228687672705:  Hold'em No Limit ($0.25/$0.50 USD) - 2021/07/30 15:58:03 ET
Table 'Gorgo III' 9-max Seat #7 is the button
Seat 1: gustguaira ($67.65 in chips) 
Seat 2: Rulet345 ($55.97 in chips) 
Seat 3: Leason22 ($24.25 in chips) 
Seat 4: bjolla ($48.25 in chips) 
Seat 6: MR.PATJEW ($109.25 in chips) 
Seat 7: sonova ($77.49 in chips) 
Seat 8: aksh3n ($53.70 in chips) 
Seat 9: fragonik ($50.26 in chips) 
aksh3n: posts small blind $0.25
fragonik: posts big blind $0.50
*** HOLE CARDS ***
gustguaira: folds 
Rulet345: folds 
Leason22: folds 
bjolla: folds 
MR.PATJEW has timed out
MR.PATJEW: folds 
sonova: folds 
aksh3n: folds 
Uncalled bet ($0.25) returned to fragonik
fragonik collected $0.50 from pot
*** SUMMARY ***
Total pot $0.50 | Rake $0 
Seat 1: gustguaira folded before Flop (didn't bet)
Seat 2: Rulet345 folded before Flop (didn't bet)
Seat 3: Leason22 folded before Flop (didn't bet)
Seat 4: bjolla folded before Flop (didn't bet)
Seat 6: MR.PATJEW folded before Flop (didn't bet)
Seat 7: sonova (button) folded before Flop (didn't bet)
Seat 8: aksh3n (small blind) folded before Flop
Seat 9: fragonik (big blind) collected ($0.50)



PokerStars Hand #228687679542:  Hold'em No Limit ($0.25/$0.50 USD) - 2021/07/30 15:58:23 ET
Table 'Gorgo III' 9-max Seat #8 is the button
Seat 1: gustguaira ($67.65 in chips) 
Seat 2: Rulet345 ($55.97 in chips) 
Seat 3: Leason22 ($24.25 in chips) 
Seat 4: bjolla ($48.25 in chips) 
Seat 6: MR.PATJEW ($109.25 in chips) 
Seat 7: sonova ($77.49 in chips) 
Seat 8: aksh3n ($53.45 in chips) 
Seat 9: fragonik ($50.51 in chips) 
fragonik: posts small blind $0.25
gustguaira: posts big blind $0.50
*** HOLE CARDS ***
Rulet345: folds 
Leason22: folds 
bjolla: folds 
MR.PATJEW: folds 
sonova: raises $0.75 to $1.25
aksh3n: folds 
fragonik: folds 
gustguaira: folds 
Uncalled bet ($0.75) returned to sonova
sonova collected $1.25 from pot
sonova: doesn't show hand 
*** SUMMARY ***
Total pot $1.25 | Rake $0 
Seat 1: gustguaira (big blind) folded before Flop
Seat 2: Rulet345 folded before Flop (didn't bet)
Seat 3: Leason22 folded before Flop (didn't bet)
Seat 4: bjolla folded before Flop (didn't bet)
Seat 6: MR.PATJEW folded before Flop (didn't bet)
Seat 7: sonova collected ($1.25)
Seat 8: aksh3n (button) folded before Flop (didn't bet)
Seat 9: fragonik (small blind) folded before Flop



PokerStars Hand #228687685086:  Hold'em No Limit ($0.25/$0.50 USD) - 2021/07/30 15:58:40 ET
Table 'Gorgo III' 9-max Seat #9 is the button
Seat 1: gustguaira ($67.15 in chips) 
Seat 2: Rulet345 ($55.97 in chips) 
Seat 3: Leason22 ($24.25 in chips) 
Seat 4: bjolla ($48.25 in chips) 
Seat 6: MR.PATJEW ($109.25 in chips) 
Seat 7: sonova ($78.24 in chips) 
Seat 8: aksh3n ($53.45 in chips) 
Seat 9: fragonik ($50.26 in chips) 
gustguaira: posts small blind $0.25
Rulet345: posts big blind $0.50
*** HOLE CARDS ***
Leason22: folds 
bjolla: folds 
MR.PATJEW: folds 
sonova: raises $0.75 to $1.25
aksh3n: folds 
fragonik: raises $2.50 to $3.75
gustguaira: folds 
Rulet345: folds 
sonova: calls $2.50
*** FLOP *** [6h 6s 7s]
sonova: checks 
fragonik: bets $2.59
sonova: calls $2.59
*** TURN *** [6h 6s 7s] [7h]
sonova: checks 
fragonik: checks 
*** RIVER *** [6h 6s 7s 7h] [2h]
sonova: checks 
fragonik: checks 
*** SHOW DOWN ***
sonova: shows [Js Jc] (two pair, Jacks and Sevens)
fragonik: mucks hand 
sonova collected $12.76 from pot
*** SUMMARY ***
Total pot $13.43 | Rake $0.67 
Board [6h 6s 7s 7h 2h]
Seat 1: gustguaira (small blind) folded before Flop
Seat 2: Rulet345 (big blind) folded before Flop
Seat 3: Leason22 folded before Flop (didn't bet)
Seat 4: bjolla folded before Flop (didn't bet)
Seat 6: MR.PATJEW folded before Flop (didn't bet)
Seat 7: sonova showed [Js Jc] and won ($12.76) with two pair, Jacks and Sevens
Seat 8: aksh3n folded before Flop (didn't bet)
Seat 9: fragonik (button) mucked



PokerStars Hand #228687708948:  Hold'em No Limit ($0.25/$0.50 USD) - 2021/07/30 15:59:51 ET
Table 'Gorgo III' 9-max Seat #1 is the button
Seat 1: gustguaira ($66.90 in chips) 
Seat 2: Rulet345 ($55.47 in chips) 
Seat 3: Leason22 ($24.25 in chips) 
Seat 4: bjolla ($48.25 in chips) 
Seat 6: MR.PATJEW ($109.25 in chips) 
Seat 7: sonova ($84.66 in chips) 
Seat 8: aksh3n ($53.45 in chips) 
Seat 9: fragonik ($50 in chips) 
Rulet345: posts small blind $0.25
Leason22: posts big blind $0.50
*** HOLE CARDS ***
bjolla: folds 
MR.PATJEW: calls $0.50
sonova: folds 
aksh3n: folds 
fragonik: raises $1.25 to $1.75
gustguaira: folds 
Rulet345: folds 
Leason22: folds 
MR.PATJEW: calls $1.25
*** FLOP *** [4s 6c 7c]
MR.PATJEW: checks 
fragonik: bets $1.25
MR.PATJEW: calls $1.25
*** TURN *** [4s 6c 7c] [7h]
MR.PATJEW: checks 
fragonik: bets $2.12
MR.PATJEW: folds 
Uncalled bet ($2.12) returned to fragonik
fragonik collected $6.41 from pot
*** SUMMARY ***
Total pot $6.75 | Rake $0.34 
Board [4s 6c 7c 7h]
Seat 1: gustguaira (button) folded before Flop (didn't bet)
Seat 2: Rulet345 (small blind) folded before Flop
Seat 3: Leason22 (big blind) folded before Flop
Seat 4: bjolla folded before Flop (didn't bet)
Seat 6: MR.PATJEW folded on the Turn
Seat 7: sonova folded before Flop (didn't bet)
Seat 8: aksh3n folded before Flop (didn't bet)
Seat 9: fragonik collected ($6.41)



PokerStars Hand #228687742906:  Hold'em No Limit ($0.25/$0.50 USD) - 2021/07/30 16:01:21 ET
Table 'Gorgo III' 9-max Seat #2 is the button
Seat 1: gustguaira ($66.90 in chips) 
Seat 2: Rulet345 ($55.22 in chips) 
Seat 3: Leason22 ($23.75 in chips) 
Seat 4: bjolla ($48.25 in chips) 
Seat 6: MR.PATJEW ($106.25 in chips) 
Seat 7: sonova ($84.66 in chips) 
Seat 8: aksh3n ($53.45 in chips) 
Seat 9: fragonik ($53.41 in chips) 
Leason22: posts small blind $0.25
bjolla: posts big blind $0.50
Bolshoy ku33: sits out 
*** HOLE CARDS ***
MR.PATJEW: folds 
sonova: folds 
aksh3n: folds 
fragonik: folds 
gustguaira: folds 
Rulet345: folds 
Leason22: folds 
Uncalled bet ($0.25) returned to bjolla
bjolla collected $0.50 from pot
bjolla: doesn't show hand 
*** SUMMARY ***
Total pot $0.50 | Rake $0 
Seat 1: gustguaira folded before Flop (didn't bet)
Seat 2: Rulet345 (button) folded before Flop (didn't bet)
Seat 3: Leason22 (small blind) folded before Flop
Seat 4: bjolla (big blind) collected ($0.50)
Seat 6: MR.PATJEW folded before Flop (didn't bet)
Seat 7: sonova folded before Flop (didn't bet)
Seat 8: aksh3n folded before Flop (didn't bet)
Seat 9: fragonik folded before Flop (didn't bet)



PokerStars Hand #228687750954:  Hold'em No Limit ($0.25/$0.50 USD) - 2021/07/30 16:01:41 ET
Table 'Gorgo III' 9-max Seat #3 is the button
Seat 1: gustguaira ($66.90 in chips) 
Seat 2: Rulet345 ($55.22 in chips) 
Seat 3: Leason22 ($23.50 in chips) 
Seat 4: bjolla ($48.50 in chips) 
Seat 5: Bolshoy ku33 ($50 in chips) 
Seat 6: MR.PATJEW ($106.25 in chips) 
Seat 7: sonova ($84.66 in chips) 
Seat 8: aksh3n ($53.45 in chips) 
Seat 9: fragonik ($53.41 in chips) 
bjolla: posts small blind $0.25
Bolshoy ku33: posts big blind $0.50
*** HOLE CARDS ***
MR.PATJEW: folds 
sonova: folds 
aksh3n: folds 
fragonik: folds 
gustguaira: folds 
Rulet345: raises $0.75 to $1.25
Leason22: folds 
bjolla: folds 
Bolshoy ku33: raises $5.25 to $6.50
Rulet345: folds 
Uncalled bet ($5.25) returned to Bolshoy ku33
Bolshoy ku33 collected $2.75 from pot
Bolshoy ku33: doesn't show hand 
*** SUMMARY ***
Total pot $2.75 | Rake $0 
Seat 1: gustguaira folded before Flop (didn't bet)
Seat 2: Rulet345 folded before Flop
Seat 3: Leason22 (button) folded before Flop (didn't bet)
Seat 4: bjolla (small blind) folded before Flop
Seat 5: Bolshoy ku33 (big blind) collected ($2.75)
Seat 6: MR.PATJEW folded before Flop (didn't bet)
Seat 7: sonova folded before Flop (didn't bet)
Seat 8: aksh3n folded before Flop (didn't bet)
Seat 9: fragonik folded before Flop (didn't bet)



PokerStars Hand #228687765090:  Hold'em No Limit ($0.25/$0.50 USD) - 2021/07/30 16:02:11 ET
Table 'Gorgo III' 9-max Seat #4 is the button
Seat 1: gustguaira ($66.90 in chips) 
Seat 2: Rulet345 ($53.97 in chips) 
Seat 3: Leason22 ($23.50 in chips) 
Seat 4: bjolla ($48.25 in chips) 
Seat 5: Bolshoy ku33 ($51.50 in chips) 
Seat 6: MR.PATJEW ($106.25 in chips) 
Seat 7: sonova ($84.66 in chips) 
Seat 8: aksh3n ($53.45 in chips) 
Seat 9: fragonik ($53.41 in chips) 
Bolshoy ku33: posts small blind $0.25
MR.PATJEW: posts big blind $0.50
*** HOLE CARDS ***
sonova: folds 
aksh3n: folds 
fragonik: raises $0.75 to $1.25
gustguaira: folds 
Rulet345: folds 
Leason22: folds 
bjolla: folds 
Bolshoy ku33: calls $1
MR.PATJEW: calls $0.75
*** FLOP *** [9c Td 3s]
Bolshoy ku33: checks 
MR.PATJEW: bets $3.56
fragonik: folds 
Bolshoy ku33: raises $5.94 to $9.50
MR.PATJEW: calls $5.94
*** TURN *** [9c Td 3s] [4c]
Bolshoy ku33: checks 
MR.PATJEW: checks 
*** RIVER *** [9c Td 3s 4c] [2c]
Bolshoy ku33: bets $40.75 and is all-in
MR.PATJEW: folds 
Uncalled bet ($40.75) returned to Bolshoy ku33
Bolshoy ku33 collected $21.61 from pot
Bolshoy ku33: doesn't show hand 
*** SUMMARY ***
Total pot $22.75 | Rake $1.14 
Board [9c Td 3s 4c 2c]
Seat 1: gustguaira folded before Flop (didn't bet)
Seat 2: Rulet345 folded before Flop (didn't bet)
Seat 3: Leason22 folded before Flop (didn't bet)
Seat 4: bjolla (button) folded before Flop (didn't bet)
Seat 5: Bolshoy ku33 (small blind) collected ($21.61)
Seat 6: MR.PATJEW (big blind) folded on the River
Seat 7: sonova folded before Flop (didn't bet)
Seat 8: aksh3n folded before Flop (didn't bet)
Seat 9: fragonik folded on the Flop



PokerStars Hand #228687807923:  Hold'em No Limit ($0.25/$0.50 USD) - 2021/07/30 16:03:45 ET
Table 'Gorgo III' 9-max Seat #5 is the button
Seat 1: gustguaira ($66.90 in chips) 
Seat 2: Rulet345 ($53.97 in chips) 
Seat 3: Leason22 ($23.50 in chips) 
Seat 4: bjolla ($48.25 in chips) 
Seat 5: Bolshoy ku33 ($62.36 in chips) 
Seat 6: MR.PATJEW ($95.50 in chips) 
Seat 7: sonova ($84.66 in chips) 
Seat 8: aksh3n ($53.45 in chips) 
Seat 9: fragonik ($52.16 in chips) 
MR.PATJEW: posts small blind $0.25
sonova: posts big blind $0.50
*** HOLE CARDS ***
aksh3n: raises $0.60 to $1.10
fragonik: folds 
gustguaira: folds 
Rulet345: folds 
Leason22: folds 
bjolla: folds 
Bolshoy ku33: folds 
MR.PATJEW: folds 
sonova: folds 
Uncalled bet ($0.60) returned to aksh3n
aksh3n collected $1.25 from pot
aksh3n: doesn't show hand 
*** SUMMARY ***
Total pot $1.25 | Rake $0 
Seat 1: gustguaira folded before Flop (didn't bet)
Seat 2: Rulet345 folded before Flop (didn't bet)
Seat 3: Leason22 folded before Flop (didn't bet)
Seat 4: bjolla folded before Flop (didn't bet)
Seat 5: Bolshoy ku33 (button) folded before Flop (didn't bet)
Seat 6: MR.PATJEW (small blind) folded before Flop
Seat 7: sonova (big blind) folded before Flop
Seat 8: aksh3n collected ($1.25)
Seat 9: fragonik folded before Flop (didn't bet)



PokerStars Hand #228687814918:  Hold'em No Limit ($0.25/$0.50 USD) - 2021/07/30 16:04:01 ET
Table 'Gorgo III' 9-max Seat #6 is the button
Seat 1: gustguaira ($66.90 in chips) 
Seat 2: Rulet345 ($53.97 in chips) 
Seat 3: Leason22 ($23.50 in chips) 
Seat 4: bjolla ($48.25 in chips) 
Seat 5: Bolshoy ku33 ($62.36 in chips) 
Seat 6: MR.PATJEW ($95.25 in chips) 
Seat 7: sonova ($84.16 in chips) 
Seat 8: aksh3n ($54.20 in chips) 
Seat 9: fragonik ($52.16 in chips) 
sonova: posts small blind $0.25
aksh3n: posts big blind $0.50
*** HOLE CARDS ***
fragonik: folds 
gustguaira has timed out
gustguaira: folds 
Rulet345: folds 
Leason22: folds 
bjolla: folds 
Bolshoy ku33: raises $1 to $1.50
MR.PATJEW: calls $1.50
sonova: raises $6.50 to $8
aksh3n: folds 
Bolshoy ku33: raises $54.36 to $62.36 and is all-in
MR.PATJEW: folds 
sonova: calls $54.36
*** FLOP *** [4s 5h 3h]
*** TURN *** [4s 5h 3h] [Ah]
*** RIVER *** [4s 5h 3h Ah] [3s]
*** SHOW DOWN ***
sonova: shows [Jc Jh] (two pair, Jacks and Threes)
Bolshoy ku33: shows [Qd 9d] (a pair of Threes)
sonova cashed out the hand for $83.50 | Cash Out Fee $0.84
*** SUMMARY ***
Total pot $126.72 | Rake $2 
Board [4s 5h 3h Ah 3s]
Seat 1: gustguaira folded before Flop (didn't bet)
Seat 2: Rulet345 folded before Flop (didn't bet)
Seat 3: Leason22 folded before Flop (didn't bet)
Seat 4: bjolla folded before Flop (didn't bet)
Seat 5: Bolshoy ku33 showed [Qd 9d] and lost with a pair of Threes
Seat 6: MR.PATJEW (button) folded before Flop
Seat 7: sonova (small blind) showed [Jc Jh] and won ($124.72) with two pair, Jacks and Threes (pot not awarded as player cashed out)
Seat 8: aksh3n (big blind) folded before Flop
Seat 9: fragonik folded before Flop (didn't bet)



PokerStars Hand #228687845456:  Hold'em No Limit ($0.25/$0.50 USD) - 2021/07/30 16:05:07 ET
Table 'Gorgo III' 9-max Seat #7 is the button
Seat 1: gustguaira ($66.90 in chips) 
Seat 2: Rulet345 ($53.97 in chips) 
Seat 3: Leason22 ($23.50 in chips) 
Seat 4: bjolla ($48.25 in chips) 
Seat 6: MR.PATJEW ($93.75 in chips) 
Seat 7: sonova ($105.30 in chips) 
Seat 8: aksh3n ($53.70 in chips) 
aksh3n: posts small blind $0.25
fragonik: is sitting out 
gustguaira: posts big blind $0.50
*** HOLE CARDS ***
Rulet345: folds 
Leason22: folds 
bjolla: folds 
Bolshoy ku33 leaves the table
MR.PATJEW: calls $0.50
sonova: folds 
aksh3n: folds 
gustguaira: raises $1 to $1.50
MR.PATJEW: calls $1
*** FLOP *** [5c 7d Td]
gustguaira: checks 
MR.PATJEW: checks 
*** TURN *** [5c 7d Td] [3d]
gustguaira: checks 
MR.PATJEW: bets $1.54
gustguaira: folds 
Uncalled bet ($1.54) returned to MR.PATJEW
MR.PATJEW collected $3.09 from pot
MR.PATJEW: doesn't show hand 
*** SUMMARY ***
Total pot $3.25 | Rake $0.16 
Board [5c 7d Td 3d]
Seat 1: gustguaira (big blind) folded on the Turn
Seat 2: Rulet345 folded before Flop (didn't bet)
Seat 3: Leason22 folded before Flop (didn't bet)
Seat 4: bjolla folded before Flop (didn't bet)
Seat 6: MR.PATJEW collected ($3.09)
Seat 7: sonova (button) folded before Flop (didn't bet)
Seat 8: aksh3n (small blind) folded before Flop



PokerStars Hand #228687869083:  Hold'em No Limit ($0.25/$0.50 USD) - 2021/07/30 16:05:57 ET
Table 'Gorgo III' 9-max Seat #8 is the button
Seat 1: gustguaira ($65.40 in chips) 
Seat 3: Leason22 ($23.50 in chips) 
Seat 4: bjolla ($48.25 in chips) 
Seat 6: MR.PATJEW ($95.34 in chips) 
Seat 7: sonova ($105.30 in chips) 
Seat 8: aksh3n ($53.45 in chips) 
gustguaira: posts small blind $0.25
Rulet345: is sitting out 
Leason22: posts big blind $0.50
*** HOLE CARDS ***
bjolla: folds 
MR.PATJEW: raises $0.50 to $1
sonova: folds 
aksh3n: folds 
gustguaira: folds 
Leason22: folds 
Uncalled bet ($0.50) returned to MR.PATJEW
MR.PATJEW collected $1.25 from pot
MR.PATJEW: doesn't show hand 
*** SUMMARY ***
Total pot $1.25 | Rake $0 
Seat 1: gustguaira (small blind) folded before Flop
Seat 3: Leason22 (big blind) folded before Flop
Seat 4: bjolla folded before Flop (didn't bet)
Seat 6: MR.PATJEW collected ($1.25)
Seat 7: sonova folded before Flop (didn't bet)
Seat 8: aksh3n (button) folded before Flop (didn't bet)



PokerStars Hand #228687878324:  Hold'em No Limit ($0.25/$0.50 USD) - 2021/07/30 16:06:17 ET
Table 'Gorgo III' 9-max Seat #1 is the button
Seat 1: gustguaira ($65.15 in chips) 
Seat 3: Leason22 ($23 in chips) 
Seat 4: bjolla ($48.25 in chips) 
Seat 6: MR.PATJEW ($96.09 in chips) 
Seat 7: sonova ($105.30 in chips) 
Seat 8: aksh3n ($53.45 in chips) 
Leason22: posts small blind $0.25
bjolla: posts big blind $0.50
*** HOLE CARDS ***
MR.PATJEW has timed out
MR.PATJEW: folds 
sonova: folds 
aksh3n: raises $0.60 to $1.10
gustguaira: folds 
Leason22: folds 
bjolla: calls $0.60
*** FLOP *** [4d 9c Qs]
bjolla: checks 
aksh3n: checks 
*** TURN *** [4d 9c Qs] [8h]
bjolla: bets $1.68
aksh3n: calls $1.68
*** RIVER *** [4d 9c Qs 8h] [3d]
bjolla: bets $5.50
aksh3n: raises $11 to $16.50
bjolla: raises $28.97 to $45.47 and is all-in
funker84 joins the table at seat #5 
Rulet345 leaves the table
aksh3n: folds 
Uncalled bet ($28.97) returned to bjolla
bjolla collected $36.87 from pot
bjolla: doesn't show hand 
*** SUMMARY ***
Total pot $38.81 | Rake $1.94 
Board [4d 9c Qs 8h 3d]
Seat 1: gustguaira (button) folded before Flop (didn't bet)
Seat 3: Leason22 (small blind) folded before Flop
Seat 4: bjolla (big blind) collected ($36.87)
Seat 6: MR.PATJEW folded before Flop (didn't bet)
Seat 7: sonova folded before Flop (didn't bet)
Seat 8: aksh3n folded on the River



PokerStars Hand #228687919130:  Hold'em No Limit ($0.25/$0.50 USD) - 2021/07/30 16:07:28 ET
Table 'Gorgo III' 9-max Seat #3 is the button
Seat 1: gustguaira ($65.15 in chips) 
Seat 3: Leason22 ($22.75 in chips) 
Seat 4: bjolla ($65.84 in chips) 
Seat 5: funker84 ($40 in chips) 
Seat 6: MR.PATJEW ($96.09 in chips) 
Seat 7: sonova ($105.30 in chips) 
Seat 8: aksh3n ($50 in chips) 
bjolla: posts small blind $0.25
funker84: posts big blind $0.50
*** HOLE CARDS ***
MR.PATJEW: raises $1 to $1.50
sonova: folds 
aksh3n: folds 
gustguaira: calls $1.50
Leason22: folds 
bjolla: folds 
funker84: folds 
*** FLOP *** [Qd 2c Tc]
MR.PATJEW: checks 
gustguaira: bets $1.78
MR.PATJEW: calls $1.78
*** TURN *** [Qd 2c Tc] [4c]
MR.PATJEW: checks 
gustguaira: bets $3.47
MR.PATJEW: folds 
Uncalled bet ($3.47) returned to gustguaira
gustguaira collected $6.94 from pot
gustguaira: doesn't show hand 
*** SUMMARY ***
Total pot $7.31 | Rake $0.37 
Board [Qd 2c Tc 4c]
Seat 1: gustguaira collected ($6.94)
Seat 3: Leason22 (button) folded before Flop (didn't bet)
Seat 4: bjolla (small blind) folded before Flop
Seat 5: funker84 (big blind) folded before Flop
Seat 6: MR.PATJEW folded on the Turn
Seat 7: sonova folded before Flop (didn't bet)
Seat 8: aksh3n folded before Flop (didn't bet)



PokerStars Hand #228687937895:  Hold'em No Limit ($0.25/$0.50 USD) - 2021/07/30 16:08:08 ET
Table 'Gorgo III' 9-max Seat #4 is the button
Seat 1: gustguaira ($68.81 in chips) 
Seat 3: Leason22 ($22.75 in chips) 
Seat 4: bjolla ($65.59 in chips) 
Seat 5: funker84 ($39.50 in chips) 
Seat 6: MR.PATJEW ($92.81 in chips) 
Seat 7: sonova ($105.30 in chips) 
Seat 8: aksh3n ($50 in chips) 
funker84: posts small blind $0.25
MR.PATJEW: posts big blind $0.50
*** HOLE CARDS ***
sonova: folds 
aksh3n: folds 
gustguaira: folds 
Leason22: folds 
inflexiblle joins the table at seat #2 
bjolla: folds 
funker84: raises $0.50 to $1
MR.PATJEW: folds 
Uncalled bet ($0.50) returned to funker84
funker84 collected $1 from pot
funker84: doesn't show hand 
*** SUMMARY ***
Total pot $1 | Rake $0 
Seat 1: gustguaira folded before Flop (didn't bet)
Seat 3: Leason22 folded before Flop (didn't bet)
Seat 4: bjolla (button) folded before Flop (didn't bet)
Seat 5: funker84 (small blind) collected ($1)
Seat 6: MR.PATJEW (big blind) folded before Flop
Seat 7: sonova folded before Flop (didn't bet)
Seat 8: aksh3n folded before Flop (didn't bet)



PokerStars Hand #228687946542:  Hold'em No Limit ($0.25/$0.50 USD) - 2021/07/30 16:08:26 ET
Table 'Gorgo III' 9-max Seat #5 is the button
Seat 1: gustguaira ($68.81 in chips) 
Seat 3: Leason22 ($22.75 in chips) 
Seat 4: bjolla ($65.59 in chips) 
Seat 5: funker84 ($40 in chips) 
Seat 6: MR.PATJEW ($92.31 in chips) 
Seat 7: sonova ($105.30 in chips) 
Seat 8: aksh3n ($50 in chips) 
MR.PATJEW: posts small blind $0.25
sonova: posts big blind $0.50
inflexiblle: sits out 
*** HOLE CARDS ***
aksh3n: folds 
gustguaira: folds 
Leason22: raises $1 to $1.50
bjolla: folds 
funker84: folds 
MR.PATJEW: calls $1.25
sonova: folds 
*** FLOP *** [7d 8s 3d]
MR.PATJEW: checks 
Leason22: bets $2
MR.PATJEW: calls $2
*** TURN *** [7d 8s 3d] [Qd]
MR.PATJEW: checks 
Leason22: bets $7
MR.PATJEW: calls $7
*** RIVER *** [7d 8s 3d Qd] [8d]
MR.PATJEW: checks 
Leason22: bets $12.25 and is all-in
MR.PATJEW: calls $12.25
*** SHOW DOWN ***
Leason22: shows [Kc Kd] (a flush, King high)
MR.PATJEW: shows [Td 9c] (a flush, Queen high)
Leason22 collected $43.50 from pot
*** SUMMARY ***
Total pot $46 | Rake $2.50 
Board [7d 8s 3d Qd 8d]
Seat 1: gustguaira folded before Flop (didn't bet)
Seat 3: Leason22 showed [Kc Kd] and won ($43.50) with a flush, King high
Seat 4: bjolla folded before Flop (didn't bet)
Seat 5: funker84 (button) folded before Flop (didn't bet)
Seat 6: MR.PATJEW (small blind) showed [Td 9c] and lost with a flush, Queen high
Seat 7: sonova (big blind) folded before Flop
Seat 8: aksh3n folded before Flop (didn't bet)



PokerStars Hand #228687970821:  Hold'em No Limit ($0.25/$0.50 USD) - 2021/07/30 16:09:18 ET
Table 'Gorgo III' 9-max Seat #6 is the button
Seat 1: gustguaira ($68.81 in chips) 
Seat 3: Leason22 ($43.50 in chips) 
Seat 4: bjolla ($65.59 in chips) 
Seat 5: funker84 ($40 in chips) 
Seat 6: MR.PATJEW ($69.56 in chips) 
Seat 7: sonova ($104.80 in chips) 
Seat 8: aksh3n ($50 in chips) 
sonova: posts small blind $0.25
aksh3n: posts big blind $0.50
inflexiblle: sits out 
*** HOLE CARDS ***
gustguaira: folds 
Leason22: calls $0.50
bjolla: calls $0.50
funker84: folds 
MR.PATJEW: raises $1 to $1.50
sonova: folds 
aksh3n: folds 
Leason22: calls $1
bjolla: calls $1
*** FLOP *** [9h 9c 9s]
Leason22: checks 
bjolla: bets $2.50
MR.PATJEW: calls $2.50
Leason22: folds 
*** TURN *** [9h 9c 9s] [3h]
bjolla: checks 
MR.PATJEW: checks 
*** RIVER *** [9h 9c 9s 3h] [Jh]
bjolla: checks 
MR.PATJEW: bets $4.87
bjolla: calls $4.87
*** SHOW DOWN ***
MR.PATJEW: shows [Qs Kd] (three of a kind, Nines)
bjolla: shows [7c 7h] (a full house, Nines full of Sevens)
bjolla collected $18.99 from pot
*** SUMMARY ***
Total pot $19.99 | Rake $1 
Board [9h 9c 9s 3h Jh]
Seat 1: gustguaira folded before Flop (didn't bet)
Seat 3: Leason22 folded on the Flop
Seat 4: bjolla showed [7c 7h] and won ($18.99) with a full house, Nines full of Sevens
Seat 5: funker84 folded before Flop (didn't bet)
Seat 6: MR.PATJEW (button) showed [Qs Kd] and lost with three of a kind, Nines
Seat 7: sonova (small blind) folded before Flop
Seat 8: aksh3n (big blind) folded before Flop



PokerStars Hand #228688005517:  Hold'em No Limit ($0.25/$0.50 USD) - 2021/07/30 16:10:33 ET
Table 'Gorgo III' 9-max Seat #7 is the button
Seat 1: gustguaira ($68.81 in chips) 
Seat 3: Leason22 ($42 in chips) 
Seat 5: funker84 ($40 in chips) 
Seat 6: MR.PATJEW ($60.69 in chips) 
Seat 7: sonova ($104.55 in chips) 
Seat 8: aksh3n ($50 in chips) 
aksh3n: posts small blind $0.25
gustguaira: posts big blind $0.50
inflexiblle: sits out 
*** HOLE CARDS ***
bjolla leaves the table
Leason22: folds 
nicu4you joins the table at seat #4 
funker84: folds 
MR.PATJEW: folds 
sonova: folds 
aksh3n: raises $1 to $1.50
gustguaira: calls $1
*** FLOP *** [5d Ac 4h]
aksh3n: bets $0.94
gustguaira: calls $0.94
*** TURN *** [5d Ac 4h] [2c]
aksh3n: checks 
gustguaira: checks 
*** RIVER *** [5d Ac 4h 2c] [7d]
aksh3n: checks 
gustguaira: bets $2.32
aksh3n: folds 
Uncalled bet ($2.32) returned to gustguaira
gustguaira collected $4.64 from pot
gustguaira: doesn't show hand 
*** SUMMARY ***
Total pot $4.88 | Rake $0.24 
Board [5d Ac 4h 2c 7d]
Seat 1: gustguaira (big blind) collected ($4.64)
Seat 3: Leason22 folded before Flop (didn't bet)
Seat 5: funker84 folded before Flop (didn't bet)
Seat 6: MR.PATJEW folded before Flop (didn't bet)
Seat 7: sonova (button) folded before Flop (didn't bet)
Seat 8: aksh3n (small blind) folded on the River



PokerStars Hand #228688024978:  Hold'em No Limit ($0.25/$0.50 USD) - 2021/07/30 16:11:12 ET
Table 'Gorgo III' 9-max Seat #8 is the button
Seat 1: gustguaira ($71.01 in chips) 
Seat 2: inflexiblle ($50 in chips) 
Seat 3: Leason22 ($42 in chips) 
Seat 5: funker84 ($40 in chips) 
Seat 6: MR.PATJEW ($60.69 in chips) 
Seat 7: sonova ($104.55 in chips) 
Seat 8: aksh3n ($50 in chips) 
gustguaira: posts small blind $0.25
inflexiblle: posts big blind $0.50
nicu4you: sits out 
*** HOLE CARDS ***
Leason22: calls $0.50
funker84: folds 
MR.PATJEW: folds 
sonova: folds 
aksh3n: folds 
gustguaira: raises $1 to $1.50
inflexiblle: folds 
Leason22: calls $1
*** FLOP *** [9h Kh 6s]
gustguaira: bets $1.66
Leason22: raises $3.34 to $5
gustguaira: raises $6.66 to $11.66
Leason22: folds 
Uncalled bet ($6.66) returned to gustguaira
gustguaira collected $12.82 from pot
gustguaira: doesn't show hand 
*** SUMMARY ***
Total pot $13.50 | Rake $0.68 
Board [9h Kh 6s]
Seat 1: gustguaira (small blind) collected ($12.82)
Seat 2: inflexiblle (big blind) folded before Flop
Seat 3: Leason22 folded on the Flop
Seat 5: funker84 folded before Flop (didn't bet)
Seat 6: MR.PATJEW folded before Flop (didn't bet)
Seat 7: sonova folded before Flop (didn't bet)
Seat 8: aksh3n (button) folded before Flop (didn't bet)



PokerStars Hand #228688044822:  Hold'em No Limit ($0.25/$0.50 USD) - 2021/07/30 16:11:55 ET
Table 'Gorgo III' 9-max Seat #1 is the button
Seat 1: gustguaira ($77.33 in chips) 
Seat 2: inflexiblle ($50 in chips) 
Seat 3: Leason22 ($35.50 in chips) 
Seat 5: funker84 ($40 in chips) 
Seat 6: MR.PATJEW ($60.69 in chips) 
Seat 7: sonova ($104.55 in chips) 
Seat 8: aksh3n ($50 in chips) 
inflexiblle: posts small blind $0.25
Leason22: posts big blind $0.50
nicu4you: sits out 
*** HOLE CARDS ***
funker84: folds 
MR.PATJEW: raises $1 to $1.50
sonova: calls $1.50
aksh3n: folds 
gustguaira: folds 
inflexiblle: folds 
Leason22: folds 
*** FLOP *** [8c Jc Ts]
MR.PATJEW: checks 
sonova: checks 
*** TURN *** [8c Jc Ts] [Ah]
MR.PATJEW: checks 
sonova: bets $1.07
MR.PATJEW: calls $1.07
*** RIVER *** [8c Jc Ts Ah] [5h]
MR.PATJEW: checks 
sonova: bets $3.92
MR.PATJEW: calls $3.92
*** SHOW DOWN ***
sonova: shows [Ad Kc] (a pair of Aces)
MR.PATJEW: mucks hand 
sonova collected $13.04 from pot
*** SUMMARY ***
Total pot $13.73 | Rake $0.69 
Board [8c Jc Ts Ah 5h]
Seat 1: gustguaira (button) folded before Flop (didn't bet)
Seat 2: inflexiblle (small blind) folded before Flop
Seat 3: Leason22 (big blind) folded before Flop
Seat 5: funker84 folded before Flop (didn't bet)
Seat 6: MR.PATJEW mucked
Seat 7: sonova showed [Ad Kc] and won ($13.04) with a pair of Aces
Seat 8: aksh3n folded before Flop (didn't bet)



PokerStars Hand #228688081322:  Hold'em No Limit ($0.25/$0.50 USD) - 2021/07/30 16:13:14 ET
Table 'Gorgo III' 9-max Seat #2 is the button
Seat 1: gustguaira ($77.33 in chips) 
Seat 2: inflexiblle ($50 in chips) 
Seat 3: Leason22 ($35 in chips) 
Seat 4: nicu4you ($50 in chips) 
Seat 5: funker84 ($40 in chips) 
Seat 6: MR.PATJEW ($54.20 in chips) 
Seat 7: sonova ($111.10 in chips) 
Seat 8: aksh3n ($50 in chips) 
Leason22: posts small blind $0.25
nicu4you: posts big blind $0.50
*** HOLE CARDS ***
funker84: folds 
MR.PATJEW: folds 
sonova: folds 
aksh3n: folds 
gustguaira: raises $1 to $1.50
inflexiblle: folds 
Leason22: folds 
nicu4you: folds 
Uncalled bet ($1) returned to gustguaira
gustguaira collected $1.25 from pot
gustguaira: doesn't show hand 
*** SUMMARY ***
Total pot $1.25 | Rake $0 
Seat 1: gustguaira collected ($1.25)
Seat 2: inflexiblle (button) folded before Flop (didn't bet)
Seat 3: Leason22 (small blind) folded before Flop
Seat 4: nicu4you (big blind) folded before Flop
Seat 5: funker84 folded before Flop (didn't bet)
Seat 6: MR.PATJEW folded before Flop (didn't bet)
Seat 7: sonova folded before Flop (didn't bet)
Seat 8: aksh3n folded before Flop (didn't bet)



PokerStars Hand #228688093666:  Hold'em No Limit ($0.25/$0.50 USD) - 2021/07/30 16:13:41 ET
Table 'Gorgo III' 9-max Seat #3 is the button
Seat 1: gustguaira ($78.08 in chips) 
Seat 2: inflexiblle ($50 in chips) 
Seat 3: Leason22 ($34.75 in chips) 
Seat 4: nicu4you ($50 in chips) 
Seat 5: funker84 ($40 in chips) 
Seat 6: MR.PATJEW ($54.20 in chips) 
Seat 7: sonova ($111.10 in chips) 
Seat 8: aksh3n ($50 in chips) 
nicu4you: posts small blind $0.25
funker84: posts big blind $0.50
*** HOLE CARDS ***
MR.PATJEW: raises $1 to $1.50
sonova: folds 
aksh3n: raises $2.50 to $4
gustguaira: folds 
inflexiblle: folds 
Leason22: folds 
nicu4you: folds 
funker84: folds 
MR.PATJEW: calls $2.50
*** FLOP *** [Ts 4c 9s]
MR.PATJEW: checks 
aksh3n: checks 
*** TURN *** [Ts 4c 9s] [2s]
MR.PATJEW: checks 
aksh3n: checks 
*** RIVER *** [Ts 4c 9s 2s] [6h]
MR.PATJEW: checks 
aksh3n: checks 
*** SHOW DOWN ***
MR.PATJEW: shows [Ac Jd] (high card Ace)
aksh3n: shows [Qh As] (high card Ace - Queen kicker)
aksh3n collected $8.31 from pot
*** SUMMARY ***
Total pot $8.75 | Rake $0.44 
Board [Ts 4c 9s 2s 6h]
Seat 1: gustguaira folded before Flop (didn't bet)
Seat 2: inflexiblle folded before Flop (didn't bet)
Seat 3: Leason22 (button) folded before Flop (didn't bet)
Seat 4: nicu4you (small blind) folded before Flop
Seat 5: funker84 (big blind) folded before Flop
Seat 6: MR.PATJEW showed [Ac Jd] and lost with high card Ace
Seat 7: sonova folded before Flop (didn't bet)
Seat 8: aksh3n showed [Qh As] and won ($8.31) with high card Ace



PokerStars Hand #228688114927:  Hold'em No Limit ($0.25/$0.50 USD) - 2021/07/30 16:14:26 ET
Table 'Gorgo III' 9-max Seat #4 is the button
Seat 1: gustguaira ($78.08 in chips) 
Seat 2: inflexiblle ($50 in chips) 
Seat 3: Leason22 ($34.75 in chips) 
Seat 4: nicu4you ($50 in chips) 
Seat 5: funker84 ($39.50 in chips) 
Seat 6: MR.PATJEW ($50.20 in chips) 
Seat 7: sonova ($111.10 in chips) 
Seat 8: aksh3n ($54.31 in chips) 
funker84: posts small blind $0.25
MR.PATJEW: posts big blind $0.50
*** HOLE CARDS ***
sonova: folds 
aksh3n: folds 
gustguaira: folds 
inflexiblle: folds 
Leason22: folds 
nicu4you: folds 
funker84: folds 
Uncalled bet ($0.25) returned to MR.PATJEW
MR.PATJEW collected $0.50 from pot
MR.PATJEW: doesn't show hand 
*** SUMMARY ***
Total pot $0.50 | Rake $0 
Seat 1: gustguaira folded before Flop (didn't bet)
Seat 2: inflexiblle folded before Flop (didn't bet)
Seat 3: Leason22 folded before Flop (didn't bet)
Seat 4: nicu4you (button) folded before Flop (didn't bet)
Seat 5: funker84 (small blind) folded before Flop
Seat 6: MR.PATJEW (big blind) collected ($0.50)
Seat 7: sonova folded before Flop (didn't bet)
Seat 8: aksh3n folded before Flop (didn't bet)



PokerStars Hand #228688122330:  Hold'em No Limit ($0.25/$0.50 USD) - 2021/07/30 16:14:42 ET
Table 'Gorgo III' 9-max Seat #5 is the button
Seat 1: gustguaira ($78.08 in chips) 
Seat 2: inflexiblle ($50 in chips) 
Seat 3: Leason22 ($34.75 in chips) 
Seat 4: nicu4you ($50 in chips) 
Seat 5: funker84 ($39.25 in chips) 
Seat 6: MR.PATJEW ($50.45 in chips) 
Seat 7: sonova ($111.10 in chips) 
Seat 8: aksh3n ($54.31 in chips) 
MR.PATJEW: posts small blind $0.25
sonova: posts big blind $0.50
*** HOLE CARDS ***
aksh3n: raises $0.60 to $1.10
gustguaira: folds 
inflexiblle: folds 
Leason22: folds 
nicu4you: folds 
funker84: folds 
MR.PATJEW: calls $0.85
sonova: folds 
*** FLOP *** [8c Jh 3c]
MR.PATJEW: checks 
aksh3n: checks 
*** TURN *** [8c Jh 3c] [8h]
MR.PATJEW: checks 
aksh3n: checks 
*** RIVER *** [8c Jh 3c 8h] [8d]
MR.PATJEW: checks 
aksh3n: checks 
*** SHOW DOWN ***
MR.PATJEW: shows [7h 9h] (three of a kind, Eights)
aksh3n: shows [Kd Qs] (three of a kind, Eights - King kicker)
aksh3n collected $2.56 from pot
*** SUMMARY ***
Total pot $2.70 | Rake $0.14 
Board [8c Jh 3c 8h 8d]
Seat 1: gustguaira folded before Flop (didn't bet)
Seat 2: inflexiblle folded before Flop (didn't bet)
Seat 3: Leason22 folded before Flop (didn't bet)
Seat 4: nicu4you folded before Flop (didn't bet)
Seat 5: funker84 (button) folded before Flop (didn't bet)
Seat 6: MR.PATJEW (small blind) showed [7h 9h] and lost with three of a kind, Eights
Seat 7: sonova (big blind) folded before Flop
Seat 8: aksh3n showed [Kd Qs] and won ($2.56) with three of a kind, Eights



PokerStars Hand #228688139331:  Hold'em No Limit ($0.25/$0.50 USD) - 2021/07/30 16:15:18 ET
Table 'Gorgo III' 9-max Seat #6 is the button
Seat 1: gustguaira ($78.08 in chips) 
Seat 2: inflexiblle ($50 in chips) 
Seat 3: Leason22 ($34.75 in chips) 
Seat 4: nicu4you ($50 in chips) 
Seat 5: funker84 ($39.25 in chips) 
Seat 6: MR.PATJEW ($49.35 in chips) 
Seat 7: sonova ($110.60 in chips) 
Seat 8: aksh3n ($55.77 in chips) 
sonova: posts small blind $0.25
aksh3n: posts big blind $0.50
*** HOLE CARDS ***
gustguaira: folds 
inflexiblle: folds 
Leason22: folds 
nicu4you: folds 
funker84: raises $1 to $1.50
MR.PATJEW: folds 
sonova: folds 
aksh3n: folds 
Uncalled bet ($1) returned to funker84
funker84 collected $1.25 from pot
funker84: doesn't show hand 
*** SUMMARY ***
Total pot $1.25 | Rake $0 
Seat 1: gustguaira folded before Flop (didn't bet)
Seat 2: inflexiblle folded before Flop (didn't bet)
Seat 3: Leason22 folded before Flop (didn't bet)
Seat 4: nicu4you folded before Flop (didn't bet)
Seat 5: funker84 collected ($1.25)
Seat 6: MR.PATJEW (button) folded before Flop (didn't bet)
Seat 7: sonova (small blind) folded before Flop
Seat 8: aksh3n (big blind) folded before Flop



PokerStars Hand #228688153579:  Hold'em No Limit ($0.25/$0.50 USD) - 2021/07/30 16:15:37 ET
Table 'Gorgo III' 9-max Seat #7 is the button
Seat 1: gustguaira ($78.08 in chips) 
Seat 2: inflexiblle ($50 in chips) 
Seat 3: Leason22 ($34.75 in chips) 
Seat 4: nicu4you ($50 in chips) 
Seat 5: funker84 ($40 in chips) 
Seat 6: MR.PATJEW ($49.35 in chips) 
Seat 7: sonova ($110.35 in chips) 
Seat 8: aksh3n ($55.27 in chips) 
aksh3n: posts small blind $0.25
gustguaira: posts big blind $0.50
*** HOLE CARDS ***
inflexiblle: folds 
Leason22: folds 
nicu4you: raises $1 to $1.50
funker84: folds 
MR.PATJEW: calls $1.50
sonova: calls $1.50
aksh3n: raises $6.50 to $8
gustguaira: folds 
nicu4you: folds 
MR.PATJEW: calls $6.50
sonova: calls $6.50
*** FLOP *** [Qh 8h 4d]
aksh3n: bets $8.15
MR.PATJEW: calls $8.15
sonova: folds 
*** TURN *** [Qh 8h 4d] [6s]
aksh3n: bets $39.12 and is all-in
MR.PATJEW: folds 
Uncalled bet ($39.12) returned to aksh3n
aksh3n collected $40.30 from pot
aksh3n: doesn't show hand 
*** SUMMARY ***
Total pot $42.30 | Rake $2 
Board [Qh 8h 4d 6s]
Seat 1: gustguaira (big blind) folded before Flop
Seat 2: inflexiblle folded before Flop (didn't bet)
Seat 3: Leason22 folded before Flop (didn't bet)
Seat 4: nicu4you folded before Flop
Seat 5: funker84 folded before Flop (didn't bet)
Seat 6: MR.PATJEW folded on the Turn
Seat 7: sonova (button) folded on the Flop
Seat 8: aksh3n (small blind) collected ($40.30)



PokerStars Hand #228688189026:  Hold'em No Limit ($0.25/$0.50 USD) - 2021/07/30 16:16:51 ET
Table 'Gorgo III' 9-max Seat #8 is the button
Seat 1: gustguaira ($77.58 in chips) 
Seat 2: inflexiblle ($50 in chips) 
Seat 3: Leason22 ($34.75 in chips) 
Seat 4: nicu4you ($50 in chips) 
Seat 5: funker84 ($40 in chips) 
Seat 6: MR.PATJEW ($33.20 in chips) 
Seat 7: sonova ($102.35 in chips) 
Seat 8: aksh3n ($79.42 in chips) 
gustguaira: posts small blind $0.25
inflexiblle: posts big blind $0.50
*** HOLE CARDS ***
Leason22: folds 
nicu4you: folds 
funker84: folds 
MR.PATJEW: raises $1 to $1.50
sonova: calls $1.50
aksh3n: folds 
aksh3n leaves the table
gustguaira: calls $1.25
inflexiblle: folds 
*** FLOP *** [4d Kh Jh]
Lisenok110 joins the table at seat #8 
gustguaira: checks 
MR.PATJEW: checks 
sonova: checks 
*** TURN *** [4d Kh Jh] [4h]
gustguaira: checks 
MR.PATJEW: checks 
sonova: checks 
*** RIVER *** [4d Kh Jh 4h] [Th]
gustguaira: checks 
MR.PATJEW: checks 
sonova: checks 
*** SHOW DOWN ***
gustguaira: shows [3d 3s] (two pair, Fours and Threes)
MR.PATJEW: shows [As Jc] (two pair, Jacks and Fours)
sonova: shows [9d 9h] (a flush, King high)
sonova collected $4.75 from pot
*** SUMMARY ***
Total pot $5 | Rake $0.25 
Board [4d Kh Jh 4h Th]
Seat 1: gustguaira (small blind) showed [3d 3s] and lost with two pair, Fours and Threes
Seat 2: inflexiblle (big blind) folded before Flop
Seat 3: Leason22 folded before Flop (didn't bet)
Seat 4: nicu4you folded before Flop (didn't bet)
Seat 5: funker84 folded before Flop (didn't bet)
Seat 6: MR.PATJEW showed [As Jc] and lost with two pair, Jacks and Fours
Seat 7: sonova showed [9d 9h] and won ($4.75) with a flush, King high
Seat 8: aksh3n (button) folded before Flop (didn't bet)



PokerStars Hand #228688237716:  Hold'em No Limit ($0.25/$0.50 USD) - 2021/07/30 16:18:30 ET
Table 'Gorgo III' 9-max Seat #2 is the button
Seat 1: gustguaira ($76.83 in chips) 
Seat 2: inflexiblle ($50 in chips) 
Seat 3: Leason22 ($34.25 in chips) 
Seat 4: nicu4you ($50 in chips) 
Seat 5: funker84 ($40 in chips) 
Seat 6: MR.PATJEW ($31.70 in chips) 
Seat 7: sonova ($105.60 in chips) 
Leason22: posts small blind $0.25
nicu4you: posts big blind $0.50
Lisenok110: sits out 
fragonik: sits out 
*** HOLE CARDS ***
funker84: raises $0.50 to $1
MR.PATJEW: calls $1
sonova: folds 
gustguaira: folds 
inflexiblle: folds 
Leason22: calls $0.75
nicu4you: raises $5 to $6
funker84: folds 
MR.PATJEW: calls $5
Leason22: folds 
*** FLOP *** [8c Th Ad]
nicu4you: bets $7.32
MR.PATJEW: folds 
Uncalled bet ($7.32) returned to nicu4you
nicu4you collected $13.30 from pot
nicu4you: doesn't show hand 
*** SUMMARY ***
Total pot $14 | Rake $0.70 
Board [8c Th Ad]
Seat 1: gustguaira folded before Flop (didn't bet)
Seat 2: inflexiblle (button) folded before Flop (didn't bet)
Seat 3: Leason22 (small blind) folded before Flop
Seat 4: nicu4you (big blind) collected ($13.30)
Seat 5: funker84 folded before Flop
Seat 6: MR.PATJEW folded on the Flop
Seat 7: sonova folded before Flop (didn't bet)



PokerStars Hand #228688263469:  Hold'em No Limit ($0.25/$0.50 USD) - 2021/07/30 16:19:23 ET
Table 'Gorgo III' 9-max Seat #3 is the button
Seat 1: gustguaira ($76.83 in chips) 
Seat 2: inflexiblle ($50 in chips) 
Seat 3: Leason22 ($33.25 in chips) 
Seat 4: nicu4you ($57.30 in chips) 
Seat 5: funker84 ($39 in chips) 
Seat 6: MR.PATJEW ($25.70 in chips) 
Seat 7: sonova ($105.60 in chips) 
nicu4you: posts small blind $0.25
funker84: posts big blind $0.50
Lisenok110: sits out 
fragonik: sits out 
*** HOLE CARDS ***
MR.PATJEW: raises $1 to $1.50
sonova: folds 
gustguaira: folds 
inflexiblle: folds 
Leason22: folds 
nicu4you: folds 
funker84: folds 
Uncalled bet ($1) returned to MR.PATJEW
MR.PATJEW collected $1.25 from pot
MR.PATJEW: doesn't show hand 
*** SUMMARY ***
Total pot $1.25 | Rake $0 
Seat 1: gustguaira folded before Flop (didn't bet)
Seat 2: inflexiblle folded before Flop (didn't bet)
Seat 3: Leason22 (button) folded before Flop (didn't bet)
Seat 4: nicu4you (small blind) folded before Flop
Seat 5: funker84 (big blind) folded before Flop
Seat 6: MR.PATJEW collected ($1.25)
Seat 7: sonova folded before Flop (didn't bet)



PokerStars Hand #228688277111:  Hold'em No Limit ($0.25/$0.50 USD) - 2021/07/30 16:19:51 ET
Table 'Gorgo III' 9-max Seat #4 is the button
Seat 1: gustguaira ($76.83 in chips) 
Seat 2: inflexiblle ($50 in chips) 
Seat 3: Leason22 ($33.25 in chips) 
Seat 4: nicu4you ($57.05 in chips) 
Seat 5: funker84 ($38.50 in chips) 
Seat 6: MR.PATJEW ($26.45 in chips) 
Seat 7: sonova ($105.60 in chips) 
funker84: posts small blind $0.25
MR.PATJEW: posts big blind $0.50
Lisenok110: sits out 
fragonik: sits out 
*** HOLE CARDS ***
sonova: folds 
gustguaira: calls $0.50
inflexiblle: folds 
Leason22: folds 
nicu4you: folds 
funker84: folds 
MR.PATJEW: raises $1.25 to $1.75
gustguaira: calls $1.25
*** FLOP *** [9d 2s 3h]
MR.PATJEW: bets $3.56
gustguaira: folds 
Uncalled bet ($3.56) returned to MR.PATJEW
MR.PATJEW collected $3.56 from pot
MR.PATJEW: doesn't show hand 
*** SUMMARY ***
Total pot $3.75 | Rake $0.19 
Board [9d 2s 3h]
Seat 1: gustguaira folded on the Flop
Seat 2: inflexiblle folded before Flop (didn't bet)
Seat 3: Leason22 folded before Flop (didn't bet)
Seat 4: nicu4you (button) folded before Flop (didn't bet)
Seat 5: funker84 (small blind) folded before Flop
Seat 6: MR.PATJEW (big blind) collected ($3.56)
Seat 7: sonova folded before Flop (didn't bet)



PokerStars Hand #228688296798:  Hold'em No Limit ($0.25/$0.50 USD) - 2021/07/30 16:20:32 ET
Table 'Gorgo III' 9-max Seat #5 is the button
Seat 1: gustguaira ($75.08 in chips) 
Seat 2: inflexiblle ($50 in chips) 
Seat 3: Leason22 ($33.25 in chips) 
Seat 4: nicu4you ($57.05 in chips) 
Seat 5: funker84 ($38.25 in chips) 
Seat 6: MR.PATJEW ($28.26 in chips) 
Seat 7: sonova ($105.60 in chips) 
MR.PATJEW: posts small blind $0.25
sonova: posts big blind $0.50
Lisenok110: sits out 
fragonik: sits out 
*** HOLE CARDS ***
gustguaira: folds 
inflexiblle: raises $1 to $1.50
Leason22: folds 
nicu4you: folds 
funker84: folds 
MR.PATJEW: calls $1.25
sonova: folds 
*** FLOP *** [Tc Ac Kd]
MR.PATJEW: checks 
inflexiblle: bets $1.25
MR.PATJEW: calls $1.25
*** TURN *** [Tc Ac Kd] [7d]
MR.PATJEW: checks 
inflexiblle: bets $4.28
MR.PATJEW: calls $4.28
*** RIVER *** [Tc Ac Kd 7d] [3s]
MR.PATJEW: checks 
inflexiblle: bets $42.97 and is all-in
MR.PATJEW: folds 
Uncalled bet ($42.97) returned to inflexiblle
inflexiblle collected $13.83 from pot
*** SUMMARY ***
Total pot $14.56 | Rake $0.73 
Board [Tc Ac Kd 7d 3s]
Seat 1: gustguaira folded before Flop (didn't bet)
Seat 2: inflexiblle collected ($13.83)
Seat 3: Leason22 folded before Flop (didn't bet)
Seat 4: nicu4you folded before Flop (didn't bet)
Seat 5: funker84 (button) folded before Flop (didn't bet)
Seat 6: MR.PATJEW (small blind) folded on the River
Seat 7: sonova (big blind) folded before Flop



PokerStars Hand #228688335553:  Hold'em No Limit ($0.25/$0.50 USD) - 2021/07/30 16:21:51 ET
Table 'Gorgo III' 9-max Seat #6 is the button
Seat 1: gustguaira ($75.08 in chips) 
Seat 2: inflexiblle ($56.80 in chips) 
Seat 3: Leason22 ($33.25 in chips) 
Seat 4: nicu4you ($57.05 in chips) 
Seat 5: funker84 ($38.25 in chips) 
Seat 6: MR.PATJEW ($21.23 in chips) 
Seat 7: sonova ($105.10 in chips) 
Seat 8: Lisenok110 ($50 in chips) 
sonova: posts small blind $0.25
Lisenok110: posts big blind $0.50
fragonik: sits out 
*** HOLE CARDS ***
gustguaira: folds 
inflexiblle: folds 
Leason22: folds 
nicu4you has timed out
nicu4you: folds 
funker84: folds 
MR.PATJEW: folds 
sonova: folds 
Uncalled bet ($0.25) returned to Lisenok110
Lisenok110 collected $0.50 from pot
Lisenok110: doesn't show hand 
*** SUMMARY ***
Total pot $0.50 | Rake $0 
Seat 1: gustguaira folded before Flop (didn't bet)
Seat 2: inflexiblle folded before Flop (didn't bet)
Seat 3: Leason22 folded before Flop (didn't bet)
Seat 4: nicu4you folded before Flop (didn't bet)
Seat 5: funker84 folded before Flop (didn't bet)
Seat 6: MR.PATJEW (button) folded before Flop (didn't bet)
Seat 7: sonova (small blind) folded before Flop
Seat 8: Lisenok110 (big blind) collected ($0.50)



PokerStars Hand #228688347083:  Hold'em No Limit ($0.25/$0.50 USD) - 2021/07/30 16:22:15 ET
Table 'Gorgo III' 9-max Seat #7 is the button
Seat 1: gustguaira ($75.08 in chips) 
Seat 2: inflexiblle ($56.80 in chips) 
Seat 3: Leason22 ($33.25 in chips) 
Seat 4: nicu4you ($57.05 in chips) 
Seat 5: funker84 ($38.25 in chips) 
Seat 6: MR.PATJEW ($21.23 in chips) 
Seat 7: sonova ($104.85 in chips) 
Seat 8: Lisenok110 ($50.25 in chips) 
Seat 9: fragonik ($52.16 in chips) 
Lisenok110: posts small blind $0.25
fragonik: posts big blind $0.50
*** HOLE CARDS ***
gustguaira has timed out
gustguaira: folds 
inflexiblle: folds 
Leason22: calls $0.50
nicu4you: folds 
funker84: raises $1 to $1.50
MR.PATJEW: folds 
sonova: folds 
Lisenok110: folds 
fragonik: folds 
Leason22: calls $1
*** FLOP *** [9c 8h 5s]
Leason22: checks 
funker84: bets $2.50
Leason22: calls $2.50
*** TURN *** [9c 8h 5s] [Tc]
Leason22: checks 
funker84: checks 
*** RIVER *** [9c 8h 5s Tc] [Jc]
Leason22: checks 
funker84: checks 
*** SHOW DOWN ***
Leason22: shows [3c 3s] (a pair of Threes)
funker84: shows [4c 4d] (a pair of Fours)
funker84 collected $8.20 from pot
*** SUMMARY ***
Total pot $8.75 | Rake $0.55 
Board [9c 8h 5s Tc Jc]
Seat 1: gustguaira folded before Flop (didn't bet)
Seat 2: inflexiblle folded before Flop (didn't bet)
Seat 3: Leason22 showed [3c 3s] and lost with a pair of Threes
Seat 4: nicu4you folded before Flop (didn't bet)
Seat 5: funker84 showed [4c 4d] and won ($8.20) with a pair of Fours
Seat 6: MR.PATJEW folded before Flop (didn't bet)
Seat 7: sonova (button) folded before Flop (didn't bet)
Seat 8: Lisenok110 (small blind) folded before Flop
Seat 9: fragonik (big blind) folded before Flop



PokerStars Hand #228688380850:  Hold'em No Limit ($0.25/$0.50 USD) - 2021/07/30 16:23:24 ET
Table 'Gorgo III' 9-max Seat #8 is the button
Seat 1: gustguaira ($75.08 in chips) 
Seat 2: inflexiblle ($56.80 in chips) 
Seat 3: Leason22 ($29.25 in chips) 
Seat 4: nicu4you ($57.05 in chips) 
Seat 5: funker84 ($42.45 in chips) 
Seat 6: MR.PATJEW ($21.23 in chips) 
Seat 7: sonova ($104.85 in chips) 
Seat 8: Lisenok110 ($50 in chips) 
Seat 9: fragonik ($51.66 in chips) 
fragonik: posts small blind $0.25
gustguaira: posts big blind $0.50
*** HOLE CARDS ***
inflexiblle: folds 
Leason22: folds 
nicu4you: folds 
funker84: folds 
MR.PATJEW: folds 
sonova: folds 
Lisenok110: folds 
fragonik: folds 
Uncalled bet ($0.25) returned to gustguaira
gustguaira collected $0.50 from pot
gustguaira: doesn't show hand 
*** SUMMARY ***
Total pot $0.50 | Rake $0 
Seat 1: gustguaira (big blind) collected ($0.50)
Seat 2: inflexiblle folded before Flop (didn't bet)
Seat 3: Leason22 folded before Flop (didn't bet)
Seat 4: nicu4you folded before Flop (didn't bet)
Seat 5: funker84 folded before Flop (didn't bet)
Seat 6: MR.PATJEW folded before Flop (didn't bet)
Seat 7: sonova folded before Flop (didn't bet)
Seat 8: Lisenok110 (button) folded before Flop (didn't bet)
Seat 9: fragonik (small blind) folded before Flop



PokerStars Hand #228688388396:  Hold'em No Limit ($0.25/$0.50 USD) - 2021/07/30 16:23:40 ET
Table 'Gorgo III' 9-max Seat #9 is the button
Seat 1: gustguaira ($75.33 in chips) 
Seat 2: inflexiblle ($56.80 in chips) 
Seat 3: Leason22 ($29.25 in chips) 
Seat 4: nicu4you ($57.05 in chips) 
Seat 5: funker84 ($42.45 in chips) 
Seat 6: MR.PATJEW ($21.23 in chips) 
Seat 7: sonova ($104.85 in chips) 
Seat 8: Lisenok110 ($50 in chips) 
Seat 9: fragonik ($51.41 in chips) 
gustguaira: posts small blind $0.25
inflexiblle: posts big blind $0.50
*** HOLE CARDS ***
Leason22: folds 
nicu4you: raises $1 to $1.50
funker84: folds 
MR.PATJEW: folds 
sonova: folds 
Lisenok110: folds 
fragonik: folds 
gustguaira: folds 
inflexiblle: folds 
Uncalled bet ($1) returned to nicu4you
nicu4you collected $1.25 from pot
nicu4you: doesn't show hand 
*** SUMMARY ***
Total pot $1.25 | Rake $0 
Seat 1: gustguaira (small blind) folded before Flop
Seat 2: inflexiblle (big blind) folded before Flop
Seat 3: Leason22 folded before Flop (didn't bet)
Seat 4: nicu4you collected ($1.25)
Seat 5: funker84 folded before Flop (didn't bet)
Seat 6: MR.PATJEW folded before Flop (didn't bet)
Seat 7: sonova folded before Flop (didn't bet)
Seat 8: Lisenok110 folded before Flop (didn't bet)
Seat 9: fragonik (button) folded before Flop (didn't bet)



PokerStars Hand #228688400182:  Hold'em No Limit ($0.25/$0.50 USD) - 2021/07/30 16:24:04 ET
Table 'Gorgo III' 9-max Seat #1 is the button
Seat 1: gustguaira ($75.08 in chips) 
Seat 2: inflexiblle ($56.30 in chips) 
Seat 3: Leason22 ($29.25 in chips) 
Seat 4: nicu4you ($57.80 in chips) 
Seat 5: funker84 ($42.45 in chips) 
Seat 6: MR.PATJEW ($21.23 in chips) 
Seat 7: sonova ($104.85 in chips) 
Seat 8: Lisenok110 ($50 in chips) 
Seat 9: fragonik ($51.41 in chips) 
inflexiblle: posts small blind $0.25
Leason22: posts big blind $0.50
*** HOLE CARDS ***
nicu4you: folds 
funker84: folds 
MR.PATJEW has timed out
MR.PATJEW: folds 
sonova: folds 
Lisenok110: folds 
fragonik: folds 
gustguaira: folds 
inflexiblle: raises $1 to $1.50
Leason22: folds 
Uncalled bet ($1) returned to inflexiblle
inflexiblle collected $1 from pot
*** SUMMARY ***
Total pot $1 | Rake $0 
Seat 1: gustguaira (button) folded before Flop (didn't bet)
Seat 2: inflexiblle (small blind) collected ($1)
Seat 3: Leason22 (big blind) folded before Flop
Seat 4: nicu4you folded before Flop (didn't bet)
Seat 5: funker84 folded before Flop (didn't bet)
Seat 6: MR.PATJEW folded before Flop (didn't bet)
Seat 7: sonova folded before Flop (didn't bet)
Seat 8: Lisenok110 folded before Flop (didn't bet)
Seat 9: fragonik folded before Flop (didn't bet)



PokerStars Hand #228688413489:  Hold'em No Limit ($0.25/$0.50 USD) - 2021/07/30 16:24:31 ET
Table 'Gorgo III' 9-max Seat #2 is the button
Seat 1: gustguaira ($75.08 in chips) 
Seat 2: inflexiblle ($56.80 in chips) 
Seat 3: Leason22 ($28.75 in chips) 
Seat 4: nicu4you ($57.80 in chips) 
Seat 5: funker84 ($42.45 in chips) 
Seat 6: MR.PATJEW ($21.23 in chips) 
Seat 7: sonova ($104.85 in chips) 
Seat 8: Lisenok110 ($50 in chips) 
Seat 9: fragonik ($51.41 in chips) 
Leason22: posts small blind $0.25
nicu4you: posts big blind $0.50
*** HOLE CARDS ***
funker84: folds 
MR.PATJEW: folds 
sonova: raises $0.75 to $1.25
Lisenok110: folds 
fragonik: folds 
gustguaira: calls $1.25
inflexiblle: folds 
Leason22: calls $1
nicu4you: calls $0.75
*** FLOP *** [Qh Ah 2h]
Leason22: checks 
nicu4you: checks 
sonova: checks 
gustguaira: bets $2.37
Leason22: folds 
nicu4you: raises $5.22 to $7.59
sonova: folds 
gustguaira: folds 
Uncalled bet ($5.22) returned to nicu4you
nicu4you collected $9.25 from pot
nicu4you: doesn't show hand 
*** SUMMARY ***
Total pot $9.74 | Rake $0.49 
Board [Qh Ah 2h]
Seat 1: gustguaira folded on the Flop
Seat 2: inflexiblle (button) folded before Flop (didn't bet)
Seat 3: Leason22 (small blind) folded on the Flop
Seat 4: nicu4you (big blind) collected ($9.25)
Seat 5: funker84 folded before Flop (didn't bet)
Seat 6: MR.PATJEW folded before Flop (didn't bet)
Seat 7: sonova folded on the Flop
Seat 8: Lisenok110 folded before Flop (didn't bet)
Seat 9: fragonik folded before Flop (didn't bet)



PokerStars Hand #228688444830:  Hold'em No Limit ($0.25/$0.50 USD) - 2021/07/30 16:25:36 ET
Table 'Gorgo III' 9-max Seat #3 is the button
Seat 1: gustguaira ($71.46 in chips) 
Seat 2: inflexiblle ($56.80 in chips) 
Seat 3: Leason22 ($27.50 in chips) 
Seat 4: nicu4you ($63.43 in chips) 
Seat 5: funker84 ($42.45 in chips) 
Seat 6: MR.PATJEW ($21.23 in chips) 
Seat 7: sonova ($103.60 in chips) 
Seat 8: Lisenok110 ($50 in chips) 
Seat 9: fragonik ($51.41 in chips) 
nicu4you: posts small blind $0.25
funker84: posts big blind $0.50
*** HOLE CARDS ***
MR.PATJEW: folds 
sonova: folds 
Lisenok110: folds 
fragonik: folds 
gustguaira: folds 
inflexiblle: folds 
Leason22: raises $1 to $1.50
nicu4you: calls $1.25
funker84: folds 
*** FLOP *** [Kc 5c Js]
nicu4you: checks 
Leason22: bets $2.50
nicu4you: calls $2.50
*** TURN *** [Kc 5c Js] [Tc]
nicu4you: checks 
Leason22: bets $6.50
nicu4you: folds 
Uncalled bet ($6.50) returned to Leason22
Leason22 collected $7.98 from pot
*** SUMMARY ***
Total pot $8.50 | Rake $0.52 
Board [Kc 5c Js Tc]
Seat 1: gustguaira folded before Flop (didn't bet)
Seat 2: inflexiblle folded before Flop (didn't bet)
Seat 3: Leason22 (button) collected ($7.98)
Seat 4: nicu4you (small blind) folded on the Turn
Seat 5: funker84 (big blind) folded before Flop
Seat 6: MR.PATJEW folded before Flop (didn't bet)
Seat 7: sonova folded before Flop (didn't bet)
Seat 8: Lisenok110 folded before Flop (didn't bet)
Seat 9: fragonik folded before Flop (didn't bet)



PokerStars Hand #228688471797:  Hold'em No Limit ($0.25/$0.50 USD) - 2021/07/30 16:26:31 ET
Table 'Gorgo III' 9-max Seat #4 is the button
Seat 1: gustguaira ($71.46 in chips) 
Seat 2: inflexiblle ($56.80 in chips) 
Seat 3: Leason22 ($31.48 in chips) 
Seat 4: nicu4you ($59.43 in chips) 
Seat 5: funker84 ($41.95 in chips) 
Seat 6: MR.PATJEW ($21.23 in chips) 
Seat 7: sonova ($103.60 in chips) 
Seat 8: Lisenok110 ($50 in chips) 
Seat 9: fragonik ($51.41 in chips) 
funker84: posts small blind $0.25
MR.PATJEW: posts big blind $0.50
*** HOLE CARDS ***
sonova: folds 
Lisenok110: folds 
fragonik: raises $1 to $1.50
gustguaira: folds 
inflexiblle: calls $1.50
Leason22: folds 
nicu4you: folds 
funker84: folds 
MR.PATJEW: calls $1
*** FLOP *** [Jh Qs 3s]
MR.PATJEW: bets $4.51
fragonik: folds 
inflexiblle: raises $50.79 to $55.30 and is all-in
MR.PATJEW: calls $15.22 and is all-in
Uncalled bet ($35.57) returned to inflexiblle
*** TURN *** [Jh Qs 3s] [2d]
*** RIVER *** [Jh Qs 3s 2d] [Th]
*** SHOW DOWN ***
MR.PATJEW: shows [Js Ts] (two pair, Jacks and Tens)
inflexiblle: shows [Ad As] (a pair of Aces)
MR.PATJEW collected $42.21 from pot
*** SUMMARY ***
Total pot $44.21 | Rake $2 
Board [Jh Qs 3s 2d Th]
Seat 1: gustguaira folded before Flop (didn't bet)
Seat 2: inflexiblle showed [Ad As] and lost with a pair of Aces
Seat 3: Leason22 folded before Flop (didn't bet)
Seat 4: nicu4you (button) folded before Flop (didn't bet)
Seat 5: funker84 (small blind) folded before Flop
Seat 6: MR.PATJEW (big blind) showed [Js Ts] and won ($42.21) with two pair, Jacks and Tens
Seat 7: sonova folded before Flop (didn't bet)
Seat 8: Lisenok110 folded before Flop (didn't bet)
Seat 9: fragonik folded on the Flop



PokerStars Hand #228688514324:  Hold'em No Limit ($0.25/$0.50 USD) - 2021/07/30 16:28:00 ET
Table 'Gorgo III' 9-max Seat #5 is the button
Seat 1: gustguaira ($71.46 in chips) 
Seat 2: inflexiblle ($50 in chips) 
Seat 3: Leason22 ($31.48 in chips) 
Seat 4: nicu4you ($59.43 in chips) 
Seat 5: funker84 ($41.70 in chips) 
Seat 6: MR.PATJEW ($42.21 in chips) 
Seat 7: sonova ($103.60 in chips) 
Seat 8: Lisenok110 ($50 in chips) 
Seat 9: fragonik ($50 in chips) 
MR.PATJEW: posts small blind $0.25
sonova: posts big blind $0.50
*** HOLE CARDS ***
Lisenok110: folds 
fragonik: folds 
gustguaira: folds 
inflexiblle: folds 
Leason22: folds 
nicu4you: folds 
funker84: folds 
MR.PATJEW: raises $1 to $1.50
sonova: folds 
Uncalled bet ($1) returned to MR.PATJEW
MR.PATJEW collected $1 from pot
MR.PATJEW: doesn't show hand 
*** SUMMARY ***
Total pot $1 | Rake $0 
Seat 1: gustguaira folded before Flop (didn't bet)
Seat 2: inflexiblle folded before Flop (didn't bet)
Seat 3: Leason22 folded before Flop (didn't bet)
Seat 4: nicu4you folded before Flop (didn't bet)
Seat 5: funker84 (button) folded before Flop (didn't bet)
Seat 6: MR.PATJEW (small blind) collected ($1)
Seat 7: sonova (big blind) folded before Flop
Seat 8: Lisenok110 folded before Flop (didn't bet)
Seat 9: fragonik folded before Flop (didn't bet)



PokerStars Hand #228688525304:  Hold'em No Limit ($0.25/$0.50 USD) - 2021/07/30 16:28:23 ET
Table 'Gorgo III' 9-max Seat #6 is the button
Seat 1: gustguaira ($71.46 in chips) 
Seat 2: inflexiblle ($50 in chips) 
Seat 3: Leason22 ($31.48 in chips) 
Seat 4: nicu4you ($59.43 in chips) 
Seat 5: funker84 ($41.70 in chips) 
Seat 6: MR.PATJEW ($42.71 in chips) 
Seat 7: sonova ($103.10 in chips) 
Seat 8: Lisenok110 ($50 in chips) 
Seat 9: fragonik ($50 in chips) 
sonova: posts small blind $0.25
Lisenok110: posts big blind $0.50
*** HOLE CARDS ***
fragonik: folds 
gustguaira: raises $1.25 to $1.75
inflexiblle: folds 
Leason22: calls $1.75
nicu4you: folds 
funker84: folds 
MR.PATJEW: folds 
sonova: folds 
Lisenok110: raises $6.50 to $8.25
gustguaira: calls $6.50
Leason22: folds 
*** FLOP *** [4s Td 9c]
Lisenok110: bets $15.82
gustguaira: folds 
Uncalled bet ($15.82) returned to Lisenok110
Lisenok110 collected $17.58 from pot
Lisenok110: doesn't show hand 
*** SUMMARY ***
Total pot $18.50 | Rake $0.92 
Board [4s Td 9c]
Seat 1: gustguaira folded on the Flop
Seat 2: inflexiblle folded before Flop (didn't bet)
Seat 3: Leason22 folded before Flop
Seat 4: nicu4you folded before Flop (didn't bet)
Seat 5: funker84 folded before Flop (didn't bet)
Seat 6: MR.PATJEW (button) folded before Flop (didn't bet)
Seat 7: sonova (small blind) folded before Flop
Seat 8: Lisenok110 (big blind) collected ($17.58)
Seat 9: fragonik folded before Flop (didn't bet)



PokerStars Hand #228688698893:  Hold'em No Limit ($0.25/$0.50 USD) - 2021/07/30 16:34:18 ET
Table 'Gorgo III' 9-max Seat #5 is the button
Seat 1: gustguaira ($61.21 in chips) 
Seat 2: inflexiblle ($50.50 in chips) 
Seat 3: Leason22 ($19.98 in chips) 
Seat 4: nicu4you ($68.47 in chips) 
Seat 5: funker84 ($42.70 in chips) 
Seat 6: MR.PATJEW ($51.85 in chips) 
Seat 8: Lisenok110 ($57.83 in chips) 
Seat 9: fragonik ($50 in chips) 
MR.PATJEW: posts small blind $0.25
Lisenok110: posts big blind $0.50
*** HOLE CARDS ***
fragonik: folds 
gustguaira: folds 
inflexiblle: folds 
Leason22: folds 
nicu4you: folds 
funker84: folds 
MR.PATJEW: calls $0.25
Lisenok110: checks 
*** FLOP *** [2s Ks 9d]
MR.PATJEW: checks 
wildermorph joins the table at seat #7 
Lisenok110: checks 
*** TURN *** [2s Ks 9d] [Th]
MR.PATJEW: checks 
Lisenok110: bets $0.63
MR.PATJEW: folds 
Uncalled bet ($0.63) returned to Lisenok110
Lisenok110 collected $0.95 from pot
Lisenok110: doesn't show hand 
*** SUMMARY ***
Total pot $1 | Rake $0.05 
Board [2s Ks 9d Th]
Seat 1: gustguaira folded before Flop (didn't bet)
Seat 2: inflexiblle folded before Flop (didn't bet)
Seat 3: Leason22 folded before Flop (didn't bet)
Seat 4: nicu4you folded before Flop (didn't bet)
Seat 5: funker84 (button) folded before Flop (didn't bet)
Seat 6: MR.PATJEW (small blind) folded on the Turn
Seat 8: Lisenok110 (big blind) collected ($0.95)
Seat 9: fragonik folded before Flop (didn't bet)



PokerStars Hand #228688734827:  Hold'em No Limit ($0.25/$0.50 USD) - 2021/07/30 16:35:33 ET
Table 'Gorgo III' 9-max Seat #6 is the button
Seat 1: gustguaira ($61.21 in chips) 
Seat 2: inflexiblle ($50.50 in chips) 
Seat 3: Leason22 ($19.98 in chips) 
Seat 4: nicu4you ($68.47 in chips) 
Seat 5: funker84 ($42.70 in chips) 
Seat 6: MR.PATJEW ($51.35 in chips) 
Seat 8: Lisenok110 ($58.28 in chips) 
Seat 9: fragonik ($50 in chips) 
Lisenok110: posts small blind $0.25
fragonik: posts big blind $0.50
*** HOLE CARDS ***
gustguaira: folds 
inflexiblle: folds 
Leason22: calls $0.50
nicu4you: folds 
funker84: folds 
MR.PATJEW: raises $1 to $1.50
Lisenok110: folds 
fragonik: folds 
Leason22: calls $1
*** FLOP *** [Th 7s 9s]
Leason22: checks 
MR.PATJEW: bets $1.78
Leason22: calls $1.78
*** TURN *** [Th 7s 9s] [7h]
Leason22: checks 
MR.PATJEW: bets $3.47
Leason22: calls $3.47
*** RIVER *** [Th 7s 9s 7h] [Qc]
Leason22: checks 
MR.PATJEW: checks 
*** SHOW DOWN ***
Leason22: shows [4d 4c] (two pair, Sevens and Fours)
MR.PATJEW: shows [Jc Qd] (two pair, Queens and Sevens)
MR.PATJEW collected $13.54 from pot
*** SUMMARY ***
Total pot $14.25 | Rake $0.71 
Board [Th 7s 9s 7h Qc]
Seat 1: gustguaira folded before Flop (didn't bet)
Seat 2: inflexiblle folded before Flop (didn't bet)
Seat 3: Leason22 showed [4d 4c] and lost with two pair, Sevens and Fours
Seat 4: nicu4you folded before Flop (didn't bet)
Seat 5: funker84 folded before Flop (didn't bet)
Seat 6: MR.PATJEW (button) showed [Jc Qd] and won ($13.54) with two pair, Queens and Sevens
Seat 8: Lisenok110 (small blind) folded before Flop
Seat 9: fragonik (big blind) folded before Flop



PokerStars Hand #228688756813:  Hold'em No Limit ($0.25/$0.50 USD) - 2021/07/30 16:36:19 ET
Table 'Gorgo III' 9-max Seat #8 is the button
Seat 1: gustguaira ($61.21 in chips) 
Seat 2: inflexiblle ($50.50 in chips) 
Seat 3: Leason22 ($13.23 in chips) 
Seat 4: nicu4you ($68.47 in chips) 
Seat 5: funker84 ($42.70 in chips) 
Seat 6: MR.PATJEW ($58.14 in chips) 
Seat 8: Lisenok110 ($58.03 in chips) 
Seat 9: fragonik ($50 in chips) 
fragonik: posts small blind $0.25
gustguaira: posts big blind $0.50
wildermorph: sits out 
*** HOLE CARDS ***
inflexiblle: folds 
Leason22: folds 
nicu4you: folds 
funker84: folds 
MR.PATJEW: calls $0.50
Lisenok110: folds 
fragonik: folds 
gustguaira: checks 
*** FLOP *** [Qc 9c 5c]
gustguaira: checks 
MR.PATJEW: checks 
*** TURN *** [Qc 9c 5c] [2h]
gustguaira: checks 
MR.PATJEW: checks 
*** RIVER *** [Qc 9c 5c 2h] [3s]
gustguaira: checks 
MR.PATJEW: checks 
*** SHOW DOWN ***
gustguaira: shows [8d 4c] (high card Queen)
MR.PATJEW: shows [9h 8s] (a pair of Nines)
MR.PATJEW collected $1.19 from pot
*** SUMMARY ***
Total pot $1.25 | Rake $0.06 
Board [Qc 9c 5c 2h 3s]
Seat 1: gustguaira (big blind) showed [8d 4c] and lost with high card Queen
Seat 2: inflexiblle folded before Flop (didn't bet)
Seat 3: Leason22 folded before Flop (didn't bet)
Seat 4: nicu4you folded before Flop (didn't bet)
Seat 5: funker84 folded before Flop (didn't bet)
Seat 6: MR.PATJEW showed [9h 8s] and won ($1.19) with a pair of Nines
Seat 8: Lisenok110 (button) folded before Flop (didn't bet)
Seat 9: fragonik (small blind) folded before Flop



PokerStars Hand #228688783951:  Hold'em No Limit ($0.25/$0.50 USD) - 2021/07/30 16:37:16 ET
Table 'Gorgo III' 9-max Seat #9 is the button
Seat 1: gustguaira ($60.71 in chips) 
Seat 2: inflexiblle ($50.50 in chips) 
Seat 3: Leason22 ($13.23 in chips) 
Seat 4: nicu4you ($68.47 in chips) 
Seat 5: funker84 ($42.70 in chips) 
Seat 6: MR.PATJEW ($58.83 in chips) 
Seat 8: Lisenok110 ($58.03 in chips) 
Seat 9: fragonik ($50 in chips) 
gustguaira: posts small blind $0.25
inflexiblle: posts big blind $0.50
wildermorph: sits out 
*** HOLE CARDS ***
Leason22: folds 
nicu4you: folds 
funker84: calls $0.50
Leason22 leaves the table
MR.PATJEW has timed out
MR.PATJEW: folds 
Lisenok110: folds 
fragonik: folds 
gustguaira: folds 
inflexiblle: checks 
*** FLOP *** [6d 8h 4h]
inflexiblle: checks 
funker84: bets $1
inflexiblle: raises $2.14 to $3.14
funker84: calls $2.14
*** TURN *** [6d 8h 4h] [Jc]
inflexiblle: bets $4.75
funker84: raises $9.75 to $14.50
inflexiblle: calls $9.75
*** RIVER *** [6d 8h 4h Jc] [2s]
inflexiblle: checks 
Dragonclawss joins the table at seat #3 
funker84: checks 
*** SHOW DOWN ***
inflexiblle: shows [9h Td] (high card Jack)
funker84: shows [Qh Kh] (high card King)
funker84 collected $34.24 from pot
*** SUMMARY ***
Total pot $36.53 | Rake $2.29 
Board [6d 8h 4h Jc 2s]
Seat 1: gustguaira (small blind) folded before Flop
Seat 2: inflexiblle (big blind) showed [9h Td] and lost with high card Jack
Seat 3: Leason22 folded before Flop (didn't bet)
Seat 4: nicu4you folded before Flop (didn't bet)
Seat 5: funker84 showed [Qh Kh] and won ($34.24) with high card King
Seat 6: MR.PATJEW folded before Flop (didn't bet)
Seat 8: Lisenok110 folded before Flop (didn't bet)
Seat 9: fragonik (button) folded before Flop (didn't bet)



PokerStars Hand #228688552053:  Hold'em No Limit ($0.25/$0.50 USD) - 2021/07/30 16:29:19 ET
Table 'Gorgo III' 9-max Seat #7 is the button
Seat 1: gustguaira ($63.21 in chips) 
Seat 2: inflexiblle ($50 in chips) 
Seat 3: Leason22 ($29.73 in chips) 
Seat 4: nicu4you ($59.43 in chips) 
Seat 5: funker84 ($41.70 in chips) 
Seat 6: MR.PATJEW ($42.71 in chips) 
Seat 7: sonova ($102.85 in chips) 
Seat 8: Lisenok110 ($59.33 in chips) 
Seat 9: fragonik ($50 in chips) 
Lisenok110: posts small blind $0.25
fragonik: posts big blind $0.50
*** HOLE CARDS ***
gustguaira: folds 
inflexiblle: folds 
Leason22: folds 
nicu4you: folds 
funker84: folds 
MR.PATJEW: calls $0.50
sonova: folds 
Lisenok110: folds 
fragonik: raises $1.75 to $2.25
MR.PATJEW: calls $1.75
*** FLOP *** [9c 8s Td]
fragonik: bets $1.49
MR.PATJEW: raises $1.99 to $3.48
fragonik: calls $1.99
*** TURN *** [9c 8s Td] [9d]
fragonik: checks 
MR.PATJEW: bets $5.56
fragonik: folds 
Uncalled bet ($5.56) returned to MR.PATJEW
MR.PATJEW collected $11.12 from pot
*** SUMMARY ***
Total pot $11.71 | Rake $0.59 
Board [9c 8s Td 9d]
Seat 1: gustguaira folded before Flop (didn't bet)
Seat 2: inflexiblle folded before Flop (didn't bet)
Seat 3: Leason22 folded before Flop (didn't bet)
Seat 4: nicu4you folded before Flop (didn't bet)
Seat 5: funker84 folded before Flop (didn't bet)
Seat 6: MR.PATJEW collected ($11.12)
Seat 7: sonova (button) folded before Flop (didn't bet)
Seat 8: Lisenok110 (small blind) folded before Flop
Seat 9: fragonik (big blind) folded on the Turn



PokerStars Hand #228688634334:  Hold'em No Limit ($0.25/$0.50 USD) - 2021/07/30 16:32:04 ET
Table 'Gorgo III' 9-max Seat #1 is the button
Seat 1: gustguaira ($62.46 in chips) 
Seat 2: inflexiblle ($51.50 in chips) 
Seat 3: Leason22 ($20.48 in chips) 
Seat 4: nicu4you ($68.47 in chips) 
Seat 5: funker84 ($41.70 in chips) 
Seat 6: MR.PATJEW ($48.10 in chips) 
Seat 7: sonova ($102.85 in chips) 
Seat 8: Lisenok110 ($59.08 in chips) 
Seat 9: fragonik ($50 in chips) 
inflexiblle: posts small blind $0.25
Leason22: posts big blind $0.50
*** HOLE CARDS ***
nicu4you: folds 
funker84: raises $0.50 to $1
MR.PATJEW: folds 
sonova: calls $1
Lisenok110: folds 
fragonik: folds 
gustguaira: folds 
inflexiblle: calls $0.75
Leason22: calls $0.50
*** FLOP *** [Ah Js 5c]
inflexiblle: checks 
Leason22: checks 
funker84: bets $2.50
sonova: folds 
inflexiblle: folds 
Leason22: folds 
Uncalled bet ($2.50) returned to funker84
funker84 collected $3.75 from pot
funker84: doesn't show hand 
*** SUMMARY ***
Total pot $4 | Rake $0.25 
Board [Ah Js 5c]
Seat 1: gustguaira (button) folded before Flop (didn't bet)
Seat 2: inflexiblle (small blind) folded on the Flop
Seat 3: Leason22 (big blind) folded on the Flop
Seat 4: nicu4you folded before Flop (didn't bet)
Seat 5: funker84 collected ($3.75)
Seat 6: MR.PATJEW folded before Flop (didn't bet)
Seat 7: sonova folded on the Flop
Seat 8: Lisenok110 folded before Flop (didn't bet)
Seat 9: fragonik folded before Flop (didn't bet)



PokerStars Hand #228688656507:  Hold'em No Limit ($0.25/$0.50 USD) - 2021/07/30 16:32:50 ET
Table 'Gorgo III' 9-max Seat #2 is the button
Seat 1: gustguaira ($62.46 in chips) 
Seat 2: inflexiblle ($50.50 in chips) 
Seat 3: Leason22 ($19.48 in chips) 
Seat 4: nicu4you ($68.47 in chips) 
Seat 5: funker84 ($44.45 in chips) 
Seat 6: MR.PATJEW ($48.10 in chips) 
Seat 7: sonova ($101.85 in chips) 
Seat 8: Lisenok110 ($59.08 in chips) 
Seat 9: fragonik ($50 in chips) 
Leason22: posts small blind $0.25
nicu4you: posts big blind $0.50
*** HOLE CARDS ***
funker84: folds 
MR.PATJEW has timed out
MR.PATJEW: folds 
sonova: folds 
Lisenok110: folds 
fragonik: folds 
gustguaira: folds 
inflexiblle: folds 
Leason22: raises $1 to $1.50
nicu4you: folds 
Uncalled bet ($1) returned to Leason22
Leason22 collected $1 from pot
*** SUMMARY ***
Total pot $1 | Rake $0 
Seat 1: gustguaira folded before Flop (didn't bet)
Seat 2: inflexiblle (button) folded before Flop (didn't bet)
Seat 3: Leason22 (small blind) collected ($1)
Seat 4: nicu4you (big blind) folded before Flop
Seat 5: funker84 folded before Flop (didn't bet)
Seat 6: MR.PATJEW folded before Flop (didn't bet)
Seat 7: sonova folded before Flop (didn't bet)
Seat 8: Lisenok110 folded before Flop (didn't bet)
Seat 9: fragonik folded before Flop (didn't bet)



PokerStars Hand #228688668597:  Hold'em No Limit ($0.25/$0.50 USD) - 2021/07/30 16:33:15 ET
Table 'Gorgo III' 9-max Seat #3 is the button
Seat 1: gustguaira ($62.46 in chips) 
Seat 2: inflexiblle ($50.50 in chips) 
Seat 3: Leason22 ($19.98 in chips) 
Seat 4: nicu4you ($67.97 in chips) 
Seat 5: funker84 ($44.45 in chips) 
Seat 7: sonova ($101.85 in chips) 
Seat 8: Lisenok110 ($59.08 in chips) 
Seat 9: fragonik ($50 in chips) 
nicu4you: posts small blind $0.25
funker84: posts big blind $0.50
*** HOLE CARDS ***
sonova: folds 
Lisenok110: folds 
fragonik: folds 
gustguaira: folds 
inflexiblle: folds 
Leason22: folds 
nicu4you: raises $1 to $1.50
funker84: folds 
Uncalled bet ($1) returned to nicu4you
nicu4you collected $1 from pot
nicu4you: doesn't show hand 
*** SUMMARY ***
Total pot $1 | Rake $0 
Seat 1: gustguaira folded before Flop (didn't bet)
Seat 2: inflexiblle folded before Flop (didn't bet)
Seat 3: Leason22 (button) folded before Flop (didn't bet)
Seat 4: nicu4you (small blind) collected ($1)
Seat 5: funker84 (big blind) folded before Flop
Seat 7: sonova folded before Flop (didn't bet)
Seat 8: Lisenok110 folded before Flop (didn't bet)
Seat 9: fragonik folded before Flop (didn't bet)



PokerStars Hand #228688676013:  Hold'em No Limit ($0.25/$0.50 USD) - 2021/07/30 16:33:30 ET
Table 'Gorgo III' 9-max Seat #4 is the button
Seat 1: gustguaira ($62.46 in chips) 
Seat 2: inflexiblle ($50.50 in chips) 
Seat 3: Leason22 ($19.98 in chips) 
Seat 4: nicu4you ($68.47 in chips) 
Seat 5: funker84 ($43.95 in chips) 
Seat 6: MR.PATJEW ($48.10 in chips) 
Seat 7: sonova ($101.85 in chips) 
Seat 8: Lisenok110 ($59.08 in chips) 
Seat 9: fragonik ($50 in chips) 
funker84: posts small blind $0.25
MR.PATJEW: posts big blind $0.50
*** HOLE CARDS ***
sonova: folds 
sonova leaves the table
Lisenok110: raises $0.75 to $1.25
fragonik: folds 
gustguaira: calls $1.25
inflexiblle: folds 
Leason22: folds 
nicu4you: folds 
funker84: calls $1
MR.PATJEW: raises $5 to $6.25
Lisenok110: folds 
gustguaira: folds 
funker84: folds 
Uncalled bet ($5) returned to MR.PATJEW
MR.PATJEW collected $5 from pot
MR.PATJEW: doesn't show hand 
*** SUMMARY ***
Total pot $5 | Rake $0 
Seat 1: gustguaira folded before Flop
Seat 2: inflexiblle folded before Flop (didn't bet)
Seat 3: Leason22 folded before Flop (didn't bet)
Seat 4: nicu4you (button) folded before Flop (didn't bet)
Seat 5: funker84 (small blind) folded before Flop
Seat 6: MR.PATJEW (big blind) collected ($5)
Seat 7: sonova folded before Flop (didn't bet)
Seat 8: Lisenok110 folded before Flop
Seat 9: fragonik folded before Flop (didn't bet)



PokerStars Hand #228688823036:  Hold'em No Limit ($0.25/$0.50 USD) - 2021/07/30 16:38:37 ET
Table 'Gorgo III' 9-max Seat #1 is the button
Seat 1: gustguaira ($60.46 in chips) 
Seat 2: inflexiblle ($50 in chips) 
Seat 3: Dragonclawss ($50 in chips) 
Seat 4: nicu4you ($68.47 in chips) 
Seat 5: funker84 ($58.80 in chips) 
Seat 6: MR.PATJEW ($58.83 in chips) 
Seat 8: Lisenok110 ($58.03 in chips) 
Seat 9: fragonik ($50 in chips) 
inflexiblle: posts small blind $0.25
Dragonclawss: posts big blind $0.50
wildermorph: sits out 
*** HOLE CARDS ***
nicu4you: folds 
funker84: folds 
MR.PATJEW: folds 
Lisenok110: raises $0.75 to $1.25
fragonik: folds 
gustguaira: folds 
inflexiblle: folds 
Dragonclawss: folds 
Uncalled bet ($0.75) returned to Lisenok110
Lisenok110 collected $1.25 from pot
Lisenok110: doesn't show hand 
*** SUMMARY ***
Total pot $1.25 | Rake $0 
Seat 1: gustguaira (button) folded before Flop (didn't bet)
Seat 2: inflexiblle (small blind) folded before Flop
Seat 3: Dragonclawss (big blind) folded before Flop
Seat 4: nicu4you folded before Flop (didn't bet)
Seat 5: funker84 folded before Flop (didn't bet)
Seat 6: MR.PATJEW folded before Flop (didn't bet)
Seat 8: Lisenok110 collected ($1.25)
Seat 9: fragonik folded before Flop (didn't bet)



PokerStars Hand #228688835716:  Hold'em No Limit ($0.25/$0.50 USD) - 2021/07/30 16:39:04 ET
Table 'Gorgo III' 9-max Seat #2 is the button
Seat 1: gustguaira ($60.46 in chips) 
Seat 2: inflexiblle ($50 in chips) 
Seat 3: Dragonclawss ($50 in chips) 
Seat 4: nicu4you ($68.47 in chips) 
Seat 5: funker84 ($58.80 in chips) 
Seat 6: MR.PATJEW ($58.83 in chips) 
Seat 8: Lisenok110 ($58.78 in chips) 
Seat 9: fragonik ($50 in chips) 
Dragonclawss: posts small blind $0.25
nicu4you: posts big blind $0.50
wildermorph: sits out 
*** HOLE CARDS ***
funker84: folds 
MR.PATJEW: raises $1 to $1.50
Lisenok110: folds 
fragonik: folds 
gustguaira: folds 
inflexiblle: calls $1.50
Dragonclawss: folds 
nicu4you: folds 
*** FLOP *** [8d Th Qd]
MR.PATJEW: bets $1.78
inflexiblle: calls $1.78
*** TURN *** [8d Th Qd] [4c]
MR.PATJEW: bets $3.47
inflexiblle: calls $3.47
*** RIVER *** [8d Th Qd 4c] [6h]
MR.PATJEW: bets $6.77
inflexiblle: calls $6.77
*** SHOW DOWN ***
MR.PATJEW: shows [8c 8s] (three of a kind, Eights)
inflexiblle: mucks hand 
MR.PATJEW collected $26.40 from pot
*** SUMMARY ***
Total pot $27.79 | Rake $1.39 
Board [8d Th Qd 4c 6h]
Seat 1: gustguaira folded before Flop (didn't bet)
Seat 2: inflexiblle (button) mucked
Seat 3: Dragonclawss (small blind) folded before Flop
Seat 4: nicu4you (big blind) folded before Flop
Seat 5: funker84 folded before Flop (didn't bet)
Seat 6: MR.PATJEW showed [8c 8s] and won ($26.40) with three of a kind, Eights
Seat 8: Lisenok110 folded before Flop (didn't bet)
Seat 9: fragonik folded before Flop (didn't bet)



PokerStars Hand #228688863175:  Hold'em No Limit ($0.25/$0.50 USD) - 2021/07/30 16:40:02 ET
Table 'Gorgo III' 9-max Seat #3 is the button
Seat 1: gustguaira ($60.46 in chips) 
Seat 2: inflexiblle ($50 in chips) 
Seat 3: Dragonclawss ($50 in chips) 
Seat 4: nicu4you ($67.97 in chips) 
Seat 5: funker84 ($58.80 in chips) 
Seat 6: MR.PATJEW ($71.71 in chips) 
Seat 8: Lisenok110 ($58.78 in chips) 
Seat 9: fragonik ($50 in chips) 
nicu4you: posts small blind $0.25
funker84: posts big blind $0.50
wildermorph: sits out 
*** HOLE CARDS ***
MR.PATJEW: calls $0.50
Lisenok110: folds 
fragonik: folds 
gustguaira: raises $1 to $1.50
inflexiblle: calls $1.50
Dragonclawss: folds 
nicu4you: folds 
funker84: folds 
MR.PATJEW: calls $1
*** FLOP *** [7d 4d 6c]
MR.PATJEW: checks 
gustguaira: checks 
inflexiblle: bets $2.75
MR.PATJEW: calls $2.75
gustguaira: folds 
*** TURN *** [7d 4d 6c] [2c]
MR.PATJEW: checks 
inflexiblle: bets $7.75
MR.PATJEW: folds 
Uncalled bet ($7.75) returned to inflexiblle
inflexiblle collected $10.21 from pot
*** SUMMARY ***
Total pot $10.75 | Rake $0.54 
Board [7d 4d 6c 2c]
Seat 1: gustguaira folded on the Flop
Seat 2: inflexiblle collected ($10.21)
Seat 3: Dragonclawss (button) folded before Flop (didn't bet)
Seat 4: nicu4you (small blind) folded before Flop
Seat 5: funker84 (big blind) folded before Flop
Seat 6: MR.PATJEW folded on the Turn
Seat 8: Lisenok110 folded before Flop (didn't bet)
Seat 9: fragonik folded before Flop (didn't bet)



PokerStars Hand #228688899031:  Hold'em No Limit ($0.25/$0.50 USD) - 2021/07/30 16:41:10 ET
Table 'Gorgo III' 9-max Seat #4 is the button
Seat 1: gustguaira ($58.96 in chips) 
Seat 2: inflexiblle ($55.96 in chips) 
Seat 3: Dragonclawss ($50 in chips) 
Seat 4: nicu4you ($67.72 in chips) 
Seat 5: funker84 ($58.30 in chips) 
Seat 6: MR.PATJEW ($67.46 in chips) 
Seat 8: Lisenok110 ($58.78 in chips) 
Seat 9: fragonik ($50 in chips) 
funker84: posts small blind $0.25
MR.PATJEW: posts big blind $0.50
wildermorph: sits out 
*** HOLE CARDS ***
Lisenok110: raises $0.75 to $1.25
fragonik: folds 
gustguaira: folds 
inflexiblle: folds 
Dragonclawss: folds 
nicu4you: folds 
funker84: folds 
MR.PATJEW: calls $0.75
*** FLOP *** [7d Qs 2c]
MR.PATJEW: checks 
Lisenok110: checks 
*** TURN *** [7d Qs 2c] [2s]
MR.PATJEW: bets $1.30
Lisenok110: folds 
Uncalled bet ($1.30) returned to MR.PATJEW
MR.PATJEW collected $2.61 from pot
MR.PATJEW: doesn't show hand 
*** SUMMARY ***
Total pot $2.75 | Rake $0.14 
Board [7d Qs 2c 2s]
Seat 1: gustguaira folded before Flop (didn't bet)
Seat 2: inflexiblle folded before Flop (didn't bet)
Seat 3: Dragonclawss folded before Flop (didn't bet)
Seat 4: nicu4you (button) folded before Flop (didn't bet)
Seat 5: funker84 (small blind) folded before Flop
Seat 6: MR.PATJEW (big blind) collected ($2.61)
Seat 8: Lisenok110 folded on the Turn
Seat 9: fragonik folded before Flop (didn't bet)



PokerStars Hand #228688918409:  Hold'em No Limit ($0.25/$0.50 USD) - 2021/07/30 16:41:51 ET
Table 'Gorgo III' 9-max Seat #5 is the button
Seat 1: gustguaira ($58.96 in chips) 
Seat 2: inflexiblle ($55.96 in chips) 
Seat 3: Dragonclawss ($50 in chips) 
Seat 4: nicu4you ($67.72 in chips) 
Seat 5: funker84 ($58.05 in chips) 
Seat 6: MR.PATJEW ($68.82 in chips) 
Seat 7: wildermorph ($50 in chips) 
Seat 8: Lisenok110 ($57.53 in chips) 
Seat 9: fragonik ($50 in chips) 
MR.PATJEW: posts small blind $0.25
wildermorph: posts big blind $0.50
*** HOLE CARDS ***
Lisenok110: folds 
fragonik: folds 
gustguaira: folds 
inflexiblle: folds 
Dragonclawss: folds 
gustguaira leaves the table
nicu4you: raises $1 to $1.50
funker84: folds 
MR.PATJEW: calls $1.25
wildermorph: folds 
*** FLOP *** [Jh 8h Jd]
Popokluev joins the table at seat #1 
MR.PATJEW: checks 
nicu4you: bets $2.29
MR.PATJEW: calls $2.29
*** TURN *** [Jh 8h Jd] [7d]
MR.PATJEW: checks 
nicu4you: bets $5.30
MR.PATJEW: calls $5.30
*** RIVER *** [Jh 8h Jd 7d] [8d]
MR.PATJEW: checks 
nicu4you: bets $14.20
MR.PATJEW: folds 
Uncalled bet ($14.20) returned to nicu4you
nicu4you collected $17.75 from pot
nicu4you: doesn't show hand 
*** SUMMARY ***
Total pot $18.68 | Rake $0.93 
Board [Jh 8h Jd 7d 8d]
Seat 1: gustguaira folded before Flop (didn't bet)
Seat 2: inflexiblle folded before Flop (didn't bet)
Seat 3: Dragonclawss folded before Flop (didn't bet)
Seat 4: nicu4you collected ($17.75)
Seat 5: funker84 (button) folded before Flop (didn't bet)
Seat 6: MR.PATJEW (small blind) folded on the River
Seat 7: wildermorph (big blind) folded before Flop
Seat 8: Lisenok110 folded before Flop (didn't bet)
Seat 9: fragonik folded before Flop (didn't bet)



PokerStars Hand #228688951645:  Hold'em No Limit ($0.25/$0.50 USD) - 2021/07/30 16:43:02 ET
Table 'Gorgo III' 9-max Seat #6 is the button
Seat 2: inflexiblle ($55.96 in chips) 
Seat 3: Dragonclawss ($50 in chips) 
Seat 4: nicu4you ($76.38 in chips) 
Seat 5: funker84 ($58.05 in chips) 
Seat 6: MR.PATJEW ($59.73 in chips) 
Seat 7: wildermorph ($49.50 in chips) 
Seat 8: Lisenok110 ($57.53 in chips) 
Seat 9: fragonik ($50 in chips) 
wildermorph: posts small blind $0.25
Lisenok110: posts big blind $0.50
Popokluev: sits out 
*** HOLE CARDS ***
fragonik: folds 
inflexiblle: folds 
Dragonclawss: folds 
nicu4you: folds 
funker84: folds 
MR.PATJEW: folds 
wildermorph: folds 
Uncalled bet ($0.25) returned to Lisenok110
Lisenok110 collected $0.50 from pot
Lisenok110: doesn't show hand 
*** SUMMARY ***
Total pot $0.50 | Rake $0 
Seat 2: inflexiblle folded before Flop (didn't bet)
Seat 3: Dragonclawss folded before Flop (didn't bet)
Seat 4: nicu4you folded before Flop (didn't bet)
Seat 5: funker84 folded before Flop (didn't bet)
Seat 6: MR.PATJEW (button) folded before Flop (didn't bet)
Seat 7: wildermorph (small blind) folded before Flop
Seat 8: Lisenok110 (big blind) collected ($0.50)
Seat 9: fragonik folded before Flop (didn't bet)



PokerStars Hand #228688991398:  Hold'em No Limit ($0.25/$0.50 USD) - 2021/07/30 16:44:26 ET
Table 'Gorgo III' 9-max Seat #8 is the button
Seat 1: Popokluev ($52.88 in chips) 
Seat 2: inflexiblle ($55.96 in chips) 
Seat 3: Dragonclawss ($50 in chips) 
Seat 4: nicu4you ($76.38 in chips) 
Seat 5: funker84 ($57.05 in chips) 
Seat 6: MR.PATJEW ($61.34 in chips) 
Seat 7: wildermorph ($49.25 in chips) 
Seat 8: Lisenok110 ($57.53 in chips) 
Seat 9: fragonik ($50 in chips) 
fragonik: posts small blind $0.25
Popokluev: posts big blind $0.50
*** HOLE CARDS ***
inflexiblle: folds 
Dragonclawss: raises $0.75 to $1.25
nicu4you: folds 
funker84: folds 
MR.PATJEW: folds 
wildermorph: folds 
Lisenok110: folds 
fragonik: folds 
Popokluev: folds 
Uncalled bet ($0.75) returned to Dragonclawss
Dragonclawss collected $1.25 from pot
Dragonclawss: doesn't show hand 
*** SUMMARY ***
Total pot $1.25 | Rake $0 
Seat 1: Popokluev (big blind) folded before Flop
Seat 2: inflexiblle folded before Flop (didn't bet)
Seat 3: Dragonclawss collected ($1.25)
Seat 4: nicu4you folded before Flop (didn't bet)
Seat 5: funker84 folded before Flop (didn't bet)
Seat 6: MR.PATJEW folded before Flop (didn't bet)
Seat 7: wildermorph folded before Flop (didn't bet)
Seat 8: Lisenok110 (button) folded before Flop (didn't bet)
Seat 9: fragonik (small blind) folded before Flop



PokerStars Hand #228689024519:  Hold'em No Limit ($0.25/$0.50 USD) - 2021/07/30 16:45:18 ET
Table 'Gorgo III' 9-max Seat #9 is the button
Seat 1: Popokluev ($52.38 in chips) 
Seat 2: inflexiblle ($55.96 in chips) 
Seat 3: Dragonclawss ($50.75 in chips) 
Seat 4: nicu4you ($76.38 in chips) 
Seat 5: funker84 ($57.05 in chips) 
Seat 6: MR.PATJEW ($61.34 in chips) 
Seat 7: wildermorph ($49.25 in chips) 
Seat 8: Lisenok110 ($57.53 in chips) 
Seat 9: fragonik ($50 in chips) 
Popokluev: posts small blind $0.25
inflexiblle: posts big blind $0.50
*** HOLE CARDS ***
Dragonclawss: folds 
nicu4you: folds 
funker84: folds 
MR.PATJEW: folds 
wildermorph: folds 
Lisenok110: folds 
fragonik: raises $0.75 to $1.25
Popokluev: folds 
inflexiblle: calls $0.75
*** FLOP *** [5c 9c Ad]
inflexiblle: checks 
fragonik: bets $0.86
inflexiblle: folds 
Uncalled bet ($0.86) returned to fragonik
fragonik collected $2.61 from pot
*** SUMMARY ***
Total pot $2.75 | Rake $0.14 
Board [5c 9c Ad]
Seat 1: Popokluev (small blind) folded before Flop
Seat 2: inflexiblle (big blind) folded on the Flop
Seat 3: Dragonclawss folded before Flop (didn't bet)
Seat 4: nicu4you folded before Flop (didn't bet)
Seat 5: funker84 folded before Flop (didn't bet)
Seat 6: MR.PATJEW folded before Flop (didn't bet)
Seat 7: wildermorph folded before Flop (didn't bet)
Seat 8: Lisenok110 folded before Flop (didn't bet)
Seat 9: fragonik (button) collected ($2.61)



PokerStars Hand #228689043558:  Hold'em No Limit ($0.25/$0.50 USD) - 2021/07/30 16:45:58 ET
Table 'Gorgo III' 9-max Seat #1 is the button
Seat 1: Popokluev ($52.13 in chips) 
Seat 2: inflexiblle ($54.71 in chips) 
Seat 4: nicu4you ($76.38 in chips) 
Seat 5: funker84 ($57.05 in chips) 
Seat 6: MR.PATJEW ($61.34 in chips) 
Seat 7: wildermorph ($49.25 in chips) 
Seat 8: Lisenok110 ($57.53 in chips) 
Seat 9: fragonik ($51.36 in chips) 
inflexiblle: posts small blind $0.25
nicu4you: posts big blind $0.50
*** HOLE CARDS ***
funker84: folds 
MR.PATJEW has timed out
MR.PATJEW: folds 
wildermorph: folds 
Lisenok110: folds 
fragonik: folds 
Popokluev: folds 
inflexiblle: raises $1 to $1.50
nicu4you: calls $1
*** FLOP *** [Jh 6c Jc]
inflexiblle: checks 
nicu4you: checks 
*** TURN *** [Jh 6c Jc] [4h]
inflexiblle: checks 
nicu4you: bets $1.57
inflexiblle: folds 
Uncalled bet ($1.57) returned to nicu4you
nicu4you collected $2.85 from pot
nicu4you: doesn't show hand 
*** SUMMARY ***
Total pot $3 | Rake $0.15 
Board [Jh 6c Jc 4h]
Seat 1: Popokluev (button) folded before Flop (didn't bet)
Seat 2: inflexiblle (small blind) folded on the Turn
Seat 4: nicu4you (big blind) collected ($2.85)
Seat 5: funker84 folded before Flop (didn't bet)
Seat 6: MR.PATJEW folded before Flop (didn't bet)
Seat 7: wildermorph folded before Flop (didn't bet)
Seat 8: Lisenok110 folded before Flop (didn't bet)
Seat 9: fragonik folded before Flop (didn't bet)



PokerStars Hand #228690347302:  Hold'em No Limit ($0.25/$0.50 USD) - 2021/07/30 17:33:04 ET
Table 'Gorgo III' 9-max Seat #8 is the button
Seat 1: ms1272 ($53.72 in chips) 
Seat 2: FeersPoker ($68.17 in chips) 
Seat 3: schmollhans ($30.26 in chips) 
Seat 4: nicu4you ($80.03 in chips) 
Seat 5: funker84 ($47.19 in chips) 
Seat 6: Dragonclawss ($50 in chips) 
Seat 7: forestry800 ($51.75 in chips) 
Seat 8: Pachebrash ($50 in chips) 
Seat 9: fragonik ($69.42 in chips) 
fragonik: posts small blind $0.25
ms1272: posts big blind $0.50
*** HOLE CARDS ***
FeersPoker: folds 
schmollhans: folds 
nicu4you: folds 
funker84: folds 
Dragonclawss: folds 
forestry800: folds 
Pachebrash: raises $0.70 to $1.20
fragonik: folds 
ms1272: folds 
Uncalled bet ($0.70) returned to Pachebrash
Pachebrash collected $1.25 from pot
Pachebrash: doesn't show hand 
*** SUMMARY ***
Total pot $1.25 | Rake $0 
Seat 1: ms1272 (big blind) folded before Flop
Seat 2: FeersPoker folded before Flop (didn't bet)
Seat 3: schmollhans folded before Flop (didn't bet)
Seat 4: nicu4you folded before Flop (didn't bet)
Seat 5: funker84 folded before Flop (didn't bet)
Seat 6: Dragonclawss folded before Flop (didn't bet)
Seat 7: forestry800 folded before Flop (didn't bet)
Seat 8: Pachebrash (button) collected ($1.25)
Seat 9: fragonik (small blind) folded before Flop



PokerStars Hand #228690355403:  Hold'em No Limit ($0.25/$0.50 USD) - 2021/07/30 17:33:22 ET
Table 'Gorgo III' 9-max Seat #9 is the button
Seat 1: ms1272 ($53.22 in chips) 
Seat 2: FeersPoker ($68.17 in chips) 
Seat 3: schmollhans ($30.26 in chips) 
Seat 4: nicu4you ($80.03 in chips) 
Seat 5: funker84 ($47.19 in chips) 
Seat 6: Dragonclawss ($50 in chips) 
Seat 7: forestry800 ($51.75 in chips) 
Seat 8: Pachebrash ($50.75 in chips) 
Seat 9: fragonik ($69.17 in chips) 
ms1272: posts small blind $0.25
FeersPoker: posts big blind $0.50
*** HOLE CARDS ***
schmollhans: calls $0.50
nicu4you: folds 
funker84: folds 
Dragonclawss: folds 
forestry800: folds 
Pachebrash: folds 
fragonik: folds 
ms1272: folds 
FeersPoker: checks 
*** FLOP *** [2h Jc Ks]
FeersPoker: checks 
schmollhans: bets $1
FeersPoker: folds 
Uncalled bet ($1) returned to schmollhans
schmollhans collected $1.17 from pot
schmollhans: doesn't show hand 
*** SUMMARY ***
Total pot $1.25 | Rake $0.08 
Board [2h Jc Ks]
Seat 1: ms1272 (small blind) folded before Flop
Seat 2: FeersPoker (big blind) folded on the Flop
Seat 3: schmollhans collected ($1.17)
Seat 4: nicu4you folded before Flop (didn't bet)
Seat 5: funker84 folded before Flop (didn't bet)
Seat 6: Dragonclawss folded before Flop (didn't bet)
Seat 7: forestry800 folded before Flop (didn't bet)
Seat 8: Pachebrash folded before Flop (didn't bet)
Seat 9: fragonik (button) folded before Flop (didn't bet)



PokerStars Hand #228690365004:  Hold'em No Limit ($0.25/$0.50 USD) - 2021/07/30 17:33:43 ET
Table 'Gorgo III' 9-max Seat #1 is the button
Seat 1: ms1272 ($52.97 in chips) 
Seat 2: FeersPoker ($67.67 in chips) 
Seat 3: schmollhans ($30.93 in chips) 
Seat 4: nicu4you ($80.03 in chips) 
Seat 5: funker84 ($47.19 in chips) 
Seat 6: Dragonclawss ($50 in chips) 
Seat 7: forestry800 ($51.75 in chips) 
Seat 8: Pachebrash ($50.75 in chips) 
Seat 9: fragonik ($69.17 in chips) 
FeersPoker: posts small blind $0.25
schmollhans: posts big blind $0.50
*** HOLE CARDS ***
nicu4you: folds 
funker84: folds 
Dragonclawss: folds 
forestry800: raises $0.75 to $1.25
Pachebrash: folds 
fragonik: folds 
ms1272: calls $1.25
FeersPoker: folds 
schmollhans: folds 
*** FLOP *** [4h 7h 9c]
forestry800: checks 
ms1272: checks 
*** TURN *** [4h 7h 9c] [As]
forestry800: checks 
ms1272: checks 
*** RIVER *** [4h 7h 9c As] [Ah]
forestry800: checks 
ms1272: checks 
*** SHOW DOWN ***
forestry800: shows [Kc Jc] (a pair of Aces)
ms1272: shows [Ks Qd] (a pair of Aces - King+Queen kicker)
ms1272 collected $3.05 from pot
*** SUMMARY ***
Total pot $3.25 | Rake $0.20 
Board [4h 7h 9c As Ah]
Seat 1: ms1272 (button) showed [Ks Qd] and won ($3.05) with a pair of Aces
Seat 2: FeersPoker (small blind) folded before Flop
Seat 3: schmollhans (big blind) folded before Flop
Seat 4: nicu4you folded before Flop (didn't bet)
Seat 5: funker84 folded before Flop (didn't bet)
Seat 6: Dragonclawss folded before Flop (didn't bet)
Seat 7: forestry800 showed [Kc Jc] and lost with a pair of Aces
Seat 8: Pachebrash folded before Flop (didn't bet)
Seat 9: fragonik folded before Flop (didn't bet)



PokerStars Hand #228689116037:  Hold'em No Limit ($0.25/$0.50 USD) - 2021/07/30 16:48:28 ET
Table 'Gorgo III' 9-max Seat #5 is the button
Seat 1: Popokluev ($52.13 in chips) 
Seat 2: inflexiblle ($51.96 in chips) 
Seat 4: nicu4you ($74.91 in chips) 
Seat 5: funker84 ($56.30 in chips) 
Seat 6: MR.PATJEW ($60.84 in chips) 
Seat 7: wildermorph ($49.25 in chips) 
Seat 8: Lisenok110 ($60.54 in chips) 
Seat 9: fragonik ($53.20 in chips) 
MR.PATJEW: posts small blind $0.25
wildermorph: posts big blind $0.50
*** HOLE CARDS ***
Lisenok110: folds 
fragonik: folds 
Popokluev: folds 
inflexiblle: folds 
nicu4you: folds 
funker84: raises $0.50 to $1
MR.PATJEW: folds 
wildermorph: folds 
Uncalled bet ($0.50) returned to funker84
funker84 collected $1.25 from pot
funker84: doesn't show hand 
*** SUMMARY ***
Total pot $1.25 | Rake $0 
Seat 1: Popokluev folded before Flop (didn't bet)
Seat 2: inflexiblle folded before Flop (didn't bet)
Seat 4: nicu4you folded before Flop (didn't bet)
Seat 5: funker84 (button) collected ($1.25)
Seat 6: MR.PATJEW (small blind) folded before Flop
Seat 7: wildermorph (big blind) folded before Flop
Seat 8: Lisenok110 folded before Flop (didn't bet)
Seat 9: fragonik folded before Flop (didn't bet)



PokerStars Hand #228689131141:  Hold'em No Limit ($0.25/$0.50 USD) - 2021/07/30 16:49:00 ET
Table 'Gorgo III' 9-max Seat #6 is the button
Seat 1: Popokluev ($52.13 in chips) 
Seat 2: inflexiblle ($51.96 in chips) 
Seat 4: nicu4you ($74.91 in chips) 
Seat 5: funker84 ($57.05 in chips) 
Seat 6: MR.PATJEW ($60.59 in chips) 
Seat 7: wildermorph ($48.75 in chips) 
Seat 8: Lisenok110 ($60.54 in chips) 
Seat 9: fragonik ($53.20 in chips) 
wildermorph: posts small blind $0.25
Lisenok110: posts big blind $0.50
*** HOLE CARDS ***
fragonik: raises $1 to $1.50
Popokluev: folds 
inflexiblle: folds 
nicu4you: folds 
funker84: folds 
MR.PATJEW: calls $1.50
wildermorph: folds 
Lisenok110: folds 
*** FLOP *** [2d 4h Jd]
fragonik: checks 
MR.PATJEW: bets $3.56
fragonik: calls $3.56
*** TURN *** [2d 4h Jd] [Ts]
fragonik: checks 
MR.PATJEW: bets $6.16
fragonik: raises $10.34 to $16.50
MR.PATJEW: calls $10.34
*** RIVER *** [2d 4h Jd Ts] [8c]
fragonik: checks 
MR.PATJEW: checks 
*** SHOW DOWN ***
fragonik: shows [Ad 6d] (high card Ace)
MR.PATJEW: shows [Qc Jh] (a pair of Jacks)
MR.PATJEW collected $41.87 from pot
*** SUMMARY ***
Total pot $43.87 | Rake $2 
Board [2d 4h Jd Ts 8c]
Seat 1: Popokluev folded before Flop (didn't bet)
Seat 2: inflexiblle folded before Flop (didn't bet)
Seat 4: nicu4you folded before Flop (didn't bet)
Seat 5: funker84 folded before Flop (didn't bet)
Seat 6: MR.PATJEW (button) showed [Qc Jh] and won ($41.87) with a pair of Jacks
Seat 7: wildermorph (small blind) folded before Flop
Seat 8: Lisenok110 (big blind) folded before Flop
Seat 9: fragonik showed [Ad 6d] and lost with high card Ace



PokerStars Hand #228689165790:  Hold'em No Limit ($0.25/$0.50 USD) - 2021/07/30 16:50:12 ET
Table 'Gorgo III' 9-max Seat #7 is the button
Seat 1: Popokluev ($52.13 in chips) 
Seat 2: inflexiblle ($51.96 in chips) 
Seat 4: nicu4you ($74.91 in chips) 
Seat 5: funker84 ($57.05 in chips) 
Seat 6: MR.PATJEW ($80.90 in chips) 
Seat 7: wildermorph ($48.50 in chips) 
Seat 8: Lisenok110 ($60.04 in chips) 
Seat 9: fragonik ($50 in chips) 
Lisenok110: posts small blind $0.25
fragonik: posts big blind $0.50
*** HOLE CARDS ***
Popokluev: raises $1 to $1.50
inflexiblle: folds 
nicu4you: folds 
funker84: folds 
MR.PATJEW: folds 
wildermorph: folds 
Lisenok110: calls $1.25
fragonik: raises $5 to $6.50
Popokluev: folds 
Lisenok110: folds 
Uncalled bet ($5) returned to fragonik
fragonik collected $4.50 from pot
*** SUMMARY ***
Total pot $4.50 | Rake $0 
Seat 1: Popokluev folded before Flop
Seat 2: inflexiblle folded before Flop (didn't bet)
Seat 4: nicu4you folded before Flop (didn't bet)
Seat 5: funker84 folded before Flop (didn't bet)
Seat 6: MR.PATJEW folded before Flop (didn't bet)
Seat 7: wildermorph (button) folded before Flop (didn't bet)
Seat 8: Lisenok110 (small blind) folded before Flop
Seat 9: fragonik (big blind) collected ($4.50)



PokerStars Hand #228689183338:  Hold'em No Limit ($0.25/$0.50 USD) - 2021/07/30 16:50:49 ET
Table 'Gorgo III' 9-max Seat #8 is the button
Seat 1: Popokluev ($50.63 in chips) 
Seat 2: inflexiblle ($51.96 in chips) 
Seat 4: nicu4you ($74.91 in chips) 
Seat 5: funker84 ($57.05 in chips) 
Seat 6: MR.PATJEW ($80.90 in chips) 
Seat 7: wildermorph ($48.50 in chips) 
Seat 8: Lisenok110 ($58.54 in chips) 
Seat 9: fragonik ($53 in chips) 
fragonik: posts small blind $0.25
Popokluev: posts big blind $0.50
*** HOLE CARDS ***
inflexiblle: folds 
Dragonclawss leaves the table
nicu4you: raises $1 to $1.50
funker84: folds 
MR.PATJEW: folds 
wildermorph: folds 
Lisenok110: folds 
inflexiblle leaves the table
fragonik: folds 
Popokluev: folds 
Uncalled bet ($1) returned to nicu4you
nicu4you collected $1.25 from pot
nicu4you: doesn't show hand 
*** SUMMARY ***
Total pot $1.25 | Rake $0 
Seat 1: Popokluev (big blind) folded before Flop
Seat 2: inflexiblle folded before Flop (didn't bet)
Seat 4: nicu4you collected ($1.25)
Seat 5: funker84 folded before Flop (didn't bet)
Seat 6: MR.PATJEW folded before Flop (didn't bet)
Seat 7: wildermorph folded before Flop (didn't bet)
Seat 8: Lisenok110 (button) folded before Flop (didn't bet)
Seat 9: fragonik (small blind) folded before Flop



PokerStars Hand #228689194030:  Hold'em No Limit ($0.25/$0.50 USD) - 2021/07/30 16:51:11 ET
Table 'Gorgo III' 9-max Seat #9 is the button
Seat 1: Popokluev ($50.13 in chips) 
Seat 4: nicu4you ($75.66 in chips) 
Seat 5: funker84 ($57.05 in chips) 
Seat 6: MR.PATJEW ($80.90 in chips) 
Seat 7: wildermorph ($48.50 in chips) 
Seat 8: Lisenok110 ($58.54 in chips) 
Seat 9: fragonik ($52.75 in chips) 
Popokluev: posts small blind $0.25
nicu4you: posts big blind $0.50
*** HOLE CARDS ***
funker84: folds 
MR.PATJEW has timed out
MR.PATJEW: folds 
wildermorph: folds 
Lisenok110: folds 
fragonik: raises $0.75 to $1.25
Popokluev: folds 
nicu4you: raises $3.25 to $4.50
fragonik: calls $3.25
*** FLOP *** [Th Tc 7c]
nicu4you: bets $4.83
FeersPoker joins the table at seat #2 
fragonik: folds 
Uncalled bet ($4.83) returned to nicu4you
nicu4you collected $8.79 from pot
nicu4you: doesn't show hand 
*** SUMMARY ***
Total pot $9.25 | Rake $0.46 
Board [Th Tc 7c]
Seat 1: Popokluev (small blind) folded before Flop
Seat 4: nicu4you (big blind) collected ($8.79)
Seat 5: funker84 folded before Flop (didn't bet)
Seat 6: MR.PATJEW folded before Flop (didn't bet)
Seat 7: wildermorph folded before Flop (didn't bet)
Seat 8: Lisenok110 folded before Flop (didn't bet)
Seat 9: fragonik (button) folded on the Flop



PokerStars Hand #228689225752:  Hold'em No Limit ($0.25/$0.50 USD) - 2021/07/30 16:52:17 ET
Table 'Gorgo III' 9-max Seat #1 is the button
Seat 1: Popokluev ($50 in chips) 
Seat 4: nicu4you ($79.95 in chips) 
Seat 5: funker84 ($57.05 in chips) 
Seat 6: MR.PATJEW ($80.90 in chips) 
Seat 7: wildermorph ($48.50 in chips) 
Seat 8: Lisenok110 ($58.54 in chips) 
Seat 9: fragonik ($50 in chips) 
nicu4you: posts small blind $0.25
funker84: posts big blind $0.50
*** HOLE CARDS ***
MR.PATJEW: folds 
wildermorph: folds 
Lisenok110: raises $0.75 to $1.25
fragonik: folds 
Popokluev: folds 
nicu4you: folds 
funker84: folds 
Uncalled bet ($0.75) returned to Lisenok110
Lisenok110 collected $1.25 from pot
Lisenok110: doesn't show hand 
*** SUMMARY ***
Total pot $1.25 | Rake $0 
Seat 1: Popokluev (button) folded before Flop (didn't bet)
Seat 4: nicu4you (small blind) folded before Flop
Seat 5: funker84 (big blind) folded before Flop
Seat 6: MR.PATJEW folded before Flop (didn't bet)
Seat 7: wildermorph folded before Flop (didn't bet)
Seat 8: Lisenok110 collected ($1.25)
Seat 9: fragonik folded before Flop (didn't bet)



PokerStars Hand #228689233170:  Hold'em No Limit ($0.25/$0.50 USD) - 2021/07/30 16:52:33 ET
Table 'Gorgo III' 9-max Seat #4 is the button
Seat 1: Popokluev ($50 in chips) 
Seat 4: nicu4you ($79.70 in chips) 
Seat 5: funker84 ($56.55 in chips) 
Seat 6: MR.PATJEW ($80.90 in chips) 
Seat 7: wildermorph ($48.50 in chips) 
Seat 8: Lisenok110 ($59.29 in chips) 
Seat 9: fragonik ($50 in chips) 
funker84: posts small blind $0.25
MR.PATJEW: posts big blind $0.50
FeersPoker: sits out 
*** HOLE CARDS ***
wildermorph: folds 
Lisenok110: folds 
fragonik: folds 
Popokluev: folds 
nicu4you: raises $0.75 to $1.25
funker84: folds 
MR.PATJEW: folds 
Uncalled bet ($0.75) returned to nicu4you
nicu4you collected $1.25 from pot
nicu4you: doesn't show hand 
*** SUMMARY ***
Total pot $1.25 | Rake $0 
Seat 1: Popokluev folded before Flop (didn't bet)
Seat 4: nicu4you (button) collected ($1.25)
Seat 5: funker84 (small blind) folded before Flop
Seat 6: MR.PATJEW (big blind) folded before Flop
Seat 7: wildermorph folded before Flop (didn't bet)
Seat 8: Lisenok110 folded before Flop (didn't bet)
Seat 9: fragonik folded before Flop (didn't bet)



PokerStars Hand #228689243234:  Hold'em No Limit ($0.25/$0.50 USD) - 2021/07/30 16:52:54 ET
Table 'Gorgo III' 9-max Seat #5 is the button
Seat 1: Popokluev ($50 in chips) 
Seat 4: nicu4you ($80.45 in chips) 
Seat 5: funker84 ($56.30 in chips) 
Seat 6: MR.PATJEW ($80.40 in chips) 
Seat 7: wildermorph ($48.50 in chips) 
Seat 8: Lisenok110 ($59.29 in chips) 
Seat 9: fragonik ($50 in chips) 
MR.PATJEW: posts small blind $0.25
wildermorph: posts big blind $0.50
FeersPoker: sits out 
*** HOLE CARDS ***
Lisenok110: folds 
fragonik: folds 
Popokluev: folds 
nicu4you: raises $1 to $1.50
funker84: folds 
MR.PATJEW: folds 
wildermorph: folds 
Uncalled bet ($1) returned to nicu4you
nicu4you collected $1.25 from pot
nicu4you: doesn't show hand 
*** SUMMARY ***
Total pot $1.25 | Rake $0 
Seat 1: Popokluev folded before Flop (didn't bet)
Seat 4: nicu4you collected ($1.25)
Seat 5: funker84 (button) folded before Flop (didn't bet)
Seat 6: MR.PATJEW (small blind) folded before Flop
Seat 7: wildermorph (big blind) folded before Flop
Seat 8: Lisenok110 folded before Flop (didn't bet)
Seat 9: fragonik folded before Flop (didn't bet)



PokerStars Hand #228689253671:  Hold'em No Limit ($0.25/$0.50 USD) - 2021/07/30 16:53:15 ET
Table 'Gorgo III' 9-max Seat #6 is the button
Seat 1: Popokluev ($50 in chips) 
Seat 4: nicu4you ($81.20 in chips) 
Seat 5: funker84 ($56.30 in chips) 
Seat 6: MR.PATJEW ($80.15 in chips) 
Seat 7: wildermorph ($48 in chips) 
Seat 8: Lisenok110 ($59.29 in chips) 
Seat 9: fragonik ($50 in chips) 
wildermorph: posts small blind $0.25
Lisenok110: posts big blind $0.50
FeersPoker: sits out 
*** HOLE CARDS ***
fragonik: folds 
Popokluev: folds 
nicu4you: raises $0.75 to $1.25
funker84: folds 
MR.PATJEW: folds 
wildermorph: folds 
Lisenok110: folds 
Uncalled bet ($0.75) returned to nicu4you
nicu4you collected $1.25 from pot
nicu4you: doesn't show hand 
*** SUMMARY ***
Total pot $1.25 | Rake $0 
Seat 1: Popokluev folded before Flop (didn't bet)
Seat 4: nicu4you collected ($1.25)
Seat 5: funker84 folded before Flop (didn't bet)
Seat 6: MR.PATJEW (button) folded before Flop (didn't bet)
Seat 7: wildermorph (small blind) folded before Flop
Seat 8: Lisenok110 (big blind) folded before Flop
Seat 9: fragonik folded before Flop (didn't bet)



PokerStars Hand #228689264803:  Hold'em No Limit ($0.25/$0.50 USD) - 2021/07/30 16:53:39 ET
Table 'Gorgo III' 9-max Seat #7 is the button
Seat 1: Popokluev ($50 in chips) 
Seat 4: nicu4you ($81.95 in chips) 
Seat 5: funker84 ($56.30 in chips) 
Seat 6: MR.PATJEW ($80.15 in chips) 
Seat 7: wildermorph ($47.75 in chips) 
Seat 8: Lisenok110 ($58.79 in chips) 
Seat 9: fragonik ($50 in chips) 
Lisenok110: posts small blind $0.25
fragonik: posts big blind $0.50
FeersPoker: sits out 
*** HOLE CARDS ***
Popokluev: folds 
nicu4you: folds 
funker84: folds 
MR.PATJEW: folds 
wildermorph: folds 
Lisenok110: folds 
Uncalled bet ($0.25) returned to fragonik
fragonik collected $0.50 from pot
*** SUMMARY ***
Total pot $0.50 | Rake $0 
Seat 1: Popokluev folded before Flop (didn't bet)
Seat 4: nicu4you folded before Flop (didn't bet)
Seat 5: funker84 folded before Flop (didn't bet)
Seat 6: MR.PATJEW folded before Flop (didn't bet)
Seat 7: wildermorph (button) folded before Flop (didn't bet)
Seat 8: Lisenok110 (small blind) folded before Flop
Seat 9: fragonik (big blind) collected ($0.50)



PokerStars Hand #228689270439:  Hold'em No Limit ($0.25/$0.50 USD) - 2021/07/30 16:53:50 ET
Table 'Gorgo III' 9-max Seat #8 is the button
Seat 1: Popokluev ($50 in chips) 
Seat 4: nicu4you ($81.95 in chips) 
Seat 5: funker84 ($56.30 in chips) 
Seat 6: MR.PATJEW ($80.15 in chips) 
Seat 7: wildermorph ($47.75 in chips) 
Seat 8: Lisenok110 ($58.54 in chips) 
Seat 9: fragonik ($50.25 in chips) 
fragonik: posts small blind $0.25
Popokluev: posts big blind $0.50
FeersPoker: sits out 
*** HOLE CARDS ***
nicu4you: raises $1 to $1.50
funker84: folds 
MR.PATJEW: folds 
wildermorph: folds 
Lisenok110: folds 
fragonik: folds 
Popokluev: folds 
Uncalled bet ($1) returned to nicu4you
nicu4you collected $1.25 from pot
nicu4you: doesn't show hand 
*** SUMMARY ***
Total pot $1.25 | Rake $0 
Seat 1: Popokluev (big blind) folded before Flop
Seat 4: nicu4you collected ($1.25)
Seat 5: funker84 folded before Flop (didn't bet)
Seat 6: MR.PATJEW folded before Flop (didn't bet)
Seat 7: wildermorph folded before Flop (didn't bet)
Seat 8: Lisenok110 (button) folded before Flop (didn't bet)
Seat 9: fragonik (small blind) folded before Flop



PokerStars Hand #228689281488:  Hold'em No Limit ($0.25/$0.50 USD) - 2021/07/30 16:54:08 ET
Table 'Gorgo III' 9-max Seat #9 is the button
Seat 1: Popokluev ($50 in chips) 
Seat 2: FeersPoker ($50 in chips) 
Seat 4: nicu4you ($82.70 in chips) 
Seat 5: funker84 ($56.30 in chips) 
Seat 6: MR.PATJEW ($80.15 in chips) 
Seat 7: wildermorph ($47.75 in chips) 
Seat 8: Lisenok110 ($58.54 in chips) 
Seat 9: fragonik ($50 in chips) 
Popokluev: posts small blind $0.25
FeersPoker: posts big blind $0.50
*** HOLE CARDS ***
nicu4you: folds 
funker84: calls $0.50
MR.PATJEW: folds 
wildermorph: folds 
Lisenok110: raises $1 to $1.50
fragonik: folds 
Popokluev: folds 
wildermorph leaves the table
FeersPoker: calls $1
funker84: calls $1
*** FLOP *** [5h 7h Qh]
FeersPoker: checks 
funker84: checks 
Lisenok110: checks 
*** TURN *** [5h 7h Qh] [3c]
FeersPoker: checks 
funker84: checks 
Lisenok110: checks 
*** RIVER *** [5h 7h Qh 3c] [Qd]
FeersPoker: checks 
funker84: bets $3.50
Lisenok110: folds 
FeersPoker: folds 
Uncalled bet ($3.50) returned to funker84
funker84 collected $4.45 from pot
funker84: doesn't show hand 
*** SUMMARY ***
Total pot $4.75 | Rake $0.30 
Board [5h 7h Qh 3c Qd]
Seat 1: Popokluev (small blind) folded before Flop
Seat 2: FeersPoker (big blind) folded on the River
Seat 4: nicu4you folded before Flop (didn't bet)
Seat 5: funker84 collected ($4.45)
Seat 6: MR.PATJEW folded before Flop (didn't bet)
Seat 7: wildermorph folded before Flop (didn't bet)
Seat 8: Lisenok110 folded on the River
Seat 9: fragonik (button) folded before Flop (didn't bet)



PokerStars Hand #228689316714:  Hold'em No Limit ($0.25/$0.50 USD) - 2021/07/30 16:55:10 ET
Table 'Gorgo III' 9-max Seat #1 is the button
Seat 1: Popokluev ($50 in chips) 
Seat 2: FeersPoker ($50 in chips) 
Seat 4: nicu4you ($82.70 in chips) 
Seat 5: funker84 ($59.25 in chips) 
Seat 6: MR.PATJEW ($80.15 in chips) 
Seat 8: Lisenok110 ($57.04 in chips) 
Seat 9: fragonik ($50 in chips) 
FeersPoker: posts small blind $0.25
nicu4you: posts big blind $0.50
*** HOLE CARDS ***
funker84: folds 
MR.PATJEW: folds 
Lisenok110: folds 
fragonik: raises $0.75 to $1.25
Popokluev: raises $3 to $4.25
FeersPoker: folds 
nicu4you: folds 
forestry800 joins the table at seat #7 
schmollhans joins the table at seat #3 
fragonik: raises $6.25 to $10.50
Popokluev: raises $39.50 to $50 and is all-in
fragonik: folds 
Uncalled bet ($39.50) returned to Popokluev
Popokluev collected $21.75 from pot
Popokluev: doesn't show hand 
*** SUMMARY ***
Total pot $21.75 | Rake $0 
Seat 1: Popokluev (button) collected ($21.75)
Seat 2: FeersPoker (small blind) folded before Flop
Seat 4: nicu4you (big blind) folded before Flop
Seat 5: funker84 folded before Flop (didn't bet)
Seat 6: MR.PATJEW folded before Flop (didn't bet)
Seat 8: Lisenok110 folded before Flop (didn't bet)
Seat 9: fragonik folded before Flop



PokerStars Hand #228689340756:  Hold'em No Limit ($0.25/$0.50 USD) - 2021/07/30 16:56:21 ET
Table 'Gorgo III' 9-max Seat #2 is the button
Seat 1: Popokluev ($61.25 in chips) 
Seat 2: FeersPoker ($50 in chips) 
Seat 4: nicu4you ($82.20 in chips) 
Seat 5: funker84 ($59.25 in chips) 
Seat 6: MR.PATJEW ($80.15 in chips) 
Seat 8: Lisenok110 ($57.04 in chips) 
Seat 9: fragonik ($50 in chips) 
nicu4you: posts small blind $0.25
funker84: posts big blind $0.50
forestry800: sits out 
*** HOLE CARDS ***
MR.PATJEW: raises $0.50 to $1
Lisenok110: folds 
fragonik: folds 
Popokluev: folds 
FeersPoker: folds 
nicu4you: folds 
funker84: folds 
Uncalled bet ($0.50) returned to MR.PATJEW
MR.PATJEW collected $1.25 from pot
MR.PATJEW: doesn't show hand 
*** SUMMARY ***
Total pot $1.25 | Rake $0 
Seat 1: Popokluev folded before Flop (didn't bet)
Seat 2: FeersPoker (button) folded before Flop (didn't bet)
Seat 4: nicu4you (small blind) folded before Flop
Seat 5: funker84 (big blind) folded before Flop
Seat 6: MR.PATJEW collected ($1.25)
Seat 8: Lisenok110 folded before Flop (didn't bet)
Seat 9: fragonik folded before Flop (didn't bet)



PokerStars Hand #228689343866:  Hold'em No Limit ($0.25/$0.50 USD) - 2021/07/30 16:56:30 ET
Table 'Gorgo III' 9-max Seat #4 is the button
Seat 1: Popokluev ($61.25 in chips) 
Seat 2: FeersPoker ($50 in chips) 
Seat 3: schmollhans ($40 in chips) 
Seat 4: nicu4you ($81.95 in chips) 
Seat 5: funker84 ($58.75 in chips) 
Seat 6: MR.PATJEW ($80.90 in chips) 
Seat 8: Lisenok110 ($57.04 in chips) 
Seat 9: fragonik ($50 in chips) 
funker84: posts small blind $0.25
MR.PATJEW: posts big blind $0.50
forestry800: sits out 
schmollhans: posts big blind $0.50
*** HOLE CARDS ***
Lisenok110: folds 
fragonik: folds 
Popokluev: folds 
FeersPoker: folds 
schmollhans: checks 
nicu4you: raises $1.75 to $2.25
funker84: folds 
MR.PATJEW: folds 
schmollhans: folds 
Uncalled bet ($1.75) returned to nicu4you
nicu4you collected $1.75 from pot
nicu4you: doesn't show hand 
*** SUMMARY ***
Total pot $1.75 | Rake $0 
Seat 1: Popokluev folded before Flop (didn't bet)
Seat 2: FeersPoker folded before Flop (didn't bet)
Seat 3: schmollhans folded before Flop (didn't bet)
Seat 4: nicu4you (button) collected ($1.75)
Seat 5: funker84 (small blind) folded before Flop
Seat 6: MR.PATJEW (big blind) folded before Flop
Seat 8: Lisenok110 folded before Flop (didn't bet)
Seat 9: fragonik folded before Flop (didn't bet)



PokerStars Hand #228689350651:  Hold'em No Limit ($0.25/$0.50 USD) - 2021/07/30 16:56:49 ET
Table 'Gorgo III' 9-max Seat #5 is the button
Seat 1: Popokluev ($61.25 in chips) 
Seat 2: FeersPoker ($50 in chips) 
Seat 3: schmollhans ($39.50 in chips) 
Seat 4: nicu4you ($83.20 in chips) 
Seat 5: funker84 ($58.50 in chips) 
Seat 6: MR.PATJEW ($80.40 in chips) 
Seat 7: forestry800 ($50 in chips) 
Seat 8: Lisenok110 ($57.04 in chips) 
Seat 9: fragonik ($50 in chips) 
MR.PATJEW: posts small blind $0.25
forestry800: posts big blind $0.50
*** HOLE CARDS ***
Lisenok110: folds 
fragonik: raises $1 to $1.50
Popokluev: folds 
FeersPoker: folds 
schmollhans: folds 
nicu4you: folds 
funker84 has timed out
funker84: folds 
MR.PATJEW: calls $1.25
forestry800: calls $1
*** FLOP *** [Th 7s 3d]
MR.PATJEW: bets $2.14
forestry800: calls $2.14
fragonik: folds 
*** TURN *** [Th 7s 3d] [Qh]
MR.PATJEW: checks 
forestry800: checks 
*** RIVER *** [Th 7s 3d Qh] [Jc]
MR.PATJEW: checks 
forestry800: checks 
*** SHOW DOWN ***
MR.PATJEW: shows [Td Ac] (a pair of Tens)
forestry800: mucks hand 
MR.PATJEW collected $8.34 from pot
*** SUMMARY ***
Total pot $8.78 | Rake $0.44 
Board [Th 7s 3d Qh Jc]
Seat 1: Popokluev folded before Flop (didn't bet)
Seat 2: FeersPoker folded before Flop (didn't bet)
Seat 3: schmollhans folded before Flop (didn't bet)
Seat 4: nicu4you folded before Flop (didn't bet)
Seat 5: funker84 (button) folded before Flop (didn't bet)
Seat 6: MR.PATJEW (small blind) showed [Td Ac] and won ($8.34) with a pair of Tens
Seat 7: forestry800 (big blind) mucked
Seat 8: Lisenok110 folded before Flop (didn't bet)
Seat 9: fragonik folded on the Flop



PokerStars Hand #228689378418:  Hold'em No Limit ($0.25/$0.50 USD) - 2021/07/30 16:58:10 ET
Table 'Gorgo III' 9-max Seat #6 is the button
Seat 1: Popokluev ($61.25 in chips) 
Seat 2: FeersPoker ($50 in chips) 
Seat 3: schmollhans ($39.50 in chips) 
Seat 4: nicu4you ($83.20 in chips) 
Seat 6: MR.PATJEW ($85.10 in chips) 
Seat 7: forestry800 ($50 in chips) 
Seat 9: fragonik ($50 in chips) 
forestry800: posts small blind $0.25
Lisenok110: is sitting out 
fragonik: posts big blind $0.50
*** HOLE CARDS ***
Popokluev: folds 
Lisenok110 leaves the table
FeersPoker: folds 
schmollhans: folds 
nicu4you: folds 
MR.PATJEW: calls $0.50
forestry800: folds 
fragonik: checks 
*** FLOP *** [As 5d Kh]
fragonik: checks 
Gluck35 joins the table at seat #8 
MR.PATJEW: checks 
*** TURN *** [As 5d Kh] [5s]
fragonik: bets $0.58
MR.PATJEW: calls $0.58
*** RIVER *** [As 5d Kh 5s] [Ts]
fragonik: checks 
MR.PATJEW: checks 
*** SHOW DOWN ***
fragonik: shows [7d 4h] (a pair of Fives)
MR.PATJEW: shows [Jh Ks] (two pair, Kings and Fives)
MR.PATJEW collected $2.29 from pot
*** SUMMARY ***
Total pot $2.41 | Rake $0.12 
Board [As 5d Kh 5s Ts]
Seat 1: Popokluev folded before Flop (didn't bet)
Seat 2: FeersPoker folded before Flop (didn't bet)
Seat 3: schmollhans folded before Flop (didn't bet)
Seat 4: nicu4you folded before Flop (didn't bet)
Seat 6: MR.PATJEW (button) showed [Jh Ks] and won ($2.29) with two pair, Kings and Fives
Seat 7: forestry800 (small blind) folded before Flop
Seat 9: fragonik (big blind) showed [7d 4h] and lost with a pair of Fives



PokerStars Hand #228689412316:  Hold'em No Limit ($0.25/$0.50 USD) - 2021/07/30 16:59:48 ET
Table 'Gorgo III' 9-max Seat #7 is the button
Seat 1: Popokluev ($61.25 in chips) 
Seat 2: FeersPoker ($50 in chips) 
Seat 3: schmollhans ($39.50 in chips) 
Seat 4: nicu4you ($83.20 in chips) 
Seat 6: MR.PATJEW ($86.31 in chips) 
Seat 7: forestry800 ($50 in chips) 
Seat 9: fragonik ($50 in chips) 
fragonik: posts small blind $0.25
Popokluev: posts big blind $0.50
*** HOLE CARDS ***
FeersPoker: folds 
schmollhans: raises $1 to $1.50
nicu4you: folds 
MR.PATJEW: calls $1.50
forestry800: calls $1.50
fragonik: folds 
Popokluev: folds 
*** FLOP *** [6c Jh 5c]
schmollhans: bets $2.50
MR.PATJEW: calls $2.50
forestry800: folds 
*** TURN *** [6c Jh 5c] [Th]
schmollhans: checks 
MR.PATJEW: checks 
*** RIVER *** [6c Jh 5c Th] [9c]
schmollhans: checks 
MR.PATJEW: bets $9.74
schmollhans: folds 
Uncalled bet ($9.74) returned to MR.PATJEW
MR.PATJEW collected $9.74 from pot
MR.PATJEW: doesn't show hand 
*** SUMMARY ***
Total pot $10.25 | Rake $0.51 
Board [6c Jh 5c Th 9c]
Seat 1: Popokluev (big blind) folded before Flop
Seat 2: FeersPoker folded before Flop (didn't bet)
Seat 3: schmollhans folded on the River
Seat 4: nicu4you folded before Flop (didn't bet)
Seat 6: MR.PATJEW collected ($9.74)
Seat 7: forestry800 (button) folded on the Flop
Seat 9: fragonik (small blind) folded before Flop



PokerStars Hand #228689442293:  Hold'em No Limit ($0.25/$0.50 USD) - 2021/07/30 17:01:09 ET
Table 'Gorgo III' 9-max Seat #9 is the button
Seat 1: Popokluev ($60.75 in chips) 
Seat 2: FeersPoker ($50 in chips) 
Seat 3: schmollhans ($35.50 in chips) 
Seat 4: nicu4you ($83.20 in chips) 
Seat 5: funker84 ($58.50 in chips) 
Seat 6: MR.PATJEW ($92.05 in chips) 
Seat 7: forestry800 ($50 in chips) 
Seat 9: fragonik ($50 in chips) 
Popokluev: posts small blind $0.25
FeersPoker: posts big blind $0.50
Gluck35: sits out 
*** HOLE CARDS ***
schmollhans: folds 
nicu4you: folds 
funker84: folds 
MR.PATJEW: folds 
forestry800: folds 
fragonik: raises $0.75 to $1.25
Popokluev: folds 
FeersPoker: folds 
Uncalled bet ($0.75) returned to fragonik
fragonik collected $1.25 from pot
*** SUMMARY ***
Total pot $1.25 | Rake $0 
Seat 1: Popokluev (small blind) folded before Flop
Seat 2: FeersPoker (big blind) folded before Flop
Seat 3: schmollhans folded before Flop (didn't bet)
Seat 4: nicu4you folded before Flop (didn't bet)
Seat 5: funker84 folded before Flop (didn't bet)
Seat 6: MR.PATJEW folded before Flop (didn't bet)
Seat 7: forestry800 folded before Flop (didn't bet)
Seat 9: fragonik (button) collected ($1.25)



PokerStars Hand #228689452408:  Hold'em No Limit ($0.25/$0.50 USD) - 2021/07/30 17:01:33 ET
Table 'Gorgo III' 9-max Seat #1 is the button
Seat 1: Popokluev ($60.50 in chips) 
Seat 2: FeersPoker ($50 in chips) 
Seat 3: schmollhans ($35.50 in chips) 
Seat 4: nicu4you ($83.20 in chips) 
Seat 5: funker84 ($58.50 in chips) 
Seat 6: MR.PATJEW ($92.05 in chips) 
Seat 7: forestry800 ($50 in chips) 
Seat 9: fragonik ($50.75 in chips) 
FeersPoker: posts small blind $0.25
schmollhans: posts big blind $0.50
Gluck35: sits out 
*** HOLE CARDS ***
nicu4you: folds 
funker84: folds 
MR.PATJEW: calls $0.50
forestry800: folds 
fragonik: folds 
Popokluev: folds 
FeersPoker: calls $0.25
schmollhans: checks 
*** FLOP *** [Jc Kd 7h]
FeersPoker: checks 
schmollhans: bets $0.50
MR.PATJEW: calls $0.50
FeersPoker: folds 
*** TURN *** [Jc Kd 7h] [8d]
schmollhans: bets $1.50
MR.PATJEW: calls $1.50
*** RIVER *** [Jc Kd 7h 8d] [4h]
schmollhans: checks 
MR.PATJEW: checks 
*** SHOW DOWN ***
schmollhans: shows [Ks 9h] (a pair of Kings)
MR.PATJEW: mucks hand 
schmollhans collected $5.15 from pot
*** SUMMARY ***
Total pot $5.50 | Rake $0.35 
Board [Jc Kd 7h 8d 4h]
Seat 1: Popokluev (button) folded before Flop (didn't bet)
Seat 2: FeersPoker (small blind) folded on the Flop
Seat 3: schmollhans (big blind) showed [Ks 9h] and won ($5.15) with a pair of Kings
Seat 4: nicu4you folded before Flop (didn't bet)
Seat 5: funker84 folded before Flop (didn't bet)
Seat 6: MR.PATJEW mucked
Seat 7: forestry800 folded before Flop (didn't bet)
Seat 9: fragonik folded before Flop (didn't bet)



PokerStars Hand #228689483444:  Hold'em No Limit ($0.25/$0.50 USD) - 2021/07/30 17:02:39 ET
Table 'Gorgo III' 9-max Seat #2 is the button
Seat 1: Popokluev ($60.50 in chips) 
Seat 2: FeersPoker ($50 in chips) 
Seat 3: schmollhans ($38.15 in chips) 
Seat 4: nicu4you ($83.20 in chips) 
Seat 5: funker84 ($58.50 in chips) 
Seat 6: MR.PATJEW ($89.55 in chips) 
Seat 7: forestry800 ($50 in chips) 
Seat 9: fragonik ($50.75 in chips) 
schmollhans: posts small blind $0.25
nicu4you: posts big blind $0.50
Gluck35: sits out 
*** HOLE CARDS ***
funker84: folds 
MR.PATJEW: folds 
forestry800: folds 
fragonik: folds 
Popokluev: raises $0.75 to $1.25
FeersPoker: folds 
schmollhans: folds 
nicu4you: calls $0.75
*** FLOP *** [Ac Qc Tc]
nicu4you: checks 
Popokluev: bets $0.86
nicu4you: raises $2.14 to $3
Popokluev: folds 
Uncalled bet ($2.14) returned to nicu4you
nicu4you collected $4.25 from pot
nicu4you: doesn't show hand 
*** SUMMARY ***
Total pot $4.47 | Rake $0.22 
Board [Ac Qc Tc]
Seat 1: Popokluev folded on the Flop
Seat 2: FeersPoker (button) folded before Flop (didn't bet)
Seat 3: schmollhans (small blind) folded before Flop
Seat 4: nicu4you (big blind) collected ($4.25)
Seat 5: funker84 folded before Flop (didn't bet)
Seat 6: MR.PATJEW folded before Flop (didn't bet)
Seat 7: forestry800 folded before Flop (didn't bet)
Seat 9: fragonik folded before Flop (didn't bet)



PokerStars Hand #228689503039:  Hold'em No Limit ($0.25/$0.50 USD) - 2021/07/30 17:03:21 ET
Table 'Gorgo III' 9-max Seat #3 is the button
Seat 1: Popokluev ($58.39 in chips) 
Seat 2: FeersPoker ($50 in chips) 
Seat 3: schmollhans ($37.90 in chips) 
Seat 4: nicu4you ($85.34 in chips) 
Seat 5: funker84 ($58.50 in chips) 
Seat 6: MR.PATJEW ($89.55 in chips) 
Seat 7: forestry800 ($50 in chips) 
Seat 9: fragonik ($50.75 in chips) 
nicu4you: posts small blind $0.25
funker84: posts big blind $0.50
Gluck35: sits out 
*** HOLE CARDS ***
MR.PATJEW has timed out
MR.PATJEW: folds 
forestry800: raises $0.75 to $1.25
fragonik: folds 
Popokluev: folds 
FeersPoker: folds 
schmollhans: folds 
nicu4you: folds 
funker84: folds 
Uncalled bet ($0.75) returned to forestry800
forestry800 collected $1.25 from pot
forestry800: doesn't show hand 
*** SUMMARY ***
Total pot $1.25 | Rake $0 
Seat 1: Popokluev folded before Flop (didn't bet)
Seat 2: FeersPoker folded before Flop (didn't bet)
Seat 3: schmollhans (button) folded before Flop (didn't bet)
Seat 4: nicu4you (small blind) folded before Flop
Seat 5: funker84 (big blind) folded before Flop
Seat 6: MR.PATJEW folded before Flop (didn't bet)
Seat 7: forestry800 collected ($1.25)
Seat 9: fragonik folded before Flop (didn't bet)



PokerStars Hand #228689513376:  Hold'em No Limit ($0.25/$0.50 USD) - 2021/07/30 17:03:43 ET
Table 'Gorgo III' 9-max Seat #4 is the button
Seat 1: Popokluev ($58.39 in chips) 
Seat 2: FeersPoker ($50 in chips) 
Seat 3: schmollhans ($37.90 in chips) 
Seat 4: nicu4you ($85.09 in chips) 
Seat 5: funker84 ($58 in chips) 
Seat 7: forestry800 ($50.75 in chips) 
Seat 9: fragonik ($50.75 in chips) 
funker84: posts small blind $0.25
forestry800: posts big blind $0.50
Gluck35: sits out 
*** HOLE CARDS ***
fragonik: folds 
Popokluev: folds 
FeersPoker: folds 
schmollhans: raises $1 to $1.50
nicu4you: calls $1.50
funker84: folds 
forestry800: folds 
*** FLOP *** [4d 9c 6d]
schmollhans: bets $1.25
nicu4you: calls $1.25
*** TURN *** [4d 9c 6d] [3c]
schmollhans: checks 
nicu4you: checks 
*** RIVER *** [4d 9c 6d 3c] [Tc]
schmollhans: checks 
nicu4you: checks 
*** SHOW DOWN ***
schmollhans: shows [Ks Qh] (high card King)
nicu4you: shows [As 4s] (a pair of Fours)
nicu4you collected $5.94 from pot
*** SUMMARY ***
Total pot $6.25 | Rake $0.31 
Board [4d 9c 6d 3c Tc]
Seat 1: Popokluev folded before Flop (didn't bet)
Seat 2: FeersPoker folded before Flop (didn't bet)
Seat 3: schmollhans showed [Ks Qh] and lost with high card King
Seat 4: nicu4you (button) showed [As 4s] and won ($5.94) with a pair of Fours
Seat 5: funker84 (small blind) folded before Flop
Seat 7: forestry800 (big blind) folded before Flop
Seat 9: fragonik folded before Flop (didn't bet)



PokerStars Hand #228689537674:  Hold'em No Limit ($0.25/$0.50 USD) - 2021/07/30 17:04:34 ET
Table 'Gorgo III' 9-max Seat #5 is the button
Seat 1: Popokluev ($58.39 in chips) 
Seat 2: FeersPoker ($50 in chips) 
Seat 3: schmollhans ($35.15 in chips) 
Seat 4: nicu4you ($88.28 in chips) 
Seat 5: funker84 ($57.75 in chips) 
Seat 7: forestry800 ($50.25 in chips) 
Seat 8: Gluck35 ($50 in chips) 
Seat 9: fragonik ($50.75 in chips) 
forestry800: posts small blind $0.25
Gluck35: posts big blind $0.50
*** HOLE CARDS ***
fragonik: folds 
Popokluev: folds 
FeersPoker: folds 
schmollhans: raises $1 to $1.50
nicu4you: folds 
funker84: calls $1.50
forestry800: folds 
Gluck35: folds 
*** FLOP *** [Kd Tc 2h]
schmollhans: bets $1.50
funker84: folds 
Uncalled bet ($1.50) returned to schmollhans
schmollhans collected $3.51 from pot
schmollhans: doesn't show hand 
*** SUMMARY ***
Total pot $3.75 | Rake $0.24 
Board [Kd Tc 2h]
Seat 1: Popokluev folded before Flop (didn't bet)
Seat 2: FeersPoker folded before Flop (didn't bet)
Seat 3: schmollhans collected ($3.51)
Seat 4: nicu4you folded before Flop (didn't bet)
Seat 5: funker84 (button) folded on the Flop
Seat 7: forestry800 (small blind) folded before Flop
Seat 8: Gluck35 (big blind) folded before Flop
Seat 9: fragonik folded before Flop (didn't bet)



PokerStars Hand #228689565619:  Hold'em No Limit ($0.25/$0.50 USD) - 2021/07/30 17:05:28 ET
Table 'Gorgo III' 9-max Seat #7 is the button
Seat 1: Popokluev ($58.39 in chips) 
Seat 2: FeersPoker ($50 in chips) 
Seat 3: schmollhans ($37.16 in chips) 
Seat 4: nicu4you ($88.28 in chips) 
Seat 5: funker84 ($56.25 in chips) 
Seat 6: MR.PATJEW ($89.55 in chips) 
Seat 7: forestry800 ($50 in chips) 
Seat 8: Gluck35 ($50 in chips) 
Seat 9: fragonik ($50.75 in chips) 
Gluck35: posts small blind $0.25
fragonik: posts big blind $0.50
MR.PATJEW: posts small & big blinds $0.75
*** HOLE CARDS ***
Popokluev: folds 
FeersPoker: folds 
schmollhans: calls $0.50
nicu4you: calls $0.50
funker84: folds 
MR.PATJEW: checks 
forestry800: folds 
Gluck35: folds 
fragonik: checks 
*** FLOP *** [Js 9h As]
fragonik: checks 
schmollhans: bets $1
nicu4you: folds 
MR.PATJEW: calls $1
fragonik: folds 
*** TURN *** [Js 9h As] [3d]
schmollhans: checks 
MR.PATJEW: checks 
*** RIVER *** [Js 9h As 3d] [Tc]
schmollhans: bets $3.77
MR.PATJEW: folds 
Uncalled bet ($3.77) returned to schmollhans
schmollhans collected $4.22 from pot
schmollhans: doesn't show hand 
*** SUMMARY ***
Total pot $4.50 | Rake $0.28 
Board [Js 9h As 3d Tc]
Seat 1: Popokluev folded before Flop (didn't bet)
Seat 2: FeersPoker folded before Flop (didn't bet)
Seat 3: schmollhans collected ($4.22)
Seat 4: nicu4you folded on the Flop
Seat 5: funker84 folded before Flop (didn't bet)
Seat 6: MR.PATJEW folded on the River
Seat 7: forestry800 (button) folded before Flop (didn't bet)
Seat 8: Gluck35 (small blind) folded before Flop
Seat 9: fragonik (big blind) folded on the Flop



PokerStars Hand #228689624510:  Hold'em No Limit ($0.25/$0.50 USD) - 2021/07/30 17:07:32 ET
Table 'Gorgo III' 9-max Seat #8 is the button
Seat 1: Popokluev ($58.39 in chips) 
Seat 2: FeersPoker ($50 in chips) 
Seat 3: schmollhans ($39.88 in chips) 
Seat 4: nicu4you ($87.78 in chips) 
Seat 5: funker84 ($56.25 in chips) 
Seat 6: MR.PATJEW ($87.80 in chips) 
Seat 7: forestry800 ($50 in chips) 
Seat 8: Gluck35 ($50 in chips) 
Seat 9: fragonik ($50.25 in chips) 
fragonik: posts small blind $0.25
Popokluev: posts big blind $0.50
*** HOLE CARDS ***
FeersPoker: raises $0.75 to $1.25
schmollhans: calls $1.25
nicu4you: folds 
funker84: folds 
MR.PATJEW has timed out
MR.PATJEW: folds 
forestry800: folds 
Gluck35: folds 
fragonik: folds 
Popokluev: folds 
*** FLOP *** [7d 5s 3h]
FeersPoker: checks 
schmollhans: bets $2
FeersPoker: calls $2
*** TURN *** [7d 5s 3h] [8d]
FeersPoker: checks 
schmollhans: bets $4.25
FeersPoker: calls $4.25
*** RIVER *** [7d 5s 3h 8d] [Jd]
FeersPoker: checks 
schmollhans: checks 
*** SHOW DOWN ***
FeersPoker: shows [Ks Kd] (a pair of Kings)
schmollhans: mucks hand 
FeersPoker collected $14.96 from pot
*** SUMMARY ***
Total pot $15.75 | Rake $0.79 
Board [7d 5s 3h 8d Jd]
Seat 1: Popokluev (big blind) folded before Flop
Seat 2: FeersPoker showed [Ks Kd] and won ($14.96) with a pair of Kings
Seat 3: schmollhans mucked
Seat 4: nicu4you folded before Flop (didn't bet)
Seat 5: funker84 folded before Flop (didn't bet)
Seat 6: MR.PATJEW folded before Flop (didn't bet)
Seat 7: forestry800 folded before Flop (didn't bet)
Seat 8: Gluck35 (button) folded before Flop (didn't bet)
Seat 9: fragonik (small blind) folded before Flop



PokerStars Hand #228689664203:  Hold'em No Limit ($0.25/$0.50 USD) - 2021/07/30 17:08:56 ET
Table 'Gorgo III' 9-max Seat #9 is the button
Seat 1: Popokluev ($57.89 in chips) 
Seat 2: FeersPoker ($57.46 in chips) 
Seat 3: schmollhans ($32.38 in chips) 
Seat 4: nicu4you ($87.78 in chips) 
Seat 5: funker84 ($56.25 in chips) 
Seat 6: MR.PATJEW ($87.80 in chips) 
Seat 7: forestry800 ($50 in chips) 
Seat 8: Gluck35 ($50 in chips) 
Seat 9: fragonik ($50 in chips) 
Popokluev: posts small blind $0.25
FeersPoker: posts big blind $0.50
*** HOLE CARDS ***
schmollhans: folds 
nicu4you: folds 
funker84 has timed out
funker84: folds 
MR.PATJEW: raises $1 to $1.50
forestry800: folds 
Gluck35: folds 
fragonik: folds 
Popokluev: folds 
FeersPoker: folds 
Uncalled bet ($1) returned to MR.PATJEW
MR.PATJEW collected $1.25 from pot
MR.PATJEW: doesn't show hand 
*** SUMMARY ***
Total pot $1.25 | Rake $0 
Seat 1: Popokluev (small blind) folded before Flop
Seat 2: FeersPoker (big blind) folded before Flop
Seat 3: schmollhans folded before Flop (didn't bet)
Seat 4: nicu4you folded before Flop (didn't bet)
Seat 5: funker84 folded before Flop (didn't bet)
Seat 6: MR.PATJEW collected ($1.25)
Seat 7: forestry800 folded before Flop (didn't bet)
Seat 8: Gluck35 folded before Flop (didn't bet)
Seat 9: fragonik (button) folded before Flop (didn't bet)



PokerStars Hand #228689678570:  Hold'em No Limit ($0.25/$0.50 USD) - 2021/07/30 17:09:27 ET
Table 'Gorgo III' 9-max Seat #1 is the button
Seat 1: Popokluev ($57.64 in chips) 
Seat 2: FeersPoker ($56.96 in chips) 
Seat 3: schmollhans ($32.38 in chips) 
Seat 4: nicu4you ($87.78 in chips) 
Seat 5: funker84 ($56.25 in chips) 
Seat 6: MR.PATJEW ($88.55 in chips) 
Seat 7: forestry800 ($50 in chips) 
Seat 8: Gluck35 ($50 in chips) 
Seat 9: fragonik ($50 in chips) 
FeersPoker: posts small blind $0.25
schmollhans: posts big blind $0.50
*** HOLE CARDS ***
nicu4you: raises $0.75 to $1.25
funker84: folds 
MR.PATJEW: folds 
forestry800: folds 
Gluck35: folds 
fragonik: folds 
Popokluev: folds 
FeersPoker: calls $1
schmollhans: calls $0.75
*** FLOP *** [2d 4h Tc]
FeersPoker: checks 
schmollhans: checks 
nicu4you: bets $1.96
FeersPoker: folds 
schmollhans: calls $1.96
*** TURN *** [2d 4h Tc] [Kc]
schmollhans: checks 
nicu4you: checks 
*** RIVER *** [2d 4h Tc Kc] [8h]
schmollhans: bets $6
nicu4you: folds 
Uncalled bet ($6) returned to schmollhans
schmollhans collected $7.19 from pot
schmollhans: doesn't show hand 
*** SUMMARY ***
Total pot $7.67 | Rake $0.48 
Board [2d 4h Tc Kc 8h]
Seat 1: Popokluev (button) folded before Flop (didn't bet)
Seat 2: FeersPoker (small blind) folded on the Flop
Seat 3: schmollhans (big blind) collected ($7.19)
Seat 4: nicu4you folded on the River
Seat 5: funker84 folded before Flop (didn't bet)
Seat 6: MR.PATJEW folded before Flop (didn't bet)
Seat 7: forestry800 folded before Flop (didn't bet)
Seat 8: Gluck35 folded before Flop (didn't bet)
Seat 9: fragonik folded before Flop (didn't bet)



PokerStars Hand #228689720288:  Hold'em No Limit ($0.25/$0.50 USD) - 2021/07/30 17:10:56 ET
Table 'Gorgo III' 9-max Seat #2 is the button
Seat 1: Popokluev ($57.64 in chips) 
Seat 2: FeersPoker ($55.71 in chips) 
Seat 3: schmollhans ($36.36 in chips) 
Seat 4: nicu4you ($84.57 in chips) 
Seat 5: funker84 ($56.25 in chips) 
Seat 6: MR.PATJEW ($88.55 in chips) 
Seat 7: forestry800 ($50 in chips) 
Seat 8: Gluck35 ($50 in chips) 
Seat 9: fragonik ($50 in chips) 
schmollhans: posts small blind $0.25
nicu4you: posts big blind $0.50
*** HOLE CARDS ***
funker84: folds 
MR.PATJEW: raises $1 to $1.50
forestry800: folds 
Gluck35: folds 
fragonik: folds 
Popokluev: folds 
FeersPoker: folds 
schmollhans: folds 
nicu4you: calls $1
*** FLOP *** [Ac 2s 3c]
nicu4you: checks 
MR.PATJEW: bets $1.54
nicu4you: folds 
Uncalled bet ($1.54) returned to MR.PATJEW
MR.PATJEW collected $3.09 from pot
MR.PATJEW: doesn't show hand 
*** SUMMARY ***
Total pot $3.25 | Rake $0.16 
Board [Ac 2s 3c]
Seat 1: Popokluev folded before Flop (didn't bet)
Seat 2: FeersPoker (button) folded before Flop (didn't bet)
Seat 3: schmollhans (small blind) folded before Flop
Seat 4: nicu4you (big blind) folded on the Flop
Seat 5: funker84 folded before Flop (didn't bet)
Seat 6: MR.PATJEW collected ($3.09)
Seat 7: forestry800 folded before Flop (didn't bet)
Seat 8: Gluck35 folded before Flop (didn't bet)
Seat 9: fragonik folded before Flop (didn't bet)



PokerStars Hand #228689734902:  Hold'em No Limit ($0.25/$0.50 USD) - 2021/07/30 17:11:28 ET
Table 'Gorgo III' 9-max Seat #3 is the button
Seat 1: Popokluev ($57.64 in chips) 
Seat 2: FeersPoker ($55.71 in chips) 
Seat 3: schmollhans ($36.11 in chips) 
Seat 4: nicu4you ($83.07 in chips) 
Seat 5: funker84 ($56.25 in chips) 
Seat 6: MR.PATJEW ($90.14 in chips) 
Seat 7: forestry800 ($50 in chips) 
Seat 8: Gluck35 ($50 in chips) 
Seat 9: fragonik ($50 in chips) 
nicu4you: posts small blind $0.25
funker84: posts big blind $0.50
*** HOLE CARDS ***
MR.PATJEW: raises $1 to $1.50
forestry800: folds 
Gluck35: folds 
fragonik: folds 
Popokluev: folds 
FeersPoker: folds 
schmollhans: folds 
nicu4you: raises $4 to $5.50
funker84 has timed out
funker84: folds 
MR.PATJEW: calls $4
*** FLOP *** [5s Js 6d]
nicu4you: bets $7.53
MR.PATJEW: folds 
Uncalled bet ($7.53) returned to nicu4you
nicu4you collected $10.92 from pot
nicu4you: doesn't show hand 
*** SUMMARY ***
Total pot $11.50 | Rake $0.58 
Board [5s Js 6d]
Seat 1: Popokluev folded before Flop (didn't bet)
Seat 2: FeersPoker folded before Flop (didn't bet)
Seat 3: schmollhans (button) folded before Flop (didn't bet)
Seat 4: nicu4you (small blind) collected ($10.92)
Seat 5: funker84 (big blind) folded before Flop
Seat 6: MR.PATJEW folded on the Flop
Seat 7: forestry800 folded before Flop (didn't bet)
Seat 8: Gluck35 folded before Flop (didn't bet)
Seat 9: fragonik folded before Flop (didn't bet)



PokerStars Hand #228689769123:  Hold'em No Limit ($0.25/$0.50 USD) - 2021/07/30 17:12:41 ET
Table 'Gorgo III' 9-max Seat #4 is the button
Seat 1: Popokluev ($57.64 in chips) 
Seat 2: FeersPoker ($55.71 in chips) 
Seat 3: schmollhans ($36.11 in chips) 
Seat 4: nicu4you ($88.49 in chips) 
Seat 5: funker84 ($55.75 in chips) 
Seat 6: MR.PATJEW ($84.64 in chips) 
Seat 7: forestry800 ($50 in chips) 
Seat 8: Gluck35 ($50 in chips) 
Seat 9: fragonik ($50 in chips) 
funker84: posts small blind $0.25
MR.PATJEW: posts big blind $0.50
*** HOLE CARDS ***
forestry800: folds 
Gluck35: folds 
fragonik: raises $0.75 to $1.25
Popokluev: folds 
FeersPoker: folds 
schmollhans: folds 
nicu4you: folds 
funker84: folds 
MR.PATJEW: calls $0.75
*** FLOP *** [5d As 4h]
MR.PATJEW: checks 
fragonik: bets $1.28
MR.PATJEW: calls $1.28
*** TURN *** [5d As 4h] [Kc]
MR.PATJEW: checks 
fragonik: bets $3.78
MR.PATJEW: folds 
Uncalled bet ($3.78) returned to fragonik
fragonik collected $5.04 from pot
*** SUMMARY ***
Total pot $5.31 | Rake $0.27 
Board [5d As 4h Kc]
Seat 1: Popokluev folded before Flop (didn't bet)
Seat 2: FeersPoker folded before Flop (didn't bet)
Seat 3: schmollhans folded before Flop (didn't bet)
Seat 4: nicu4you (button) folded before Flop (didn't bet)
Seat 5: funker84 (small blind) folded before Flop
Seat 6: MR.PATJEW (big blind) folded on the Turn
Seat 7: forestry800 folded before Flop (didn't bet)
Seat 8: Gluck35 folded before Flop (didn't bet)
Seat 9: fragonik collected ($5.04)



PokerStars Hand #228689803808:  Hold'em No Limit ($0.25/$0.50 USD) - 2021/07/30 17:13:35 ET
Table 'Gorgo III' 9-max Seat #5 is the button
Seat 1: Popokluev ($57.64 in chips) 
Seat 2: FeersPoker ($55.71 in chips) 
Seat 3: schmollhans ($36.11 in chips) 
Seat 4: nicu4you ($88.49 in chips) 
Seat 5: funker84 ($55.50 in chips) 
Seat 6: MR.PATJEW ($82.11 in chips) 
Seat 7: forestry800 ($50 in chips) 
Seat 8: Gluck35 ($50 in chips) 
Seat 9: fragonik ($52.51 in chips) 
MR.PATJEW: posts small blind $0.25
forestry800: posts big blind $0.50
*** HOLE CARDS ***
Gluck35: folds 
fragonik: folds 
Popokluev: folds 
FeersPoker: folds 
schmollhans: folds 
nicu4you: folds 
funker84: calls $0.50
MR.PATJEW: calls $0.25
forestry800: checks 
*** FLOP *** [2s 9h 6h]
MR.PATJEW: checks 
forestry800: checks 
funker84: checks 
*** TURN *** [2s 9h 6h] [8h]
MR.PATJEW: checks 
forestry800: bets $0.99
funker84: folds 
MR.PATJEW: calls $0.99
*** RIVER *** [2s 9h 6h 8h] [Th]
MR.PATJEW: checks 
forestry800: checks 
*** SHOW DOWN ***
MR.PATJEW: shows [Jh Qs] (a flush, Jack high)
forestry800: mucks hand 
MR.PATJEW collected $3.31 from pot
*** SUMMARY ***
Total pot $3.48 | Rake $0.17 
Board [2s 9h 6h 8h Th]
Seat 1: Popokluev folded before Flop (didn't bet)
Seat 2: FeersPoker folded before Flop (didn't bet)
Seat 3: schmollhans folded before Flop (didn't bet)
Seat 4: nicu4you folded before Flop (didn't bet)
Seat 5: funker84 (button) folded on the Turn
Seat 6: MR.PATJEW (small blind) showed [Jh Qs] and won ($3.31) with a flush, Jack high
Seat 7: forestry800 (big blind) mucked
Seat 8: Gluck35 folded before Flop (didn't bet)
Seat 9: fragonik folded before Flop (didn't bet)



PokerStars Hand #228689835345:  Hold'em No Limit ($0.25/$0.50 USD) - 2021/07/30 17:14:42 ET
Table 'Gorgo III' 9-max Seat #6 is the button
Seat 1: Popokluev ($57.64 in chips) 
Seat 2: FeersPoker ($55.71 in chips) 
Seat 3: schmollhans ($36.11 in chips) 
Seat 4: nicu4you ($88.49 in chips) 
Seat 5: funker84 ($55 in chips) 
Seat 6: MR.PATJEW ($83.93 in chips) 
Seat 7: forestry800 ($50 in chips) 
forestry800: posts small blind $0.25
Gluck35: is sitting out 
fragonik: is sitting out 
Popokluev: posts big blind $0.50
*** HOLE CARDS ***
FeersPoker: folds 
schmollhans: raises $1 to $1.50
nicu4you: folds 
funker84: folds 
MR.PATJEW: folds 
forestry800: folds 
Popokluev: folds 
Uncalled bet ($1) returned to schmollhans
schmollhans collected $1.25 from pot
schmollhans: doesn't show hand 
*** SUMMARY ***
Total pot $1.25 | Rake $0 
Seat 1: Popokluev (big blind) folded before Flop
Seat 2: FeersPoker folded before Flop (didn't bet)
Seat 3: schmollhans collected ($1.25)
Seat 4: nicu4you folded before Flop (didn't bet)
Seat 5: funker84 folded before Flop (didn't bet)
Seat 6: MR.PATJEW (button) folded before Flop (didn't bet)
Seat 7: forestry800 (small blind) folded before Flop



PokerStars Hand #228689843194:  Hold'em No Limit ($0.25/$0.50 USD) - 2021/07/30 17:14:59 ET
Table 'Gorgo III' 9-max Seat #7 is the button
Seat 1: Popokluev ($57.14 in chips) 
Seat 2: FeersPoker ($55.71 in chips) 
Seat 3: schmollhans ($36.86 in chips) 
Seat 4: nicu4you ($88.49 in chips) 
Seat 5: funker84 ($55 in chips) 
Seat 6: MR.PATJEW ($83.93 in chips) 
Seat 7: forestry800 ($50 in chips) 
Popokluev: posts small blind $0.25
FeersPoker: posts big blind $0.50
*** HOLE CARDS ***
schmollhans: folds 
nicu4you: folds 
funker84: folds 
MR.PATJEW: calls $0.50
forestry800: raises $1.50 to $2
Popokluev: folds 
FeersPoker: folds 
MR.PATJEW: calls $1.50
*** FLOP *** [Ad 2d Td]
MR.PATJEW: checks 
forestry800: bets $1.44
Gluck35 leaves the table
MR.PATJEW: raises $80.49 to $81.93 and is all-in
forestry800: folds 
Uncalled bet ($80.49) returned to MR.PATJEW
MR.PATJEW collected $7.25 from pot
MR.PATJEW: doesn't show hand 
*** SUMMARY ***
Total pot $7.63 | Rake $0.38 
Board [Ad 2d Td]
Seat 1: Popokluev (small blind) folded before Flop
Seat 2: FeersPoker (big blind) folded before Flop
Seat 3: schmollhans folded before Flop (didn't bet)
Seat 4: nicu4you folded before Flop (didn't bet)
Seat 5: funker84 folded before Flop (didn't bet)
Seat 6: MR.PATJEW collected ($7.25)
Seat 7: forestry800 (button) folded on the Flop



PokerStars Hand #228689862431:  Hold'em No Limit ($0.25/$0.50 USD) - 2021/07/30 17:15:40 ET
Table 'Gorgo III' 9-max Seat #1 is the button
Seat 1: Popokluev ($56.89 in chips) 
Seat 2: FeersPoker ($55.21 in chips) 
Seat 3: schmollhans ($36.86 in chips) 
Seat 4: nicu4you ($88.49 in chips) 
Seat 5: funker84 ($55 in chips) 
Seat 6: MR.PATJEW ($87.74 in chips) 
Seat 7: forestry800 ($50 in chips) 
FeersPoker: posts small blind $0.25
schmollhans: posts big blind $0.50
*** HOLE CARDS ***
nicu4you: folds 
funker84: raises $0.50 to $1
Pachebrash joins the table at seat #8 
MR.PATJEW: calls $1
forestry800: folds 
Popokluev: folds 
FeersPoker: raises $5 to $6
schmollhans: folds 
funker84: folds 
MR.PATJEW: calls $5
*** FLOP *** [5s 6s As]
FeersPoker: checks 
MR.PATJEW: bets $6.41
FeersPoker: folds 
Uncalled bet ($6.41) returned to MR.PATJEW
MR.PATJEW collected $12.82 from pot
MR.PATJEW: doesn't show hand 
*** SUMMARY ***
Total pot $13.50 | Rake $0.68 
Board [5s 6s As]
Seat 1: Popokluev (button) folded before Flop (didn't bet)
Seat 2: FeersPoker (small blind) folded on the Flop
Seat 3: schmollhans (big blind) folded before Flop
Seat 4: nicu4you folded before Flop (didn't bet)
Seat 5: funker84 folded before Flop
Seat 6: MR.PATJEW collected ($12.82)
Seat 7: forestry800 folded before Flop (didn't bet)



PokerStars Hand #228689883431:  Hold'em No Limit ($0.25/$0.50 USD) - 2021/07/30 17:16:25 ET
Table 'Gorgo III' 9-max Seat #2 is the button
Seat 1: Popokluev ($56.89 in chips) 
Seat 2: FeersPoker ($50 in chips) 
Seat 3: schmollhans ($36.36 in chips) 
Seat 4: nicu4you ($88.49 in chips) 
Seat 5: funker84 ($54 in chips) 
Seat 6: MR.PATJEW ($94.56 in chips) 
Seat 7: forestry800 ($50 in chips) 
schmollhans: posts small blind $0.25
nicu4you: posts big blind $0.50
Pachebrash: sits out 
*** HOLE CARDS ***
funker84: folds 
MR.PATJEW: folds 
forestry800: folds 
Popokluev: folds 
FeersPoker: folds 
schmollhans: folds 
Uncalled bet ($0.25) returned to nicu4you
nicu4you collected $0.50 from pot
nicu4you: doesn't show hand 
*** SUMMARY ***
Total pot $0.50 | Rake $0 
Seat 1: Popokluev folded before Flop (didn't bet)
Seat 2: FeersPoker (button) folded before Flop (didn't bet)
Seat 3: schmollhans (small blind) folded before Flop
Seat 4: nicu4you (big blind) collected ($0.50)
Seat 5: funker84 folded before Flop (didn't bet)
Seat 6: MR.PATJEW folded before Flop (didn't bet)
Seat 7: forestry800 folded before Flop (didn't bet)



PokerStars Hand #228689887983:  Hold'em No Limit ($0.25/$0.50 USD) - 2021/07/30 17:16:35 ET
Table 'Gorgo III' 9-max Seat #3 is the button
Seat 1: Popokluev ($56.89 in chips) 
Seat 2: FeersPoker ($50 in chips) 
Seat 3: schmollhans ($36.11 in chips) 
Seat 4: nicu4you ($88.74 in chips) 
Seat 5: funker84 ($54 in chips) 
Seat 6: MR.PATJEW ($94.56 in chips) 
Seat 7: forestry800 ($50 in chips) 
nicu4you: posts small blind $0.25
funker84: posts big blind $0.50
Pachebrash: sits out 
*** HOLE CARDS ***
MR.PATJEW: folds 
forestry800: folds 
Popokluev: folds 
FeersPoker: raises $0.75 to $1.25
schmollhans: folds 
nicu4you: folds 
funker84: folds 
Uncalled bet ($0.75) returned to FeersPoker
FeersPoker collected $1.25 from pot
FeersPoker: doesn't show hand 
*** SUMMARY ***
Total pot $1.25 | Rake $0 
Seat 1: Popokluev folded before Flop (didn't bet)
Seat 2: FeersPoker collected ($1.25)
Seat 3: schmollhans (button) folded before Flop (didn't bet)
Seat 4: nicu4you (small blind) folded before Flop
Seat 5: funker84 (big blind) folded before Flop
Seat 6: MR.PATJEW folded before Flop (didn't bet)
Seat 7: forestry800 folded before Flop (didn't bet)



PokerStars Hand #228689894410:  Hold'em No Limit ($0.25/$0.50 USD) - 2021/07/30 17:16:48 ET
Table 'Gorgo III' 9-max Seat #4 is the button
Seat 1: Popokluev ($56.89 in chips) 
Seat 2: FeersPoker ($50.75 in chips) 
Seat 3: schmollhans ($36.11 in chips) 
Seat 4: nicu4you ($88.49 in chips) 
Seat 5: funker84 ($53.50 in chips) 
Seat 6: MR.PATJEW ($94.56 in chips) 
Seat 7: forestry800 ($50 in chips) 
funker84: posts small blind $0.25
MR.PATJEW: posts big blind $0.50
Pachebrash: sits out 
*** HOLE CARDS ***
forestry800: folds 
Popokluev: folds 
FeersPoker: folds 
schmollhans: folds 
nicu4you: folds 
funker84: raises $0.50 to $1
MR.PATJEW: calls $0.50
*** FLOP *** [Tc 2s 6h]
funker84: bets $1
MR.PATJEW: calls $1
*** TURN *** [Tc 2s 6h] [Qc]
funker84: checks 
MR.PATJEW: checks 
*** RIVER *** [Tc 2s 6h Qc] [Ts]
funker84: bets $2
MR.PATJEW: calls $2
*** SHOW DOWN ***
funker84: shows [7h 7d] (two pair, Tens and Sevens)
MR.PATJEW: mucks hand 
funker84 collected $7.50 from pot
*** SUMMARY ***
Total pot $8 | Rake $0.50 
Board [Tc 2s 6h Qc Ts]
Seat 1: Popokluev folded before Flop (didn't bet)
Seat 2: FeersPoker folded before Flop (didn't bet)
Seat 3: schmollhans folded before Flop (didn't bet)
Seat 4: nicu4you (button) folded before Flop (didn't bet)
Seat 5: funker84 (small blind) showed [7h 7d] and won ($7.50) with two pair, Tens and Sevens
Seat 6: MR.PATJEW (big blind) mucked
Seat 7: forestry800 folded before Flop (didn't bet)



PokerStars Hand #228689927080:  Hold'em No Limit ($0.25/$0.50 USD) - 2021/07/30 17:17:59 ET
Table 'Gorgo III' 9-max Seat #5 is the button
Seat 1: Popokluev ($56.89 in chips) 
Seat 2: FeersPoker ($50.75 in chips) 
Seat 3: schmollhans ($36.11 in chips) 
Seat 4: nicu4you ($88.49 in chips) 
Seat 5: funker84 ($57 in chips) 
Seat 6: MR.PATJEW ($90.56 in chips) 
Seat 7: forestry800 ($50 in chips) 
MR.PATJEW: posts small blind $0.25
forestry800: posts big blind $0.50
Pachebrash: sits out 
*** HOLE CARDS ***
Popokluev: folds 
FeersPoker: folds 
schmollhans: raises $1.50 to $2
nicu4you: raises $4.75 to $6.75
funker84: folds 
MR.PATJEW: folds 
forestry800: folds 
schmollhans: folds 
Uncalled bet ($4.75) returned to nicu4you
nicu4you collected $4.75 from pot
nicu4you: doesn't show hand 
*** SUMMARY ***
Total pot $4.75 | Rake $0 
Seat 1: Popokluev folded before Flop (didn't bet)
Seat 2: FeersPoker folded before Flop (didn't bet)
Seat 3: schmollhans folded before Flop
Seat 4: nicu4you collected ($4.75)
Seat 5: funker84 (button) folded before Flop (didn't bet)
Seat 6: MR.PATJEW (small blind) folded before Flop
Seat 7: forestry800 (big blind) folded before Flop



PokerStars Hand #228689955875:  Hold'em No Limit ($0.25/$0.50 USD) - 2021/07/30 17:19:01 ET
Table 'Gorgo III' 9-max Seat #6 is the button
Seat 1: Popokluev ($56.89 in chips) 
Seat 2: FeersPoker ($50.75 in chips) 
Seat 3: schmollhans ($34.11 in chips) 
Seat 4: nicu4you ($91.24 in chips) 
Seat 5: funker84 ($57 in chips) 
Seat 6: MR.PATJEW ($90.31 in chips) 
Seat 7: forestry800 ($50 in chips) 
Seat 8: Pachebrash ($50 in chips) 
forestry800: posts small blind $0.25
Pachebrash: posts big blind $0.50
*** HOLE CARDS ***
Popokluev: raises $1 to $1.50
FeersPoker: raises $3 to $4.50
schmollhans: folds 
nicu4you: folds 
funker84: folds 
MR.PATJEW: folds 
forestry800: folds 
Pachebrash: folds 
Popokluev: calls $3
*** FLOP *** [6d Tc Ah]
Popokluev: checks 
FeersPoker: bets $3.06
Popokluev: calls $3.06
*** TURN *** [6d Tc Ah] [8d]
Popokluev: checks 
FeersPoker: bets $10.10
Popokluev: calls $10.10
*** RIVER *** [6d Tc Ah 8d] [Qs]
Popokluev: checks 
FeersPoker: bets $33.09 and is all-in
Popokluev: folds 
Uncalled bet ($33.09) returned to FeersPoker
FeersPoker collected $34.27 from pot
FeersPoker: doesn't show hand 
*** SUMMARY ***
Total pot $36.07 | Rake $1.80 
Board [6d Tc Ah 8d Qs]
Seat 1: Popokluev folded on the River
Seat 2: FeersPoker collected ($34.27)
Seat 3: schmollhans folded before Flop (didn't bet)
Seat 4: nicu4you folded before Flop (didn't bet)
Seat 5: funker84 folded before Flop (didn't bet)
Seat 6: MR.PATJEW (button) folded before Flop (didn't bet)
Seat 7: forestry800 (small blind) folded before Flop
Seat 8: Pachebrash (big blind) folded before Flop



PokerStars Hand #228690008390:  Hold'em No Limit ($0.25/$0.50 USD) - 2021/07/30 17:20:55 ET
Table 'Gorgo III' 9-max Seat #7 is the button
Seat 1: Popokluev ($50 in chips) 
Seat 2: FeersPoker ($67.36 in chips) 
Seat 3: schmollhans ($34.11 in chips) 
Seat 4: nicu4you ($91.24 in chips) 
Seat 5: funker84 ($57 in chips) 
Seat 6: MR.PATJEW ($90.31 in chips) 
Seat 7: forestry800 ($50 in chips) 
Seat 8: Pachebrash ($50 in chips) 
Seat 9: fragonik ($52.51 in chips) 
Pachebrash: posts small blind $0.25
fragonik: posts big blind $0.50
*** HOLE CARDS ***
Popokluev: folds 
FeersPoker: folds 
schmollhans: calls $0.50
nicu4you: raises $1.75 to $2.25
funker84: folds 
MR.PATJEW: folds 
forestry800: folds 
Pachebrash: folds 
fragonik: calls $1.75
schmollhans: calls $1.75
*** FLOP *** [7h Kc Tc]
fragonik: checks 
schmollhans: checks 
nicu4you: bets $4.59
MR.PATJEW leaves the table
fragonik: raises $11.87 to $16.46
schmollhans: folds 
Dragonclawss joins the table at seat #6 
nicu4you: folds 
Uncalled bet ($11.87) returned to fragonik
fragonik collected $15.37 from pot
*** SUMMARY ***
Total pot $16.18 | Rake $0.81 
Board [7h Kc Tc]
Seat 1: Popokluev folded before Flop (didn't bet)
Seat 2: FeersPoker folded before Flop (didn't bet)
Seat 3: schmollhans folded on the Flop
Seat 4: nicu4you folded on the Flop
Seat 5: funker84 folded before Flop (didn't bet)
Seat 6: MR.PATJEW folded before Flop (didn't bet)
Seat 7: forestry800 (button) folded before Flop (didn't bet)
Seat 8: Pachebrash (small blind) folded before Flop
Seat 9: fragonik (big blind) collected ($15.37)



PokerStars Hand #228690034611:  Hold'em No Limit ($0.25/$0.50 USD) - 2021/07/30 17:21:51 ET
Table 'Gorgo III' 9-max Seat #8 is the button
Seat 2: FeersPoker ($67.36 in chips) 
Seat 3: schmollhans ($31.86 in chips) 
Seat 4: nicu4you ($84.40 in chips) 
Seat 5: funker84 ($57 in chips) 
Seat 7: forestry800 ($50 in chips) 
Seat 8: Pachebrash ($50 in chips) 
Seat 9: fragonik ($61.04 in chips) 
fragonik: posts small blind $0.25
Popokluev: is sitting out 
FeersPoker: posts big blind $0.50
Dragonclawss: sits out 
*** HOLE CARDS ***
schmollhans: folds 
Popokluev leaves the table
nicu4you has timed out
nicu4you: folds 
funker84: folds 
forestry800: raises $0.75 to $1.25
Pachebrash: folds 
fragonik: folds 
FeersPoker: folds 
Uncalled bet ($0.75) returned to forestry800
forestry800 collected $1.25 from pot
forestry800: doesn't show hand 
*** SUMMARY ***
Total pot $1.25 | Rake $0 
Seat 2: FeersPoker (big blind) folded before Flop
Seat 3: schmollhans folded before Flop (didn't bet)
Seat 4: nicu4you folded before Flop (didn't bet)
Seat 5: funker84 folded before Flop (didn't bet)
Seat 7: forestry800 collected ($1.25)
Seat 8: Pachebrash (button) folded before Flop (didn't bet)
Seat 9: fragonik (small blind) folded before Flop



PokerStars Hand #228690047005:  Hold'em No Limit ($0.25/$0.50 USD) - 2021/07/30 17:22:18 ET
Table 'Gorgo III' 9-max Seat #9 is the button
Seat 2: FeersPoker ($66.86 in chips) 
Seat 3: schmollhans ($31.86 in chips) 
Seat 4: nicu4you ($84.40 in chips) 
Seat 5: funker84 ($57 in chips) 
Seat 7: forestry800 ($50.75 in chips) 
Seat 8: Pachebrash ($50 in chips) 
Seat 9: fragonik ($60.79 in chips) 
FeersPoker: posts small blind $0.25
schmollhans: posts big blind $0.50
Dragonclawss: sits out 
*** HOLE CARDS ***
nicu4you: folds 
funker84: folds 
forestry800: raises $0.75 to $1.25
Pachebrash: folds 
fragonik: folds 
FeersPoker: folds 
ms1272 joins the table at seat #1 
schmollhans: folds 
Uncalled bet ($0.75) returned to forestry800
forestry800 collected $1.25 from pot
forestry800: doesn't show hand 
*** SUMMARY ***
Total pot $1.25 | Rake $0 
Seat 2: FeersPoker (small blind) folded before Flop
Seat 3: schmollhans (big blind) folded before Flop
Seat 4: nicu4you folded before Flop (didn't bet)
Seat 5: funker84 folded before Flop (didn't bet)
Seat 7: forestry800 collected ($1.25)
Seat 8: Pachebrash folded before Flop (didn't bet)
Seat 9: fragonik (button) folded before Flop (didn't bet)



PokerStars Hand #228690053995:  Hold'em No Limit ($0.25/$0.50 USD) - 2021/07/30 17:22:33 ET
Table 'Gorgo III' 9-max Seat #2 is the button
Seat 2: FeersPoker ($66.61 in chips) 
Seat 3: schmollhans ($31.36 in chips) 
Seat 4: nicu4you ($84.40 in chips) 
Seat 5: funker84 ($57 in chips) 
Seat 7: forestry800 ($51.50 in chips) 
Seat 8: Pachebrash ($50 in chips) 
Seat 9: fragonik ($60.79 in chips) 
schmollhans: posts small blind $0.25
nicu4you: posts big blind $0.50
Dragonclawss: sits out 
ms1272: sits out 
*** HOLE CARDS ***
funker84: folds 
forestry800: folds 
Pachebrash: folds 
fragonik: folds 
FeersPoker: folds 
schmollhans: calls $0.25
nicu4you: checks 
*** FLOP *** [Jh 4s 2d]
schmollhans: checks 
nicu4you: checks 
*** TURN *** [Jh 4s 2d] [3h]
schmollhans: checks 
nicu4you: checks 
*** RIVER *** [Jh 4s 2d 3h] [3c]
schmollhans: checks 
nicu4you: checks 
*** SHOW DOWN ***
schmollhans: shows [7c Ts] (a pair of Threes)
nicu4you: mucks hand 
schmollhans collected $0.94 from pot
*** SUMMARY ***
Total pot $1 | Rake $0.06 
Board [Jh 4s 2d 3h 3c]
Seat 2: FeersPoker (button) folded before Flop (didn't bet)
Seat 3: schmollhans (small blind) showed [7c Ts] and won ($0.94) with a pair of Threes
Seat 4: nicu4you (big blind) mucked
Seat 5: funker84 folded before Flop (didn't bet)
Seat 7: forestry800 folded before Flop (didn't bet)
Seat 8: Pachebrash folded before Flop (didn't bet)
Seat 9: fragonik folded before Flop (didn't bet)



PokerStars Hand #228690077312:  Hold'em No Limit ($0.25/$0.50 USD) - 2021/07/30 17:23:23 ET
Table 'Gorgo III' 9-max Seat #3 is the button
Seat 1: ms1272 ($50 in chips) 
Seat 2: FeersPoker ($66.61 in chips) 
Seat 3: schmollhans ($31.80 in chips) 
Seat 4: nicu4you ($83.90 in chips) 
Seat 5: funker84 ($57 in chips) 
Seat 7: forestry800 ($51.50 in chips) 
Seat 8: Pachebrash ($50 in chips) 
Seat 9: fragonik ($60.79 in chips) 
nicu4you: posts small blind $0.25
funker84: posts big blind $0.50
Dragonclawss: sits out 
ms1272: posts big blind $0.50
*** HOLE CARDS ***
forestry800: folds 
Pachebrash: folds 
fragonik: folds 
ms1272: checks 
FeersPoker: folds 
schmollhans: folds 
nicu4you: calls $0.25
funker84: checks 
*** FLOP *** [Qc 2d 4h]
nicu4you: bets $0.98
funker84: folds 
ms1272: calls $0.98
*** TURN *** [Qc 2d 4h] [Ac]
nicu4you: checks 
ms1272: bets $1.64
nicu4you: calls $1.64
*** RIVER *** [Qc 2d 4h Ac] [Ks]
nicu4you: checks 
ms1272: bets $4.90
nicu4you: folds 
Uncalled bet ($4.90) returned to ms1272
ms1272 collected $6.32 from pot
ms1272: doesn't show hand 
*** SUMMARY ***
Total pot $6.74 | Rake $0.42 
Board [Qc 2d 4h Ac Ks]
Seat 1: ms1272 collected ($6.32)
Seat 2: FeersPoker folded before Flop (didn't bet)
Seat 3: schmollhans (button) folded before Flop (didn't bet)
Seat 4: nicu4you (small blind) folded on the River
Seat 5: funker84 (big blind) folded on the Flop
Seat 7: forestry800 folded before Flop (didn't bet)
Seat 8: Pachebrash folded before Flop (didn't bet)
Seat 9: fragonik folded before Flop (didn't bet)



PokerStars Hand #228690122276:  Hold'em No Limit ($0.25/$0.50 USD) - 2021/07/30 17:25:01 ET
Table 'Gorgo III' 9-max Seat #4 is the button
Seat 1: ms1272 ($53.20 in chips) 
Seat 2: FeersPoker ($66.61 in chips) 
Seat 3: schmollhans ($31.80 in chips) 
Seat 4: nicu4you ($80.78 in chips) 
Seat 5: funker84 ($56.50 in chips) 
Seat 7: forestry800 ($51.50 in chips) 
Seat 8: Pachebrash ($50 in chips) 
Seat 9: fragonik ($60.79 in chips) 
funker84: posts small blind $0.25
forestry800: posts big blind $0.50
*** HOLE CARDS ***
Pachebrash: folds 
fragonik: raises $1 to $1.50
ms1272: folds 
FeersPoker: folds 
schmollhans: folds 
nicu4you: folds 
funker84: calls $1.25
forestry800: folds 
*** FLOP *** [6h Jd 9s]
funker84: checks 
fragonik: bets $1.63
funker84: calls $1.63
*** TURN *** [6h Jd 9s] [7c]
funker84: checks 
fragonik: bets $4.82
funker84: calls $4.82
*** RIVER *** [6h Jd 9s 7c] [Qc]
funker84: checks 
fragonik: checks 
*** SHOW DOWN ***
funker84: shows [Ts Td] (a pair of Tens)
fragonik: shows [Ad Jh] (a pair of Jacks)
fragonik collected $15.58 from pot
*** SUMMARY ***
Total pot $16.40 | Rake $0.82 
Board [6h Jd 9s 7c Qc]
Seat 1: ms1272 folded before Flop (didn't bet)
Seat 2: FeersPoker folded before Flop (didn't bet)
Seat 3: schmollhans folded before Flop (didn't bet)
Seat 4: nicu4you (button) folded before Flop (didn't bet)
Seat 5: funker84 (small blind) showed [Ts Td] and lost with a pair of Tens
Seat 7: forestry800 (big blind) folded before Flop
Seat 8: Pachebrash folded before Flop (didn't bet)
Seat 9: fragonik showed [Ad Jh] and won ($15.58) with a pair of Jacks



PokerStars Hand #228690160346:  Hold'em No Limit ($0.25/$0.50 USD) - 2021/07/30 17:26:25 ET
Table 'Gorgo III' 9-max Seat #5 is the button
Seat 1: ms1272 ($53.20 in chips) 
Seat 2: FeersPoker ($66.61 in chips) 
Seat 3: schmollhans ($31.80 in chips) 
Seat 4: nicu4you ($80.78 in chips) 
Seat 5: funker84 ($48.55 in chips) 
Seat 7: forestry800 ($51 in chips) 
Seat 8: Pachebrash ($50 in chips) 
Seat 9: fragonik ($68.42 in chips) 
forestry800: posts small blind $0.25
Pachebrash: posts big blind $0.50
*** HOLE CARDS ***
fragonik: folds 
ms1272: folds 
FeersPoker: folds 
schmollhans: folds 
nicu4you has timed out
nicu4you: folds 
funker84: folds 
forestry800: folds 
Uncalled bet ($0.25) returned to Pachebrash
Pachebrash collected $0.50 from pot
Pachebrash: doesn't show hand 
*** SUMMARY ***
Total pot $0.50 | Rake $0 
Seat 1: ms1272 folded before Flop (didn't bet)
Seat 2: FeersPoker folded before Flop (didn't bet)
Seat 3: schmollhans folded before Flop (didn't bet)
Seat 4: nicu4you folded before Flop (didn't bet)
Seat 5: funker84 (button) folded before Flop (didn't bet)
Seat 7: forestry800 (small blind) folded before Flop
Seat 8: Pachebrash (big blind) collected ($0.50)
Seat 9: fragonik folded before Flop (didn't bet)



PokerStars Hand #228690302904:  Hold'em No Limit ($0.25/$0.50 USD) - 2021/07/30 17:31:26 ET
Table 'Gorgo III' 9-max Seat #4 is the button
Seat 1: ms1272 ($53.15 in chips) 
Seat 2: FeersPoker ($69.17 in chips) 
Seat 3: schmollhans ($28.51 in chips) 
Seat 4: nicu4you ($80.03 in chips) 
Seat 5: funker84 ($47.44 in chips) 
Seat 6: Dragonclawss ($50.75 in chips) 
Seat 7: forestry800 ($51.75 in chips) 
Seat 8: Pachebrash ($50.50 in chips) 
Seat 9: fragonik ($67.67 in chips) 
funker84: posts small blind $0.25
Dragonclawss: posts big blind $0.50
*** HOLE CARDS ***
forestry800: folds 
Pachebrash: raises $1 to $1.50
fragonik: raises $3 to $4.50
ms1272: folds 
FeersPoker: folds 
schmollhans: folds 
nicu4you: folds 
funker84: folds 
Dragonclawss: folds 
Pachebrash: folds 
Uncalled bet ($3) returned to fragonik
fragonik collected $3.75 from pot
*** SUMMARY ***
Total pot $3.75 | Rake $0 
Seat 1: ms1272 folded before Flop (didn't bet)
Seat 2: FeersPoker folded before Flop (didn't bet)
Seat 3: schmollhans folded before Flop (didn't bet)
Seat 4: nicu4you (button) folded before Flop (didn't bet)
Seat 5: funker84 (small blind) folded before Flop
Seat 6: Dragonclawss (big blind) folded before Flop
Seat 7: forestry800 folded before Flop (didn't bet)
Seat 8: Pachebrash folded before Flop
Seat 9: fragonik collected ($3.75)



PokerStars Hand #228690316413:  Hold'em No Limit ($0.25/$0.50 USD) - 2021/07/30 17:31:56 ET
Table 'Gorgo III' 9-max Seat #5 is the button
Seat 1: ms1272 ($53.15 in chips) 
Seat 2: FeersPoker ($69.17 in chips) 
Seat 3: schmollhans ($28.51 in chips) 
Seat 4: nicu4you ($80.03 in chips) 
Seat 5: funker84 ($47.19 in chips) 
Seat 6: Dragonclawss ($50.25 in chips) 
Seat 7: forestry800 ($51.75 in chips) 
Seat 8: Pachebrash ($50 in chips) 
Seat 9: fragonik ($69.92 in chips) 
Dragonclawss: posts small blind $0.25
forestry800: posts big blind $0.50
*** HOLE CARDS ***
Pachebrash: folds 
fragonik: folds 
ms1272: raises $0.50 to $1
FeersPoker: calls $1
schmollhans: raises $3 to $4
nicu4you: folds 
funker84: folds 
Dragonclawss: folds 
forestry800: folds 
ms1272: folds 
FeersPoker: folds 
Uncalled bet ($3) returned to schmollhans
schmollhans collected $3.75 from pot
schmollhans: doesn't show hand 
*** SUMMARY ***
Total pot $3.75 | Rake $0 
Seat 1: ms1272 folded before Flop
Seat 2: FeersPoker folded before Flop
Seat 3: schmollhans collected ($3.75)
Seat 4: nicu4you folded before Flop (didn't bet)
Seat 5: funker84 (button) folded before Flop (didn't bet)
Seat 6: Dragonclawss (small blind) folded before Flop
Seat 7: forestry800 (big blind) folded before Flop
Seat 8: Pachebrash folded before Flop (didn't bet)
Seat 9: fragonik folded before Flop (didn't bet)



PokerStars Hand #228690330832:  Hold'em No Limit ($0.25/$0.50 USD) - 2021/07/30 17:32:28 ET
Table 'Gorgo III' 9-max Seat #6 is the button
Seat 1: ms1272 ($52.15 in chips) 
Seat 2: FeersPoker ($68.17 in chips) 
Seat 3: schmollhans ($31.26 in chips) 
Seat 4: nicu4you ($80.03 in chips) 
Seat 5: funker84 ($47.19 in chips) 
Seat 6: Dragonclawss ($50 in chips) 
Seat 7: forestry800 ($51.25 in chips) 
Seat 8: Pachebrash ($50 in chips) 
Seat 9: fragonik ($69.92 in chips) 
forestry800: posts small blind $0.25
Pachebrash: posts big blind $0.50
*** HOLE CARDS ***
fragonik: folds 
ms1272: folds 
FeersPoker: folds 
schmollhans: folds 
nicu4you: folds 
funker84: folds 
Dragonclawss: folds 
forestry800: raises $1 to $1.50
Pachebrash: folds 
Uncalled bet ($1) returned to forestry800
forestry800 collected $1 from pot
forestry800: doesn't show hand 
*** SUMMARY ***
Total pot $1 | Rake $0 
Seat 1: ms1272 folded before Flop (didn't bet)
Seat 2: FeersPoker folded before Flop (didn't bet)
Seat 3: schmollhans folded before Flop (didn't bet)
Seat 4: nicu4you folded before Flop (didn't bet)
Seat 5: funker84 folded before Flop (didn't bet)
Seat 6: Dragonclawss (button) folded before Flop (didn't bet)
Seat 7: forestry800 (small blind) collected ($1)
Seat 8: Pachebrash (big blind) folded before Flop
Seat 9: fragonik folded before Flop (didn't bet)



PokerStars Hand #228690336427:  Hold'em No Limit ($0.25/$0.50 USD) - 2021/07/30 17:32:40 ET
Table 'Gorgo III' 9-max Seat #7 is the button
Seat 1: ms1272 ($52.15 in chips) 
Seat 2: FeersPoker ($68.17 in chips) 
Seat 3: schmollhans ($31.26 in chips) 
Seat 4: nicu4you ($80.03 in chips) 
Seat 5: funker84 ($47.19 in chips) 
Seat 6: Dragonclawss ($50 in chips) 
Seat 7: forestry800 ($51.75 in chips) 
Seat 8: Pachebrash ($50 in chips) 
Seat 9: fragonik ($69.92 in chips) 
Pachebrash: posts small blind $0.25
fragonik: posts big blind $0.50
*** HOLE CARDS ***
ms1272: raises $0.50 to $1
FeersPoker: folds 
schmollhans: calls $1
nicu4you: folds 
funker84: folds 
Dragonclawss: folds 
forestry800: folds 
Pachebrash: folds 
fragonik: folds 
*** FLOP *** [Jd 2c 4h]
ms1272: bets $1.30
schmollhans: folds 
Uncalled bet ($1.30) returned to ms1272
ms1272 collected $2.57 from pot
ms1272: doesn't show hand 
*** SUMMARY ***
Total pot $2.75 | Rake $0.18 
Board [Jd 2c 4h]
Seat 1: ms1272 collected ($2.57)
Seat 2: FeersPoker folded before Flop (didn't bet)
Seat 3: schmollhans folded on the Flop
Seat 4: nicu4you folded before Flop (didn't bet)
Seat 5: funker84 folded before Flop (didn't bet)
Seat 6: Dragonclawss folded before Flop (didn't bet)
Seat 7: forestry800 (button) folded before Flop (didn't bet)
Seat 8: Pachebrash (small blind) folded before Flop
Seat 9: fragonik (big blind) folded before Flop



PokerStars Hand #228690380599:  Hold'em No Limit ($0.25/$0.50 USD) - 2021/07/30 17:34:17 ET
Table 'Gorgo III' 9-max Seat #2 is the button
Seat 1: ms1272 ($54.77 in chips) 
Seat 2: FeersPoker ($67.42 in chips) 
Seat 3: schmollhans ($30.43 in chips) 
Seat 4: nicu4you ($80.03 in chips) 
Seat 5: funker84 ($47.19 in chips) 
Seat 6: Dragonclawss ($50 in chips) 
Seat 7: forestry800 ($50.50 in chips) 
Seat 8: Pachebrash ($50.75 in chips) 
Seat 9: fragonik ($69.17 in chips) 
schmollhans: posts small blind $0.25
nicu4you: posts big blind $0.50
*** HOLE CARDS ***
funker84: folds 
Dragonclawss: folds 
forestry800: folds 
Pachebrash: folds 
fragonik: folds 
ms1272: folds 
FeersPoker: raises $0.75 to $1.25
schmollhans: calls $1
nicu4you: folds 
*** FLOP *** [7c Jd 9d]
Pachebrash leaves the table
schmollhans: checks 
soso_slash joins the table at seat #8 
FeersPoker: bets $0.94
schmollhans: calls $0.94
*** TURN *** [7c Jd 9d] [8d]
schmollhans: checks 
FeersPoker: checks 
*** RIVER *** [7c Jd 9d 8d] [4h]
schmollhans: bets $4.50
FeersPoker: folds 
Uncalled bet ($4.50) returned to schmollhans
schmollhans collected $4.58 from pot
schmollhans: doesn't show hand 
*** SUMMARY ***
Total pot $4.88 | Rake $0.30 
Board [7c Jd 9d 8d 4h]
Seat 1: ms1272 folded before Flop (didn't bet)
Seat 2: FeersPoker (button) folded on the River
Seat 3: schmollhans (small blind) collected ($4.58)
Seat 4: nicu4you (big blind) folded before Flop
Seat 5: funker84 folded before Flop (didn't bet)
Seat 6: Dragonclawss folded before Flop (didn't bet)
Seat 7: forestry800 folded before Flop (didn't bet)
Seat 8: Pachebrash folded before Flop (didn't bet)
Seat 9: fragonik folded before Flop (didn't bet)



PokerStars Hand #228690406240:  Hold'em No Limit ($0.25/$0.50 USD) - 2021/07/30 17:35:14 ET
Table 'Gorgo III' 9-max Seat #3 is the button
Seat 1: ms1272 ($54.77 in chips) 
Seat 2: FeersPoker ($65.23 in chips) 
Seat 3: schmollhans ($32.82 in chips) 
Seat 4: nicu4you ($79.53 in chips) 
Seat 5: funker84 ($47.19 in chips) 
Seat 6: Dragonclawss ($50 in chips) 
Seat 7: forestry800 ($50.50 in chips) 
Seat 8: soso_slash ($23.47 in chips) 
Seat 9: fragonik ($69.17 in chips) 
nicu4you: posts small blind $0.25
funker84: posts big blind $0.50
soso_slash: posts big blind $0.50
*** HOLE CARDS ***
Dragonclawss: folds 
forestry800: folds 
soso_slash: raises $1.25 to $1.75
fragonik: folds 
ms1272: calls $1.75
FeersPoker: folds 
schmollhans: folds 
nicu4you: folds 
funker84: folds 
*** FLOP *** [Qc 2d 4d]
soso_slash: bets $2.52
ms1272: raises $4.54 to $7.06
soso_slash: folds 
Uncalled bet ($4.54) returned to ms1272
ms1272 collected $8.71 from pot
ms1272: doesn't show hand 
*** SUMMARY ***
Total pot $9.29 | Rake $0.58 
Board [Qc 2d 4d]
Seat 1: ms1272 collected ($8.71)
Seat 2: FeersPoker folded before Flop (didn't bet)
Seat 3: schmollhans (button) folded before Flop (didn't bet)
Seat 4: nicu4you (small blind) folded before Flop
Seat 5: funker84 (big blind) folded before Flop
Seat 6: Dragonclawss folded before Flop (didn't bet)
Seat 7: forestry800 folded before Flop (didn't bet)
Seat 8: soso_slash folded on the Flop
Seat 9: fragonik folded before Flop (didn't bet)



PokerStars Hand #228690422133:  Hold'em No Limit ($0.25/$0.50 USD) - 2021/07/30 17:35:49 ET
Table 'Gorgo III' 9-max Seat #4 is the button
Seat 1: ms1272 ($59.21 in chips) 
Seat 2: FeersPoker ($65.23 in chips) 
Seat 3: schmollhans ($32.82 in chips) 
Seat 4: nicu4you ($79.28 in chips) 
Seat 5: funker84 ($46.69 in chips) 
Seat 6: Dragonclawss ($50 in chips) 
Seat 7: forestry800 ($50.50 in chips) 
Seat 8: soso_slash ($19.20 in chips) 
Seat 9: fragonik ($69.17 in chips) 
funker84: posts small blind $0.25
Dragonclawss: posts big blind $0.50
*** HOLE CARDS ***
forestry800: folds 
soso_slash: raises $1 to $1.50
fragonik: folds 
ms1272: folds 
FeersPoker: folds 
schmollhans: folds 
nicu4you: folds 
funker84: folds 
Dragonclawss: folds 
Uncalled bet ($1) returned to soso_slash
soso_slash collected $1.25 from pot
soso_slash: doesn't show hand 
*** SUMMARY ***
Total pot $1.25 | Rake $0 
Seat 1: ms1272 folded before Flop (didn't bet)
Seat 2: FeersPoker folded before Flop (didn't bet)
Seat 3: schmollhans folded before Flop (didn't bet)
Seat 4: nicu4you (button) folded before Flop (didn't bet)
Seat 5: funker84 (small blind) folded before Flop
Seat 6: Dragonclawss (big blind) folded before Flop
Seat 7: forestry800 folded before Flop (didn't bet)
Seat 8: soso_slash collected ($1.25)
Seat 9: fragonik folded before Flop (didn't bet)



PokerStars Hand #228690432477:  Hold'em No Limit ($0.25/$0.50 USD) - 2021/07/30 17:36:13 ET
Table 'Gorgo III' 9-max Seat #5 is the button
Seat 1: ms1272 ($59.21 in chips) 
Seat 2: FeersPoker ($65.23 in chips) 
Seat 3: schmollhans ($32.82 in chips) 
Seat 4: nicu4you ($79.28 in chips) 
Seat 5: funker84 ($46.44 in chips) 
Seat 6: Dragonclawss ($50 in chips) 
Seat 7: forestry800 ($50.50 in chips) 
Seat 8: soso_slash ($19.95 in chips) 
Seat 9: fragonik ($69.17 in chips) 
Dragonclawss: posts small blind $0.25
forestry800: posts big blind $0.50
*** HOLE CARDS ***
soso_slash: raises $1 to $1.50
fragonik: folds 
ms1272: folds 
FeersPoker: folds 
schmollhans: folds 
nicu4you: folds 
funker84: folds 
Dragonclawss: folds 
forestry800: folds 
Uncalled bet ($1) returned to soso_slash
soso_slash collected $1.25 from pot
soso_slash: doesn't show hand 
*** SUMMARY ***
Total pot $1.25 | Rake $0 
Seat 1: ms1272 folded before Flop (didn't bet)
Seat 2: FeersPoker folded before Flop (didn't bet)
Seat 3: schmollhans folded before Flop (didn't bet)
Seat 4: nicu4you folded before Flop (didn't bet)
Seat 5: funker84 (button) folded before Flop (didn't bet)
Seat 6: Dragonclawss (small blind) folded before Flop
Seat 7: forestry800 (big blind) folded before Flop
Seat 8: soso_slash collected ($1.25)
Seat 9: fragonik folded before Flop (didn't bet)



PokerStars Hand #228690437013:  Hold'em No Limit ($0.25/$0.50 USD) - 2021/07/30 17:36:23 ET
Table 'Gorgo III' 9-max Seat #6 is the button
Seat 1: ms1272 ($59.21 in chips) 
Seat 2: FeersPoker ($65.23 in chips) 
Seat 3: schmollhans ($32.82 in chips) 
Seat 4: nicu4you ($79.28 in chips) 
Seat 5: funker84 ($46.44 in chips) 
Seat 6: Dragonclawss ($50 in chips) 
Seat 7: forestry800 ($50 in chips) 
Seat 8: soso_slash ($20.70 in chips) 
Seat 9: fragonik ($69.17 in chips) 
forestry800: posts small blind $0.25
soso_slash: posts big blind $0.50
*** HOLE CARDS ***
fragonik: folds 
ms1272: folds 
FeersPoker: folds 
schmollhans: folds 
nicu4you: folds 
funker84: raises $0.50 to $1
Dragonclawss: raises $3.50 to $4.50
forestry800: folds 
soso_slash: calls $4
funker84: calls $3.50
*** FLOP *** [6c 4s 3d]
soso_slash: checks 
funker84: checks 
Dragonclawss: bets $7.50
soso_slash: calls $7.50
funker84: raises $34.44 to $41.94 and is all-in
Dragonclawss: folds 
soso_slash: calls $8.70 and is all-in
Uncalled bet ($25.74) returned to funker84
*** TURN *** [6c 4s 3d] [6d]
*** RIVER *** [6c 4s 3d 6d] [9s]
*** SHOW DOWN ***
soso_slash: shows [5s Kh] (a pair of Sixes)
funker84: shows [Kc Ks] (two pair, Kings and Sixes)
funker84 collected $51.15 from pot
*** SUMMARY ***
Total pot $53.65 | Rake $2.50 
Board [6c 4s 3d 6d 9s]
Seat 1: ms1272 folded before Flop (didn't bet)
Seat 2: FeersPoker folded before Flop (didn't bet)
Seat 3: schmollhans folded before Flop (didn't bet)
Seat 4: nicu4you folded before Flop (didn't bet)
Seat 5: funker84 showed [Kc Ks] and won ($51.15) with two pair, Kings and Sixes
Seat 6: Dragonclawss (button) folded on the Flop
Seat 7: forestry800 (small blind) folded before Flop
Seat 8: soso_slash (big blind) showed [5s Kh] and lost with a pair of Sixes
Seat 9: fragonik folded before Flop (didn't bet)



PokerStars Hand #228690480810:  Hold'em No Limit ($0.25/$0.50 USD) - 2021/07/30 17:37:55 ET
Table 'Gorgo III' 9-max Seat #7 is the button
Seat 1: ms1272 ($59.21 in chips) 
Seat 2: FeersPoker ($65.23 in chips) 
Seat 3: schmollhans ($32.82 in chips) 
Seat 4: nicu4you ($79.28 in chips) 
Seat 5: funker84 ($76.89 in chips) 
Seat 6: Dragonclawss ($50 in chips) 
Seat 7: forestry800 ($50 in chips) 
Seat 9: fragonik ($69.17 in chips) 
fragonik: posts small blind $0.25
ms1272: posts big blind $0.50
*** HOLE CARDS ***
FeersPoker: folds 
schmollhans: folds 
nicu4you: folds 
funker84: folds 
soso_slash leaves the table
Dragonclawss: folds 
forestry800: raises $0.60 to $1.10
fragonik: folds 
ms1272: folds 
Uncalled bet ($0.60) returned to forestry800
forestry800 collected $1.25 from pot
forestry800: doesn't show hand 
*** SUMMARY ***
Total pot $1.25 | Rake $0 
Seat 1: ms1272 (big blind) folded before Flop
Seat 2: FeersPoker folded before Flop (didn't bet)
Seat 3: schmollhans folded before Flop (didn't bet)
Seat 4: nicu4you folded before Flop (didn't bet)
Seat 5: funker84 folded before Flop (didn't bet)
Seat 6: Dragonclawss folded before Flop (didn't bet)
Seat 7: forestry800 (button) collected ($1.25)
Seat 9: fragonik (small blind) folded before Flop



PokerStars Hand #228690491969:  Hold'em No Limit ($0.25/$0.50 USD) - 2021/07/30 17:38:20 ET
Table 'Gorgo III' 9-max Seat #9 is the button
Seat 1: ms1272 ($58.71 in chips) 
Seat 2: FeersPoker ($65.23 in chips) 
Seat 3: schmollhans ($32.82 in chips) 
Seat 4: nicu4you ($79.28 in chips) 
Seat 5: funker84 ($76.89 in chips) 
Seat 6: Dragonclawss ($50 in chips) 
Seat 7: forestry800 ($50.75 in chips) 
Seat 9: fragonik ($68.92 in chips) 
ms1272: posts small blind $0.25
FeersPoker: posts big blind $0.50
*** HOLE CARDS ***
schmollhans: calls $0.50
nicu4you: folds 
Leason22 joins the table at seat #8 
funker84: raises $1 to $1.50
Dragonclawss: folds 
forestry800: folds 
fragonik: folds 
ms1272: calls $1.25
FeersPoker: folds 
schmollhans: calls $1
*** FLOP *** [9s 3c Qd]
ms1272: checks 
schmollhans: checks 
funker84: bets $2.50
ms1272: folds 
schmollhans: folds 
Uncalled bet ($2.50) returned to funker84
funker84 collected $4.69 from pot
funker84: doesn't show hand 
*** SUMMARY ***
Total pot $5 | Rake $0.31 
Board [9s 3c Qd]
Seat 1: ms1272 (small blind) folded on the Flop
Seat 2: FeersPoker (big blind) folded before Flop
Seat 3: schmollhans folded on the Flop
Seat 4: nicu4you folded before Flop (didn't bet)
Seat 5: funker84 collected ($4.69)
Seat 6: Dragonclawss folded before Flop (didn't bet)
Seat 7: forestry800 folded before Flop (didn't bet)
Seat 9: fragonik (button) folded before Flop (didn't bet)



PokerStars Hand #228690516148:  Hold'em No Limit ($0.25/$0.50 USD) - 2021/07/30 17:39:15 ET
Table 'Gorgo III' 9-max Seat #1 is the button
Seat 1: ms1272 ($57.21 in chips) 
Seat 2: FeersPoker ($64.73 in chips) 
Seat 3: schmollhans ($31.32 in chips) 
Seat 4: nicu4you ($79.28 in chips) 
Seat 5: funker84 ($80.08 in chips) 
Seat 6: Dragonclawss ($50 in chips) 
Seat 7: forestry800 ($50.75 in chips) 
Seat 9: fragonik ($68.92 in chips) 
FeersPoker: posts small blind $0.25
schmollhans: posts big blind $0.50
Leason22: sits out 
*** HOLE CARDS ***
nicu4you: folds 
funker84: folds 
Dragonclawss: folds 
forestry800: raises $0.75 to $1.25
fragonik: folds 
ms1272: folds 
FeersPoker: folds 
schmollhans: folds 
Uncalled bet ($0.75) returned to forestry800
forestry800 collected $1.25 from pot
forestry800: doesn't show hand 
*** SUMMARY ***
Total pot $1.25 | Rake $0 
Seat 1: ms1272 (button) folded before Flop (didn't bet)
Seat 2: FeersPoker (small blind) folded before Flop
Seat 3: schmollhans (big blind) folded before Flop
Seat 4: nicu4you folded before Flop (didn't bet)
Seat 5: funker84 folded before Flop (didn't bet)
Seat 6: Dragonclawss folded before Flop (didn't bet)
Seat 7: forestry800 collected ($1.25)
Seat 9: fragonik folded before Flop (didn't bet)



PokerStars Hand #228690522532:  Hold'em No Limit ($0.25/$0.50 USD) - 2021/07/30 17:39:29 ET
Table 'Gorgo III' 9-max Seat #2 is the button
Seat 1: ms1272 ($57.21 in chips) 
Seat 2: FeersPoker ($64.48 in chips) 
Seat 3: schmollhans ($30.82 in chips) 
Seat 4: nicu4you ($79.28 in chips) 
Seat 5: funker84 ($80.08 in chips) 
Seat 6: Dragonclawss ($50 in chips) 
Seat 7: forestry800 ($51.50 in chips) 
Seat 9: fragonik ($68.92 in chips) 
schmollhans: posts small blind $0.25
nicu4you: posts big blind $0.50
Leason22: sits out 
*** HOLE CARDS ***
funker84: folds 
Dragonclawss: folds 
forestry800: folds 
fragonik: folds 
ms1272: raises $0.50 to $1
FeersPoker: folds 
schmollhans: folds 
nicu4you: calls $0.50
*** FLOP *** [8d Ts 2h]
nicu4you: checks 
ms1272: bets $1.07
nicu4you: folds 
Uncalled bet ($1.07) returned to ms1272
ms1272 collected $2.11 from pot
ms1272: doesn't show hand 
*** SUMMARY ***
Total pot $2.25 | Rake $0.14 
Board [8d Ts 2h]
Seat 1: ms1272 collected ($2.11)
Seat 2: FeersPoker (button) folded before Flop (didn't bet)
Seat 3: schmollhans (small blind) folded before Flop
Seat 4: nicu4you (big blind) folded on the Flop
Seat 5: funker84 folded before Flop (didn't bet)
Seat 6: Dragonclawss folded before Flop (didn't bet)
Seat 7: forestry800 folded before Flop (didn't bet)
Seat 9: fragonik folded before Flop (didn't bet)



PokerStars Hand #228690533357:  Hold'em No Limit ($0.25/$0.50 USD) - 2021/07/30 17:39:53 ET
Table 'Gorgo III' 9-max Seat #3 is the button
Seat 1: ms1272 ($58.32 in chips) 
Seat 2: FeersPoker ($64.48 in chips) 
Seat 3: schmollhans ($30.57 in chips) 
Seat 4: nicu4you ($78.28 in chips) 
Seat 5: funker84 ($80.08 in chips) 
Seat 6: Dragonclawss ($50 in chips) 
Seat 7: forestry800 ($51.50 in chips) 
Seat 9: fragonik ($68.92 in chips) 
nicu4you: posts small blind $0.25
funker84: posts big blind $0.50
Leason22: sits out 
*** HOLE CARDS ***
Dragonclawss: folds 
forestry800: folds 
fragonik: folds 
ms1272: raises $0.50 to $1
FeersPoker: folds 
schmollhans: raises $2 to $3
nicu4you: folds 
funker84: folds 
ms1272: folds 
Uncalled bet ($2) returned to schmollhans
schmollhans collected $2.75 from pot
schmollhans: doesn't show hand 
*** SUMMARY ***
Total pot $2.75 | Rake $0 
Seat 1: ms1272 folded before Flop
Seat 2: FeersPoker folded before Flop (didn't bet)
Seat 3: schmollhans (button) collected ($2.75)
Seat 4: nicu4you (small blind) folded before Flop
Seat 5: funker84 (big blind) folded before Flop
Seat 6: Dragonclawss folded before Flop (didn't bet)
Seat 7: forestry800 folded before Flop (didn't bet)
Seat 9: fragonik folded before Flop (didn't bet)



PokerStars Hand #228690541659:  Hold'em No Limit ($0.25/$0.50 USD) - 2021/07/30 17:40:12 ET
Table 'Gorgo III' 9-max Seat #4 is the button
Seat 1: ms1272 ($57.32 in chips) 
Seat 2: FeersPoker ($64.48 in chips) 
Seat 3: schmollhans ($32.32 in chips) 
Seat 4: nicu4you ($78.03 in chips) 
Seat 5: funker84 ($79.58 in chips) 
Seat 7: forestry800 ($51.50 in chips) 
Seat 9: fragonik ($68.92 in chips) 
funker84: posts small blind $0.25
Dragonclawss: is sitting out 
Dragonclawss leaves the table
forestry800: posts big blind $0.50
Leason22: sits out 
*** HOLE CARDS ***
fragonik: folds 
ms1272: folds 
FeersPoker: folds 
schmollhans: raises $1 to $1.50
nicu4you: calls $1.50
funker84: calls $1.25
forestry800: folds 
*** FLOP *** [Js 6s Tc]
funker84: checks 
schmollhans: checks 
nicu4you: checks 
*** TURN *** [Js 6s Tc] [9c]
IsalieTBM joins the table at seat #6 
funker84: bets $3.50
schmollhans: folds 
nicu4you: folds 
Uncalled bet ($3.50) returned to funker84
funker84 collected $4.69 from pot
funker84: doesn't show hand 
*** SUMMARY ***
Total pot $5 | Rake $0.31 
Board [Js 6s Tc 9c]
Seat 1: ms1272 folded before Flop (didn't bet)
Seat 2: FeersPoker folded before Flop (didn't bet)
Seat 3: schmollhans folded on the Turn
Seat 4: nicu4you (button) folded on the Turn
Seat 5: funker84 (small blind) collected ($4.69)
Seat 7: forestry800 (big blind) folded before Flop
Seat 9: fragonik folded before Flop (didn't bet)



PokerStars Hand #228690559999:  Hold'em No Limit ($0.25/$0.50 USD) - 2021/07/30 17:40:54 ET
Table 'Gorgo III' 9-max Seat #5 is the button
Seat 1: ms1272 ($57.32 in chips) 
Seat 2: FeersPoker ($64.48 in chips) 
Seat 3: schmollhans ($30.82 in chips) 
Seat 4: nicu4you ($76.53 in chips) 
Seat 5: funker84 ($82.77 in chips) 
Seat 7: forestry800 ($51 in chips) 
Seat 8: Leason22 ($20 in chips) 
Seat 9: fragonik ($68.92 in chips) 
forestry800: posts small blind $0.25
Leason22: posts big blind $0.50
*** HOLE CARDS ***
fragonik: raises $1 to $1.50
ms1272: folds 
FeersPoker: folds 
schmollhans: folds 
nicu4you: raises $3.75 to $5.25
funker84: folds 
forestry800: folds 
Leason22: folds 
fragonik: calls $3.75
*** FLOP *** [Js 9s 3h]
fragonik: checks 
nicu4you: bets $7.38
fragonik: folds 
Uncalled bet ($7.38) returned to nicu4you
nicu4you collected $10.69 from pot
nicu4you: doesn't show hand 
*** SUMMARY ***
Total pot $11.25 | Rake $0.56 
Board [Js 9s 3h]
Seat 1: ms1272 folded before Flop (didn't bet)
Seat 2: FeersPoker folded before Flop (didn't bet)
Seat 3: schmollhans folded before Flop (didn't bet)
Seat 4: nicu4you collected ($10.69)
Seat 5: funker84 (button) folded before Flop (didn't bet)
Seat 7: forestry800 (small blind) folded before Flop
Seat 8: Leason22 (big blind) folded before Flop
Seat 9: fragonik folded on the Flop



PokerStars Hand #228690578825:  Hold'em No Limit ($0.25/$0.50 USD) - 2021/07/30 17:41:36 ET
Table 'Gorgo III' 9-max Seat #7 is the button
Seat 1: ms1272 ($57.32 in chips) 
Seat 2: FeersPoker ($64.48 in chips) 
Seat 3: schmollhans ($30.82 in chips) 
Seat 4: nicu4you ($81.97 in chips) 
Seat 5: funker84 ($82.77 in chips) 
Seat 6: IsalieTBM ($42.91 in chips) 
Seat 7: forestry800 ($50.75 in chips) 
Seat 8: Leason22 ($19.50 in chips) 
Seat 9: fragonik ($63.67 in chips) 
Leason22: posts small blind $0.25
fragonik: posts big blind $0.50
IsalieTBM: posts big blind $0.50
*** HOLE CARDS ***
ms1272: raises $0.50 to $1
FeersPoker: folds 
schmollhans: folds 
nicu4you: folds 
funker84: folds 
IsalieTBM: calls $0.50
forestry800: folds 
Leason22: folds 
fragonik: calls $0.50
*** FLOP *** [Qh Jc Qc]
fragonik: bets $1.51
ms1272: folds 
IsalieTBM: folds 
Uncalled bet ($1.51) returned to fragonik
fragonik collected $3.09 from pot
*** SUMMARY ***
Total pot $3.25 | Rake $0.16 
Board [Qh Jc Qc]
Seat 1: ms1272 folded on the Flop
Seat 2: FeersPoker folded before Flop (didn't bet)
Seat 3: schmollhans folded before Flop (didn't bet)
Seat 4: nicu4you folded before Flop (didn't bet)
Seat 5: funker84 folded before Flop (didn't bet)
Seat 6: IsalieTBM folded on the Flop
Seat 7: forestry800 (button) folded before Flop (didn't bet)
Seat 8: Leason22 (small blind) folded before Flop
Seat 9: fragonik (big blind) collected ($3.09)



PokerStars Hand #228690595482:  Hold'em No Limit ($0.25/$0.50 USD) - 2021/07/30 17:42:14 ET
Table 'Gorgo III' 9-max Seat #8 is the button
Seat 1: ms1272 ($56.32 in chips) 
Seat 2: FeersPoker ($64.48 in chips) 
Seat 4: nicu4you ($81.97 in chips) 
Seat 5: funker84 ($82.77 in chips) 
Seat 6: IsalieTBM ($41.91 in chips) 
Seat 7: forestry800 ($50.75 in chips) 
Seat 8: Leason22 ($19.25 in chips) 
Seat 9: fragonik ($65.76 in chips) 
fragonik: posts small blind $0.25
ms1272: posts big blind $0.50
*** HOLE CARDS ***
FeersPoker: folds 
nicu4you: folds 
funker84: folds 
IsalieTBM: folds 
forestry800: folds 
Leason22: folds 
fragonik: folds 
Uncalled bet ($0.25) returned to ms1272
ms1272 collected $0.50 from pot
ms1272: doesn't show hand 
*** SUMMARY ***
Total pot $0.50 | Rake $0 
Seat 1: ms1272 (big blind) collected ($0.50)
Seat 2: FeersPoker folded before Flop (didn't bet)
Seat 4: nicu4you folded before Flop (didn't bet)
Seat 5: funker84 folded before Flop (didn't bet)
Seat 6: IsalieTBM folded before Flop (didn't bet)
Seat 7: forestry800 folded before Flop (didn't bet)
Seat 8: Leason22 (button) folded before Flop (didn't bet)
Seat 9: fragonik (small blind) folded before Flop



PokerStars Hand #228690601986:  Hold'em No Limit ($0.25/$0.50 USD) - 2021/07/30 17:42:28 ET
Table 'Gorgo III' 9-max Seat #9 is the button
Seat 1: ms1272 ($56.57 in chips) 
Seat 2: FeersPoker ($64.48 in chips) 
Seat 4: nicu4you ($81.97 in chips) 
Seat 5: funker84 ($82.77 in chips) 
Seat 6: IsalieTBM ($41.91 in chips) 
Seat 7: forestry800 ($50.75 in chips) 
Seat 8: Leason22 ($19.25 in chips) 
Seat 9: fragonik ($65.51 in chips) 
ms1272: posts small blind $0.25
FeersPoker: posts big blind $0.50
*** HOLE CARDS ***
nicu4you: folds 
funker84: folds 
IsalieTBM: folds 
forestry800: folds 
Leason22: folds 
fragonik: folds 
ms1272: raises $0.50 to $1
FeersPoker: calls $0.50
*** FLOP *** [Tc 6d Qd]
ms1272: bets $0.95
FeersPoker: calls $0.95
*** TURN *** [Tc 6d Qd] [4s]
ms1272: checks 
FeersPoker: bets $1.66
ms1272: folds 
Uncalled bet ($1.66) returned to FeersPoker
FeersPoker collected $3.70 from pot
FeersPoker: doesn't show hand 
*** SUMMARY ***
Total pot $3.90 | Rake $0.20 
Board [Tc 6d Qd 4s]
Seat 1: ms1272 (small blind) folded on the Turn
Seat 2: FeersPoker (big blind) collected ($3.70)
Seat 4: nicu4you folded before Flop (didn't bet)
Seat 5: funker84 folded before Flop (didn't bet)
Seat 6: IsalieTBM folded before Flop (didn't bet)
Seat 7: forestry800 folded before Flop (didn't bet)
Seat 8: Leason22 folded before Flop (didn't bet)
Seat 9: fragonik (button) folded before Flop (didn't bet)



PokerStars Hand #228690623329:  Hold'em No Limit ($0.25/$0.50 USD) - 2021/07/30 17:43:17 ET
Table 'Gorgo III' 9-max Seat #1 is the button
Seat 1: ms1272 ($54.62 in chips) 
Seat 2: FeersPoker ($66.23 in chips) 
Seat 4: nicu4you ($81.97 in chips) 
Seat 5: funker84 ($82.77 in chips) 
Seat 6: IsalieTBM ($41.91 in chips) 
Seat 7: forestry800 ($50.75 in chips) 
Seat 8: Leason22 ($19.25 in chips) 
Seat 9: fragonik ($65.51 in chips) 
FeersPoker: posts small blind $0.25
nicu4you: posts big blind $0.50
*** HOLE CARDS ***
funker84: folds 
IsalieTBM: folds 
forestry800: raises $0.75 to $1.25
Leason22: folds 
fragonik: folds 
ms1272: calls $1.25
FeersPoker: raises $5.50 to $6.75
nicu4you: folds 
forestry800: folds 
ms1272: folds 
Uncalled bet ($5.50) returned to FeersPoker
FeersPoker collected $4.25 from pot
FeersPoker: doesn't show hand 
*** SUMMARY ***
Total pot $4.25 | Rake $0 
Seat 1: ms1272 (button) folded before Flop
Seat 2: FeersPoker (small blind) collected ($4.25)
Seat 4: nicu4you (big blind) folded before Flop
Seat 5: funker84 folded before Flop (didn't bet)
Seat 6: IsalieTBM folded before Flop (didn't bet)
Seat 7: forestry800 folded before Flop
Seat 8: Leason22 folded before Flop (didn't bet)
Seat 9: fragonik folded before Flop (didn't bet)



PokerStars Hand #228690637593:  Hold'em No Limit ($0.25/$0.50 USD) - 2021/07/30 17:43:49 ET
Table 'Gorgo III' 9-max Seat #2 is the button
Seat 1: ms1272 ($53.37 in chips) 
Seat 2: FeersPoker ($69.23 in chips) 
Seat 4: nicu4you ($81.47 in chips) 
Seat 5: funker84 ($82.77 in chips) 
Seat 6: IsalieTBM ($41.91 in chips) 
Seat 7: forestry800 ($50 in chips) 
Seat 8: Leason22 ($19.25 in chips) 
Seat 9: fragonik ($65.51 in chips) 
nicu4you: posts small blind $0.25
funker84: posts big blind $0.50
*** HOLE CARDS ***
IsalieTBM: folds 
forestry800: folds 
Leason22: raises $1 to $1.50
fragonik: folds 
ms1272: calls $1.50
FeersPoker: folds 
nicu4you: folds 
funker84: folds 
*** FLOP *** [3c Jd Jc]
Leason22: bets $2
ms1272: folds 
Uncalled bet ($2) returned to Leason22
Leason22 collected $3.51 from pot
*** SUMMARY ***
Total pot $3.75 | Rake $0.24 
Board [3c Jd Jc]
Seat 1: ms1272 folded on the Flop
Seat 2: FeersPoker (button) folded before Flop (didn't bet)
Seat 4: nicu4you (small blind) folded before Flop
Seat 5: funker84 (big blind) folded before Flop
Seat 6: IsalieTBM folded before Flop (didn't bet)
Seat 7: forestry800 folded before Flop (didn't bet)
Seat 8: Leason22 collected ($3.51)
Seat 9: fragonik folded before Flop (didn't bet)



PokerStars Hand #228690656892:  Hold'em No Limit ($0.25/$0.50 USD) - 2021/07/30 17:44:33 ET
Table 'Gorgo III' 9-max Seat #4 is the button
Seat 1: ms1272 ($51.87 in chips) 
Seat 2: FeersPoker ($69.23 in chips) 
Seat 4: nicu4you ($81.22 in chips) 
Seat 5: funker84 ($82.27 in chips) 
Seat 6: IsalieTBM ($41.91 in chips) 
Seat 7: forestry800 ($50 in chips) 
Seat 8: Leason22 ($21.26 in chips) 
Seat 9: fragonik ($65.51 in chips) 
funker84: posts small blind $0.25
IsalieTBM: posts big blind $0.50
*** HOLE CARDS ***
forestry800: folds 
Leason22: raises $1 to $1.50
fragonik: folds 
ms1272: folds 
FeersPoker: folds 
nicu4you: calls $1.50
funker84: folds 
IsalieTBM: folds 
*** FLOP *** [3c Kh 8c]
Leason22: bets $2
nicu4you: calls $2
*** TURN *** [3c Kh 8c] [As]
Leason22: checks 
nicu4you: checks 
*** RIVER *** [3c Kh 8c As] [Ks]
Leason22: bets $3
nicu4you: folds 
Uncalled bet ($3) returned to Leason22
Leason22 collected $7.26 from pot
*** SUMMARY ***
Total pot $7.75 | Rake $0.49 
Board [3c Kh 8c As Ks]
Seat 1: ms1272 folded before Flop (didn't bet)
Seat 2: FeersPoker folded before Flop (didn't bet)
Seat 4: nicu4you (button) folded on the River
Seat 5: funker84 (small blind) folded before Flop
Seat 6: IsalieTBM (big blind) folded before Flop
Seat 7: forestry800 folded before Flop (didn't bet)
Seat 8: Leason22 collected ($7.26)
Seat 9: fragonik folded before Flop (didn't bet)



PokerStars Hand #228690673841:  Hold'em No Limit ($0.25/$0.50 USD) - 2021/07/30 17:45:12 ET
Table 'Gorgo III' 9-max Seat #5 is the button
Seat 1: ms1272 ($51.87 in chips) 
Seat 2: FeersPoker ($69.23 in chips) 
Seat 4: nicu4you ($77.72 in chips) 
Seat 5: funker84 ($82.02 in chips) 
Seat 6: IsalieTBM ($41.41 in chips) 
Seat 7: forestry800 ($50 in chips) 
Seat 8: Leason22 ($25.02 in chips) 
Seat 9: fragonik ($65.51 in chips) 
IsalieTBM: posts small blind $0.25
forestry800: posts big blind $0.50
*** HOLE CARDS ***
Leason22: folds 
fragonik: folds 
ms1272: raises $0.50 to $1
FeersPoker: calls $1
nicu4you: folds 
funker84: folds 
IsalieTBM: folds 
forestry800: folds 
*** FLOP *** [Qd Js Th]
ms1272: bets $1.30
FeersPoker: folds 
Uncalled bet ($1.30) returned to ms1272
ms1272 collected $2.57 from pot
ms1272: doesn't show hand 
*** SUMMARY ***
Total pot $2.75 | Rake $0.18 
Board [Qd Js Th]
Seat 1: ms1272 collected ($2.57)
Seat 2: FeersPoker folded on the Flop
Seat 4: nicu4you folded before Flop (didn't bet)
Seat 5: funker84 (button) folded before Flop (didn't bet)
Seat 6: IsalieTBM (small blind) folded before Flop
Seat 7: forestry800 (big blind) folded before Flop
Seat 8: Leason22 folded before Flop (didn't bet)
Seat 9: fragonik folded before Flop (didn't bet)



PokerStars Hand #228690683207:  Hold'em No Limit ($0.25/$0.50 USD) - 2021/07/30 17:45:33 ET
Table 'Gorgo III' 9-max Seat #6 is the button
Seat 1: ms1272 ($53.44 in chips) 
Seat 2: FeersPoker ($68.23 in chips) 
Seat 4: nicu4you ($77.72 in chips) 
Seat 5: funker84 ($82.02 in chips) 
Seat 6: IsalieTBM ($41.16 in chips) 
Seat 7: forestry800 ($50 in chips) 
Seat 8: Leason22 ($25.02 in chips) 
Seat 9: fragonik ($65.51 in chips) 
forestry800: posts small blind $0.25
Leason22: posts big blind $0.50
*** HOLE CARDS ***
fragonik: folds 
ms1272: folds 
FeersPoker: folds 
nicu4you: raises $0.53 to $1.03
funker84: folds 
IsalieTBM: folds 
forestry800: folds 
Leason22: calls $0.53
*** FLOP *** [Kd Qh 7c]
Leason22: checks 
nicu4you: checks 
*** TURN *** [Kd Qh 7c] [Ah]
Leason22: checks 
nicu4you: checks 
*** RIVER *** [Kd Qh 7c Ah] [2h]
Leason22: checks 
nicu4you: checks 
*** SHOW DOWN ***
Leason22: shows [3d 5d] (high card Ace)
nicu4you: shows [7d 6d] (a pair of Sevens)
nicu4you collected $2.19 from pot
*** SUMMARY ***
Total pot $2.31 | Rake $0.12 
Board [Kd Qh 7c Ah 2h]
Seat 1: ms1272 folded before Flop (didn't bet)
Seat 2: FeersPoker folded before Flop (didn't bet)
Seat 4: nicu4you showed [7d 6d] and won ($2.19) with a pair of Sevens
Seat 5: funker84 folded before Flop (didn't bet)
Seat 6: IsalieTBM (button) folded before Flop (didn't bet)
Seat 7: forestry800 (small blind) folded before Flop
Seat 8: Leason22 (big blind) showed [3d 5d] and lost with high card Ace
Seat 9: fragonik folded before Flop (didn't bet)



PokerStars Hand #228690701124:  Hold'em No Limit ($0.25/$0.50 USD) - 2021/07/30 17:46:15 ET
Table 'Gorgo III' 9-max Seat #8 is the button
Seat 1: ms1272 ($53.44 in chips) 
Seat 2: FeersPoker ($68.23 in chips) 
Seat 4: nicu4you ($78.88 in chips) 
Seat 5: funker84 ($82.02 in chips) 
Seat 6: IsalieTBM ($41.16 in chips) 
Seat 8: Leason22 ($23.99 in chips) 
Seat 9: fragonik ($65.51 in chips) 
fragonik: posts small blind $0.25
ms1272: posts big blind $0.50
*** HOLE CARDS ***
FeersPoker: folds 
nicu4you: raises $1 to $1.50
funker84: folds 
IsalieTBM: folds 
Leason22: calls $1.50
fragonik: folds 
ms1272: calls $1
*** FLOP *** [Jh Qd 7c]
ms1272: checks 
nicu4you: checks 
Leason22: bets $2
ms1272: folds 
nicu4you: folds 
Uncalled bet ($2) returned to Leason22
Leason22 collected $4.45 from pot
*** SUMMARY ***
Total pot $4.75 | Rake $0.30 
Board [Jh Qd 7c]
Seat 1: ms1272 (big blind) folded on the Flop
Seat 2: FeersPoker folded before Flop (didn't bet)
Seat 4: nicu4you folded on the Flop
Seat 5: funker84 folded before Flop (didn't bet)
Seat 6: IsalieTBM folded before Flop (didn't bet)
Seat 8: Leason22 (button) collected ($4.45)
Seat 9: fragonik (small blind) folded before Flop



PokerStars Hand #228690719343:  Hold'em No Limit ($0.25/$0.50 USD) - 2021/07/30 17:46:57 ET
Table 'Gorgo III' 9-max Seat #9 is the button
Seat 1: ms1272 ($51.94 in chips) 
Seat 2: FeersPoker ($68.23 in chips) 
Seat 4: nicu4you ($77.38 in chips) 
Seat 5: funker84 ($82.02 in chips) 
Seat 6: IsalieTBM ($41.16 in chips) 
Seat 7: forestry800 ($50 in chips) 
Seat 8: Leason22 ($26.94 in chips) 
Seat 9: fragonik ($65.26 in chips) 
ms1272: posts small blind $0.25
FeersPoker: posts big blind $0.50
*** HOLE CARDS ***
nicu4you: folds 
funker84: folds 
IsalieTBM: folds 
forestry800: folds 
Leason22: raises $0.50 to $1
fragonik: folds 
ms1272: folds 
FeersPoker: calls $0.50
*** FLOP *** [6c 5h Qh]
FeersPoker: checks 
Leason22: bets $1.50
FeersPoker: calls $1.50
*** TURN *** [6c 5h Qh] [5c]
FeersPoker: checks 
Leason22: bets $4.99
FeersPoker: folds 
Uncalled bet ($4.99) returned to Leason22
Leason22 collected $4.93 from pot
*** SUMMARY ***
Total pot $5.25 | Rake $0.32 
Board [6c 5h Qh 5c]
Seat 1: ms1272 (small blind) folded before Flop
Seat 2: FeersPoker (big blind) folded on the Turn
Seat 4: nicu4you folded before Flop (didn't bet)
Seat 5: funker84 folded before Flop (didn't bet)
Seat 6: IsalieTBM folded before Flop (didn't bet)
Seat 7: forestry800 folded before Flop (didn't bet)
Seat 8: Leason22 collected ($4.93)
Seat 9: fragonik (button) folded before Flop (didn't bet)



PokerStars Hand #228690746900:  Hold'em No Limit ($0.25/$0.50 USD) - 2021/07/30 17:48:01 ET
Table 'Gorgo III' 9-max Seat #1 is the button
Seat 1: ms1272 ($51.69 in chips) 
Seat 2: FeersPoker ($65.73 in chips) 
Seat 4: nicu4you ($77.38 in chips) 
Seat 5: funker84 ($82.02 in chips) 
Seat 6: IsalieTBM ($41.16 in chips) 
Seat 7: forestry800 ($50 in chips) 
Seat 8: Leason22 ($29.37 in chips) 
Seat 9: fragonik ($65.26 in chips) 
FeersPoker: posts small blind $0.25
nicu4you: posts big blind $0.50
*** HOLE CARDS ***
funker84: folds 
IsalieTBM: folds 
forestry800: raises $0.75 to $1.25
Leason22: folds 
fragonik: folds 
ms1272: folds 
FeersPoker: raises $3.50 to $4.75
nicu4you: folds 
forestry800: folds 
Uncalled bet ($3.50) returned to FeersPoker
FeersPoker collected $3 from pot
FeersPoker: doesn't show hand 
*** SUMMARY ***
Total pot $3 | Rake $0 
Seat 1: ms1272 (button) folded before Flop (didn't bet)
Seat 2: FeersPoker (small blind) collected ($3)
Seat 4: nicu4you (big blind) folded before Flop
Seat 5: funker84 folded before Flop (didn't bet)
Seat 6: IsalieTBM folded before Flop (didn't bet)
Seat 7: forestry800 folded before Flop
Seat 8: Leason22 folded before Flop (didn't bet)
Seat 9: fragonik folded before Flop (didn't bet)



PokerStars Hand #228690756561:  Hold'em No Limit ($0.25/$0.50 USD) - 2021/07/30 17:48:24 ET
Table 'Gorgo III' 9-max Seat #2 is the button
Seat 1: ms1272 ($51.69 in chips) 
Seat 2: FeersPoker ($67.48 in chips) 
Seat 4: nicu4you ($76.88 in chips) 
Seat 5: funker84 ($82.02 in chips) 
Seat 6: IsalieTBM ($41.16 in chips) 
Seat 7: forestry800 ($50 in chips) 
Seat 8: Leason22 ($29.37 in chips) 
Seat 9: fragonik ($65.26 in chips) 
nicu4you: posts small blind $0.25
funker84: posts big blind $0.50
*** HOLE CARDS ***
IsalieTBM: folds 
forestry800: folds 
Leason22: folds 
fragonik: folds 
ms1272: raises $0.50 to $1
FeersPoker: folds 
nicu4you: folds 
funker84: calls $0.50
*** FLOP *** [7d Kh 6c]
funker84: checks 
ms1272: bets $1.07
funker84: raises $2.43 to $3.50
ms1272: folds 
Uncalled bet ($2.43) returned to funker84
funker84 collected $4.11 from pot
funker84: doesn't show hand 
*** SUMMARY ***
Total pot $4.39 | Rake $0.28 
Board [7d Kh 6c]
Seat 1: ms1272 folded on the Flop
Seat 2: FeersPoker (button) folded before Flop (didn't bet)
Seat 4: nicu4you (small blind) folded before Flop
Seat 5: funker84 (big blind) collected ($4.11)
Seat 6: IsalieTBM folded before Flop (didn't bet)
Seat 7: forestry800 folded before Flop (didn't bet)
Seat 8: Leason22 folded before Flop (didn't bet)
Seat 9: fragonik folded before Flop (didn't bet)



PokerStars Hand #228690773307:  Hold'em No Limit ($0.25/$0.50 USD) - 2021/07/30 17:49:03 ET
Table 'Gorgo III' 9-max Seat #4 is the button
Seat 1: ms1272 ($50 in chips) 
Seat 2: FeersPoker ($67.48 in chips) 
Seat 4: nicu4you ($76.63 in chips) 
Seat 5: funker84 ($84.06 in chips) 
Seat 6: IsalieTBM ($41.16 in chips) 
Seat 7: forestry800 ($50 in chips) 
Seat 8: Leason22 ($29.37 in chips) 
Seat 9: fragonik ($65.26 in chips) 
funker84: posts small blind $0.25
IsalieTBM: posts big blind $0.50
schmollhans: sits out 
*** HOLE CARDS ***
forestry800: raises $0.75 to $1.25
Leason22: folds 
fragonik: folds 
ms1272: folds 
FeersPoker: folds 
nicu4you: folds 
funker84: folds 
IsalieTBM: folds 
Uncalled bet ($0.75) returned to forestry800
forestry800 collected $1.25 from pot
forestry800: doesn't show hand 
*** SUMMARY ***
Total pot $1.25 | Rake $0 
Seat 1: ms1272 folded before Flop (didn't bet)
Seat 2: FeersPoker folded before Flop (didn't bet)
Seat 4: nicu4you (button) folded before Flop (didn't bet)
Seat 5: funker84 (small blind) folded before Flop
Seat 6: IsalieTBM (big blind) folded before Flop
Seat 7: forestry800 collected ($1.25)
Seat 8: Leason22 folded before Flop (didn't bet)
Seat 9: fragonik folded before Flop (didn't bet)



PokerStars Hand #228690781033:  Hold'em No Limit ($0.25/$0.50 USD) - 2021/07/30 17:49:21 ET
Table 'Gorgo III' 9-max Seat #5 is the button
Seat 1: ms1272 ($50 in chips) 
Seat 2: FeersPoker ($67.48 in chips) 
Seat 4: nicu4you ($76.63 in chips) 
Seat 5: funker84 ($83.81 in chips) 
Seat 6: IsalieTBM ($40.66 in chips) 
Seat 8: Leason22 ($29.37 in chips) 
Seat 9: fragonik ($65.26 in chips) 
IsalieTBM: posts small blind $0.25
forestry800: is sitting out 
Leason22: posts big blind $0.50
schmollhans: sits out 
*** HOLE CARDS ***
fragonik: folds 
forestry800 leaves the table
ms1272: folds 
FeersPoker: raises $0.75 to $1.25
nicu4you: folds 
Pablo1405 joins the table at seat #7 
funker84: folds 
IsalieTBM: folds 
Leason22: folds 
Uncalled bet ($0.75) returned to FeersPoker
FeersPoker collected $1.25 from pot
FeersPoker: doesn't show hand 
*** SUMMARY ***
Total pot $1.25 | Rake $0 
Seat 1: ms1272 folded before Flop (didn't bet)
Seat 2: FeersPoker collected ($1.25)
Seat 4: nicu4you folded before Flop (didn't bet)
Seat 5: funker84 (button) folded before Flop (didn't bet)
Seat 6: IsalieTBM (small blind) folded before Flop
Seat 8: Leason22 (big blind) folded before Flop
Seat 9: fragonik folded before Flop (didn't bet)



PokerStars Hand #228690788652:  Hold'em No Limit ($0.25/$0.50 USD) - 2021/07/30 17:49:39 ET
Table 'Gorgo III' 9-max Seat #6 is the button
Seat 1: ms1272 ($50 in chips) 
Seat 2: FeersPoker ($68.23 in chips) 
Seat 4: nicu4you ($76.63 in chips) 
Seat 5: funker84 ($83.81 in chips) 
Seat 6: IsalieTBM ($40.41 in chips) 
Seat 8: Leason22 ($28.87 in chips) 
Seat 9: fragonik ($65.26 in chips) 
Leason22: posts small blind $0.25
fragonik: posts big blind $0.50
schmollhans: sits out 
*** HOLE CARDS ***
ms1272: folds 
FeersPoker: folds 
nicu4you: folds 
funker84: folds 
IsalieTBM: folds 
Leason22: folds 
Uncalled bet ($0.25) returned to fragonik
fragonik collected $0.50 from pot
*** SUMMARY ***
Total pot $0.50 | Rake $0 
Seat 1: ms1272 folded before Flop (didn't bet)
Seat 2: FeersPoker folded before Flop (didn't bet)
Seat 4: nicu4you folded before Flop (didn't bet)
Seat 5: funker84 folded before Flop (didn't bet)
Seat 6: IsalieTBM (button) folded before Flop (didn't bet)
Seat 8: Leason22 (small blind) folded before Flop
Seat 9: fragonik (big blind) collected ($0.50)



PokerStars Hand #228690794388:  Hold'em No Limit ($0.25/$0.50 USD) - 2021/07/30 17:49:52 ET
Table 'Gorgo III' 9-max Seat #8 is the button
Seat 1: ms1272 ($50 in chips) 
Seat 2: FeersPoker ($68.23 in chips) 
Seat 4: nicu4you ($76.63 in chips) 
Seat 5: funker84 ($83.81 in chips) 
Seat 6: IsalieTBM ($40.41 in chips) 
Seat 8: Leason22 ($28.62 in chips) 
Seat 9: fragonik ($65.51 in chips) 
fragonik: posts small blind $0.25
ms1272: posts big blind $0.50
schmollhans: sits out 
Pablo1405: sits out 
*** HOLE CARDS ***
FeersPoker: raises $0.75 to $1.25
nicu4you: folds 
funker84: folds 
IsalieTBM: folds 
Leason22: folds 
fragonik: folds 
ms1272: calls $0.75
*** FLOP *** [Qd 7d Jd]
ms1272: checks 
FeersPoker: checks 
*** TURN *** [Qd 7d Jd] [9s]
ms1272: checks 
FeersPoker: checks 
*** RIVER *** [Qd 7d Jd 9s] [3c]
ms1272: checks 
FeersPoker: checks 
*** SHOW DOWN ***
ms1272: shows [Ac Jc] (a pair of Jacks)
FeersPoker: mucks hand 
ms1272 collected $2.57 from pot
*** SUMMARY ***
Total pot $2.75 | Rake $0.18 
Board [Qd 7d Jd 9s 3c]
Seat 1: ms1272 (big blind) showed [Ac Jc] and won ($2.57) with a pair of Jacks
Seat 2: FeersPoker mucked
Seat 4: nicu4you folded before Flop (didn't bet)
Seat 5: funker84 folded before Flop (didn't bet)
Seat 6: IsalieTBM folded before Flop (didn't bet)
Seat 8: Leason22 (button) folded before Flop (didn't bet)
Seat 9: fragonik (small blind) folded before Flop



PokerStars Hand #228690812656:  Hold'em No Limit ($0.25/$0.50 USD) - 2021/07/30 17:50:35 ET
Table 'Gorgo III' 9-max Seat #9 is the button
Seat 1: ms1272 ($51.32 in chips) 
Seat 2: FeersPoker ($66.98 in chips) 
Seat 4: nicu4you ($76.63 in chips) 
Seat 5: funker84 ($83.81 in chips) 
Seat 6: IsalieTBM ($40.41 in chips) 
Seat 8: Leason22 ($28.62 in chips) 
Seat 9: fragonik ($65.26 in chips) 
ms1272: posts small blind $0.25
FeersPoker: posts big blind $0.50
schmollhans: sits out 
Pablo1405: sits out 
*** HOLE CARDS ***
nicu4you: folds 
funker84: folds 
IsalieTBM: folds 
Leason22: folds 
fragonik: folds 
ms1272: folds 
Uncalled bet ($0.25) returned to FeersPoker
FeersPoker collected $0.50 from pot
FeersPoker: doesn't show hand 
*** SUMMARY ***
Total pot $0.50 | Rake $0 
Seat 1: ms1272 (small blind) folded before Flop
Seat 2: FeersPoker (big blind) collected ($0.50)
Seat 4: nicu4you folded before Flop (didn't bet)
Seat 5: funker84 folded before Flop (didn't bet)
Seat 6: IsalieTBM folded before Flop (didn't bet)
Seat 8: Leason22 folded before Flop (didn't bet)
Seat 9: fragonik (button) folded before Flop (didn't bet)



PokerStars Hand #228690816864:  Hold'em No Limit ($0.25/$0.50 USD) - 2021/07/30 17:50:45 ET
Table 'Gorgo III' 9-max Seat #1 is the button
Seat 1: ms1272 ($51.07 in chips) 
Seat 2: FeersPoker ($67.23 in chips) 
Seat 3: schmollhans ($30.82 in chips) 
Seat 4: nicu4you ($76.63 in chips) 
Seat 5: funker84 ($83.81 in chips) 
Seat 6: IsalieTBM ($40.41 in chips) 
Seat 8: Leason22 ($28.62 in chips) 
Seat 9: fragonik ($65.26 in chips) 
FeersPoker: posts small blind $0.25
schmollhans: posts big blind $0.50
Pablo1405: sits out 
*** HOLE CARDS ***
nicu4you: folds 
funker84: folds 
IsalieTBM: folds 
Leason22: folds 
fragonik: folds 
ms1272: raises $0.50 to $1
FeersPoker: folds 
schmollhans: calls $0.50
*** FLOP *** [Qh Ah 7h]
schmollhans: checks 
ms1272: bets $1.07
schmollhans: folds 
Uncalled bet ($1.07) returned to ms1272
ms1272 collected $2.11 from pot
ms1272: doesn't show hand 
*** SUMMARY ***
Total pot $2.25 | Rake $0.14 
Board [Qh Ah 7h]
Seat 1: ms1272 (button) collected ($2.11)
Seat 2: FeersPoker (small blind) folded before Flop
Seat 3: schmollhans (big blind) folded on the Flop
Seat 4: nicu4you folded before Flop (didn't bet)
Seat 5: funker84 folded before Flop (didn't bet)
Seat 6: IsalieTBM folded before Flop (didn't bet)
Seat 8: Leason22 folded before Flop (didn't bet)
Seat 9: fragonik folded before Flop (didn't bet)



PokerStars Hand #228690824193:  Hold'em No Limit ($0.25/$0.50 USD) - 2021/07/30 17:51:02 ET
Table 'Gorgo III' 9-max Seat #2 is the button
Seat 1: ms1272 ($52.18 in chips) 
Seat 2: FeersPoker ($66.98 in chips) 
Seat 3: schmollhans ($29.82 in chips) 
Seat 4: nicu4you ($76.63 in chips) 
Seat 5: funker84 ($83.81 in chips) 
Seat 6: IsalieTBM ($40.41 in chips) 
Seat 8: Leason22 ($28.62 in chips) 
Seat 9: fragonik ($65.26 in chips) 
schmollhans: posts small blind $0.25
nicu4you: posts big blind $0.50
Pablo1405: sits out 
*** HOLE CARDS ***
funker84: raises $0.50 to $1
IsalieTBM: folds 
Leason22: calls $1
fragonik: folds 
ms1272: folds 
FeersPoker: calls $1
schmollhans: folds 
nicu4you: folds 
*** FLOP *** [Ad Qd 4s]
funker84: checks 
Leason22: bets $1.50
FeersPoker: calls $1.50
funker84: folds 
*** TURN *** [Ad Qd 4s] [As]
Leason22: bets $4
FeersPoker: calls $4
*** RIVER *** [Ad Qd 4s As] [3h]
Leason22: bets $7.01
FeersPoker: calls $7.01
*** SHOW DOWN ***
Leason22: shows [Ac 9c] (three of a kind, Aces)
FeersPoker: mucks hand 
Leason22 collected $26.97 from pot
*** SUMMARY ***
Total pot $28.77 | Rake $1.80 
Board [Ad Qd 4s As 3h]
Seat 1: ms1272 folded before Flop (didn't bet)
Seat 2: FeersPoker (button) mucked
Seat 3: schmollhans (small blind) folded before Flop
Seat 4: nicu4you (big blind) folded before Flop
Seat 5: funker84 folded on the Flop
Seat 6: IsalieTBM folded before Flop (didn't bet)
Seat 8: Leason22 showed [Ac 9c] and won ($26.97) with three of a kind, Aces
Seat 9: fragonik folded before Flop (didn't bet)



PokerStars Hand #228690879082:  Hold'em No Limit ($0.25/$0.50 USD) - 2021/07/30 17:53:01 ET
Table 'Gorgo III' 9-max Seat #3 is the button
Seat 1: ms1272 ($52.18 in chips) 
Seat 2: FeersPoker ($53.47 in chips) 
Seat 3: schmollhans ($29.57 in chips) 
Seat 4: nicu4you ($76.13 in chips) 
Seat 5: funker84 ($82.81 in chips) 
Seat 6: IsalieTBM ($40.41 in chips) 
Seat 8: Leason22 ($42.08 in chips) 
Seat 9: fragonik ($65.26 in chips) 
nicu4you: posts small blind $0.25
funker84: posts big blind $0.50
Pablo1405: sits out 
*** HOLE CARDS ***
IsalieTBM: folds 
Leason22: folds 
fragonik: folds 
ms1272: folds 
FeersPoker: raises $0.75 to $1.25
schmollhans: raises $1.75 to $3
nicu4you: folds 
funker84: folds 
FeersPoker: folds 
Uncalled bet ($1.75) returned to schmollhans
schmollhans collected $3.25 from pot
schmollhans: doesn't show hand 
*** SUMMARY ***
Total pot $3.25 | Rake $0 
Seat 1: ms1272 folded before Flop (didn't bet)
Seat 2: FeersPoker folded before Flop
Seat 3: schmollhans (button) collected ($3.25)
Seat 4: nicu4you (small blind) folded before Flop
Seat 5: funker84 (big blind) folded before Flop
Seat 6: IsalieTBM folded before Flop (didn't bet)
Seat 8: Leason22 folded before Flop (didn't bet)
Seat 9: fragonik folded before Flop (didn't bet)



PokerStars Hand #228690896071:  Hold'em No Limit ($0.25/$0.50 USD) - 2021/07/30 17:53:41 ET
Table 'Gorgo III' 9-max Seat #4 is the button
Seat 1: ms1272 ($52.18 in chips) 
Seat 2: FeersPoker ($52.22 in chips) 
Seat 3: schmollhans ($31.57 in chips) 
Seat 4: nicu4you ($75.88 in chips) 
Seat 5: funker84 ($82.31 in chips) 
Seat 6: IsalieTBM ($40.41 in chips) 
Seat 8: Leason22 ($42.08 in chips) 
Seat 9: fragonik ($65.26 in chips) 
funker84: posts small blind $0.25
IsalieTBM: posts big blind $0.50
Pablo1405: sits out 
*** HOLE CARDS ***
Leason22: folds 
fragonik: folds 
ms1272: raises $0.50 to $1
FeersPoker: folds 
schmollhans: folds 
nicu4you: folds 
funker84: folds 
IsalieTBM: calls $0.50
*** FLOP *** [2d Td 5c]
IsalieTBM: bets $1.07
ms1272: raises $2.14 to $3.21
IsalieTBM: folds 
Uncalled bet ($2.14) returned to ms1272
ms1272 collected $4.11 from pot
ms1272: doesn't show hand 
*** SUMMARY ***
Total pot $4.39 | Rake $0.28 
Board [2d Td 5c]
Seat 1: ms1272 collected ($4.11)
Seat 2: FeersPoker folded before Flop (didn't bet)
Seat 3: schmollhans folded before Flop (didn't bet)
Seat 4: nicu4you (button) folded before Flop (didn't bet)
Seat 5: funker84 (small blind) folded before Flop
Seat 6: IsalieTBM (big blind) folded on the Flop
Seat 8: Leason22 folded before Flop (didn't bet)
Seat 9: fragonik folded before Flop (didn't bet)



PokerStars Hand #228690916249:  Hold'em No Limit ($0.25/$0.50 USD) - 2021/07/30 17:54:29 ET
Table 'Gorgo III' 9-max Seat #5 is the button
Seat 1: ms1272 ($54.22 in chips) 
Seat 2: FeersPoker ($52.22 in chips) 
Seat 3: schmollhans ($31.57 in chips) 
Seat 4: nicu4you ($75.88 in chips) 
Seat 5: funker84 ($82.06 in chips) 
Seat 6: IsalieTBM ($38.34 in chips) 
Seat 7: Pablo1405 ($50 in chips) 
Seat 8: Leason22 ($42.08 in chips) 
Seat 9: fragonik ($65.26 in chips) 
IsalieTBM: posts small blind $0.25
Pablo1405: posts big blind $0.50
*** HOLE CARDS ***
Leason22: folds 
fragonik: folds 
ms1272: folds 
FeersPoker: folds 
Leason22 leaves the table
schmollhans: raises $1 to $1.50
nicu4you: folds 
funker84: folds 
IsalieTBM: folds 
Pablo1405: folds 
Uncalled bet ($1) returned to schmollhans
schmollhans collected $1.25 from pot
schmollhans: doesn't show hand 
*** SUMMARY ***
Total pot $1.25 | Rake $0 
Seat 1: ms1272 folded before Flop (didn't bet)
Seat 2: FeersPoker folded before Flop (didn't bet)
Seat 3: schmollhans collected ($1.25)
Seat 4: nicu4you folded before Flop (didn't bet)
Seat 5: funker84 (button) folded before Flop (didn't bet)
Seat 6: IsalieTBM (small blind) folded before Flop
Seat 7: Pablo1405 (big blind) folded before Flop
Seat 8: Leason22 folded before Flop (didn't bet)
Seat 9: fragonik folded before Flop (didn't bet)



PokerStars Hand #228690922730:  Hold'em No Limit ($0.25/$0.50 USD) - 2021/07/30 17:54:44 ET
Table 'Gorgo III' 9-max Seat #6 is the button
Seat 1: ms1272 ($54.22 in chips) 
Seat 2: FeersPoker ($52.22 in chips) 
Seat 3: schmollhans ($32.32 in chips) 
Seat 4: nicu4you ($75.88 in chips) 
Seat 5: funker84 ($82.06 in chips) 
Seat 6: IsalieTBM ($38.09 in chips) 
Seat 7: Pablo1405 ($50 in chips) 
Seat 9: fragonik ($65.26 in chips) 
SENSAS1AN joins the table at seat #8 
Pablo1405: posts small blind $0.25
fragonik: posts big blind $0.50
*** HOLE CARDS ***
ms1272: folds 
FeersPoker: folds 
schmollhans: folds 
nicu4you: folds 
funker84: folds 
IsalieTBM: calls $0.50
Pablo1405: folds 
fragonik: checks 
*** FLOP *** [9s Ah Jd]
fragonik: checks 
IsalieTBM: bets $0.59
fragonik: folds 
Uncalled bet ($0.59) returned to IsalieTBM
IsalieTBM collected $1.19 from pot
IsalieTBM: doesn't show hand 
*** SUMMARY ***
Total pot $1.25 | Rake $0.06 
Board [9s Ah Jd]
Seat 1: ms1272 folded before Flop (didn't bet)
Seat 2: FeersPoker folded before Flop (didn't bet)
Seat 3: schmollhans folded before Flop (didn't bet)
Seat 4: nicu4you folded before Flop (didn't bet)
Seat 5: funker84 folded before Flop (didn't bet)
Seat 6: IsalieTBM (button) collected ($1.19)
Seat 7: Pablo1405 (small blind) folded before Flop
Seat 9: fragonik (big blind) folded on the Flop



PokerStars Hand #228690940937:  Hold'em No Limit ($0.25/$0.50 USD) - 2021/07/30 17:55:33 ET
Table 'Gorgo III' 9-max Seat #7 is the button
Seat 1: ms1272 ($54.22 in chips) 
Seat 2: FeersPoker ($52.22 in chips) 
Seat 3: schmollhans ($32.32 in chips) 
Seat 4: nicu4you ($75.88 in chips) 
Seat 5: funker84 ($82.06 in chips) 
Seat 6: IsalieTBM ($38.78 in chips) 
Seat 7: Pablo1405 ($50 in chips) 
Seat 9: fragonik ($64.76 in chips) 
fragonik: posts small blind $0.25
ms1272: posts big blind $0.50
*** HOLE CARDS ***
FeersPoker: folds 
schmollhans: folds 
nicu4you: folds 
funker84: folds 
IsalieTBM: raises $1 to $1.50
Pablo1405: folds 
fragonik: folds 
ms1272: calls $1
*** FLOP *** [Ks 2c 4c]
ms1272: checks 
IsalieTBM: bets $1.54
ms1272: folds 
Uncalled bet ($1.54) returned to IsalieTBM
IsalieTBM collected $3.09 from pot
IsalieTBM: doesn't show hand 
*** SUMMARY ***
Total pot $3.25 | Rake $0.16 
Board [Ks 2c 4c]
Seat 1: ms1272 (big blind) folded on the Flop
Seat 2: FeersPoker folded before Flop (didn't bet)
Seat 3: schmollhans folded before Flop (didn't bet)
Seat 4: nicu4you folded before Flop (didn't bet)
Seat 5: funker84 folded before Flop (didn't bet)
Seat 6: IsalieTBM collected ($3.09)
Seat 7: Pablo1405 (button) folded before Flop (didn't bet)
Seat 9: fragonik (small blind) folded before Flop



PokerStars Hand #228690950179:  Hold'em No Limit ($0.25/$0.50 USD) - 2021/07/30 17:56:02 ET
Table 'Gorgo III' 9-max Seat #9 is the button
Seat 1: ms1272 ($52.72 in chips) 
Seat 2: FeersPoker ($52.22 in chips) 
Seat 3: schmollhans ($32.32 in chips) 
Seat 4: nicu4you ($75.88 in chips) 
Seat 5: funker84 ($82.06 in chips) 
Seat 6: IsalieTBM ($40.37 in chips) 
Seat 7: Pablo1405 ($50 in chips) 
Seat 9: fragonik ($64.51 in chips) 
ms1272: posts small blind $0.25
FeersPoker: posts big blind $0.50
SENSAS1AN: sits out 
*** HOLE CARDS ***
schmollhans: folds 
nicu4you: folds 
funker84: raises $0.50 to $1
IsalieTBM: folds 
Pablo1405: folds 
fragonik: folds 
ms1272: folds 
FeersPoker: folds 
Uncalled bet ($0.50) returned to funker84
funker84 collected $1.25 from pot
funker84: doesn't show hand 
*** SUMMARY ***
Total pot $1.25 | Rake $0 
Seat 1: ms1272 (small blind) folded before Flop
Seat 2: FeersPoker (big blind) folded before Flop
Seat 3: schmollhans folded before Flop (didn't bet)
Seat 4: nicu4you folded before Flop (didn't bet)
Seat 5: funker84 collected ($1.25)
Seat 6: IsalieTBM folded before Flop (didn't bet)
Seat 7: Pablo1405 folded before Flop (didn't bet)
Seat 9: fragonik (button) folded before Flop (didn't bet)



PokerStars Hand #228690955286:  Hold'em No Limit ($0.25/$0.50 USD) - 2021/07/30 17:56:17 ET
Table 'Gorgo III' 9-max Seat #1 is the button
Seat 1: ms1272 ($52.47 in chips) 
Seat 2: FeersPoker ($51.72 in chips) 
Seat 3: schmollhans ($32.32 in chips) 
Seat 4: nicu4you ($75.88 in chips) 
Seat 5: funker84 ($82.81 in chips) 
Seat 6: IsalieTBM ($40.37 in chips) 
Seat 7: Pablo1405 ($50 in chips) 
Seat 9: fragonik ($64.51 in chips) 
FeersPoker: posts small blind $0.25
schmollhans: posts big blind $0.50
SENSAS1AN: sits out 
*** HOLE CARDS ***
nicu4you: folds 
funker84: folds 
IsalieTBM: folds 
Pablo1405: folds 
fragonik: raises $0.75 to $1.25
ms1272: folds 
FeersPoker: raises $3.50 to $4.75
schmollhans: folds 
fragonik: folds 
Uncalled bet ($3.50) returned to FeersPoker
FeersPoker collected $3 from pot
FeersPoker: doesn't show hand 
*** SUMMARY ***
Total pot $3 | Rake $0 
Seat 1: ms1272 (button) folded before Flop (didn't bet)
Seat 2: FeersPoker (small blind) collected ($3)
Seat 3: schmollhans (big blind) folded before Flop
Seat 4: nicu4you folded before Flop (didn't bet)
Seat 5: funker84 folded before Flop (didn't bet)
Seat 6: IsalieTBM folded before Flop (didn't bet)
Seat 7: Pablo1405 folded before Flop (didn't bet)
Seat 9: fragonik folded before Flop



PokerStars Hand #228690964581:  Hold'em No Limit ($0.25/$0.50 USD) - 2021/07/30 17:56:46 ET
Table 'Gorgo III' 9-max Seat #2 is the button
Seat 1: ms1272 ($52.47 in chips) 
Seat 2: FeersPoker ($53.47 in chips) 
Seat 3: schmollhans ($31.82 in chips) 
Seat 4: nicu4you ($75.88 in chips) 
Seat 5: funker84 ($82.81 in chips) 
Seat 6: IsalieTBM ($40.37 in chips) 
Seat 7: Pablo1405 ($50 in chips) 
Seat 9: fragonik ($63.26 in chips) 
schmollhans: posts small blind $0.25
nicu4you: posts big blind $0.50
SENSAS1AN: sits out 
*** HOLE CARDS ***
funker84: folds 
IsalieTBM: folds 
Pablo1405: folds 
fragonik: folds 
ms1272: folds 
FeersPoker: folds 
schmollhans: calls $0.25
nicu4you: checks 
*** FLOP *** [Th Js Qd]
schmollhans: checks 
nicu4you: checks 
*** TURN *** [Th Js Qd] [4d]
schmollhans: bets $1
nicu4you: folds 
Uncalled bet ($1) returned to schmollhans
schmollhans collected $0.94 from pot
schmollhans: doesn't show hand 
*** SUMMARY ***
Total pot $1 | Rake $0.06 
Board [Th Js Qd 4d]
Seat 1: ms1272 folded before Flop (didn't bet)
Seat 2: FeersPoker (button) folded before Flop (didn't bet)
Seat 3: schmollhans (small blind) collected ($0.94)
Seat 4: nicu4you (big blind) folded on the Turn
Seat 5: funker84 folded before Flop (didn't bet)
Seat 6: IsalieTBM folded before Flop (didn't bet)
Seat 7: Pablo1405 folded before Flop (didn't bet)
Seat 9: fragonik folded before Flop (didn't bet)



PokerStars Hand #228690975629:  Hold'em No Limit ($0.25/$0.50 USD) - 2021/07/30 17:57:20 ET
Table 'Gorgo III' 9-max Seat #3 is the button
Seat 1: ms1272 ($52.47 in chips) 
Seat 2: FeersPoker ($53.47 in chips) 
Seat 3: schmollhans ($32.26 in chips) 
Seat 4: nicu4you ($75.38 in chips) 
Seat 5: funker84 ($82.81 in chips) 
Seat 6: IsalieTBM ($40.37 in chips) 
Seat 7: Pablo1405 ($50 in chips) 
Seat 9: fragonik ($63.26 in chips) 
nicu4you: posts small blind $0.25
funker84: posts big blind $0.50
SENSAS1AN: sits out 
*** HOLE CARDS ***
IsalieTBM: folds 
Pablo1405: folds 
fragonik: folds 
ms1272: raises $0.50 to $1
FeersPoker: folds 
schmollhans: calls $1
nicu4you: folds 
funker84: calls $0.50
*** FLOP *** [9h 4c As]
funker84: checks 
ms1272: bets $1.54
schmollhans: folds 
funker84: folds 
Uncalled bet ($1.54) returned to ms1272
ms1272 collected $3.05 from pot
ms1272: doesn't show hand 
*** SUMMARY ***
Total pot $3.25 | Rake $0.20 
Board [9h 4c As]
Seat 1: ms1272 collected ($3.05)
Seat 2: FeersPoker folded before Flop (didn't bet)
Seat 3: schmollhans (button) folded on the Flop
Seat 4: nicu4you (small blind) folded before Flop
Seat 5: funker84 (big blind) folded on the Flop
Seat 6: IsalieTBM folded before Flop (didn't bet)
Seat 7: Pablo1405 folded before Flop (didn't bet)
Seat 9: fragonik folded before Flop (didn't bet)



PokerStars Hand #228691003726:  Hold'em No Limit ($0.25/$0.50 USD) - 2021/07/30 17:58:01 ET
Table 'Gorgo III' 9-max Seat #4 is the button
Seat 1: ms1272 ($54.52 in chips) 
Seat 2: FeersPoker ($53.47 in chips) 
Seat 3: schmollhans ($31.26 in chips) 
Seat 4: nicu4you ($75.13 in chips) 
Seat 5: funker84 ($81.81 in chips) 
Seat 6: IsalieTBM ($40.37 in chips) 
Seat 7: Pablo1405 ($50 in chips) 
Seat 9: fragonik ($63.26 in chips) 
funker84: posts small blind $0.25
IsalieTBM: posts big blind $0.50
SENSAS1AN: sits out 
*** HOLE CARDS ***
Pablo1405: folds 
fragonik: raises $1 to $1.50
ms1272: folds 
FeersPoker: folds 
schmollhans: folds 
nicu4you: folds 
funker84: folds 
IsalieTBM: folds 
Uncalled bet ($1) returned to fragonik
fragonik collected $1.25 from pot
*** SUMMARY ***
Total pot $1.25 | Rake $0 
Seat 1: ms1272 folded before Flop (didn't bet)
Seat 2: FeersPoker folded before Flop (didn't bet)
Seat 3: schmollhans folded before Flop (didn't bet)
Seat 4: nicu4you (button) folded before Flop (didn't bet)
Seat 5: funker84 (small blind) folded before Flop
Seat 6: IsalieTBM (big blind) folded before Flop
Seat 7: Pablo1405 folded before Flop (didn't bet)
Seat 9: fragonik collected ($1.25)



PokerStars Hand #228691011507:  Hold'em No Limit ($0.25/$0.50 USD) - 2021/07/30 17:58:24 ET
Table 'Gorgo III' 9-max Seat #5 is the button
Seat 1: ms1272 ($54.52 in chips) 
Seat 2: FeersPoker ($53.47 in chips) 
Seat 3: schmollhans ($31.26 in chips) 
Seat 4: nicu4you ($75.13 in chips) 
Seat 5: funker84 ($81.56 in chips) 
Seat 6: IsalieTBM ($39.87 in chips) 
Seat 7: Pablo1405 ($50 in chips) 
Seat 9: fragonik ($64.01 in chips) 
IsalieTBM: posts small blind $0.25
Pablo1405: posts big blind $0.50
SENSAS1AN: sits out 
*** HOLE CARDS ***
fragonik: folds 
ms1272: folds 
FeersPoker: folds 
schmollhans: raises $1 to $1.50
nicu4you: folds 
funker84: folds 
IsalieTBM: folds 
Pablo1405: folds 
Uncalled bet ($1) returned to schmollhans
schmollhans collected $1.25 from pot
schmollhans: doesn't show hand 
*** SUMMARY ***
Total pot $1.25 | Rake $0 
Seat 1: ms1272 folded before Flop (didn't bet)
Seat 2: FeersPoker folded before Flop (didn't bet)
Seat 3: schmollhans collected ($1.25)
Seat 4: nicu4you folded before Flop (didn't bet)
Seat 5: funker84 (button) folded before Flop (didn't bet)
Seat 6: IsalieTBM (small blind) folded before Flop
Seat 7: Pablo1405 (big blind) folded before Flop
Seat 9: fragonik folded before Flop (didn't bet)



PokerStars Hand #228691017448:  Hold'em No Limit ($0.25/$0.50 USD) - 2021/07/30 17:58:43 ET
Table 'Gorgo III' 9-max Seat #6 is the button
Seat 1: ms1272 ($54.52 in chips) 
Seat 2: FeersPoker ($53.47 in chips) 
Seat 3: schmollhans ($32.01 in chips) 
Seat 4: nicu4you ($75.13 in chips) 
Seat 5: funker84 ($81.56 in chips) 
Seat 6: IsalieTBM ($39.62 in chips) 
Seat 7: Pablo1405 ($50 in chips) 
Seat 8: SENSAS1AN ($50 in chips) 
Seat 9: fragonik ($64.01 in chips) 
Pablo1405: posts small blind $0.25
SENSAS1AN: posts big blind $0.50
*** HOLE CARDS ***
fragonik: raises $1 to $1.50
ms1272: folds 
FeersPoker: folds 
schmollhans: folds 
nicu4you: folds 
funker84: folds 
IsalieTBM: folds 
Pablo1405: folds 
SENSAS1AN: calls $1
*** FLOP *** [6d 9s Ts]
SENSAS1AN: checks 
fragonik: checks 
*** TURN *** [6d 9s Ts] [8s]
SENSAS1AN: bets $2.06
fragonik: calls $2.06
*** RIVER *** [6d 9s Ts 8s] [3c]
SENSAS1AN: checks 
funker84 leaves the table
fragonik: bets $5.25
SENSAS1AN: folds 
Uncalled bet ($5.25) returned to fragonik
fragonik collected $7 from pot
*** SUMMARY ***
Total pot $7.37 | Rake $0.37 
Board [6d 9s Ts 8s 3c]
Seat 1: ms1272 folded before Flop (didn't bet)
Seat 2: FeersPoker folded before Flop (didn't bet)
Seat 3: schmollhans folded before Flop (didn't bet)
Seat 4: nicu4you folded before Flop (didn't bet)
Seat 5: funker84 folded before Flop (didn't bet)
Seat 6: IsalieTBM (button) folded before Flop (didn't bet)
Seat 7: Pablo1405 (small blind) folded before Flop
Seat 8: SENSAS1AN (big blind) folded on the River
Seat 9: fragonik collected ($7)



PokerStars Hand #228691030329:  Hold'em No Limit ($0.25/$0.50 USD) - 2021/07/30 17:59:22 ET
Table 'Gorgo III' 9-max Seat #7 is the button
Seat 1: ms1272 ($54.52 in chips) 
Seat 2: FeersPoker ($53.47 in chips) 
Seat 3: schmollhans ($32.01 in chips) 
Seat 4: nicu4you ($75.13 in chips) 
Seat 6: IsalieTBM ($39.62 in chips) 
Seat 7: Pablo1405 ($50 in chips) 
Seat 8: SENSAS1AN ($50 in chips) 
Seat 9: fragonik ($67.45 in chips) 
SENSAS1AN: posts small blind $0.25
fragonik: posts big blind $0.50
*** HOLE CARDS ***
ms1272: folds 
FeersPoker: folds 
Dragonclawss joins the table at seat #5 
schmollhans: folds 
nicu4you: folds 
IsalieTBM: raises $1 to $1.50
Pablo1405: folds 
SENSAS1AN: calls $1.25
fragonik: folds 
*** FLOP *** [Ad 2h 9d]
SENSAS1AN: bets $2.21
IsalieTBM: folds 
Uncalled bet ($2.21) returned to SENSAS1AN
SENSAS1AN collected $3.32 from pot
SENSAS1AN: doesn't show hand 
*** SUMMARY ***
Total pot $3.50 | Rake $0.18 
Board [Ad 2h 9d]
Seat 1: ms1272 folded before Flop (didn't bet)
Seat 2: FeersPoker folded before Flop (didn't bet)
Seat 3: schmollhans folded before Flop (didn't bet)
Seat 4: nicu4you folded before Flop (didn't bet)
Seat 6: IsalieTBM folded on the Flop
Seat 7: Pablo1405 (button) folded before Flop (didn't bet)
Seat 8: SENSAS1AN (small blind) collected ($3.32)
Seat 9: fragonik (big blind) folded before Flop



PokerStars Hand #228691041974:  Hold'em No Limit ($0.25/$0.50 USD) - 2021/07/30 17:59:58 ET
Table 'Gorgo III' 9-max Seat #8 is the button
Seat 1: ms1272 ($54.52 in chips) 
Seat 2: FeersPoker ($53.47 in chips) 
Seat 3: schmollhans ($32.01 in chips) 
Seat 4: nicu4you ($75.13 in chips) 
Seat 6: IsalieTBM ($38.12 in chips) 
Seat 7: Pablo1405 ($50 in chips) 
Seat 8: SENSAS1AN ($51.82 in chips) 
Seat 9: fragonik ($66.95 in chips) 
fragonik: posts small blind $0.25
ms1272: posts big blind $0.50
Dragonclawss: sits out 
*** HOLE CARDS ***
FeersPoker: folds 
schmollhans: raises $1 to $1.50
nicu4you: folds 
IsalieTBM: folds 
Pablo1405: folds 
SENSAS1AN: folds 
fragonik: folds 
ms1272: calls $1
*** FLOP *** [3d 5h 4c]
ms1272: checks 
schmollhans: bets $1.85
ms1272: folds 
Uncalled bet ($1.85) returned to schmollhans
schmollhans collected $3.05 from pot
schmollhans: doesn't show hand 
*** SUMMARY ***
Total pot $3.25 | Rake $0.20 
Board [3d 5h 4c]
Seat 1: ms1272 (big blind) folded on the Flop
Seat 2: FeersPoker folded before Flop (didn't bet)
Seat 3: schmollhans collected ($3.05)
Seat 4: nicu4you folded before Flop (didn't bet)
Seat 6: IsalieTBM folded before Flop (didn't bet)
Seat 7: Pablo1405 folded before Flop (didn't bet)
Seat 8: SENSAS1AN (button) folded before Flop (didn't bet)
Seat 9: fragonik (small blind) folded before Flop



PokerStars Hand #228691050060:  Hold'em No Limit ($0.25/$0.50 USD) - 2021/07/30 18:00:22 ET
Table 'Gorgo III' 9-max Seat #9 is the button
Seat 1: ms1272 ($53.02 in chips) 
Seat 2: FeersPoker ($53.47 in chips) 
Seat 3: schmollhans ($33.56 in chips) 
Seat 4: nicu4you ($75.13 in chips) 
Seat 6: IsalieTBM ($38.12 in chips) 
Seat 7: Pablo1405 ($50 in chips) 
Seat 8: SENSAS1AN ($51.82 in chips) 
Seat 9: fragonik ($66.70 in chips) 
ms1272: posts small blind $0.25
FeersPoker: posts big blind $0.50
Dragonclawss: sits out 
*** HOLE CARDS ***
schmollhans: folds 
nicu4you: raises $1 to $1.50
IsalieTBM: folds 
Pablo1405: folds 
SENSAS1AN: folds 
fragonik: folds 
ms1272: calls $1.25
FeersPoker: folds 
*** FLOP *** [6c Jc Qh]
ms1272: checks 
nicu4you: bets $2.66
ms1272: folds 
Uncalled bet ($2.66) returned to nicu4you
nicu4you collected $3.32 from pot
nicu4you: doesn't show hand 
*** SUMMARY ***
Total pot $3.50 | Rake $0.18 
Board [6c Jc Qh]
Seat 1: ms1272 (small blind) folded on the Flop
Seat 2: FeersPoker (big blind) folded before Flop
Seat 3: schmollhans folded before Flop (didn't bet)
Seat 4: nicu4you collected ($3.32)
Seat 6: IsalieTBM folded before Flop (didn't bet)
Seat 7: Pablo1405 folded before Flop (didn't bet)
Seat 8: SENSAS1AN folded before Flop (didn't bet)
Seat 9: fragonik (button) folded before Flop (didn't bet)



PokerStars Hand #228691060925:  Hold'em No Limit ($0.25/$0.50 USD) - 2021/07/30 18:00:52 ET
Table 'Gorgo III' 9-max Seat #1 is the button
Seat 1: ms1272 ($51.52 in chips) 
Seat 2: FeersPoker ($52.97 in chips) 
Seat 3: schmollhans ($33.56 in chips) 
Seat 4: nicu4you ($76.95 in chips) 
Seat 6: IsalieTBM ($38.12 in chips) 
Seat 7: Pablo1405 ($50 in chips) 
Seat 8: SENSAS1AN ($51.82 in chips) 
Seat 9: fragonik ($66.70 in chips) 
FeersPoker: posts small blind $0.25
schmollhans: posts big blind $0.50
Dragonclawss: sits out 
*** HOLE CARDS ***
nicu4you: folds 
IsalieTBM: folds 
Pablo1405: folds 
SENSAS1AN: folds 
fragonik: folds 
ms1272: raises $0.50 to $1
FeersPoker: folds 
schmollhans: calls $0.50
*** FLOP *** [7h 4c 6s]
schmollhans: checks 
ms1272: bets $1.07
schmollhans: calls $1.07
*** TURN *** [7h 4c 6s] [As]
schmollhans: checks 
ms1272: bets $2.08
schmollhans: folds 
Uncalled bet ($2.08) returned to ms1272
ms1272 collected $4.11 from pot
ms1272: doesn't show hand 
*** SUMMARY ***
Total pot $4.39 | Rake $0.28 
Board [7h 4c 6s As]
Seat 1: ms1272 (button) collected ($4.11)
Seat 2: FeersPoker (small blind) folded before Flop
Seat 3: schmollhans (big blind) folded on the Turn
Seat 4: nicu4you folded before Flop (didn't bet)
Seat 6: IsalieTBM folded before Flop (didn't bet)
Seat 7: Pablo1405 folded before Flop (didn't bet)
Seat 8: SENSAS1AN folded before Flop (didn't bet)
Seat 9: fragonik folded before Flop (didn't bet)



PokerStars Hand #228691075744:  Hold'em No Limit ($0.25/$0.50 USD) - 2021/07/30 18:01:29 ET
Table 'Gorgo III' 9-max Seat #2 is the button
Seat 1: ms1272 ($53.56 in chips) 
Seat 2: FeersPoker ($52.72 in chips) 
Seat 4: nicu4you ($76.95 in chips) 
Seat 5: Dragonclawss ($50 in chips) 
Seat 6: IsalieTBM ($38.12 in chips) 
Seat 7: Pablo1405 ($50 in chips) 
Seat 8: SENSAS1AN ($51.82 in chips) 
Seat 9: fragonik ($66.70 in chips) 
nicu4you: posts small blind $0.25
Dragonclawss: posts big blind $0.50
*** HOLE CARDS ***
schmollhans leaves the table
IsalieTBM: raises $1 to $1.50
Pablo1405: folds 
SENSAS1AN: folds 
fragonik: folds 
ms1272: folds 
FeersPoker: folds 
nicu4you: folds 
Dragonclawss: folds 
Uncalled bet ($1) returned to IsalieTBM
IsalieTBM collected $1.25 from pot
IsalieTBM: doesn't show hand 
*** SUMMARY ***
Total pot $1.25 | Rake $0 
Seat 1: ms1272 folded before Flop (didn't bet)
Seat 2: FeersPoker (button) folded before Flop (didn't bet)
Seat 4: nicu4you (small blind) folded before Flop
Seat 5: Dragonclawss (big blind) folded before Flop
Seat 6: IsalieTBM collected ($1.25)
Seat 7: Pablo1405 folded before Flop (didn't bet)
Seat 8: SENSAS1AN folded before Flop (didn't bet)
Seat 9: fragonik folded before Flop (didn't bet)



PokerStars Hand #228691081364:  Hold'em No Limit ($0.25/$0.50 USD) - 2021/07/30 18:01:43 ET
Table 'Gorgo III' 9-max Seat #4 is the button
Seat 1: ms1272 ($53.56 in chips) 
Seat 2: FeersPoker ($52.72 in chips) 
Seat 4: nicu4you ($76.70 in chips) 
Seat 5: Dragonclawss ($50 in chips) 
Seat 6: IsalieTBM ($38.87 in chips) 
Seat 7: Pablo1405 ($50 in chips) 
Seat 8: SENSAS1AN ($51.82 in chips) 
Seat 9: fragonik ($66.70 in chips) 
Dragonclawss: posts small blind $0.25
IsalieTBM: posts big blind $0.50
*** HOLE CARDS ***
Pablo1405: folds 
SENSAS1AN: folds 
fragonik: folds 
ms1272: folds 
FeersPoker: folds 
nicu4you: folds 
Dragonclawss: raises $1 to $1.50
IsalieTBM: folds 
Uncalled bet ($1) returned to Dragonclawss
Dragonclawss collected $1 from pot
Dragonclawss: doesn't show hand 
*** SUMMARY ***
Total pot $1 | Rake $0 
Seat 1: ms1272 folded before Flop (didn't bet)
Seat 2: FeersPoker folded before Flop (didn't bet)
Seat 4: nicu4you (button) folded before Flop (didn't bet)
Seat 5: Dragonclawss (small blind) collected ($1)
Seat 6: IsalieTBM (big blind) folded before Flop
Seat 7: Pablo1405 folded before Flop (didn't bet)
Seat 8: SENSAS1AN folded before Flop (didn't bet)
Seat 9: fragonik folded before Flop (didn't bet)



PokerStars Hand #228691090942:  Hold'em No Limit ($0.25/$0.50 USD) - 2021/07/30 18:02:06 ET
Table 'Gorgo III' 9-max Seat #5 is the button
Seat 1: ms1272 ($53.56 in chips) 
Seat 2: FeersPoker ($52.72 in chips) 
Seat 4: nicu4you ($76.70 in chips) 
Seat 5: Dragonclawss ($50.50 in chips) 
Seat 6: IsalieTBM ($38.37 in chips) 
Seat 7: Pablo1405 ($50 in chips) 
Seat 8: SENSAS1AN ($51.82 in chips) 
Seat 9: fragonik ($66.70 in chips) 
IsalieTBM: posts small blind $0.25
Pablo1405: posts big blind $0.50
*** HOLE CARDS ***
SENSAS1AN: folds 
fragonik has timed out
fragonik: folds 
ms1272: raises $0.50 to $1
FeersPoker: raises $3 to $4
nicu4you: calls $4
Dragonclawss: folds 
IsalieTBM: folds 
Pablo1405: folds 
ms1272: folds 
*** FLOP *** [5s 8c Qs]
FeersPoker: checks 
kastellani87 joins the table at seat #3 
nicu4you: bets $3.06
FeersPoker: folds 
Uncalled bet ($3.06) returned to nicu4you
nicu4you collected $9.26 from pot
nicu4you: doesn't show hand 
*** SUMMARY ***
Total pot $9.75 | Rake $0.49 
Board [5s 8c Qs]
Seat 1: ms1272 folded before Flop
Seat 2: FeersPoker folded on the Flop
Seat 4: nicu4you collected ($9.26)
Seat 5: Dragonclawss (button) folded before Flop (didn't bet)
Seat 6: IsalieTBM (small blind) folded before Flop
Seat 7: Pablo1405 (big blind) folded before Flop
Seat 8: SENSAS1AN folded before Flop (didn't bet)
Seat 9: fragonik folded before Flop (didn't bet)



PokerStars Hand #228691108347:  Hold'em No Limit ($0.25/$0.50 USD) - 2021/07/30 18:02:48 ET
Table 'Gorgo III' 9-max Seat #6 is the button
Seat 1: ms1272 ($52.56 in chips) 
Seat 2: FeersPoker ($50 in chips) 
Seat 3: kastellani87 ($50 in chips) 
Seat 4: nicu4you ($81.96 in chips) 
Seat 5: Dragonclawss ($50.50 in chips) 
Seat 6: IsalieTBM ($38.12 in chips) 
Seat 7: Pablo1405 ($50 in chips) 
Seat 8: SENSAS1AN ($51.82 in chips) 
Seat 9: fragonik ($66.70 in chips) 
Pablo1405: posts small blind $0.25
SENSAS1AN: posts big blind $0.50
kastellani87: posts big blind $0.50
*** HOLE CARDS ***
fragonik: folds 
ms1272: raises $0.50 to $1
FeersPoker: folds 
kastellani87: calls $0.50
nicu4you: folds 
Dragonclawss: calls $1
IsalieTBM: raises $3.25 to $4.25
Pablo1405: folds 
SENSAS1AN: folds 
ms1272: raises $11.25 to $15.50
kastellani87: folds 
Dragonclawss: folds 
IsalieTBM: calls $11.25
*** FLOP *** [4h 3d 9s]
ms1272: bets $32.06
IsalieTBM: calls $22.62 and is all-in
Uncalled bet ($9.44) returned to ms1272
*** TURN *** [4h 3d 9s] [7h]
*** RIVER *** [4h 3d 9s 7h] [Kd]
*** SHOW DOWN ***
ms1272: shows [Jd Jh] (a pair of Jacks)
IsalieTBM: shows [9d 5d] (a pair of Nines)
ms1272 cashed out the hand for $55.97 | Cash Out Fee $0.57
*** SUMMARY ***
Total pot $78.99 | Rake $2 
Board [4h 3d 9s 7h Kd]
Seat 1: ms1272 showed [Jd Jh] and won ($76.99) with a pair of Jacks (pot not awarded as player cashed out)
Seat 2: FeersPoker folded before Flop (didn't bet)
Seat 3: kastellani87 folded before Flop
Seat 4: nicu4you folded before Flop (didn't bet)
Seat 5: Dragonclawss folded before Flop
Seat 6: IsalieTBM (button) showed [9d 5d] and lost with a pair of Nines
Seat 7: Pablo1405 (small blind) folded before Flop
Seat 8: SENSAS1AN (big blind) folded before Flop
Seat 9: fragonik folded before Flop (didn't bet)



PokerStars Hand #228691138342:  Hold'em No Limit ($0.25/$0.50 USD) - 2021/07/30 18:03:58 ET
Table 'Gorgo III' 9-max Seat #7 is the button
Seat 1: ms1272 ($70.41 in chips) 
Seat 2: FeersPoker ($50 in chips) 
Seat 3: kastellani87 ($49 in chips) 
Seat 4: nicu4you ($81.96 in chips) 
Seat 5: Dragonclawss ($50 in chips) 
Seat 7: Pablo1405 ($50 in chips) 
Seat 8: SENSAS1AN ($51.32 in chips) 
Seat 9: fragonik ($66.70 in chips) 
SENSAS1AN: posts small blind $0.25
fragonik: posts big blind $0.50
*** HOLE CARDS ***
ms1272: folds 
FeersPoker: folds 
kastellani87: folds 
nicu4you: folds 
Dragonclawss: folds 
Pablo1405: raises $0.75 to $1.25
IsalieTBM leaves the table
StudentRB joins the table at seat #6 
SENSAS1AN: folds 
fragonik: calls $0.75
*** FLOP *** [Jd 9c Kd]
fragonik: checks 
Pablo1405: checks 
*** TURN *** [Jd 9c Kd] [Td]
fragonik: checks 
Pablo1405: bets $0.91
fragonik: folds 
Uncalled bet ($0.91) returned to Pablo1405
Pablo1405 collected $2.61 from pot
Pablo1405: doesn't show hand 
*** SUMMARY ***
Total pot $2.75 | Rake $0.14 
Board [Jd 9c Kd Td]
Seat 1: ms1272 folded before Flop (didn't bet)
Seat 2: FeersPoker folded before Flop (didn't bet)
Seat 3: kastellani87 folded before Flop (didn't bet)
Seat 4: nicu4you folded before Flop (didn't bet)
Seat 5: Dragonclawss folded before Flop (didn't bet)
Seat 7: Pablo1405 (button) collected ($2.61)
Seat 8: SENSAS1AN (small blind) folded before Flop
Seat 9: fragonik (big blind) folded on the Turn



PokerStars Hand #228691164049:  Hold'em No Limit ($0.25/$0.50 USD) - 2021/07/30 18:04:59 ET
Table 'Gorgo III' 9-max Seat #8 is the button
Seat 1: ms1272 ($70.41 in chips) 
Seat 2: FeersPoker ($50 in chips) 
Seat 3: kastellani87 ($49 in chips) 
Seat 4: nicu4you ($81.96 in chips) 
Seat 5: Dragonclawss ($50 in chips) 
Seat 7: Pablo1405 ($51.36 in chips) 
Seat 8: SENSAS1AN ($51.07 in chips) 
Seat 9: fragonik ($65.45 in chips) 
fragonik: posts small blind $0.25
ms1272: posts big blind $0.50
StudentRB: sits out 
*** HOLE CARDS ***
FeersPoker: folds 
kastellani87: calls $0.50
nicu4you: folds 
Dragonclawss: raises $2 to $2.50
Pablo1405: folds 
SENSAS1AN: folds 
fragonik: folds 
ms1272: folds 
kastellani87: folds 
Uncalled bet ($2) returned to Dragonclawss
Dragonclawss collected $1.75 from pot
Dragonclawss: doesn't show hand 
*** SUMMARY ***
Total pot $1.75 | Rake $0 
Seat 1: ms1272 (big blind) folded before Flop
Seat 2: FeersPoker folded before Flop (didn't bet)
Seat 3: kastellani87 folded before Flop
Seat 4: nicu4you folded before Flop (didn't bet)
Seat 5: Dragonclawss collected ($1.75)
Seat 7: Pablo1405 folded before Flop (didn't bet)
Seat 8: SENSAS1AN (button) folded before Flop (didn't bet)
Seat 9: fragonik (small blind) folded before Flop



PokerStars Hand #228691180933:  Hold'em No Limit ($0.25/$0.50 USD) - 2021/07/30 18:05:39 ET
Table 'Gorgo III' 9-max Seat #9 is the button
Seat 1: ms1272 ($69.91 in chips) 
Seat 2: FeersPoker ($50 in chips) 
Seat 3: kastellani87 ($48.50 in chips) 
Seat 4: nicu4you ($81.96 in chips) 
Seat 5: Dragonclawss ($51.25 in chips) 
Seat 7: Pablo1405 ($51.36 in chips) 
Seat 8: SENSAS1AN ($51.07 in chips) 
Seat 9: fragonik ($65.20 in chips) 
ms1272: posts small blind $0.25
FeersPoker: posts big blind $0.50
StudentRB: sits out 
*** HOLE CARDS ***
kastellani87: folds 
nicu4you: folds 
Dragonclawss: folds 
Pablo1405: folds 
SENSAS1AN: folds 
fragonik: folds 
ms1272: raises $0.50 to $1
FeersPoker: calls $0.50
*** FLOP *** [3c 7d Ad]
ms1272: bets $0.95
FeersPoker: raises $2.05 to $3
ms1272: folds 
Uncalled bet ($2.05) returned to FeersPoker
FeersPoker collected $3.70 from pot
FeersPoker: doesn't show hand 
*** SUMMARY ***
Total pot $3.90 | Rake $0.20 
Board [3c 7d Ad]
Seat 1: ms1272 (small blind) folded on the Flop
Seat 2: FeersPoker (big blind) collected ($3.70)
Seat 3: kastellani87 folded before Flop (didn't bet)
Seat 4: nicu4you folded before Flop (didn't bet)
Seat 5: Dragonclawss folded before Flop (didn't bet)
Seat 7: Pablo1405 folded before Flop (didn't bet)
Seat 8: SENSAS1AN folded before Flop (didn't bet)
Seat 9: fragonik (button) folded before Flop (didn't bet)



PokerStars Hand #228691192702:  Hold'em No Limit ($0.25/$0.50 USD) - 2021/07/30 18:06:07 ET
Table 'Gorgo III' 9-max Seat #1 is the button
Seat 1: ms1272 ($67.96 in chips) 
Seat 2: FeersPoker ($51.75 in chips) 
Seat 3: kastellani87 ($48.50 in chips) 
Seat 4: nicu4you ($81.96 in chips) 
Seat 5: Dragonclawss ($51.25 in chips) 
Seat 7: Pablo1405 ($51.36 in chips) 
Seat 8: SENSAS1AN ($51.07 in chips) 
Seat 9: fragonik ($65.20 in chips) 
FeersPoker: posts small blind $0.25
kastellani87: posts big blind $0.50
StudentRB: sits out 
*** HOLE CARDS ***
nicu4you: folds 
Dragonclawss: folds 
Pablo1405: folds 
nicu4you leaves the table
SENSAS1AN: raises $0.75 to $1.25
wscrewey joins the table at seat #4 
fragonik: raises $2.50 to $3.75
ms1272: raises $9.50 to $13.25
FeersPoker: folds 
kastellani87: calls $12.75
SENSAS1AN: folds 
fragonik: folds 
*** FLOP *** [Qh 9d 5h]
kastellani87: bets $35.25 and is all-in
ms1272: calls $35.25
*** TURN *** [Qh 9d 5h] [8s]
*** RIVER *** [Qh 9d 5h 8s] [6c]
*** SHOW DOWN ***
kastellani87: shows [Qs Ac] (a pair of Queens)
ms1272: shows [Kc Kh] (a pair of Kings)
ms1272 cashed out the hand for $80.09 | Cash Out Fee $0.81
*** SUMMARY ***
Total pot $102.25 | Rake $2 
Board [Qh 9d 5h 8s 6c]
Seat 1: ms1272 (button) showed [Kc Kh] and won ($100.25) with a pair of Kings (pot not awarded as player cashed out)
Seat 2: FeersPoker (small blind) folded before Flop
Seat 3: kastellani87 (big blind) showed [Qs Ac] and lost with a pair of Queens
Seat 4: nicu4you folded before Flop (didn't bet)
Seat 5: Dragonclawss folded before Flop (didn't bet)
Seat 7: Pablo1405 folded before Flop (didn't bet)
Seat 8: SENSAS1AN folded before Flop
Seat 9: fragonik folded before Flop



PokerStars Hand #228691217856:  Hold'em No Limit ($0.25/$0.50 USD) - 2021/07/30 18:07:06 ET
Table 'Gorgo III' 9-max Seat #2 is the button
Seat 1: ms1272 ($99.55 in chips) 
Seat 2: FeersPoker ($51.50 in chips) 
Seat 5: Dragonclawss ($51.25 in chips) 
Seat 6: StudentRB ($50 in chips) 
Seat 7: Pablo1405 ($51.36 in chips) 
Seat 8: SENSAS1AN ($50 in chips) 
Seat 9: fragonik ($61.45 in chips) 
Dragonclawss: posts small blind $0.25
StudentRB: posts big blind $0.50
*** HOLE CARDS ***
Pablo1405: folds 
SENSAS1AN: folds 
fragonik: folds 
ms1272: raises $0.50 to $1
FeersPoker: folds 
Dragonclawss: calls $0.75
StudentRB: raises $5 to $6
ms1272: folds 
Dragonclawss: folds 
Uncalled bet ($5) returned to StudentRB
StudentRB collected $3 from pot
StudentRB: doesn't show hand 
*** SUMMARY ***
Total pot $3 | Rake $0 
Seat 1: ms1272 folded before Flop
Seat 2: FeersPoker (button) folded before Flop (didn't bet)
Seat 5: Dragonclawss (small blind) folded before Flop
Seat 6: StudentRB (big blind) collected ($3)
Seat 7: Pablo1405 folded before Flop (didn't bet)
Seat 8: SENSAS1AN folded before Flop (didn't bet)
Seat 9: fragonik folded before Flop (didn't bet)



PokerStars Hand #228691226659:  Hold'em No Limit ($0.25/$0.50 USD) - 2021/07/30 18:07:27 ET
Table 'Gorgo III' 9-max Seat #5 is the button
Seat 1: ms1272 ($98.55 in chips) 
Seat 2: FeersPoker ($51.50 in chips) 
Seat 5: Dragonclawss ($50.25 in chips) 
Seat 6: StudentRB ($52 in chips) 
Seat 7: Pablo1405 ($51.36 in chips) 
Seat 8: SENSAS1AN ($50 in chips) 
Seat 9: fragonik ($61.45 in chips) 
StudentRB: posts small blind $0.25
Pablo1405: posts big blind $0.50
wscrewey: sits out 
*** HOLE CARDS ***
SENSAS1AN: folds 
fragonik: folds 
ms1272: folds 
wscrewey leaves the table
rasku91 joins the table at seat #4 
FeersPoker: folds 
Dragonclawss: folds 
StudentRB: raises $1 to $1.50
Pablo1405: folds 
Uncalled bet ($1) returned to StudentRB
StudentRB collected $1 from pot
StudentRB: doesn't show hand 
*** SUMMARY ***
Total pot $1 | Rake $0 
Seat 1: ms1272 folded before Flop (didn't bet)
Seat 2: FeersPoker folded before Flop (didn't bet)
Seat 5: Dragonclawss (button) folded before Flop (didn't bet)
Seat 6: StudentRB (small blind) collected ($1)
Seat 7: Pablo1405 (big blind) folded before Flop
Seat 8: SENSAS1AN folded before Flop (didn't bet)
Seat 9: fragonik folded before Flop (didn't bet)



PokerStars Hand #228691247682:  Hold'em No Limit ($0.25/$0.50 USD) - 2021/07/30 18:07:59 ET
Table 'Gorgo III' 9-max Seat #6 is the button
Seat 1: ms1272 ($98.55 in chips) 
Seat 2: FeersPoker ($51.50 in chips) 
Seat 5: Dragonclawss ($50.25 in chips) 
Seat 6: StudentRB ($52.50 in chips) 
Seat 7: Pablo1405 ($50.86 in chips) 
Seat 8: SENSAS1AN ($50 in chips) 
Seat 9: fragonik ($61.45 in chips) 
Pablo1405: posts small blind $0.25
SENSAS1AN: posts big blind $0.50
rasku91: sits out 
*** HOLE CARDS ***
fragonik: raises $1 to $1.50
ms1272: folds 
FeersPoker: folds 
Dragonclawss: folds 
StudentRB: folds 
Pablo1405: folds 
SENSAS1AN: folds 
Uncalled bet ($1) returned to fragonik
fragonik collected $1.25 from pot
*** SUMMARY ***
Total pot $1.25 | Rake $0 
Seat 1: ms1272 folded before Flop (didn't bet)
Seat 2: FeersPoker folded before Flop (didn't bet)
Seat 5: Dragonclawss folded before Flop (didn't bet)
Seat 6: StudentRB (button) folded before Flop (didn't bet)
Seat 7: Pablo1405 (small blind) folded before Flop
Seat 8: SENSAS1AN (big blind) folded before Flop
Seat 9: fragonik collected ($1.25)



PokerStars Hand #228691252593:  Hold'em No Limit ($0.25/$0.50 USD) - 2021/07/30 18:08:11 ET
Table 'Gorgo III' 9-max Seat #7 is the button
Seat 1: ms1272 ($98.55 in chips) 
Seat 2: FeersPoker ($51.50 in chips) 
Seat 5: Dragonclawss ($50.25 in chips) 
Seat 6: StudentRB ($52.50 in chips) 
Seat 7: Pablo1405 ($50.61 in chips) 
Seat 8: SENSAS1AN ($50 in chips) 
Seat 9: fragonik ($62.20 in chips) 
SENSAS1AN: posts small blind $0.25
fragonik: posts big blind $0.50
rasku91: sits out 
*** HOLE CARDS ***
ms1272: folds 
FeersPoker: folds 
Dragonclawss: folds 
StudentRB: folds 
Pablo1405: raises $0.75 to $1.25
SENSAS1AN: folds 
fragonik: calls $0.75
*** FLOP *** [4c Jd Tc]
fragonik: checks 
Pablo1405: bets $0.91
fragonik: folds 
Uncalled bet ($0.91) returned to Pablo1405
Pablo1405 collected $2.61 from pot
Pablo1405: doesn't show hand 
*** SUMMARY ***
Total pot $2.75 | Rake $0.14 
Board [4c Jd Tc]
Seat 1: ms1272 folded before Flop (didn't bet)
Seat 2: FeersPoker folded before Flop (didn't bet)
Seat 5: Dragonclawss folded before Flop (didn't bet)
Seat 6: StudentRB folded before Flop (didn't bet)
Seat 7: Pablo1405 (button) collected ($2.61)
Seat 8: SENSAS1AN (small blind) folded before Flop
Seat 9: fragonik (big blind) folded on the Flop



PokerStars Hand #228691264881:  Hold'em No Limit ($0.25/$0.50 USD) - 2021/07/30 18:08:40 ET
Table 'Gorgo III' 9-max Seat #8 is the button
Seat 1: ms1272 ($98.55 in chips) 
Seat 2: FeersPoker ($51.50 in chips) 
Seat 5: Dragonclawss ($50.25 in chips) 
Seat 6: StudentRB ($52.50 in chips) 
Seat 7: Pablo1405 ($51.97 in chips) 
Seat 8: SENSAS1AN ($50 in chips) 
Seat 9: fragonik ($60.95 in chips) 
fragonik: posts small blind $0.25
ms1272: posts big blind $0.50
kastellani87: sits out 
rasku91: sits out 
*** HOLE CARDS ***
FeersPoker: raises $0.75 to $1.25
Dragonclawss: folds 
StudentRB: folds 
Pablo1405: folds 
SENSAS1AN: folds 
fragonik: folds 
ms1272: calls $0.75
*** FLOP *** [Jh Ac 7d]
ms1272: checks 
FeersPoker: checks 
*** TURN *** [Jh Ac 7d] [5s]
ms1272: checks 
FeersPoker: checks 
*** RIVER *** [Jh Ac 7d 5s] [Ks]
ms1272: checks 
FeersPoker: checks 
*** SHOW DOWN ***
ms1272: shows [5d 4h] (a pair of Fives)
FeersPoker: shows [Qc Qd] (a pair of Queens)
FeersPoker collected $2.61 from pot
*** SUMMARY ***
Total pot $2.75 | Rake $0.14 
Board [Jh Ac 7d 5s Ks]
Seat 1: ms1272 (big blind) showed [5d 4h] and lost with a pair of Fives
Seat 2: FeersPoker showed [Qc Qd] and won ($2.61) with a pair of Queens
Seat 5: Dragonclawss folded before Flop (didn't bet)
Seat 6: StudentRB folded before Flop (didn't bet)
Seat 7: Pablo1405 folded before Flop (didn't bet)
Seat 8: SENSAS1AN (button) folded before Flop (didn't bet)
Seat 9: fragonik (small blind) folded before Flop



PokerStars Hand #228691288860:  Hold'em No Limit ($0.25/$0.50 USD) - 2021/07/30 18:09:37 ET
Table 'Gorgo III' 9-max Seat #9 is the button
Seat 1: ms1272 ($97.30 in chips) 
Seat 2: FeersPoker ($52.86 in chips) 
Seat 5: Dragonclawss ($50.25 in chips) 
Seat 6: StudentRB ($52.50 in chips) 
Seat 7: Pablo1405 ($51.97 in chips) 
Seat 8: SENSAS1AN ($50 in chips) 
Seat 9: fragonik ($60.70 in chips) 
ms1272: posts small blind $0.25
FeersPoker: posts big blind $0.50
kastellani87: sits out 
rasku91: sits out 
*** HOLE CARDS ***
Dragonclawss: raises $1 to $1.50
StudentRB: folds 
Pablo1405: folds 
SENSAS1AN: folds 
fragonik: folds 
ms1272: folds 
FeersPoker: folds 
Uncalled bet ($1) returned to Dragonclawss
Dragonclawss collected $1.25 from pot
Dragonclawss: doesn't show hand 
*** SUMMARY ***
Total pot $1.25 | Rake $0 
Seat 1: ms1272 (small blind) folded before Flop
Seat 2: FeersPoker (big blind) folded before Flop
Seat 5: Dragonclawss collected ($1.25)
Seat 6: StudentRB folded before Flop (didn't bet)
Seat 7: Pablo1405 folded before Flop (didn't bet)
Seat 8: SENSAS1AN folded before Flop (didn't bet)
Seat 9: fragonik (button) folded before Flop (didn't bet)



PokerStars Hand #228691293603:  Hold'em No Limit ($0.25/$0.50 USD) - 2021/07/30 18:09:49 ET
Table 'Gorgo III' 9-max Seat #1 is the button
Seat 1: ms1272 ($97.05 in chips) 
Seat 2: FeersPoker ($52.36 in chips) 
Seat 3: kastellani87 ($50 in chips) 
Seat 5: Dragonclawss ($51 in chips) 
Seat 6: StudentRB ($52.50 in chips) 
Seat 7: Pablo1405 ($51.97 in chips) 
Seat 8: SENSAS1AN ($50 in chips) 
Seat 9: fragonik ($60.70 in chips) 
FeersPoker: posts small blind $0.25
kastellani87: posts big blind $0.50
rasku91: sits out 
*** HOLE CARDS ***
Dragonclawss: folds 
StudentRB: raises $0.50 to $1
Pablo1405: folds 
SENSAS1AN: folds 
fragonik: folds 
ms1272: folds 
FeersPoker: folds 
kastellani87: raises $0.50 to $1.50
StudentRB: calls $0.50
*** FLOP *** [6d 5h 2h]
kastellani87: bets $3.09
StudentRB: folds 
Uncalled bet ($3.09) returned to kastellani87
kastellani87 collected $3.09 from pot
kastellani87: doesn't show hand 
*** SUMMARY ***
Total pot $3.25 | Rake $0.16 
Board [6d 5h 2h]
Seat 1: ms1272 (button) folded before Flop (didn't bet)
Seat 2: FeersPoker (small blind) folded before Flop
Seat 3: kastellani87 (big blind) collected ($3.09)
Seat 5: Dragonclawss folded before Flop (didn't bet)
Seat 6: StudentRB folded on the Flop
Seat 7: Pablo1405 folded before Flop (didn't bet)
Seat 8: SENSAS1AN folded before Flop (didn't bet)
Seat 9: fragonik folded before Flop (didn't bet)



PokerStars Hand #228691304471:  Hold'em No Limit ($0.25/$0.50 USD) - 2021/07/30 18:10:15 ET
Table 'Gorgo III' 9-max Seat #2 is the button
Seat 1: ms1272 ($97.05 in chips) 
Seat 2: FeersPoker ($52.11 in chips) 
Seat 3: kastellani87 ($51.59 in chips) 
Seat 4: rasku91 ($27.53 in chips) 
Seat 5: Dragonclawss ($51 in chips) 
Seat 6: StudentRB ($51 in chips) 
Seat 7: Pablo1405 ($51.97 in chips) 
Seat 8: SENSAS1AN ($50 in chips) 
Seat 9: fragonik ($60.70 in chips) 
kastellani87: posts small blind $0.25
rasku91: posts big blind $0.50
*** HOLE CARDS ***
Dragonclawss: folds 
StudentRB: raises $0.75 to $1.25
Pablo1405: folds 
SENSAS1AN: folds 
fragonik has timed out
fragonik: folds 
ms1272: folds 
FeersPoker: folds 
kastellani87: folds 
rasku91: folds 
Uncalled bet ($0.75) returned to StudentRB
StudentRB collected $1.25 from pot
StudentRB: doesn't show hand 
*** SUMMARY ***
Total pot $1.25 | Rake $0 
Seat 1: ms1272 folded before Flop (didn't bet)
Seat 2: FeersPoker (button) folded before Flop (didn't bet)
Seat 3: kastellani87 (small blind) folded before Flop
Seat 4: rasku91 (big blind) folded before Flop
Seat 5: Dragonclawss folded before Flop (didn't bet)
Seat 6: StudentRB collected ($1.25)
Seat 7: Pablo1405 folded before Flop (didn't bet)
Seat 8: SENSAS1AN folded before Flop (didn't bet)
Seat 9: fragonik folded before Flop (didn't bet)



PokerStars Hand #228691321005:  Hold'em No Limit ($0.25/$0.50 USD) - 2021/07/30 18:10:55 ET
Table 'Gorgo III' 9-max Seat #3 is the button
Seat 1: ms1272 ($97.05 in chips) 
Seat 3: kastellani87 ($51.34 in chips) 
Seat 4: rasku91 ($27.03 in chips) 
Seat 6: StudentRB ($51.75 in chips) 
Seat 7: Pablo1405 ($51.97 in chips) 
Seat 8: SENSAS1AN ($50 in chips) 
rasku91: posts small blind $0.25
Dragonclawss: is sitting out 
StudentRB: posts big blind $0.50
*** HOLE CARDS ***
Dragonclawss leaves the table
Pablo1405: folds 
SENSAS1AN: folds 
3DMINSK joins the table at seat #5 
ms1272: raises $0.50 to $1
kastellani87: calls $1
rasku91: raises $0.50 to $1.50
StudentRB: folds 
ms1272: calls $0.50
kastellani87: calls $0.50
*** FLOP *** [8s 3h 2s]
rasku91: bets $1
ms1272: calls $1
kastellani87: calls $1
*** TURN *** [8s 3h 2s] [Kc]
rasku91: bets $2
ms1272: folds 
kastellani87: folds 
Uncalled bet ($2) returned to rasku91
rasku91 collected $7.60 from pot
rasku91: doesn't show hand 
*** SUMMARY ***
Total pot $8 | Rake $0.40 
Board [8s 3h 2s Kc]
Seat 1: ms1272 folded on the Turn
Seat 3: kastellani87 (button) folded on the Turn
Seat 4: rasku91 (small blind) collected ($7.60)
Seat 6: StudentRB (big blind) folded before Flop
Seat 7: Pablo1405 folded before Flop (didn't bet)
Seat 8: SENSAS1AN folded before Flop (didn't bet)



PokerStars Hand #228691345010:  Hold'em No Limit ($0.25/$0.50 USD) - 2021/07/30 18:11:53 ET
Table 'Gorgo III' 9-max Seat #4 is the button
Seat 1: ms1272 ($94.55 in chips) 
Seat 3: kastellani87 ($48.84 in chips) 
Seat 4: rasku91 ($32.13 in chips) 
Seat 6: StudentRB ($51.25 in chips) 
Seat 7: Pablo1405 ($51.97 in chips) 
Seat 8: SENSAS1AN ($50 in chips) 
StudentRB: posts small blind $0.25
Pablo1405: posts big blind $0.50
*** HOLE CARDS ***
SENSAS1AN: folds 
ms1272: folds 
kastellani87: calls $0.50
rasku91: folds 
StudentRB: calls $0.25
Pablo1405: checks 
*** FLOP *** [Ks Qd 9s]
StudentRB: checks 
Pablo1405: checks 
kastellani87: bets $0.71
StudentRB: calls $0.71
Pablo1405: folds 
*** TURN *** [Ks Qd 9s] [2c]
StudentRB: checks 
kastellani87: bets $1.39
StudentRB: calls $1.39
*** RIVER *** [Ks Qd 9s 2c] [Td]
StudentRB: checks 
kastellani87: bets $5.42
StudentRB: folds 
Uncalled bet ($5.42) returned to kastellani87
kastellani87 collected $5.42 from pot
kastellani87: doesn't show hand 
*** SUMMARY ***
Total pot $5.70 | Rake $0.28 
Board [Ks Qd 9s 2c Td]
Seat 1: ms1272 folded before Flop (didn't bet)
Seat 3: kastellani87 collected ($5.42)
Seat 4: rasku91 (button) folded before Flop (didn't bet)
Seat 6: StudentRB (small blind) folded on the River
Seat 7: Pablo1405 (big blind) folded on the Flop
Seat 8: SENSAS1AN folded before Flop (didn't bet)



PokerStars Hand #228691367965:  Hold'em No Limit ($0.25/$0.50 USD) - 2021/07/30 18:12:49 ET
Table 'Gorgo III' 9-max Seat #6 is the button
Seat 1: ms1272 ($94.55 in chips) 
Seat 2: FeersPoker ($52.11 in chips) 
Seat 3: kastellani87 ($51.66 in chips) 
Seat 4: rasku91 ($32.13 in chips) 
Seat 6: StudentRB ($50 in chips) 
Seat 7: Pablo1405 ($51.47 in chips) 
Seat 8: SENSAS1AN ($50 in chips) 
Seat 9: fragonik ($60.70 in chips) 
Pablo1405: posts small blind $0.25
SENSAS1AN: posts big blind $0.50
3DMINSK: sits out 
*** HOLE CARDS ***
fragonik: folds 
ms1272: folds 
FeersPoker: folds 
kastellani87: calls $0.50
rasku91: raises $1 to $1.50
StudentRB: folds 
Pablo1405: raises $4.50 to $6
SENSAS1AN: folds 
kastellani87: folds 
rasku91: calls $4.50
*** FLOP *** [Qd 7c Ad]
Pablo1405: checks 
rasku91: bets $4.50
Pablo1405: folds 
Uncalled bet ($4.50) returned to rasku91
rasku91 collected $12.35 from pot
rasku91: doesn't show hand 
*** SUMMARY ***
Total pot $13 | Rake $0.65 
Board [Qd 7c Ad]
Seat 1: ms1272 folded before Flop (didn't bet)
Seat 2: FeersPoker folded before Flop (didn't bet)
Seat 3: kastellani87 folded before Flop
Seat 4: rasku91 collected ($12.35)
Seat 6: StudentRB (button) folded before Flop (didn't bet)
Seat 7: Pablo1405 (small blind) folded on the Flop
Seat 8: SENSAS1AN (big blind) folded before Flop
Seat 9: fragonik folded before Flop (didn't bet)



PokerStars Hand #228691393911:  Hold'em No Limit ($0.25/$0.50 USD) - 2021/07/30 18:13:52 ET
Table 'Gorgo III' 9-max Seat #7 is the button
Seat 1: ms1272 ($94.55 in chips) 
Seat 2: FeersPoker ($52.11 in chips) 
Seat 3: kastellani87 ($51.16 in chips) 
Seat 4: rasku91 ($38.48 in chips) 
Seat 6: StudentRB ($50 in chips) 
Seat 7: Pablo1405 ($50 in chips) 
Seat 8: SENSAS1AN ($50 in chips) 
Seat 9: fragonik ($60.70 in chips) 
SENSAS1AN: posts small blind $0.25
fragonik: posts big blind $0.50
3DMINSK: sits out 
*** HOLE CARDS ***
ms1272: folds 
FeersPoker: folds 
kastellani87: calls $0.50
rasku91: folds 
StudentRB: raises $1.50 to $2
Pablo1405: folds 
SENSAS1AN: folds 
fragonik: folds 
kastellani87: folds 
Uncalled bet ($1.50) returned to StudentRB
StudentRB collected $1.75 from pot
StudentRB: doesn't show hand 
*** SUMMARY ***
Total pot $1.75 | Rake $0 
Seat 1: ms1272 folded before Flop (didn't bet)
Seat 2: FeersPoker folded before Flop (didn't bet)
Seat 3: kastellani87 folded before Flop
Seat 4: rasku91 folded before Flop (didn't bet)
Seat 6: StudentRB collected ($1.75)
Seat 7: Pablo1405 (button) folded before Flop (didn't bet)
Seat 8: SENSAS1AN (small blind) folded before Flop
Seat 9: fragonik (big blind) folded before Flop



PokerStars Hand #228691411295:  Hold'em No Limit ($0.25/$0.50 USD) - 2021/07/30 18:14:35 ET
Table 'Gorgo III' 9-max Seat #8 is the button
Seat 1: ms1272 ($94.55 in chips) 
Seat 2: FeersPoker ($52.11 in chips) 
Seat 3: kastellani87 ($50.66 in chips) 
Seat 4: rasku91 ($38.48 in chips) 
Seat 6: StudentRB ($51.25 in chips) 
Seat 7: Pablo1405 ($50 in chips) 
Seat 8: SENSAS1AN ($50 in chips) 
Seat 9: fragonik ($60.20 in chips) 
fragonik: posts small blind $0.25
ms1272: posts big blind $0.50
3DMINSK: sits out 
*** HOLE CARDS ***
FeersPoker: folds 
kastellani87: calls $0.50
rasku91: folds 
StudentRB: folds 
Pablo1405: folds 
SENSAS1AN: folds 
fragonik: folds 
ms1272: checks 
*** FLOP *** [8c 9d 3d]
ms1272: checks 
kastellani87: checks 
*** TURN *** [8c 9d 3d] [Kd]
ms1272: checks 
kastellani87: bets $0.60
ms1272: calls $0.60
*** RIVER *** [8c 9d 3d Kd] [6d]
ms1272: checks 
kastellani87: bets $20.50
ms1272: folds 
Uncalled bet ($20.50) returned to kastellani87
kastellani87 collected $2.33 from pot
kastellani87: doesn't show hand 
*** SUMMARY ***
Total pot $2.45 | Rake $0.12 
Board [8c 9d 3d Kd 6d]
Seat 1: ms1272 (big blind) folded on the River
Seat 2: FeersPoker folded before Flop (didn't bet)
Seat 3: kastellani87 collected ($2.33)
Seat 4: rasku91 folded before Flop (didn't bet)
Seat 6: StudentRB folded before Flop (didn't bet)
Seat 7: Pablo1405 folded before Flop (didn't bet)
Seat 8: SENSAS1AN (button) folded before Flop (didn't bet)
Seat 9: fragonik (small blind) folded before Flop



PokerStars Hand #228691432864:  Hold'em No Limit ($0.25/$0.50 USD) - 2021/07/30 18:15:27 ET
Table 'Gorgo III' 9-max Seat #9 is the button
Seat 1: ms1272 ($93.45 in chips) 
Seat 2: FeersPoker ($52.11 in chips) 
Seat 3: kastellani87 ($51.89 in chips) 
Seat 4: rasku91 ($38.48 in chips) 
Seat 6: StudentRB ($51.25 in chips) 
Seat 7: Pablo1405 ($50 in chips) 
Seat 8: SENSAS1AN ($50 in chips) 
Seat 9: fragonik ($59.95 in chips) 
ms1272: posts small blind $0.25
FeersPoker: posts big blind $0.50
3DMINSK: sits out 
*** HOLE CARDS ***
kastellani87: folds 
rasku91: raises $0.50 to $1
StudentRB: folds 
Pablo1405: folds 
SENSAS1AN: folds 
fragonik: folds 
ms1272: calls $0.75
FeersPoker: calls $0.50
*** FLOP *** [6c 4h 2s]
ms1272: checks 
FeersPoker: checks 
rasku91: bets $1.43
ms1272: folds 
FeersPoker: folds 
Uncalled bet ($1.43) returned to rasku91
rasku91 collected $2.85 from pot
rasku91: doesn't show hand 
*** SUMMARY ***
Total pot $3 | Rake $0.15 
Board [6c 4h 2s]
Seat 1: ms1272 (small blind) folded on the Flop
Seat 2: FeersPoker (big blind) folded on the Flop
Seat 3: kastellani87 folded before Flop (didn't bet)
Seat 4: rasku91 collected ($2.85)
Seat 6: StudentRB folded before Flop (didn't bet)
Seat 7: Pablo1405 folded before Flop (didn't bet)
Seat 8: SENSAS1AN folded before Flop (didn't bet)
Seat 9: fragonik (button) folded before Flop (didn't bet)



PokerStars Hand #228691448337:  Hold'em No Limit ($0.25/$0.50 USD) - 2021/07/30 18:16:05 ET
Table 'Gorgo III' 9-max Seat #1 is the button
Seat 1: ms1272 ($92.45 in chips) 
Seat 2: FeersPoker ($51.11 in chips) 
Seat 3: kastellani87 ($51.89 in chips) 
Seat 4: rasku91 ($40.33 in chips) 
Seat 6: StudentRB ($51.25 in chips) 
Seat 7: Pablo1405 ($50 in chips) 
Seat 8: SENSAS1AN ($50 in chips) 
Seat 9: fragonik ($59.95 in chips) 
FeersPoker: posts small blind $0.25
kastellani87: posts big blind $0.50
3DMINSK: sits out 
*** HOLE CARDS ***
rasku91 has timed out
rasku91: folds 
StudentRB: folds 
Pablo1405: folds 
SENSAS1AN: folds 
fragonik: raises $0.75 to $1.25
ms1272: folds 
FeersPoker: folds 
kastellani87: raises $2.75 to $4
fragonik: folds 
Uncalled bet ($2.75) returned to kastellani87
kastellani87 collected $2.75 from pot
kastellani87: doesn't show hand 
*** SUMMARY ***
Total pot $2.75 | Rake $0 
Seat 1: ms1272 (button) folded before Flop (didn't bet)
Seat 2: FeersPoker (small blind) folded before Flop
Seat 3: kastellani87 (big blind) collected ($2.75)
Seat 4: rasku91 folded before Flop (didn't bet)
Seat 6: StudentRB folded before Flop (didn't bet)
Seat 7: Pablo1405 folded before Flop (didn't bet)
Seat 8: SENSAS1AN folded before Flop (didn't bet)
Seat 9: fragonik folded before Flop



PokerStars Hand #228691464853:  Hold'em No Limit ($0.25/$0.50 USD) - 2021/07/30 18:16:46 ET
Table 'Gorgo III' 9-max Seat #2 is the button
Seat 1: ms1272 ($92.45 in chips) 
Seat 2: FeersPoker ($50.86 in chips) 
Seat 3: kastellani87 ($53.39 in chips) 
Seat 5: 3DMINSK ($50 in chips) 
Seat 6: StudentRB ($51.25 in chips) 
Seat 7: Pablo1405 ($50 in chips) 
Seat 8: SENSAS1AN ($50 in chips) 
Seat 9: fragonik ($58.70 in chips) 
kastellani87: posts small blind $0.25
3DMINSK: posts big blind $0.50
*** HOLE CARDS ***
StudentRB: folds 
Pablo1405: folds 
SENSAS1AN: folds 
fragonik: folds 
ms1272: folds 
FeersPoker: raises $0.75 to $1.25
kastellani87: calls $1
3DMINSK: folds 
*** FLOP *** [Qc Qh Tc]
kastellani87: checks 
FeersPoker: bets $1.51
kastellani87: folds 
Uncalled bet ($1.51) returned to FeersPoker
FeersPoker collected $2.85 from pot
FeersPoker: doesn't show hand 
*** SUMMARY ***
Total pot $3 | Rake $0.15 
Board [Qc Qh Tc]
Seat 1: ms1272 folded before Flop (didn't bet)
Seat 2: FeersPoker (button) collected ($2.85)
Seat 3: kastellani87 (small blind) folded on the Flop
Seat 5: 3DMINSK (big blind) folded before Flop
Seat 6: StudentRB folded before Flop (didn't bet)
Seat 7: Pablo1405 folded before Flop (didn't bet)
Seat 8: SENSAS1AN folded before Flop (didn't bet)
Seat 9: fragonik folded before Flop (didn't bet)



PokerStars Hand #228691480617:  Hold'em No Limit ($0.25/$0.50 USD) - 2021/07/30 18:17:24 ET
Table 'Gorgo III' 9-max Seat #3 is the button
Seat 1: ms1272 ($92.45 in chips) 
Seat 2: FeersPoker ($52.46 in chips) 
Seat 3: kastellani87 ($52.14 in chips) 
Seat 5: 3DMINSK ($50 in chips) 
Seat 6: StudentRB ($51.25 in chips) 
Seat 7: Pablo1405 ($50 in chips) 
Seat 8: SENSAS1AN ($50 in chips) 
Seat 9: fragonik ($58.70 in chips) 
3DMINSK: posts small blind $0.25
StudentRB: posts big blind $0.50
*** HOLE CARDS ***
Pablo1405: folds 
SENSAS1AN: folds 
fragonik: folds 
ms1272: folds 
FeersPoker: folds 
kastellani87: folds 
3DMINSK: folds 
Uncalled bet ($0.25) returned to StudentRB
StudentRB collected $0.50 from pot
StudentRB: doesn't show hand 
*** SUMMARY ***
Total pot $0.50 | Rake $0 
Seat 1: ms1272 folded before Flop (didn't bet)
Seat 2: FeersPoker folded before Flop (didn't bet)
Seat 3: kastellani87 (button) folded before Flop (didn't bet)
Seat 5: 3DMINSK (small blind) folded before Flop
Seat 6: StudentRB (big blind) collected ($0.50)
Seat 7: Pablo1405 folded before Flop (didn't bet)
Seat 8: SENSAS1AN folded before Flop (didn't bet)
Seat 9: fragonik folded before Flop (didn't bet)



PokerStars Hand #228691485405:  Hold'em No Limit ($0.25/$0.50 USD) - 2021/07/30 18:17:36 ET
Table 'Gorgo III' 9-max Seat #5 is the button
Seat 1: ms1272 ($92.45 in chips) 
Seat 2: FeersPoker ($52.46 in chips) 
Seat 3: kastellani87 ($52.14 in chips) 
Seat 5: 3DMINSK ($50 in chips) 
Seat 6: StudentRB ($51.50 in chips) 
Seat 7: Pablo1405 ($50 in chips) 
Seat 8: SENSAS1AN ($50 in chips) 
Seat 9: fragonik ($58.70 in chips) 
StudentRB: posts small blind $0.25
Pablo1405: posts big blind $0.50
rasku91: sits out 
*** HOLE CARDS ***
SENSAS1AN: calls $0.50
fragonik: folds 
ms1272: folds 
FeersPoker: folds 
kastellani87: calls $0.50
3DMINSK: folds 
StudentRB: calls $0.25
Pablo1405: checks 
*** FLOP *** [7d Js 3s]
StudentRB: checks 
Pablo1405: checks 
SENSAS1AN: bets $1.27
kastellani87: folds 
StudentRB: folds 
Pablo1405: calls $1.27
*** TURN *** [7d Js 3s] [6h]
Pablo1405: checks 
SENSAS1AN: checks 
*** RIVER *** [7d Js 3s 6h] [2c]
Pablo1405: bets $3
SENSAS1AN: folds 
Uncalled bet ($3) returned to Pablo1405
Pablo1405 collected $4.31 from pot
Pablo1405: doesn't show hand 
*** SUMMARY ***
Total pot $4.54 | Rake $0.23 
Board [7d Js 3s 6h 2c]
Seat 1: ms1272 folded before Flop (didn't bet)
Seat 2: FeersPoker folded before Flop (didn't bet)
Seat 3: kastellani87 folded on the Flop
Seat 5: 3DMINSK (button) folded before Flop (didn't bet)
Seat 6: StudentRB (small blind) folded on the Flop
Seat 7: Pablo1405 (big blind) collected ($4.31)
Seat 8: SENSAS1AN folded on the River
Seat 9: fragonik folded before Flop (didn't bet)



PokerStars Hand #228691514330:  Hold'em No Limit ($0.25/$0.50 USD) - 2021/07/30 18:18:47 ET
Table 'Gorgo III' 9-max Seat #6 is the button
Seat 1: ms1272 ($92.45 in chips) 
Seat 2: FeersPoker ($52.46 in chips) 
Seat 3: kastellani87 ($51.64 in chips) 
Seat 5: 3DMINSK ($50 in chips) 
Seat 6: StudentRB ($51 in chips) 
Seat 7: Pablo1405 ($52.54 in chips) 
Seat 8: SENSAS1AN ($50 in chips) 
Seat 9: fragonik ($58.70 in chips) 
Pablo1405: posts small blind $0.25
SENSAS1AN: posts big blind $0.50
rasku91: sits out 
*** HOLE CARDS ***
fragonik: raises $1 to $1.50
ms1272: folds 
FeersPoker: folds 
kastellani87: folds 
3DMINSK: folds 
StudentRB: folds 
Pablo1405: folds 
SENSAS1AN: folds 
Uncalled bet ($1) returned to fragonik
fragonik collected $1.25 from pot
*** SUMMARY ***
Total pot $1.25 | Rake $0 
Seat 1: ms1272 folded before Flop (didn't bet)
Seat 2: FeersPoker folded before Flop (didn't bet)
Seat 3: kastellani87 folded before Flop (didn't bet)
Seat 5: 3DMINSK folded before Flop (didn't bet)
Seat 6: StudentRB (button) folded before Flop (didn't bet)
Seat 7: Pablo1405 (small blind) folded before Flop
Seat 8: SENSAS1AN (big blind) folded before Flop
Seat 9: fragonik collected ($1.25)



PokerStars Hand #228691523795:  Hold'em No Limit ($0.25/$0.50 USD) - 2021/07/30 18:19:11 ET
Table 'Gorgo III' 9-max Seat #7 is the button
Seat 1: ms1272 ($92.45 in chips) 
Seat 2: FeersPoker ($52.46 in chips) 
Seat 3: kastellani87 ($51.64 in chips) 
Seat 5: 3DMINSK ($50 in chips) 
Seat 6: StudentRB ($51 in chips) 
Seat 7: Pablo1405 ($52.29 in chips) 
Seat 8: SENSAS1AN ($50 in chips) 
Seat 9: fragonik ($59.45 in chips) 
SENSAS1AN: posts small blind $0.25
fragonik: posts big blind $0.50
rasku91: sits out 
*** HOLE CARDS ***
ms1272: folds 
FeersPoker: folds 
kastellani87: calls $0.50
3DMINSK: calls $0.50
StudentRB: folds 
Pablo1405: folds 
SENSAS1AN: folds 
fragonik: checks 
*** FLOP *** [5c Qh Jd]
fragonik: checks 
kastellani87: checks 
3DMINSK: checks 
*** TURN *** [5c Qh Jd] [2s]
fragonik: bets $0.81
kastellani87: folds 
3DMINSK: folds 
Uncalled bet ($0.81) returned to fragonik
fragonik collected $1.66 from pot
*** SUMMARY ***
Total pot $1.75 | Rake $0.09 
Board [5c Qh Jd 2s]
Seat 1: ms1272 folded before Flop (didn't bet)
Seat 2: FeersPoker folded before Flop (didn't bet)
Seat 3: kastellani87 folded on the Turn
Seat 5: 3DMINSK folded on the Turn
Seat 6: StudentRB folded before Flop (didn't bet)
Seat 7: Pablo1405 (button) folded before Flop (didn't bet)
Seat 8: SENSAS1AN (small blind) folded before Flop
Seat 9: fragonik (big blind) collected ($1.66)



PokerStars Hand #228691539723:  Hold'em No Limit ($0.25/$0.50 USD) - 2021/07/30 18:19:50 ET
Table 'Gorgo III' 9-max Seat #8 is the button
Seat 1: ms1272 ($92.45 in chips) 
Seat 2: FeersPoker ($52.46 in chips) 
Seat 3: kastellani87 ($51.14 in chips) 
Seat 5: 3DMINSK ($50 in chips) 
Seat 6: StudentRB ($51 in chips) 
Seat 7: Pablo1405 ($52.29 in chips) 
Seat 8: SENSAS1AN ($50 in chips) 
Seat 9: fragonik ($60.61 in chips) 
fragonik: posts small blind $0.25
ms1272: posts big blind $0.50
rasku91: sits out 
*** HOLE CARDS ***
FeersPoker: folds 
kastellani87: folds 
3DMINSK: folds 
StudentRB: folds 
Pablo1405: raises $0.75 to $1.25
SENSAS1AN: folds 
fragonik: folds 
ms1272: calls $0.75
*** FLOP *** [Kh Ah Jd]
ms1272: checks 
Pablo1405: bets $0.91
ms1272: calls $0.91
*** TURN *** [Kh Ah Jd] [As]
ms1272: checks 
Pablo1405: checks 
*** RIVER *** [Kh Ah Jd As] [4s]
ms1272: bets $2.17
Pablo1405: folds 
Uncalled bet ($2.17) returned to ms1272
ms1272 collected $4.28 from pot
ms1272: doesn't show hand 
*** SUMMARY ***
Total pot $4.57 | Rake $0.29 
Board [Kh Ah Jd As 4s]
Seat 1: ms1272 (big blind) collected ($4.28)
Seat 2: FeersPoker folded before Flop (didn't bet)
Seat 3: kastellani87 folded before Flop (didn't bet)
Seat 5: 3DMINSK folded before Flop (didn't bet)
Seat 6: StudentRB folded before Flop (didn't bet)
Seat 7: Pablo1405 folded on the River
Seat 8: SENSAS1AN (button) folded before Flop (didn't bet)
Seat 9: fragonik (small blind) folded before Flop



PokerStars Hand #228691557000:  Hold'em No Limit ($0.25/$0.50 USD) - 2021/07/30 18:20:33 ET
Table 'Gorgo III' 9-max Seat #9 is the button
Seat 1: ms1272 ($94.57 in chips) 
Seat 2: FeersPoker ($52.46 in chips) 
Seat 3: kastellani87 ($51.14 in chips) 
Seat 5: 3DMINSK ($50 in chips) 
Seat 6: StudentRB ($51 in chips) 
Seat 7: Pablo1405 ($50.13 in chips) 
Seat 8: SENSAS1AN ($50 in chips) 
Seat 9: fragonik ($60.36 in chips) 
ms1272: posts small blind $0.25
FeersPoker: posts big blind $0.50
rasku91: sits out 
*** HOLE CARDS ***
kastellani87: folds 
3DMINSK: folds 
StudentRB: folds 
Pablo1405: folds 
SENSAS1AN: raises $0.75 to $1.25
fragonik: raises $2.50 to $3.75
ms1272: folds 
FeersPoker: folds 
SENSAS1AN: folds 
Uncalled bet ($2.50) returned to fragonik
fragonik collected $3.25 from pot
*** SUMMARY ***
Total pot $3.25 | Rake $0 
Seat 1: ms1272 (small blind) folded before Flop
Seat 2: FeersPoker (big blind) folded before Flop
Seat 3: kastellani87 folded before Flop (didn't bet)
Seat 5: 3DMINSK folded before Flop (didn't bet)
Seat 6: StudentRB folded before Flop (didn't bet)
Seat 7: Pablo1405 folded before Flop (didn't bet)
Seat 8: SENSAS1AN folded before Flop
Seat 9: fragonik (button) collected ($3.25)



PokerStars Hand #228691568021:  Hold'em No Limit ($0.25/$0.50 USD) - 2021/07/30 18:21:00 ET
Table 'Gorgo III' 9-max Seat #1 is the button
Seat 1: ms1272 ($94.32 in chips) 
Seat 2: FeersPoker ($51.96 in chips) 
Seat 3: kastellani87 ($51.14 in chips) 
Seat 5: 3DMINSK ($50 in chips) 
Seat 6: StudentRB ($51 in chips) 
Seat 7: Pablo1405 ($50.13 in chips) 
Seat 8: SENSAS1AN ($50 in chips) 
Seat 9: fragonik ($62.36 in chips) 
FeersPoker: posts small blind $0.25
kastellani87: posts big blind $0.50
rasku91: sits out 
*** HOLE CARDS ***
3DMINSK: raises $1 to $1.50
StudentRB: folds 
Pablo1405: folds 
SENSAS1AN: folds 
fragonik has timed out
fragonik: folds 
ms1272: folds 
FeersPoker: folds 
kastellani87: calls $1
*** FLOP *** [4s 2s Ks]
kastellani87: checks 
3DMINSK: checks 
*** TURN *** [4s 2s Ks] [7s]
kastellani87: checks 
3DMINSK: bets $1.58
kastellani87: folds 
Uncalled bet ($1.58) returned to 3DMINSK
3DMINSK collected $3.09 from pot
3DMINSK: doesn't show hand 
*** SUMMARY ***
Total pot $3.25 | Rake $0.16 
Board [4s 2s Ks 7s]
Seat 1: ms1272 (button) folded before Flop (didn't bet)
Seat 2: FeersPoker (small blind) folded before Flop
Seat 3: kastellani87 (big blind) folded on the Turn
Seat 5: 3DMINSK collected ($3.09)
Seat 6: StudentRB folded before Flop (didn't bet)
Seat 7: Pablo1405 folded before Flop (didn't bet)
Seat 8: SENSAS1AN folded before Flop (didn't bet)
Seat 9: fragonik folded before Flop (didn't bet)



PokerStars Hand #228691589481:  Hold'em No Limit ($0.25/$0.50 USD) - 2021/07/30 18:21:54 ET
Table 'Gorgo III' 9-max Seat #2 is the button
Seat 1: ms1272 ($94.32 in chips) 
Seat 2: FeersPoker ($51.71 in chips) 
Seat 3: kastellani87 ($49.64 in chips) 
Seat 4: rasku91 ($40.33 in chips) 
Seat 5: 3DMINSK ($51.59 in chips) 
Seat 6: StudentRB ($51 in chips) 
Seat 7: Pablo1405 ($50.13 in chips) 
Seat 8: SENSAS1AN ($50 in chips) 
kastellani87: posts small blind $0.25
rasku91: posts big blind $0.50
*** HOLE CARDS ***
3DMINSK: folds 
StudentRB: folds 
Pablo1405: folds 
SENSAS1AN: folds 
ms1272: raises $0.50 to $1
FeersPoker: folds 
kastellani87: folds 
rasku91: calls $0.50
*** FLOP *** [Jh 2h 7d]
rasku91: checks 
ms1272: bets $1.07
rasku91: calls $1.07
*** TURN *** [Jh 2h 7d] [4h]
rasku91: checks 
ms1272: checks 
*** RIVER *** [Jh 2h 7d 4h] [Qd]
rasku91: bets $2.50
ms1272: calls $2.50
*** SHOW DOWN ***
rasku91: shows [Kh 3h] (a flush, King high)
ms1272: mucks hand 
rasku91 collected $8.92 from pot
*** SUMMARY ***
Total pot $9.39 | Rake $0.47 
Board [Jh 2h 7d 4h Qd]
Seat 1: ms1272 mucked
Seat 2: FeersPoker (button) folded before Flop (didn't bet)
Seat 3: kastellani87 (small blind) folded before Flop
Seat 4: rasku91 (big blind) showed [Kh 3h] and won ($8.92) with a flush, King high
Seat 5: 3DMINSK folded before Flop (didn't bet)
Seat 6: StudentRB folded before Flop (didn't bet)
Seat 7: Pablo1405 folded before Flop (didn't bet)
Seat 8: SENSAS1AN folded before Flop (didn't bet)



PokerStars Hand #228691607416:  Hold'em No Limit ($0.25/$0.50 USD) - 2021/07/30 18:22:39 ET
Table 'Gorgo III' 9-max Seat #3 is the button
Seat 1: ms1272 ($89.75 in chips) 
Seat 2: FeersPoker ($51.71 in chips) 
Seat 3: kastellani87 ($49.39 in chips) 
Seat 4: rasku91 ($44.68 in chips) 
Seat 5: 3DMINSK ($51.59 in chips) 
Seat 6: StudentRB ($51 in chips) 
Seat 7: Pablo1405 ($50.13 in chips) 
Seat 8: SENSAS1AN ($50 in chips) 
Seat 9: fragonik ($62.36 in chips) 
rasku91: posts small blind $0.25
3DMINSK: posts big blind $0.50
*** HOLE CARDS ***
StudentRB: folds 
Pablo1405: folds 
SENSAS1AN: folds 
fragonik: folds 
ms1272: folds 
FeersPoker: folds 
kastellani87: folds 
rasku91: folds 
Uncalled bet ($0.25) returned to 3DMINSK
3DMINSK collected $0.50 from pot
3DMINSK: doesn't show hand 
*** SUMMARY ***
Total pot $0.50 | Rake $0 
Seat 1: ms1272 folded before Flop (didn't bet)
Seat 2: FeersPoker folded before Flop (didn't bet)
Seat 3: kastellani87 (button) folded before Flop (didn't bet)
Seat 4: rasku91 (small blind) folded before Flop
Seat 5: 3DMINSK (big blind) collected ($0.50)
Seat 6: StudentRB folded before Flop (didn't bet)
Seat 7: Pablo1405 folded before Flop (didn't bet)
Seat 8: SENSAS1AN folded before Flop (didn't bet)
Seat 9: fragonik folded before Flop (didn't bet)



PokerStars Hand #228691616667:  Hold'em No Limit ($0.25/$0.50 USD) - 2021/07/30 18:23:02 ET
Table 'Gorgo III' 9-max Seat #4 is the button
Seat 1: ms1272 ($89.75 in chips) 
Seat 2: FeersPoker ($51.71 in chips) 
Seat 3: kastellani87 ($49.39 in chips) 
Seat 4: rasku91 ($44.43 in chips) 
Seat 5: 3DMINSK ($51.84 in chips) 
Seat 6: StudentRB ($51 in chips) 
Seat 7: Pablo1405 ($50.13 in chips) 
Seat 8: SENSAS1AN ($50 in chips) 
Seat 9: fragonik ($62.36 in chips) 
3DMINSK: posts small blind $0.25
StudentRB: posts big blind $0.50
*** HOLE CARDS ***
Pablo1405: folds 
SENSAS1AN: calls $0.50
fragonik: raises $1.50 to $2
ms1272: folds 
FeersPoker: folds 
kastellani87: calls $2
rasku91: calls $2
3DMINSK: folds 
StudentRB: folds 
SENSAS1AN: calls $1.50
*** FLOP *** [3s 2d 7d]
SENSAS1AN: checks 
fragonik: bets $3.75
kastellani87: folds 
rasku91: calls $3.75
SENSAS1AN: folds 
*** TURN *** [3s 2d 7d] [Ah]
fragonik: checks 
rasku91: bets $6.50
fragonik: calls $6.50
*** RIVER *** [3s 2d 7d Ah] [7s]
fragonik: checks 
rasku91: bets $6
fragonik: folds 
Uncalled bet ($6) returned to rasku91
rasku91 collected $27.79 from pot
rasku91: doesn't show hand 
*** SUMMARY ***
Total pot $29.25 | Rake $1.46 
Board [3s 2d 7d Ah 7s]
Seat 1: ms1272 folded before Flop (didn't bet)
Seat 2: FeersPoker folded before Flop (didn't bet)
Seat 3: kastellani87 folded on the Flop
Seat 4: rasku91 (button) collected ($27.79)
Seat 5: 3DMINSK (small blind) folded before Flop
Seat 6: StudentRB (big blind) folded before Flop
Seat 7: Pablo1405 folded before Flop (didn't bet)
Seat 8: SENSAS1AN folded on the Flop
Seat 9: fragonik folded on the River



PokerStars Hand #228691668116:  Hold'em No Limit ($0.25/$0.50 USD) - 2021/07/30 18:25:12 ET
Table 'Gorgo III' 9-max Seat #5 is the button
Seat 1: ms1272 ($89.75 in chips) 
Seat 2: FeersPoker ($51.71 in chips) 
Seat 3: kastellani87 ($47.39 in chips) 
Seat 4: rasku91 ($59.97 in chips) 
Seat 5: 3DMINSK ($51.59 in chips) 
Seat 6: StudentRB ($50.50 in chips) 
Seat 7: Pablo1405 ($50.13 in chips) 
Seat 8: SENSAS1AN ($50 in chips) 
Seat 9: fragonik ($50.11 in chips) 
StudentRB: posts small blind $0.25
Pablo1405: posts big blind $0.50
*** HOLE CARDS ***
SENSAS1AN: folds 
fragonik: folds 
ms1272: folds 
FeersPoker: folds 
kastellani87: calls $0.50
rasku91: folds 
3DMINSK: folds 
StudentRB: calls $0.25
Pablo1405: checks 
*** FLOP *** [Th 7h 5d]
StudentRB: bets $1
Pablo1405: folds 
kastellani87: folds 
Uncalled bet ($1) returned to StudentRB
StudentRB collected $1.42 from pot
StudentRB: doesn't show hand 
*** SUMMARY ***
Total pot $1.50 | Rake $0.08 
Board [Th 7h 5d]
Seat 1: ms1272 folded before Flop (didn't bet)
Seat 2: FeersPoker folded before Flop (didn't bet)
Seat 3: kastellani87 folded on the Flop
Seat 4: rasku91 folded before Flop (didn't bet)
Seat 5: 3DMINSK (button) folded before Flop (didn't bet)
Seat 6: StudentRB (small blind) collected ($1.42)
Seat 7: Pablo1405 (big blind) folded on the Flop
Seat 8: SENSAS1AN folded before Flop (didn't bet)
Seat 9: fragonik folded before Flop (didn't bet)



PokerStars Hand #228691686861:  Hold'em No Limit ($0.25/$0.50 USD) - 2021/07/30 18:25:59 ET
Table 'Gorgo III' 9-max Seat #6 is the button
Seat 1: ms1272 ($89.75 in chips) 
Seat 2: FeersPoker ($51.71 in chips) 
Seat 3: kastellani87 ($46.89 in chips) 
Seat 4: rasku91 ($59.97 in chips) 
Seat 5: 3DMINSK ($51.59 in chips) 
Seat 6: StudentRB ($51.42 in chips) 
Seat 7: Pablo1405 ($50 in chips) 
Seat 8: SENSAS1AN ($50 in chips) 
Seat 9: fragonik ($50.11 in chips) 
Pablo1405: posts small blind $0.25
SENSAS1AN: posts big blind $0.50
*** HOLE CARDS ***
fragonik: folds 
ms1272: folds 
FeersPoker: folds 
kastellani87: calls $0.50
rasku91: folds 
3DMINSK: folds 
StudentRB: folds 
Pablo1405: calls $0.25
SENSAS1AN: checks 
*** FLOP *** [Qc 7d Ac]
Pablo1405: checks 
SENSAS1AN: checks 
kastellani87: bets $0.71
Pablo1405: folds 
SENSAS1AN: folds 
Uncalled bet ($0.71) returned to kastellani87
kastellani87 collected $1.42 from pot
kastellani87: doesn't show hand 
*** SUMMARY ***
Total pot $1.50 | Rake $0.08 
Board [Qc 7d Ac]
Seat 1: ms1272 folded before Flop (didn't bet)
Seat 2: FeersPoker folded before Flop (didn't bet)
Seat 3: kastellani87 collected ($1.42)
Seat 4: rasku91 folded before Flop (didn't bet)
Seat 5: 3DMINSK folded before Flop (didn't bet)
Seat 6: StudentRB (button) folded before Flop (didn't bet)
Seat 7: Pablo1405 (small blind) folded on the Flop
Seat 8: SENSAS1AN (big blind) folded on the Flop
Seat 9: fragonik folded before Flop (didn't bet)



PokerStars Hand #228691704775:  Hold'em No Limit ($0.25/$0.50 USD) - 2021/07/30 18:26:44 ET
Table 'Gorgo III' 9-max Seat #7 is the button
Seat 1: ms1272 ($89.75 in chips) 
Seat 2: FeersPoker ($51.71 in chips) 
Seat 3: kastellani87 ($47.81 in chips) 
Seat 4: rasku91 ($59.97 in chips) 
Seat 5: 3DMINSK ($51.59 in chips) 
Seat 6: StudentRB ($51.42 in chips) 
Seat 7: Pablo1405 ($50 in chips) 
Seat 8: SENSAS1AN ($50 in chips) 
SENSAS1AN: posts small blind $0.25
fragonik: is sitting out 
ms1272: posts big blind $0.50
*** HOLE CARDS ***
FeersPoker: folds 
kastellani87: calls $0.50
rasku91: folds 
3DMINSK: folds 
StudentRB: folds 
Pablo1405: raises $1.50 to $2
SENSAS1AN: folds 
ms1272: calls $1.50
kastellani87: calls $1.50
*** FLOP *** [7s 5c Kc]
ms1272: checks 
kastellani87: checks 
Pablo1405: bets $2.50
ms1272: calls $2.50
kastellani87: folds 
*** TURN *** [7s 5c Kc] [8d]
ms1272: checks 
Pablo1405: checks 
*** RIVER *** [7s 5c Kc 8d] [8h]
ms1272: checks 
Pablo1405: bets $3.50
ms1272: calls $3.50
*** SHOW DOWN ***
Pablo1405: shows [Kh 9h] (two pair, Kings and Eights)
ms1272: mucks hand 
Pablo1405 collected $17.34 from pot
*** SUMMARY ***
Total pot $18.25 | Rake $0.91 
Board [7s 5c Kc 8d 8h]
Seat 1: ms1272 (big blind) mucked
Seat 2: FeersPoker folded before Flop (didn't bet)
Seat 3: kastellani87 folded on the Flop
Seat 4: rasku91 folded before Flop (didn't bet)
Seat 5: 3DMINSK folded before Flop (didn't bet)
Seat 6: StudentRB folded before Flop (didn't bet)
Seat 7: Pablo1405 (button) showed [Kh 9h] and won ($17.34) with two pair, Kings and Eights
Seat 8: SENSAS1AN (small blind) folded before Flop



PokerStars Hand #228688589390:  Hold'em No Limit ($0.25/$0.50 USD) - 2021/07/30 16:30:36 ET
Table 'Gorgo III' 9-max Seat #8 is the button
Seat 1: gustguaira ($63.21 in chips) 
Seat 2: inflexiblle ($50 in chips) 
Seat 3: Leason22 ($29.73 in chips) 
Seat 4: nicu4you ($59.43 in chips) 
Seat 5: funker84 ($41.70 in chips) 
Seat 6: MR.PATJEW ($48.10 in chips) 
Seat 7: sonova ($102.85 in chips) 
Seat 8: Lisenok110 ($59.08 in chips) 
Seat 9: fragonik ($50 in chips) 
fragonik: posts small blind $0.25
gustguaira: posts big blind $0.50
*** HOLE CARDS ***
inflexiblle: folds 
Leason22: raises $1 to $1.50
nicu4you: raises $3.75 to $5.25
funker84: folds 
MR.PATJEW: folds 
sonova: folds 
Lisenok110: folds 
fragonik: folds 
gustguaira: folds 
Leason22: calls $3.75
*** FLOP *** [Th 2d As]
Leason22: bets $4
nicu4you: calls $4
*** TURN *** [Th 2d As] [9s]
Leason22: checks 
nicu4you: bets $11.50
Leason22: folds 
Uncalled bet ($11.50) returned to nicu4you
nicu4you collected $18.29 from pot
nicu4you: doesn't show hand 
*** SUMMARY ***
Total pot $19.25 | Rake $0.96 
Board [Th 2d As 9s]
Seat 1: gustguaira (big blind) folded before Flop
Seat 2: inflexiblle folded before Flop (didn't bet)
Seat 3: Leason22 folded on the Turn
Seat 4: nicu4you collected ($18.29)
Seat 5: funker84 folded before Flop (didn't bet)
Seat 6: MR.PATJEW folded before Flop (didn't bet)
Seat 7: sonova folded before Flop (didn't bet)
Seat 8: Lisenok110 (button) folded before Flop (didn't bet)
Seat 9: fragonik (small blind) folded before Flop



PokerStars Hand #228688616798:  Hold'em No Limit ($0.25/$0.50 USD) - 2021/07/30 16:31:32 ET
Table 'Gorgo III' 9-max Seat #9 is the button
Seat 1: gustguaira ($62.71 in chips) 
Seat 2: inflexiblle ($50 in chips) 
Seat 3: Leason22 ($20.48 in chips) 
Seat 4: nicu4you ($68.47 in chips) 
Seat 5: funker84 ($41.70 in chips) 
Seat 6: MR.PATJEW ($48.10 in chips) 
Seat 7: sonova ($102.85 in chips) 
Seat 8: Lisenok110 ($59.08 in chips) 
Seat 9: fragonik ($50 in chips) 
gustguaira: posts small blind $0.25
inflexiblle: posts big blind $0.50
*** HOLE CARDS ***
Leason22: folds 
nicu4you: folds 
funker84: folds 
MR.PATJEW: folds 
sonova: folds 
Lisenok110: folds 
fragonik: raises $0.75 to $1.25
gustguaira: folds 
inflexiblle: raises $4.75 to $6
fragonik: folds 
Uncalled bet ($4.75) returned to inflexiblle
inflexiblle collected $2.75 from pot
*** SUMMARY ***
Total pot $2.75 | Rake $0 
Seat 1: gustguaira (small blind) folded before Flop
Seat 2: inflexiblle (big blind) collected ($2.75)
Seat 3: Leason22 folded before Flop (didn't bet)
Seat 4: nicu4you folded before Flop (didn't bet)
Seat 5: funker84 folded before Flop (didn't bet)
Seat 6: MR.PATJEW folded before Flop (didn't bet)
Seat 7: sonova folded before Flop (didn't bet)
Seat 8: Lisenok110 folded before Flop (didn't bet)
Seat 9: fragonik (button) folded before Flop



PokerStars Hand #228688963108:  Hold'em No Limit ($0.25/$0.50 USD) - 2021/07/30 16:43:26 ET
Table 'Gorgo III' 9-max Seat #7 is the button
Seat 2: inflexiblle ($55.96 in chips) 
Seat 3: Dragonclawss ($50 in chips) 
Seat 4: nicu4you ($76.38 in chips) 
Seat 5: funker84 ($58.05 in chips) 
Seat 6: MR.PATJEW ($59.73 in chips) 
Seat 7: wildermorph ($49.25 in chips) 
Seat 8: Lisenok110 ($57.78 in chips) 
Seat 9: fragonik ($50 in chips) 
Lisenok110: posts small blind $0.25
fragonik: posts big blind $0.50
Popokluev: sits out 
*** HOLE CARDS ***
inflexiblle: folds 
Dragonclawss: folds 
nicu4you: folds 
funker84: raises $0.50 to $1
MR.PATJEW: calls $1
wildermorph: folds 
Lisenok110: folds 
fragonik: folds 
*** FLOP *** [Kc 2c Ac]
funker84: checks 
MR.PATJEW: checks 
*** TURN *** [Kc 2c Ac] [9s]
funker84: checks 
MR.PATJEW: checks 
*** RIVER *** [Kc 2c Ac 9s] [3d]
funker84: checks 
MR.PATJEW: checks 
*** SHOW DOWN ***
funker84: shows [7d 7s] (a pair of Sevens)
MR.PATJEW: shows [Kh Ts] (a pair of Kings)
MR.PATJEW collected $2.61 from pot
*** SUMMARY ***
Total pot $2.75 | Rake $0.14 
Board [Kc 2c Ac 9s 3d]
Seat 2: inflexiblle folded before Flop (didn't bet)
Seat 3: Dragonclawss folded before Flop (didn't bet)
Seat 4: nicu4you folded before Flop (didn't bet)
Seat 5: funker84 showed [7d 7s] and lost with a pair of Sevens
Seat 6: MR.PATJEW showed [Kh Ts] and won ($2.61) with a pair of Kings
Seat 7: wildermorph (button) folded before Flop (didn't bet)
Seat 8: Lisenok110 (small blind) folded before Flop
Seat 9: fragonik (big blind) folded before Flop



PokerStars Hand #228689074639:  Hold'em No Limit ($0.25/$0.50 USD) - 2021/07/30 16:47:02 ET
Table 'Gorgo III' 9-max Seat #2 is the button
Seat 1: Popokluev ($52.13 in chips) 
Seat 2: inflexiblle ($53.21 in chips) 
Seat 4: nicu4you ($77.73 in chips) 
Seat 5: funker84 ($57.05 in chips) 
Seat 6: MR.PATJEW ($61.34 in chips) 
Seat 7: wildermorph ($49.25 in chips) 
Seat 8: Lisenok110 ($57.53 in chips) 
Seat 9: fragonik ($51.36 in chips) 
nicu4you: posts small blind $0.25
funker84: posts big blind $0.50
*** HOLE CARDS ***
MR.PATJEW has timed out
MR.PATJEW: folds 
wildermorph: folds 
Lisenok110: raises $0.75 to $1.25
fragonik: folds 
Popokluev: folds 
inflexiblle: folds 
nicu4you: calls $1
funker84: folds 
*** FLOP *** [4s 7s 3c]
nicu4you: checks 
Lisenok110: checks 
*** TURN *** [4s 7s 3c] [7h]
nicu4you: bets $1.57
Lisenok110: calls $1.57
*** RIVER *** [4s 7s 3c 7h] [Jd]
nicu4you: checks 
Lisenok110: bets $5.25
nicu4you: folds 
Uncalled bet ($5.25) returned to Lisenok110
Lisenok110 collected $5.83 from pot
Lisenok110: doesn't show hand 
*** SUMMARY ***
Total pot $6.14 | Rake $0.31 
Board [4s 7s 3c 7h Jd]
Seat 1: Popokluev folded before Flop (didn't bet)
Seat 2: inflexiblle (button) folded before Flop (didn't bet)
Seat 4: nicu4you (small blind) folded on the River
Seat 5: funker84 (big blind) folded before Flop
Seat 6: MR.PATJEW folded before Flop (didn't bet)
Seat 7: wildermorph folded before Flop (didn't bet)
Seat 8: Lisenok110 collected ($5.83)
Seat 9: fragonik folded before Flop (didn't bet)



PokerStars Hand #228689102289:  Hold'em No Limit ($0.25/$0.50 USD) - 2021/07/30 16:48:00 ET
Table 'Gorgo III' 9-max Seat #4 is the button
Seat 1: Popokluev ($52.13 in chips) 
Seat 2: inflexiblle ($53.21 in chips) 
Seat 4: nicu4you ($74.91 in chips) 
Seat 5: funker84 ($56.55 in chips) 
Seat 6: MR.PATJEW ($61.34 in chips) 
Seat 7: wildermorph ($49.25 in chips) 
Seat 8: Lisenok110 ($60.54 in chips) 
Seat 9: fragonik ($51.36 in chips) 
funker84: posts small blind $0.25
MR.PATJEW: posts big blind $0.50
*** HOLE CARDS ***
wildermorph: folds 
Lisenok110: folds 
fragonik: raises $0.75 to $1.25
Popokluev: folds 
inflexiblle: calls $1.25
nicu4you: folds 
funker84: folds 
MR.PATJEW: folds 
*** FLOP *** [4s Th Jd]
fragonik: bets $1.51
inflexiblle: folds 
Uncalled bet ($1.51) returned to fragonik
fragonik collected $3.09 from pot
*** SUMMARY ***
Total pot $3.25 | Rake $0.16 
Board [4s Th Jd]
Seat 1: Popokluev folded before Flop (didn't bet)
Seat 2: inflexiblle folded on the Flop
Seat 4: nicu4you (button) folded before Flop (didn't bet)
Seat 5: funker84 (small blind) folded before Flop
Seat 6: MR.PATJEW (big blind) folded before Flop
Seat 7: wildermorph folded before Flop (didn't bet)
Seat 8: Lisenok110 folded before Flop (didn't bet)
Seat 9: fragonik collected ($3.09)



PokerStars Hand #228692384802:  Hold'em No Limit ($0.25/$0.50 USD) - 2021/07/30 18:55:10 ET
Table 'Gorgo III' 9-max Seat #5 is the button
Seat 1: Antoxa970 ($21.89 in chips) 
Seat 2: FeersPoker ($71.51 in chips) 
Seat 3: kastellani87 ($104.86 in chips) 
Seat 4: BB_dont_cry ($49.25 in chips) 
Seat 5: 3DMINSK ($50 in chips) 
Seat 6: StudentRB ($51.61 in chips) 
Seat 7: Pablo1405 ($57.43 in chips) 
Seat 8: SENSAS1AN ($50 in chips) 
StudentRB: posts small blind $0.25
Pablo1405: posts big blind $0.50
fragonik: sits out 
*** HOLE CARDS ***
SENSAS1AN: folds 
Antoxa970: calls $0.50
FeersPoker: folds 
kastellani87: raises $1 to $1.50
BB_dont_cry: folds 
3DMINSK: folds 
StudentRB: folds 
Pablo1405: folds 
Antoxa970: calls $1
*** FLOP *** [9d 6c Jh]
Antoxa970: bets $3.56
kastellani87: raises $3.56 to $7.12
Antoxa970: raises $3.56 to $10.68
kastellani87: raises $3.56 to $14.24
Antoxa970: calls $3.56
*** TURN *** [9d 6c Jh] [5h]
Antoxa970: bets $6.15 and is all-in
kastellani87: calls $6.15
kastellani87:  
Antoxa970:  
*** RIVER *** [9d 6c Jh 5h] [4d]
*** SHOW DOWN ***
Antoxa970: shows [Ks 5s] (a pair of Fives)
kastellani87: shows [Jd Ad] (a pair of Jacks)
kastellani87 collected $42.53 from pot
*** SUMMARY ***
Total pot $44.53 | Rake $2 
Board [9d 6c Jh 5h 4d]
Seat 1: Antoxa970 showed [Ks 5s] and lost with a pair of Fives
Seat 2: FeersPoker folded before Flop (didn't bet)
Seat 3: kastellani87 showed [Jd Ad] and won ($42.53) with a pair of Jacks
Seat 4: BB_dont_cry folded before Flop (didn't bet)
Seat 5: 3DMINSK (button) folded before Flop (didn't bet)
Seat 6: StudentRB (small blind) folded before Flop
Seat 7: Pablo1405 (big blind) folded before Flop
Seat 8: SENSAS1AN folded before Flop (didn't bet)



PokerStars Hand #228692410427:  Hold'em No Limit ($0.25/$0.50 USD) - 2021/07/30 18:56:37 ET
Table 'Gorgo III' 9-max Seat #6 is the button
Seat 2: FeersPoker ($71.51 in chips) 
Seat 3: kastellani87 ($125.50 in chips) 
Seat 4: BB_dont_cry ($49.25 in chips) 
Seat 5: 3DMINSK ($50 in chips) 
Seat 6: StudentRB ($51.36 in chips) 
Seat 7: Pablo1405 ($56.93 in chips) 
Seat 8: SENSAS1AN ($50 in chips) 
Pablo1405: posts small blind $0.25
SENSAS1AN: posts big blind $0.50
fragonik: sits out 
*** HOLE CARDS ***
FeersPoker: folds 
kastellani87: folds 
BB_dont_cry: raises $1 to $1.50
3DMINSK: calls $1.50
StudentRB: folds 
Pablo1405: folds 
SENSAS1AN: folds 
*** FLOP *** [2c 4h Qs]
BB_dont_cry: checks 
3DMINSK: bets $1.07
BB_dont_cry: folds 
Uncalled bet ($1.07) returned to 3DMINSK
3DMINSK collected $3.56 from pot
3DMINSK: doesn't show hand 
*** SUMMARY ***
Total pot $3.75 | Rake $0.19 
Board [2c 4h Qs]
Seat 2: FeersPoker folded before Flop (didn't bet)
Seat 3: kastellani87 folded before Flop (didn't bet)
Seat 4: BB_dont_cry folded on the Flop
Seat 5: 3DMINSK collected ($3.56)
Seat 6: StudentRB (button) folded before Flop (didn't bet)
Seat 7: Pablo1405 (small blind) folded before Flop
Seat 8: SENSAS1AN (big blind) folded before Flop



PokerStars Hand #228692426318:  Hold'em No Limit ($0.25/$0.50 USD) - 2021/07/30 18:57:13 ET
Table 'Gorgo III' 9-max Seat #7 is the button
Seat 1: Antoxa970 ($48.86 in chips) 
Seat 2: FeersPoker ($71.51 in chips) 
Seat 3: kastellani87 ($125.50 in chips) 
Seat 4: BB_dont_cry ($47.75 in chips) 
Seat 5: 3DMINSK ($52.06 in chips) 
Seat 6: StudentRB ($51.36 in chips) 
Seat 7: Pablo1405 ($56.68 in chips) 
Seat 8: SENSAS1AN ($50 in chips) 
Seat 9: fragonik ($52.07 in chips) 
SENSAS1AN: posts small blind $0.25
fragonik: posts big blind $0.50
*** HOLE CARDS ***
Antoxa970: calls $0.50
FeersPoker: folds 
kastellani87: calls $0.50
BB_dont_cry: raises $2.25 to $2.75
3DMINSK: folds 
StudentRB: folds 
Pablo1405: folds 
SENSAS1AN: folds 
fragonik: folds 
Antoxa970: folds 
kastellani87: folds 
Uncalled bet ($2.25) returned to BB_dont_cry
BB_dont_cry collected $2.25 from pot
*** SUMMARY ***
Total pot $2.25 | Rake $0 
Seat 1: Antoxa970 folded before Flop
Seat 2: FeersPoker folded before Flop (didn't bet)
Seat 3: kastellani87 folded before Flop
Seat 4: BB_dont_cry collected ($2.25)
Seat 5: 3DMINSK folded before Flop (didn't bet)
Seat 6: StudentRB folded before Flop (didn't bet)
Seat 7: Pablo1405 (button) folded before Flop (didn't bet)
Seat 8: SENSAS1AN (small blind) folded before Flop
Seat 9: fragonik (big blind) folded before Flop



PokerStars Hand #228692446170:  Hold'em No Limit ($0.25/$0.50 USD) - 2021/07/30 18:57:59 ET
Table 'Gorgo III' 9-max Seat #8 is the button
Seat 1: Antoxa970 ($48.36 in chips) 
Seat 2: FeersPoker ($71.51 in chips) 
Seat 3: kastellani87 ($125 in chips) 
Seat 4: BB_dont_cry ($49.50 in chips) 
Seat 5: 3DMINSK ($52.06 in chips) 
Seat 6: StudentRB ($51.36 in chips) 
Seat 7: Pablo1405 ($56.68 in chips) 
Seat 8: SENSAS1AN ($50 in chips) 
Seat 9: fragonik ($51.57 in chips) 
fragonik: posts small blind $0.25
Antoxa970: posts big blind $0.50
*** HOLE CARDS ***
FeersPoker: folds 
kastellani87: folds 
BB_dont_cry: calls $0.50
3DMINSK: calls $0.50
StudentRB: folds 
Pablo1405: folds 
SENSAS1AN: folds 
fragonik: folds 
Antoxa970: checks 
*** FLOP *** [Ac Ad Ks]
Antoxa970: checks 
BB_dont_cry: bets $0.83
3DMINSK: folds 
Antoxa970: raises $1.66 to $2.49
BB_dont_cry: folds 
Uncalled bet ($1.66) returned to Antoxa970
Antoxa970 collected $3.24 from pot
Antoxa970: doesn't show hand 
*** SUMMARY ***
Total pot $3.41 | Rake $0.17 
Board [Ac Ad Ks]
Seat 1: Antoxa970 (big blind) collected ($3.24)
Seat 2: FeersPoker folded before Flop (didn't bet)
Seat 3: kastellani87 folded before Flop (didn't bet)
Seat 4: BB_dont_cry folded on the Flop
Seat 5: 3DMINSK folded on the Flop
Seat 6: StudentRB folded before Flop (didn't bet)
Seat 7: Pablo1405 folded before Flop (didn't bet)
Seat 8: SENSAS1AN (button) folded before Flop (didn't bet)
Seat 9: fragonik (small blind) folded before Flop



PokerStars Hand #228692459742:  Hold'em No Limit ($0.25/$0.50 USD) - 2021/07/30 18:58:45 ET
Table 'Gorgo III' 9-max Seat #9 is the button
Seat 1: Antoxa970 ($50.27 in chips) 
Seat 2: FeersPoker ($71.51 in chips) 
Seat 3: kastellani87 ($125 in chips) 
Seat 4: BB_dont_cry ($48.17 in chips) 
Seat 5: 3DMINSK ($51.56 in chips) 
Seat 6: StudentRB ($51.36 in chips) 
Seat 7: Pablo1405 ($56.68 in chips) 
Seat 8: SENSAS1AN ($50 in chips) 
Seat 9: fragonik ($51.32 in chips) 
Antoxa970: posts small blind $0.25
FeersPoker: posts big blind $0.50
*** HOLE CARDS ***
kastellani87: folds 
BB_dont_cry: folds 
3DMINSK: folds 
StudentRB: folds 
Pablo1405: folds 
SENSAS1AN: folds 
fragonik has timed out
fragonik: folds 
Antoxa970: calls $0.25
FeersPoker: checks 
*** FLOP *** [5s 8c 8d]
Antoxa970: checks 
FeersPoker: bets $0.57
Antoxa970: raises $1.05 to $1.62
FeersPoker: folds 
Uncalled bet ($1.05) returned to Antoxa970
Antoxa970 collected $2.03 from pot
Antoxa970: doesn't show hand 
*** SUMMARY ***
Total pot $2.14 | Rake $0.11 
Board [5s 8c 8d]
Seat 1: Antoxa970 (small blind) collected ($2.03)
Seat 2: FeersPoker (big blind) folded on the Flop
Seat 3: kastellani87 folded before Flop (didn't bet)
Seat 4: BB_dont_cry folded before Flop (didn't bet)
Seat 5: 3DMINSK folded before Flop (didn't bet)
Seat 6: StudentRB folded before Flop (didn't bet)
Seat 7: Pablo1405 folded before Flop (didn't bet)
Seat 8: SENSAS1AN folded before Flop (didn't bet)
Seat 9: fragonik (button) folded before Flop (didn't bet)



PokerStars Hand #228692472685:  Hold'em No Limit ($0.25/$0.50 USD) - 2021/07/30 18:59:29 ET
Table 'Gorgo III' 9-max Seat #1 is the button
Seat 1: Antoxa970 ($51.23 in chips) 
Seat 2: FeersPoker ($70.44 in chips) 
Seat 3: kastellani87 ($125 in chips) 
Seat 4: BB_dont_cry ($48.17 in chips) 
Seat 5: 3DMINSK ($51.56 in chips) 
Seat 6: StudentRB ($51.36 in chips) 
Seat 7: Pablo1405 ($56.68 in chips) 
Seat 8: SENSAS1AN ($50 in chips) 
Seat 9: fragonik ($51.32 in chips) 
FeersPoker: posts small blind $0.25
kastellani87: posts big blind $0.50
*** HOLE CARDS ***
BB_dont_cry: calls $0.50
3DMINSK: folds 
StudentRB: folds 
Pablo1405: raises $1 to $1.50
SENSAS1AN: folds 
fragonik: calls $1.50
Antoxa970: calls $1.50
FeersPoker: folds 
kastellani87: calls $1
BB_dont_cry: calls $1
*** FLOP *** [5c Ts Ac]
kastellani87: checks 
BB_dont_cry: bets $4
Pablo1405: calls $4
fragonik: calls $4
Antoxa970: folds 
kastellani87: folds 
*** TURN *** [5c Ts Ac] [Jd]
BB_dont_cry: bets $10.50
Pablo1405: folds 
fragonik: folds 
Uncalled bet ($10.50) returned to BB_dont_cry
BB_dont_cry collected $18.76 from pot
*** SUMMARY ***
Total pot $19.75 | Rake $0.99 
Board [5c Ts Ac Jd]
Seat 1: Antoxa970 (button) folded on the Flop
Seat 2: FeersPoker (small blind) folded before Flop
Seat 3: kastellani87 (big blind) folded on the Flop
Seat 4: BB_dont_cry collected ($18.76)
Seat 5: 3DMINSK folded before Flop (didn't bet)
Seat 6: StudentRB folded before Flop (didn't bet)
Seat 7: Pablo1405 folded on the Turn
Seat 8: SENSAS1AN folded before Flop (didn't bet)
Seat 9: fragonik folded on the Turn



PokerStars Hand #228692494207:  Hold'em No Limit ($0.25/$0.50 USD) - 2021/07/30 19:00:39 ET
Table 'Gorgo III' 9-max Seat #2 is the button
Seat 1: Antoxa970 ($49.73 in chips) 
Seat 2: FeersPoker ($70.19 in chips) 
Seat 3: kastellani87 ($123.50 in chips) 
Seat 4: BB_dont_cry ($61.43 in chips) 
Seat 5: 3DMINSK ($51.56 in chips) 
Seat 6: StudentRB ($51.36 in chips) 
Seat 7: Pablo1405 ($51.18 in chips) 
Seat 8: SENSAS1AN ($50 in chips) 
Seat 9: fragonik ($50 in chips) 
kastellani87: posts small blind $0.25
BB_dont_cry: posts big blind $0.50
*** HOLE CARDS ***
3DMINSK: folds 
StudentRB: folds 
Pablo1405: folds 
SENSAS1AN: folds 
fragonik: folds 
Antoxa970: calls $0.50
FeersPoker: raises $1.50 to $2
kastellani87: calls $1.75
BB_dont_cry: folds 
Antoxa970: calls $1.50
*** FLOP *** [8h 2s Qd]
kastellani87: checks 
Antoxa970: bets $6.18
FeersPoker: folds 
kastellani87: folds 
Uncalled bet ($6.18) returned to Antoxa970
Antoxa970 collected $6.18 from pot
Antoxa970: doesn't show hand 
*** SUMMARY ***
Total pot $6.50 | Rake $0.32 
Board [8h 2s Qd]
Seat 1: Antoxa970 collected ($6.18)
Seat 2: FeersPoker (button) folded on the Flop
Seat 3: kastellani87 (small blind) folded on the Flop
Seat 4: BB_dont_cry (big blind) folded before Flop
Seat 5: 3DMINSK folded before Flop (didn't bet)
Seat 6: StudentRB folded before Flop (didn't bet)
Seat 7: Pablo1405 folded before Flop (didn't bet)
Seat 8: SENSAS1AN folded before Flop (didn't bet)
Seat 9: fragonik folded before Flop (didn't bet)



PokerStars Hand #228692504205:  Hold'em No Limit ($0.25/$0.50 USD) - 2021/07/30 19:01:09 ET
Table 'Gorgo III' 9-max Seat #3 is the button
Seat 1: Antoxa970 ($53.91 in chips) 
Seat 2: FeersPoker ($68.19 in chips) 
Seat 3: kastellani87 ($121.50 in chips) 
Seat 4: BB_dont_cry ($60.93 in chips) 
Seat 5: 3DMINSK ($51.56 in chips) 
Seat 6: StudentRB ($51.36 in chips) 
Seat 7: Pablo1405 ($51.18 in chips) 
Seat 8: SENSAS1AN ($50 in chips) 
Seat 9: fragonik ($50 in chips) 
BB_dont_cry: posts small blind $0.25
3DMINSK: posts big blind $0.50
*** HOLE CARDS ***
StudentRB: folds 
Pablo1405: folds 
SENSAS1AN: folds 
fragonik: folds 
Antoxa970: calls $0.50
FeersPoker: folds 
kastellani87: calls $0.50
BB_dont_cry: folds 
3DMINSK: checks 
*** FLOP *** [5d 3c 9c]
3DMINSK: checks 
Antoxa970: bets $1.66
kastellani87: calls $1.66
3DMINSK: calls $1.66
*** TURN *** [5d 3c 9c] [Ks]
3DMINSK: checks 
Antoxa970: bets $6.39
kastellani87: folds 
3DMINSK: calls $6.39
*** RIVER *** [5d 3c 9c Ks] [Js]
3DMINSK: checks 
Antoxa970: bets $18.53
3DMINSK: folds 
Uncalled bet ($18.53) returned to Antoxa970
Antoxa970 collected $18.53 from pot
Antoxa970: doesn't show hand 
*** SUMMARY ***
Total pot $19.51 | Rake $0.98 
Board [5d 3c 9c Ks Js]
Seat 1: Antoxa970 collected ($18.53)
Seat 2: FeersPoker folded before Flop (didn't bet)
Seat 3: kastellani87 (button) folded on the Turn
Seat 4: BB_dont_cry (small blind) folded before Flop
Seat 5: 3DMINSK (big blind) folded on the River
Seat 6: StudentRB folded before Flop (didn't bet)
Seat 7: Pablo1405 folded before Flop (didn't bet)
Seat 8: SENSAS1AN folded before Flop (didn't bet)
Seat 9: fragonik folded before Flop (didn't bet)



PokerStars Hand #228692630146:  Hold'em No Limit ($0.25/$0.50 USD) - 2021/07/30 19:06:36 ET
Table 'Gorgo III' 9-max Seat #1 is the button
Seat 1: Antoxa970 ($37.72 in chips) 
Seat 2: FeersPoker ($76.87 in chips) 
Seat 3: kastellani87 ($112.84 in chips) 
Seat 4: BB_dont_cry ($59.43 in chips) 
Seat 5: 3DMINSK ($50 in chips) 
Seat 6: StudentRB ($50.61 in chips) 
Seat 7: Pablo1405 ($75.66 in chips) 
Seat 8: SENSAS1AN ($50 in chips) 
FeersPoker: posts small blind $0.25
kastellani87: posts big blind $0.50
Pachebrash: sits out 
*** HOLE CARDS ***
BB_dont_cry: folds 
3DMINSK: folds 
StudentRB: folds 
Pablo1405: folds 
SENSAS1AN: raises $0.75 to $1.25
Antoxa970: calls $1.25
FeersPoker: folds 
kastellani87: calls $0.75
*** FLOP *** [6s 3d 8d]
kastellani87: checks 
SENSAS1AN: checks 
Antoxa970: bets $3.80
kastellani87: folds 
SENSAS1AN: raises $10.70 to $14.50
Antoxa970: calls $10.70
*** TURN *** [6s 3d 8d] [Jh]
SENSAS1AN: bets $31.35
Antoxa970 has timed out
Antoxa970: folds 
Uncalled bet ($31.35) returned to SENSAS1AN
SENSAS1AN collected $31.35 from pot
SENSAS1AN: doesn't show hand 
*** SUMMARY ***
Total pot $33 | Rake $1.65 
Board [6s 3d 8d Jh]
Seat 1: Antoxa970 (button) folded on the Turn
Seat 2: FeersPoker (small blind) folded before Flop
Seat 3: kastellani87 (big blind) folded on the Flop
Seat 4: BB_dont_cry folded before Flop (didn't bet)
Seat 5: 3DMINSK folded before Flop (didn't bet)
Seat 6: StudentRB folded before Flop (didn't bet)
Seat 7: Pablo1405 folded before Flop (didn't bet)
Seat 8: SENSAS1AN collected ($31.35)



PokerStars Hand #228692667712:  Hold'em No Limit ($0.25/$0.50 USD) - 2021/07/30 19:08:20 ET
Table 'Gorgo III' 9-max Seat #2 is the button
Seat 2: FeersPoker ($76.62 in chips) 
Seat 3: kastellani87 ($111.59 in chips) 
Seat 4: BB_dont_cry ($59.43 in chips) 
Seat 5: 3DMINSK ($50 in chips) 
Seat 6: StudentRB ($50.61 in chips) 
Seat 7: Pablo1405 ($75.66 in chips) 
Seat 8: SENSAS1AN ($65.60 in chips) 
kastellani87: posts small blind $0.25
BB_dont_cry: posts big blind $0.50
Pachebrash: sits out 
*** HOLE CARDS ***
3DMINSK: folds 
StudentRB: folds 
Pablo1405: folds 
SENSAS1AN: calls $0.50
FeersPoker: folds 
kastellani87: calls $0.25
BB_dont_cry: checks 
*** FLOP *** [3d Qd Js]
kastellani87: checks 
BB_dont_cry: bets $1.42
SENSAS1AN: folds 
kastellani87: folds 
Uncalled bet ($1.42) returned to BB_dont_cry
BB_dont_cry collected $1.42 from pot
*** SUMMARY ***
Total pot $1.50 | Rake $0.08 
Board [3d Qd Js]
Seat 2: FeersPoker (button) folded before Flop (didn't bet)
Seat 3: kastellani87 (small blind) folded on the Flop
Seat 4: BB_dont_cry (big blind) collected ($1.42)
Seat 5: 3DMINSK folded before Flop (didn't bet)
Seat 6: StudentRB folded before Flop (didn't bet)
Seat 7: Pablo1405 folded before Flop (didn't bet)
Seat 8: SENSAS1AN folded on the Flop



PokerStars Hand #228692679447:  Hold'em No Limit ($0.25/$0.50 USD) - 2021/07/30 19:08:52 ET
Table 'Gorgo III' 9-max Seat #3 is the button
Seat 1: Antoxa970 ($21.97 in chips) 
Seat 2: FeersPoker ($76.62 in chips) 
Seat 3: kastellani87 ($111.09 in chips) 
Seat 4: BB_dont_cry ($60.35 in chips) 
Seat 5: 3DMINSK ($50 in chips) 
Seat 6: StudentRB ($50.61 in chips) 
Seat 7: Pablo1405 ($75.66 in chips) 
Seat 8: SENSAS1AN ($65.10 in chips) 
BB_dont_cry: posts small blind $0.25
3DMINSK: posts big blind $0.50
Pachebrash: sits out 
*** HOLE CARDS ***
StudentRB: folds 
Pablo1405: folds 
SENSAS1AN: folds 
Antoxa970: folds 
FeersPoker: raises $0.75 to $1.25
kastellani87: calls $1.25
BB_dont_cry: folds 
3DMINSK: folds 
*** FLOP *** [2s 3h 4c]
FeersPoker: bets $1.02
kastellani87: calls $1.02
*** TURN *** [2s 3h 4c] [4s]
FeersPoker: checks 
kastellani87: checks 
*** RIVER *** [2s 3h 4c 4s] [6s]
FeersPoker: bets $3.02
kastellani87: calls $3.02
*** SHOW DOWN ***
FeersPoker: shows [9d 8d] (a pair of Fours)
kastellani87: shows [Js Ac] (a pair of Fours - Ace kicker)
kastellani87 collected $10.76 from pot
*** SUMMARY ***
Total pot $11.33 | Rake $0.57 
Board [2s 3h 4c 4s 6s]
Seat 1: Antoxa970 folded before Flop (didn't bet)
Seat 2: FeersPoker showed [9d 8d] and lost with a pair of Fours
Seat 3: kastellani87 (button) showed [Js Ac] and won ($10.76) with a pair of Fours
Seat 4: BB_dont_cry (small blind) folded before Flop
Seat 5: 3DMINSK (big blind) folded before Flop
Seat 6: StudentRB folded before Flop (didn't bet)
Seat 7: Pablo1405 folded before Flop (didn't bet)
Seat 8: SENSAS1AN folded before Flop (didn't bet)



PokerStars Hand #228692723563:  Hold'em No Limit ($0.25/$0.50 USD) - 2021/07/30 19:10:55 ET
Table 'Gorgo III' 9-max Seat #5 is the button
Seat 1: Antoxa970 ($23.13 in chips) 
Seat 2: FeersPoker ($71.33 in chips) 
Seat 3: kastellani87 ($116.06 in chips) 
Seat 4: BB_dont_cry ($60.10 in chips) 
Seat 5: 3DMINSK ($50 in chips) 
Seat 6: StudentRB ($50.11 in chips) 
Seat 7: Pablo1405 ($75.66 in chips) 
Seat 8: SENSAS1AN ($65.10 in chips) 
StudentRB: posts small blind $0.25
Pablo1405: posts big blind $0.50
Pachebrash: sits out 
*** HOLE CARDS ***
SENSAS1AN: folds 
Antoxa970: calls $0.50
FeersPoker: raises $1.50 to $2
kastellani87: folds 
BB_dont_cry: folds 
3DMINSK: calls $2
StudentRB: folds 
Pablo1405: folds 
Antoxa970: calls $1.50
*** FLOP *** [9c 7h 2s]
Antoxa970: bets $7.16
FeersPoker: folds 
3DMINSK: folds 
Uncalled bet ($7.16) returned to Antoxa970
Antoxa970 collected $6.41 from pot
Antoxa970: doesn't show hand 
*** SUMMARY ***
Total pot $6.75 | Rake $0.34 
Board [9c 7h 2s]
Seat 1: Antoxa970 collected ($6.41)
Seat 2: FeersPoker folded on the Flop
Seat 3: kastellani87 folded before Flop (didn't bet)
Seat 4: BB_dont_cry folded before Flop (didn't bet)
Seat 5: 3DMINSK (button) folded on the Flop
Seat 6: StudentRB (small blind) folded before Flop
Seat 7: Pablo1405 (big blind) folded before Flop
Seat 8: SENSAS1AN folded before Flop (didn't bet)



PokerStars Hand #228692734354:  Hold'em No Limit ($0.25/$0.50 USD) - 2021/07/30 19:11:25 ET
Table 'Gorgo III' 9-max Seat #6 is the button
Seat 1: Antoxa970 ($27.54 in chips) 
Seat 2: FeersPoker ($69.33 in chips) 
Seat 3: kastellani87 ($116.06 in chips) 
Seat 4: BB_dont_cry ($60.10 in chips) 
Seat 5: 3DMINSK ($50 in chips) 
Seat 6: StudentRB ($50 in chips) 
Seat 7: Pablo1405 ($75.16 in chips) 
Seat 8: SENSAS1AN ($65.10 in chips) 
Pablo1405: posts small blind $0.25
SENSAS1AN: posts big blind $0.50
Pachebrash: sits out 
*** HOLE CARDS ***
Antoxa970: calls $0.50
FeersPoker: folds 
kastellani87: folds 
BB_dont_cry: folds 
3DMINSK: folds 
StudentRB: folds 
Pablo1405: folds 
SENSAS1AN: checks 
*** FLOP *** [8s Kh 2d]
SENSAS1AN: checks 
Antoxa970: bets $2.19
SENSAS1AN: folds 
Uncalled bet ($2.19) returned to Antoxa970
Antoxa970 collected $1.19 from pot
Antoxa970: doesn't show hand 
*** SUMMARY ***
Total pot $1.25 | Rake $0.06 
Board [8s Kh 2d]
Seat 1: Antoxa970 collected ($1.19)
Seat 2: FeersPoker folded before Flop (didn't bet)
Seat 3: kastellani87 folded before Flop (didn't bet)
Seat 4: BB_dont_cry folded before Flop (didn't bet)
Seat 5: 3DMINSK folded before Flop (didn't bet)
Seat 6: StudentRB (button) folded before Flop (didn't bet)
Seat 7: Pablo1405 (small blind) folded before Flop
Seat 8: SENSAS1AN (big blind) folded on the Flop



PokerStars Hand #228692742395:  Hold'em No Limit ($0.25/$0.50 USD) - 2021/07/30 19:11:48 ET
Table 'Gorgo III' 9-max Seat #7 is the button
Seat 1: Antoxa970 ($28.23 in chips) 
Seat 2: FeersPoker ($69.33 in chips) 
Seat 3: kastellani87 ($116.06 in chips) 
Seat 4: BB_dont_cry ($60.10 in chips) 
Seat 5: 3DMINSK ($50 in chips) 
Seat 6: StudentRB ($50 in chips) 
Seat 7: Pablo1405 ($74.91 in chips) 
Seat 8: SENSAS1AN ($64.60 in chips) 
Seat 9: Pachebrash ($50.75 in chips) 
SENSAS1AN: posts small blind $0.25
Pachebrash: posts big blind $0.50
*** HOLE CARDS ***
Antoxa970: calls $0.50
FeersPoker: folds 
kastellani87: calls $0.50
BB_dont_cry: folds 
3DMINSK: folds 
StudentRB: raises $1.50 to $2
Pablo1405: folds 
SENSAS1AN: folds 
Pachebrash: folds 
Antoxa970: calls $1.50
kastellani87: folds 
*** FLOP *** [5s Jd Js]
Antoxa970: checks 
StudentRB: bets $1.65
Antoxa970: raises $8.29 to $9.94
StudentRB: calls $8.29
*** TURN *** [5s Jd Js] [As]
Antoxa970: bets $16.29 and is all-in
StudentRB: calls $16.29
*** RIVER *** [5s Jd Js As] [Qs]
*** SHOW DOWN ***
Antoxa970: shows [7c 7h] (two pair, Jacks and Sevens)
StudentRB: shows [Jh Ac] (a full house, Jacks full of Aces)
StudentRB collected $55.71 from pot
*** SUMMARY ***
Total pot $57.71 | Rake $2 
Board [5s Jd Js As Qs]
Seat 1: Antoxa970 showed [7c 7h] and lost with two pair, Jacks and Sevens
Seat 2: FeersPoker folded before Flop (didn't bet)
Seat 3: kastellani87 folded before Flop
Seat 4: BB_dont_cry folded before Flop (didn't bet)
Seat 5: 3DMINSK folded before Flop (didn't bet)
Seat 6: StudentRB showed [Jh Ac] and won ($55.71) with a full house, Jacks full of Aces
Seat 7: Pablo1405 (button) folded before Flop (didn't bet)
Seat 8: SENSAS1AN (small blind) folded before Flop
Seat 9: Pachebrash (big blind) folded before Flop



PokerStars Hand #228692762175:  Hold'em No Limit ($0.25/$0.50 USD) - 2021/07/30 19:12:43 ET
Table 'Gorgo III' 9-max Seat #8 is the button
Seat 2: FeersPoker ($69.33 in chips) 
Seat 3: kastellani87 ($115.56 in chips) 
Seat 4: BB_dont_cry ($60.10 in chips) 
Seat 5: 3DMINSK ($50 in chips) 
Seat 6: StudentRB ($77.48 in chips) 
Seat 7: Pablo1405 ($74.91 in chips) 
Seat 8: SENSAS1AN ($64.35 in chips) 
Seat 9: Pachebrash ($50.25 in chips) 
Pachebrash: posts small blind $0.25
FeersPoker: posts big blind $0.50
*** HOLE CARDS ***
kastellani87: folds 
BB_dont_cry: folds 
3DMINSK: folds 
StudentRB: folds 
Pablo1405: folds 
SENSAS1AN: folds 
Antoxa970 leaves the table
Pachebrash: folds 
Uncalled bet ($0.25) returned to FeersPoker
FeersPoker collected $0.50 from pot
FeersPoker: doesn't show hand 
*** SUMMARY ***
Total pot $0.50 | Rake $0 
Seat 2: FeersPoker (big blind) collected ($0.50)
Seat 3: kastellani87 folded before Flop (didn't bet)
Seat 4: BB_dont_cry folded before Flop (didn't bet)
Seat 5: 3DMINSK folded before Flop (didn't bet)
Seat 6: StudentRB folded before Flop (didn't bet)
Seat 7: Pablo1405 folded before Flop (didn't bet)
Seat 8: SENSAS1AN (button) folded before Flop (didn't bet)
Seat 9: Pachebrash (small blind) folded before Flop



PokerStars Hand #228692767891:  Hold'em No Limit ($0.25/$0.50 USD) - 2021/07/30 19:12:59 ET
Table 'Gorgo III' 9-max Seat #9 is the button
Seat 2: FeersPoker ($69.58 in chips) 
Seat 3: kastellani87 ($115.56 in chips) 
Seat 4: BB_dont_cry ($60.10 in chips) 
Seat 5: 3DMINSK ($50 in chips) 
Seat 6: StudentRB ($77.48 in chips) 
Seat 7: Pablo1405 ($74.91 in chips) 
Seat 8: SENSAS1AN ($64.35 in chips) 
Seat 9: Pachebrash ($50 in chips) 
FeersPoker: posts small blind $0.25
kastellani87: posts big blind $0.50
*** HOLE CARDS ***
BB_dont_cry: folds 
3DMINSK: folds 
StudentRB: folds 
Pablo1405: raises $0.75 to $1.25
SENSAS1AN: folds 
Pachebrash: folds 
FeersPoker: folds 
kastellani87: raises $4.75 to $6
Pablo1405: folds 
Uncalled bet ($4.75) returned to kastellani87
kastellani87 collected $2.75 from pot
kastellani87: doesn't show hand 
*** SUMMARY ***
Total pot $2.75 | Rake $0 
Seat 2: FeersPoker (small blind) folded before Flop
Seat 3: kastellani87 (big blind) collected ($2.75)
Seat 4: BB_dont_cry folded before Flop (didn't bet)
Seat 5: 3DMINSK folded before Flop (didn't bet)
Seat 6: StudentRB folded before Flop (didn't bet)
Seat 7: Pablo1405 folded before Flop
Seat 8: SENSAS1AN folded before Flop (didn't bet)
Seat 9: Pachebrash (button) folded before Flop (didn't bet)



PokerStars Hand #228692777444:  Hold'em No Limit ($0.25/$0.50 USD) - 2021/07/30 19:13:26 ET
Table 'Gorgo III' 9-max Seat #2 is the button
Seat 2: FeersPoker ($69.33 in chips) 
Seat 3: kastellani87 ($117.06 in chips) 
Seat 4: BB_dont_cry ($60.10 in chips) 
Seat 5: 3DMINSK ($50 in chips) 
Seat 6: StudentRB ($77.48 in chips) 
Seat 7: Pablo1405 ($73.66 in chips) 
Seat 8: SENSAS1AN ($64.35 in chips) 
Seat 9: Pachebrash ($50 in chips) 
kastellani87: posts small blind $0.25
BB_dont_cry: posts big blind $0.50
*** HOLE CARDS ***
3DMINSK: folds 
StudentRB: folds 
Pablo1405: folds 
SENSAS1AN: folds 
Pachebrash: folds 
FeersPoker: raises $0.75 to $1.25
kastellani87: calls $1
BB_dont_cry: raises $5.25 to $6.50
FeersPoker: folds 
kastellani87: folds 
Uncalled bet ($5.25) returned to BB_dont_cry
BB_dont_cry collected $3.75 from pot
*** SUMMARY ***
Total pot $3.75 | Rake $0 
Seat 2: FeersPoker (button) folded before Flop
Seat 3: kastellani87 (small blind) folded before Flop
Seat 4: BB_dont_cry (big blind) collected ($3.75)
Seat 5: 3DMINSK folded before Flop (didn't bet)
Seat 6: StudentRB folded before Flop (didn't bet)
Seat 7: Pablo1405 folded before Flop (didn't bet)
Seat 8: SENSAS1AN folded before Flop (didn't bet)
Seat 9: Pachebrash folded before Flop (didn't bet)



PokerStars Hand #228692791794:  Hold'em No Limit ($0.25/$0.50 USD) - 2021/07/30 19:14:07 ET
Table 'Gorgo III' 9-max Seat #3 is the button
Seat 2: FeersPoker ($68.08 in chips) 
Seat 3: kastellani87 ($115.81 in chips) 
Seat 4: BB_dont_cry ($62.60 in chips) 
Seat 5: 3DMINSK ($50 in chips) 
Seat 6: StudentRB ($77.48 in chips) 
Seat 7: Pablo1405 ($73.66 in chips) 
Seat 8: SENSAS1AN ($64.35 in chips) 
Seat 9: Pachebrash ($50 in chips) 
BB_dont_cry: posts small blind $0.25
3DMINSK: posts big blind $0.50
*** HOLE CARDS ***
StudentRB: folds 
Pablo1405: folds 
SENSAS1AN: folds 
Pachebrash: raises $1 to $1.50
FeersPoker: folds 
kastellani87: folds 
BB_dont_cry: folds 
3DMINSK: folds 
Uncalled bet ($1) returned to Pachebrash
Pachebrash collected $1.25 from pot
Pachebrash: doesn't show hand 
*** SUMMARY ***
Total pot $1.25 | Rake $0 
Seat 2: FeersPoker folded before Flop (didn't bet)
Seat 3: kastellani87 (button) folded before Flop (didn't bet)
Seat 4: BB_dont_cry (small blind) folded before Flop
Seat 5: 3DMINSK (big blind) folded before Flop
Seat 6: StudentRB folded before Flop (didn't bet)
Seat 7: Pablo1405 folded before Flop (didn't bet)
Seat 8: SENSAS1AN folded before Flop (didn't bet)
Seat 9: Pachebrash collected ($1.25)



PokerStars Hand #228692798182:  Hold'em No Limit ($0.25/$0.50 USD) - 2021/07/30 19:14:25 ET
Table 'Gorgo III' 9-max Seat #4 is the button
Seat 2: FeersPoker ($68.08 in chips) 
Seat 3: kastellani87 ($115.81 in chips) 
Seat 4: BB_dont_cry ($62.35 in chips) 
Seat 5: 3DMINSK ($50 in chips) 
Seat 6: StudentRB ($77.48 in chips) 
Seat 7: Pablo1405 ($73.66 in chips) 
Seat 8: SENSAS1AN ($64.35 in chips) 
Seat 9: Pachebrash ($50.75 in chips) 
3DMINSK: posts small blind $0.25
StudentRB: posts big blind $0.50
*** HOLE CARDS ***
Pablo1405: folds 
SENSAS1AN: folds 
Pachebrash: folds 
FeersPoker: folds 
kastellani87: folds 
BB_dont_cry: folds 
3DMINSK: raises $0.75 to $1.25
Kolyan2114 joins the table at seat #1 
StudentRB: raises $2.25 to $3.50
3DMINSK: folds 
Uncalled bet ($2.25) returned to StudentRB
StudentRB collected $2.50 from pot
StudentRB: doesn't show hand 
*** SUMMARY ***
Total pot $2.50 | Rake $0 
Seat 2: FeersPoker folded before Flop (didn't bet)
Seat 3: kastellani87 folded before Flop (didn't bet)
Seat 4: BB_dont_cry (button) folded before Flop (didn't bet)
Seat 5: 3DMINSK (small blind) folded before Flop
Seat 6: StudentRB (big blind) collected ($2.50)
Seat 7: Pablo1405 folded before Flop (didn't bet)
Seat 8: SENSAS1AN folded before Flop (didn't bet)
Seat 9: Pachebrash folded before Flop (didn't bet)



PokerStars Hand #228692806509:  Hold'em No Limit ($0.25/$0.50 USD) - 2021/07/30 19:14:49 ET
Table 'Gorgo III' 9-max Seat #5 is the button
Seat 2: FeersPoker ($68.08 in chips) 
Seat 3: kastellani87 ($115.81 in chips) 
Seat 4: BB_dont_cry ($62.35 in chips) 
Seat 5: 3DMINSK ($50 in chips) 
Seat 6: StudentRB ($78.73 in chips) 
Seat 7: Pablo1405 ($73.66 in chips) 
Seat 8: SENSAS1AN ($64.35 in chips) 
Seat 9: Pachebrash ($50.75 in chips) 
StudentRB: posts small blind $0.25
Pablo1405: posts big blind $0.50
Kolyan2114: sits out 
*** HOLE CARDS ***
SENSAS1AN: calls $0.50
Pachebrash: folds 
FeersPoker: folds 
kastellani87: folds 
BB_dont_cry: raises $1.75 to $2.25
3DMINSK: folds 
StudentRB: folds 
Pablo1405: folds 
SENSAS1AN: calls $1.75
*** FLOP *** [Ad 8h 6c]
SENSAS1AN: checks 
BB_dont_cry: checks 
*** TURN *** [Ad 8h 6c] [Qs]
SENSAS1AN: bets $3.33
BB_dont_cry: raises $5.17 to $8.50
SENSAS1AN: folds 
Uncalled bet ($5.17) returned to BB_dont_cry
BB_dont_cry collected $11.31 from pot
*** SUMMARY ***
Total pot $11.91 | Rake $0.60 
Board [Ad 8h 6c Qs]
Seat 2: FeersPoker folded before Flop (didn't bet)
Seat 3: kastellani87 folded before Flop (didn't bet)
Seat 4: BB_dont_cry collected ($11.31)
Seat 5: 3DMINSK (button) folded before Flop (didn't bet)
Seat 6: StudentRB (small blind) folded before Flop
Seat 7: Pablo1405 (big blind) folded before Flop
Seat 8: SENSAS1AN folded on the Turn
Seat 9: Pachebrash folded before Flop (didn't bet)



PokerStars Hand #228692835060:  Hold'em No Limit ($0.25/$0.50 USD) - 2021/07/30 19:16:10 ET
Table 'Gorgo III' 9-max Seat #6 is the button
Seat 2: FeersPoker ($68.08 in chips) 
Seat 3: kastellani87 ($115.81 in chips) 
Seat 4: BB_dont_cry ($68.08 in chips) 
Seat 5: 3DMINSK ($50 in chips) 
Seat 6: StudentRB ($78.48 in chips) 
Seat 7: Pablo1405 ($73.16 in chips) 
Seat 8: SENSAS1AN ($58.77 in chips) 
Seat 9: Pachebrash ($50.75 in chips) 
Pablo1405: posts small blind $0.25
SENSAS1AN: posts big blind $0.50
Kolyan2114: sits out 
*** HOLE CARDS ***
Pachebrash: folds 
FeersPoker: folds 
kastellani87: calls $0.50
BB_dont_cry: folds 
3DMINSK: folds 
StudentRB: raises $1 to $1.50
Pablo1405: folds 
SENSAS1AN: raises $4 to $5.50
kastellani87: folds 
StudentRB: folds 
Uncalled bet ($4) returned to SENSAS1AN
SENSAS1AN collected $3.75 from pot
SENSAS1AN: doesn't show hand 
*** SUMMARY ***
Total pot $3.75 | Rake $0 
Seat 2: FeersPoker folded before Flop (didn't bet)
Seat 3: kastellani87 folded before Flop
Seat 4: BB_dont_cry folded before Flop (didn't bet)
Seat 5: 3DMINSK folded before Flop (didn't bet)
Seat 6: StudentRB (button) folded before Flop
Seat 7: Pablo1405 (small blind) folded before Flop
Seat 8: SENSAS1AN (big blind) collected ($3.75)
Seat 9: Pachebrash folded before Flop (didn't bet)



PokerStars Hand #228692855330:  Hold'em No Limit ($0.25/$0.50 USD) - 2021/07/30 19:17:09 ET
Table 'Gorgo III' 9-max Seat #8 is the button
Seat 1: Kolyan2114 ($50.45 in chips) 
Seat 2: pudge.3096 ($50 in chips) 
Seat 3: kastellani87 ($115.31 in chips) 
Seat 4: BB_dont_cry ($68.08 in chips) 
Seat 5: 3DMINSK ($50 in chips) 
Seat 6: StudentRB ($76.98 in chips) 
Seat 7: Pablo1405 ($72.91 in chips) 
Seat 8: SENSAS1AN ($60.52 in chips) 
Kolyan2114: posts small blind $0.25
pudge.3096: posts big blind $0.50
*** HOLE CARDS ***
kastellani87: calls $0.50
BB_dont_cry: folds 
3DMINSK: folds 
StudentRB: raises $2 to $2.50
Pablo1405: folds 
SENSAS1AN: folds 
Kolyan2114: folds 
pudge.3096: folds 
kastellani87: calls $2
*** FLOP *** [Kh 8c Js]
kastellani87: checks 
StudentRB: checks 
*** TURN *** [Kh 8c Js] [6s]
kastellani87: checks 
StudentRB: checks 
*** RIVER *** [Kh 8c Js 6s] [As]
kastellani87: bets $5.46
StudentRB: folds 
Uncalled bet ($5.46) returned to kastellani87
kastellani87 collected $5.46 from pot
kastellani87: doesn't show hand 
*** SUMMARY ***
Total pot $5.75 | Rake $0.29 
Board [Kh 8c Js 6s As]
Seat 1: Kolyan2114 (small blind) folded before Flop
Seat 2: pudge.3096 (big blind) folded before Flop
Seat 3: kastellani87 collected ($5.46)
Seat 4: BB_dont_cry folded before Flop (didn't bet)
Seat 5: 3DMINSK folded before Flop (didn't bet)
Seat 6: StudentRB folded on the River
Seat 7: Pablo1405 folded before Flop (didn't bet)
Seat 8: SENSAS1AN (button) folded before Flop (didn't bet)



PokerStars Hand #228692877880:  Hold'em No Limit ($0.25/$0.50 USD) - 2021/07/30 19:18:13 ET
Table 'Gorgo III' 9-max Seat #1 is the button
Seat 1: Kolyan2114 ($50.20 in chips) 
Seat 2: pudge.3096 ($50 in chips) 
Seat 3: kastellani87 ($118.27 in chips) 
Seat 4: BB_dont_cry ($68.08 in chips) 
Seat 5: 3DMINSK ($50 in chips) 
Seat 6: StudentRB ($74.48 in chips) 
Seat 7: Pablo1405 ($72.91 in chips) 
Seat 8: SENSAS1AN ($60.52 in chips) 
pudge.3096: posts small blind $0.25
kastellani87: posts big blind $0.50
*** HOLE CARDS ***
BB_dont_cry: folds 
3DMINSK: folds 
StudentRB: folds 
Pablo1405: folds 
SENSAS1AN: folds 
Kolyan2114: raises $0.75 to $1.25
pudge.3096: folds 
kastellani87: folds 
Uncalled bet ($0.75) returned to Kolyan2114
Kolyan2114 collected $1.25 from pot
*** SUMMARY ***
Total pot $1.25 | Rake $0 
Seat 1: Kolyan2114 (button) collected ($1.25)
Seat 2: pudge.3096 (small blind) folded before Flop
Seat 3: kastellani87 (big blind) folded before Flop
Seat 4: BB_dont_cry folded before Flop (didn't bet)
Seat 5: 3DMINSK folded before Flop (didn't bet)
Seat 6: StudentRB folded before Flop (didn't bet)
Seat 7: Pablo1405 folded before Flop (didn't bet)
Seat 8: SENSAS1AN folded before Flop (didn't bet)



PokerStars Hand #228692883401:  Hold'em No Limit ($0.25/$0.50 USD) - 2021/07/30 19:18:29 ET
Table 'Gorgo III' 9-max Seat #2 is the button
Seat 1: Kolyan2114 ($50.95 in chips) 
Seat 2: pudge.3096 ($50 in chips) 
Seat 3: kastellani87 ($117.77 in chips) 
Seat 4: BB_dont_cry ($68.08 in chips) 
Seat 5: 3DMINSK ($50 in chips) 
Seat 6: StudentRB ($74.48 in chips) 
Seat 7: Pablo1405 ($72.91 in chips) 
Seat 8: SENSAS1AN ($60.52 in chips) 
kastellani87: posts small blind $0.25
BB_dont_cry: posts big blind $0.50
*** HOLE CARDS ***
3DMINSK: folds 
StudentRB: folds 
Pablo1405: folds 
SENSAS1AN: folds 
Kolyan2114: folds 
pudge.3096: folds 
kastellani87: calls $0.25
BB_dont_cry: checks 
*** FLOP *** [5s 8d 2c]
kastellani87: checks 
BB_dont_cry: bets $0.95
kastellani87: folds 
Uncalled bet ($0.95) returned to BB_dont_cry
BB_dont_cry collected $0.95 from pot
Myles96 joins the table at seat #9 
*** SUMMARY ***
Total pot $1 | Rake $0.05 
Board [5s 8d 2c]
Seat 1: Kolyan2114 folded before Flop (didn't bet)
Seat 2: pudge.3096 (button) folded before Flop (didn't bet)
Seat 3: kastellani87 (small blind) folded on the Flop
Seat 4: BB_dont_cry (big blind) collected ($0.95)
Seat 5: 3DMINSK folded before Flop (didn't bet)
Seat 6: StudentRB folded before Flop (didn't bet)
Seat 7: Pablo1405 folded before Flop (didn't bet)
Seat 8: SENSAS1AN folded before Flop (didn't bet)



PokerStars Hand #228692891933:  Hold'em No Limit ($0.25/$0.50 USD) - 2021/07/30 19:18:54 ET
Table 'Gorgo III' 9-max Seat #3 is the button
Seat 1: Kolyan2114 ($50.95 in chips) 
Seat 2: pudge.3096 ($50 in chips) 
Seat 3: kastellani87 ($117.27 in chips) 
Seat 4: BB_dont_cry ($68.53 in chips) 
Seat 5: 3DMINSK ($50 in chips) 
Seat 6: StudentRB ($74.48 in chips) 
Seat 7: Pablo1405 ($72.91 in chips) 
Seat 8: SENSAS1AN ($60.52 in chips) 
Seat 9: Myles96 ($20 in chips) 
BB_dont_cry: posts small blind $0.25
3DMINSK: posts big blind $0.50
Myles96 is connected 
Myles96: posts big blind $0.50
*** HOLE CARDS ***
StudentRB: folds 
Pablo1405: folds 
SENSAS1AN: folds 
Myles96: checks 
Kolyan2114: raises $1.50 to $2
pudge.3096: calls $2
kastellani87: folds 
BB_dont_cry: folds 
3DMINSK: folds 
Myles96: folds 
*** FLOP *** [7h Ac 4h]
Kolyan2114: checks 
pudge.3096: bets $2.59
Kolyan2114: folds 
Uncalled bet ($2.59) returned to pudge.3096
pudge.3096 collected $4.99 from pot
pudge.3096: doesn't show hand 
*** SUMMARY ***
Total pot $5.25 | Rake $0.26 
Board [7h Ac 4h]
Seat 1: Kolyan2114 folded on the Flop
Seat 2: pudge.3096 collected ($4.99)
Seat 3: kastellani87 (button) folded before Flop (didn't bet)
Seat 4: BB_dont_cry (small blind) folded before Flop
Seat 5: 3DMINSK (big blind) folded before Flop
Seat 6: StudentRB folded before Flop (didn't bet)
Seat 7: Pablo1405 folded before Flop (didn't bet)
Seat 8: SENSAS1AN folded before Flop (didn't bet)
Seat 9: Myles96 folded before Flop (didn't bet)



PokerStars Hand #228692905079:  Hold'em No Limit ($0.25/$0.50 USD) - 2021/07/30 19:19:31 ET
Table 'Gorgo III' 9-max Seat #4 is the button
Seat 1: Kolyan2114 ($50 in chips) 
Seat 2: pudge.3096 ($52.99 in chips) 
Seat 3: kastellani87 ($117.27 in chips) 
Seat 4: BB_dont_cry ($68.28 in chips) 
Seat 5: 3DMINSK ($50 in chips) 
Seat 6: StudentRB ($74.48 in chips) 
Seat 7: Pablo1405 ($72.91 in chips) 
Seat 8: SENSAS1AN ($60.52 in chips) 
Seat 9: Myles96 ($19.50 in chips) 
3DMINSK: posts small blind $0.25
StudentRB: posts big blind $0.50
*** HOLE CARDS ***
Pablo1405: folds 
SENSAS1AN: folds 
Myles96: raises $1.25 to $1.75
Kolyan2114: calls $1.75
pudge.3096: folds 
kastellani87: folds 
BB_dont_cry: calls $1.75
3DMINSK: calls $1.50
StudentRB: raises $9.25 to $11
Myles96: raises $8.50 to $19.50 and is all-in
Kolyan2114: folds 
BB_dont_cry: folds 
3DMINSK: folds 
StudentRB: calls $8.50
Myles96:  
StudentRB:  
*** FLOP *** [9d Qh 5h]
*** TURN *** [9d Qh 5h] [Jd]
*** RIVER *** [9d Qh 5h Jd] [4d]
*** SHOW DOWN ***
StudentRB: shows [Kd Ks] (a pair of Kings)
Myles96: shows [6h 6d] (a pair of Sixes)
StudentRB collected $42.25 from pot
*** SUMMARY ***
Total pot $44.25 | Rake $2 
Board [9d Qh 5h Jd 4d]
Seat 1: Kolyan2114 folded before Flop
Seat 2: pudge.3096 folded before Flop (didn't bet)
Seat 3: kastellani87 folded before Flop (didn't bet)
Seat 4: BB_dont_cry (button) folded before Flop
Seat 5: 3DMINSK (small blind) folded before Flop
Seat 6: StudentRB (big blind) showed [Kd Ks] and won ($42.25) with a pair of Kings
Seat 7: Pablo1405 folded before Flop (didn't bet)
Seat 8: SENSAS1AN folded before Flop (didn't bet)
Seat 9: Myles96 showed [6h 6d] and lost with a pair of Sixes



PokerStars Hand #228692989118:  Hold'em No Limit ($0.25/$0.50 USD) - 2021/07/30 19:23:21 ET
Table 'Gorgo III' 9-max Seat #3 is the button
Seat 2: pudge.3096 ($52.24 in chips) 
Seat 3: kastellani87 ($123.49 in chips) 
Seat 4: BB_dont_cry ($64.94 in chips) 
Seat 5: 3DMINSK ($50 in chips) 
Seat 6: StudentRB ($96.98 in chips) 
Seat 7: Pablo1405 ($74.16 in chips) 
Seat 8: SENSAS1AN ($59.77 in chips) 
BB_dont_cry: posts small blind $0.25
3DMINSK: posts big blind $0.50
doucwhatic: sits out 
PanicJX: sits out 
*** HOLE CARDS ***
StudentRB: folds 
Pablo1405: folds 
SENSAS1AN: folds 
pudge.3096: folds 
kastellani87: folds 
BB_dont_cry: calls $0.25
3DMINSK: checks 
*** FLOP *** [Ts 8s 9s]
BB_dont_cry: checks 
3DMINSK: bets $0.50
BB_dont_cry: folds 
Uncalled bet ($0.50) returned to 3DMINSK
3DMINSK collected $0.95 from pot
3DMINSK: doesn't show hand 
*** SUMMARY ***
Total pot $1 | Rake $0.05 
Board [Ts 8s 9s]
Seat 2: pudge.3096 folded before Flop (didn't bet)
Seat 3: kastellani87 (button) folded before Flop (didn't bet)
Seat 4: BB_dont_cry (small blind) folded on the Flop
Seat 5: 3DMINSK (big blind) collected ($0.95)
Seat 6: StudentRB folded before Flop (didn't bet)
Seat 7: Pablo1405 folded before Flop (didn't bet)
Seat 8: SENSAS1AN folded before Flop (didn't bet)



PokerStars Hand #228692996762:  Hold'em No Limit ($0.25/$0.50 USD) - 2021/07/30 19:23:43 ET
Table 'Gorgo III' 9-max Seat #4 is the button
Seat 2: pudge.3096 ($52.24 in chips) 
Seat 3: kastellani87 ($123.49 in chips) 
Seat 4: BB_dont_cry ($64.44 in chips) 
Seat 5: 3DMINSK ($50.45 in chips) 
Seat 6: StudentRB ($96.98 in chips) 
Seat 7: Pablo1405 ($74.16 in chips) 
Seat 8: SENSAS1AN ($59.77 in chips) 
3DMINSK: posts small blind $0.25
StudentRB: posts big blind $0.50
doucwhatic: sits out 
PanicJX: sits out 
*** HOLE CARDS ***
Pablo1405: folds 
SENSAS1AN: folds 
pudge.3096: raises $0.75 to $1.25
kastellani87: folds 
BB_dont_cry: calls $1.25
3DMINSK: raises $5 to $6.25
StudentRB: folds 
pudge.3096: calls $5
BB_dont_cry: folds 
*** FLOP *** [6s 5s Kh]
3DMINSK: bets $4.06
pudge.3096: folds 
Uncalled bet ($4.06) returned to 3DMINSK
3DMINSK collected $13.54 from pot
3DMINSK: doesn't show hand 
*** SUMMARY ***
Total pot $14.25 | Rake $0.71 
Board [6s 5s Kh]
Seat 2: pudge.3096 folded on the Flop
Seat 3: kastellani87 folded before Flop (didn't bet)
Seat 4: BB_dont_cry (button) folded before Flop
Seat 5: 3DMINSK (small blind) collected ($13.54)
Seat 6: StudentRB (big blind) folded before Flop
Seat 7: Pablo1405 folded before Flop (didn't bet)
Seat 8: SENSAS1AN folded before Flop (didn't bet)



PokerStars Hand #228693015389:  Hold'em No Limit ($0.25/$0.50 USD) - 2021/07/30 19:24:37 ET
Table 'Gorgo III' 9-max Seat #5 is the button
Seat 2: pudge.3096 ($50 in chips) 
Seat 3: kastellani87 ($123.49 in chips) 
Seat 4: BB_dont_cry ($63.19 in chips) 
Seat 5: 3DMINSK ($57.74 in chips) 
Seat 6: StudentRB ($96.48 in chips) 
Seat 7: Pablo1405 ($74.16 in chips) 
Seat 8: SENSAS1AN ($59.77 in chips) 
StudentRB: posts small blind $0.25
Pablo1405: posts big blind $0.50
doucwhatic: sits out 
PanicJX: sits out 
*** HOLE CARDS ***
SENSAS1AN: folds 
pudge.3096: folds 
kastellani87: folds 
BB_dont_cry: folds 
3DMINSK: folds 
StudentRB: folds 
Uncalled bet ($0.25) returned to Pablo1405
Pablo1405 collected $0.50 from pot
SENSAS1AN leaves the table
Pablo1405: doesn't show hand 
*** SUMMARY ***
Total pot $0.50 | Rake $0 
Seat 2: pudge.3096 folded before Flop (didn't bet)
Seat 3: kastellani87 folded before Flop (didn't bet)
Seat 4: BB_dont_cry folded before Flop (didn't bet)
Seat 5: 3DMINSK (button) folded before Flop (didn't bet)
Seat 6: StudentRB (small blind) folded before Flop
Seat 7: Pablo1405 (big blind) collected ($0.50)
Seat 8: SENSAS1AN folded before Flop (didn't bet)



PokerStars Hand #228693020807:  Hold'em No Limit ($0.25/$0.50 USD) - 2021/07/30 19:24:53 ET
Table 'Gorgo III' 9-max Seat #6 is the button
Seat 2: pudge.3096 ($50 in chips) 
Seat 3: kastellani87 ($123.49 in chips) 
Seat 4: BB_dont_cry ($63.19 in chips) 
Seat 5: 3DMINSK ($57.74 in chips) 
Seat 6: StudentRB ($96.23 in chips) 
Seat 7: Pablo1405 ($74.41 in chips) 
Seat 9: doucwhatic ($43.75 in chips) 
Pablo1405: posts small blind $0.25
doucwhatic: posts big blind $0.50
PanicJX: sits out 
*** HOLE CARDS ***
pudge.3096: raises $0.75 to $1.25
kastellani87: folds 
BB_dont_cry: folds 
3DMINSK: folds 
StudentRB: folds 
Pablo1405: raises $3.25 to $4.50
doucwhatic: folds 
pudge.3096: folds 
Uncalled bet ($3.25) returned to Pablo1405
Pablo1405 collected $3 from pot
Pablo1405: doesn't show hand 
*** SUMMARY ***
Total pot $3 | Rake $0 
Seat 2: pudge.3096 folded before Flop
Seat 3: kastellani87 folded before Flop (didn't bet)
Seat 4: BB_dont_cry folded before Flop (didn't bet)
Seat 5: 3DMINSK folded before Flop (didn't bet)
Seat 6: StudentRB (button) folded before Flop (didn't bet)
Seat 7: Pablo1405 (small blind) collected ($3)
Seat 9: doucwhatic (big blind) folded before Flop



PokerStars Hand #228693031201:  Hold'em No Limit ($0.25/$0.50 USD) - 2021/07/30 19:25:23 ET
Table 'Gorgo III' 9-max Seat #7 is the button
Seat 1: PanicJX ($50 in chips) 
Seat 2: pudge.3096 ($50 in chips) 
Seat 3: kastellani87 ($123.49 in chips) 
Seat 4: BB_dont_cry ($63.19 in chips) 
Seat 5: 3DMINSK ($57.74 in chips) 
Seat 6: StudentRB ($96.23 in chips) 
Seat 7: Pablo1405 ($76.16 in chips) 
Seat 9: doucwhatic ($43.25 in chips) 
doucwhatic: posts small blind $0.25
PanicJX: posts big blind $0.50
*** HOLE CARDS ***
pudge.3096: folds 
kastellani87: calls $0.50
BB_dont_cry: folds 
3DMINSK: folds 
StudentRB: folds 
Pablo1405: folds 
doucwhatic: folds 
PanicJX: checks 
*** FLOP *** [3d 8c Jh]
wildermorph joins the table at seat #8 
PanicJX: checks 
kastellani87: bets $1.19
PanicJX: folds 
Uncalled bet ($1.19) returned to kastellani87
kastellani87 collected $1.19 from pot
kastellani87: doesn't show hand 
*** SUMMARY ***
Total pot $1.25 | Rake $0.06 
Board [3d 8c Jh]
Seat 1: PanicJX (big blind) folded on the Flop
Seat 2: pudge.3096 folded before Flop (didn't bet)
Seat 3: kastellani87 collected ($1.19)
Seat 4: BB_dont_cry folded before Flop (didn't bet)
Seat 5: 3DMINSK folded before Flop (didn't bet)
Seat 6: StudentRB folded before Flop (didn't bet)
Seat 7: Pablo1405 (button) folded before Flop (didn't bet)
Seat 9: doucwhatic (small blind) folded before Flop



PokerStars Hand #228691828230:  Hold'em No Limit ($0.25/$0.50 USD) - 2021/07/30 18:31:44 ET
Table 'Gorgo III' 9-max Seat #5 is the button
Seat 1: ms1272 ($78.33 in chips) 
Seat 2: FeersPoker ($50 in chips) 
Seat 3: kastellani87 ($48.07 in chips) 
Seat 4: rasku91 ($70.81 in chips) 
Seat 5: 3DMINSK ($50 in chips) 
Seat 6: StudentRB ($50 in chips) 
Seat 7: Pablo1405 ($59.34 in chips) 
Seat 8: SENSAS1AN ($55.09 in chips) 
StudentRB: posts small blind $0.25
Pablo1405: posts big blind $0.50
*** HOLE CARDS ***
SENSAS1AN: folds 
ms1272: folds 
FeersPoker: folds 
kastellani87: calls $0.50
rasku91: raises $1.50 to $2
3DMINSK: folds 
StudentRB: folds 
Pablo1405: folds 
kastellani87: calls $1.50
*** FLOP *** [As 7s Ah]
kastellani87: checks 
rasku91: bets $2.26
kastellani87: folds 
Uncalled bet ($2.26) returned to rasku91
rasku91 collected $4.51 from pot
rasku91: doesn't show hand 
*** SUMMARY ***
Total pot $4.75 | Rake $0.24 
Board [As 7s Ah]
Seat 1: ms1272 folded before Flop (didn't bet)
Seat 2: FeersPoker folded before Flop (didn't bet)
Seat 3: kastellani87 folded on the Flop
Seat 4: rasku91 collected ($4.51)
Seat 5: 3DMINSK (button) folded before Flop (didn't bet)
Seat 6: StudentRB (small blind) folded before Flop
Seat 7: Pablo1405 (big blind) folded before Flop
Seat 8: SENSAS1AN folded before Flop (didn't bet)



PokerStars Hand #228691849896:  Hold'em No Limit ($0.25/$0.50 USD) - 2021/07/30 18:32:38 ET
Table 'Gorgo III' 9-max Seat #6 is the button
Seat 1: ms1272 ($78.33 in chips) 
Seat 2: FeersPoker ($50 in chips) 
Seat 3: kastellani87 ($46.07 in chips) 
Seat 4: rasku91 ($73.32 in chips) 
Seat 5: 3DMINSK ($50 in chips) 
Seat 6: StudentRB ($50 in chips) 
Seat 7: Pablo1405 ($58.84 in chips) 
Seat 8: SENSAS1AN ($55.09 in chips) 
Pablo1405: posts small blind $0.25
SENSAS1AN: posts big blind $0.50
*** HOLE CARDS ***
ms1272: raises $0.50 to $1
FeersPoker: folds 
kastellani87: folds 
rasku91: folds 
3DMINSK: folds 
StudentRB: folds 
Pablo1405: folds 
SENSAS1AN: folds 
Uncalled bet ($0.50) returned to ms1272
ms1272 collected $1.25 from pot
ms1272: doesn't show hand 
*** SUMMARY ***
Total pot $1.25 | Rake $0 
Seat 1: ms1272 collected ($1.25)
Seat 2: FeersPoker folded before Flop (didn't bet)
Seat 3: kastellani87 folded before Flop (didn't bet)
Seat 4: rasku91 folded before Flop (didn't bet)
Seat 5: 3DMINSK folded before Flop (didn't bet)
Seat 6: StudentRB (button) folded before Flop (didn't bet)
Seat 7: Pablo1405 (small blind) folded before Flop
Seat 8: SENSAS1AN (big blind) folded before Flop



PokerStars Hand #228691856800:  Hold'em No Limit ($0.25/$0.50 USD) - 2021/07/30 18:32:55 ET
Table 'Gorgo III' 9-max Seat #7 is the button
Seat 1: ms1272 ($79.08 in chips) 
Seat 2: FeersPoker ($50 in chips) 
Seat 3: kastellani87 ($46.07 in chips) 
Seat 4: rasku91 ($73.32 in chips) 
Seat 5: 3DMINSK ($50 in chips) 
Seat 6: StudentRB ($50 in chips) 
Seat 7: Pablo1405 ($58.59 in chips) 
Seat 8: SENSAS1AN ($54.59 in chips) 
SENSAS1AN: posts small blind $0.25
ms1272: posts big blind $0.50
*** HOLE CARDS ***
FeersPoker: folds 
kastellani87: folds 
rasku91: raises $0.50 to $1
3DMINSK: folds 
StudentRB: folds 
Pablo1405: folds 
SENSAS1AN: folds 
ms1272: calls $0.50
*** FLOP *** [3h 6h Kd]
ms1272: checks 
rasku91: bets $1.07
ms1272: folds 
Uncalled bet ($1.07) returned to rasku91
rasku91 collected $2.14 from pot
rasku91: doesn't show hand 
*** SUMMARY ***
Total pot $2.25 | Rake $0.11 
Board [3h 6h Kd]
Seat 1: ms1272 (big blind) folded on the Flop
Seat 2: FeersPoker folded before Flop (didn't bet)
Seat 3: kastellani87 folded before Flop (didn't bet)
Seat 4: rasku91 collected ($2.14)
Seat 5: 3DMINSK folded before Flop (didn't bet)
Seat 6: StudentRB folded before Flop (didn't bet)
Seat 7: Pablo1405 (button) folded before Flop (didn't bet)
Seat 8: SENSAS1AN (small blind) folded before Flop



PokerStars Hand #228691865547:  Hold'em No Limit ($0.25/$0.50 USD) - 2021/07/30 18:33:17 ET
Table 'Gorgo III' 9-max Seat #8 is the button
Seat 1: ms1272 ($78.08 in chips) 
Seat 2: FeersPoker ($50 in chips) 
Seat 3: kastellani87 ($46.07 in chips) 
Seat 4: rasku91 ($74.46 in chips) 
Seat 5: 3DMINSK ($50 in chips) 
Seat 6: StudentRB ($50 in chips) 
Seat 7: Pablo1405 ($58.59 in chips) 
Seat 8: SENSAS1AN ($54.34 in chips) 
ms1272: posts small blind $0.25
FeersPoker: posts big blind $0.50
*** HOLE CARDS ***
kastellani87: folds 
rasku91: raises $0.50 to $1
3DMINSK: folds 
StudentRB: folds 
Pablo1405: folds 
SENSAS1AN: folds 
ms1272: raises $2.50 to $3.50
FeersPoker: folds 
rasku91: calls $2.50
*** FLOP *** [5s 7d 5c]
ms1272: bets $3.56
rasku91: folds 
Uncalled bet ($3.56) returned to ms1272
ms1272 collected $7.02 from pot
ms1272: doesn't show hand 
*** SUMMARY ***
Total pot $7.50 | Rake $0.48 
Board [5s 7d 5c]
Seat 1: ms1272 (small blind) collected ($7.02)
Seat 2: FeersPoker (big blind) folded before Flop
Seat 3: kastellani87 folded before Flop (didn't bet)
Seat 4: rasku91 folded on the Flop
Seat 5: 3DMINSK folded before Flop (didn't bet)
Seat 6: StudentRB folded before Flop (didn't bet)
Seat 7: Pablo1405 folded before Flop (didn't bet)
Seat 8: SENSAS1AN (button) folded before Flop (didn't bet)



PokerStars Hand #228691882069:  Hold'em No Limit ($0.25/$0.50 USD) - 2021/07/30 18:33:47 ET
Table 'Gorgo III' 9-max Seat #1 is the button
Seat 1: ms1272 ($81.60 in chips) 
Seat 2: FeersPoker ($50 in chips) 
Seat 3: kastellani87 ($46.07 in chips) 
Seat 4: rasku91 ($70.96 in chips) 
Seat 5: 3DMINSK ($50 in chips) 
Seat 6: StudentRB ($50 in chips) 
Seat 7: Pablo1405 ($58.59 in chips) 
Seat 8: SENSAS1AN ($54.34 in chips) 
FeersPoker: posts small blind $0.25
kastellani87: posts big blind $0.50
*** HOLE CARDS ***
rasku91: folds 
3DMINSK: folds 
StudentRB: folds 
Pablo1405: folds 
SENSAS1AN: folds 
ms1272: folds 
FeersPoker: calls $0.25
kastellani87: checks 
*** FLOP *** [8c 3s Tc]
FeersPoker: bets $0.57
kastellani87: calls $0.57
*** TURN *** [8c 3s Tc] [Th]
FeersPoker: bets $1.12
kastellani87: folds 
Uncalled bet ($1.12) returned to FeersPoker
FeersPoker collected $2.03 from pot
FeersPoker: doesn't show hand 
*** SUMMARY ***
Total pot $2.14 | Rake $0.11 
Board [8c 3s Tc Th]
Seat 1: ms1272 (button) folded before Flop (didn't bet)
Seat 2: FeersPoker (small blind) collected ($2.03)
Seat 3: kastellani87 (big blind) folded on the Turn
Seat 4: rasku91 folded before Flop (didn't bet)
Seat 5: 3DMINSK folded before Flop (didn't bet)
Seat 6: StudentRB folded before Flop (didn't bet)
Seat 7: Pablo1405 folded before Flop (didn't bet)
Seat 8: SENSAS1AN folded before Flop (didn't bet)



PokerStars Hand #228691902851:  Hold'em No Limit ($0.25/$0.50 USD) - 2021/07/30 18:34:39 ET
Table 'Gorgo III' 9-max Seat #2 is the button
Seat 1: ms1272 ($81.60 in chips) 
Seat 2: FeersPoker ($50.96 in chips) 
Seat 3: kastellani87 ($45 in chips) 
Seat 4: rasku91 ($70.96 in chips) 
Seat 5: 3DMINSK ($50 in chips) 
Seat 6: StudentRB ($50 in chips) 
Seat 7: Pablo1405 ($58.59 in chips) 
Seat 8: SENSAS1AN ($54.34 in chips) 
kastellani87: posts small blind $0.25
rasku91: posts big blind $0.50
*** HOLE CARDS ***
3DMINSK: folds 
StudentRB: folds 
Pablo1405: raises $0.75 to $1.25
SENSAS1AN: calls $1.25
ms1272: folds 
FeersPoker: folds 
kastellani87: folds 
rasku91: calls $0.75
*** FLOP *** [4s 5s Kh]
rasku91: checks 
Pablo1405: bets $1.50
SENSAS1AN: folds 
rasku91: folds 
Uncalled bet ($1.50) returned to Pablo1405
Pablo1405 collected $3.80 from pot
Pablo1405: doesn't show hand 
*** SUMMARY ***
Total pot $4 | Rake $0.20 
Board [4s 5s Kh]
Seat 1: ms1272 folded before Flop (didn't bet)
Seat 2: FeersPoker (button) folded before Flop (didn't bet)
Seat 3: kastellani87 (small blind) folded before Flop
Seat 4: rasku91 (big blind) folded on the Flop
Seat 5: 3DMINSK folded before Flop (didn't bet)
Seat 6: StudentRB folded before Flop (didn't bet)
Seat 7: Pablo1405 collected ($3.80)
Seat 8: SENSAS1AN folded on the Flop



PokerStars Hand #228691920742:  Hold'em No Limit ($0.25/$0.50 USD) - 2021/07/30 18:35:23 ET
Table 'Gorgo III' 9-max Seat #3 is the button
Seat 1: ms1272 ($81.60 in chips) 
Seat 2: FeersPoker ($50.96 in chips) 
Seat 3: kastellani87 ($44.75 in chips) 
Seat 4: rasku91 ($69.71 in chips) 
Seat 5: 3DMINSK ($50 in chips) 
Seat 6: StudentRB ($50 in chips) 
Seat 7: Pablo1405 ($61.14 in chips) 
Seat 8: SENSAS1AN ($53.09 in chips) 
rasku91: posts small blind $0.25
3DMINSK: posts big blind $0.50
*** HOLE CARDS ***
StudentRB: folds 
Pablo1405: folds 
SENSAS1AN: folds 
ms1272: raises $0.50 to $1
FeersPoker: folds 
kastellani87: folds 
rasku91: raises $2.50 to $3.50
3DMINSK: folds 
ms1272: calls $2.50
*** FLOP *** [8s 3d 6d]
rasku91: checks 
ms1272: checks 
*** TURN *** [8s 3d 6d] [Kd]
rasku91: bets $3.56
ms1272: folds 
Uncalled bet ($3.56) returned to rasku91
rasku91 collected $7.12 from pot
rasku91: doesn't show hand 
*** SUMMARY ***
Total pot $7.50 | Rake $0.38 
Board [8s 3d 6d Kd]
Seat 1: ms1272 folded on the Turn
Seat 2: FeersPoker folded before Flop (didn't bet)
Seat 3: kastellani87 (button) folded before Flop (didn't bet)
Seat 4: rasku91 (small blind) collected ($7.12)
Seat 5: 3DMINSK (big blind) folded before Flop
Seat 6: StudentRB folded before Flop (didn't bet)
Seat 7: Pablo1405 folded before Flop (didn't bet)
Seat 8: SENSAS1AN folded before Flop (didn't bet)



PokerStars Hand #228691935763:  Hold'em No Limit ($0.25/$0.50 USD) - 2021/07/30 18:36:01 ET
Table 'Gorgo III' 9-max Seat #4 is the button
Seat 1: ms1272 ($78.10 in chips) 
Seat 2: FeersPoker ($50.96 in chips) 
Seat 3: kastellani87 ($44.75 in chips) 
Seat 4: rasku91 ($73.33 in chips) 
Seat 5: 3DMINSK ($50 in chips) 
Seat 6: StudentRB ($50 in chips) 
Seat 7: Pablo1405 ($61.14 in chips) 
Seat 8: SENSAS1AN ($53.09 in chips) 
3DMINSK: posts small blind $0.25
StudentRB: posts big blind $0.50
*** HOLE CARDS ***
Pablo1405: folds 
SENSAS1AN: folds 
ms1272: folds 
FeersPoker: folds 
kastellani87: folds 
rasku91: folds 
3DMINSK: raises $0.75 to $1.25
StudentRB: calls $0.75
*** FLOP *** [Qs Ac 2s]
3DMINSK: bets $0.71
StudentRB: calls $0.71
*** TURN *** [Qs Ac 2s] [Jh]
3DMINSK: checks 
StudentRB: checks 
*** RIVER *** [Qs Ac 2s Jh] [4s]
3DMINSK: checks 
StudentRB: bets $1.50
3DMINSK: folds 
Uncalled bet ($1.50) returned to StudentRB
StudentRB collected $3.72 from pot
StudentRB: doesn't show hand 
*** SUMMARY ***
Total pot $3.92 | Rake $0.20 
Board [Qs Ac 2s Jh 4s]
Seat 1: ms1272 folded before Flop (didn't bet)
Seat 2: FeersPoker folded before Flop (didn't bet)
Seat 3: kastellani87 folded before Flop (didn't bet)
Seat 4: rasku91 (button) folded before Flop (didn't bet)
Seat 5: 3DMINSK (small blind) folded on the River
Seat 6: StudentRB (big blind) collected ($3.72)
Seat 7: Pablo1405 folded before Flop (didn't bet)
Seat 8: SENSAS1AN folded before Flop (didn't bet)



PokerStars Hand #228691955149:  Hold'em No Limit ($0.25/$0.50 USD) - 2021/07/30 18:36:50 ET
Table 'Gorgo III' 9-max Seat #5 is the button
Seat 1: ms1272 ($78.10 in chips) 
Seat 2: FeersPoker ($50.96 in chips) 
Seat 3: kastellani87 ($44.75 in chips) 
Seat 4: rasku91 ($73.33 in chips) 
Seat 5: 3DMINSK ($50 in chips) 
Seat 6: StudentRB ($51.76 in chips) 
Seat 7: Pablo1405 ($61.14 in chips) 
Seat 8: SENSAS1AN ($53.09 in chips) 
StudentRB: posts small blind $0.25
Pablo1405: posts big blind $0.50
*** HOLE CARDS ***
SENSAS1AN: folds 
ms1272: folds 
FeersPoker: raises $0.75 to $1.25
kastellani87: raises $3.25 to $4.50
rasku91: folds 
3DMINSK: folds 
StudentRB: folds 
Pablo1405: folds 
FeersPoker: folds 
Uncalled bet ($3.25) returned to kastellani87
kastellani87 collected $3.25 from pot
kastellani87: doesn't show hand 
*** SUMMARY ***
Total pot $3.25 | Rake $0 
Seat 1: ms1272 folded before Flop (didn't bet)
Seat 2: FeersPoker folded before Flop
Seat 3: kastellani87 collected ($3.25)
Seat 4: rasku91 folded before Flop (didn't bet)
Seat 5: 3DMINSK (button) folded before Flop (didn't bet)
Seat 6: StudentRB (small blind) folded before Flop
Seat 7: Pablo1405 (big blind) folded before Flop
Seat 8: SENSAS1AN folded before Flop (didn't bet)



PokerStars Hand #228691968961:  Hold'em No Limit ($0.25/$0.50 USD) - 2021/07/30 18:37:25 ET
Table 'Gorgo III' 9-max Seat #6 is the button
Seat 1: ms1272 ($78.10 in chips) 
Seat 2: FeersPoker ($50 in chips) 
Seat 3: kastellani87 ($46.75 in chips) 
Seat 4: rasku91 ($73.33 in chips) 
Seat 5: 3DMINSK ($50 in chips) 
Seat 6: StudentRB ($51.51 in chips) 
Seat 7: Pablo1405 ($60.64 in chips) 
Seat 8: SENSAS1AN ($53.09 in chips) 
Pablo1405: posts small blind $0.25
SENSAS1AN: posts big blind $0.50
fragonik: sits out 
*** HOLE CARDS ***
ms1272: folds 
FeersPoker: folds 
kastellani87: raises $0.50 to $1
rasku91: folds 
3DMINSK: folds 
StudentRB: folds 
Pablo1405: folds 
SENSAS1AN: calls $0.50
*** FLOP *** [5c 9h Th]
SENSAS1AN: checks 
kastellani87: checks 
*** TURN *** [5c 9h Th] [Kc]
SENSAS1AN: checks 
kastellani87: checks 
*** RIVER *** [5c 9h Th Kc] [Ah]
SENSAS1AN: bets $1
kastellani87: raises $4.14 to $5.14
rasku91 leaves the table
SENSAS1AN: folds 
Uncalled bet ($4.14) returned to kastellani87
kastellani87 collected $4.04 from pot
kastellani87: doesn't show hand 
*** SUMMARY ***
Total pot $4.25 | Rake $0.21 
Board [5c 9h Th Kc Ah]
Seat 1: ms1272 folded before Flop (didn't bet)
Seat 2: FeersPoker folded before Flop (didn't bet)
Seat 3: kastellani87 collected ($4.04)
Seat 4: rasku91 folded before Flop (didn't bet)
Seat 5: 3DMINSK folded before Flop (didn't bet)
Seat 6: StudentRB (button) folded before Flop (didn't bet)
Seat 7: Pablo1405 (small blind) folded before Flop
Seat 8: SENSAS1AN (big blind) folded on the River



PokerStars Hand #228691993004:  Hold'em No Limit ($0.25/$0.50 USD) - 2021/07/30 18:38:25 ET
Table 'Gorgo III' 9-max Seat #7 is the button
Seat 1: ms1272 ($78.10 in chips) 
Seat 2: FeersPoker ($50 in chips) 
Seat 3: kastellani87 ($48.79 in chips) 
Seat 5: 3DMINSK ($50 in chips) 
Seat 6: StudentRB ($51.51 in chips) 
Seat 7: Pablo1405 ($60.39 in chips) 
Seat 8: SENSAS1AN ($51.09 in chips) 
Seat 9: fragonik ($50.11 in chips) 
SENSAS1AN: posts small blind $0.25
fragonik: posts big blind $0.50
*** HOLE CARDS ***
ms1272: folds 
FeersPoker: folds 
kastellani87: raises $0.50 to $1
3DMINSK: folds 
StudentRB: folds 
Pablo1405: raises $3 to $4
SENSAS1AN: calls $3.75
fragonik: folds 
kastellani87: raises $12.50 to $16.50
Pablo1405: raises $43.89 to $60.39 and is all-in
SENSAS1AN: folds 
kastellani87: calls $32.29 and is all-in
Uncalled bet ($11.60) returned to Pablo1405
*** FLOP *** [Kc 8d 6s]
*** TURN *** [Kc 8d 6s] [Jd]
*** RIVER *** [Kc 8d 6s Jd] [8c]
*** SHOW DOWN ***
kastellani87: shows [Ac Ad] (two pair, Aces and Eights)
Pablo1405: shows [Qh Qd] (two pair, Queens and Eights)
kastellani87 collected $100.08 from pot
*** SUMMARY ***
Total pot $102.08 | Rake $2 
Board [Kc 8d 6s Jd 8c]
Seat 1: ms1272 folded before Flop (didn't bet)
Seat 2: FeersPoker folded before Flop (didn't bet)
Seat 3: kastellani87 showed [Ac Ad] and won ($100.08) with two pair, Aces and Eights
Seat 5: 3DMINSK folded before Flop (didn't bet)
Seat 6: StudentRB folded before Flop (didn't bet)
Seat 7: Pablo1405 (button) showed [Qh Qd] and lost with two pair, Queens and Eights
Seat 8: SENSAS1AN (small blind) folded before Flop
Seat 9: fragonik (big blind) folded before Flop



PokerStars Hand #228692012354:  Hold'em No Limit ($0.25/$0.50 USD) - 2021/07/30 18:39:14 ET
Table 'Gorgo III' 9-max Seat #8 is the button
Seat 1: ms1272 ($78.10 in chips) 
Seat 2: FeersPoker ($50 in chips) 
Seat 3: kastellani87 ($100.08 in chips) 
Seat 5: 3DMINSK ($50 in chips) 
Seat 6: StudentRB ($51.51 in chips) 
Seat 7: Pablo1405 ($50 in chips) 
Seat 8: SENSAS1AN ($50 in chips) 
Seat 9: fragonik ($50 in chips) 
fragonik: posts small blind $0.25
ms1272: posts big blind $0.50
*** HOLE CARDS ***
BB_dont_cry joins the table at seat #4 
FeersPoker: folds 
kastellani87: folds 
3DMINSK: folds 
StudentRB: folds 
Pablo1405: folds 
SENSAS1AN: folds 
fragonik: folds 
Uncalled bet ($0.25) returned to ms1272
ms1272 collected $0.50 from pot
ms1272: doesn't show hand 
*** SUMMARY ***
Total pot $0.50 | Rake $0 
Seat 1: ms1272 (big blind) collected ($0.50)
Seat 2: FeersPoker folded before Flop (didn't bet)
Seat 3: kastellani87 folded before Flop (didn't bet)
Seat 5: 3DMINSK folded before Flop (didn't bet)
Seat 6: StudentRB folded before Flop (didn't bet)
Seat 7: Pablo1405 folded before Flop (didn't bet)
Seat 8: SENSAS1AN (button) folded before Flop (didn't bet)
Seat 9: fragonik (small blind) folded before Flop



PokerStars Hand #228692021797:  Hold'em No Limit ($0.25/$0.50 USD) - 2021/07/30 18:39:38 ET
Table 'Gorgo III' 9-max Seat #9 is the button
Seat 1: ms1272 ($78.35 in chips) 
Seat 2: FeersPoker ($50 in chips) 
Seat 3: kastellani87 ($100.08 in chips) 
Seat 5: 3DMINSK ($50 in chips) 
Seat 6: StudentRB ($51.51 in chips) 
Seat 7: Pablo1405 ($50 in chips) 
Seat 8: SENSAS1AN ($50 in chips) 
Seat 9: fragonik ($50 in chips) 
ms1272: posts small blind $0.25
FeersPoker: posts big blind $0.50
BB_dont_cry: sits out 
*** HOLE CARDS ***
kastellani87: calls $0.50
3DMINSK: folds 
StudentRB: folds 
Pablo1405: folds 
SENSAS1AN: folds 
fragonik: raises $1.50 to $2
ms1272: calls $1.75
FeersPoker: folds 
kastellani87: calls $1.50
*** FLOP *** [Kh 6s 4c]
ms1272: checks 
kastellani87: checks 
fragonik: bets $2.04
ms1272: folds 
kastellani87: folds 
Uncalled bet ($2.04) returned to fragonik
fragonik collected $6.18 from pot
*** SUMMARY ***
Total pot $6.50 | Rake $0.32 
Board [Kh 6s 4c]
Seat 1: ms1272 (small blind) folded on the Flop
Seat 2: FeersPoker (big blind) folded before Flop
Seat 3: kastellani87 folded on the Flop
Seat 5: 3DMINSK folded before Flop (didn't bet)
Seat 6: StudentRB folded before Flop (didn't bet)
Seat 7: Pablo1405 folded before Flop (didn't bet)
Seat 8: SENSAS1AN folded before Flop (didn't bet)
Seat 9: fragonik (button) collected ($6.18)



PokerStars Hand #228692042290:  Hold'em No Limit ($0.25/$0.50 USD) - 2021/07/30 18:40:30 ET
Table 'Gorgo III' 9-max Seat #1 is the button
Seat 1: ms1272 ($76.35 in chips) 
Seat 2: FeersPoker ($50 in chips) 
Seat 3: kastellani87 ($98.08 in chips) 
Seat 5: 3DMINSK ($50 in chips) 
Seat 6: StudentRB ($51.51 in chips) 
Seat 7: Pablo1405 ($50 in chips) 
Seat 8: SENSAS1AN ($50 in chips) 
Seat 9: fragonik ($54.18 in chips) 
FeersPoker: posts small blind $0.25
kastellani87: posts big blind $0.50
BB_dont_cry: sits out 
*** HOLE CARDS ***
3DMINSK: folds 
StudentRB: folds 
Pablo1405: raises $0.75 to $1.25
SENSAS1AN: folds 
fragonik: folds 
ms1272: raises $3.25 to $4.50
FeersPoker: folds 
kastellani87: folds 
Pablo1405: folds 
Uncalled bet ($3.25) returned to ms1272
ms1272 collected $3.25 from pot
ms1272: doesn't show hand 
*** SUMMARY ***
Total pot $3.25 | Rake $0 
Seat 1: ms1272 (button) collected ($3.25)
Seat 2: FeersPoker (small blind) folded before Flop
Seat 3: kastellani87 (big blind) folded before Flop
Seat 5: 3DMINSK folded before Flop (didn't bet)
Seat 6: StudentRB folded before Flop (didn't bet)
Seat 7: Pablo1405 folded before Flop
Seat 8: SENSAS1AN folded before Flop (didn't bet)
Seat 9: fragonik folded before Flop (didn't bet)



PokerStars Hand #228692052537:  Hold'em No Limit ($0.25/$0.50 USD) - 2021/07/30 18:40:56 ET
Table 'Gorgo III' 9-max Seat #2 is the button
Seat 1: ms1272 ($78.35 in chips) 
Seat 2: FeersPoker ($50 in chips) 
Seat 3: kastellani87 ($97.58 in chips) 
Seat 4: BB_dont_cry ($40 in chips) 
Seat 5: 3DMINSK ($50 in chips) 
Seat 6: StudentRB ($51.51 in chips) 
Seat 7: Pablo1405 ($50 in chips) 
Seat 8: SENSAS1AN ($50 in chips) 
Seat 9: fragonik ($54.18 in chips) 
kastellani87: posts small blind $0.25
BB_dont_cry: posts big blind $0.50
*** HOLE CARDS ***
3DMINSK: folds 
StudentRB: folds 
Pablo1405: folds 
SENSAS1AN: folds 
fragonik: folds 
ms1272: raises $0.50 to $1
FeersPoker: folds 
kastellani87: calls $0.75
BB_dont_cry: calls $0.50
*** FLOP *** [Qd 3s 3h]
kastellani87: checks 
BB_dont_cry: bets $1.43
ms1272: folds 
kastellani87: folds 
Uncalled bet ($1.43) returned to BB_dont_cry
BB_dont_cry collected $2.85 from pot
*** SUMMARY ***
Total pot $3 | Rake $0.15 
Board [Qd 3s 3h]
Seat 1: ms1272 folded on the Flop
Seat 2: FeersPoker (button) folded before Flop (didn't bet)
Seat 3: kastellani87 (small blind) folded on the Flop
Seat 4: BB_dont_cry (big blind) collected ($2.85)
Seat 5: 3DMINSK folded before Flop (didn't bet)
Seat 6: StudentRB folded before Flop (didn't bet)
Seat 7: Pablo1405 folded before Flop (didn't bet)
Seat 8: SENSAS1AN folded before Flop (didn't bet)
Seat 9: fragonik folded before Flop (didn't bet)



PokerStars Hand #228692067907:  Hold'em No Limit ($0.25/$0.50 USD) - 2021/07/30 18:41:35 ET
Table 'Gorgo III' 9-max Seat #3 is the button
Seat 1: ms1272 ($77.35 in chips) 
Seat 2: FeersPoker ($50 in chips) 
Seat 3: kastellani87 ($96.58 in chips) 
Seat 4: BB_dont_cry ($41.85 in chips) 
Seat 5: 3DMINSK ($50 in chips) 
Seat 6: StudentRB ($51.51 in chips) 
Seat 7: Pablo1405 ($50 in chips) 
Seat 8: SENSAS1AN ($50 in chips) 
Seat 9: fragonik ($54.18 in chips) 
BB_dont_cry: posts small blind $0.25
3DMINSK: posts big blind $0.50
*** HOLE CARDS ***
StudentRB: folds 
Pablo1405: folds 
SENSAS1AN: raises $0.75 to $1.25
fragonik: folds 
ms1272: calls $1.25
FeersPoker: folds 
kastellani87: folds 
BB_dont_cry: folds 
3DMINSK: folds 
*** FLOP *** [8h 6d 4d]
SENSAS1AN: checks 
ms1272: checks 
*** TURN *** [8h 6d 4d] [Jc]
SENSAS1AN: bets $2.06
ms1272: folds 
Uncalled bet ($2.06) returned to SENSAS1AN
SENSAS1AN collected $3.09 from pot
SENSAS1AN: doesn't show hand 
*** SUMMARY ***
Total pot $3.25 | Rake $0.16 
Board [8h 6d 4d Jc]
Seat 1: ms1272 folded on the Turn
Seat 2: FeersPoker folded before Flop (didn't bet)
Seat 3: kastellani87 (button) folded before Flop (didn't bet)
Seat 4: BB_dont_cry (small blind) folded before Flop
Seat 5: 3DMINSK (big blind) folded before Flop
Seat 6: StudentRB folded before Flop (didn't bet)
Seat 7: Pablo1405 folded before Flop (didn't bet)
Seat 8: SENSAS1AN collected ($3.09)
Seat 9: fragonik folded before Flop (didn't bet)



PokerStars Hand #228692079369:  Hold'em No Limit ($0.25/$0.50 USD) - 2021/07/30 18:42:04 ET
Table 'Gorgo III' 9-max Seat #4 is the button
Seat 1: ms1272 ($76.10 in chips) 
Seat 2: FeersPoker ($50 in chips) 
Seat 3: kastellani87 ($96.58 in chips) 
Seat 4: BB_dont_cry ($41.60 in chips) 
Seat 5: 3DMINSK ($50 in chips) 
Seat 6: StudentRB ($51.51 in chips) 
Seat 7: Pablo1405 ($50 in chips) 
Seat 8: SENSAS1AN ($51.84 in chips) 
Seat 9: fragonik ($54.18 in chips) 
3DMINSK: posts small blind $0.25
StudentRB: posts big blind $0.50
*** HOLE CARDS ***
Pablo1405: folds 
SENSAS1AN: folds 
fragonik: folds 
ms1272: folds 
FeersPoker: folds 
kastellani87: folds 
BB_dont_cry: folds 
3DMINSK: raises $0.75 to $1.25
StudentRB: calls $0.75
*** FLOP *** [2s 9d Kc]
3DMINSK: bets $0.71
StudentRB: folds 
Uncalled bet ($0.71) returned to 3DMINSK
3DMINSK collected $2.38 from pot
3DMINSK: doesn't show hand 
*** SUMMARY ***
Total pot $2.50 | Rake $0.12 
Board [2s 9d Kc]
Seat 1: ms1272 folded before Flop (didn't bet)
Seat 2: FeersPoker folded before Flop (didn't bet)
Seat 3: kastellani87 folded before Flop (didn't bet)
Seat 4: BB_dont_cry (button) folded before Flop (didn't bet)
Seat 5: 3DMINSK (small blind) collected ($2.38)
Seat 6: StudentRB (big blind) folded on the Flop
Seat 7: Pablo1405 folded before Flop (didn't bet)
Seat 8: SENSAS1AN folded before Flop (didn't bet)
Seat 9: fragonik folded before Flop (didn't bet)



PokerStars Hand #228692090360:  Hold'em No Limit ($0.25/$0.50 USD) - 2021/07/30 18:42:33 ET
Table 'Gorgo III' 9-max Seat #5 is the button
Seat 1: ms1272 ($76.10 in chips) 
Seat 2: FeersPoker ($50 in chips) 
Seat 3: kastellani87 ($96.58 in chips) 
Seat 4: BB_dont_cry ($41.60 in chips) 
Seat 5: 3DMINSK ($51.13 in chips) 
Seat 6: StudentRB ($50.26 in chips) 
Seat 7: Pablo1405 ($50 in chips) 
Seat 8: SENSAS1AN ($51.84 in chips) 
Seat 9: fragonik ($54.18 in chips) 
StudentRB: posts small blind $0.25
Pablo1405: posts big blind $0.50
*** HOLE CARDS ***
SENSAS1AN: folds 
fragonik: folds 
ms1272: raises $0.50 to $1
FeersPoker: calls $1
kastellani87: folds 
BB_dont_cry: folds 
3DMINSK: folds 
StudentRB: folds 
Pablo1405: folds 
*** FLOP *** [2s Ac 4h]
ms1272: bets $1.30
FeersPoker: calls $1.30
*** TURN *** [2s Ac 4h] [8c]
ms1272: checks 
FeersPoker: bets $2.79
ms1272: folds 
Uncalled bet ($2.79) returned to FeersPoker
FeersPoker collected $5.08 from pot
FeersPoker: doesn't show hand 
*** SUMMARY ***
Total pot $5.35 | Rake $0.27 
Board [2s Ac 4h 8c]
Seat 1: ms1272 folded on the Turn
Seat 2: FeersPoker collected ($5.08)
Seat 3: kastellani87 folded before Flop (didn't bet)
Seat 4: BB_dont_cry folded before Flop (didn't bet)
Seat 5: 3DMINSK (button) folded before Flop (didn't bet)
Seat 6: StudentRB (small blind) folded before Flop
Seat 7: Pablo1405 (big blind) folded before Flop
Seat 8: SENSAS1AN folded before Flop (didn't bet)
Seat 9: fragonik folded before Flop (didn't bet)



PokerStars Hand #228692105737:  Hold'em No Limit ($0.25/$0.50 USD) - 2021/07/30 18:43:12 ET
Table 'Gorgo III' 9-max Seat #6 is the button
Seat 1: ms1272 ($73.80 in chips) 
Seat 2: FeersPoker ($52.78 in chips) 
Seat 3: kastellani87 ($96.58 in chips) 
Seat 4: BB_dont_cry ($41.60 in chips) 
Seat 5: 3DMINSK ($51.13 in chips) 
Seat 6: StudentRB ($50.01 in chips) 
Seat 7: Pablo1405 ($50 in chips) 
Seat 8: SENSAS1AN ($51.84 in chips) 
Seat 9: fragonik ($54.18 in chips) 
Pablo1405: posts small blind $0.25
SENSAS1AN: posts big blind $0.50
*** HOLE CARDS ***
fragonik: raises $1 to $1.50
ms1272: folds 
FeersPoker: folds 
kastellani87: folds 
BB_dont_cry: folds 
3DMINSK: folds 
StudentRB: folds 
Pablo1405: folds 
SENSAS1AN: folds 
Uncalled bet ($1) returned to fragonik
fragonik collected $1.25 from pot
*** SUMMARY ***
Total pot $1.25 | Rake $0 
Seat 1: ms1272 folded before Flop (didn't bet)
Seat 2: FeersPoker folded before Flop (didn't bet)
Seat 3: kastellani87 folded before Flop (didn't bet)
Seat 4: BB_dont_cry folded before Flop (didn't bet)
Seat 5: 3DMINSK folded before Flop (didn't bet)
Seat 6: StudentRB (button) folded before Flop (didn't bet)
Seat 7: Pablo1405 (small blind) folded before Flop
Seat 8: SENSAS1AN (big blind) folded before Flop
Seat 9: fragonik collected ($1.25)



PokerStars Hand #228692116039:  Hold'em No Limit ($0.25/$0.50 USD) - 2021/07/30 18:43:38 ET
Table 'Gorgo III' 9-max Seat #7 is the button
Seat 1: ms1272 ($73.80 in chips) 
Seat 2: FeersPoker ($52.78 in chips) 
Seat 3: kastellani87 ($96.58 in chips) 
Seat 4: BB_dont_cry ($41.60 in chips) 
Seat 5: 3DMINSK ($51.13 in chips) 
Seat 6: StudentRB ($50.01 in chips) 
Seat 7: Pablo1405 ($50 in chips) 
Seat 8: SENSAS1AN ($51.34 in chips) 
Seat 9: fragonik ($54.93 in chips) 
SENSAS1AN: posts small blind $0.25
fragonik: posts big blind $0.50
*** HOLE CARDS ***
ms1272: folds 
FeersPoker: folds 
kastellani87: folds 
BB_dont_cry: folds 
3DMINSK: raises $1 to $1.50
StudentRB: folds 
Pablo1405: folds 
SENSAS1AN: folds 
fragonik: raises $3.25 to $4.75
3DMINSK: folds 
Uncalled bet ($3.25) returned to fragonik
fragonik collected $3.25 from pot
*** SUMMARY ***
Total pot $3.25 | Rake $0 
Seat 1: ms1272 folded before Flop (didn't bet)
Seat 2: FeersPoker folded before Flop (didn't bet)
Seat 3: kastellani87 folded before Flop (didn't bet)
Seat 4: BB_dont_cry folded before Flop (didn't bet)
Seat 5: 3DMINSK folded before Flop
Seat 6: StudentRB folded before Flop (didn't bet)
Seat 7: Pablo1405 (button) folded before Flop (didn't bet)
Seat 8: SENSAS1AN (small blind) folded before Flop
Seat 9: fragonik (big blind) collected ($3.25)



PokerStars Hand #228692127154:  Hold'em No Limit ($0.25/$0.50 USD) - 2021/07/30 18:44:07 ET
Table 'Gorgo III' 9-max Seat #8 is the button
Seat 1: ms1272 ($73.80 in chips) 
Seat 2: FeersPoker ($52.78 in chips) 
Seat 3: kastellani87 ($96.58 in chips) 
Seat 4: BB_dont_cry ($41.60 in chips) 
Seat 5: 3DMINSK ($50 in chips) 
Seat 6: StudentRB ($50.01 in chips) 
Seat 7: Pablo1405 ($50 in chips) 
Seat 8: SENSAS1AN ($51.09 in chips) 
Seat 9: fragonik ($56.68 in chips) 
fragonik: posts small blind $0.25
ms1272: posts big blind $0.50
*** HOLE CARDS ***
FeersPoker: folds 
kastellani87: folds 
BB_dont_cry: folds 
3DMINSK: folds 
StudentRB: folds 
Pablo1405: raises $1 to $1.50
SENSAS1AN: folds 
fragonik: folds 
ms1272: calls $1
*** FLOP *** [8s Ks 2c]
ms1272: checks 
Pablo1405: bets $2.50
ms1272: folds 
Uncalled bet ($2.50) returned to Pablo1405
Pablo1405 collected $3.09 from pot
Pablo1405: doesn't show hand 
*** SUMMARY ***
Total pot $3.25 | Rake $0.16 
Board [8s Ks 2c]
Seat 1: ms1272 (big blind) folded on the Flop
Seat 2: FeersPoker folded before Flop (didn't bet)
Seat 3: kastellani87 folded before Flop (didn't bet)
Seat 4: BB_dont_cry folded before Flop (didn't bet)
Seat 5: 3DMINSK folded before Flop (didn't bet)
Seat 6: StudentRB folded before Flop (didn't bet)
Seat 7: Pablo1405 collected ($3.09)
Seat 8: SENSAS1AN (button) folded before Flop (didn't bet)
Seat 9: fragonik (small blind) folded before Flop



PokerStars Hand #228692143398:  Hold'em No Limit ($0.25/$0.50 USD) - 2021/07/30 18:44:49 ET
Table 'Gorgo III' 9-max Seat #9 is the button
Seat 1: ms1272 ($72.30 in chips) 
Seat 2: FeersPoker ($52.78 in chips) 
Seat 3: kastellani87 ($96.58 in chips) 
Seat 4: BB_dont_cry ($41.60 in chips) 
Seat 5: 3DMINSK ($50 in chips) 
Seat 6: StudentRB ($50.01 in chips) 
Seat 7: Pablo1405 ($51.59 in chips) 
Seat 8: SENSAS1AN ($51.09 in chips) 
Seat 9: fragonik ($56.43 in chips) 
ms1272: posts small blind $0.25
FeersPoker: posts big blind $0.50
*** HOLE CARDS ***
kastellani87: folds 
BB_dont_cry: raises $1.25 to $1.75
3DMINSK: folds 
StudentRB: folds 
Pablo1405: folds 
SENSAS1AN: folds 
fragonik: folds 
ms1272: folds 
FeersPoker: folds 
Uncalled bet ($1.25) returned to BB_dont_cry
BB_dont_cry collected $1.25 from pot
*** SUMMARY ***
Total pot $1.25 | Rake $0 
Seat 1: ms1272 (small blind) folded before Flop
Seat 2: FeersPoker (big blind) folded before Flop
Seat 3: kastellani87 folded before Flop (didn't bet)
Seat 4: BB_dont_cry collected ($1.25)
Seat 5: 3DMINSK folded before Flop (didn't bet)
Seat 6: StudentRB folded before Flop (didn't bet)
Seat 7: Pablo1405 folded before Flop (didn't bet)
Seat 8: SENSAS1AN folded before Flop (didn't bet)
Seat 9: fragonik (button) folded before Flop (didn't bet)



PokerStars Hand #228692151839:  Hold'em No Limit ($0.25/$0.50 USD) - 2021/07/30 18:45:11 ET
Table 'Gorgo III' 9-max Seat #1 is the button
Seat 1: ms1272 ($72.05 in chips) 
Seat 2: FeersPoker ($52.28 in chips) 
Seat 3: kastellani87 ($96.58 in chips) 
Seat 4: BB_dont_cry ($42.35 in chips) 
Seat 5: 3DMINSK ($50 in chips) 
Seat 6: StudentRB ($50.01 in chips) 
Seat 7: Pablo1405 ($51.59 in chips) 
Seat 8: SENSAS1AN ($51.09 in chips) 
Seat 9: fragonik ($56.43 in chips) 
FeersPoker: posts small blind $0.25
kastellani87: posts big blind $0.50
*** HOLE CARDS ***
BB_dont_cry: raises $1.25 to $1.75
3DMINSK: folds 
StudentRB: folds 
Pablo1405: folds 
SENSAS1AN: folds 
fragonik: calls $1.75
ms1272: folds 
FeersPoker: folds 
kastellani87: calls $1.25
*** FLOP *** [Th Td 8s]
kastellani87: checks 
ms1272 leaves the table
BB_dont_cry: bets $2.61
fragonik: calls $2.61
kastellani87: folds 
*** TURN *** [Th Td 8s] [7d]
BB_dont_cry: checks 
fragonik: checks 
*** RIVER *** [Th Td 8s 7d] [5s]
BB_dont_cry: checks 
fragonik: checks 
*** SHOW DOWN ***
BB_dont_cry: shows [Jc Jh] (two pair, Jacks and Tens)
fragonik: mucks hand 
BB_dont_cry collected $10.18 from pot
*** SUMMARY ***
Total pot $10.72 | Rake $0.54 
Board [Th Td 8s 7d 5s]
Seat 1: ms1272 (button) folded before Flop (didn't bet)
Seat 2: FeersPoker (small blind) folded before Flop
Seat 3: kastellani87 (big blind) folded on the Flop
Seat 4: BB_dont_cry showed [Jc Jh] and won ($10.18) with two pair, Jacks and Tens
Seat 5: 3DMINSK folded before Flop (didn't bet)
Seat 6: StudentRB folded before Flop (didn't bet)
Seat 7: Pablo1405 folded before Flop (didn't bet)
Seat 8: SENSAS1AN folded before Flop (didn't bet)
Seat 9: fragonik mucked



PokerStars Hand #228692176906:  Hold'em No Limit ($0.25/$0.50 USD) - 2021/07/30 18:46:16 ET
Table 'Gorgo III' 9-max Seat #2 is the button
Seat 2: FeersPoker ($52.03 in chips) 
Seat 3: kastellani87 ($94.83 in chips) 
Seat 4: BB_dont_cry ($48.17 in chips) 
Seat 5: 3DMINSK ($50 in chips) 
Seat 6: StudentRB ($50.01 in chips) 
Seat 7: Pablo1405 ($51.59 in chips) 
Seat 8: SENSAS1AN ($51.09 in chips) 
Seat 9: fragonik ($52.07 in chips) 
kastellani87: posts small blind $0.25
BB_dont_cry: posts big blind $0.50
*** HOLE CARDS ***
Antoxa970 joins the table at seat #1 
3DMINSK: raises $1 to $1.50
StudentRB: folds 
Pablo1405: folds 
SENSAS1AN: calls $1.50
fragonik: folds 
FeersPoker: calls $1.50
kastellani87: folds 
BB_dont_cry: folds 
*** FLOP *** [3c 8c 8d]
3DMINSK: checks 
SENSAS1AN: checks 
FeersPoker: bets $1.65
3DMINSK: folds 
SENSAS1AN: folds 
Uncalled bet ($1.65) returned to FeersPoker
FeersPoker collected $4.99 from pot
FeersPoker: doesn't show hand 
*** SUMMARY ***
Total pot $5.25 | Rake $0.26 
Board [3c 8c 8d]
Seat 2: FeersPoker (button) collected ($4.99)
Seat 3: kastellani87 (small blind) folded before Flop
Seat 4: BB_dont_cry (big blind) folded before Flop
Seat 5: 3DMINSK folded on the Flop
Seat 6: StudentRB folded before Flop (didn't bet)
Seat 7: Pablo1405 folded before Flop (didn't bet)
Seat 8: SENSAS1AN folded on the Flop
Seat 9: fragonik folded before Flop (didn't bet)



PokerStars Hand #228692195409:  Hold'em No Limit ($0.25/$0.50 USD) - 2021/07/30 18:47:04 ET
Table 'Gorgo III' 9-max Seat #3 is the button
Seat 1: Antoxa970 ($40 in chips) 
Seat 2: FeersPoker ($55.52 in chips) 
Seat 3: kastellani87 ($94.58 in chips) 
Seat 4: BB_dont_cry ($47.67 in chips) 
Seat 5: 3DMINSK ($50 in chips) 
Seat 6: StudentRB ($50.01 in chips) 
Seat 7: Pablo1405 ($51.59 in chips) 
Seat 8: SENSAS1AN ($50 in chips) 
Seat 9: fragonik ($52.07 in chips) 
BB_dont_cry: posts small blind $0.25
3DMINSK: posts big blind $0.50
Antoxa970: posts big blind $0.50
*** HOLE CARDS ***
StudentRB: folds 
Pablo1405: folds 
SENSAS1AN: folds 
fragonik: folds 
Antoxa970: checks 
FeersPoker: raises $1.50 to $2
kastellani87: folds 
BB_dont_cry: folds 
3DMINSK: folds 
Antoxa970: calls $1.50
*** FLOP *** [6s Kd 8s]
Antoxa970: checks 
FeersPoker: bets $2.26
Antoxa970: raises $4.52 to $6.78
FeersPoker: folds 
Uncalled bet ($4.52) returned to Antoxa970
Antoxa970 collected $8.81 from pot
Antoxa970: doesn't show hand 
*** SUMMARY ***
Total pot $9.27 | Rake $0.46 
Board [6s Kd 8s]
Seat 1: Antoxa970 collected ($8.81)
Seat 2: FeersPoker folded on the Flop
Seat 3: kastellani87 (button) folded before Flop (didn't bet)
Seat 4: BB_dont_cry (small blind) folded before Flop
Seat 5: 3DMINSK (big blind) folded before Flop
Seat 6: StudentRB folded before Flop (didn't bet)
Seat 7: Pablo1405 folded before Flop (didn't bet)
Seat 8: SENSAS1AN folded before Flop (didn't bet)
Seat 9: fragonik folded before Flop (didn't bet)



PokerStars Hand #228692211726:  Hold'em No Limit ($0.25/$0.50 USD) - 2021/07/30 18:47:46 ET
Table 'Gorgo III' 9-max Seat #4 is the button
Seat 1: Antoxa970 ($44.55 in chips) 
Seat 2: FeersPoker ($51.26 in chips) 
Seat 3: kastellani87 ($94.58 in chips) 
Seat 4: BB_dont_cry ($47.42 in chips) 
Seat 5: 3DMINSK ($50 in chips) 
Seat 6: StudentRB ($50.01 in chips) 
Seat 7: Pablo1405 ($51.59 in chips) 
Seat 8: SENSAS1AN ($50 in chips) 
Seat 9: fragonik ($52.07 in chips) 
3DMINSK: posts small blind $0.25
StudentRB: posts big blind $0.50
*** HOLE CARDS ***
Pablo1405: folds 
SENSAS1AN: folds 
fragonik: folds 
Antoxa970: calls $0.50
FeersPoker: folds 
kastellani87: calls $0.50
BB_dont_cry: folds 
3DMINSK: calls $0.25
StudentRB: checks 
*** FLOP *** [Kh 8d 7d]
3DMINSK: checks 
StudentRB: checks 
Antoxa970: bets $1.90
kastellani87: raises $1.90 to $3.80
3DMINSK: folds 
StudentRB: folds 
Antoxa970: calls $1.90
*** TURN *** [Kh 8d 7d] [Ah]
Antoxa970: checks 
kastellani87: checks 
*** RIVER *** [Kh 8d 7d Ah] [3h]
Antoxa970: bets $9.12
kastellani87: calls $9.12
*** SHOW DOWN ***
Antoxa970: shows [6s Ts] (high card Ace)
kastellani87: shows [3d Ks] (two pair, Kings and Threes)
kastellani87 collected $26.45 from pot
*** SUMMARY ***
Total pot $27.84 | Rake $1.39 
Board [Kh 8d 7d Ah 3h]
Seat 1: Antoxa970 showed [6s Ts] and lost with high card Ace
Seat 2: FeersPoker folded before Flop (didn't bet)
Seat 3: kastellani87 showed [3d Ks] and won ($26.45) with two pair, Kings and Threes
Seat 4: BB_dont_cry (button) folded before Flop (didn't bet)
Seat 5: 3DMINSK (small blind) folded on the Flop
Seat 6: StudentRB (big blind) folded on the Flop
Seat 7: Pablo1405 folded before Flop (didn't bet)
Seat 8: SENSAS1AN folded before Flop (didn't bet)
Seat 9: fragonik folded before Flop (didn't bet)



PokerStars Hand #228692232304:  Hold'em No Limit ($0.25/$0.50 USD) - 2021/07/30 18:48:40 ET
Table 'Gorgo III' 9-max Seat #5 is the button
Seat 1: Antoxa970 ($31.13 in chips) 
Seat 2: FeersPoker ($51.26 in chips) 
Seat 3: kastellani87 ($107.61 in chips) 
Seat 4: BB_dont_cry ($47.42 in chips) 
Seat 5: 3DMINSK ($50 in chips) 
Seat 6: StudentRB ($50 in chips) 
Seat 7: Pablo1405 ($51.59 in chips) 
Seat 8: SENSAS1AN ($50 in chips) 
Seat 9: fragonik ($52.07 in chips) 
StudentRB: posts small blind $0.25
Pablo1405: posts big blind $0.50
*** HOLE CARDS ***
SENSAS1AN: folds 
fragonik: folds 
Antoxa970: calls $0.50
FeersPoker: folds 
kastellani87: calls $0.50
BB_dont_cry: folds 
3DMINSK: raises $2 to $2.50
StudentRB: folds 
Pablo1405: folds 
Antoxa970: calls $2
kastellani87: folds 
*** FLOP *** [Tc 8s 3c]
Antoxa970: checks 
3DMINSK: bets $1.78
Antoxa970: raises $4.75 to $6.53
3DMINSK: folds 
Uncalled bet ($4.75) returned to Antoxa970
Antoxa970 collected $9.32 from pot
Antoxa970: doesn't show hand 
*** SUMMARY ***
Total pot $9.81 | Rake $0.49 
Board [Tc 8s 3c]
Seat 1: Antoxa970 collected ($9.32)
Seat 2: FeersPoker folded before Flop (didn't bet)
Seat 3: kastellani87 folded before Flop
Seat 4: BB_dont_cry folded before Flop (didn't bet)
Seat 5: 3DMINSK (button) folded on the Flop
Seat 6: StudentRB (small blind) folded before Flop
Seat 7: Pablo1405 (big blind) folded before Flop
Seat 8: SENSAS1AN folded before Flop (didn't bet)
Seat 9: fragonik folded before Flop (didn't bet)



PokerStars Hand #228692248105:  Hold'em No Limit ($0.25/$0.50 USD) - 2021/07/30 18:49:22 ET
Table 'Gorgo III' 9-max Seat #6 is the button
Seat 1: Antoxa970 ($36.17 in chips) 
Seat 2: FeersPoker ($51.26 in chips) 
Seat 3: kastellani87 ($107.11 in chips) 
Seat 4: BB_dont_cry ($47.42 in chips) 
Seat 5: 3DMINSK ($50 in chips) 
Seat 6: StudentRB ($50 in chips) 
Seat 7: Pablo1405 ($51.09 in chips) 
Seat 8: SENSAS1AN ($50 in chips) 
Seat 9: fragonik ($52.07 in chips) 
Pablo1405: posts small blind $0.25
SENSAS1AN: posts big blind $0.50
*** HOLE CARDS ***
fragonik has timed out
fragonik: folds 
Antoxa970: calls $0.50
FeersPoker: folds 
kastellani87: folds 
BB_dont_cry: folds 
3DMINSK: folds 
StudentRB: folds 
Pablo1405: folds 
SENSAS1AN: checks 
*** FLOP *** [6s Td 8c]
SENSAS1AN: checks 
Antoxa970: bets $1.19
SENSAS1AN: folds 
Uncalled bet ($1.19) returned to Antoxa970
Antoxa970 collected $1.19 from pot
Antoxa970: doesn't show hand 
*** SUMMARY ***
Total pot $1.25 | Rake $0.06 
Board [6s Td 8c]
Seat 1: Antoxa970 collected ($1.19)
Seat 2: FeersPoker folded before Flop (didn't bet)
Seat 3: kastellani87 folded before Flop (didn't bet)
Seat 4: BB_dont_cry folded before Flop (didn't bet)
Seat 5: 3DMINSK folded before Flop (didn't bet)
Seat 6: StudentRB (button) folded before Flop (didn't bet)
Seat 7: Pablo1405 (small blind) folded before Flop
Seat 8: SENSAS1AN (big blind) folded on the Flop
Seat 9: fragonik folded before Flop (didn't bet)



PokerStars Hand #228692264940:  Hold'em No Limit ($0.25/$0.50 USD) - 2021/07/30 18:50:01 ET
Table 'Gorgo III' 9-max Seat #7 is the button
Seat 1: Antoxa970 ($36.86 in chips) 
Seat 2: FeersPoker ($51.26 in chips) 
Seat 3: kastellani87 ($107.11 in chips) 
Seat 4: BB_dont_cry ($47.42 in chips) 
Seat 5: 3DMINSK ($50 in chips) 
Seat 6: StudentRB ($50 in chips) 
Seat 7: Pablo1405 ($50.84 in chips) 
Seat 8: SENSAS1AN ($50 in chips) 
SENSAS1AN: posts small blind $0.25
Antoxa970: posts big blind $0.50
*** HOLE CARDS ***
FeersPoker: folds 
kastellani87: folds 
BB_dont_cry: calls $0.50
3DMINSK: folds 
StudentRB: folds 
Pablo1405: folds 
SENSAS1AN: folds 
Antoxa970: checks 
*** FLOP *** [2s 6s Ks]
Antoxa970: checks 
BB_dont_cry: bets $1.19
Antoxa970: raises $1.19 to $2.38
BB_dont_cry: calls $1.19
*** TURN *** [2s 6s Ks] [8s]
Antoxa970: checks 
BB_dont_cry: checks 
*** RIVER *** [2s 6s Ks 8s] [Kc]
Antoxa970: checks 
BB_dont_cry: checks 
*** SHOW DOWN ***
Antoxa970: shows [4h As] (a flush, Ace high)
BB_dont_cry: mucks hand 
Antoxa970 collected $5.71 from pot
*** SUMMARY ***
Total pot $6.01 | Rake $0.30 
Board [2s 6s Ks 8s Kc]
Seat 1: Antoxa970 (big blind) showed [4h As] and won ($5.71) with a flush, Ace high
Seat 2: FeersPoker folded before Flop (didn't bet)
Seat 3: kastellani87 folded before Flop (didn't bet)
Seat 4: BB_dont_cry mucked
Seat 5: 3DMINSK folded before Flop (didn't bet)
Seat 6: StudentRB folded before Flop (didn't bet)
Seat 7: Pablo1405 (button) folded before Flop (didn't bet)
Seat 8: SENSAS1AN (small blind) folded before Flop



PokerStars Hand #228692280941:  Hold'em No Limit ($0.25/$0.50 USD) - 2021/07/30 18:50:40 ET
Table 'Gorgo III' 9-max Seat #8 is the button
Seat 1: Antoxa970 ($39.69 in chips) 
Seat 2: FeersPoker ($51.26 in chips) 
Seat 3: kastellani87 ($107.11 in chips) 
Seat 4: BB_dont_cry ($44.54 in chips) 
Seat 5: 3DMINSK ($50 in chips) 
Seat 6: StudentRB ($50 in chips) 
Seat 7: Pablo1405 ($50.84 in chips) 
Seat 8: SENSAS1AN ($50 in chips) 
Antoxa970: posts small blind $0.25
FeersPoker: posts big blind $0.50
*** HOLE CARDS ***
kastellani87: calls $0.50
BB_dont_cry: folds 
3DMINSK: raises $1.50 to $2
StudentRB: folds 
Pablo1405: raises $4 to $6
SENSAS1AN: folds 
Antoxa970: folds 
FeersPoker: folds 
kastellani87: folds 
3DMINSK: calls $4
*** FLOP *** [Td 6s 2c]
3DMINSK: checks 
Pablo1405: bets $6
3DMINSK: folds 
Uncalled bet ($6) returned to Pablo1405
Pablo1405 collected $12.59 from pot
Pablo1405: doesn't show hand 
*** SUMMARY ***
Total pot $13.25 | Rake $0.66 
Board [Td 6s 2c]
Seat 1: Antoxa970 (small blind) folded before Flop
Seat 2: FeersPoker (big blind) folded before Flop
Seat 3: kastellani87 folded before Flop
Seat 4: BB_dont_cry folded before Flop (didn't bet)
Seat 5: 3DMINSK folded on the Flop
Seat 6: StudentRB folded before Flop (didn't bet)
Seat 7: Pablo1405 collected ($12.59)
Seat 8: SENSAS1AN (button) folded before Flop (didn't bet)



PokerStars Hand #228692294862:  Hold'em No Limit ($0.25/$0.50 USD) - 2021/07/30 18:51:16 ET
Table 'Gorgo III' 9-max Seat #1 is the button
Seat 1: Antoxa970 ($39.44 in chips) 
Seat 2: FeersPoker ($50.76 in chips) 
Seat 3: kastellani87 ($106.61 in chips) 
Seat 4: BB_dont_cry ($44.54 in chips) 
Seat 5: 3DMINSK ($50 in chips) 
Seat 6: StudentRB ($50 in chips) 
Seat 7: Pablo1405 ($57.43 in chips) 
Seat 8: SENSAS1AN ($50 in chips) 
FeersPoker: posts small blind $0.25
kastellani87: posts big blind $0.50
fragonik: sits out 
*** HOLE CARDS ***
BB_dont_cry: folds 
3DMINSK: raises $1 to $1.50
StudentRB: folds 
Pablo1405: folds 
SENSAS1AN: folds 
Antoxa970: calls $1.50
FeersPoker: raises $5 to $6.50
kastellani87: folds 
3DMINSK: folds 
Antoxa970: calls $5
*** FLOP *** [Td Ac 7c]
FeersPoker: checks 
Antoxa970: bets $14.25
FeersPoker: calls $14.25
*** TURN *** [Td Ac 7c] [2c]
FeersPoker: checks 
Antoxa970: checks 
*** RIVER *** [Td Ac 7c 2c] [6h]
FeersPoker: checks 
Antoxa970: checks 
*** SHOW DOWN ***
FeersPoker: shows [Ad As] (three of a kind, Aces)
Antoxa970: mucks hand 
FeersPoker collected $41.50 from pot
*** SUMMARY ***
Total pot $43.50 | Rake $2 
Board [Td Ac 7c 2c 6h]
Seat 1: Antoxa970 (button) mucked
Seat 2: FeersPoker (small blind) showed [Ad As] and won ($41.50) with three of a kind, Aces
Seat 3: kastellani87 (big blind) folded before Flop
Seat 4: BB_dont_cry folded before Flop (didn't bet)
Seat 5: 3DMINSK folded before Flop
Seat 6: StudentRB folded before Flop (didn't bet)
Seat 7: Pablo1405 folded before Flop (didn't bet)
Seat 8: SENSAS1AN folded before Flop (didn't bet)



PokerStars Hand #228692341890:  Hold'em No Limit ($0.25/$0.50 USD) - 2021/07/30 18:53:21 ET
Table 'Gorgo III' 9-max Seat #2 is the button
Seat 1: Antoxa970 ($18.69 in chips) 
Seat 2: FeersPoker ($71.51 in chips) 
Seat 3: kastellani87 ($106.11 in chips) 
Seat 4: BB_dont_cry ($50 in chips) 
Seat 5: 3DMINSK ($50 in chips) 
Seat 6: StudentRB ($50 in chips) 
Seat 7: Pablo1405 ($57.43 in chips) 
Seat 8: SENSAS1AN ($50 in chips) 
kastellani87: posts small blind $0.25
BB_dont_cry: posts big blind $0.50
fragonik: sits out 
*** HOLE CARDS ***
3DMINSK: folds 
StudentRB: folds 
Pablo1405: folds 
SENSAS1AN: raises $1 to $1.50
Antoxa970: calls $1.50
FeersPoker: folds 
kastellani87: folds 
BB_dont_cry: folds 
*** FLOP *** [9s 3s 6s]
SENSAS1AN: checks 
Antoxa970: bets $3.56
SENSAS1AN: folds 
Uncalled bet ($3.56) returned to Antoxa970
Antoxa970 collected $3.56 from pot
Antoxa970: doesn't show hand 
*** SUMMARY ***
Total pot $3.75 | Rake $0.19 
Board [9s 3s 6s]
Seat 1: Antoxa970 collected ($3.56)
Seat 2: FeersPoker (button) folded before Flop (didn't bet)
Seat 3: kastellani87 (small blind) folded before Flop
Seat 4: BB_dont_cry (big blind) folded before Flop
Seat 5: 3DMINSK folded before Flop (didn't bet)
Seat 6: StudentRB folded before Flop (didn't bet)
Seat 7: Pablo1405 folded before Flop (didn't bet)
Seat 8: SENSAS1AN folded on the Flop



PokerStars Hand #228692351329:  Hold'em No Limit ($0.25/$0.50 USD) - 2021/07/30 18:53:46 ET
Table 'Gorgo III' 9-max Seat #3 is the button
Seat 1: Antoxa970 ($20.75 in chips) 
Seat 2: FeersPoker ($71.51 in chips) 
Seat 3: kastellani87 ($105.86 in chips) 
Seat 4: BB_dont_cry ($49.50 in chips) 
Seat 5: 3DMINSK ($50 in chips) 
Seat 6: StudentRB ($50 in chips) 
Seat 7: Pablo1405 ($57.43 in chips) 
Seat 8: SENSAS1AN ($50 in chips) 
BB_dont_cry: posts small blind $0.25
3DMINSK: posts big blind $0.50
fragonik: sits out 
*** HOLE CARDS ***
StudentRB: folds 
Pablo1405: folds 
SENSAS1AN: folds 
Antoxa970: calls $0.50
FeersPoker: folds 
kastellani87: folds 
BB_dont_cry: folds 
3DMINSK: checks 
*** FLOP *** [3d Qd 4s]
3DMINSK: checks 
Antoxa970: bets $0.50
3DMINSK: calls $0.50
*** TURN *** [3d Qd 4s] [5d]
3DMINSK: checks 
Antoxa970: bets $1.07
3DMINSK: folds 
Uncalled bet ($1.07) returned to Antoxa970
Antoxa970 collected $2.14 from pot
Antoxa970: doesn't show hand 
*** SUMMARY ***
Total pot $2.25 | Rake $0.11 
Board [3d Qd 4s 5d]
Seat 1: Antoxa970 collected ($2.14)
Seat 2: FeersPoker folded before Flop (didn't bet)
Seat 3: kastellani87 (button) folded before Flop (didn't bet)
Seat 4: BB_dont_cry (small blind) folded before Flop
Seat 5: 3DMINSK (big blind) folded on the Turn
Seat 6: StudentRB folded before Flop (didn't bet)
Seat 7: Pablo1405 folded before Flop (didn't bet)
Seat 8: SENSAS1AN folded before Flop (didn't bet)



PokerStars Hand #228692365282:  Hold'em No Limit ($0.25/$0.50 USD) - 2021/07/30 18:54:24 ET
Table 'Gorgo III' 9-max Seat #4 is the button
Seat 1: Antoxa970 ($21.89 in chips) 
Seat 2: FeersPoker ($71.51 in chips) 
Seat 3: kastellani87 ($105.86 in chips) 
Seat 4: BB_dont_cry ($49.25 in chips) 
Seat 5: 3DMINSK ($50 in chips) 
Seat 6: StudentRB ($50 in chips) 
Seat 7: Pablo1405 ($57.43 in chips) 
Seat 8: SENSAS1AN ($50 in chips) 
3DMINSK: posts small blind $0.25
StudentRB: posts big blind $0.50
fragonik: sits out 
*** HOLE CARDS ***
Pablo1405: folds 
SENSAS1AN: calls $0.50
Antoxa970: folds 
FeersPoker: folds 
kastellani87: calls $0.50
BB_dont_cry: folds 
3DMINSK: folds 
StudentRB: checks 
*** FLOP *** [5d 2h 9c]
StudentRB: checks 
SENSAS1AN: checks 
kastellani87: bets $0.50
StudentRB: raises $1.50 to $2
SENSAS1AN: folds 
kastellani87: folds 
Uncalled bet ($1.50) returned to StudentRB
StudentRB collected $2.61 from pot
StudentRB: doesn't show hand 
*** SUMMARY ***
Total pot $2.75 | Rake $0.14 
Board [5d 2h 9c]
Seat 1: Antoxa970 folded before Flop (didn't bet)
Seat 2: FeersPoker folded before Flop (didn't bet)
Seat 3: kastellani87 folded on the Flop
Seat 4: BB_dont_cry (button) folded before Flop (didn't bet)
Seat 5: 3DMINSK (small blind) folded before Flop
Seat 6: StudentRB (big blind) collected ($2.61)
Seat 7: Pablo1405 folded before Flop (didn't bet)
Seat 8: SENSAS1AN folded on the Flop



PokerStars Hand #228692530789:  Hold'em No Limit ($0.25/$0.50 USD) - 2021/07/30 19:02:00 ET
Table 'Gorgo III' 9-max Seat #4 is the button
Seat 1: Antoxa970 ($63.89 in chips) 
Seat 2: FeersPoker ($68.19 in chips) 
Seat 3: kastellani87 ($119.34 in chips) 
Seat 4: BB_dont_cry ($60.68 in chips) 
Seat 5: 3DMINSK ($50 in chips) 
Seat 6: StudentRB ($51.36 in chips) 
Seat 7: Pablo1405 ($51.18 in chips) 
Seat 8: SENSAS1AN ($50 in chips) 
Seat 9: fragonik ($50 in chips) 
3DMINSK: posts small blind $0.25
StudentRB: posts big blind $0.50
*** HOLE CARDS ***
Pablo1405: raises $1.50 to $2
SENSAS1AN: folds 
fragonik: folds 
Antoxa970: calls $2
FeersPoker: folds 
kastellani87: folds 
BB_dont_cry: folds 
3DMINSK: folds 
StudentRB: folds 
*** FLOP *** [3c 2s 5s]
Pablo1405: checks 
Antoxa970: bets $4.51
Pablo1405: calls $4.51
*** TURN *** [3c 2s 5s] [3d]
Pablo1405: checks 
Antoxa970: checks 
*** RIVER *** [3c 2s 5s 3d] [2c]
Pablo1405: checks 
Antoxa970: bets $13.08
Pablo1405: calls $13.08
*** SHOW DOWN ***
Antoxa970: shows [8h 7h] (two pair, Threes and Deuces)
Pablo1405: shows [As Kd] (two pair, Threes and Deuces - Ace kicker)
Pablo1405 collected $37.93 from pot
*** SUMMARY ***
Total pot $39.93 | Rake $2 
Board [3c 2s 5s 3d 2c]
Seat 1: Antoxa970 showed [8h 7h] and lost with two pair, Threes and Deuces
Seat 2: FeersPoker folded before Flop (didn't bet)
Seat 3: kastellani87 folded before Flop (didn't bet)
Seat 4: BB_dont_cry (button) folded before Flop (didn't bet)
Seat 5: 3DMINSK (small blind) folded before Flop
Seat 6: StudentRB (big blind) folded before Flop
Seat 7: Pablo1405 showed [As Kd] and won ($37.93) with two pair, Threes and Deuces
Seat 8: SENSAS1AN folded before Flop (didn't bet)
Seat 9: fragonik folded before Flop (didn't bet)



PokerStars Hand #228692549855:  Hold'em No Limit ($0.25/$0.50 USD) - 2021/07/30 19:02:53 ET
Table 'Gorgo III' 9-max Seat #5 is the button
Seat 1: Antoxa970 ($44.30 in chips) 
Seat 2: FeersPoker ($68.19 in chips) 
Seat 3: kastellani87 ($119.34 in chips) 
Seat 4: BB_dont_cry ($60.68 in chips) 
Seat 5: 3DMINSK ($50 in chips) 
Seat 6: StudentRB ($50.86 in chips) 
Seat 7: Pablo1405 ($69.52 in chips) 
Seat 8: SENSAS1AN ($50 in chips) 
Seat 9: fragonik ($50 in chips) 
StudentRB: posts small blind $0.25
Pablo1405: posts big blind $0.50
*** HOLE CARDS ***
SENSAS1AN: calls $0.50
fragonik: folds 
Antoxa970: calls $0.50
FeersPoker: folds 
kastellani87: folds 
BB_dont_cry: folds 
3DMINSK: calls $0.50
StudentRB: folds 
Pablo1405: checks 
*** FLOP *** [6s 4h 5c]
Pablo1405: bets $1.28
SENSAS1AN: folds 
Antoxa970: calls $1.28
3DMINSK: folds 
*** TURN *** [6s 4h 5c] [Td]
Pablo1405: bets $4
Antoxa970: calls $4
*** RIVER *** [6s 4h 5c Td] [5d]
Pablo1405: bets $11
Antoxa970: folds 
Uncalled bet ($11) returned to Pablo1405
Pablo1405 collected $12.17 from pot
Pablo1405: doesn't show hand 
*** SUMMARY ***
Total pot $12.81 | Rake $0.64 
Board [6s 4h 5c Td 5d]
Seat 1: Antoxa970 folded on the River
Seat 2: FeersPoker folded before Flop (didn't bet)
Seat 3: kastellani87 folded before Flop (didn't bet)
Seat 4: BB_dont_cry folded before Flop (didn't bet)
Seat 5: 3DMINSK (button) folded on the Flop
Seat 6: StudentRB (small blind) folded before Flop
Seat 7: Pablo1405 (big blind) collected ($12.17)
Seat 8: SENSAS1AN folded on the Flop
Seat 9: fragonik folded before Flop (didn't bet)



PokerStars Hand #228692570359:  Hold'em No Limit ($0.25/$0.50 USD) - 2021/07/30 19:03:49 ET
Table 'Gorgo III' 9-max Seat #6 is the button
Seat 1: Antoxa970 ($38.52 in chips) 
Seat 2: FeersPoker ($68.19 in chips) 
Seat 3: kastellani87 ($119.34 in chips) 
Seat 4: BB_dont_cry ($60.68 in chips) 
Seat 5: 3DMINSK ($50 in chips) 
Seat 6: StudentRB ($50.61 in chips) 
Seat 7: Pablo1405 ($75.91 in chips) 
Seat 8: SENSAS1AN ($50 in chips) 
Seat 9: fragonik ($50 in chips) 
Pablo1405: posts small blind $0.25
SENSAS1AN: posts big blind $0.50
*** HOLE CARDS ***
fragonik: folds 
Antoxa970: folds 
FeersPoker: raises $0.75 to $1.25
kastellani87: calls $1.25
BB_dont_cry: calls $1.25
3DMINSK: folds 
StudentRB: folds 
Pablo1405: folds 
SENSAS1AN: folds 
*** FLOP *** [5h 6h 2d]
FeersPoker: bets $2.87
kastellani87: folds 
BB_dont_cry: folds 
Uncalled bet ($2.87) returned to FeersPoker
FeersPoker collected $4.28 from pot
FeersPoker: doesn't show hand 
*** SUMMARY ***
Total pot $4.50 | Rake $0.22 
Board [5h 6h 2d]
Seat 1: Antoxa970 folded before Flop (didn't bet)
Seat 2: FeersPoker collected ($4.28)
Seat 3: kastellani87 folded on the Flop
Seat 4: BB_dont_cry folded on the Flop
Seat 5: 3DMINSK folded before Flop (didn't bet)
Seat 6: StudentRB (button) folded before Flop (didn't bet)
Seat 7: Pablo1405 (small blind) folded before Flop
Seat 8: SENSAS1AN (big blind) folded before Flop
Seat 9: fragonik folded before Flop (didn't bet)



PokerStars Hand #228692584839:  Hold'em No Limit ($0.25/$0.50 USD) - 2021/07/30 19:04:29 ET
Table 'Gorgo III' 9-max Seat #7 is the button
Seat 1: Antoxa970 ($38.52 in chips) 
Seat 2: FeersPoker ($71.22 in chips) 
Seat 3: kastellani87 ($118.09 in chips) 
Seat 4: BB_dont_cry ($59.43 in chips) 
Seat 5: 3DMINSK ($50 in chips) 
Seat 6: StudentRB ($50.61 in chips) 
Seat 7: Pablo1405 ($75.66 in chips) 
Seat 8: SENSAS1AN ($50 in chips) 
SENSAS1AN: posts small blind $0.25
fragonik: is sitting out 
Antoxa970: posts big blind $0.50
*** HOLE CARDS ***
FeersPoker: raises $0.75 to $1.25
kastellani87: calls $1.25
BB_dont_cry: folds 
fragonik leaves the table
3DMINSK: folds 
StudentRB: folds 
Pablo1405: folds 
SENSAS1AN: folds 
Antoxa970: calls $0.75
*** FLOP *** [Jd 6h 6d]
Pachebrash joins the table at seat #9 
Antoxa970: checks 
FeersPoker: checks 
kastellani87: bets $4
Antoxa970: folds 
FeersPoker: calls $4
*** TURN *** [Jd 6h 6d] [2d]
FeersPoker: checks 
kastellani87: checks 
*** RIVER *** [Jd 6h 6d 2d] [Kd]
FeersPoker: bets $3.76
kastellani87: folds 
Uncalled bet ($3.76) returned to FeersPoker
FeersPoker collected $11.40 from pot
FeersPoker: doesn't show hand 
*** SUMMARY ***
Total pot $12 | Rake $0.60 
Board [Jd 6h 6d 2d Kd]
Seat 1: Antoxa970 (big blind) folded on the Flop
Seat 2: FeersPoker collected ($11.40)
Seat 3: kastellani87 folded on the River
Seat 4: BB_dont_cry folded before Flop (didn't bet)
Seat 5: 3DMINSK folded before Flop (didn't bet)
Seat 6: StudentRB folded before Flop (didn't bet)
Seat 7: Pablo1405 (button) folded before Flop (didn't bet)
Seat 8: SENSAS1AN (small blind) folded before Flop



PokerStars Hand #228692618821:  Hold'em No Limit ($0.25/$0.50 USD) - 2021/07/30 19:06:04 ET
Table 'Gorgo III' 9-max Seat #8 is the button
Seat 1: Antoxa970 ($37.27 in chips) 
Seat 2: FeersPoker ($77.37 in chips) 
Seat 3: kastellani87 ($112.84 in chips) 
Seat 4: BB_dont_cry ($59.43 in chips) 
Seat 5: 3DMINSK ($50 in chips) 
Seat 6: StudentRB ($50.61 in chips) 
Seat 7: Pablo1405 ($75.66 in chips) 
Seat 8: SENSAS1AN ($50 in chips) 
Antoxa970: posts small blind $0.25
FeersPoker: posts big blind $0.50
*** HOLE CARDS ***
kastellani87: folds 
BB_dont_cry: folds 
3DMINSK: folds 
StudentRB: folds 
Pablo1405: folds 
SENSAS1AN: folds 
Antoxa970: calls $0.25
FeersPoker: checks 
*** FLOP *** [8c Ac Kc]
Antoxa970: bets $0.95
FeersPoker: folds 
Uncalled bet ($0.95) returned to Antoxa970
Antoxa970 collected $0.95 from pot
Antoxa970: doesn't show hand 
*** SUMMARY ***
Total pot $1 | Rake $0.05 
Board [8c Ac Kc]
Seat 1: Antoxa970 (small blind) collected ($0.95)
Seat 2: FeersPoker (big blind) folded on the Flop
Seat 3: kastellani87 folded before Flop (didn't bet)
Seat 4: BB_dont_cry folded before Flop (didn't bet)
Seat 5: 3DMINSK folded before Flop (didn't bet)
Seat 6: StudentRB folded before Flop (didn't bet)
Seat 7: Pablo1405 folded before Flop (didn't bet)
Seat 8: SENSAS1AN (button) folded before Flop (didn't bet)



PokerStars Hand #228692710995:  Hold'em No Limit ($0.25/$0.50 USD) - 2021/07/30 19:10:20 ET
Table 'Gorgo III' 9-max Seat #4 is the button
Seat 1: Antoxa970 ($21.97 in chips) 
Seat 2: FeersPoker ($71.33 in chips) 
Seat 3: kastellani87 ($116.56 in chips) 
Seat 4: BB_dont_cry ($60.10 in chips) 
Seat 5: 3DMINSK ($50 in chips) 
Seat 6: StudentRB ($50.61 in chips) 
Seat 7: Pablo1405 ($75.66 in chips) 
Seat 8: SENSAS1AN ($65.10 in chips) 
3DMINSK: posts small blind $0.25
StudentRB: posts big blind $0.50
Pachebrash: sits out 
*** HOLE CARDS ***
Pablo1405: folds 
SENSAS1AN: folds 
Antoxa970: calls $0.50
FeersPoker: folds 
kastellani87: calls $0.50
BB_dont_cry: folds 
3DMINSK: folds 
StudentRB: checks 
*** FLOP *** [Jd Js 4s]
StudentRB: checks 
Antoxa970: bets $1.66
kastellani87: folds 
StudentRB: folds 
Uncalled bet ($1.66) returned to Antoxa970
Antoxa970 collected $1.66 from pot
Antoxa970: doesn't show hand 
*** SUMMARY ***
Total pot $1.75 | Rake $0.09 
Board [Jd Js 4s]
Seat 1: Antoxa970 collected ($1.66)
Seat 2: FeersPoker folded before Flop (didn't bet)
Seat 3: kastellani87 folded on the Flop
Seat 4: BB_dont_cry (button) folded before Flop (didn't bet)
Seat 5: 3DMINSK (small blind) folded before Flop
Seat 6: StudentRB (big blind) folded on the Flop
Seat 7: Pablo1405 folded before Flop (didn't bet)
Seat 8: SENSAS1AN folded before Flop (didn't bet)



PokerStars Hand #228692846426:  Hold'em No Limit ($0.25/$0.50 USD) - 2021/07/30 19:16:43 ET
Table 'Gorgo III' 9-max Seat #7 is the button
Seat 1: Kolyan2114 ($50 in chips) 
Seat 2: FeersPoker ($68.08 in chips) 
Seat 3: kastellani87 ($115.31 in chips) 
Seat 4: BB_dont_cry ($68.08 in chips) 
Seat 5: 3DMINSK ($50 in chips) 
Seat 6: StudentRB ($76.98 in chips) 
Seat 7: Pablo1405 ($72.91 in chips) 
Seat 8: SENSAS1AN ($61.02 in chips) 
SENSAS1AN: posts small blind $0.25
Pachebrash: is sitting out 
Kolyan2114: posts big blind $0.50
*** HOLE CARDS ***
Pachebrash leaves the table
FeersPoker: folds 
kastellani87: folds 
BB_dont_cry: folds 
FeersPoker leaves the table
3DMINSK: folds 
StudentRB: folds 
Pablo1405: folds 
SENSAS1AN: calls $0.25
Kolyan2114: checks 
*** FLOP *** [Qs 5h Tc]
SENSAS1AN: checks 
Kolyan2114: checks 
*** TURN *** [Qs 5h Tc] [2h]
SENSAS1AN: checks 
Kolyan2114: checks 
*** RIVER *** [Qs 5h Tc 2h] [2c]
SENSAS1AN: checks 
Kolyan2114: checks 
*** SHOW DOWN ***
SENSAS1AN: shows [Ac 7c] (a pair of Deuces)
Kolyan2114: shows [5c 8h] (two pair, Fives and Deuces)
pudge.3096 joins the table at seat #2 
Kolyan2114 collected $0.95 from pot
*** SUMMARY ***
Total pot $1 | Rake $0.05 
Board [Qs 5h Tc 2h 2c]
Seat 1: Kolyan2114 (big blind) showed [5c 8h] and won ($0.95) with two pair, Fives and Deuces
Seat 2: FeersPoker folded before Flop (didn't bet)
Seat 3: kastellani87 folded before Flop (didn't bet)
Seat 4: BB_dont_cry folded before Flop (didn't bet)
Seat 5: 3DMINSK folded before Flop (didn't bet)
Seat 6: StudentRB folded before Flop (didn't bet)
Seat 7: Pablo1405 (button) folded before Flop (didn't bet)
Seat 8: SENSAS1AN (small blind) showed [Ac 7c] and lost with a pair of Deuces



PokerStars Hand #228692923936:  Hold'em No Limit ($0.25/$0.50 USD) - 2021/07/30 19:20:26 ET
Table 'Gorgo III' 9-max Seat #5 is the button
Seat 2: pudge.3096 ($52.99 in chips) 
Seat 3: kastellani87 ($117.27 in chips) 
Seat 4: BB_dont_cry ($66.53 in chips) 
Seat 5: 3DMINSK ($50 in chips) 
Seat 6: StudentRB ($97.23 in chips) 
Seat 7: Pablo1405 ($72.91 in chips) 
Seat 8: SENSAS1AN ($60.52 in chips) 
StudentRB: posts small blind $0.25
Pablo1405: posts big blind $0.50
*** HOLE CARDS ***
Myles96 leaves the table
SENSAS1AN: folds 
Kolyan2114 leaves the table
pudge.3096: folds 
kastellani87: calls $0.50
BB_dont_cry: raises $1.75 to $2.25
3DMINSK: folds 
StudentRB: folds 
Pablo1405: folds 
kastellani87: calls $1.75
*** FLOP *** [5h 5d 9s]
kastellani87: checks 
BB_dont_cry: checks 
*** TURN *** [5h 5d 9s] [Ad]
kastellani87: bets $4.99
BB_dont_cry: folds 
Uncalled bet ($4.99) returned to kastellani87
kastellani87 collected $4.99 from pot
kastellani87: doesn't show hand 
*** SUMMARY ***
Total pot $5.25 | Rake $0.26 
Board [5h 5d 9s Ad]
Seat 2: pudge.3096 folded before Flop (didn't bet)
Seat 3: kastellani87 collected ($4.99)
Seat 4: BB_dont_cry folded on the Turn
Seat 5: 3DMINSK (button) folded before Flop (didn't bet)
Seat 6: StudentRB (small blind) folded before Flop
Seat 7: Pablo1405 (big blind) folded before Flop
Seat 8: SENSAS1AN folded before Flop (didn't bet)



PokerStars Hand #228692936717:  Hold'em No Limit ($0.25/$0.50 USD) - 2021/07/30 19:21:02 ET
Table 'Gorgo III' 9-max Seat #6 is the button
Seat 2: pudge.3096 ($52.99 in chips) 
Seat 3: kastellani87 ($120.01 in chips) 
Seat 4: BB_dont_cry ($64.28 in chips) 
Seat 5: 3DMINSK ($50 in chips) 
Seat 6: StudentRB ($96.98 in chips) 
Seat 7: Pablo1405 ($72.41 in chips) 
Seat 8: SENSAS1AN ($60.52 in chips) 
Pablo1405: posts small blind $0.25
SENSAS1AN: posts big blind $0.50
*** HOLE CARDS ***
pudge.3096: folds 
kastellani87: calls $0.50
BB_dont_cry: calls $0.50
3DMINSK: folds 
StudentRB: folds 
Pablo1405: folds 
SENSAS1AN: checks 
*** FLOP *** [3s Jh 6s]
SENSAS1AN: checks 
kastellani87: checks 
BB_dont_cry: bets $2
SENSAS1AN: folds 
kastellani87: folds 
Uncalled bet ($2) returned to BB_dont_cry
BB_dont_cry collected $1.66 from pot
*** SUMMARY ***
Total pot $1.75 | Rake $0.09 
Board [3s Jh 6s]
Seat 2: pudge.3096 folded before Flop (didn't bet)
Seat 3: kastellani87 folded on the Flop
Seat 4: BB_dont_cry collected ($1.66)
Seat 5: 3DMINSK folded before Flop (didn't bet)
Seat 6: StudentRB (button) folded before Flop (didn't bet)
Seat 7: Pablo1405 (small blind) folded before Flop
Seat 8: SENSAS1AN (big blind) folded on the Flop



PokerStars Hand #228692950361:  Hold'em No Limit ($0.25/$0.50 USD) - 2021/07/30 19:21:41 ET
Table 'Gorgo III' 9-max Seat #7 is the button
Seat 2: pudge.3096 ($52.99 in chips) 
Seat 3: kastellani87 ($119.51 in chips) 
Seat 4: BB_dont_cry ($65.44 in chips) 
Seat 5: 3DMINSK ($50 in chips) 
Seat 6: StudentRB ($96.98 in chips) 
Seat 7: Pablo1405 ($72.16 in chips) 
Seat 8: SENSAS1AN ($60.02 in chips) 
SENSAS1AN: posts small blind $0.25
pudge.3096: posts big blind $0.50
*** HOLE CARDS ***
kastellani87: calls $0.50
BB_dont_cry: folds 
3DMINSK: folds 
StudentRB: folds 
Pablo1405: raises $1.50 to $2
PanicJX joins the table at seat #1 
SENSAS1AN: folds 
pudge.3096: folds 
kastellani87: folds 
Uncalled bet ($1.50) returned to Pablo1405
Pablo1405 collected $1.75 from pot
Pablo1405: doesn't show hand 
*** SUMMARY ***
Total pot $1.75 | Rake $0 
Seat 2: pudge.3096 (big blind) folded before Flop
Seat 3: kastellani87 folded before Flop
Seat 4: BB_dont_cry folded before Flop (didn't bet)
Seat 5: 3DMINSK folded before Flop (didn't bet)
Seat 6: StudentRB folded before Flop (didn't bet)
Seat 7: Pablo1405 (button) collected ($1.75)
Seat 8: SENSAS1AN (small blind) folded before Flop



PokerStars Hand #228692964580:  Hold'em No Limit ($0.25/$0.50 USD) - 2021/07/30 19:22:22 ET
Table 'Gorgo III' 9-max Seat #8 is the button
Seat 2: pudge.3096 ($52.49 in chips) 
Seat 3: kastellani87 ($119.01 in chips) 
Seat 4: BB_dont_cry ($65.44 in chips) 
Seat 5: 3DMINSK ($50 in chips) 
Seat 6: StudentRB ($96.98 in chips) 
Seat 7: Pablo1405 ($73.41 in chips) 
Seat 8: SENSAS1AN ($59.77 in chips) 
pudge.3096: posts small blind $0.25
kastellani87: posts big blind $0.50
*** HOLE CARDS ***
BB_dont_cry: folds 
3DMINSK: folds 
StudentRB: folds 
Pablo1405: raises $1 to $1.50
SENSAS1AN: folds 
pudge.3096: folds 
kastellani87: folds 
Uncalled bet ($1) returned to Pablo1405
Pablo1405 collected $1.25 from pot
Pablo1405: doesn't show hand 
*** SUMMARY ***
Total pot $1.25 | Rake $0 
Seat 2: pudge.3096 (small blind) folded before Flop
Seat 3: kastellani87 (big blind) folded before Flop
Seat 4: BB_dont_cry folded before Flop (didn't bet)
Seat 5: 3DMINSK folded before Flop (didn't bet)
Seat 6: StudentRB folded before Flop (didn't bet)
Seat 7: Pablo1405 collected ($1.25)
Seat 8: SENSAS1AN (button) folded before Flop (didn't bet)



PokerStars Hand #228692976912:  Hold'em No Limit ($0.25/$0.50 USD) - 2021/07/30 19:22:46 ET
Table 'Gorgo III' 9-max Seat #2 is the button
Seat 2: pudge.3096 ($52.24 in chips) 
Seat 3: kastellani87 ($118.51 in chips) 
Seat 4: BB_dont_cry ($65.44 in chips) 
Seat 5: 3DMINSK ($50 in chips) 
Seat 6: StudentRB ($96.98 in chips) 
Seat 7: Pablo1405 ($74.16 in chips) 
Seat 8: SENSAS1AN ($59.77 in chips) 
kastellani87: posts small blind $0.25
BB_dont_cry: posts big blind $0.50
PanicJX: sits out 
*** HOLE CARDS ***
3DMINSK: raises $1 to $1.50
StudentRB: folds 
Pablo1405: folds 
SENSAS1AN: folds 
pudge.3096: folds 
kastellani87: raises $3.50 to $5
BB_dont_cry: folds 
3DMINSK: calls $3.50
*** FLOP *** [Jd Kd Td]
kastellani87: bets $113.51 and is all-in
doucwhatic joins the table at seat #9 
3DMINSK: folds 
Uncalled bet ($113.51) returned to kastellani87
kastellani87 collected $9.98 from pot
kastellani87: doesn't show hand 
*** SUMMARY ***
Total pot $10.50 | Rake $0.52 
Board [Jd Kd Td]
Seat 2: pudge.3096 (button) folded before Flop (didn't bet)
Seat 3: kastellani87 (small blind) collected ($9.98)
Seat 4: BB_dont_cry (big blind) folded before Flop
Seat 5: 3DMINSK folded on the Flop
Seat 6: StudentRB folded before Flop (didn't bet)
Seat 7: Pablo1405 folded before Flop (didn't bet)
Seat 8: SENSAS1AN folded before Flop (didn't bet)



PokerStars Hand #228693042796:  Hold'em No Limit ($0.25/$0.50 USD) - 2021/07/30 19:25:57 ET
Table 'Gorgo III' 9-max Seat #9 is the button
Seat 1: PanicJX ($49.50 in chips) 
Seat 2: pudge.3096 ($50 in chips) 
Seat 3: kastellani87 ($124.18 in chips) 
Seat 4: BB_dont_cry ($63.19 in chips) 
Seat 5: 3DMINSK ($57.74 in chips) 
Seat 6: StudentRB ($96.23 in chips) 
Seat 7: Pablo1405 ($76.16 in chips) 
Seat 9: doucwhatic ($43 in chips) 
PanicJX: posts small blind $0.25
pudge.3096: posts big blind $0.50
wildermorph: sits out 
*** HOLE CARDS ***
kastellani87: calls $0.50
BB_dont_cry: folds 
3DMINSK: folds 
StudentRB: raises $1.50 to $2
Pablo1405: folds 
doucwhatic: raises $3.50 to $5.50
PanicJX: folds 
pudge.3096: folds 
kastellani87: folds 
StudentRB: folds 
Uncalled bet ($3.50) returned to doucwhatic
doucwhatic collected $5.25 from pot
doucwhatic: doesn't show hand 
*** SUMMARY ***
Total pot $5.25 | Rake $0 
Seat 1: PanicJX (small blind) folded before Flop
Seat 2: pudge.3096 (big blind) folded before Flop
Seat 3: kastellani87 folded before Flop
Seat 4: BB_dont_cry folded before Flop (didn't bet)
Seat 5: 3DMINSK folded before Flop (didn't bet)
Seat 6: StudentRB folded before Flop
Seat 7: Pablo1405 folded before Flop (didn't bet)
Seat 9: doucwhatic (button) collected ($5.25)



PokerStars Hand #228693053121:  Hold'em No Limit ($0.25/$0.50 USD) - 2021/07/30 19:26:27 ET
Table 'Gorgo III' 9-max Seat #1 is the button
Seat 1: PanicJX ($49.25 in chips) 
Seat 2: pudge.3096 ($50 in chips) 
Seat 3: kastellani87 ($123.68 in chips) 
Seat 4: BB_dont_cry ($63.19 in chips) 
Seat 5: 3DMINSK ($57.74 in chips) 
Seat 6: StudentRB ($94.23 in chips) 
Seat 7: Pablo1405 ($76.16 in chips) 
Seat 9: doucwhatic ($46.25 in chips) 
pudge.3096: posts small blind $0.25
kastellani87: posts big blind $0.50
wildermorph: sits out 
*** HOLE CARDS ***
BB_dont_cry: folds 
3DMINSK: folds 
StudentRB: folds 
Pablo1405: folds 
doucwhatic: raises $1 to $1.50
PanicJX: folds 
pudge.3096: raises $4.50 to $6
kastellani87: folds 
doucwhatic: calls $4.50
*** FLOP *** [8c 9d Qd]
pudge.3096: checks 
doucwhatic: bets $11.88
pudge.3096: folds 
Uncalled bet ($11.88) returned to doucwhatic
doucwhatic collected $11.88 from pot
doucwhatic: doesn't show hand 
*** SUMMARY ***
Total pot $12.50 | Rake $0.62 
Board [8c 9d Qd]
Seat 1: PanicJX (button) folded before Flop (didn't bet)
Seat 2: pudge.3096 (small blind) folded on the Flop
Seat 3: kastellani87 (big blind) folded before Flop
Seat 4: BB_dont_cry folded before Flop (didn't bet)
Seat 5: 3DMINSK folded before Flop (didn't bet)
Seat 6: StudentRB folded before Flop (didn't bet)
Seat 7: Pablo1405 folded before Flop (didn't bet)
Seat 9: doucwhatic collected ($11.88)



PokerStars Hand #228693071540:  Hold'em No Limit ($0.25/$0.50 USD) - 2021/07/30 19:26:56 ET
Table 'Gorgo III' 9-max Seat #2 is the button
Seat 1: PanicJX ($49.25 in chips) 
Seat 2: pudge.3096 ($50 in chips) 
Seat 3: kastellani87 ($123.18 in chips) 
Seat 4: BB_dont_cry ($63.19 in chips) 
Seat 5: 3DMINSK ($57.74 in chips) 
Seat 6: StudentRB ($94.23 in chips) 
Seat 7: Pablo1405 ($76.16 in chips) 
Seat 9: doucwhatic ($52.13 in chips) 
kastellani87: posts small blind $0.25
BB_dont_cry: posts big blind $0.50
wildermorph: sits out 
*** HOLE CARDS ***
3DMINSK: folds 
StudentRB: folds 
Pablo1405: folds 
doucwhatic: folds 
PanicJX: folds 
pudge.3096: folds 
kastellani87: raises $0.50 to $1
BB_dont_cry: calls $0.50
*** FLOP *** [Qc 4c Jh]
kastellani87: checks 
BB_dont_cry: checks 
*** TURN *** [Qc 4c Jh] [2h]
kastellani87: bets $0.95
BB_dont_cry: raises $4.05 to $5
kastellani87: folds 
Uncalled bet ($4.05) returned to BB_dont_cry
BB_dont_cry collected $3.70 from pot
*** SUMMARY ***
Total pot $3.90 | Rake $0.20 
Board [Qc 4c Jh 2h]
Seat 1: PanicJX folded before Flop (didn't bet)
Seat 2: pudge.3096 (button) folded before Flop (didn't bet)
Seat 3: kastellani87 (small blind) folded on the Turn
Seat 4: BB_dont_cry (big blind) collected ($3.70)
Seat 5: 3DMINSK folded before Flop (didn't bet)
Seat 6: StudentRB folded before Flop (didn't bet)
Seat 7: Pablo1405 folded before Flop (didn't bet)
Seat 9: doucwhatic folded before Flop (didn't bet)



PokerStars Hand #228693084017:  Hold'em No Limit ($0.25/$0.50 USD) - 2021/07/30 19:27:32 ET
Table 'Gorgo III' 9-max Seat #3 is the button
Seat 1: PanicJX ($49.25 in chips) 
Seat 2: pudge.3096 ($50 in chips) 
Seat 3: kastellani87 ($121.23 in chips) 
Seat 4: BB_dont_cry ($64.94 in chips) 
Seat 6: StudentRB ($94.23 in chips) 
Seat 7: Pablo1405 ($76.16 in chips) 
Seat 9: doucwhatic ($52.13 in chips) 
BB_dont_cry: posts small blind $0.25
3DMINSK: is sitting out 
StudentRB: posts big blind $0.50
wildermorph: sits out 
*** HOLE CARDS ***
3DMINSK leaves the table
Pablo1405: folds 
doucwhatic: folds 
PanicJX: folds 
pudge.3096: raises $0.75 to $1.25
kastellani87: folds 
BB_dont_cry: folds 
StudentRB: folds 
Uncalled bet ($0.75) returned to pudge.3096
pudge.3096 collected $1.25 from pot
pudge.3096: doesn't show hand 
*** SUMMARY ***
Total pot $1.25 | Rake $0 
Seat 1: PanicJX folded before Flop (didn't bet)
Seat 2: pudge.3096 collected ($1.25)
Seat 3: kastellani87 (button) folded before Flop (didn't bet)
Seat 4: BB_dont_cry (small blind) folded before Flop
Seat 6: StudentRB (big blind) folded before Flop
Seat 7: Pablo1405 folded before Flop (didn't bet)
Seat 9: doucwhatic folded before Flop (didn't bet)



PokerStars Hand #228693211554:  Hold'em No Limit ($0.25/$0.50 USD) - 2021/07/30 19:33:46 ET
Table 'Gorgo III' 9-max Seat #3 is the button
Seat 1: PanicJX ($48.50 in chips) 
Seat 2: pudge.3096 ($50 in chips) 
Seat 3: kastellani87 ($126.15 in chips) 
Seat 4: BB_dont_cry ($64.19 in chips) 
Seat 5: Mr. white2604 ($61.15 in chips) 
Seat 6: StudentRB ($94.23 in chips) 
Seat 7: Pablo1405 ($77.05 in chips) 
Seat 8: wildermorph ($59.58 in chips) 
Seat 9: eltonmiranda ($39.25 in chips) 
BB_dont_cry: posts small blind $0.25
Mr. white2604: posts big blind $0.50
*** HOLE CARDS ***
StudentRB: folds 
Pablo1405: folds 
wildermorph: raises $0.50 to $1
eltonmiranda: folds 
PanicJX: folds 
pudge.3096: calls $1
kastellani87: calls $1
BB_dont_cry: calls $0.75
Mr. white2604: calls $0.50
*** FLOP *** [7s 5h 8h]
BB_dont_cry: bets $2.38
Mr. white2604: calls $2.38
wildermorph: folds 
pudge.3096: folds 
kastellani87: calls $2.38
*** TURN *** [7s 5h 8h] [3s]
BB_dont_cry: checks 
Mr. white2604: bets $1.50
kastellani87: calls $1.50
BB_dont_cry: calls $1.50
*** RIVER *** [7s 5h 8h 3s] [7c]
BB_dont_cry: checks 
Mr. white2604: checks 
kastellani87: checks 
*** SHOW DOWN ***
BB_dont_cry: shows [8d Kd] (two pair, Eights and Sevens)
Mr. white2604: mucks hand 
kastellani87: mucks hand 
BB_dont_cry collected $15.81 from pot
*** SUMMARY ***
Total pot $16.64 | Rake $0.83 
Board [7s 5h 8h 3s 7c]
Seat 1: PanicJX folded before Flop (didn't bet)
Seat 2: pudge.3096 folded on the Flop
Seat 3: kastellani87 (button) mucked
Seat 4: BB_dont_cry (small blind) showed [8d Kd] and won ($15.81) with two pair, Eights and Sevens
Seat 5: Mr. white2604 (big blind) mucked
Seat 6: StudentRB folded before Flop (didn't bet)
Seat 7: Pablo1405 folded before Flop (didn't bet)
Seat 8: wildermorph folded on the Flop
Seat 9: eltonmiranda folded before Flop (didn't bet)



PokerStars Hand #228693234369:  Hold'em No Limit ($0.25/$0.50 USD) - 2021/07/30 19:34:54 ET
Table 'Gorgo III' 9-max Seat #4 is the button
Seat 1: PanicJX ($48.50 in chips) 
Seat 2: pudge.3096 ($50 in chips) 
Seat 3: kastellani87 ($121.27 in chips) 
Seat 4: BB_dont_cry ($75.12 in chips) 
Seat 5: Mr. white2604 ($56.27 in chips) 
Seat 6: StudentRB ($94.23 in chips) 
Seat 7: Pablo1405 ($77.05 in chips) 
Seat 8: wildermorph ($58.58 in chips) 
Seat 9: eltonmiranda ($39.25 in chips) 
Mr. white2604: posts small blind $0.25
StudentRB: posts big blind $0.50
*** HOLE CARDS ***
Pablo1405: folds 
wildermorph: folds 
eltonmiranda: raises $1 to $1.50
PanicJX: folds 
pudge.3096: calls $1.50
kastellani87: folds 
BB_dont_cry: calls $1.50
Mr. white2604: calls $1.25
StudentRB: raises $8 to $9.50
eltonmiranda: folds 
pudge.3096: folds 
BB_dont_cry: folds 
Mr. white2604: folds 
Uncalled bet ($8) returned to StudentRB
StudentRB collected $7.50 from pot
StudentRB: doesn't show hand 
*** SUMMARY ***
Total pot $7.50 | Rake $0 
Seat 1: PanicJX folded before Flop (didn't bet)
Seat 2: pudge.3096 folded before Flop
Seat 3: kastellani87 folded before Flop (didn't bet)
Seat 4: BB_dont_cry (button) folded before Flop
Seat 5: Mr. white2604 (small blind) folded before Flop
Seat 6: StudentRB (big blind) collected ($7.50)
Seat 7: Pablo1405 folded before Flop (didn't bet)
Seat 8: wildermorph folded before Flop (didn't bet)
Seat 9: eltonmiranda folded before Flop



PokerStars Hand #228693251807:  Hold'em No Limit ($0.25/$0.50 USD) - 2021/07/30 19:35:47 ET
Table 'Gorgo III' 9-max Seat #5 is the button
Seat 1: PanicJX ($48.50 in chips) 
Seat 2: pudge.3096 ($50 in chips) 
Seat 3: kastellani87 ($121.27 in chips) 
Seat 4: BB_dont_cry ($73.62 in chips) 
Seat 5: Mr. white2604 ($54.77 in chips) 
Seat 6: StudentRB ($100.23 in chips) 
Seat 7: Pablo1405 ($77.05 in chips) 
Seat 8: wildermorph ($58.58 in chips) 
Seat 9: eltonmiranda ($37.75 in chips) 
StudentRB: posts small blind $0.25
Pablo1405: posts big blind $0.50
*** HOLE CARDS ***
wildermorph: folds 
eltonmiranda: folds 
PanicJX: folds 
pudge.3096: folds 
kastellani87: calls $0.50
BB_dont_cry: raises $1.75 to $2.25
Mr. white2604: folds 
StudentRB: folds 
Pablo1405: raises $4.75 to $7
kastellani87: folds 
BB_dont_cry: calls $4.75
*** FLOP *** [3c Ts 5s]
Pablo1405: checks 
BB_dont_cry: checks 
*** TURN *** [3c Ts 5s] [3s]
Pablo1405: bets $5
BB_dont_cry: folds 
Uncalled bet ($5) returned to Pablo1405
Pablo1405 collected $14.01 from pot
Pablo1405: doesn't show hand 
*** SUMMARY ***
Total pot $14.75 | Rake $0.74 
Board [3c Ts 5s 3s]
Seat 1: PanicJX folded before Flop (didn't bet)
Seat 2: pudge.3096 folded before Flop (didn't bet)
Seat 3: kastellani87 folded before Flop
Seat 4: BB_dont_cry folded on the Turn
Seat 5: Mr. white2604 (button) folded before Flop (didn't bet)
Seat 6: StudentRB (small blind) folded before Flop
Seat 7: Pablo1405 (big blind) collected ($14.01)
Seat 8: wildermorph folded before Flop (didn't bet)
Seat 9: eltonmiranda folded before Flop (didn't bet)



PokerStars Hand #228693273042:  Hold'em No Limit ($0.25/$0.50 USD) - 2021/07/30 19:36:49 ET
Table 'Gorgo III' 9-max Seat #6 is the button
Seat 1: PanicJX ($48.50 in chips) 
Seat 2: pudge.3096 ($50 in chips) 
Seat 3: kastellani87 ($120.77 in chips) 
Seat 4: BB_dont_cry ($66.62 in chips) 
Seat 5: Mr. white2604 ($54.77 in chips) 
Seat 6: StudentRB ($99.98 in chips) 
Seat 7: Pablo1405 ($84.06 in chips) 
Seat 8: wildermorph ($58.58 in chips) 
Seat 9: eltonmiranda ($37.75 in chips) 
Pablo1405: posts small blind $0.25
wildermorph: posts big blind $0.50
*** HOLE CARDS ***
eltonmiranda: calls $0.50
PanicJX: folds 
pudge.3096: folds 
kastellani87: folds 
BB_dont_cry: folds 
Mr. white2604: raises $1 to $1.50
StudentRB: folds 
Pablo1405: calls $1.25
wildermorph: folds 
eltonmiranda: calls $1
*** FLOP *** [9d 5d Qd]
Pablo1405: checks 
eltonmiranda: checks 
Mr. white2604: bets $1.50
Pablo1405: folds 
eltonmiranda: folds 
Uncalled bet ($1.50) returned to Mr. white2604
Mr. white2604 collected $4.75 from pot
Mr. white2604: doesn't show hand 
*** SUMMARY ***
Total pot $5 | Rake $0.25 
Board [9d 5d Qd]
Seat 1: PanicJX folded before Flop (didn't bet)
Seat 2: pudge.3096 folded before Flop (didn't bet)
Seat 3: kastellani87 folded before Flop (didn't bet)
Seat 4: BB_dont_cry folded before Flop (didn't bet)
Seat 5: Mr. white2604 collected ($4.75)
Seat 6: StudentRB (button) folded before Flop (didn't bet)
Seat 7: Pablo1405 (small blind) folded on the Flop
Seat 8: wildermorph (big blind) folded before Flop
Seat 9: eltonmiranda folded on the Flop



PokerStars Hand #228693287667:  Hold'em No Limit ($0.25/$0.50 USD) - 2021/07/30 19:37:33 ET
Table 'Gorgo III' 9-max Seat #7 is the button
Seat 1: PanicJX ($48.50 in chips) 
Seat 2: pudge.3096 ($50 in chips) 
Seat 3: kastellani87 ($120.77 in chips) 
Seat 4: BB_dont_cry ($66.62 in chips) 
Seat 5: Mr. white2604 ($58.02 in chips) 
Seat 6: StudentRB ($99.98 in chips) 
Seat 7: Pablo1405 ($82.56 in chips) 
Seat 8: wildermorph ($58.08 in chips) 
Seat 9: eltonmiranda ($36.25 in chips) 
wildermorph: posts small blind $0.25
eltonmiranda: posts big blind $0.50
*** HOLE CARDS ***
PanicJX: folds 
pudge.3096: folds 
kastellani87: calls $0.50
BB_dont_cry: folds 
Mr. white2604: folds 
StudentRB: folds 
Pablo1405: folds 
wildermorph: folds 
eltonmiranda: checks 
*** FLOP *** [3h Kc Ah]
eltonmiranda: checks 
kastellani87: bets $0.50
eltonmiranda: folds 
Uncalled bet ($0.50) returned to kastellani87
kastellani87 collected $1.19 from pot
kastellani87: doesn't show hand 
*** SUMMARY ***
Total pot $1.25 | Rake $0.06 
Board [3h Kc Ah]
Seat 1: PanicJX folded before Flop (didn't bet)
Seat 2: pudge.3096 folded before Flop (didn't bet)
Seat 3: kastellani87 collected ($1.19)
Seat 4: BB_dont_cry folded before Flop (didn't bet)
Seat 5: Mr. white2604 folded before Flop (didn't bet)
Seat 6: StudentRB folded before Flop (didn't bet)
Seat 7: Pablo1405 (button) folded before Flop (didn't bet)
Seat 8: wildermorph (small blind) folded before Flop
Seat 9: eltonmiranda (big blind) folded on the Flop



PokerStars Hand #228693295780:  Hold'em No Limit ($0.25/$0.50 USD) - 2021/07/30 19:37:58 ET
Table 'Gorgo III' 9-max Seat #8 is the button
Seat 1: PanicJX ($48.50 in chips) 
Seat 2: pudge.3096 ($50 in chips) 
Seat 3: kastellani87 ($121.46 in chips) 
Seat 4: BB_dont_cry ($66.62 in chips) 
Seat 5: Mr. white2604 ($58.02 in chips) 
Seat 6: StudentRB ($99.98 in chips) 
Seat 7: Pablo1405 ($82.56 in chips) 
Seat 8: wildermorph ($57.83 in chips) 
Seat 9: eltonmiranda ($35.75 in chips) 
eltonmiranda: posts small blind $0.25
PanicJX: posts big blind $0.50
*** HOLE CARDS ***
pudge.3096: folds 
kastellani87: calls $0.50
BB_dont_cry: folds 
Mr. white2604: raises $0.50 to $1
StudentRB: folds 
Pablo1405: folds 
wildermorph: folds 
eltonmiranda: folds 
PanicJX: calls $0.50
kastellani87: calls $0.50
*** FLOP *** [2c 5d Ah]
PanicJX: checks 
kastellani87: checks 
Mr. white2604: checks 
*** TURN *** [2c 5d Ah] [Kc]
PanicJX: checks 
kastellani87: checks 
Mr. white2604: bets $1.50
PanicJX: folds 
kastellani87: calls $1.50
*** RIVER *** [2c 5d Ah Kc] [9d]
kastellani87: checks 
Mr. white2604: bets $1.50
kastellani87: calls $1.50
*** SHOW DOWN ***
Mr. white2604: shows [As Jh] (a pair of Aces)
kastellani87: mucks hand 
Mr. white2604 collected $8.79 from pot
*** SUMMARY ***
Total pot $9.25 | Rake $0.46 
Board [2c 5d Ah Kc 9d]
Seat 1: PanicJX (big blind) folded on the Turn
Seat 2: pudge.3096 folded before Flop (didn't bet)
Seat 3: kastellani87 mucked
Seat 4: BB_dont_cry folded before Flop (didn't bet)
Seat 5: Mr. white2604 showed [As Jh] and won ($8.79) with a pair of Aces
Seat 6: StudentRB folded before Flop (didn't bet)
Seat 7: Pablo1405 folded before Flop (didn't bet)
Seat 8: wildermorph (button) folded before Flop (didn't bet)
Seat 9: eltonmiranda (small blind) folded before Flop



PokerStars Hand #228693319644:  Hold'em No Limit ($0.25/$0.50 USD) - 2021/07/30 19:38:51 ET
Table 'Gorgo III' 9-max Seat #9 is the button
Seat 1: PanicJX ($47.50 in chips) 
Seat 2: pudge.3096 ($50 in chips) 
Seat 3: kastellani87 ($117.46 in chips) 
Seat 4: BB_dont_cry ($66.62 in chips) 
Seat 5: Mr. white2604 ($62.81 in chips) 
Seat 6: StudentRB ($99.98 in chips) 
Seat 7: Pablo1405 ($82.56 in chips) 
Seat 8: wildermorph ($57.83 in chips) 
Seat 9: eltonmiranda ($35.50 in chips) 
PanicJX: posts small blind $0.25
pudge.3096: posts big blind $0.50
*** HOLE CARDS ***
kastellani87: calls $0.50
BB_dont_cry: calls $0.50
Mr. white2604: calls $0.50
StudentRB: folds 
Pablo1405: folds 
wildermorph: folds 
eltonmiranda: folds 
PanicJX: raises $2.50 to $3
pudge.3096: folds 
kastellani87: calls $2.50
BB_dont_cry: calls $2.50
Mr. white2604: calls $2.50
*** FLOP *** [6c 6s 5s]
PanicJX: bets $11.88
kastellani87: folds 
BB_dont_cry: folds 
Mr. white2604: folds 
Uncalled bet ($11.88) returned to PanicJX
PanicJX collected $11.88 from pot
PanicJX: doesn't show hand 
*** SUMMARY ***
Total pot $12.50 | Rake $0.62 
Board [6c 6s 5s]
Seat 1: PanicJX (small blind) collected ($11.88)
Seat 2: pudge.3096 (big blind) folded before Flop
Seat 3: kastellani87 folded on the Flop
Seat 4: BB_dont_cry folded on the Flop
Seat 5: Mr. white2604 folded on the Flop
Seat 6: StudentRB folded before Flop (didn't bet)
Seat 7: Pablo1405 folded before Flop (didn't bet)
Seat 8: wildermorph folded before Flop (didn't bet)
Seat 9: eltonmiranda (button) folded before Flop (didn't bet)



PokerStars Hand #228693335744:  Hold'em No Limit ($0.25/$0.50 USD) - 2021/07/30 19:39:39 ET
Table 'Gorgo III' 9-max Seat #1 is the button
Seat 1: PanicJX ($56.38 in chips) 
Seat 2: pudge.3096 ($50 in chips) 
Seat 3: kastellani87 ($114.46 in chips) 
Seat 4: BB_dont_cry ($63.62 in chips) 
Seat 5: Mr. white2604 ($59.81 in chips) 
Seat 6: StudentRB ($99.98 in chips) 
Seat 7: Pablo1405 ($82.56 in chips) 
Seat 8: wildermorph ($57.83 in chips) 
Seat 9: eltonmiranda ($35.50 in chips) 
pudge.3096: posts small blind $0.25
kastellani87: posts big blind $0.50
*** HOLE CARDS ***
BB_dont_cry: raises $2 to $2.50
Mr. white2604: folds 
StudentRB: folds 
Pablo1405: folds 
wildermorph: folds 
eltonmiranda: folds 
PanicJX: folds 
pudge.3096: folds 
kastellani87: folds 
Uncalled bet ($2) returned to BB_dont_cry
BB_dont_cry collected $1.25 from pot
*** SUMMARY ***
Total pot $1.25 | Rake $0 
Seat 1: PanicJX (button) folded before Flop (didn't bet)
Seat 2: pudge.3096 (small blind) folded before Flop
Seat 3: kastellani87 (big blind) folded before Flop
Seat 4: BB_dont_cry collected ($1.25)
Seat 5: Mr. white2604 folded before Flop (didn't bet)
Seat 6: StudentRB folded before Flop (didn't bet)
Seat 7: Pablo1405 folded before Flop (didn't bet)
Seat 8: wildermorph folded before Flop (didn't bet)
Seat 9: eltonmiranda folded before Flop (didn't bet)



PokerStars Hand #228693347188:  Hold'em No Limit ($0.25/$0.50 USD) - 2021/07/30 19:40:14 ET
Table 'Gorgo III' 9-max Seat #2 is the button
Seat 1: PanicJX ($56.38 in chips) 
Seat 2: pudge.3096 ($50 in chips) 
Seat 3: kastellani87 ($113.96 in chips) 
Seat 4: BB_dont_cry ($64.37 in chips) 
Seat 5: Mr. white2604 ($59.81 in chips) 
Seat 6: StudentRB ($99.98 in chips) 
Seat 7: Pablo1405 ($82.56 in chips) 
Seat 8: wildermorph ($57.83 in chips) 
Seat 9: eltonmiranda ($35.50 in chips) 
kastellani87: posts small blind $0.25
BB_dont_cry: posts big blind $0.50
*** HOLE CARDS ***
Mr. white2604: raises $0.50 to $1
StudentRB: folds 
Pablo1405: folds 
wildermorph: folds 
eltonmiranda: folds 
PanicJX: folds 
pudge.3096: folds 
kastellani87: calls $0.75
BB_dont_cry: folds 
*** FLOP *** [9d 7h Ts]
kastellani87: bets $1.19
Mr. white2604: calls $1.19
*** TURN *** [9d 7h Ts] [8h]
kastellani87: bets $2.32
Mr. white2604: folds 
Uncalled bet ($2.32) returned to kastellani87
kastellani87 collected $4.64 from pot
kastellani87: doesn't show hand 
*** SUMMARY ***
Total pot $4.88 | Rake $0.24 
Board [9d 7h Ts 8h]
Seat 1: PanicJX folded before Flop (didn't bet)
Seat 2: pudge.3096 (button) folded before Flop (didn't bet)
Seat 3: kastellani87 (small blind) collected ($4.64)
Seat 4: BB_dont_cry (big blind) folded before Flop
Seat 5: Mr. white2604 folded on the Turn
Seat 6: StudentRB folded before Flop (didn't bet)
Seat 7: Pablo1405 folded before Flop (didn't bet)
Seat 8: wildermorph folded before Flop (didn't bet)
Seat 9: eltonmiranda folded before Flop (didn't bet)



PokerStars Hand #228693361067:  Hold'em No Limit ($0.25/$0.50 USD) - 2021/07/30 19:40:56 ET
Table 'Gorgo III' 9-max Seat #3 is the button
Seat 1: PanicJX ($56.38 in chips) 
Seat 2: pudge.3096 ($50 in chips) 
Seat 3: kastellani87 ($116.41 in chips) 
Seat 4: BB_dont_cry ($63.87 in chips) 
Seat 5: Mr. white2604 ($57.62 in chips) 
Seat 6: StudentRB ($99.98 in chips) 
Seat 7: Pablo1405 ($82.56 in chips) 
Seat 8: wildermorph ($57.83 in chips) 
Seat 9: eltonmiranda ($35.50 in chips) 
BB_dont_cry: posts small blind $0.25
Mr. white2604: posts big blind $0.50
*** HOLE CARDS ***
StudentRB: folds 
Pablo1405: folds 
wildermorph has timed out
wildermorph: folds 
eltonmiranda: folds 
PanicJX: folds 
pudge.3096: folds 
kastellani87: folds 
BB_dont_cry: folds 
Uncalled bet ($0.25) returned to Mr. white2604
Mr. white2604 collected $0.50 from pot
Mr. white2604: doesn't show hand 
*** SUMMARY ***
Total pot $0.50 | Rake $0 
Seat 1: PanicJX folded before Flop (didn't bet)
Seat 2: pudge.3096 folded before Flop (didn't bet)
Seat 3: kastellani87 (button) folded before Flop (didn't bet)
Seat 4: BB_dont_cry (small blind) folded before Flop
Seat 5: Mr. white2604 (big blind) collected ($0.50)
Seat 6: StudentRB folded before Flop (didn't bet)
Seat 7: Pablo1405 folded before Flop (didn't bet)
Seat 8: wildermorph folded before Flop (didn't bet)
Seat 9: eltonmiranda folded before Flop (didn't bet)



PokerStars Hand #228693368451:  Hold'em No Limit ($0.25/$0.50 USD) - 2021/07/30 19:41:19 ET
Table 'Gorgo III' 9-max Seat #4 is the button
Seat 1: PanicJX ($56.38 in chips) 
Seat 2: pudge.3096 ($50 in chips) 
Seat 3: kastellani87 ($116.41 in chips) 
Seat 4: BB_dont_cry ($63.62 in chips) 
Seat 5: Mr. white2604 ($57.87 in chips) 
Seat 6: StudentRB ($99.98 in chips) 
Seat 7: Pablo1405 ($82.56 in chips) 
Seat 8: wildermorph ($57.83 in chips) 
Seat 9: eltonmiranda ($35.50 in chips) 
Mr. white2604: posts small blind $0.25
StudentRB: posts big blind $0.50
*** HOLE CARDS ***
Pablo1405: folds 
wildermorph: folds 
eltonmiranda: folds 
PanicJX: folds 
pudge.3096: raises $0.75 to $1.25
kastellani87: calls $1.25
BB_dont_cry: folds 
Mr. white2604: calls $1
StudentRB: folds 
*** FLOP *** [7c Qs 9s]
Mr. white2604: bets $4
pudge.3096: calls $4
kastellani87: folds 
*** TURN *** [7c Qs 9s] [9h]
Mr. white2604: bets $2
pudge.3096: calls $2
*** RIVER *** [7c Qs 9s 9h] [Jd]
Mr. white2604: bets $3.50
pudge.3096: calls $3.50
*** SHOW DOWN ***
Mr. white2604: shows [Jc Js] (a full house, Jacks full of Nines)
pudge.3096: mucks hand 
Mr. white2604 collected $22.09 from pot
*** SUMMARY ***
Total pot $23.25 | Rake $1.16 
Board [7c Qs 9s 9h Jd]
Seat 1: PanicJX folded before Flop (didn't bet)
Seat 2: pudge.3096 mucked
Seat 3: kastellani87 folded on the Flop
Seat 4: BB_dont_cry (button) folded before Flop (didn't bet)
Seat 5: Mr. white2604 (small blind) showed [Jc Js] and won ($22.09) with a full house, Jacks full of Nines
Seat 6: StudentRB (big blind) folded before Flop
Seat 7: Pablo1405 folded before Flop (didn't bet)
Seat 8: wildermorph folded before Flop (didn't bet)
Seat 9: eltonmiranda folded before Flop (didn't bet)



PokerStars Hand #228693404335:  Hold'em No Limit ($0.25/$0.50 USD) - 2021/07/30 19:42:38 ET
Table 'Gorgo III' 9-max Seat #5 is the button
Seat 1: PanicJX ($56.38 in chips) 
Seat 2: pudge.3096 ($50 in chips) 
Seat 3: kastellani87 ($115.16 in chips) 
Seat 4: BB_dont_cry ($63.62 in chips) 
Seat 5: Mr. white2604 ($69.21 in chips) 
Seat 6: StudentRB ($99.48 in chips) 
Seat 8: wildermorph ($57.83 in chips) 
Seat 9: eltonmiranda ($35.50 in chips) 
StudentRB: posts small blind $0.25
wildermorph: posts big blind $0.50
*** HOLE CARDS ***
eltonmiranda: folds 
eltonmiranda leaves the table
PanicJX: raises $0.75 to $1.25
pudge.3096: folds 
kastellani87: folds 
fragonik joins the table at seat #9 
BB_dont_cry: calls $1.25
Mr. white2604: folds 
Pablo1405 leaves the table
StudentRB: folds 
el Fatto joins the table at seat #7 
wildermorph: folds 
*** FLOP *** [Jd 3s 3h]
PanicJX: checks 
BB_dont_cry: bets $3.09
PanicJX: calls $3.09
*** TURN *** [Jd 3s 3h] [Th]
PanicJX: checks 
BB_dont_cry: checks 
*** RIVER *** [Jd 3s 3h Th] [4c]
PanicJX: checks 
BB_dont_cry: checks 
*** SHOW DOWN ***
PanicJX: shows [Ks Ah] (a pair of Threes)
BB_dont_cry: shows [8c Jc] (two pair, Jacks and Threes)
BB_dont_cry collected $8.96 from pot
*** SUMMARY ***
Total pot $9.43 | Rake $0.47 
Board [Jd 3s 3h Th 4c]
Seat 1: PanicJX showed [Ks Ah] and lost with a pair of Threes
Seat 2: pudge.3096 folded before Flop (didn't bet)
Seat 3: kastellani87 folded before Flop (didn't bet)
Seat 4: BB_dont_cry showed [8c Jc] and won ($8.96) with two pair, Jacks and Threes
Seat 5: Mr. white2604 (button) folded before Flop (didn't bet)
Seat 6: StudentRB (small blind) folded before Flop
Seat 8: wildermorph (big blind) folded before Flop
Seat 9: eltonmiranda folded before Flop (didn't bet)



PokerStars Hand #228693415926:  Hold'em No Limit ($0.25/$0.50 USD) - 2021/07/30 19:43:14 ET
Table 'Gorgo III' 9-max Seat #6 is the button
Seat 1: PanicJX ($52.04 in chips) 
Seat 2: pudge.3096 ($50 in chips) 
Seat 3: kastellani87 ($115.16 in chips) 
Seat 4: BB_dont_cry ($68.24 in chips) 
Seat 5: Mr. white2604 ($69.21 in chips) 
Seat 6: StudentRB ($99.23 in chips) 
Seat 8: wildermorph ($57.33 in chips) 
Seat 9: fragonik ($50 in chips) 
wildermorph: posts small blind $0.25
fragonik: posts big blind $0.50
*** HOLE CARDS ***
PanicJX: folds 
pudge.3096: folds 
kastellani87: calls $0.50
BB_dont_cry: calls $0.50
Mr. white2604: calls $0.50
pudge.3096 is disconnected 
StudentRB: raises $2 to $2.50
wildermorph: folds 
fragonik: folds 
kastellani87: folds 
BB_dont_cry: calls $2
Mr. white2604: calls $2
*** FLOP *** [Th 8d 5c]
BB_dont_cry: bets $4.16
Mr. white2604: folds 
StudentRB: calls $4.16
*** TURN *** [Th 8d 5c] [4d]
BB_dont_cry: bets $2
StudentRB: raises $6 to $8
BB_dont_cry: folds 
Uncalled bet ($6) returned to StudentRB
StudentRB collected $20.02 from pot
StudentRB: doesn't show hand 
*** SUMMARY ***
Total pot $21.07 | Rake $1.05 
Board [Th 8d 5c 4d]
Seat 1: PanicJX folded before Flop (didn't bet)
Seat 2: pudge.3096 folded before Flop (didn't bet)
Seat 3: kastellani87 folded before Flop
Seat 4: BB_dont_cry folded on the Turn
Seat 5: Mr. white2604 folded on the Flop
Seat 6: StudentRB (button) collected ($20.02)
Seat 8: wildermorph (small blind) folded before Flop
Seat 9: fragonik (big blind) folded before Flop



PokerStars Hand #228693444142:  Hold'em No Limit ($0.25/$0.50 USD) - 2021/07/30 19:44:42 ET
Table 'Gorgo III' 9-max Seat #8 is the button
Seat 1: PanicJX ($52.04 in chips) 
Seat 2: pudge.3096 ($50 in chips) 
Seat 3: kastellani87 ($114.66 in chips) 
Seat 4: BB_dont_cry ($59.58 in chips) 
Seat 5: Mr. white2604 ($66.71 in chips) 
Seat 6: StudentRB ($110.59 in chips) 
Seat 8: wildermorph ($57.08 in chips) 
Seat 9: fragonik ($50 in chips) 
fragonik: posts small blind $0.25
PanicJX: posts big blind $0.50
el Fatto: sits out 
*** HOLE CARDS ***
pudge.3096: raises $0.75 to $1.25
kastellani87: folds 
BB_dont_cry: calls $1.25
Mr. white2604: raises $3.25 to $4.50
StudentRB: folds 
wildermorph: folds 
fragonik: raises $7.25 to $11.75
PanicJX: folds 
pudge.3096: folds 
BB_dont_cry: folds 
Mr. white2604: calls $7.25
*** FLOP *** [3d Ac Qs]
fragonik: bets $8.75
Mr. white2604: folds 
Uncalled bet ($8.75) returned to fragonik
fragonik collected $25.18 from pot
*** SUMMARY ***
Total pot $26.50 | Rake $1.32 
Board [3d Ac Qs]
Seat 1: PanicJX (big blind) folded before Flop
Seat 2: pudge.3096 folded before Flop
Seat 3: kastellani87 folded before Flop (didn't bet)
Seat 4: BB_dont_cry folded before Flop
Seat 5: Mr. white2604 folded on the Flop
Seat 6: StudentRB folded before Flop (didn't bet)
Seat 8: wildermorph (button) folded before Flop (didn't bet)
Seat 9: fragonik (small blind) collected ($25.18)



PokerStars Hand #228693464955:  Hold'em No Limit ($0.25/$0.50 USD) - 2021/07/30 19:45:47 ET
Table 'Gorgo III' 9-max Seat #9 is the button
Seat 1: PanicJX ($51.54 in chips) 
Seat 2: pudge.3096 ($50 in chips) 
Seat 3: kastellani87 ($114.66 in chips) 
Seat 4: BB_dont_cry ($58.33 in chips) 
Seat 5: Mr. white2604 ($54.96 in chips) 
Seat 6: StudentRB ($110.59 in chips) 
Seat 8: wildermorph ($57.08 in chips) 
Seat 9: fragonik ($63.43 in chips) 
PanicJX: posts small blind $0.25
pudge.3096: posts big blind $0.50
el Fatto: sits out 
*** HOLE CARDS ***
kastellani87: raises $1 to $1.50
BB_dont_cry: folds 
Mr. white2604: folds 
StudentRB: folds 
wildermorph: folds 
fragonik: folds 
PanicJX: folds 
pudge.3096: folds 
Uncalled bet ($1) returned to kastellani87
kastellani87 collected $1.25 from pot
kastellani87: doesn't show hand 
*** SUMMARY ***
Total pot $1.25 | Rake $0 
Seat 1: PanicJX (small blind) folded before Flop
Seat 2: pudge.3096 (big blind) folded before Flop
Seat 3: kastellani87 collected ($1.25)
Seat 4: BB_dont_cry folded before Flop (didn't bet)
Seat 5: Mr. white2604 folded before Flop (didn't bet)
Seat 6: StudentRB folded before Flop (didn't bet)
Seat 8: wildermorph folded before Flop (didn't bet)
Seat 9: fragonik (button) folded before Flop (didn't bet)



PokerStars Hand #228693471990:  Hold'em No Limit ($0.25/$0.50 USD) - 2021/07/30 19:46:09 ET
Table 'Gorgo III' 9-max Seat #1 is the button
Seat 1: PanicJX ($51.29 in chips) 
Seat 2: pudge.3096 ($50 in chips) 
Seat 3: kastellani87 ($115.41 in chips) 
Seat 4: BB_dont_cry ($58.33 in chips) 
Seat 5: Mr. white2604 ($54.96 in chips) 
Seat 6: StudentRB ($110.59 in chips) 
Seat 8: wildermorph ($57.08 in chips) 
Seat 9: fragonik ($63.43 in chips) 
pudge.3096: posts small blind $0.25
kastellani87: posts big blind $0.50
el Fatto: sits out 
*** HOLE CARDS ***
BB_dont_cry: folds 
Mr. white2604: calls $0.50
StudentRB: folds 
wildermorph: folds 
fragonik: folds 
PanicJX: folds 
pudge.3096: folds 
kastellani87: checks 
*** FLOP *** [9c 7d 3d]
kastellani87: checks 
Mr. white2604: bets $2
kastellani87: folds 
Uncalled bet ($2) returned to Mr. white2604
Mr. white2604 collected $1.19 from pot
Mr. white2604: doesn't show hand 
*** SUMMARY ***
Total pot $1.25 | Rake $0.06 
Board [9c 7d 3d]
Seat 1: PanicJX (button) folded before Flop (didn't bet)
Seat 2: pudge.3096 (small blind) folded before Flop
Seat 3: kastellani87 (big blind) folded on the Flop
Seat 4: BB_dont_cry folded before Flop (didn't bet)
Seat 5: Mr. white2604 collected ($1.19)
Seat 6: StudentRB folded before Flop (didn't bet)
Seat 8: wildermorph folded before Flop (didn't bet)
Seat 9: fragonik folded before Flop (didn't bet)



PokerStars Hand #228693482522:  Hold'em No Limit ($0.25/$0.50 USD) - 2021/07/30 19:46:41 ET
Table 'Gorgo III' 9-max Seat #2 is the button
Seat 1: PanicJX ($51.29 in chips) 
Seat 2: pudge.3096 ($50 in chips) 
Seat 3: kastellani87 ($114.91 in chips) 
Seat 4: BB_dont_cry ($58.33 in chips) 
Seat 5: Mr. white2604 ($55.65 in chips) 
Seat 6: StudentRB ($110.59 in chips) 
Seat 8: wildermorph ($57.08 in chips) 
Seat 9: fragonik ($63.43 in chips) 
kastellani87: posts small blind $0.25
BB_dont_cry: posts big blind $0.50
el Fatto: sits out 
*** HOLE CARDS ***
Mr. white2604: raises $0.50 to $1
StudentRB: folds 
wildermorph: folds 
fragonik: folds 
PanicJX: folds 
pudge.3096: folds 
kastellani87: calls $0.75
BB_dont_cry: raises $0.50 to $1.50
Mr. white2604: calls $0.50
kastellani87: calls $0.50
*** FLOP *** [2d 4d 8c]
kastellani87: checks 
BB_dont_cry: bets $0.50
Mr. white2604: raises $1.50 to $2
kastellani87: calls $2
BB_dont_cry: calls $1.50
*** TURN *** [2d 4d 8c] [Kh]
kastellani87: checks 
BB_dont_cry: bets $0.50
Mr. white2604: raises $2.50 to $3
kastellani87: folds 
BB_dont_cry: calls $2.50
*** RIVER *** [2d 4d 8c Kh] [8d]
BB_dont_cry: bets $0.50
Mr. white2604: calls $0.50
*** SHOW DOWN ***
BB_dont_cry: shows [6c Kc] (two pair, Kings and Eights)
Mr. white2604: mucks hand 
BB_dont_cry collected $16.62 from pot
*** SUMMARY ***
Total pot $17.50 | Rake $0.88 
Board [2d 4d 8c Kh 8d]
Seat 1: PanicJX folded before Flop (didn't bet)
Seat 2: pudge.3096 (button) folded before Flop (didn't bet)
Seat 3: kastellani87 (small blind) folded on the Turn
Seat 4: BB_dont_cry (big blind) showed [6c Kc] and won ($16.62) with two pair, Kings and Eights
Seat 5: Mr. white2604 mucked
Seat 6: StudentRB folded before Flop (didn't bet)
Seat 8: wildermorph folded before Flop (didn't bet)
Seat 9: fragonik folded before Flop (didn't bet)



PokerStars Hand #228693506532:  Hold'em No Limit ($0.25/$0.50 USD) - 2021/07/30 19:47:57 ET
Table 'Gorgo III' 9-max Seat #3 is the button
Seat 1: PanicJX ($51.29 in chips) 
Seat 2: pudge.3096 ($50 in chips) 
Seat 3: kastellani87 ($111.41 in chips) 
Seat 4: BB_dont_cry ($67.95 in chips) 
Seat 5: Mr. white2604 ($48.65 in chips) 
Seat 6: StudentRB ($110.59 in chips) 
Seat 8: wildermorph ($57.08 in chips) 
Seat 9: fragonik ($63.43 in chips) 
BB_dont_cry: posts small blind $0.25
Mr. white2604: posts big blind $0.50
el Fatto: sits out 
*** HOLE CARDS ***
StudentRB: folds 
wildermorph: folds 
fragonik: folds 
PanicJX: folds 
pudge.3096: raises $0.75 to $1.25
kastellani87: folds 
BB_dont_cry: folds 
Mr. white2604: calls $0.75
*** FLOP *** [Ac 6d Ks]
Mr. white2604: checks 
pudge.3096: bets $0.84
Mr. white2604: calls $0.84
*** TURN *** [Ac 6d Ks] [4c]
Mr. white2604: checks 
pudge.3096: checks 
*** RIVER *** [Ac 6d Ks 4c] [9d]
Mr. white2604: checks 
pudge.3096: checks 
*** SHOW DOWN ***
Mr. white2604: shows [Qs Tc] (high card Ace)
pudge.3096: mucks hand 
Mr. white2604 collected $4.21 from pot
*** SUMMARY ***
Total pot $4.43 | Rake $0.22 
Board [Ac 6d Ks 4c 9d]
Seat 1: PanicJX folded before Flop (didn't bet)
Seat 2: pudge.3096 mucked
Seat 3: kastellani87 (button) folded before Flop (didn't bet)
Seat 4: BB_dont_cry (small blind) folded before Flop
Seat 5: Mr. white2604 (big blind) showed [Qs Tc] and won ($4.21) with high card Ace
Seat 6: StudentRB folded before Flop (didn't bet)
Seat 8: wildermorph folded before Flop (didn't bet)
Seat 9: fragonik folded before Flop (didn't bet)



PokerStars Hand #228693519009:  Hold'em No Limit ($0.25/$0.50 USD) - 2021/07/30 19:48:37 ET
Table 'Gorgo III' 9-max Seat #4 is the button
Seat 1: PanicJX ($51.29 in chips) 
Seat 2: pudge.3096 ($50 in chips) 
Seat 3: kastellani87 ($111.41 in chips) 
Seat 4: BB_dont_cry ($67.70 in chips) 
Seat 5: Mr. white2604 ($50.77 in chips) 
Seat 6: StudentRB ($110.59 in chips) 
Seat 8: wildermorph ($57.08 in chips) 
Seat 9: fragonik ($63.43 in chips) 
Mr. white2604: posts small blind $0.25
StudentRB: posts big blind $0.50
el Fatto: sits out 
*** HOLE CARDS ***
wildermorph has timed out
wildermorph: folds 
fragonik: folds 
PanicJX: folds 
pudge.3096: folds 
kastellani87: folds 
BB_dont_cry: raises $1 to $1.50
Mr. white2604: calls $1.25
wildermorph leaves the table
StudentRB: raises $5 to $6.50
BB_dont_cry: folds 
Mr. white2604: calls $5
*** FLOP *** [Js 4d 9h]
Mr. white2604: checks 
StudentRB: bets $4.55
Mr. white2604: folds 
Uncalled bet ($4.55) returned to StudentRB
StudentRB collected $13.78 from pot
StudentRB: doesn't show hand 
*** SUMMARY ***
Total pot $14.50 | Rake $0.72 
Board [Js 4d 9h]
Seat 1: PanicJX folded before Flop (didn't bet)
Seat 2: pudge.3096 folded before Flop (didn't bet)
Seat 3: kastellani87 folded before Flop (didn't bet)
Seat 4: BB_dont_cry (button) folded before Flop
Seat 5: Mr. white2604 (small blind) folded on the Flop
Seat 6: StudentRB (big blind) collected ($13.78)
Seat 8: wildermorph folded before Flop (didn't bet)
Seat 9: fragonik folded before Flop (didn't bet)



PokerStars Hand #228693531891:  Hold'em No Limit ($0.25/$0.50 USD) - 2021/07/30 19:49:18 ET
Table 'Gorgo III' 9-max Seat #5 is the button
Seat 1: PanicJX ($51.29 in chips) 
Seat 2: pudge.3096 ($50 in chips) 
Seat 3: kastellani87 ($111.41 in chips) 
Seat 4: BB_dont_cry ($66.20 in chips) 
Seat 5: Mr. white2604 ($44.27 in chips) 
Seat 6: StudentRB ($117.87 in chips) 
Seat 7: el Fatto ($50 in chips) 
Seat 9: fragonik ($63.43 in chips) 
StudentRB: posts small blind $0.25
el Fatto: posts big blind $0.50
*** HOLE CARDS ***
fragonik: folds 
PanicJX: folds 
pudge.3096: folds 
kastellani87: folds 
BB_dont_cry: folds 
Mr. white2604: folds 
StudentRB: folds 
Uncalled bet ($0.25) returned to el Fatto
el Fatto collected $0.50 from pot
el Fatto: doesn't show hand 
*** SUMMARY ***
Total pot $0.50 | Rake $0 
Seat 1: PanicJX folded before Flop (didn't bet)
Seat 2: pudge.3096 folded before Flop (didn't bet)
Seat 3: kastellani87 folded before Flop (didn't bet)
Seat 4: BB_dont_cry folded before Flop (didn't bet)
Seat 5: Mr. white2604 (button) folded before Flop (didn't bet)
Seat 6: StudentRB (small blind) folded before Flop
Seat 7: el Fatto (big blind) collected ($0.50)
Seat 9: fragonik folded before Flop (didn't bet)



PokerStars Hand #228693536969:  Hold'em No Limit ($0.25/$0.50 USD) - 2021/07/30 19:49:34 ET
Table 'Gorgo III' 9-max Seat #6 is the button
Seat 1: PanicJX ($51.29 in chips) 
Seat 2: pudge.3096 ($50 in chips) 
Seat 3: kastellani87 ($111.41 in chips) 
Seat 4: BB_dont_cry ($66.20 in chips) 
Seat 5: Mr. white2604 ($44.27 in chips) 
Seat 6: StudentRB ($117.62 in chips) 
Seat 7: el Fatto ($50.25 in chips) 
Seat 9: fragonik ($63.43 in chips) 
el Fatto: posts small blind $0.25
fragonik: posts big blind $0.50
*** HOLE CARDS ***
PanicJX has timed out
PanicJX: folds 
pudge.3096: folds 
kastellani87: folds 
BB_dont_cry: folds 
MonplDCmax joins the table at seat #8 
Mr. white2604: calls $0.50
StudentRB: raises $1 to $1.50
el Fatto: folds 
fragonik: folds 
Mr. white2604: calls $1
*** FLOP *** [As 4s 4d]
Mr. white2604: checks 
StudentRB: bets $1.17
Mr. white2604: folds 
Uncalled bet ($1.17) returned to StudentRB
StudentRB collected $3.56 from pot
StudentRB: doesn't show hand 
*** SUMMARY ***
Total pot $3.75 | Rake $0.19 
Board [As 4s 4d]
Seat 1: PanicJX folded before Flop (didn't bet)
Seat 2: pudge.3096 folded before Flop (didn't bet)
Seat 3: kastellani87 folded before Flop (didn't bet)
Seat 4: BB_dont_cry folded before Flop (didn't bet)
Seat 5: Mr. white2604 folded on the Flop
Seat 6: StudentRB (button) collected ($3.56)
Seat 7: el Fatto (small blind) folded before Flop
Seat 9: fragonik (big blind) folded before Flop



PokerStars Hand #228693556435:  Hold'em No Limit ($0.25/$0.50 USD) - 2021/07/30 19:50:36 ET
Table 'Gorgo III' 9-max Seat #7 is the button
Seat 1: PanicJX ($51.29 in chips) 
Seat 2: pudge.3096 ($50 in chips) 
Seat 3: kastellani87 ($111.41 in chips) 
Seat 4: BB_dont_cry ($66.20 in chips) 
Seat 5: Mr. white2604 ($42.77 in chips) 
Seat 6: StudentRB ($119.68 in chips) 
Seat 7: el Fatto ($50 in chips) 
Seat 9: fragonik ($62.93 in chips) 
fragonik: posts small blind $0.25
PanicJX: posts big blind $0.50
*** HOLE CARDS ***
pudge.3096: folds 
kastellani87: folds 
BB_dont_cry: folds 
Mr. white2604: calls $0.50
StudentRB: raises $1.50 to $2
el Fatto: folds 
fragonik: folds 
PanicJX: calls $1.50
Mr. white2604: calls $1.50
*** FLOP *** [7h 8s 8d]
PanicJX: checks 
Mr. white2604: bets $2.50
StudentRB: folds 
PanicJX: raises $6 to $8.50
Mr. white2604: calls $6
*** TURN *** [7h 8s 8d] [6d]
PanicJX: bets $8.25
Mr. white2604: folds 
Uncalled bet ($8.25) returned to PanicJX
PanicJX collected $22.09 from pot
PanicJX: doesn't show hand 
*** SUMMARY ***
Total pot $23.25 | Rake $1.16 
Board [7h 8s 8d 6d]
Seat 1: PanicJX (big blind) collected ($22.09)
Seat 2: pudge.3096 folded before Flop (didn't bet)
Seat 3: kastellani87 folded before Flop (didn't bet)
Seat 4: BB_dont_cry folded before Flop (didn't bet)
Seat 5: Mr. white2604 folded on the Turn
Seat 6: StudentRB folded on the Flop
Seat 7: el Fatto (button) folded before Flop (didn't bet)
Seat 9: fragonik (small blind) folded before Flop



PokerStars Hand #228693582368:  Hold'em No Limit ($0.25/$0.50 USD) - 2021/07/30 19:52:00 ET
Table 'Gorgo III' 9-max Seat #9 is the button
Seat 1: PanicJX ($62.88 in chips) 
Seat 2: pudge.3096 ($50 in chips) 
Seat 3: kastellani87 ($111.41 in chips) 
Seat 4: BB_dont_cry ($66.20 in chips) 
Seat 5: Mr. white2604 ($32.27 in chips) 
Seat 6: StudentRB ($117.68 in chips) 
Seat 7: el Fatto ($50 in chips) 
Seat 9: fragonik ($62.68 in chips) 
PanicJX: posts small blind $0.25
pudge.3096: posts big blind $0.50
MonplDCmax: sits out 
*** HOLE CARDS ***
kastellani87: raises $1 to $1.50
BB_dont_cry: folds 
Mr. white2604: folds 
StudentRB: folds 
el Fatto: folds 
fragonik: folds 
PanicJX: folds 
pudge.3096: folds 
Uncalled bet ($1) returned to kastellani87
kastellani87 collected $1.25 from pot
kastellani87: doesn't show hand 
*** SUMMARY ***
Total pot $1.25 | Rake $0 
Seat 1: PanicJX (small blind) folded before Flop
Seat 2: pudge.3096 (big blind) folded before Flop
Seat 3: kastellani87 collected ($1.25)
Seat 4: BB_dont_cry folded before Flop (didn't bet)
Seat 5: Mr. white2604 folded before Flop (didn't bet)
Seat 6: StudentRB folded before Flop (didn't bet)
Seat 7: el Fatto folded before Flop (didn't bet)
Seat 9: fragonik (button) folded before Flop (didn't bet)



PokerStars Hand #228693588160:  Hold'em No Limit ($0.25/$0.50 USD) - 2021/07/30 19:52:18 ET
Table 'Gorgo III' 9-max Seat #1 is the button
Seat 1: PanicJX ($62.63 in chips) 
Seat 2: pudge.3096 ($50 in chips) 
Seat 3: kastellani87 ($112.16 in chips) 
Seat 4: BB_dont_cry ($66.20 in chips) 
Seat 5: Mr. white2604 ($32.27 in chips) 
Seat 6: StudentRB ($117.68 in chips) 
Seat 7: el Fatto ($50 in chips) 
Seat 9: fragonik ($62.68 in chips) 
pudge.3096: posts small blind $0.25
kastellani87: posts big blind $0.50
MonplDCmax: sits out 
*** HOLE CARDS ***
BB_dont_cry: folds 
Mr. white2604: folds 
StudentRB: raises $0.75 to $1.25
el Fatto: folds 
fragonik: folds 
PanicJX: folds 
pudge.3096: folds 
kastellani87: calls $0.75
*** FLOP *** [6d Kc Qc]
kastellani87: bets $1.31
StudentRB: raises $2.19 to $3.50
kastellani87: calls $2.19
*** TURN *** [6d Kc Qc] [Th]
kastellani87: checks 
StudentRB: bets $7.50
kastellani87: folds 
Uncalled bet ($7.50) returned to StudentRB
StudentRB collected $9.26 from pot
StudentRB: doesn't show hand 
*** SUMMARY ***
Total pot $9.75 | Rake $0.49 
Board [6d Kc Qc Th]
Seat 1: PanicJX (button) folded before Flop (didn't bet)
Seat 2: pudge.3096 (small blind) folded before Flop
Seat 3: kastellani87 (big blind) folded on the Turn
Seat 4: BB_dont_cry folded before Flop (didn't bet)
Seat 5: Mr. white2604 folded before Flop (didn't bet)
Seat 6: StudentRB collected ($9.26)
Seat 7: el Fatto folded before Flop (didn't bet)
Seat 9: fragonik folded before Flop (didn't bet)



PokerStars Hand #228693621396:  Hold'em No Limit ($0.25/$0.50 USD) - 2021/07/30 19:53:44 ET
Table 'Gorgo III' 9-max Seat #2 is the button
Seat 1: PanicJX ($62.63 in chips) 
Seat 2: pudge.3096 ($50 in chips) 
Seat 3: kastellani87 ($107.41 in chips) 
Seat 4: BB_dont_cry ($66.20 in chips) 
Seat 5: Mr. white2604 ($32.27 in chips) 
Seat 6: StudentRB ($122.19 in chips) 
Seat 7: el Fatto ($50 in chips) 
Seat 9: fragonik ($62.68 in chips) 
kastellani87: posts small blind $0.25
BB_dont_cry: posts big blind $0.50
MonplDCmax: sits out 
*** HOLE CARDS ***
Mr. white2604: folds 
StudentRB: folds 
el Fatto: folds 
fragonik: folds 
PanicJX: raises $0.75 to $1.25
pudge.3096: folds 
kastellani87: calls $1
BB_dont_cry: folds 
*** FLOP *** [Td 3s Kc]
kastellani87: checks 
PanicJX: bets $1.43
kastellani87: folds 
Uncalled bet ($1.43) returned to PanicJX
PanicJX collected $2.85 from pot
PanicJX: doesn't show hand 
*** SUMMARY ***
Total pot $3 | Rake $0.15 
Board [Td 3s Kc]
Seat 1: PanicJX collected ($2.85)
Seat 2: pudge.3096 (button) folded before Flop (didn't bet)
Seat 3: kastellani87 (small blind) folded on the Flop
Seat 4: BB_dont_cry (big blind) folded before Flop
Seat 5: Mr. white2604 folded before Flop (didn't bet)
Seat 6: StudentRB folded before Flop (didn't bet)
Seat 7: el Fatto folded before Flop (didn't bet)
Seat 9: fragonik folded before Flop (didn't bet)



PokerStars Hand #228693632462:  Hold'em No Limit ($0.25/$0.50 USD) - 2021/07/30 19:54:20 ET
Table 'Gorgo III' 9-max Seat #3 is the button
Seat 1: PanicJX ($64.23 in chips) 
Seat 2: pudge.3096 ($50 in chips) 
Seat 3: kastellani87 ($106.16 in chips) 
Seat 4: BB_dont_cry ($65.70 in chips) 
Seat 5: Mr. white2604 ($32.27 in chips) 
Seat 6: StudentRB ($122.19 in chips) 
Seat 7: el Fatto ($50 in chips) 
Seat 9: fragonik ($62.68 in chips) 
BB_dont_cry: posts small blind $0.25
Mr. white2604: posts big blind $0.50
MonplDCmax: sits out 
*** HOLE CARDS ***
StudentRB: folds 
el Fatto: folds 
fragonik: folds 
PanicJX: folds 
pudge.3096: folds 
kastellani87: calls $0.50
BB_dont_cry: calls $0.25
Mr. white2604: checks 
*** FLOP *** [Ts Qs 4d]
BB_dont_cry: checks 
Mr. white2604: checks 
kastellani87: checks 
*** TURN *** [Ts Qs 4d] [2h]
BB_dont_cry: checks 
Mr. white2604: bets $1
kastellani87: calls $1
BB_dont_cry: folds 
*** RIVER *** [Ts Qs 4d 2h] [3c]
Mr. white2604: checks 
kastellani87: checks 
*** SHOW DOWN ***
Mr. white2604: shows [7s 4c] (a pair of Fours)
kastellani87: mucks hand 
Mr. white2604 collected $3.32 from pot
*** SUMMARY ***
Total pot $3.50 | Rake $0.18 
Board [Ts Qs 4d 2h 3c]
Seat 1: PanicJX folded before Flop (didn't bet)
Seat 2: pudge.3096 folded before Flop (didn't bet)
Seat 3: kastellani87 (button) mucked
Seat 4: BB_dont_cry (small blind) folded on the Turn
Seat 5: Mr. white2604 (big blind) showed [7s 4c] and won ($3.32) with a pair of Fours
Seat 6: StudentRB folded before Flop (didn't bet)
Seat 7: el Fatto folded before Flop (didn't bet)
Seat 9: fragonik folded before Flop (didn't bet)



PokerStars Hand #228693656977:  Hold'em No Limit ($0.25/$0.50 USD) - 2021/07/30 19:55:46 ET
Table 'Gorgo III' 9-max Seat #4 is the button
Seat 1: PanicJX ($64.23 in chips) 
Seat 2: pudge.3096 ($50 in chips) 
Seat 3: kastellani87 ($104.66 in chips) 
Seat 4: BB_dont_cry ($65.20 in chips) 
Seat 5: Mr. white2604 ($34.09 in chips) 
Seat 6: StudentRB ($122.19 in chips) 
Seat 7: el Fatto ($50 in chips) 
Seat 9: fragonik ($62.68 in chips) 
Mr. white2604: posts small blind $0.25
StudentRB: posts big blind $0.50
MonplDCmax: sits out 
*** HOLE CARDS ***
el Fatto: folds 
fragonik: folds 
PanicJX: folds 
pudge.3096: folds 
kastellani87: folds 
BB_dont_cry: folds 
Mr. white2604: raises $0.50 to $1
StudentRB: calls $0.50
*** FLOP *** [2d 6d Qs]
Mr. white2604: checks 
StudentRB: checks 
*** TURN *** [2d 6d Qs] [Ks]
Mr. white2604: bets $1
StudentRB: calls $1
*** RIVER *** [2d 6d Qs Ks] [6h]
Mr. white2604: checks 
StudentRB: checks 
*** SHOW DOWN ***
Mr. white2604: shows [8d Ad] (a pair of Sixes)
StudentRB: shows [5c Kd] (two pair, Kings and Sixes)
StudentRB collected $3.80 from pot
*** SUMMARY ***
Total pot $4 | Rake $0.20 
Board [2d 6d Qs Ks 6h]
Seat 1: PanicJX folded before Flop (didn't bet)
Seat 2: pudge.3096 folded before Flop (didn't bet)
Seat 3: kastellani87 folded before Flop (didn't bet)
Seat 4: BB_dont_cry (button) folded before Flop (didn't bet)
Seat 5: Mr. white2604 (small blind) showed [8d Ad] and lost with a pair of Sixes
Seat 6: StudentRB (big blind) showed [5c Kd] and won ($3.80) with two pair, Kings and Sixes
Seat 7: el Fatto folded before Flop (didn't bet)
Seat 9: fragonik folded before Flop (didn't bet)



PokerStars Hand #228693666712:  Hold'em No Limit ($0.25/$0.50 USD) - 2021/07/30 19:56:25 ET
Table 'Gorgo III' 9-max Seat #5 is the button
Seat 1: PanicJX ($64.23 in chips) 
Seat 2: pudge.3096 ($50 in chips) 
Seat 3: kastellani87 ($104.66 in chips) 
Seat 4: BB_dont_cry ($65.20 in chips) 
Seat 5: Mr. white2604 ($32.09 in chips) 
Seat 6: StudentRB ($123.99 in chips) 
Seat 7: el Fatto ($50 in chips) 
Seat 9: fragonik ($62.68 in chips) 
StudentRB: posts small blind $0.25
el Fatto: posts big blind $0.50
MonplDCmax: sits out 
*** HOLE CARDS ***
fragonik: folds 
PanicJX: folds 
pudge.3096: folds 
kastellani87: calls $0.50
BB_dont_cry: folds 
Mr. white2604: folds 
StudentRB: folds 
el Fatto: checks 
*** FLOP *** [Ks 6c 5s]
el Fatto: checks 
kastellani87: checks 
*** TURN *** [Ks 6c 5s] [3d]
el Fatto: bets $1
kastellani87: folds 
Uncalled bet ($1) returned to el Fatto
el Fatto collected $1.19 from pot
el Fatto: doesn't show hand 
*** SUMMARY ***
Total pot $1.25 | Rake $0.06 
Board [Ks 6c 5s 3d]
Seat 1: PanicJX folded before Flop (didn't bet)
Seat 2: pudge.3096 folded before Flop (didn't bet)
Seat 3: kastellani87 folded on the Turn
Seat 4: BB_dont_cry folded before Flop (didn't bet)
Seat 5: Mr. white2604 (button) folded before Flop (didn't bet)
Seat 6: StudentRB (small blind) folded before Flop
Seat 7: el Fatto (big blind) collected ($1.19)
Seat 9: fragonik folded before Flop (didn't bet)



PokerStars Hand #228693674243:  Hold'em No Limit ($0.25/$0.50 USD) - 2021/07/30 19:56:55 ET
Table 'Gorgo III' 9-max Seat #6 is the button
Seat 1: PanicJX ($64.23 in chips) 
Seat 2: pudge.3096 ($50 in chips) 
Seat 3: kastellani87 ($104.16 in chips) 
Seat 4: BB_dont_cry ($65.20 in chips) 
Seat 5: Mr. white2604 ($32.09 in chips) 
Seat 6: StudentRB ($123.74 in chips) 
Seat 7: el Fatto ($50.69 in chips) 
Seat 8: MonplDCmax ($50 in chips) 
Seat 9: fragonik ($62.68 in chips) 
el Fatto: posts small blind $0.25
MonplDCmax: posts big blind $0.50
*** HOLE CARDS ***
fragonik: folds 
PanicJX: folds 
pudge.3096: folds 
kastellani87: folds 
BB_dont_cry: folds 
Mr. white2604: folds 
StudentRB: folds 
el Fatto: folds 
Uncalled bet ($0.25) returned to MonplDCmax
MonplDCmax collected $0.50 from pot
MonplDCmax: doesn't show hand 
*** SUMMARY ***
Total pot $0.50 | Rake $0 
Seat 1: PanicJX folded before Flop (didn't bet)
Seat 2: pudge.3096 folded before Flop (didn't bet)
Seat 3: kastellani87 folded before Flop (didn't bet)
Seat 4: BB_dont_cry folded before Flop (didn't bet)
Seat 5: Mr. white2604 folded before Flop (didn't bet)
Seat 6: StudentRB (button) folded before Flop (didn't bet)
Seat 7: el Fatto (small blind) folded before Flop
Seat 8: MonplDCmax (big blind) collected ($0.50)
Seat 9: fragonik folded before Flop (didn't bet)



PokerStars Hand #228693678707:  Hold'em No Limit ($0.25/$0.50 USD) - 2021/07/30 19:57:13 ET
Table 'Gorgo III' 9-max Seat #7 is the button
Seat 1: PanicJX ($64.23 in chips) 
Seat 2: pudge.3096 ($50 in chips) 
Seat 3: kastellani87 ($104.16 in chips) 
Seat 4: BB_dont_cry ($65.20 in chips) 
Seat 5: Mr. white2604 ($32.09 in chips) 
Seat 6: StudentRB ($123.74 in chips) 
Seat 7: el Fatto ($50.44 in chips) 
Seat 8: MonplDCmax ($50.25 in chips) 
Seat 9: fragonik ($62.68 in chips) 
MonplDCmax: posts small blind $0.25
fragonik: posts big blind $0.50
*** HOLE CARDS ***
PanicJX: calls $0.50
pudge.3096: folds 
kastellani87 has timed out
kastellani87: folds 
BB_dont_cry: folds 
Mr. white2604: calls $0.50
StudentRB: raises $2 to $2.50
el Fatto: folds 
MonplDCmax: folds 
fragonik: folds 
PanicJX: calls $2
Mr. white2604: calls $2
*** FLOP *** [9h 9d Qs]
PanicJX: checks 
Mr. white2604: bets $1.50
StudentRB: calls $1.50
PanicJX: folds 
*** TURN *** [9h 9d Qs] [5s]
Mr. white2604: bets $3
StudentRB: calls $3
*** RIVER *** [9h 9d Qs 5s] [7c]
Mr. white2604: bets $3.50
StudentRB: calls $3.50
*** SHOW DOWN ***
Mr. white2604: shows [Kh Qc] (two pair, Queens and Nines)
StudentRB: mucks hand 
Mr. white2604 collected $23.04 from pot
*** SUMMARY ***
Total pot $24.25 | Rake $1.21 
Board [9h 9d Qs 5s 7c]
Seat 1: PanicJX folded on the Flop
Seat 2: pudge.3096 folded before Flop (didn't bet)
Seat 3: kastellani87 folded before Flop (didn't bet)
Seat 4: BB_dont_cry folded before Flop (didn't bet)
Seat 5: Mr. white2604 showed [Kh Qc] and won ($23.04) with two pair, Queens and Nines
Seat 6: StudentRB mucked
Seat 7: el Fatto (button) folded before Flop (didn't bet)
Seat 8: MonplDCmax (small blind) folded before Flop
Seat 9: fragonik (big blind) folded before Flop



PokerStars Hand #228693700500:  Hold'em No Limit ($0.25/$0.50 USD) - 2021/07/30 19:58:40 ET
Table 'Gorgo III' 9-max Seat #8 is the button
Seat 1: PanicJX ($61.73 in chips) 
Seat 2: pudge.3096 ($50 in chips) 
Seat 3: kastellani87 ($104.16 in chips) 
Seat 4: BB_dont_cry ($65.20 in chips) 
Seat 5: Mr. white2604 ($44.63 in chips) 
Seat 6: StudentRB ($113.24 in chips) 
Seat 7: el Fatto ($50.44 in chips) 
Seat 8: MonplDCmax ($50 in chips) 
Seat 9: fragonik ($62.18 in chips) 
fragonik: posts small blind $0.25
PanicJX: posts big blind $0.50
*** HOLE CARDS ***
pudge.3096: raises $0.75 to $1.25
kastellani87: folds 
BB_dont_cry: folds 
Mr. white2604: folds 
StudentRB: folds 
el Fatto: folds 
MonplDCmax: folds 
fragonik: folds 
PanicJX: folds 
Uncalled bet ($0.75) returned to pudge.3096
pudge.3096 collected $1.25 from pot
pudge.3096: doesn't show hand 
*** SUMMARY ***
Total pot $1.25 | Rake $0 
Seat 1: PanicJX (big blind) folded before Flop
Seat 2: pudge.3096 collected ($1.25)
Seat 3: kastellani87 folded before Flop (didn't bet)
Seat 4: BB_dont_cry folded before Flop (didn't bet)
Seat 5: Mr. white2604 folded before Flop (didn't bet)
Seat 6: StudentRB folded before Flop (didn't bet)
Seat 7: el Fatto folded before Flop (didn't bet)
Seat 8: MonplDCmax (button) folded before Flop (didn't bet)
Seat 9: fragonik (small blind) folded before Flop



PokerStars Hand #228693706962:  Hold'em No Limit ($0.25/$0.50 USD) - 2021/07/30 19:59:06 ET
Table 'Gorgo III' 9-max Seat #9 is the button
Seat 1: PanicJX ($61.23 in chips) 
Seat 2: pudge.3096 ($50.75 in chips) 
Seat 3: kastellani87 ($104.16 in chips) 
Seat 4: BB_dont_cry ($65.20 in chips) 
Seat 5: Mr. white2604 ($44.63 in chips) 
Seat 6: StudentRB ($113.24 in chips) 
Seat 7: el Fatto ($50.44 in chips) 
Seat 8: MonplDCmax ($50 in chips) 
Seat 9: fragonik ($61.93 in chips) 
PanicJX: posts small blind $0.25
pudge.3096: posts big blind $0.50
*** HOLE CARDS ***
kastellani87: folds 
BB_dont_cry: folds 
Mr. white2604: folds 
StudentRB: raises $0.75 to $1.25
el Fatto: folds 
MonplDCmax: folds 
fragonik: folds 
PanicJX: folds 
pudge.3096: folds 
Uncalled bet ($0.75) returned to StudentRB
StudentRB collected $1.25 from pot
StudentRB: doesn't show hand 
*** SUMMARY ***
Total pot $1.25 | Rake $0 
Seat 1: PanicJX (small blind) folded before Flop
Seat 2: pudge.3096 (big blind) folded before Flop
Seat 3: kastellani87 folded before Flop (didn't bet)
Seat 4: BB_dont_cry folded before Flop (didn't bet)
Seat 5: Mr. white2604 folded before Flop (didn't bet)
Seat 6: StudentRB collected ($1.25)
Seat 7: el Fatto folded before Flop (didn't bet)
Seat 8: MonplDCmax folded before Flop (didn't bet)
Seat 9: fragonik (button) folded before Flop (didn't bet)



PokerStars Hand #228693713451:  Hold'em No Limit ($0.25/$0.50 USD) - 2021/07/30 19:59:32 ET
Table 'Gorgo III' 9-max Seat #1 is the button
Seat 1: PanicJX ($60.98 in chips) 
Seat 2: pudge.3096 ($50.25 in chips) 
Seat 3: kastellani87 ($104.16 in chips) 
Seat 4: BB_dont_cry ($65.20 in chips) 
Seat 5: Mr. white2604 ($44.63 in chips) 
Seat 6: StudentRB ($113.99 in chips) 
Seat 7: el Fatto ($50.44 in chips) 
Seat 8: MonplDCmax ($50 in chips) 
Seat 9: fragonik ($61.93 in chips) 
pudge.3096: posts small blind $0.25
kastellani87: posts big blind $0.50
*** HOLE CARDS ***
BB_dont_cry has timed out
BB_dont_cry: folds 
Mr. white2604: calls $0.50
StudentRB: folds 
el Fatto: folds 
MonplDCmax: folds 
fragonik: folds 
PanicJX: raises $1.75 to $2.25
pudge.3096: folds 
kastellani87: folds 
Mr. white2604: calls $1.75
*** FLOP *** [Js 4s 7h]
Mr. white2604: checks 
PanicJX: checks 
*** TURN *** [Js 4s 7h] [7d]
Mr. white2604: bets $1
PanicJX: calls $1
*** RIVER *** [Js 4s 7h 7d] [Qh]
Mr. white2604: checks 
PanicJX: bets $6.89
Mr. white2604: folds 
Uncalled bet ($6.89) returned to PanicJX
PanicJX collected $6.89 from pot
PanicJX: doesn't show hand 
*** SUMMARY ***
Total pot $7.25 | Rake $0.36 
Board [Js 4s 7h 7d Qh]
Seat 1: PanicJX (button) collected ($6.89)
Seat 2: pudge.3096 (small blind) folded before Flop
Seat 3: kastellani87 (big blind) folded before Flop
Seat 4: BB_dont_cry folded before Flop (didn't bet)
Seat 5: Mr. white2604 folded on the River
Seat 6: StudentRB folded before Flop (didn't bet)
Seat 7: el Fatto folded before Flop (didn't bet)
Seat 8: MonplDCmax folded before Flop (didn't bet)
Seat 9: fragonik folded before Flop (didn't bet)



PokerStars Hand #228693730764:  Hold'em No Limit ($0.25/$0.50 USD) - 2021/07/30 20:00:40 ET
Table 'Gorgo III' 9-max Seat #2 is the button
Seat 1: PanicJX ($64.62 in chips) 
Seat 2: pudge.3096 ($50 in chips) 
Seat 3: kastellani87 ($103.66 in chips) 
Seat 4: BB_dont_cry ($65.20 in chips) 
Seat 5: Mr. white2604 ($41.38 in chips) 
Seat 6: StudentRB ($113.99 in chips) 
Seat 7: el Fatto ($50.44 in chips) 
Seat 8: MonplDCmax ($50 in chips) 
Seat 9: fragonik ($61.93 in chips) 
kastellani87: posts small blind $0.25
BB_dont_cry: posts big blind $0.50
*** HOLE CARDS ***
Mr. white2604: folds 
StudentRB: folds 
el Fatto: folds 
MonplDCmax: folds 
fragonik: folds 
PanicJX: raises $0.75 to $1.25
pudge.3096: folds 
kastellani87: calls $1
BB_dont_cry: raises $5.25 to $6.50
PanicJX: calls $5.25
kastellani87: folds 
*** FLOP *** [4h 9d Ad]
BB_dont_cry: checks 
PanicJX: checks 
*** TURN *** [4h 9d Ad] [Qs]
BB_dont_cry: checks 
PanicJX: checks 
*** RIVER *** [4h 9d Ad Qs] [3c]
BB_dont_cry: checks 
PanicJX: checks 
*** SHOW DOWN ***
BB_dont_cry: shows [Qh Kc] (a pair of Queens)
PanicJX: mucks hand 
BB_dont_cry collected $13.54 from pot
*** SUMMARY ***
Total pot $14.25 | Rake $0.71 
Board [4h 9d Ad Qs 3c]
Seat 1: PanicJX mucked
Seat 2: pudge.3096 (button) folded before Flop (didn't bet)
Seat 3: kastellani87 (small blind) folded before Flop
Seat 4: BB_dont_cry (big blind) showed [Qh Kc] and won ($13.54) with a pair of Queens
Seat 5: Mr. white2604 folded before Flop (didn't bet)
Seat 6: StudentRB folded before Flop (didn't bet)
Seat 7: el Fatto folded before Flop (didn't bet)
Seat 8: MonplDCmax folded before Flop (didn't bet)
Seat 9: fragonik folded before Flop (didn't bet)



PokerStars Hand #228693754673:  Hold'em No Limit ($0.25/$0.50 USD) - 2021/07/30 20:02:02 ET
Table 'Gorgo III' 9-max Seat #4 is the button
Seat 1: PanicJX ($58.12 in chips) 
Seat 2: pudge.3096 ($50 in chips) 
Seat 3: kastellani87 ($104.45 in chips) 
Seat 4: BB_dont_cry ($71.99 in chips) 
Seat 5: Mr. white2604 ($40.88 in chips) 
Seat 6: StudentRB ($113.99 in chips) 
Seat 7: el Fatto ($50.44 in chips) 
Seat 8: MonplDCmax ($50 in chips) 
Seat 9: fragonik ($61.93 in chips) 
Mr. white2604: posts small blind $0.25
StudentRB: posts big blind $0.50
*** HOLE CARDS ***
el Fatto: folds 
MonplDCmax: folds 
fragonik: folds 
PanicJX: raises $0.75 to $1.25
pudge.3096: folds 
kastellani87: folds 
BB_dont_cry: folds 
Mr. white2604: calls $1
StudentRB: folds 
*** FLOP *** [9c 5h 4c]
Mr. white2604: checks 
PanicJX: bets $2.85
Mr. white2604: calls $2.85
*** TURN *** [9c 5h 4c] [Qh]
Mr. white2604: checks 
PanicJX: bets $8.26
Mr. white2604: folds 
Uncalled bet ($8.26) returned to PanicJX
PanicJX collected $8.26 from pot
PanicJX: doesn't show hand 
*** SUMMARY ***
Total pot $8.70 | Rake $0.44 
Board [9c 5h 4c Qh]
Seat 1: PanicJX collected ($8.26)
Seat 2: pudge.3096 folded before Flop (didn't bet)
Seat 3: kastellani87 folded before Flop (didn't bet)
Seat 4: BB_dont_cry (button) folded before Flop (didn't bet)
Seat 5: Mr. white2604 (small blind) folded on the Turn
Seat 6: StudentRB (big blind) folded before Flop
Seat 7: el Fatto folded before Flop (didn't bet)
Seat 8: MonplDCmax folded before Flop (didn't bet)
Seat 9: fragonik folded before Flop (didn't bet)



PokerStars Hand #228693767660:  Hold'em No Limit ($0.25/$0.50 USD) - 2021/07/30 20:02:45 ET
Table 'Gorgo III' 9-max Seat #5 is the button
Seat 1: PanicJX ($62.28 in chips) 
Seat 2: pudge.3096 ($50 in chips) 
Seat 3: kastellani87 ($104.45 in chips) 
Seat 4: BB_dont_cry ($71.99 in chips) 
Seat 5: Mr. white2604 ($36.78 in chips) 
Seat 6: StudentRB ($113.49 in chips) 
Seat 8: MonplDCmax ($50 in chips) 
Seat 9: fragonik ($61.93 in chips) 
StudentRB: posts small blind $0.25
el Fatto: is sitting out 
MonplDCmax: posts big blind $0.50
*** HOLE CARDS ***
el Fatto leaves the table
fragonik: folds 
PanicJX: folds 
pudge.3096: folds 
kastellani87: calls $0.50
BB_dont_cry: raises $1.75 to $2.25
Mr. white2604: calls $2.25
StudentRB: folds 
MonplDCmax: folds 
kastellani87: folds 
*** FLOP *** [5c 4d 8h]
Gluck35 joins the table at seat #7 
BB_dont_cry: bets $2.73
Mr. white2604: calls $2.73
*** TURN *** [5c 4d 8h] [7c]
BB_dont_cry: bets $5.33
Mr. white2604: folds 
Uncalled bet ($5.33) returned to BB_dont_cry
BB_dont_cry collected $10.65 from pot
*** SUMMARY ***
Total pot $11.21 | Rake $0.56 
Board [5c 4d 8h 7c]
Seat 1: PanicJX folded before Flop (didn't bet)
Seat 2: pudge.3096 folded before Flop (didn't bet)
Seat 3: kastellani87 folded before Flop
Seat 4: BB_dont_cry collected ($10.65)
Seat 5: Mr. white2604 (button) folded on the Turn
Seat 6: StudentRB (small blind) folded before Flop
Seat 8: MonplDCmax (big blind) folded before Flop
Seat 9: fragonik folded before Flop (didn't bet)



PokerStars Hand #228693793470:  Hold'em No Limit ($0.25/$0.50 USD) - 2021/07/30 20:03:59 ET
Table 'Gorgo III' 9-max Seat #6 is the button
Seat 1: PanicJX ($62.28 in chips) 
Seat 2: pudge.3096 ($50 in chips) 
Seat 3: kastellani87 ($103.95 in chips) 
Seat 4: BB_dont_cry ($77.66 in chips) 
Seat 5: Mr. white2604 ($31.80 in chips) 
Seat 6: StudentRB ($113.24 in chips) 
Seat 8: MonplDCmax ($50 in chips) 
Seat 9: fragonik ($61.93 in chips) 
MonplDCmax: posts small blind $0.25
fragonik: posts big blind $0.50
*** HOLE CARDS ***
PanicJX: folds 
pudge.3096: folds 
kastellani87: folds 
BB_dont_cry: folds 
Mr. white2604: folds 
StudentRB: raises $0.75 to $1.25
MonplDCmax: folds 
fragonik: folds 
Uncalled bet ($0.75) returned to StudentRB
StudentRB collected $1.25 from pot
StudentRB: doesn't show hand 
*** SUMMARY ***
Total pot $1.25 | Rake $0 
Seat 1: PanicJX folded before Flop (didn't bet)
Seat 2: pudge.3096 folded before Flop (didn't bet)
Seat 3: kastellani87 folded before Flop (didn't bet)
Seat 4: BB_dont_cry folded before Flop (didn't bet)
Seat 5: Mr. white2604 folded before Flop (didn't bet)
Seat 6: StudentRB (button) collected ($1.25)
Seat 8: MonplDCmax (small blind) folded before Flop
Seat 9: fragonik (big blind) folded before Flop



PokerStars Hand #228693799196:  Hold'em No Limit ($0.25/$0.50 USD) - 2021/07/30 20:04:19 ET
Table 'Gorgo III' 9-max Seat #8 is the button
Seat 1: PanicJX ($62.28 in chips) 
Seat 2: pudge.3096 ($50 in chips) 
Seat 3: kastellani87 ($103.95 in chips) 
Seat 4: BB_dont_cry ($77.66 in chips) 
Seat 5: Mr. white2604 ($31.80 in chips) 
Seat 6: StudentRB ($113.99 in chips) 
Seat 8: MonplDCmax ($50 in chips) 
Seat 9: fragonik ($61.43 in chips) 
fragonik: posts small blind $0.25
PanicJX: posts big blind $0.50
Gluck35: sits out 
*** HOLE CARDS ***
pudge.3096: folds 
kastellani87: folds 
BB_dont_cry: folds 
Mr. white2604: raises $0.50 to $1
StudentRB: raises $2 to $3
MonplDCmax: raises $5 to $8
fragonik: folds 
PanicJX: folds 
Mr. white2604: folds 
StudentRB: folds 
Uncalled bet ($5) returned to MonplDCmax
MonplDCmax collected $7.75 from pot
MonplDCmax: doesn't show hand 
*** SUMMARY ***
Total pot $7.75 | Rake $0 
Seat 1: PanicJX (big blind) folded before Flop
Seat 2: pudge.3096 folded before Flop (didn't bet)
Seat 3: kastellani87 folded before Flop (didn't bet)
Seat 4: BB_dont_cry folded before Flop (didn't bet)
Seat 5: Mr. white2604 folded before Flop
Seat 6: StudentRB folded before Flop
Seat 8: MonplDCmax (button) collected ($7.75)
Seat 9: fragonik (small blind) folded before Flop



PokerStars Hand #228693808843:  Hold'em No Limit ($0.25/$0.50 USD) - 2021/07/30 20:04:51 ET
Table 'Gorgo III' 9-max Seat #9 is the button
Seat 1: PanicJX ($61.78 in chips) 
Seat 2: pudge.3096 ($50 in chips) 
Seat 3: kastellani87 ($103.95 in chips) 
Seat 4: BB_dont_cry ($77.66 in chips) 
Seat 5: Mr. white2604 ($30.80 in chips) 
Seat 6: StudentRB ($110.99 in chips) 
Seat 8: MonplDCmax ($54.75 in chips) 
Seat 9: fragonik ($61.18 in chips) 
PanicJX: posts small blind $0.25
pudge.3096: posts big blind $0.50
Gluck35: sits out 
*** HOLE CARDS ***
kastellani87: folds 
BB_dont_cry: raises $1.25 to $1.75
Mr. white2604: folds 
StudentRB: folds 
MonplDCmax: folds 
fragonik: folds 
PanicJX: folds 
pudge.3096: folds 
Uncalled bet ($1.25) returned to BB_dont_cry
BB_dont_cry collected $1.25 from pot
*** SUMMARY ***
Total pot $1.25 | Rake $0 
Seat 1: PanicJX (small blind) folded before Flop
Seat 2: pudge.3096 (big blind) folded before Flop
Seat 3: kastellani87 folded before Flop (didn't bet)
Seat 4: BB_dont_cry collected ($1.25)
Seat 5: Mr. white2604 folded before Flop (didn't bet)
Seat 6: StudentRB folded before Flop (didn't bet)
Seat 8: MonplDCmax folded before Flop (didn't bet)
Seat 9: fragonik (button) folded before Flop (didn't bet)



PokerStars Hand #228693813790:  Hold'em No Limit ($0.25/$0.50 USD) - 2021/07/30 20:05:08 ET
Table 'Gorgo III' 9-max Seat #1 is the button
Seat 1: PanicJX ($61.53 in chips) 
Seat 2: pudge.3096 ($50 in chips) 
Seat 3: kastellani87 ($103.95 in chips) 
Seat 4: BB_dont_cry ($78.41 in chips) 
Seat 5: Mr. white2604 ($30.80 in chips) 
Seat 6: StudentRB ($110.99 in chips) 
Seat 8: MonplDCmax ($54.75 in chips) 
Seat 9: fragonik ($61.18 in chips) 
pudge.3096: posts small blind $0.25
kastellani87: posts big blind $0.50
Gluck35: sits out 
*** HOLE CARDS ***
BB_dont_cry: folds 
Mr. white2604: folds 
StudentRB: folds 
MonplDCmax: folds 
fragonik: folds 
PanicJX: raises $0.75 to $1.25
pudge.3096: folds 
kastellani87: calls $0.75
*** FLOP *** [3d 7c Tc]
kastellani87: checks 
PanicJX: checks 
*** TURN *** [3d 7c Tc] [4d]
kastellani87: checks 
PanicJX: bets $2.61
kastellani87: calls $2.61
*** RIVER *** [3d 7c Tc 4d] [Kh]
kastellani87: checks 
PanicJX: bets $7.57
kastellani87: folds 
Uncalled bet ($7.57) returned to PanicJX
PanicJX collected $7.57 from pot
PanicJX: doesn't show hand 
*** SUMMARY ***
Total pot $7.97 | Rake $0.40 
Board [3d 7c Tc 4d Kh]
Seat 1: PanicJX (button) collected ($7.57)
Seat 2: pudge.3096 (small blind) folded before Flop
Seat 3: kastellani87 (big blind) folded on the River
Seat 4: BB_dont_cry folded before Flop (didn't bet)
Seat 5: Mr. white2604 folded before Flop (didn't bet)
Seat 6: StudentRB folded before Flop (didn't bet)
Seat 8: MonplDCmax folded before Flop (didn't bet)
Seat 9: fragonik folded before Flop (didn't bet)



PokerStars Hand #228693830220:  Hold'em No Limit ($0.25/$0.50 USD) - 2021/07/30 20:06:02 ET
Table 'Gorgo III' 9-max Seat #2 is the button
Seat 1: PanicJX ($65.24 in chips) 
Seat 2: pudge.3096 ($50 in chips) 
Seat 3: kastellani87 ($100.09 in chips) 
Seat 4: BB_dont_cry ($78.41 in chips) 
Seat 5: Mr. white2604 ($30.80 in chips) 
Seat 6: StudentRB ($110.99 in chips) 
Seat 8: MonplDCmax ($54.75 in chips) 
Seat 9: fragonik ($61.18 in chips) 
kastellani87: posts small blind $0.25
BB_dont_cry: posts big blind $0.50
Gluck35: sits out 
*** HOLE CARDS ***
Mr. white2604: folds 
StudentRB: folds 
MonplDCmax: folds 
fragonik: raises $0.75 to $1.25
PanicJX: folds 
pudge.3096: calls $1.25
kastellani87: calls $1
BB_dont_cry: folds 
*** FLOP *** [9d Qc 3c]
kastellani87: checks 
fragonik: bets $2.75
pudge.3096: folds 
kastellani87: folds 
Uncalled bet ($2.75) returned to fragonik
fragonik collected $4.04 from pot
*** SUMMARY ***
Total pot $4.25 | Rake $0.21 
Board [9d Qc 3c]
Seat 1: PanicJX folded before Flop (didn't bet)
Seat 2: pudge.3096 (button) folded on the Flop
Seat 3: kastellani87 (small blind) folded on the Flop
Seat 4: BB_dont_cry (big blind) folded before Flop
Seat 5: Mr. white2604 folded before Flop (didn't bet)
Seat 6: StudentRB folded before Flop (didn't bet)
Seat 8: MonplDCmax folded before Flop (didn't bet)
Seat 9: fragonik collected ($4.04)



PokerStars Hand #228693841232:  Hold'em No Limit ($0.25/$0.50 USD) - 2021/07/30 20:06:40 ET
Table 'Gorgo III' 9-max Seat #3 is the button
Seat 1: PanicJX ($65.24 in chips) 
Seat 2: pudge.3096 ($50 in chips) 
Seat 3: kastellani87 ($98.84 in chips) 
Seat 4: BB_dont_cry ($77.91 in chips) 
Seat 5: Mr. white2604 ($30.80 in chips) 
Seat 6: StudentRB ($110.99 in chips) 
Seat 8: MonplDCmax ($54.75 in chips) 
Seat 9: fragonik ($63.97 in chips) 
BB_dont_cry: posts small blind $0.25
Mr. white2604: posts big blind $0.50
Gluck35: sits out 
*** HOLE CARDS ***
StudentRB: folds 
MonplDCmax: folds 
fragonik: folds 
PanicJX: folds 
pudge.3096: folds 
kastellani87: folds 
BB_dont_cry: folds 
Uncalled bet ($0.25) returned to Mr. white2604
Mr. white2604 collected $0.50 from pot
Mr. white2604: doesn't show hand 
*** SUMMARY ***
Total pot $0.50 | Rake $0 
Seat 1: PanicJX folded before Flop (didn't bet)
Seat 2: pudge.3096 folded before Flop (didn't bet)
Seat 3: kastellani87 (button) folded before Flop (didn't bet)
Seat 4: BB_dont_cry (small blind) folded before Flop
Seat 5: Mr. white2604 (big blind) collected ($0.50)
Seat 6: StudentRB folded before Flop (didn't bet)
Seat 8: MonplDCmax folded before Flop (didn't bet)
Seat 9: fragonik folded before Flop (didn't bet)



PokerStars Hand #228693847516:  Hold'em No Limit ($0.25/$0.50 USD) - 2021/07/30 20:07:01 ET
Table 'Gorgo III' 9-max Seat #4 is the button
Seat 1: PanicJX ($65.24 in chips) 
Seat 2: pudge.3096 ($50 in chips) 
Seat 3: kastellani87 ($98.84 in chips) 
Seat 4: BB_dont_cry ($77.66 in chips) 
Seat 5: Mr. white2604 ($31.05 in chips) 
Seat 6: StudentRB ($110.99 in chips) 
Seat 8: MonplDCmax ($54.75 in chips) 
Seat 9: fragonik ($63.97 in chips) 
Mr. white2604: posts small blind $0.25
StudentRB: posts big blind $0.50
Gluck35: sits out 
*** HOLE CARDS ***
MonplDCmax: folds 
fragonik: folds 
PanicJX: raises $0.75 to $1.25
pudge.3096: folds 
kastellani87: calls $1.25
BB_dont_cry: calls $1.25
Mr. white2604: calls $1
StudentRB: folds 
*** FLOP *** [9s 7s 4s]
Mr. white2604: checks 
PanicJX: checks 
kastellani87: checks 
BB_dont_cry: checks 
*** TURN *** [9s 7s 4s] [Ac]
Mr. white2604: bets $1.50
PanicJX: raises $1.50 to $3
kastellani87: folds 
BB_dont_cry: folds 
Mr. white2604: calls $1.50
*** RIVER *** [9s 7s 4s Ac] [9d]
Mr. white2604: bets $1.50
PanicJX: calls $1.50
*** SHOW DOWN ***
Mr. white2604: shows [7c Ah] (two pair, Aces and Nines)
PanicJX: shows [Ad Ts] (two pair, Aces and Nines - Ten kicker)
PanicJX collected $13.78 from pot
*** SUMMARY ***
Total pot $14.50 | Rake $0.72 
Board [9s 7s 4s Ac 9d]
Seat 1: PanicJX showed [Ad Ts] and won ($13.78) with two pair, Aces and Nines
Seat 2: pudge.3096 folded before Flop (didn't bet)
Seat 3: kastellani87 folded on the Turn
Seat 4: BB_dont_cry (button) folded on the Turn
Seat 5: Mr. white2604 (small blind) showed [7c Ah] and lost with two pair, Aces and Nines
Seat 6: StudentRB (big blind) folded before Flop
Seat 8: MonplDCmax folded before Flop (didn't bet)
Seat 9: fragonik folded before Flop (didn't bet)



PokerStars Hand #228693871379:  Hold'em No Limit ($0.25/$0.50 USD) - 2021/07/30 20:08:21 ET
Table 'Gorgo III' 9-max Seat #5 is the button
Seat 1: PanicJX ($73.27 in chips) 
Seat 2: pudge.3096 ($50 in chips) 
Seat 3: kastellani87 ($97.59 in chips) 
Seat 4: BB_dont_cry ($76.41 in chips) 
Seat 5: Mr. white2604 ($25.30 in chips) 
Seat 6: StudentRB ($110.49 in chips) 
Seat 7: Gluck35 ($50 in chips) 
Seat 8: MonplDCmax ($54.75 in chips) 
Seat 9: fragonik ($63.97 in chips) 
StudentRB: posts small blind $0.25
Gluck35: posts big blind $0.50
*** HOLE CARDS ***
MonplDCmax: folds 
fragonik: folds 
PanicJX: folds 
pudge.3096: folds 
kastellani87: folds 
BB_dont_cry: raises $1.25 to $1.75
Mr. white2604: folds 
StudentRB: folds 
Gluck35: raises $4.25 to $6
BB_dont_cry: calls $4.25
*** FLOP *** [Ks 7s 6h]
Gluck35: bets $6.17
BB_dont_cry: raises $8.33 to $14.50
Gluck35: raises $29.50 to $44 and is all-in
BB_dont_cry: folds 
Uncalled bet ($29.50) returned to Gluck35
Gluck35 collected $39.25 from pot
Gluck35: doesn't show hand 
*** SUMMARY ***
Total pot $41.25 | Rake $2 
Board [Ks 7s 6h]
Seat 1: PanicJX folded before Flop (didn't bet)
Seat 2: pudge.3096 folded before Flop (didn't bet)
Seat 3: kastellani87 folded before Flop (didn't bet)
Seat 4: BB_dont_cry folded on the Flop
Seat 5: Mr. white2604 (button) folded before Flop (didn't bet)
Seat 6: StudentRB (small blind) folded before Flop
Seat 7: Gluck35 (big blind) collected ($39.25)
Seat 8: MonplDCmax folded before Flop (didn't bet)
Seat 9: fragonik folded before Flop (didn't bet)



PokerStars Hand #228693894045:  Hold'em No Limit ($0.25/$0.50 USD) - 2021/07/30 20:09:38 ET
Table 'Gorgo III' 9-max Seat #6 is the button
Seat 1: PanicJX ($73.27 in chips) 
Seat 2: pudge.3096 ($50 in chips) 
Seat 3: kastellani87 ($97.59 in chips) 
Seat 4: BB_dont_cry ($55.91 in chips) 
Seat 5: Mr. white2604 ($25.30 in chips) 
Seat 6: StudentRB ($110.24 in chips) 
Seat 7: Gluck35 ($68.75 in chips) 
Seat 8: MonplDCmax ($54.75 in chips) 
Seat 9: fragonik ($63.97 in chips) 
Gluck35: posts small blind $0.25
MonplDCmax: posts big blind $0.50
*** HOLE CARDS ***
fragonik: folds 
PanicJX: folds 
pudge.3096: folds 
kastellani87: calls $0.50
BB_dont_cry: folds 
Mr. white2604: folds 
StudentRB: folds 
Gluck35: folds 
MonplDCmax: checks 
*** FLOP *** [Qh 6c 5h]
MonplDCmax: checks 
kastellani87: checks 
*** TURN *** [Qh 6c 5h] [9s]
MonplDCmax: checks 
kastellani87: bets $0.60
MonplDCmax: calls $0.60
*** RIVER *** [Qh 6c 5h 9s] [2h]
MonplDCmax: bets $2
kastellani87: calls $2
*** SHOW DOWN ***
MonplDCmax: shows [Js Tc] (high card Queen)
kastellani87: shows [Ah 5c] (a pair of Fives)
kastellani87 collected $6.13 from pot
*** SUMMARY ***
Total pot $6.45 | Rake $0.32 
Board [Qh 6c 5h 9s 2h]
Seat 1: PanicJX folded before Flop (didn't bet)
Seat 2: pudge.3096 folded before Flop (didn't bet)
Seat 3: kastellani87 showed [Ah 5c] and won ($6.13) with a pair of Fives
Seat 4: BB_dont_cry folded before Flop (didn't bet)
Seat 5: Mr. white2604 folded before Flop (didn't bet)
Seat 6: StudentRB (button) folded before Flop (didn't bet)
Seat 7: Gluck35 (small blind) folded before Flop
Seat 8: MonplDCmax (big blind) showed [Js Tc] and lost with high card Queen
Seat 9: fragonik folded before Flop (didn't bet)



PokerStars Hand #228693928011:  Hold'em No Limit ($0.25/$0.50 USD) - 2021/07/30 20:11:33 ET
Table 'Gorgo III' 9-max Seat #7 is the button
Seat 1: PanicJX ($73.27 in chips) 
Seat 2: pudge.3096 ($50 in chips) 
Seat 3: kastellani87 ($100.62 in chips) 
Seat 4: BB_dont_cry ($55.91 in chips) 
Seat 5: Mr. white2604 ($25.30 in chips) 
Seat 6: StudentRB ($110.24 in chips) 
Seat 7: Gluck35 ($68.50 in chips) 
Seat 8: MonplDCmax ($51.65 in chips) 
Seat 9: fragonik ($63.97 in chips) 
MonplDCmax: posts small blind $0.25
fragonik: posts big blind $0.50
*** HOLE CARDS ***
PanicJX: folds 
pudge.3096: folds 
kastellani87: folds 
BB_dont_cry: folds 
Mr. white2604: folds 
StudentRB: folds 
Gluck35: raises $0.75 to $1.25
MonplDCmax: folds 
fragonik: calls $0.75
*** FLOP *** [6d 5h Ah]
fragonik: checks 
Gluck35: checks 
*** TURN *** [6d 5h Ah] [5d]
fragonik: checks 
Gluck35: bets $1.57
fragonik: folds 
Uncalled bet ($1.57) returned to Gluck35
Gluck35 collected $2.61 from pot
Gluck35: doesn't show hand 
*** SUMMARY ***
Total pot $2.75 | Rake $0.14 
Board [6d 5h Ah 5d]
Seat 1: PanicJX folded before Flop (didn't bet)
Seat 2: pudge.3096 folded before Flop (didn't bet)
Seat 3: kastellani87 folded before Flop (didn't bet)
Seat 4: BB_dont_cry folded before Flop (didn't bet)
Seat 5: Mr. white2604 folded before Flop (didn't bet)
Seat 6: StudentRB folded before Flop (didn't bet)
Seat 7: Gluck35 (button) collected ($2.61)
Seat 8: MonplDCmax (small blind) folded before Flop
Seat 9: fragonik (big blind) folded on the Turn



PokerStars Hand #228693941523:  Hold'em No Limit ($0.25/$0.50 USD) - 2021/07/30 20:12:19 ET
Table 'Gorgo III' 9-max Seat #8 is the button
Seat 1: PanicJX ($73.27 in chips) 
Seat 2: pudge.3096 ($50 in chips) 
Seat 3: kastellani87 ($100.62 in chips) 
Seat 4: BB_dont_cry ($55.91 in chips) 
Seat 5: Mr. white2604 ($41.30 in chips) 
Seat 6: StudentRB ($110.24 in chips) 
Seat 7: Gluck35 ($69.86 in chips) 
Seat 8: MonplDCmax ($51.40 in chips) 
Seat 9: fragonik ($62.72 in chips) 
fragonik: posts small blind $0.25
PanicJX: posts big blind $0.50
*** HOLE CARDS ***
pudge.3096: folds 
kastellani87: folds 
BB_dont_cry: folds 
Mr. white2604: folds 
StudentRB: folds 
Gluck35: raises $0.75 to $1.25
MonplDCmax: raises $2.55 to $3.80
fragonik: folds 
PanicJX: folds 
Gluck35: folds 
Uncalled bet ($2.55) returned to MonplDCmax
MonplDCmax collected $3.25 from pot
MonplDCmax: doesn't show hand 
*** SUMMARY ***
Total pot $3.25 | Rake $0 
Seat 1: PanicJX (big blind) folded before Flop
Seat 2: pudge.3096 folded before Flop (didn't bet)
Seat 3: kastellani87 folded before Flop (didn't bet)
Seat 4: BB_dont_cry folded before Flop (didn't bet)
Seat 5: Mr. white2604 folded before Flop (didn't bet)
Seat 6: StudentRB folded before Flop (didn't bet)
Seat 7: Gluck35 folded before Flop
Seat 8: MonplDCmax (button) collected ($3.25)
Seat 9: fragonik (small blind) folded before Flop



PokerStars Hand #228693956308:  Hold'em No Limit ($0.25/$0.50 USD) - 2021/07/30 20:12:53 ET
Table 'Gorgo III' 9-max Seat #9 is the button
Seat 1: PanicJX ($72.77 in chips) 
Seat 2: pudge.3096 ($50 in chips) 
Seat 3: kastellani87 ($100.62 in chips) 
Seat 4: BB_dont_cry ($55.91 in chips) 
Seat 5: Mr. white2604 ($41.30 in chips) 
Seat 6: StudentRB ($110.24 in chips) 
Seat 7: Gluck35 ($68.61 in chips) 
Seat 8: MonplDCmax ($53.40 in chips) 
Seat 9: fragonik ($62.47 in chips) 
PanicJX: posts small blind $0.25
pudge.3096: posts big blind $0.50
*** HOLE CARDS ***
kastellani87: folds 
BB_dont_cry: folds 
Mr. white2604: raises $1 to $1.50
StudentRB: folds 
Gluck35: folds 
MonplDCmax: folds 
fragonik: folds 
PanicJX: calls $1.25
pudge.3096: raises $5.50 to $7
Mr. white2604: folds 
PanicJX: folds 
Uncalled bet ($5.50) returned to pudge.3096
pudge.3096 collected $4.50 from pot
pudge.3096: doesn't show hand 
*** SUMMARY ***
Total pot $4.50 | Rake $0 
Seat 1: PanicJX (small blind) folded before Flop
Seat 2: pudge.3096 (big blind) collected ($4.50)
Seat 3: kastellani87 folded before Flop (didn't bet)
Seat 4: BB_dont_cry folded before Flop (didn't bet)
Seat 5: Mr. white2604 folded before Flop
Seat 6: StudentRB folded before Flop (didn't bet)
Seat 7: Gluck35 folded before Flop (didn't bet)
Seat 8: MonplDCmax folded before Flop (didn't bet)
Seat 9: fragonik (button) folded before Flop (didn't bet)



PokerStars Hand #228693965705:  Hold'em No Limit ($0.25/$0.50 USD) - 2021/07/30 20:13:25 ET
Table 'Gorgo III' 9-max Seat #1 is the button
Seat 1: PanicJX ($71.27 in chips) 
Seat 2: pudge.3096 ($53 in chips) 
Seat 3: kastellani87 ($100.62 in chips) 
Seat 4: BB_dont_cry ($55.91 in chips) 
Seat 5: Mr. white2604 ($39.80 in chips) 
Seat 6: StudentRB ($110.24 in chips) 
Seat 7: Gluck35 ($68.61 in chips) 
Seat 8: MonplDCmax ($53.40 in chips) 
Seat 9: fragonik ($62.47 in chips) 
pudge.3096: posts small blind $0.25
kastellani87: posts big blind $0.50
*** HOLE CARDS ***
BB_dont_cry: raises $2 to $2.50
Mr. white2604: folds 
StudentRB: folds 
Gluck35: folds 
MonplDCmax: folds 
fragonik: folds 
PanicJX: folds 
pudge.3096: folds 
kastellani87: folds 
Uncalled bet ($2) returned to BB_dont_cry
BB_dont_cry collected $1.25 from pot
*** SUMMARY ***
Total pot $1.25 | Rake $0 
Seat 1: PanicJX (button) folded before Flop (didn't bet)
Seat 2: pudge.3096 (small blind) folded before Flop
Seat 3: kastellani87 (big blind) folded before Flop
Seat 4: BB_dont_cry collected ($1.25)
Seat 5: Mr. white2604 folded before Flop (didn't bet)
Seat 6: StudentRB folded before Flop (didn't bet)
Seat 7: Gluck35 folded before Flop (didn't bet)
Seat 8: MonplDCmax folded before Flop (didn't bet)
Seat 9: fragonik folded before Flop (didn't bet)



PokerStars Hand #228693970988:  Hold'em No Limit ($0.25/$0.50 USD) - 2021/07/30 20:13:43 ET
Table 'Gorgo III' 9-max Seat #2 is the button
Seat 1: PanicJX ($71.27 in chips) 
Seat 2: pudge.3096 ($52.75 in chips) 
Seat 3: kastellani87 ($100.12 in chips) 
Seat 4: BB_dont_cry ($56.66 in chips) 
Seat 5: Mr. white2604 ($39.80 in chips) 
Seat 6: StudentRB ($110.24 in chips) 
Seat 7: Gluck35 ($68.61 in chips) 
Seat 8: MonplDCmax ($53.40 in chips) 
Seat 9: fragonik ($62.47 in chips) 
kastellani87: posts small blind $0.25
BB_dont_cry: posts big blind $0.50
*** HOLE CARDS ***
Mr. white2604: raises $0.50 to $1
StudentRB: folds 
Gluck35: folds 
MonplDCmax: raises $2.50 to $3.50
fragonik: folds 
PanicJX: folds 
pudge.3096: folds 
kastellani87: folds 
BB_dont_cry: folds 
Mr. white2604: calls $2.50
*** FLOP *** [Jh 4s 9h]
Mr. white2604: checks 
MonplDCmax: checks 
*** TURN *** [Jh 4s 9h] [7d]
Mr. white2604: bets $1.50
MonplDCmax: calls $1.50
*** RIVER *** [Jh 4s 9h 7d] [Ac]
Mr. white2604: checks 
MonplDCmax: checks 
*** SHOW DOWN ***
Mr. white2604: shows [Kh Th] (high card Ace)
MonplDCmax: shows [Ad Kc] (a pair of Aces)
MonplDCmax collected $10.21 from pot
*** SUMMARY ***
Total pot $10.75 | Rake $0.54 
Board [Jh 4s 9h 7d Ac]
Seat 1: PanicJX folded before Flop (didn't bet)
Seat 2: pudge.3096 (button) folded before Flop (didn't bet)
Seat 3: kastellani87 (small blind) folded before Flop
Seat 4: BB_dont_cry (big blind) folded before Flop
Seat 5: Mr. white2604 showed [Kh Th] and lost with high card Ace
Seat 6: StudentRB folded before Flop (didn't bet)
Seat 7: Gluck35 folded before Flop (didn't bet)
Seat 8: MonplDCmax showed [Ad Kc] and won ($10.21) with a pair of Aces
Seat 9: fragonik folded before Flop (didn't bet)



PokerStars Hand #228693992568:  Hold'em No Limit ($0.25/$0.50 USD) - 2021/07/30 20:14:57 ET
Table 'Gorgo III' 9-max Seat #3 is the button
Seat 1: PanicJX ($71.27 in chips) 
Seat 2: pudge.3096 ($52.75 in chips) 
Seat 3: kastellani87 ($99.87 in chips) 
Seat 4: BB_dont_cry ($56.16 in chips) 
Seat 5: Mr. white2604 ($34.80 in chips) 
Seat 6: StudentRB ($110.24 in chips) 
Seat 7: Gluck35 ($68.61 in chips) 
Seat 8: MonplDCmax ($58.61 in chips) 
Seat 9: fragonik ($62.47 in chips) 
BB_dont_cry: posts small blind $0.25
Mr. white2604: posts big blind $0.50
*** HOLE CARDS ***
StudentRB: folds 
Gluck35: folds 
MonplDCmax: folds 
fragonik: folds 
PanicJX: folds 
pudge.3096: folds 
kastellani87: folds 
BB_dont_cry: folds 
Uncalled bet ($0.25) returned to Mr. white2604
Mr. white2604 collected $0.50 from pot
Mr. white2604: doesn't show hand 
*** SUMMARY ***
Total pot $0.50 | Rake $0 
Seat 1: PanicJX folded before Flop (didn't bet)
Seat 2: pudge.3096 folded before Flop (didn't bet)
Seat 3: kastellani87 (button) folded before Flop (didn't bet)
Seat 4: BB_dont_cry (small blind) folded before Flop
Seat 5: Mr. white2604 (big blind) collected ($0.50)
Seat 6: StudentRB folded before Flop (didn't bet)
Seat 7: Gluck35 folded before Flop (didn't bet)
Seat 8: MonplDCmax folded before Flop (didn't bet)
Seat 9: fragonik folded before Flop (didn't bet)



PokerStars Hand #228693997888:  Hold'em No Limit ($0.25/$0.50 USD) - 2021/07/30 20:15:15 ET
Table 'Gorgo III' 9-max Seat #4 is the button
Seat 1: PanicJX ($71.27 in chips) 
Seat 2: pudge.3096 ($52.75 in chips) 
Seat 3: kastellani87 ($99.87 in chips) 
Seat 4: BB_dont_cry ($55.91 in chips) 
Seat 5: Mr. white2604 ($35.05 in chips) 
Seat 6: StudentRB ($110.24 in chips) 
Seat 7: Gluck35 ($68.61 in chips) 
Seat 8: MonplDCmax ($58.61 in chips) 
Seat 9: fragonik ($62.47 in chips) 
Mr. white2604: posts small blind $0.25
StudentRB: posts big blind $0.50
*** HOLE CARDS ***
Gluck35: folds 
MonplDCmax: folds 
fragonik: folds 
PanicJX: folds 
pudge.3096: folds 
kastellani87: folds 
BB_dont_cry: raises $1 to $1.50
Mr. white2604: folds 
StudentRB: folds 
Uncalled bet ($1) returned to BB_dont_cry
BB_dont_cry collected $1.25 from pot
*** SUMMARY ***
Total pot $1.25 | Rake $0 
Seat 1: PanicJX folded before Flop (didn't bet)
Seat 2: pudge.3096 folded before Flop (didn't bet)
Seat 3: kastellani87 folded before Flop (didn't bet)
Seat 4: BB_dont_cry (button) collected ($1.25)
Seat 5: Mr. white2604 (small blind) folded before Flop
Seat 6: StudentRB (big blind) folded before Flop
Seat 7: Gluck35 folded before Flop (didn't bet)
Seat 8: MonplDCmax folded before Flop (didn't bet)
Seat 9: fragonik folded before Flop (didn't bet)



PokerStars Hand #228694004448:  Hold'em No Limit ($0.25/$0.50 USD) - 2021/07/30 20:15:38 ET
Table 'Gorgo III' 9-max Seat #5 is the button
Seat 1: PanicJX ($71.27 in chips) 
Seat 2: pudge.3096 ($52.75 in chips) 
Seat 3: kastellani87 ($99.87 in chips) 
Seat 4: BB_dont_cry ($56.66 in chips) 
Seat 5: Mr. white2604 ($34.80 in chips) 
Seat 6: StudentRB ($109.74 in chips) 
Seat 7: Gluck35 ($68.61 in chips) 
Seat 8: MonplDCmax ($58.61 in chips) 
Seat 9: fragonik ($62.47 in chips) 
StudentRB: posts small blind $0.25
Gluck35: posts big blind $0.50
*** HOLE CARDS ***
MonplDCmax: folds 
fragonik: folds 
PanicJX: folds 
pudge.3096: folds 
kastellani87: folds 
BB_dont_cry: folds 
Mr. white2604: folds 
StudentRB: folds 
Uncalled bet ($0.25) returned to Gluck35
Gluck35 collected $0.50 from pot
Gluck35: doesn't show hand 
*** SUMMARY ***
Total pot $0.50 | Rake $0 
Seat 1: PanicJX folded before Flop (didn't bet)
Seat 2: pudge.3096 folded before Flop (didn't bet)
Seat 3: kastellani87 folded before Flop (didn't bet)
Seat 4: BB_dont_cry folded before Flop (didn't bet)
Seat 5: Mr. white2604 (button) folded before Flop (didn't bet)
Seat 6: StudentRB (small blind) folded before Flop
Seat 7: Gluck35 (big blind) collected ($0.50)
Seat 8: MonplDCmax folded before Flop (didn't bet)
Seat 9: fragonik folded before Flop (didn't bet)



PokerStars Hand #228694007358:  Hold'em No Limit ($0.25/$0.50 USD) - 2021/07/30 20:15:48 ET
Table 'Gorgo III' 9-max Seat #6 is the button
Seat 1: PanicJX ($71.27 in chips) 
Seat 2: pudge.3096 ($52.75 in chips) 
Seat 3: kastellani87 ($99.87 in chips) 
Seat 4: BB_dont_cry ($56.66 in chips) 
Seat 5: Mr. white2604 ($34.80 in chips) 
Seat 6: StudentRB ($109.49 in chips) 
Seat 7: Gluck35 ($68.86 in chips) 
Seat 8: MonplDCmax ($58.61 in chips) 
Seat 9: fragonik ($62.47 in chips) 
Gluck35: posts small blind $0.25
MonplDCmax: posts big blind $0.50
*** HOLE CARDS ***
fragonik: raises $1 to $1.50
PanicJX: folds 
pudge.3096: calls $1.50
kastellani87: folds 
BB_dont_cry: calls $1.50
Mr. white2604: folds 
StudentRB: folds 
Gluck35: folds 
MonplDCmax: folds 
*** FLOP *** [4d 9c 6s]
fragonik: bets $2.25
pudge.3096: folds 
BB_dont_cry: folds 
Uncalled bet ($2.25) returned to fragonik
fragonik collected $4.99 from pot
*** SUMMARY ***
Total pot $5.25 | Rake $0.26 
Board [4d 9c 6s]
Seat 1: PanicJX folded before Flop (didn't bet)
Seat 2: pudge.3096 folded on the Flop
Seat 3: kastellani87 folded before Flop (didn't bet)
Seat 4: BB_dont_cry folded on the Flop
Seat 5: Mr. white2604 folded before Flop (didn't bet)
Seat 6: StudentRB (button) folded before Flop (didn't bet)
Seat 7: Gluck35 (small blind) folded before Flop
Seat 8: MonplDCmax (big blind) folded before Flop
Seat 9: fragonik collected ($4.99)



PokerStars Hand #228694021762:  Hold'em No Limit ($0.25/$0.50 USD) - 2021/07/30 20:16:37 ET
Table 'Gorgo III' 9-max Seat #7 is the button
Seat 1: PanicJX ($71.27 in chips) 
Seat 2: pudge.3096 ($51.25 in chips) 
Seat 3: kastellani87 ($99.87 in chips) 
Seat 4: BB_dont_cry ($55.16 in chips) 
Seat 5: Mr. white2604 ($34.80 in chips) 
Seat 6: StudentRB ($109.49 in chips) 
Seat 7: Gluck35 ($68.61 in chips) 
Seat 8: MonplDCmax ($58.11 in chips) 
Seat 9: fragonik ($65.96 in chips) 
MonplDCmax: posts small blind $0.25
fragonik: posts big blind $0.50
*** HOLE CARDS ***
PanicJX: folds 
pudge.3096: folds 
kastellani87: calls $0.50
BB_dont_cry: folds 
Mr. white2604: folds 
StudentRB: folds 
Gluck35: folds 
MonplDCmax: folds 
fragonik: checks 
*** FLOP *** [4d 6d Qd]
fragonik: checks 
kastellani87: checks 
*** TURN *** [4d 6d Qd] [Jd]
fragonik: bets $0.58
kastellani87: folds 
Uncalled bet ($0.58) returned to fragonik
fragonik collected $1.19 from pot
*** SUMMARY ***
Total pot $1.25 | Rake $0.06 
Board [4d 6d Qd Jd]
Seat 1: PanicJX folded before Flop (didn't bet)
Seat 2: pudge.3096 folded before Flop (didn't bet)
Seat 3: kastellani87 folded on the Turn
Seat 4: BB_dont_cry folded before Flop (didn't bet)
Seat 5: Mr. white2604 folded before Flop (didn't bet)
Seat 6: StudentRB folded before Flop (didn't bet)
Seat 7: Gluck35 (button) folded before Flop (didn't bet)
Seat 8: MonplDCmax (small blind) folded before Flop
Seat 9: fragonik (big blind) collected ($1.19)



PokerStars Hand #228694040786:  Hold'em No Limit ($0.25/$0.50 USD) - 2021/07/30 20:17:13 ET
Table 'Gorgo III' 9-max Seat #8 is the button
Seat 1: PanicJX ($71.27 in chips) 
Seat 2: pudge.3096 ($51.25 in chips) 
Seat 3: kastellani87 ($99.37 in chips) 
Seat 4: BB_dont_cry ($55.16 in chips) 
Seat 5: Mr. white2604 ($34.80 in chips) 
Seat 6: StudentRB ($109.49 in chips) 
Seat 7: Gluck35 ($68.61 in chips) 
Seat 8: MonplDCmax ($57.86 in chips) 
Seat 9: fragonik ($66.65 in chips) 
fragonik: posts small blind $0.25
PanicJX: posts big blind $0.50
*** HOLE CARDS ***
pudge.3096: raises $0.75 to $1.25
kastellani87: folds 
BB_dont_cry: calls $1.25
Mr. white2604: folds 
StudentRB: folds 
Gluck35: folds 
MonplDCmax: folds 
fragonik: folds 
PanicJX: folds 
*** FLOP *** [Jh 4s 5d]
pudge.3096: checks 
BB_dont_cry: bets $1.55
pudge.3096: calls $1.55
*** TURN *** [Jh 4s 5d] [7s]
pudge.3096: checks 
BB_dont_cry: checks 
*** RIVER *** [Jh 4s 5d 7s] [6d]
pudge.3096: bets $4.70
BB_dont_cry: raises $4.70 to $9.40
pudge.3096: folds 
Uncalled bet ($4.70) returned to BB_dont_cry
BB_dont_cry collected $14.96 from pot
*** SUMMARY ***
Total pot $15.75 | Rake $0.79 
Board [Jh 4s 5d 7s 6d]
Seat 1: PanicJX (big blind) folded before Flop
Seat 2: pudge.3096 folded on the River
Seat 3: kastellani87 folded before Flop (didn't bet)
Seat 4: BB_dont_cry collected ($14.96)
Seat 5: Mr. white2604 folded before Flop (didn't bet)
Seat 6: StudentRB folded before Flop (didn't bet)
Seat 7: Gluck35 folded before Flop (didn't bet)
Seat 8: MonplDCmax (button) folded before Flop (didn't bet)
Seat 9: fragonik (small blind) folded before Flop



PokerStars Hand #228694054603:  Hold'em No Limit ($0.25/$0.50 USD) - 2021/07/30 20:18:01 ET
Table 'Gorgo III' 9-max Seat #9 is the button
Seat 1: PanicJX ($70.77 in chips) 
Seat 2: pudge.3096 ($50 in chips) 
Seat 3: kastellani87 ($99.37 in chips) 
Seat 4: BB_dont_cry ($62.62 in chips) 
Seat 5: Mr. white2604 ($34.80 in chips) 
Seat 6: StudentRB ($109.49 in chips) 
Seat 7: Gluck35 ($68.61 in chips) 
Seat 8: MonplDCmax ($57.86 in chips) 
Seat 9: fragonik ($66.40 in chips) 
PanicJX: posts small blind $0.25
pudge.3096: posts big blind $0.50
*** HOLE CARDS ***
kastellani87: calls $0.50
BB_dont_cry: calls $0.50
Mr. white2604: calls $0.50
StudentRB: folds 
Gluck35: folds 
MonplDCmax: folds 
fragonik: raises $2.75 to $3.25
PanicJX: folds 
pudge.3096: folds 
kastellani87: folds 
BB_dont_cry: calls $2.75
Mr. white2604: calls $2.75
*** FLOP *** [7d 3d 8s]
BB_dont_cry: checks 
Mr. white2604: bets $4
fragonik: folds 
BB_dont_cry: raises $55.37 to $59.37 and is all-in
Mr. white2604: calls $27.55 and is all-in
Uncalled bet ($27.82) returned to BB_dont_cry
*** TURN *** [7d 3d 8s] [Js]
*** RIVER *** [7d 3d 8s Js] [Ad]
*** SHOW DOWN ***
BB_dont_cry: shows [8c Ac] (two pair, Aces and Eights)
Mr. white2604: shows [9s 9c] (a pair of Nines)
BB_dont_cry collected $72.10 from pot
*** SUMMARY ***
Total pot $74.10 | Rake $2 
Board [7d 3d 8s Js Ad]
Seat 1: PanicJX (small blind) folded before Flop
Seat 2: pudge.3096 (big blind) folded before Flop
Seat 3: kastellani87 folded before Flop
Seat 4: BB_dont_cry showed [8c Ac] and won ($72.10) with two pair, Aces and Eights
Seat 5: Mr. white2604 showed [9s 9c] and lost with a pair of Nines
Seat 6: StudentRB folded before Flop (didn't bet)
Seat 7: Gluck35 folded before Flop (didn't bet)
Seat 8: MonplDCmax folded before Flop (didn't bet)
Seat 9: fragonik (button) folded on the Flop



PokerStars Hand #228694082083:  Hold'em No Limit ($0.25/$0.50 USD) - 2021/07/30 20:19:36 ET
Table 'Gorgo III' 9-max Seat #1 is the button
Seat 1: PanicJX ($70.52 in chips) 
Seat 2: pudge.3096 ($50 in chips) 
Seat 3: kastellani87 ($98.87 in chips) 
Seat 4: BB_dont_cry ($99.92 in chips) 
Seat 6: StudentRB ($109.49 in chips) 
Seat 7: Gluck35 ($68.61 in chips) 
Seat 8: MonplDCmax ($57.86 in chips) 
Seat 9: fragonik ($63.15 in chips) 
pudge.3096: posts small blind $0.25
kastellani87: posts big blind $0.50
*** HOLE CARDS ***
BB_dont_cry: raises $1 to $1.50
StudentRB: raises $3 to $4.50
Gluck35: folds 
MonplDCmax: folds 
fragonik: raises $6 to $10.50
PanicJX: folds 
pudge.3096: folds 
kastellani87: folds 
BB_dont_cry: folds 
StudentRB: folds 
Uncalled bet ($6) returned to fragonik
fragonik collected $11.25 from pot
*** SUMMARY ***
Total pot $11.25 | Rake $0 
Seat 1: PanicJX (button) folded before Flop (didn't bet)
Seat 2: pudge.3096 (small blind) folded before Flop
Seat 3: kastellani87 (big blind) folded before Flop
Seat 4: BB_dont_cry folded before Flop
Seat 6: StudentRB folded before Flop
Seat 7: Gluck35 folded before Flop (didn't bet)
Seat 8: MonplDCmax folded before Flop (didn't bet)
Seat 9: fragonik collected ($11.25)



PokerStars Hand #228694090596:  Hold'em No Limit ($0.25/$0.50 USD) - 2021/07/30 20:20:06 ET
Table 'Gorgo III' 9-max Seat #2 is the button
Seat 1: PanicJX ($70.52 in chips) 
Seat 2: pudge.3096 ($50 in chips) 
Seat 3: kastellani87 ($98.37 in chips) 
Seat 4: BB_dont_cry ($98.42 in chips) 
Seat 6: StudentRB ($104.99 in chips) 
Seat 7: Gluck35 ($68.61 in chips) 
Seat 8: MonplDCmax ($57.86 in chips) 
Seat 9: fragonik ($69.90 in chips) 
kastellani87: posts small blind $0.25
BB_dont_cry: posts big blind $0.50
*** HOLE CARDS ***
StudentRB: raises $0.75 to $1.25
Gluck35: folds 
MonplDCmax: folds 
Mr. white2604 leaves the table
fragonik: folds 
PanicJX: folds 
pudge.3096: folds 
kastellani87: folds 
BB_dont_cry: folds 
Uncalled bet ($0.75) returned to StudentRB
StudentRB collected $1.25 from pot
StudentRB: doesn't show hand 
*** SUMMARY ***
Total pot $1.25 | Rake $0 
Seat 1: PanicJX folded before Flop (didn't bet)
Seat 2: pudge.3096 (button) folded before Flop (didn't bet)
Seat 3: kastellani87 (small blind) folded before Flop
Seat 4: BB_dont_cry (big blind) folded before Flop
Seat 6: StudentRB collected ($1.25)
Seat 7: Gluck35 folded before Flop (didn't bet)
Seat 8: MonplDCmax folded before Flop (didn't bet)
Seat 9: fragonik folded before Flop (didn't bet)



PokerStars Hand #228694094409:  Hold'em No Limit ($0.25/$0.50 USD) - 2021/07/30 20:20:19 ET
Table 'Gorgo III' 9-max Seat #3 is the button
Seat 1: PanicJX ($70.52 in chips) 
Seat 2: pudge.3096 ($50 in chips) 
Seat 3: kastellani87 ($98.12 in chips) 
Seat 4: BB_dont_cry ($97.92 in chips) 
Seat 6: StudentRB ($105.74 in chips) 
Seat 7: Gluck35 ($68.61 in chips) 
Seat 8: MonplDCmax ($57.86 in chips) 
Seat 9: fragonik ($69.90 in chips) 
BB_dont_cry: posts small blind $0.25
StudentRB: posts big blind $0.50
*** HOLE CARDS ***
Gluck35: raises $1 to $1.50
MonplDCmax: folds 
fragonik: folds 
PanicJX: folds 
Rhythmicstep joins the table at seat #5 
pudge.3096: raises $3 to $4.50
MonplDCmax leaves the table
kastellani87: folds 
BB_dont_cry: folds 
StudentRB: folds 
zarplatka joins the table at seat #8 
Gluck35: calls $3
*** FLOP *** [Jh 2c 2d]
Gluck35: checks 
pudge.3096: bets $2.96
Gluck35: calls $2.96
*** TURN *** [Jh 2c 2d] [7d]
Gluck35: checks 
pudge.3096: bets $11.32
Gluck35: folds 
Uncalled bet ($11.32) returned to pudge.3096
pudge.3096 collected $14.89 from pot
pudge.3096: doesn't show hand 
*** SUMMARY ***
Total pot $15.67 | Rake $0.78 
Board [Jh 2c 2d 7d]
Seat 1: PanicJX folded before Flop (didn't bet)
Seat 2: pudge.3096 collected ($14.89)
Seat 3: kastellani87 (button) folded before Flop (didn't bet)
Seat 4: BB_dont_cry (small blind) folded before Flop
Seat 6: StudentRB (big blind) folded before Flop
Seat 7: Gluck35 folded on the Turn
Seat 8: MonplDCmax folded before Flop (didn't bet)
Seat 9: fragonik folded before Flop (didn't bet)



PokerStars Hand #228694121573:  Hold'em No Limit ($0.25/$0.50 USD) - 2021/07/30 20:21:53 ET
Table 'Gorgo III' 9-max Seat #4 is the button
Seat 1: PanicJX ($70.52 in chips) 
Seat 2: pudge.3096 ($57.43 in chips) 
Seat 3: kastellani87 ($98.12 in chips) 
Seat 4: BB_dont_cry ($97.67 in chips) 
Seat 6: StudentRB ($105.24 in chips) 
Seat 7: Gluck35 ($61.15 in chips) 
Seat 9: fragonik ($69.90 in chips) 
StudentRB: posts small blind $0.25
Gluck35: posts big blind $0.50
zarplatka: sits out 
*** HOLE CARDS ***
fragonik: folds 
PanicJX: folds 
pudge.3096: folds 
kastellani87: calls $0.50
BB_dont_cry: calls $0.50
StudentRB: calls $0.25
Gluck35: checks 
*** FLOP *** [Qs 4s 4h]
StudentRB: checks 
Gluck35: checks 
kastellani87: checks 
BB_dont_cry: checks 
*** TURN *** [Qs 4s 4h] [Kc]
StudentRB: checks 
Gluck35: checks 
kastellani87: bets $2
BB_dont_cry: folds 
StudentRB: folds 
Gluck35: folds 
Uncalled bet ($2) returned to kastellani87
kastellani87 collected $1.90 from pot
kastellani87: doesn't show hand 
*** SUMMARY ***
Total pot $2 | Rake $0.10 
Board [Qs 4s 4h Kc]
Seat 1: PanicJX folded before Flop (didn't bet)
Seat 2: pudge.3096 folded before Flop (didn't bet)
Seat 3: kastellani87 collected ($1.90)
Seat 4: BB_dont_cry (button) folded on the Turn
Seat 6: StudentRB (small blind) folded on the Turn
Seat 7: Gluck35 (big blind) folded on the Turn
Seat 9: fragonik folded before Flop (didn't bet)



PokerStars Hand #228694137079:  Hold'em No Limit ($0.25/$0.50 USD) - 2021/07/30 20:22:48 ET
Table 'Gorgo III' 9-max Seat #6 is the button
Seat 1: PanicJX ($70.52 in chips) 
Seat 2: pudge.3096 ($57.43 in chips) 
Seat 3: kastellani87 ($99.52 in chips) 
Seat 4: BB_dont_cry ($97.17 in chips) 
Seat 6: StudentRB ($104.74 in chips) 
Seat 7: Gluck35 ($60.65 in chips) 
Seat 8: zarplatka ($40 in chips) 
Seat 9: fragonik ($69.90 in chips) 
Gluck35: posts small blind $0.25
zarplatka: posts big blind $0.50
Rhythmicstep: sits out 
*** HOLE CARDS ***
fragonik: folds 
PanicJX: folds 
pudge.3096: raises $0.75 to $1.25
kastellani87: folds 
BB_dont_cry: calls $1.25
StudentRB: folds 
Gluck35: folds 
zarplatka: folds 
*** FLOP *** [Qc 4c Jc]
pudge.3096: checks 
BB_dont_cry: checks 
*** TURN *** [Qc 4c Jc] [Js]
pudge.3096: bets $2.35
BB_dont_cry: calls $2.35
*** RIVER *** [Qc 4c Jc Js] [5d]
pudge.3096: bets $5.89
BB_dont_cry: folds 
Uncalled bet ($5.89) returned to pudge.3096
pudge.3096 collected $7.55 from pot
pudge.3096: doesn't show hand 
*** SUMMARY ***
Total pot $7.95 | Rake $0.40 
Board [Qc 4c Jc Js 5d]
Seat 1: PanicJX folded before Flop (didn't bet)
Seat 2: pudge.3096 collected ($7.55)
Seat 3: kastellani87 folded before Flop (didn't bet)
Seat 4: BB_dont_cry folded on the River
Seat 6: StudentRB (button) folded before Flop (didn't bet)
Seat 7: Gluck35 (small blind) folded before Flop
Seat 8: zarplatka (big blind) folded before Flop
Seat 9: fragonik folded before Flop (didn't bet)



PokerStars Hand #228694156223:  Hold'em No Limit ($0.25/$0.50 USD) - 2021/07/30 20:23:56 ET
Table 'Gorgo III' 9-max Seat #7 is the button
Seat 1: PanicJX ($70.52 in chips) 
Seat 2: pudge.3096 ($61.38 in chips) 
Seat 3: kastellani87 ($99.52 in chips) 
Seat 4: BB_dont_cry ($93.57 in chips) 
Seat 6: StudentRB ($104.74 in chips) 
Seat 7: Gluck35 ($60.40 in chips) 
Seat 8: zarplatka ($40 in chips) 
Seat 9: fragonik ($69.90 in chips) 
zarplatka: posts small blind $0.25
fragonik: posts big blind $0.50
Rhythmicstep: sits out 
*** HOLE CARDS ***
PanicJX: calls $0.50
pudge.3096: folds 
kastellani87: calls $0.50
BB_dont_cry: raises $2.25 to $2.75
StudentRB: folds 
Gluck35: folds 
zarplatka: folds 
fragonik: folds 
PanicJX: calls $2.25
kastellani87: folds 
*** FLOP *** [7s 5c 5s]
PanicJX: checks 
BB_dont_cry: checks 
*** TURN *** [7s 5c 5s] [8s]
PanicJX: bets $6.41
BB_dont_cry: folds 
Uncalled bet ($6.41) returned to PanicJX
PanicJX collected $6.41 from pot
PanicJX: doesn't show hand 
*** SUMMARY ***
Total pot $6.75 | Rake $0.34 
Board [7s 5c 5s 8s]
Seat 1: PanicJX collected ($6.41)
Seat 2: pudge.3096 folded before Flop (didn't bet)
Seat 3: kastellani87 folded before Flop
Seat 4: BB_dont_cry folded on the Turn
Seat 6: StudentRB folded before Flop (didn't bet)
Seat 7: Gluck35 (button) folded before Flop (didn't bet)
Seat 8: zarplatka (small blind) folded before Flop
Seat 9: fragonik (big blind) folded before Flop



PokerStars Hand #228694170308:  Hold'em No Limit ($0.25/$0.50 USD) - 2021/07/30 20:24:46 ET
Table 'Gorgo III' 9-max Seat #8 is the button
Seat 1: PanicJX ($74.18 in chips) 
Seat 2: pudge.3096 ($61.38 in chips) 
Seat 3: kastellani87 ($99.02 in chips) 
Seat 4: BB_dont_cry ($90.82 in chips) 
Seat 6: StudentRB ($104.74 in chips) 
Seat 7: Gluck35 ($60.40 in chips) 
Seat 8: zarplatka ($40 in chips) 
Seat 9: fragonik ($69.40 in chips) 
fragonik: posts small blind $0.25
PanicJX: posts big blind $0.50
Rhythmicstep: sits out 
*** HOLE CARDS ***
pudge.3096: folds 
kastellani87: folds 
BB_dont_cry: folds 
StudentRB: raises $0.75 to $1.25
Gluck35: folds 
zarplatka: raises $3.25 to $4.50
fragonik: folds 
PanicJX: folds 
StudentRB: folds 
Uncalled bet ($3.25) returned to zarplatka
PanicJX leaves the table
zarplatka collected $3.25 from pot
zarplatka: doesn't show hand 
*** SUMMARY ***
Total pot $3.25 | Rake $0 
Seat 1: PanicJX (big blind) folded before Flop
Seat 2: pudge.3096 folded before Flop (didn't bet)
Seat 3: kastellani87 folded before Flop (didn't bet)
Seat 4: BB_dont_cry folded before Flop (didn't bet)
Seat 6: StudentRB folded before Flop
Seat 7: Gluck35 folded before Flop (didn't bet)
Seat 8: zarplatka (button) collected ($3.25)
Seat 9: fragonik (small blind) folded before Flop



PokerStars Hand #228694181637:  Hold'em No Limit ($0.25/$0.50 USD) - 2021/07/30 20:25:26 ET
Table 'Gorgo III' 9-max Seat #9 is the button
Seat 2: pudge.3096 ($61.38 in chips) 
Seat 3: kastellani87 ($99.02 in chips) 
Seat 4: BB_dont_cry ($90.82 in chips) 
Seat 6: StudentRB ($103.49 in chips) 
Seat 7: Gluck35 ($60.40 in chips) 
Seat 9: fragonik ($69.15 in chips) 
pudge.3096: posts small blind $0.25
kastellani87: posts big blind $0.50
Rhythmicstep: sits out 
*** HOLE CARDS ***
BB_dont_cry: folds 
StudentRB: folds 
Gluck35: folds 
fragonik: raises $0.75 to $1.25
pudge.3096: folds 
kastellani87: folds 
Uncalled bet ($0.75) returned to fragonik
fragonik collected $1.25 from pot
*** SUMMARY ***
Total pot $1.25 | Rake $0 
Seat 2: pudge.3096 (small blind) folded before Flop
Seat 3: kastellani87 (big blind) folded before Flop
Seat 4: BB_dont_cry folded before Flop (didn't bet)
Seat 6: StudentRB folded before Flop (didn't bet)
Seat 7: Gluck35 folded before Flop (didn't bet)
Seat 9: fragonik (button) collected ($1.25)



PokerStars Hand #228694193358:  Hold'em No Limit ($0.25/$0.50 USD) - 2021/07/30 20:25:41 ET
Table 'Gorgo III' 9-max Seat #2 is the button
Seat 2: pudge.3096 ($61.13 in chips) 
Seat 3: kastellani87 ($98.52 in chips) 
Seat 4: BB_dont_cry ($90.82 in chips) 
Seat 6: StudentRB ($103.49 in chips) 
Seat 7: Gluck35 ($60.40 in chips) 
Seat 9: fragonik ($69.90 in chips) 
kastellani87: posts small blind $0.25
BB_dont_cry: posts big blind $0.50
Rhythmicstep: sits out 
*** HOLE CARDS ***
StudentRB: raises $0.75 to $1.25
Gluck35: raises $2.75 to $4
fragonik: folds 
pudge.3096: folds 
kastellani87: folds 
BB_dont_cry: folds 
StudentRB: calls $2.75
*** FLOP *** [2c Tc Ac]
StudentRB: checks 
Gluck35: checks 
*** TURN *** [2c Tc Ac] [5c]
StudentRB: checks 
Gluck35: checks 
*** RIVER *** [2c Tc Ac 5c] [Qc]
StudentRB: checks 
Gluck35: checks 
*** SHOW DOWN ***
StudentRB: shows [9c 9d] (a flush, Ace high)
Gluck35: mucks hand 
StudentRB collected $8.31 from pot
*** SUMMARY ***
Total pot $8.75 | Rake $0.44 
Board [2c Tc Ac 5c Qc]
Seat 2: pudge.3096 (button) folded before Flop (didn't bet)
Seat 3: kastellani87 (small blind) folded before Flop
Seat 4: BB_dont_cry (big blind) folded before Flop
Seat 6: StudentRB showed [9c 9d] and won ($8.31) with a flush, Ace high
Seat 7: Gluck35 mucked
Seat 9: fragonik folded before Flop (didn't bet)



PokerStars Hand #228694204475:  Hold'em No Limit ($0.25/$0.50 USD) - 2021/07/30 20:26:20 ET
Table 'Gorgo III' 9-max Seat #3 is the button
Seat 2: pudge.3096 ($61.13 in chips) 
Seat 3: kastellani87 ($98.27 in chips) 
Seat 4: BB_dont_cry ($90.32 in chips) 
Seat 5: Rhythmicstep ($50 in chips) 
Seat 6: StudentRB ($107.80 in chips) 
Seat 7: Gluck35 ($56.40 in chips) 
Seat 9: fragonik ($69.90 in chips) 
BB_dont_cry: posts small blind $0.25
Rhythmicstep: posts big blind $0.50
*** HOLE CARDS ***
StudentRB: folds 
Gluck35: folds 
fragonik: folds 
pudge.3096: raises $0.75 to $1.25
kastellani87: calls $1.25
BB_dont_cry: raises $5.25 to $6.50
Rhythmicstep: folds 
pudge.3096: folds 
kastellani87: calls $5.25
*** FLOP *** [9c 4d Kh]
BB_dont_cry: checks 
kastellani87: checks 
*** TURN *** [9c 4d Kh] [9s]
BB_dont_cry: checks 
kastellani87: checks 
*** RIVER *** [9c 4d Kh 9s] [As]
BB_dont_cry: checks 
kastellani87: checks 
*** SHOW DOWN ***
BB_dont_cry: shows [4s 3c] (two pair, Nines and Fours)
kastellani87: mucks hand 
BB_dont_cry collected $14.01 from pot
*** SUMMARY ***
Total pot $14.75 | Rake $0.74 
Board [9c 4d Kh 9s As]
Seat 2: pudge.3096 folded before Flop
Seat 3: kastellani87 (button) mucked
Seat 4: BB_dont_cry (small blind) showed [4s 3c] and won ($14.01) with two pair, Nines and Fours
Seat 5: Rhythmicstep (big blind) folded before Flop
Seat 6: StudentRB folded before Flop (didn't bet)
Seat 7: Gluck35 folded before Flop (didn't bet)
Seat 9: fragonik folded before Flop (didn't bet)



PokerStars Hand #228694231319:  Hold'em No Limit ($0.25/$0.50 USD) - 2021/07/30 20:27:56 ET
Table 'Gorgo III' 9-max Seat #4 is the button
Seat 2: pudge.3096 ($59.88 in chips) 
Seat 3: kastellani87 ($91.77 in chips) 
Seat 4: BB_dont_cry ($97.83 in chips) 
Seat 5: Rhythmicstep ($50 in chips) 
Seat 6: StudentRB ($107.80 in chips) 
Seat 7: Gluck35 ($56.40 in chips) 
Seat 9: fragonik ($69.90 in chips) 
Rhythmicstep: posts small blind $0.25
StudentRB: posts big blind $0.50
*** HOLE CARDS ***
Gluck35: folds 
Gluck35 was removed from the table for failing to post
Gluck35 leaves the table
fragonik: folds 
pudge.3096: raises $0.75 to $1.25
kastellani87: calls $1.25
BB_dont_cry: raises $5.25 to $6.50
Rhythmicstep: folds 
StudentRB: folds 
pudge.3096: folds 
kastellani87: folds 
Uncalled bet ($5.25) returned to BB_dont_cry
BB_dont_cry collected $4.50 from pot
*** SUMMARY ***
Total pot $4.50 | Rake $0 
Seat 2: pudge.3096 folded before Flop
Seat 3: kastellani87 folded before Flop
Seat 4: BB_dont_cry (button) collected ($4.50)
Seat 5: Rhythmicstep (small blind) folded before Flop
Seat 6: StudentRB (big blind) folded before Flop
Seat 7: Gluck35 folded before Flop (didn't bet)
Seat 9: fragonik folded before Flop (didn't bet)



PokerStars Hand #228694243604:  Hold'em No Limit ($0.25/$0.50 USD) - 2021/07/30 20:28:39 ET
Table 'Gorgo III' 9-max Seat #5 is the button
Seat 2: pudge.3096 ($58.63 in chips) 
Seat 3: kastellani87 ($90.52 in chips) 
Seat 4: BB_dont_cry ($101.08 in chips) 
Seat 5: Rhythmicstep ($50 in chips) 
Seat 6: StudentRB ($107.30 in chips) 
Seat 9: fragonik ($69.90 in chips) 
StudentRB: posts small blind $0.25
fragonik: posts big blind $0.50
*** HOLE CARDS ***
Squall33bdi joins the table at seat #1 
pudge.3096: folds 
kastellani87: raises $1 to $1.50
BB_dont_cry: raises $2.50 to $4
Rhythmicstep: folds 
StudentRB: folds 
fragonik: folds 
kastellani87: calls $2.50
*** FLOP *** [8h 4s 9s]
kastellani87: checks 
BB_dont_cry: bets $4.50
kastellani87: folds 
Uncalled bet ($4.50) returned to BB_dont_cry
BB_dont_cry collected $8.31 from pot
*** SUMMARY ***
Total pot $8.75 | Rake $0.44 
Board [8h 4s 9s]
Seat 2: pudge.3096 folded before Flop (didn't bet)
Seat 3: kastellani87 folded on the Flop
Seat 4: BB_dont_cry collected ($8.31)
Seat 5: Rhythmicstep (button) folded before Flop (didn't bet)
Seat 6: StudentRB (small blind) folded before Flop
Seat 9: fragonik (big blind) folded before Flop



PokerStars Hand #228694258190:  Hold'em No Limit ($0.25/$0.50 USD) - 2021/07/30 20:29:32 ET
Table 'Gorgo III' 9-max Seat #6 is the button
Seat 1: Squall33bdi ($50 in chips) 
Seat 2: pudge.3096 ($58.63 in chips) 
Seat 3: kastellani87 ($86.52 in chips) 
Seat 4: BB_dont_cry ($105.39 in chips) 
Seat 5: Rhythmicstep ($50 in chips) 
Seat 6: StudentRB ($107.05 in chips) 
Seat 9: fragonik ($69.40 in chips) 
fragonik: posts small blind $0.25
Squall33bdi: posts big blind $0.50
*** HOLE CARDS ***
pudge.3096: folds 
kastellani87: calls $0.50
BB_dont_cry: raises $1 to $1.50
Rhythmicstep: calls $1.50
StudentRB: folds 
fragonik: raises $5.50 to $7
Squall33bdi: folds 
kastellani87: folds 
BB_dont_cry: calls $5.50
Rhythmicstep: folds 
*** FLOP *** [6d 3d 8d]
fragonik: bets $5.17
BB_dont_cry: folds 
Uncalled bet ($5.17) returned to fragonik
fragonik collected $15.68 from pot
*** SUMMARY ***
Total pot $16.50 | Rake $0.82 
Board [6d 3d 8d]
Seat 1: Squall33bdi (big blind) folded before Flop
Seat 2: pudge.3096 folded before Flop (didn't bet)
Seat 3: kastellani87 folded before Flop
Seat 4: BB_dont_cry folded on the Flop
Seat 5: Rhythmicstep folded before Flop
Seat 6: StudentRB (button) folded before Flop (didn't bet)
Seat 9: fragonik (small blind) collected ($15.68)



PokerStars Hand #228694276508:  Hold'em No Limit ($0.25/$0.50 USD) - 2021/07/30 20:30:37 ET
Table 'Gorgo III' 9-max Seat #9 is the button
Seat 1: Squall33bdi ($50 in chips) 
Seat 2: pudge.3096 ($58.63 in chips) 
Seat 3: kastellani87 ($86.02 in chips) 
Seat 4: BB_dont_cry ($98.39 in chips) 
Seat 5: Rhythmicstep ($50 in chips) 
Seat 6: StudentRB ($107.05 in chips) 
Seat 9: fragonik ($78.08 in chips) 
Squall33bdi: posts small blind $0.25
pudge.3096: posts big blind $0.50
*** HOLE CARDS ***
kastellani87: folds 
BB_dont_cry: folds 
Rhythmicstep: folds 
StudentRB: folds 
fragonik: folds 
Squall33bdi: folds 
Uncalled bet ($0.25) returned to pudge.3096
pudge.3096 collected $0.50 from pot
pudge.3096: doesn't show hand 
*** SUMMARY ***
Total pot $0.50 | Rake $0 
Seat 1: Squall33bdi (small blind) folded before Flop
Seat 2: pudge.3096 (big blind) collected ($0.50)
Seat 3: kastellani87 folded before Flop (didn't bet)
Seat 4: BB_dont_cry folded before Flop (didn't bet)
Seat 5: Rhythmicstep folded before Flop (didn't bet)
Seat 6: StudentRB folded before Flop (didn't bet)
Seat 9: fragonik (button) folded before Flop (didn't bet)



PokerStars Hand #228694280556:  Hold'em No Limit ($0.25/$0.50 USD) - 2021/07/30 20:30:51 ET
Table 'Gorgo III' 9-max Seat #1 is the button
Seat 1: Squall33bdi ($50 in chips) 
Seat 2: pudge.3096 ($58.88 in chips) 
Seat 3: kastellani87 ($86.02 in chips) 
Seat 4: BB_dont_cry ($98.39 in chips) 
Seat 5: Rhythmicstep ($50 in chips) 
Seat 6: StudentRB ($107.05 in chips) 
Seat 9: fragonik ($78.08 in chips) 
pudge.3096: posts small blind $0.25
kastellani87: posts big blind $0.50
*** HOLE CARDS ***
BB_dont_cry: folds 
Rhythmicstep: raises $1 to $1.50
StudentRB: folds 
fragonik: folds 
Squall33bdi: folds 
pudge.3096: folds 
kastellani87: folds 
Uncalled bet ($1) returned to Rhythmicstep
Rhythmicstep collected $1.25 from pot
Rhythmicstep: doesn't show hand 
*** SUMMARY ***
Total pot $1.25 | Rake $0 
Seat 1: Squall33bdi (button) folded before Flop (didn't bet)
Seat 2: pudge.3096 (small blind) folded before Flop
Seat 3: kastellani87 (big blind) folded before Flop
Seat 4: BB_dont_cry folded before Flop (didn't bet)
Seat 5: Rhythmicstep collected ($1.25)
Seat 6: StudentRB folded before Flop (didn't bet)
Seat 9: fragonik folded before Flop (didn't bet)



PokerStars Hand #228694287903:  Hold'em No Limit ($0.25/$0.50 USD) - 2021/07/30 20:31:17 ET
Table 'Gorgo III' 9-max Seat #2 is the button
Seat 1: Squall33bdi ($50 in chips) 
Seat 2: pudge.3096 ($58.63 in chips) 
Seat 3: kastellani87 ($85.52 in chips) 
Seat 4: BB_dont_cry ($98.39 in chips) 
Seat 5: Rhythmicstep ($50.75 in chips) 
Seat 6: StudentRB ($107.05 in chips) 
Seat 9: fragonik ($78.08 in chips) 
kastellani87: posts small blind $0.25
BB_dont_cry: posts big blind $0.50
*** HOLE CARDS ***
Rhythmicstep: folds 
StudentRB: folds 
fragonik: folds 
Squall33bdi: folds 
pudge.3096: raises $0.75 to $1.25
kastellani87: calls $1
BB_dont_cry: folds 
*** FLOP *** [9c 2h 9d]
kastellani87: checks 
pudge.3096: bets $1.48
kastellani87: calls $1.48
*** TURN *** [9c 2h 9d] [Kd]
kastellani87: checks 
pudge.3096: bets $4.30
kastellani87: folds 
Uncalled bet ($4.30) returned to pudge.3096
pudge.3096 collected $5.66 from pot
Chernovsky joins the table at seat #7 
pudge.3096: doesn't show hand 
*** SUMMARY ***
Total pot $5.96 | Rake $0.30 
Board [9c 2h 9d Kd]
Seat 1: Squall33bdi folded before Flop (didn't bet)
Seat 2: pudge.3096 (button) collected ($5.66)
Seat 3: kastellani87 (small blind) folded on the Turn
Seat 4: BB_dont_cry (big blind) folded before Flop
Seat 5: Rhythmicstep folded before Flop (didn't bet)
Seat 6: StudentRB folded before Flop (didn't bet)
Seat 9: fragonik folded before Flop (didn't bet)



PokerStars Hand #228694300574:  Hold'em No Limit ($0.25/$0.50 USD) - 2021/07/30 20:32:02 ET
Table 'Gorgo III' 9-max Seat #3 is the button
Seat 1: Squall33bdi ($50 in chips) 
Seat 2: pudge.3096 ($61.56 in chips) 
Seat 3: kastellani87 ($82.79 in chips) 
Seat 4: BB_dont_cry ($97.89 in chips) 
Seat 5: Rhythmicstep ($50.75 in chips) 
Seat 6: StudentRB ($107.05 in chips) 
Seat 9: fragonik ($78.08 in chips) 
BB_dont_cry: posts small blind $0.25
Rhythmicstep: posts big blind $0.50
Chernovsky: sits out 
*** HOLE CARDS ***
StudentRB: folds 
fragonik: folds 
Squall33bdi: folds 
pudge.3096: raises $0.75 to $1.25
kastellani87: folds 
BB_dont_cry: calls $1
Rhythmicstep: calls $0.75
*** FLOP *** [7d Ad 7c]
christyirish joins the table at seat #8 
BB_dont_cry: bets $1.78
Rhythmicstep: calls $1.78
pudge.3096: folds 
*** TURN *** [7d Ad 7c] [7s]
BB_dont_cry: checks 
Rhythmicstep: checks 
*** RIVER *** [7d Ad 7c 7s] [Kh]
BB_dont_cry: checks 
Rhythmicstep: checks 
*** SHOW DOWN ***
BB_dont_cry: shows [3s Ah] (a full house, Sevens full of Aces)
Rhythmicstep: mucks hand 
BB_dont_cry collected $6.94 from pot
*** SUMMARY ***
Total pot $7.31 | Rake $0.37 
Board [7d Ad 7c 7s Kh]
Seat 1: Squall33bdi folded before Flop (didn't bet)
Seat 2: pudge.3096 folded on the Flop
Seat 3: kastellani87 (button) folded before Flop (didn't bet)
Seat 4: BB_dont_cry (small blind) showed [3s Ah] and won ($6.94) with a full house, Sevens full of Aces
Seat 5: Rhythmicstep (big blind) mucked
Seat 6: StudentRB folded before Flop (didn't bet)
Seat 9: fragonik folded before Flop (didn't bet)



PokerStars Hand #228694319913:  Hold'em No Limit ($0.25/$0.50 USD) - 2021/07/30 20:33:11 ET
Table 'Gorgo III' 9-max Seat #4 is the button
Seat 1: Squall33bdi ($50 in chips) 
Seat 2: pudge.3096 ($60.31 in chips) 
Seat 3: kastellani87 ($82.79 in chips) 
Seat 4: BB_dont_cry ($101.80 in chips) 
Seat 5: Rhythmicstep ($50 in chips) 
Seat 6: StudentRB ($107.05 in chips) 
Seat 8: christyirish ($50 in chips) 
Seat 9: fragonik ($78.08 in chips) 
Rhythmicstep: posts small blind $0.25
StudentRB: posts big blind $0.50
Chernovsky: sits out 
christyirish: posts big blind $0.50
*** HOLE CARDS ***
christyirish: checks 
fragonik: folds 
Squall33bdi: folds 
pudge.3096: folds 
kastellani87: raises $0.50 to $1
BB_dont_cry: folds 
Rhythmicstep: raises $4 to $5
StudentRB: folds 
christyirish: folds 
kastellani87: raises $11 to $16
Rhythmicstep: folds 
Uncalled bet ($11) returned to kastellani87
kastellani87 collected $11 from pot
kastellani87: doesn't show hand 
*** SUMMARY ***
Total pot $11 | Rake $0 
Seat 1: Squall33bdi folded before Flop (didn't bet)
Seat 2: pudge.3096 folded before Flop (didn't bet)
Seat 3: kastellani87 collected ($11)
Seat 4: BB_dont_cry (button) folded before Flop (didn't bet)
Seat 5: Rhythmicstep (small blind) folded before Flop
Seat 6: StudentRB (big blind) folded before Flop
Seat 8: christyirish folded before Flop (didn't bet)
Seat 9: fragonik folded before Flop (didn't bet)



PokerStars Hand #228694334974:  Hold'em No Limit ($0.25/$0.50 USD) - 2021/07/30 20:34:06 ET
Table 'Gorgo III' 9-max Seat #5 is the button
Seat 1: Squall33bdi ($50 in chips) 
Seat 2: pudge.3096 ($60.31 in chips) 
Seat 3: kastellani87 ($88.79 in chips) 
Seat 4: BB_dont_cry ($101.80 in chips) 
Seat 5: Rhythmicstep ($50 in chips) 
Seat 6: StudentRB ($106.55 in chips) 
Seat 7: Chernovsky ($50 in chips) 
Seat 8: christyirish ($50 in chips) 
Seat 9: fragonik ($78.08 in chips) 
StudentRB: posts small blind $0.25
Chernovsky: posts big blind $0.50
*** HOLE CARDS ***
christyirish: folds 
fragonik: folds 
Squall33bdi: folds 
pudge.3096: folds 
kastellani87: folds 
BB_dont_cry: folds 
Rhythmicstep: folds 
StudentRB: raises $1 to $1.50
Chernovsky: calls $1
*** FLOP *** [Kh Qs Tc]
StudentRB: checks 
Chernovsky: checks 
*** TURN *** [Kh Qs Tc] [5c]
StudentRB: bets $2.14
Chernovsky: calls $2.14
*** RIVER *** [Kh Qs Tc 5c] [2h]
StudentRB: bets $10.38
Chernovsky: folds 
Uncalled bet ($10.38) returned to StudentRB
StudentRB collected $6.92 from pot
StudentRB: doesn't show hand 
*** SUMMARY ***
Total pot $7.28 | Rake $0.36 
Board [Kh Qs Tc 5c 2h]
Seat 1: Squall33bdi folded before Flop (didn't bet)
Seat 2: pudge.3096 folded before Flop (didn't bet)
Seat 3: kastellani87 folded before Flop (didn't bet)
Seat 4: BB_dont_cry folded before Flop (didn't bet)
Seat 5: Rhythmicstep (button) folded before Flop (didn't bet)
Seat 6: StudentRB (small blind) collected ($6.92)
Seat 7: Chernovsky (big blind) folded on the River
Seat 8: christyirish folded before Flop (didn't bet)
Seat 9: fragonik folded before Flop (didn't bet)



PokerStars Hand #228694347850:  Hold'em No Limit ($0.25/$0.50 USD) - 2021/07/30 20:34:52 ET
Table 'Gorgo III' 9-max Seat #6 is the button
Seat 1: Squall33bdi ($50 in chips) 
Seat 2: pudge.3096 ($60.31 in chips) 
Seat 3: kastellani87 ($88.79 in chips) 
Seat 4: BB_dont_cry ($101.80 in chips) 
Seat 5: Rhythmicstep ($50 in chips) 
Seat 6: StudentRB ($109.83 in chips) 
Seat 7: Chernovsky ($50 in chips) 
Seat 8: christyirish ($50 in chips) 
Seat 9: fragonik ($78.08 in chips) 
Chernovsky: posts small blind $0.25
christyirish: posts big blind $0.50
*** HOLE CARDS ***
fragonik: folds 
Squall33bdi: folds 
pudge.3096: folds 
kastellani87: folds 
BB_dont_cry: raises $1 to $1.50
Rhythmicstep: folds 
StudentRB: folds 
Chernovsky: folds 
christyirish: calls $1
*** FLOP *** [6d 4s 8h]
christyirish: checks 
BB_dont_cry: bets $2
christyirish: calls $2
*** TURN *** [6d 4s 8h] [7d]
christyirish: bets $4
BB_dont_cry: raises $5.50 to $9.50
christyirish: calls $5.50
*** RIVER *** [6d 4s 8h 7d] [Ad]
christyirish: bets $37 and is all-in
BB_dont_cry: folds 
Uncalled bet ($37) returned to christyirish
christyirish collected $24.94 from pot
christyirish: shows [9d 8s] (a pair of Eights)
*** SUMMARY ***
Total pot $26.25 | Rake $1.31 
Board [6d 4s 8h 7d Ad]
Seat 1: Squall33bdi folded before Flop (didn't bet)
Seat 2: pudge.3096 folded before Flop (didn't bet)
Seat 3: kastellani87 folded before Flop (didn't bet)
Seat 4: BB_dont_cry folded on the River
Seat 5: Rhythmicstep folded before Flop (didn't bet)
Seat 6: StudentRB (button) folded before Flop (didn't bet)
Seat 7: Chernovsky (small blind) folded before Flop
Seat 8: christyirish (big blind) collected ($24.94)
Seat 9: fragonik folded before Flop (didn't bet)



PokerStars Hand #228694371046:  Hold'em No Limit ($0.25/$0.50 USD) - 2021/07/30 20:36:15 ET
Table 'Gorgo III' 9-max Seat #7 is the button
Seat 1: Squall33bdi ($50 in chips) 
Seat 2: pudge.3096 ($60.31 in chips) 
Seat 3: kastellani87 ($88.79 in chips) 
Seat 4: BB_dont_cry ($88.80 in chips) 
Seat 5: Rhythmicstep ($50 in chips) 
Seat 6: StudentRB ($109.83 in chips) 
Seat 7: Chernovsky ($50 in chips) 
Seat 8: christyirish ($61.94 in chips) 
Seat 9: fragonik ($78.08 in chips) 
christyirish: posts small blind $0.25
fragonik: posts big blind $0.50
*** HOLE CARDS ***
Squall33bdi: folds 
pudge.3096: folds 
kastellani87: folds 
BB_dont_cry: calls $0.50
Rhythmicstep: folds 
StudentRB: folds 
Chernovsky: raises $1.50 to $2
christyirish: folds 
fragonik: folds 
BB_dont_cry: calls $1.50
*** FLOP *** [Kh 3d 4c]
BB_dont_cry: checks 
Chernovsky: bets $1.53
BB_dont_cry: calls $1.53
*** TURN *** [Kh 3d 4c] [8h]
BB_dont_cry: checks 
Chernovsky: bets $5.57
BB_dont_cry: folds 
Uncalled bet ($5.57) returned to Chernovsky
Chernovsky collected $7.42 from pot
Chernovsky: doesn't show hand 
*** SUMMARY ***
Total pot $7.81 | Rake $0.39 
Board [Kh 3d 4c 8h]
Seat 1: Squall33bdi folded before Flop (didn't bet)
Seat 2: pudge.3096 folded before Flop (didn't bet)
Seat 3: kastellani87 folded before Flop (didn't bet)
Seat 4: BB_dont_cry folded on the Turn
Seat 5: Rhythmicstep folded before Flop (didn't bet)
Seat 6: StudentRB folded before Flop (didn't bet)
Seat 7: Chernovsky (button) collected ($7.42)
Seat 8: christyirish (small blind) folded before Flop
Seat 9: fragonik (big blind) folded before Flop



PokerStars Hand #228694390591:  Hold'em No Limit ($0.25/$0.50 USD) - 2021/07/30 20:37:25 ET
Table 'Gorgo III' 9-max Seat #8 is the button
Seat 2: pudge.3096 ($60.31 in chips) 
Seat 3: kastellani87 ($88.79 in chips) 
Seat 4: BB_dont_cry ($85.27 in chips) 
Seat 5: Rhythmicstep ($50 in chips) 
Seat 6: StudentRB ($109.83 in chips) 
Seat 7: Chernovsky ($53.89 in chips) 
Seat 8: christyirish ($61.69 in chips) 
Seat 9: fragonik ($77.58 in chips) 
fragonik: posts small blind $0.25
Squall33bdi: is sitting out 
pudge.3096: posts big blind $0.50
*** HOLE CARDS ***
kastellani87: folds 
BB_dont_cry: raises $1.50 to $2
Rhythmicstep: folds 
StudentRB: raises $3 to $5
Chernovsky: folds 
christyirish: folds 
fragonik: folds 
pudge.3096: folds 
BB_dont_cry: raises $10.75 to $15.75
StudentRB: calls $10.75
*** FLOP *** [Kh 4s 7d]
BB_dont_cry: bets $69.52 and is all-in
StudentRB: folds 
Uncalled bet ($69.52) returned to BB_dont_cry
BB_dont_cry collected $30.64 from pot
*** SUMMARY ***
Total pot $32.25 | Rake $1.61 
Board [Kh 4s 7d]
Seat 2: pudge.3096 (big blind) folded before Flop
Seat 3: kastellani87 folded before Flop (didn't bet)
Seat 4: BB_dont_cry collected ($30.64)
Seat 5: Rhythmicstep folded before Flop (didn't bet)
Seat 6: StudentRB folded on the Flop
Seat 7: Chernovsky folded before Flop (didn't bet)
Seat 8: christyirish (button) folded before Flop (didn't bet)
Seat 9: fragonik (small blind) folded before Flop



PokerStars Hand #228694401535:  Hold'em No Limit ($0.25/$0.50 USD) - 2021/07/30 20:38:05 ET
Table 'Gorgo III' 9-max Seat #9 is the button
Seat 2: pudge.3096 ($59.81 in chips) 
Seat 3: kastellani87 ($88.79 in chips) 
Seat 4: BB_dont_cry ($100.16 in chips) 
Seat 5: Rhythmicstep ($50 in chips) 
Seat 6: StudentRB ($94.08 in chips) 
Seat 7: Chernovsky ($53.89 in chips) 
Seat 8: christyirish ($61.69 in chips) 
Seat 9: fragonik ($77.33 in chips) 
pudge.3096: posts small blind $0.25
kastellani87: posts big blind $0.50
*** HOLE CARDS ***
BB_dont_cry: folds 
Rhythmicstep: folds 
StudentRB: folds 
Chernovsky: raises $0.75 to $1.25
christyirish: folds 
fragonik: folds 
pudge.3096: folds 
kastellani87: calls $0.75
*** FLOP *** [Qd 9d Ah]
kastellani87: checks 
Chernovsky: checks 
*** TURN *** [Qd 9d Ah] [Tc]
kastellani87: checks 
Chernovsky: bets $1.96
kastellani87: folds 
Uncalled bet ($1.96) returned to Chernovsky
Chernovsky collected $2.61 from pot
Chernovsky: doesn't show hand 
*** SUMMARY ***
Total pot $2.75 | Rake $0.14 
Board [Qd 9d Ah Tc]
Seat 2: pudge.3096 (small blind) folded before Flop
Seat 3: kastellani87 (big blind) folded on the Turn
Seat 4: BB_dont_cry folded before Flop (didn't bet)
Seat 5: Rhythmicstep folded before Flop (didn't bet)
Seat 6: StudentRB folded before Flop (didn't bet)
Seat 7: Chernovsky collected ($2.61)
Seat 8: christyirish folded before Flop (didn't bet)
Seat 9: fragonik (button) folded before Flop (didn't bet)



PokerStars Hand #228694410316:  Hold'em No Limit ($0.25/$0.50 USD) - 2021/07/30 20:38:37 ET
Table 'Gorgo III' 9-max Seat #2 is the button
Seat 2: pudge.3096 ($59.56 in chips) 
Seat 3: kastellani87 ($87.54 in chips) 
Seat 4: BB_dont_cry ($100.16 in chips) 
Seat 5: Rhythmicstep ($50 in chips) 
Seat 6: StudentRB ($94.08 in chips) 
Seat 7: Chernovsky ($55.25 in chips) 
Seat 8: christyirish ($61.69 in chips) 
Seat 9: fragonik ($77.33 in chips) 
kastellani87: posts small blind $0.25
BB_dont_cry: posts big blind $0.50
*** HOLE CARDS ***
Rhythmicstep: folds 
StudentRB: folds 
Chernovsky: folds 
christyirish: folds 
fragonik: folds 
pudge.3096: folds 
kastellani87: folds 
Uncalled bet ($0.25) returned to BB_dont_cry
BB_dont_cry collected $0.50 from pot
*** SUMMARY ***
Total pot $0.50 | Rake $0 
Seat 2: pudge.3096 (button) folded before Flop (didn't bet)
Seat 3: kastellani87 (small blind) folded before Flop
Seat 4: BB_dont_cry (big blind) collected ($0.50)
Seat 5: Rhythmicstep folded before Flop (didn't bet)
Seat 6: StudentRB folded before Flop (didn't bet)
Seat 7: Chernovsky folded before Flop (didn't bet)
Seat 8: christyirish folded before Flop (didn't bet)
Seat 9: fragonik folded before Flop (didn't bet)



PokerStars Hand #228694413378:  Hold'em No Limit ($0.25/$0.50 USD) - 2021/07/30 20:38:48 ET
Table 'Gorgo III' 9-max Seat #3 is the button
Seat 2: pudge.3096 ($59.56 in chips) 
Seat 3: kastellani87 ($87.29 in chips) 
Seat 4: BB_dont_cry ($100.41 in chips) 
Seat 5: Rhythmicstep ($50 in chips) 
Seat 6: StudentRB ($94.08 in chips) 
Seat 7: Chernovsky ($55.25 in chips) 
Seat 8: christyirish ($61.69 in chips) 
Seat 9: fragonik ($77.33 in chips) 
BB_dont_cry: posts small blind $0.25
Rhythmicstep: posts big blind $0.50
*** HOLE CARDS ***
StudentRB: folds 
Chernovsky: folds 
christyirish: folds 
fragonik: folds 
pudge.3096: folds 
kastellani87: calls $0.50
BB_dont_cry: calls $0.25
Rhythmicstep: checks 
*** FLOP *** [As Jh 6h]
BB_dont_cry: checks 
Rhythmicstep: checks 
kastellani87: bets $1.42
BB_dont_cry: calls $1.42
Rhythmicstep: calls $1.42
*** TURN *** [As Jh 6h] [7h]
BB_dont_cry: bets $2.74
Rhythmicstep: folds 
kastellani87: calls $2.74
*** RIVER *** [As Jh 6h 7h] [6s]
BB_dont_cry: checks 
kastellani87: checks 
*** SHOW DOWN ***
BB_dont_cry: shows [Jc 6c] (a full house, Sixes full of Jacks)
kastellani87: mucks hand 
BB_dont_cry collected $10.68 from pot
*** SUMMARY ***
Total pot $11.24 | Rake $0.56 
Board [As Jh 6h 7h 6s]
Seat 2: pudge.3096 folded before Flop (didn't bet)
Seat 3: kastellani87 (button) mucked
Seat 4: BB_dont_cry (small blind) showed [Jc 6c] and won ($10.68) with a full house, Sixes full of Jacks
Seat 5: Rhythmicstep (big blind) folded on the Turn
Seat 6: StudentRB folded before Flop (didn't bet)
Seat 7: Chernovsky folded before Flop (didn't bet)
Seat 8: christyirish folded before Flop (didn't bet)
Seat 9: fragonik folded before Flop (didn't bet)



PokerStars Hand #228694432752:  Hold'em No Limit ($0.25/$0.50 USD) - 2021/07/30 20:39:58 ET
Table 'Gorgo III' 9-max Seat #4 is the button
Seat 2: pudge.3096 ($59.56 in chips) 
Seat 3: kastellani87 ($82.63 in chips) 
Seat 4: BB_dont_cry ($106.43 in chips) 
Seat 5: Rhythmicstep ($50 in chips) 
Seat 6: StudentRB ($94.08 in chips) 
Seat 7: Chernovsky ($55.25 in chips) 
Seat 8: christyirish ($61.69 in chips) 
Seat 9: fragonik ($77.33 in chips) 
Rhythmicstep: posts small blind $0.25
StudentRB: posts big blind $0.50
*** HOLE CARDS ***
Chernovsky: raises $1 to $1.50
christyirish: folds 
fragonik: folds 
pudge.3096: folds 
kastellani87: folds 
BB_dont_cry: folds 
Rhythmicstep: folds 
StudentRB: folds 
Uncalled bet ($1) returned to Chernovsky
Chernovsky collected $1.25 from pot
Chernovsky: doesn't show hand 
*** SUMMARY ***
Total pot $1.25 | Rake $0 
Seat 2: pudge.3096 folded before Flop (didn't bet)
Seat 3: kastellani87 folded before Flop (didn't bet)
Seat 4: BB_dont_cry (button) folded before Flop (didn't bet)
Seat 5: Rhythmicstep (small blind) folded before Flop
Seat 6: StudentRB (big blind) folded before Flop
Seat 7: Chernovsky collected ($1.25)
Seat 8: christyirish folded before Flop (didn't bet)
Seat 9: fragonik folded before Flop (didn't bet)



PokerStars Hand #228694439615:  Hold'em No Limit ($0.25/$0.50 USD) - 2021/07/30 20:40:23 ET
Table 'Gorgo III' 9-max Seat #5 is the button
Seat 2: pudge.3096 ($59.56 in chips) 
Seat 3: kastellani87 ($82.63 in chips) 
Seat 4: BB_dont_cry ($106.43 in chips) 
Seat 5: Rhythmicstep ($50 in chips) 
Seat 6: StudentRB ($93.58 in chips) 
Seat 7: Chernovsky ($56 in chips) 
Seat 8: christyirish ($61.69 in chips) 
Seat 9: fragonik ($77.33 in chips) 
StudentRB: posts small blind $0.25
Chernovsky: posts big blind $0.50
*** HOLE CARDS ***
christyirish: folds 
fragonik: folds 
pudge.3096: folds 
kastellani87: calls $0.50
BB_dont_cry: folds 
Rhythmicstep: folds 
StudentRB: raises $2 to $2.50
Chernovsky: raises $4.50 to $7
kastellani87: folds 
StudentRB: folds 
Uncalled bet ($4.50) returned to Chernovsky
Chernovsky collected $5.50 from pot
Chernovsky: doesn't show hand 
*** SUMMARY ***
Total pot $5.50 | Rake $0 
Seat 2: pudge.3096 folded before Flop (didn't bet)
Seat 3: kastellani87 folded before Flop
Seat 4: BB_dont_cry folded before Flop (didn't bet)
Seat 5: Rhythmicstep (button) folded before Flop (didn't bet)
Seat 6: StudentRB (small blind) folded before Flop
Seat 7: Chernovsky (big blind) collected ($5.50)
Seat 8: christyirish folded before Flop (didn't bet)
Seat 9: fragonik folded before Flop (didn't bet)



PokerStars Hand #228694447318:  Hold'em No Limit ($0.25/$0.50 USD) - 2021/07/30 20:40:51 ET
Table 'Gorgo III' 9-max Seat #6 is the button
Seat 2: pudge.3096 ($59.56 in chips) 
Seat 3: kastellani87 ($82.13 in chips) 
Seat 4: BB_dont_cry ($106.43 in chips) 
Seat 5: Rhythmicstep ($50 in chips) 
Seat 6: StudentRB ($91.08 in chips) 
Seat 7: Chernovsky ($59 in chips) 
Seat 8: christyirish ($61.69 in chips) 
Seat 9: fragonik ($77.33 in chips) 
Chernovsky: posts small blind $0.25
christyirish: posts big blind $0.50
*** HOLE CARDS ***
fragonik: folds 
pudge.3096: folds 
kastellani87: calls $0.50
BB_dont_cry: raises $1.75 to $2.25
Rhythmicstep: folds 
StudentRB: folds 
Chernovsky: folds 
christyirish: folds 
kastellani87: calls $1.75
*** FLOP *** [8h 2c Td]
kastellani87: bets $4.99
BB_dont_cry: folds 
Uncalled bet ($4.99) returned to kastellani87
kastellani87 collected $4.99 from pot
kastellani87: doesn't show hand 
*** SUMMARY ***
Total pot $5.25 | Rake $0.26 
Board [8h 2c Td]
Seat 2: pudge.3096 folded before Flop (didn't bet)
Seat 3: kastellani87 collected ($4.99)
Seat 4: BB_dont_cry folded on the Flop
Seat 5: Rhythmicstep folded before Flop (didn't bet)
Seat 6: StudentRB (button) folded before Flop (didn't bet)
Seat 7: Chernovsky (small blind) folded before Flop
Seat 8: christyirish (big blind) folded before Flop
Seat 9: fragonik folded before Flop (didn't bet)



PokerStars Hand #228694459081:  Hold'em No Limit ($0.25/$0.50 USD) - 2021/07/30 20:41:34 ET
Table 'Gorgo III' 9-max Seat #7 is the button
Seat 2: pudge.3096 ($59.56 in chips) 
Seat 3: kastellani87 ($84.87 in chips) 
Seat 4: BB_dont_cry ($104.18 in chips) 
Seat 5: Rhythmicstep ($50 in chips) 
Seat 6: StudentRB ($91.08 in chips) 
Seat 7: Chernovsky ($58.75 in chips) 
Seat 8: christyirish ($61.19 in chips) 
Seat 9: fragonik ($77.33 in chips) 
christyirish: posts small blind $0.25
fragonik: posts big blind $0.50
*** HOLE CARDS ***
pudge.3096: folds 
kastellani87: folds 
BB_dont_cry: folds 
Rhythmicstep: folds 
StudentRB: raises $0.75 to $1.25
Chernovsky: folds 
christyirish: raises $3 to $4.25
fragonik: folds 
StudentRB: raises $6.75 to $11
christyirish: calls $6.75
*** FLOP *** [Ad 8s Qh]
christyirish: checks 
StudentRB: bets $5.50
christyirish: calls $5.50
*** TURN *** [Ad 8s Qh] [4c]
christyirish: checks 
StudentRB: bets $9.55
christyirish: raises $35.14 to $44.69 and is all-in
StudentRB: calls $35.14
*** RIVER *** [Ad 8s Qh 4c] [Js]
*** SHOW DOWN ***
christyirish: shows [As Qd] (two pair, Aces and Queens)
StudentRB: shows [Ac 8c] (two pair, Aces and Eights)
christyirish collected $120.88 from pot
*** SUMMARY ***
Total pot $122.88 | Rake $2 
Board [Ad 8s Qh 4c Js]
Seat 2: pudge.3096 folded before Flop (didn't bet)
Seat 3: kastellani87 folded before Flop (didn't bet)
Seat 4: BB_dont_cry folded before Flop (didn't bet)
Seat 5: Rhythmicstep folded before Flop (didn't bet)
Seat 6: StudentRB showed [Ac 8c] and lost with two pair, Aces and Eights
Seat 7: Chernovsky (button) folded before Flop (didn't bet)
Seat 8: christyirish (small blind) showed [As Qd] and won ($120.88) with two pair, Aces and Queens
Seat 9: fragonik (big blind) folded before Flop



PokerStars Hand #228694492631:  Hold'em No Limit ($0.25/$0.50 USD) - 2021/07/30 20:43:36 ET
Table 'Gorgo III' 9-max Seat #8 is the button
Seat 2: pudge.3096 ($59.56 in chips) 
Seat 3: kastellani87 ($84.87 in chips) 
Seat 4: BB_dont_cry ($104.18 in chips) 
Seat 5: Rhythmicstep ($50 in chips) 
Seat 6: StudentRB ($50 in chips) 
Seat 7: Chernovsky ($58.75 in chips) 
Seat 8: christyirish ($120.88 in chips) 
Seat 9: fragonik ($76.83 in chips) 
fragonik: posts small blind $0.25
pudge.3096: posts big blind $0.50
*** HOLE CARDS ***
kastellani87: folds 
BB_dont_cry: calls $0.50
Rhythmicstep: folds 
StudentRB: folds 
Chernovsky: raises $1.50 to $2
christyirish: folds 
fragonik: folds 
pudge.3096: folds 
BB_dont_cry: calls $1.50
*** FLOP *** [5c 5h Jc]
BB_dont_cry: checks 
Chernovsky: bets $1.53
BB_dont_cry: calls $1.53
*** TURN *** [5c 5h Jc] [Js]
BB_dont_cry: checks 
Chernovsky: checks 
*** RIVER *** [5c 5h Jc Js] [8s]
BB_dont_cry: checks 
Chernovsky: checks 
*** SHOW DOWN ***
BB_dont_cry: shows [4s 4c] (two pair, Jacks and Fives)
Chernovsky: shows [Ac Qc] (two pair, Jacks and Fives - Ace kicker)
Chernovsky collected $7.42 from pot
*** SUMMARY ***
Total pot $7.81 | Rake $0.39 
Board [5c 5h Jc Js 8s]
Seat 2: pudge.3096 (big blind) folded before Flop
Seat 3: kastellani87 folded before Flop (didn't bet)
Seat 4: BB_dont_cry showed [4s 4c] and lost with two pair, Jacks and Fives
Seat 5: Rhythmicstep folded before Flop (didn't bet)
Seat 6: StudentRB folded before Flop (didn't bet)
Seat 7: Chernovsky showed [Ac Qc] and won ($7.42) with two pair, Jacks and Fives
Seat 8: christyirish (button) folded before Flop (didn't bet)
Seat 9: fragonik (small blind) folded before Flop



PokerStars Hand #228694502985:  Hold'em No Limit ($0.25/$0.50 USD) - 2021/07/30 20:44:14 ET
Table 'Gorgo III' 9-max Seat #9 is the button
Seat 2: pudge.3096 ($59.06 in chips) 
Seat 3: kastellani87 ($84.87 in chips) 
Seat 4: BB_dont_cry ($100.65 in chips) 
Seat 5: Rhythmicstep ($50 in chips) 
Seat 6: StudentRB ($50 in chips) 
Seat 7: Chernovsky ($62.64 in chips) 
Seat 8: christyirish ($120.88 in chips) 
Seat 9: fragonik ($76.58 in chips) 
pudge.3096: posts small blind $0.25
kastellani87: posts big blind $0.50
*** HOLE CARDS ***
BB_dont_cry: folds 
Rhythmicstep: folds 
StudentRB: folds 
Chernovsky: folds 
christyirish: folds 
fragonik: folds 
pudge.3096: folds 
Uncalled bet ($0.25) returned to kastellani87
kastellani87 collected $0.50 from pot
kastellani87: doesn't show hand 
*** SUMMARY ***
Total pot $0.50 | Rake $0 
Seat 2: pudge.3096 (small blind) folded before Flop
Seat 3: kastellani87 (big blind) collected ($0.50)
Seat 4: BB_dont_cry folded before Flop (didn't bet)
Seat 5: Rhythmicstep folded before Flop (didn't bet)
Seat 6: StudentRB folded before Flop (didn't bet)
Seat 7: Chernovsky folded before Flop (didn't bet)
Seat 8: christyirish folded before Flop (didn't bet)
Seat 9: fragonik (button) folded before Flop (didn't bet)



PokerStars Hand #228694508093:  Hold'em No Limit ($0.25/$0.50 USD) - 2021/07/30 20:44:33 ET
Table 'Gorgo III' 9-max Seat #2 is the button
Seat 2: pudge.3096 ($58.81 in chips) 
Seat 3: kastellani87 ($85.12 in chips) 
Seat 4: BB_dont_cry ($100.65 in chips) 
Seat 5: Rhythmicstep ($50 in chips) 
Seat 6: StudentRB ($50 in chips) 
Seat 7: Chernovsky ($62.64 in chips) 
Seat 8: christyirish ($120.88 in chips) 
Seat 9: fragonik ($76.58 in chips) 
kastellani87: posts small blind $0.25
BB_dont_cry: posts big blind $0.50
*** HOLE CARDS ***
Rhythmicstep: folds 
StudentRB: folds 
Chernovsky: folds 
christyirish: folds 
fragonik: folds 
pudge.3096: folds 
kastellani87: raises $0.50 to $1
BB_dont_cry: folds 
Uncalled bet ($0.50) returned to kastellani87
kastellani87 collected $1 from pot
kastellani87: doesn't show hand 
*** SUMMARY ***
Total pot $1 | Rake $0 
Seat 2: pudge.3096 (button) folded before Flop (didn't bet)
Seat 3: kastellani87 (small blind) collected ($1)
Seat 4: BB_dont_cry (big blind) folded before Flop
Seat 5: Rhythmicstep folded before Flop (didn't bet)
Seat 6: StudentRB folded before Flop (didn't bet)
Seat 7: Chernovsky folded before Flop (didn't bet)
Seat 8: christyirish folded before Flop (didn't bet)
Seat 9: fragonik folded before Flop (didn't bet)



PokerStars Hand #228694514821:  Hold'em No Limit ($0.25/$0.50 USD) - 2021/07/30 20:44:54 ET
Table 'Gorgo III' 9-max Seat #3 is the button
Seat 2: pudge.3096 ($58.81 in chips) 
Seat 3: kastellani87 ($85.62 in chips) 
Seat 4: BB_dont_cry ($100.15 in chips) 
Seat 5: Rhythmicstep ($50 in chips) 
Seat 6: StudentRB ($50 in chips) 
Seat 7: Chernovsky ($62.64 in chips) 
Seat 8: christyirish ($120.88 in chips) 
Seat 9: fragonik ($76.58 in chips) 
BB_dont_cry: posts small blind $0.25
Rhythmicstep: posts big blind $0.50
*** HOLE CARDS ***
StudentRB: folds 
Chernovsky: folds 
christyirish: folds 
fragonik: folds 
pudge.3096: folds 
kastellani87: calls $0.50
BB_dont_cry: calls $0.25
Rhythmicstep: checks 
*** FLOP *** [2d Ts Td]
BB_dont_cry: checks 
Rhythmicstep: checks 
kastellani87: checks 
*** TURN *** [2d Ts Td] [4d]
BB_dont_cry: checks 
Chernovsky leaves the table
maximusse73 joins the table at seat #7 
Rhythmicstep: checks 
kastellani87: checks 
*** RIVER *** [2d Ts Td 4d] [9d]
BB_dont_cry: checks 
Rhythmicstep: checks 
kastellani87: checks 
*** SHOW DOWN ***
BB_dont_cry: shows [6s 7c] (a pair of Tens)
Rhythmicstep: shows [7s 9s] (two pair, Tens and Nines)
kastellani87: shows [Tc Ah] (three of a kind, Tens)
kastellani87 collected $1.42 from pot
*** SUMMARY ***
Total pot $1.50 | Rake $0.08 
Board [2d Ts Td 4d 9d]
Seat 2: pudge.3096 folded before Flop (didn't bet)
Seat 3: kastellani87 (button) showed [Tc Ah] and won ($1.42) with three of a kind, Tens
Seat 4: BB_dont_cry (small blind) showed [6s 7c] and lost with a pair of Tens
Seat 5: Rhythmicstep (big blind) showed [7s 9s] and lost with two pair, Tens and Nines
Seat 6: StudentRB folded before Flop (didn't bet)
Seat 7: Chernovsky folded before Flop (didn't bet)
Seat 8: christyirish folded before Flop (didn't bet)
Seat 9: fragonik folded before Flop (didn't bet)



PokerStars Hand #228694546444:  Hold'em No Limit ($0.25/$0.50 USD) - 2021/07/30 20:46:06 ET
Table 'Gorgo III' 9-max Seat #4 is the button
Seat 2: pudge.3096 ($58.81 in chips) 
Seat 3: kastellani87 ($86.54 in chips) 
Seat 4: BB_dont_cry ($99.65 in chips) 
Seat 5: Rhythmicstep ($50 in chips) 
Seat 7: maximusse73 ($40 in chips) 
Seat 8: christyirish ($120.88 in chips) 
Seat 9: fragonik ($76.58 in chips) 
Rhythmicstep: posts small blind $0.25
StudentRB: is sitting out 
maximusse73: posts big blind $0.50
*** HOLE CARDS ***
StudentRB leaves the table
christyirish: raises $1 to $1.50
fragonik: folds 
pudge.3096: folds 
Mc57Arnold joins the table at seat #6 
kastellani87: calls $1.50
BB_dont_cry: calls $1.50
Rhythmicstep: folds 
maximusse73: folds 
*** FLOP *** [Qc 3s Kd]
christyirish: checks 
kastellani87: checks 
BB_dont_cry: checks 
*** TURN *** [Qc 3s Kd] [Ts]
christyirish: checks 
kastellani87: bets $2.50
BB_dont_cry: folds 
Squall33bdi leaves the table
christyirish: calls $2.50
*** RIVER *** [Qc 3s Kd Ts] [Qs]
christyirish: bets $7.31
kastellani87: calls $7.31
*** SHOW DOWN ***
christyirish: shows [6s As] (a flush, Ace high)
kastellani87: mucks hand 
christyirish collected $23.63 from pot
*** SUMMARY ***
Total pot $24.87 | Rake $1.24 
Board [Qc 3s Kd Ts Qs]
Seat 2: pudge.3096 folded before Flop (didn't bet)
Seat 3: kastellani87 mucked
Seat 4: BB_dont_cry (button) folded on the Turn
Seat 5: Rhythmicstep (small blind) folded before Flop
Seat 7: maximusse73 (big blind) folded before Flop
Seat 8: christyirish showed [6s As] and won ($23.63) with a flush, Ace high
Seat 9: fragonik folded before Flop (didn't bet)



PokerStars Hand #228694571734:  Hold'em No Limit ($0.25/$0.50 USD) - 2021/07/30 20:47:07 ET
Table 'Gorgo III' 9-max Seat #5 is the button
Seat 2: pudge.3096 ($58.81 in chips) 
Seat 3: kastellani87 ($75.23 in chips) 
Seat 4: BB_dont_cry ($98.15 in chips) 
Seat 5: Rhythmicstep ($50 in chips) 
Seat 7: maximusse73 ($39.50 in chips) 
Seat 8: christyirish ($133.20 in chips) 
Seat 9: fragonik ($76.58 in chips) 
maximusse73: posts small blind $0.25
christyirish: posts big blind $0.50
*** HOLE CARDS ***
fragonik: folds 
pudge.3096: raises $0.75 to $1.25
kastellani87: folds 
BB_dont_cry: folds 
Rhythmicstep: folds 
maximusse73: calls $1
christyirish: folds 
*** FLOP *** [8d 3s 7h]
maximusse73: bets $1.42
pudge.3096: calls $1.42
*** TURN *** [8d 3s 7h] [2s]
maximusse73: checks 
pudge.3096: checks 
*** RIVER *** [8d 3s 7h 2s] [Td]
maximusse73: checks 
pudge.3096: bets $4.33
maximusse73: folds 
Uncalled bet ($4.33) returned to pudge.3096
pudge.3096 collected $5.55 from pot
pudge.3096: doesn't show hand 
*** SUMMARY ***
Total pot $5.84 | Rake $0.29 
Board [8d 3s 7h 2s Td]
Seat 2: pudge.3096 collected ($5.55)
Seat 3: kastellani87 folded before Flop (didn't bet)
Seat 4: BB_dont_cry folded before Flop (didn't bet)
Seat 5: Rhythmicstep (button) folded before Flop (didn't bet)
Seat 7: maximusse73 (small blind) folded on the River
Seat 8: christyirish (big blind) folded before Flop
Seat 9: fragonik folded before Flop (didn't bet)



PokerStars Hand #228694592782:  Hold'em No Limit ($0.25/$0.50 USD) - 2021/07/30 20:48:26 ET
Table 'Gorgo III' 9-max Seat #7 is the button
Seat 2: pudge.3096 ($61.69 in chips) 
Seat 3: kastellani87 ($75.23 in chips) 
Seat 4: BB_dont_cry ($98.15 in chips) 
Seat 5: Rhythmicstep ($50 in chips) 
Seat 7: maximusse73 ($36.83 in chips) 
Seat 8: christyirish ($132.70 in chips) 
Seat 9: fragonik ($76.58 in chips) 
christyirish: posts small blind $0.25
fragonik: posts big blind $0.50
Mc57Arnold: sits out 
*** HOLE CARDS ***
pudge.3096: folds 
kastellani87: folds 
BB_dont_cry: raises $1.25 to $1.75
Rhythmicstep: folds 
maximusse73: folds 
christyirish: raises $4 to $5.75
fragonik: folds 
BB_dont_cry: calls $4
*** FLOP *** [Qd Qc 6c]
christyirish: bets $5.70
BB_dont_cry: raises $8.80 to $14.50
christyirish: calls $8.80
*** TURN *** [Qd Qc 6c] [2h]
christyirish: checks 
BB_dont_cry: checks 
*** RIVER *** [Qd Qc 6c 2h] [Tc]
christyirish: checks 
BB_dont_cry: checks 
*** SHOW DOWN ***
christyirish: shows [Qs Ad] (three of a kind, Queens)
BB_dont_cry: mucks hand 
christyirish collected $39 from pot
*** SUMMARY ***
Total pot $41 | Rake $2 
Board [Qd Qc 6c 2h Tc]
Seat 2: pudge.3096 folded before Flop (didn't bet)
Seat 3: kastellani87 folded before Flop (didn't bet)
Seat 4: BB_dont_cry mucked
Seat 5: Rhythmicstep folded before Flop (didn't bet)
Seat 7: maximusse73 (button) folded before Flop (didn't bet)
Seat 8: christyirish (small blind) showed [Qs Ad] and won ($39) with three of a kind, Queens
Seat 9: fragonik (big blind) folded before Flop



PokerStars Hand #228694609053:  Hold'em No Limit ($0.25/$0.50 USD) - 2021/07/30 20:49:27 ET
Table 'Gorgo III' 9-max Seat #8 is the button
Seat 2: pudge.3096 ($61.69 in chips) 
Seat 3: kastellani87 ($75.23 in chips) 
Seat 4: BB_dont_cry ($77.90 in chips) 
Seat 5: Rhythmicstep ($50 in chips) 
Seat 7: maximusse73 ($36.83 in chips) 
Seat 8: christyirish ($151.45 in chips) 
Seat 9: fragonik ($76.08 in chips) 
fragonik: posts small blind $0.25
pudge.3096: posts big blind $0.50
Mc57Arnold: sits out 
*** HOLE CARDS ***
kastellani87: calls $0.50
BB_dont_cry: folds 
Rhythmicstep: folds 
maximusse73: folds 
christyirish: folds 
fragonik: folds 
pudge.3096: checks 
*** FLOP *** [3c 9d 4h]
pudge.3096: checks 
kastellani87: checks 
*** TURN *** [3c 9d 4h] [Ad]
MonplDCmax joins the table at seat #1 
pudge.3096: checks 
kastellani87: bets $1.19
pudge.3096: folds 
Uncalled bet ($1.19) returned to kastellani87
kastellani87 collected $1.19 from pot
kastellani87: doesn't show hand 
*** SUMMARY ***
Total pot $1.25 | Rake $0.06 
Board [3c 9d 4h Ad]
Seat 2: pudge.3096 (big blind) folded on the Turn
Seat 3: kastellani87 collected ($1.19)
Seat 4: BB_dont_cry folded before Flop (didn't bet)
Seat 5: Rhythmicstep folded before Flop (didn't bet)
Seat 7: maximusse73 folded before Flop (didn't bet)
Seat 8: christyirish (button) folded before Flop (didn't bet)
Seat 9: fragonik (small blind) folded before Flop



PokerStars Hand #228694619003:  Hold'em No Limit ($0.25/$0.50 USD) - 2021/07/30 20:50:05 ET
Table 'Gorgo III' 9-max Seat #9 is the button
Seat 2: pudge.3096 ($61.19 in chips) 
Seat 3: kastellani87 ($75.92 in chips) 
Seat 4: BB_dont_cry ($77.90 in chips) 
Seat 5: Rhythmicstep ($50 in chips) 
Seat 7: maximusse73 ($36.83 in chips) 
Seat 8: christyirish ($151.45 in chips) 
Seat 9: fragonik ($75.83 in chips) 
pudge.3096: posts small blind $0.25
kastellani87: posts big blind $0.50
Mc57Arnold: sits out 
*** HOLE CARDS ***
BB_dont_cry: folds 
Rhythmicstep: folds 
maximusse73: folds 
christyirish: folds 
fragonik: folds 
pudge.3096: folds 
Uncalled bet ($0.25) returned to kastellani87
kastellani87 collected $0.50 from pot
kastellani87: doesn't show hand 
*** SUMMARY ***
Total pot $0.50 | Rake $0 
Seat 2: pudge.3096 (small blind) folded before Flop
Seat 3: kastellani87 (big blind) collected ($0.50)
Seat 4: BB_dont_cry folded before Flop (didn't bet)
Seat 5: Rhythmicstep folded before Flop (didn't bet)
Seat 7: maximusse73 folded before Flop (didn't bet)
Seat 8: christyirish folded before Flop (didn't bet)
Seat 9: fragonik (button) folded before Flop (didn't bet)



PokerStars Hand #228694625121:  Hold'em No Limit ($0.25/$0.50 USD) - 2021/07/30 20:50:28 ET
Table 'Gorgo III' 9-max Seat #2 is the button
Seat 2: pudge.3096 ($60.94 in chips) 
Seat 3: kastellani87 ($76.17 in chips) 
Seat 4: BB_dont_cry ($77.90 in chips) 
Seat 5: Rhythmicstep ($50 in chips) 
Seat 7: maximusse73 ($36.83 in chips) 
Seat 8: christyirish ($151.45 in chips) 
Seat 9: fragonik ($75.83 in chips) 
kastellani87: posts small blind $0.25
BB_dont_cry: posts big blind $0.50
Mc57Arnold: sits out 
MonplDCmax: sits out 
*** HOLE CARDS ***
Rhythmicstep: folds 
maximusse73: calls $0.50
christyirish: raises $1.75 to $2.25
fragonik: folds 
pudge.3096: folds 
kastellani87: folds 
BB_dont_cry: folds 
maximusse73: calls $1.75
*** FLOP *** [5d 7d Qh]
maximusse73: checks 
christyirish: bets $3.50
maximusse73: raises $3.50 to $7
christyirish: calls $3.50
*** TURN *** [5d 7d Qh] [2d]
maximusse73: bets $9.14
christyirish: calls $9.14
*** RIVER *** [5d 7d Qh 2d] [Ts]
maximusse73: bets $18.44 and is all-in
christyirish: calls $18.44
*** SHOW DOWN ***
maximusse73: shows [5h 7h] (two pair, Sevens and Fives)
christyirish: shows [Ks Kh] (a pair of Kings)
maximusse73 collected $72.41 from pot
*** SUMMARY ***
Total pot $74.41 | Rake $2 
Board [5d 7d Qh 2d Ts]
Seat 2: pudge.3096 (button) folded before Flop (didn't bet)
Seat 3: kastellani87 (small blind) folded before Flop
Seat 4: BB_dont_cry (big blind) folded before Flop
Seat 5: Rhythmicstep folded before Flop (didn't bet)
Seat 7: maximusse73 showed [5h 7h] and won ($72.41) with two pair, Sevens and Fives
Seat 8: christyirish showed [Ks Kh] and lost with a pair of Kings
Seat 9: fragonik folded before Flop (didn't bet)



PokerStars Hand #228694652111:  Hold'em No Limit ($0.25/$0.50 USD) - 2021/07/30 20:52:09 ET
Table 'Gorgo III' 9-max Seat #3 is the button
Seat 2: pudge.3096 ($60.94 in chips) 
Seat 3: kastellani87 ($75.92 in chips) 
Seat 4: BB_dont_cry ($77.40 in chips) 
Seat 5: Rhythmicstep ($50 in chips) 
Seat 7: maximusse73 ($72.41 in chips) 
Seat 8: christyirish ($114.62 in chips) 
Seat 9: fragonik ($75.83 in chips) 
BB_dont_cry: posts small blind $0.25
Rhythmicstep: posts big blind $0.50
Mc57Arnold: sits out 
MonplDCmax: sits out 
*** HOLE CARDS ***
maximusse73: folds 
christyirish: folds 
fragonik: folds 
pudge.3096: raises $0.75 to $1.25
kastellani87: folds 
BB_dont_cry: folds 
Rhythmicstep: calls $0.75
*** FLOP *** [Jc 7c Qh]
Rhythmicstep: checks 
pudge.3096: checks 
*** TURN *** [Jc 7c Qh] [5s]
Rhythmicstep: bets $1.75
pudge.3096: calls $1.75
*** RIVER *** [Jc 7c Qh 5s] [6h]
Rhythmicstep: checks 
pudge.3096: checks 
*** SHOW DOWN ***
Rhythmicstep: shows [Js Ts] (a pair of Jacks)
pudge.3096: mucks hand 
Rhythmicstep collected $5.94 from pot
*** SUMMARY ***
Total pot $6.25 | Rake $0.31 
Board [Jc 7c Qh 5s 6h]
Seat 2: pudge.3096 mucked
Seat 3: kastellani87 (button) folded before Flop (didn't bet)
Seat 4: BB_dont_cry (small blind) folded before Flop
Seat 5: Rhythmicstep (big blind) showed [Js Ts] and won ($5.94) with a pair of Jacks
Seat 7: maximusse73 folded before Flop (didn't bet)
Seat 8: christyirish folded before Flop (didn't bet)
Seat 9: fragonik folded before Flop (didn't bet)



PokerStars Hand #228694669978:  Hold'em No Limit ($0.25/$0.50 USD) - 2021/07/30 20:53:17 ET
Table 'Gorgo III' 9-max Seat #4 is the button
Seat 2: pudge.3096 ($57.94 in chips) 
Seat 3: kastellani87 ($75.92 in chips) 
Seat 4: BB_dont_cry ($77.15 in chips) 
Seat 5: Rhythmicstep ($52.94 in chips) 
Seat 6: Mc57Arnold ($50 in chips) 
Seat 7: maximusse73 ($72.41 in chips) 
Seat 8: christyirish ($114.62 in chips) 
Seat 9: fragonik ($75.83 in chips) 
Rhythmicstep: posts small blind $0.25
Mc57Arnold: posts big blind $0.50
MonplDCmax: sits out 
*** HOLE CARDS ***
maximusse73: folds 
christyirish: folds 
fragonik: folds 
pudge.3096: folds 
kastellani87: folds 
BB_dont_cry: folds 
Rhythmicstep: raises $1 to $1.50
Mc57Arnold: folds 
Uncalled bet ($1) returned to Rhythmicstep
Rhythmicstep collected $1 from pot
Rhythmicstep: doesn't show hand 
*** SUMMARY ***
Total pot $1 | Rake $0 
Seat 2: pudge.3096 folded before Flop (didn't bet)
Seat 3: kastellani87 folded before Flop (didn't bet)
Seat 4: BB_dont_cry (button) folded before Flop (didn't bet)
Seat 5: Rhythmicstep (small blind) collected ($1)
Seat 6: Mc57Arnold (big blind) folded before Flop
Seat 7: maximusse73 folded before Flop (didn't bet)
Seat 8: christyirish folded before Flop (didn't bet)
Seat 9: fragonik folded before Flop (didn't bet)



PokerStars Hand #228694684563:  Hold'em No Limit ($0.25/$0.50 USD) - 2021/07/30 20:53:39 ET
Table 'Gorgo III' 9-max Seat #5 is the button
Seat 2: pudge.3096 ($57.94 in chips) 
Seat 3: kastellani87 ($75.92 in chips) 
Seat 4: BB_dont_cry ($77.15 in chips) 
Seat 5: Rhythmicstep ($53.44 in chips) 
Seat 6: Mc57Arnold ($50 in chips) 
Seat 7: maximusse73 ($72.41 in chips) 
Seat 8: christyirish ($114.62 in chips) 
Seat 9: fragonik ($75.83 in chips) 
Mc57Arnold: posts small blind $0.25
maximusse73: posts big blind $0.50
MonplDCmax: sits out 
*** HOLE CARDS ***
christyirish: folds 
fragonik: folds 
pudge.3096: folds 
kastellani87: folds 
BB_dont_cry: folds 
Rhythmicstep: folds 
Mc57Arnold: folds 
Uncalled bet ($0.25) returned to maximusse73
maximusse73 collected $0.50 from pot
maximusse73: doesn't show hand 
*** SUMMARY ***
Total pot $0.50 | Rake $0 
Seat 2: pudge.3096 folded before Flop (didn't bet)
Seat 3: kastellani87 folded before Flop (didn't bet)
Seat 4: BB_dont_cry folded before Flop (didn't bet)
Seat 5: Rhythmicstep (button) folded before Flop (didn't bet)
Seat 6: Mc57Arnold (small blind) folded before Flop
Seat 7: maximusse73 (big blind) collected ($0.50)
Seat 8: christyirish folded before Flop (didn't bet)
Seat 9: fragonik folded before Flop (didn't bet)



PokerStars Hand #228694687045:  Hold'em No Limit ($0.25/$0.50 USD) - 2021/07/30 20:53:48 ET
Table 'Gorgo III' 9-max Seat #6 is the button
Seat 2: pudge.3096 ($57.94 in chips) 
Seat 3: kastellani87 ($75.92 in chips) 
Seat 4: BB_dont_cry ($77.15 in chips) 
Seat 5: Rhythmicstep ($53.44 in chips) 
Seat 6: Mc57Arnold ($50 in chips) 
Seat 7: maximusse73 ($72.66 in chips) 
Seat 8: christyirish ($114.62 in chips) 
Seat 9: fragonik ($75.83 in chips) 
maximusse73: posts small blind $0.25
christyirish: posts big blind $0.50
MonplDCmax: sits out 
*** HOLE CARDS ***
fragonik: folds 
pudge.3096: folds 
kastellani87: folds 
BB_dont_cry: folds 
Rhythmicstep: folds 
Mc57Arnold: raises $0.65 to $1.15
maximusse73: calls $0.90
christyirish: folds 
*** FLOP *** [8s Jc 3s]
maximusse73: bets $1.33
Mc57Arnold: folds 
Uncalled bet ($1.33) returned to maximusse73
maximusse73 collected $2.66 from pot
maximusse73: doesn't show hand 
*** SUMMARY ***
Total pot $2.80 | Rake $0.14 
Board [8s Jc 3s]
Seat 2: pudge.3096 folded before Flop (didn't bet)
Seat 3: kastellani87 folded before Flop (didn't bet)
Seat 4: BB_dont_cry folded before Flop (didn't bet)
Seat 5: Rhythmicstep folded before Flop (didn't bet)
Seat 6: Mc57Arnold (button) folded on the Flop
Seat 7: maximusse73 (small blind) collected ($2.66)
Seat 8: christyirish (big blind) folded before Flop
Seat 9: fragonik folded before Flop (didn't bet)



PokerStars Hand #228694695305:  Hold'em No Limit ($0.25/$0.50 USD) - 2021/07/30 20:54:19 ET
Table 'Gorgo III' 9-max Seat #7 is the button
Seat 2: pudge.3096 ($57.94 in chips) 
Seat 3: kastellani87 ($75.92 in chips) 
Seat 4: BB_dont_cry ($77.15 in chips) 
Seat 5: Rhythmicstep ($53.44 in chips) 
Seat 6: Mc57Arnold ($50 in chips) 
Seat 7: maximusse73 ($74.17 in chips) 
Seat 8: christyirish ($114.12 in chips) 
Seat 9: fragonik ($75.83 in chips) 
christyirish: posts small blind $0.25
fragonik: posts big blind $0.50
MonplDCmax: sits out 
*** HOLE CARDS ***
pudge.3096: folds 
kastellani87: folds 
BB_dont_cry: folds 
Rhythmicstep: folds 
Mc57Arnold: raises $0.85 to $1.35
maximusse73: calls $1.35
christyirish: raises $4.55 to $5.90
fragonik: folds 
Mc57Arnold: folds 
maximusse73: folds 
Uncalled bet ($4.55) returned to christyirish
christyirish collected $4.55 from pot
christyirish: doesn't show hand 
*** SUMMARY ***
Total pot $4.55 | Rake $0 
Seat 2: pudge.3096 folded before Flop (didn't bet)
Seat 3: kastellani87 folded before Flop (didn't bet)
Seat 4: BB_dont_cry folded before Flop (didn't bet)
Seat 5: Rhythmicstep folded before Flop (didn't bet)
Seat 6: Mc57Arnold folded before Flop
Seat 7: maximusse73 (button) folded before Flop
Seat 8: christyirish (small blind) collected ($4.55)
Seat 9: fragonik (big blind) folded before Flop



PokerStars Hand #228694702151:  Hold'em No Limit ($0.25/$0.50 USD) - 2021/07/30 20:54:45 ET
Table 'Gorgo III' 9-max Seat #8 is the button
Seat 1: MonplDCmax ($57.86 in chips) 
Seat 2: pudge.3096 ($57.94 in chips) 
Seat 3: kastellani87 ($75.92 in chips) 
Seat 4: BB_dont_cry ($77.15 in chips) 
Seat 5: Rhythmicstep ($53.44 in chips) 
Seat 6: Mc57Arnold ($50 in chips) 
Seat 7: maximusse73 ($72.82 in chips) 
Seat 8: christyirish ($117.32 in chips) 
Seat 9: fragonik ($75.33 in chips) 
fragonik: posts small blind $0.25
MonplDCmax: posts big blind $0.50
*** HOLE CARDS ***
pudge.3096: raises $0.75 to $1.25
kastellani87 has timed out
kastellani87: folds 
BB_dont_cry: folds 
Rhythmicstep: folds 
Mc57Arnold: folds 
maximusse73: folds 
christyirish: calls $1.25
fragonik: folds 
MonplDCmax: calls $0.75
*** FLOP *** [Tc 8d 8c]
MonplDCmax: checks 
pudge.3096: checks 
christyirish: bets $1.90
MonplDCmax: folds 
pudge.3096: folds 
Uncalled bet ($1.90) returned to christyirish
christyirish collected $3.80 from pot
christyirish: doesn't show hand 
*** SUMMARY ***
Total pot $4 | Rake $0.20 
Board [Tc 8d 8c]
Seat 1: MonplDCmax (big blind) folded on the Flop
Seat 2: pudge.3096 folded on the Flop
Seat 3: kastellani87 folded before Flop (didn't bet)
Seat 4: BB_dont_cry folded before Flop (didn't bet)
Seat 5: Rhythmicstep folded before Flop (didn't bet)
Seat 6: Mc57Arnold folded before Flop (didn't bet)
Seat 7: maximusse73 folded before Flop (didn't bet)
Seat 8: christyirish (button) collected ($3.80)
Seat 9: fragonik (small blind) folded before Flop



PokerStars Hand #228694718369:  Hold'em No Limit ($0.25/$0.50 USD) - 2021/07/30 20:55:55 ET
Table 'Gorgo III' 9-max Seat #9 is the button
Seat 1: MonplDCmax ($56.61 in chips) 
Seat 2: pudge.3096 ($56.69 in chips) 
Seat 3: kastellani87 ($75.92 in chips) 
Seat 4: BB_dont_cry ($77.15 in chips) 
Seat 5: Rhythmicstep ($53.44 in chips) 
Seat 6: Mc57Arnold ($50 in chips) 
Seat 7: maximusse73 ($72.82 in chips) 
Seat 8: christyirish ($119.87 in chips) 
Seat 9: fragonik ($75.08 in chips) 
MonplDCmax: posts small blind $0.25
pudge.3096: posts big blind $0.50
*** HOLE CARDS ***
kastellani87: folds 
BB_dont_cry: folds 
Rhythmicstep: folds 
Mc57Arnold: folds 
maximusse73: folds 
christyirish: folds 
fragonik: raises $0.75 to $1.25
MonplDCmax: folds 
pudge.3096: folds 
Uncalled bet ($0.75) returned to fragonik
fragonik collected $1.25 from pot
*** SUMMARY ***
Total pot $1.25 | Rake $0 
Seat 1: MonplDCmax (small blind) folded before Flop
Seat 2: pudge.3096 (big blind) folded before Flop
Seat 3: kastellani87 folded before Flop (didn't bet)
Seat 4: BB_dont_cry folded before Flop (didn't bet)
Seat 5: Rhythmicstep folded before Flop (didn't bet)
Seat 6: Mc57Arnold folded before Flop (didn't bet)
Seat 7: maximusse73 folded before Flop (didn't bet)
Seat 8: christyirish folded before Flop (didn't bet)
Seat 9: fragonik (button) collected ($1.25)



PokerStars Hand #228694721985:  Hold'em No Limit ($0.25/$0.50 USD) - 2021/07/30 20:56:12 ET
Table 'Gorgo III' 9-max Seat #1 is the button
Seat 1: MonplDCmax ($56.36 in chips) 
Seat 2: pudge.3096 ($56.19 in chips) 
Seat 3: kastellani87 ($75.92 in chips) 
Seat 4: BB_dont_cry ($77.15 in chips) 
Seat 5: Rhythmicstep ($53.44 in chips) 
Seat 6: Mc57Arnold ($50 in chips) 
Seat 7: maximusse73 ($72.82 in chips) 
Seat 8: christyirish ($119.87 in chips) 
Seat 9: fragonik ($75.83 in chips) 
pudge.3096: posts small blind $0.25
kastellani87: posts big blind $0.50
*** HOLE CARDS ***
BB_dont_cry: raises $1.50 to $2
Rhythmicstep: folds 
Mc57Arnold: raises $4 to $6
maximusse73: folds 
christyirish: folds 
fragonik: folds 
MonplDCmax: folds 
pudge.3096: folds 
kastellani87: folds 
BB_dont_cry: calls $4
*** FLOP *** [8s Jc 4s]
BB_dont_cry: checks 
Mc57Arnold: bets $44 and is all-in
BB_dont_cry: folds 
Uncalled bet ($44) returned to Mc57Arnold
Mc57Arnold collected $12.11 from pot
Mc57Arnold: doesn't show hand 
*** SUMMARY ***
Total pot $12.75 | Rake $0.64 
Board [8s Jc 4s]
Seat 1: MonplDCmax (button) folded before Flop (didn't bet)
Seat 2: pudge.3096 (small blind) folded before Flop
Seat 3: kastellani87 (big blind) folded before Flop
Seat 4: BB_dont_cry folded on the Flop
Seat 5: Rhythmicstep folded before Flop (didn't bet)
Seat 6: Mc57Arnold collected ($12.11)
Seat 7: maximusse73 folded before Flop (didn't bet)
Seat 8: christyirish folded before Flop (didn't bet)
Seat 9: fragonik folded before Flop (didn't bet)



PokerStars Hand #228694729228:  Hold'em No Limit ($0.25/$0.50 USD) - 2021/07/30 20:56:46 ET
Table 'Gorgo III' 9-max Seat #3 is the button
Seat 1: MonplDCmax ($56.36 in chips) 
Seat 3: kastellani87 ($75.42 in chips) 
Seat 4: BB_dont_cry ($71.15 in chips) 
Seat 5: Rhythmicstep ($53.44 in chips) 
Seat 6: Mc57Arnold ($56.11 in chips) 
Seat 7: maximusse73 ($72.82 in chips) 
Seat 8: christyirish ($119.87 in chips) 
Seat 9: fragonik ($75.83 in chips) 
BB_dont_cry: posts small blind $0.25
Rhythmicstep: posts big blind $0.50
*** HOLE CARDS ***
Mc57Arnold: raises $0.85 to $1.35
maximusse73: folds 
christyirish: folds 
fragonik: folds 
MonplDCmax: folds 
kastellani87: calls $1.35
BB_dont_cry: folds 
Rhythmicstep: folds 
*** FLOP *** [Jd 6c 9h]
Mc57Arnold: bets $1.64
kastellani87: raises $6.56 to $8.20
Mc57Arnold: raises $46.56 to $54.76 and is all-in
kastellani87: calls $46.56
*** TURN *** [Jd 6c 9h] [Kd]
*** RIVER *** [Jd 6c 9h Kd] [4h]
*** SHOW DOWN ***
Mc57Arnold: shows [Qh Qd] (a pair of Queens)
kastellani87: shows [9d Jh] (two pair, Jacks and Nines)
kastellani87 collected $110.97 from pot
*** SUMMARY ***
Total pot $112.97 | Rake $2 
Board [Jd 6c 9h Kd 4h]
Seat 1: MonplDCmax folded before Flop (didn't bet)
Seat 3: kastellani87 (button) showed [9d Jh] and won ($110.97) with two pair, Jacks and Nines
Seat 4: BB_dont_cry (small blind) folded before Flop
Seat 5: Rhythmicstep (big blind) folded before Flop
Seat 6: Mc57Arnold showed [Qh Qd] and lost with a pair of Queens
Seat 7: maximusse73 folded before Flop (didn't bet)
Seat 8: christyirish folded before Flop (didn't bet)
Seat 9: fragonik folded before Flop (didn't bet)



PokerStars Hand #228694741627:  Hold'em No Limit ($0.25/$0.50 USD) - 2021/07/30 20:57:43 ET
Table 'Gorgo III' 9-max Seat #4 is the button
Seat 1: MonplDCmax ($56.36 in chips) 
Seat 3: kastellani87 ($130.28 in chips) 
Seat 4: BB_dont_cry ($70.90 in chips) 
Seat 5: Rhythmicstep ($52.94 in chips) 
Seat 6: Mc57Arnold ($50 in chips) 
Seat 7: maximusse73 ($72.82 in chips) 
Seat 8: christyirish ($119.87 in chips) 
Seat 9: fragonik ($75.83 in chips) 
Rhythmicstep: posts small blind $0.25
Mc57Arnold: posts big blind $0.50
*** HOLE CARDS ***
maximusse73: folds 
christyirish: folds 
fragonik: folds 
MonplDCmax: raises $0.79 to $1.29
kastellani87: folds 
BB_dont_cry: folds 
Rhythmicstep: folds 
Mc57Arnold: folds 
Uncalled bet ($0.79) returned to MonplDCmax
MonplDCmax collected $1.25 from pot
MonplDCmax: doesn't show hand 
*** SUMMARY ***
Total pot $1.25 | Rake $0 
Seat 1: MonplDCmax collected ($1.25)
Seat 3: kastellani87 folded before Flop (didn't bet)
Seat 4: BB_dont_cry (button) folded before Flop (didn't bet)
Seat 5: Rhythmicstep (small blind) folded before Flop
Seat 6: Mc57Arnold (big blind) folded before Flop
Seat 7: maximusse73 folded before Flop (didn't bet)
Seat 8: christyirish folded before Flop (didn't bet)
Seat 9: fragonik folded before Flop (didn't bet)



PokerStars Hand #228694748987:  Hold'em No Limit ($0.25/$0.50 USD) - 2021/07/30 20:58:17 ET
Table 'Gorgo III' 9-max Seat #5 is the button
Seat 1: MonplDCmax ($57.11 in chips) 
Seat 3: kastellani87 ($130.28 in chips) 
Seat 4: BB_dont_cry ($70.90 in chips) 
Seat 5: Rhythmicstep ($52.69 in chips) 
Seat 6: Mc57Arnold ($50 in chips) 
Seat 7: maximusse73 ($72.82 in chips) 
Seat 8: christyirish ($119.87 in chips) 
Seat 9: fragonik ($75.83 in chips) 
Mc57Arnold: posts small blind $0.25
maximusse73: posts big blind $0.50
*** HOLE CARDS ***
christyirish: folds 
fragonik: folds 
MonplDCmax: folds 
kastellani87: folds 
BB_dont_cry: raises $1 to $1.50
Rhythmicstep: folds 
Mc57Arnold: folds 
maximusse73: calls $1
*** FLOP *** [5s 6c 8s]
maximusse73: checks 
BB_dont_cry: checks 
*** TURN *** [5s 6c 8s] [2c]
maximusse73: checks 
BB_dont_cry: checks 
*** RIVER *** [5s 6c 8s 2c] [2s]
maximusse73: bets $3.09
BB_dont_cry: folds 
Uncalled bet ($3.09) returned to maximusse73
maximusse73 collected $3.09 from pot
maximusse73: doesn't show hand 
*** SUMMARY ***
Total pot $3.25 | Rake $0.16 
Board [5s 6c 8s 2c 2s]
Seat 1: MonplDCmax folded before Flop (didn't bet)
Seat 3: kastellani87 folded before Flop (didn't bet)
Seat 4: BB_dont_cry folded on the River
Seat 5: Rhythmicstep (button) folded before Flop (didn't bet)
Seat 6: Mc57Arnold (small blind) folded before Flop
Seat 7: maximusse73 (big blind) collected ($3.09)
Seat 8: christyirish folded before Flop (didn't bet)
Seat 9: fragonik folded before Flop (didn't bet)



PokerStars Hand #228694760427:  Hold'em No Limit ($0.25/$0.50 USD) - 2021/07/30 20:59:09 ET
Table 'Gorgo III' 9-max Seat #6 is the button
Seat 1: MonplDCmax ($57.11 in chips) 
Seat 3: kastellani87 ($130.28 in chips) 
Seat 4: BB_dont_cry ($69.40 in chips) 
Seat 5: Rhythmicstep ($52.69 in chips) 
Seat 6: Mc57Arnold ($50 in chips) 
Seat 7: maximusse73 ($74.41 in chips) 
Seat 8: christyirish ($119.87 in chips) 
Seat 9: fragonik ($75.83 in chips) 
maximusse73: posts small blind $0.25
christyirish: posts big blind $0.50
*** HOLE CARDS ***
fragonik: raises $1 to $1.50
MonplDCmax: folds 
kastellani87: folds 
BB_dont_cry: folds 
Rhythmicstep: folds 
Mc57Arnold: raises $3 to $4.50
maximusse73: folds 
christyirish: folds 
fragonik: folds 
Uncalled bet ($3) returned to Mc57Arnold
Mc57Arnold collected $3.75 from pot
Mc57Arnold: doesn't show hand 
*** SUMMARY ***
Total pot $3.75 | Rake $0 
Seat 1: MonplDCmax folded before Flop (didn't bet)
Seat 3: kastellani87 folded before Flop (didn't bet)
Seat 4: BB_dont_cry folded before Flop (didn't bet)
Seat 5: Rhythmicstep folded before Flop (didn't bet)
Seat 6: Mc57Arnold (button) collected ($3.75)
Seat 7: maximusse73 (small blind) folded before Flop
Seat 8: christyirish (big blind) folded before Flop
Seat 9: fragonik folded before Flop



PokerStars Hand #228694767512:  Hold'em No Limit ($0.25/$0.50 USD) - 2021/07/30 20:59:42 ET
Table 'Gorgo III' 9-max Seat #7 is the button
Seat 1: MonplDCmax ($57.11 in chips) 
Seat 3: kastellani87 ($130.28 in chips) 
Seat 4: BB_dont_cry ($69.40 in chips) 
Seat 5: Rhythmicstep ($52.69 in chips) 
Seat 6: Mc57Arnold ($52.25 in chips) 
Seat 7: maximusse73 ($74.16 in chips) 
Seat 8: christyirish ($119.37 in chips) 
christyirish: posts small blind $0.25
fragonik: is sitting out 
MonplDCmax: posts big blind $0.50
*** HOLE CARDS ***
kastellani87: calls $0.50
BB_dont_cry: calls $0.50
fragonik leaves the table
Rhythmicstep: raises $2 to $2.50
Mc57Arnold: calls $2.50
maximusse73: folds 
christyirish: folds 
MonplDCmax: folds 
kastellani87: calls $2
BB_dont_cry: calls $2
*** FLOP *** [3d Qd 2h]
kastellani87: checks 
BB_dont_cry: checks 
Rhythmicstep: checks 
84d83473r joins the table at seat #9 
Mc57Arnold: checks 
*** TURN *** [3d Qd 2h] [8h]
kastellani87: checks 
BB_dont_cry: checks 
Rhythmicstep: checks 
Mc57Arnold: bets $5.11
kastellani87: folds 
BB_dont_cry: folds 
Rhythmicstep: folds 
Uncalled bet ($5.11) returned to Mc57Arnold
Mc57Arnold collected $10.21 from pot
Mc57Arnold: doesn't show hand 
*** SUMMARY ***
Total pot $10.75 | Rake $0.54 
Board [3d Qd 2h 8h]
Seat 1: MonplDCmax (big blind) folded before Flop
Seat 3: kastellani87 folded on the Turn
Seat 4: BB_dont_cry folded on the Turn
Seat 5: Rhythmicstep folded on the Turn
Seat 6: Mc57Arnold collected ($10.21)
Seat 7: maximusse73 (button) folded before Flop (didn't bet)
Seat 8: christyirish (small blind) folded before Flop



PokerStars Hand #228694787262:  Hold'em No Limit ($0.25/$0.50 USD) - 2021/07/30 21:01:06 ET
Table 'Gorgo III' 9-max Seat #8 is the button
Seat 1: MonplDCmax ($56.61 in chips) 
Seat 3: kastellani87 ($127.78 in chips) 
Seat 4: BB_dont_cry ($66.90 in chips) 
Seat 5: Rhythmicstep ($50.19 in chips) 
Seat 6: Mc57Arnold ($59.96 in chips) 
Seat 7: maximusse73 ($74.16 in chips) 
Seat 8: christyirish ($119.12 in chips) 
MonplDCmax: posts small blind $0.25
kastellani87: posts big blind $0.50
*** HOLE CARDS ***
BB_dont_cry: folds 
Rhythmicstep: folds 
Mc57Arnold: folds 
maximusse73 has timed out
maximusse73: folds 
christyirish: folds 
MonplDCmax: folds 
Uncalled bet ($0.25) returned to kastellani87
kastellani87 collected $0.50 from pot
kastellani87: doesn't show hand 
*** SUMMARY ***
Total pot $0.50 | Rake $0 
Seat 1: MonplDCmax (small blind) folded before Flop
Seat 3: kastellani87 (big blind) collected ($0.50)
Seat 4: BB_dont_cry folded before Flop (didn't bet)
Seat 5: Rhythmicstep folded before Flop (didn't bet)
Seat 6: Mc57Arnold folded before Flop (didn't bet)
Seat 7: maximusse73 folded before Flop (didn't bet)
Seat 8: christyirish (button) folded before Flop (didn't bet)



PokerStars Hand #228694794253:  Hold'em No Limit ($0.25/$0.50 USD) - 2021/07/30 21:01:33 ET
Table 'Gorgo III' 9-max Seat #1 is the button
Seat 1: MonplDCmax ($56.36 in chips) 
Seat 3: kastellani87 ($128.03 in chips) 
Seat 4: BB_dont_cry ($66.90 in chips) 
Seat 5: Rhythmicstep ($50.19 in chips) 
Seat 6: Mc57Arnold ($59.96 in chips) 
Seat 7: maximusse73 ($74.16 in chips) 
Seat 8: christyirish ($119.12 in chips) 
kastellani87: posts small blind $0.25
BB_dont_cry: posts big blind $0.50
84d83473r: sits out 
*** HOLE CARDS ***
Rhythmicstep: folds 
Mc57Arnold: folds 
maximusse73: folds 
christyirish: raises $1 to $1.50
MonplDCmax: calls $1.50
kastellani87: folds 
BB_dont_cry: folds 
*** FLOP *** [Ah Js Kc]
christyirish: checks 
MonplDCmax: checks 
*** TURN *** [Ah Js Kc] [Tc]
christyirish: bets $1.78
MonplDCmax: folds 
Uncalled bet ($1.78) returned to christyirish
christyirish collected $3.56 from pot
*** SUMMARY ***
Total pot $3.75 | Rake $0.19 
Board [Ah Js Kc Tc]
Seat 1: MonplDCmax (button) folded on the Turn
Seat 3: kastellani87 (small blind) folded before Flop
Seat 4: BB_dont_cry (big blind) folded before Flop
Seat 5: Rhythmicstep folded before Flop (didn't bet)
Seat 6: Mc57Arnold folded before Flop (didn't bet)
Seat 7: maximusse73 folded before Flop (didn't bet)
Seat 8: christyirish collected ($3.56)



PokerStars Hand #228694806397:  Hold'em No Limit ($0.25/$0.50 USD) - 2021/07/30 21:02:20 ET
Table 'Gorgo III' 9-max Seat #3 is the button
Seat 1: MonplDCmax ($54.86 in chips) 
Seat 3: kastellani87 ($127.78 in chips) 
Seat 4: BB_dont_cry ($66.40 in chips) 
Seat 5: Rhythmicstep ($50.19 in chips) 
Seat 6: Mc57Arnold ($59.96 in chips) 
Seat 7: maximusse73 ($74.16 in chips) 
Seat 8: christyirish ($121.18 in chips) 
BB_dont_cry: posts small blind $0.25
Rhythmicstep: posts big blind $0.50
84d83473r: sits out 
*** HOLE CARDS ***
Mc57Arnold: folds 
maximusse73: folds 
christyirish: folds 
MonplDCmax: raises $0.81 to $1.31
kastellani87: folds 
BB_dont_cry: folds 
Rhythmicstep: raises $3.69 to $5
MonplDCmax: folds 
Uncalled bet ($3.69) returned to Rhythmicstep
Rhythmicstep collected $2.87 from pot
Rhythmicstep: doesn't show hand 
*** SUMMARY ***
Total pot $2.87 | Rake $0 
Seat 1: MonplDCmax folded before Flop
Seat 3: kastellani87 (button) folded before Flop (didn't bet)
Seat 4: BB_dont_cry (small blind) folded before Flop
Seat 5: Rhythmicstep (big blind) collected ($2.87)
Seat 6: Mc57Arnold folded before Flop (didn't bet)
Seat 7: maximusse73 folded before Flop (didn't bet)
Seat 8: christyirish folded before Flop (didn't bet)



PokerStars Hand #228694816293:  Hold'em No Limit ($0.25/$0.50 USD) - 2021/07/30 21:02:58 ET
Table 'Gorgo III' 9-max Seat #4 is the button
Seat 1: MonplDCmax ($53.55 in chips) 
Seat 3: kastellani87 ($127.78 in chips) 
Seat 4: BB_dont_cry ($66.15 in chips) 
Seat 5: Rhythmicstep ($51.75 in chips) 
Seat 6: Mc57Arnold ($59.96 in chips) 
Seat 7: maximusse73 ($74.16 in chips) 
Seat 8: christyirish ($121.18 in chips) 
Rhythmicstep: posts small blind $0.25
Mc57Arnold: posts big blind $0.50
84d83473r: sits out 
*** HOLE CARDS ***
maximusse73: folds 
christyirish: folds 
MonplDCmax: folds 
kastellani87: folds 
BB_dont_cry: folds 
Rhythmicstep: folds 
Uncalled bet ($0.25) returned to Mc57Arnold
Mc57Arnold collected $0.50 from pot
Mc57Arnold: doesn't show hand 
*** SUMMARY ***
Total pot $0.50 | Rake $0 
Seat 1: MonplDCmax folded before Flop (didn't bet)
Seat 3: kastellani87 folded before Flop (didn't bet)
Seat 4: BB_dont_cry (button) folded before Flop (didn't bet)
Seat 5: Rhythmicstep (small blind) folded before Flop
Seat 6: Mc57Arnold (big blind) collected ($0.50)
Seat 7: maximusse73 folded before Flop (didn't bet)
Seat 8: christyirish folded before Flop (didn't bet)



PokerStars Hand #228694821927:  Hold'em No Limit ($0.25/$0.50 USD) - 2021/07/30 21:03:19 ET
Table 'Gorgo III' 9-max Seat #5 is the button
Seat 1: MonplDCmax ($53.55 in chips) 
Seat 3: kastellani87 ($127.78 in chips) 
Seat 4: BB_dont_cry ($66.15 in chips) 
Seat 5: Rhythmicstep ($51.50 in chips) 
Seat 6: Mc57Arnold ($60.21 in chips) 
Seat 7: maximusse73 ($74.16 in chips) 
Seat 8: christyirish ($121.18 in chips) 
Mc57Arnold: posts small blind $0.25
maximusse73: posts big blind $0.50
84d83473r: sits out 
*** HOLE CARDS ***
christyirish: folds 
MonplDCmax: folds 
kastellani87: folds 
BB_dont_cry: raises $1.25 to $1.75
Rhythmicstep has timed out
Rhythmicstep: folds 
Mc57Arnold: folds 
maximusse73: calls $1.25
*** FLOP *** [9d Qs 8h]
maximusse73: checks 
BB_dont_cry: bets $1.50
MonplDCmax was removed from the table for failing to post
MonplDCmax leaves the table
maximusse73: calls $1.50
*** TURN *** [9d Qs 8h] [5c]
maximusse73: checks 
BB_dont_cry: bets $5
maximusse73: calls $5
*** RIVER *** [9d Qs 8h 5c] [3c]
maximusse73: checks 
BB_dont_cry: bets $3
maximusse73: calls $3
*** SHOW DOWN ***
BB_dont_cry: shows [8d 8s] (three of a kind, Eights)
maximusse73: mucks hand 
BB_dont_cry collected $21.61 from pot
*** SUMMARY ***
Total pot $22.75 | Rake $1.14 
Board [9d Qs 8h 5c 3c]
Seat 1: MonplDCmax folded before Flop (didn't bet)
Seat 3: kastellani87 folded before Flop (didn't bet)
Seat 4: BB_dont_cry showed [8d 8s] and won ($21.61) with three of a kind, Eights
Seat 5: Rhythmicstep (button) folded before Flop (didn't bet)
Seat 6: Mc57Arnold (small blind) folded before Flop
Seat 7: maximusse73 (big blind) mucked
Seat 8: christyirish folded before Flop (didn't bet)



PokerStars Hand #228694843034:  Hold'em No Limit ($0.25/$0.50 USD) - 2021/07/30 21:04:40 ET
Table 'Gorgo III' 9-max Seat #6 is the button
Seat 3: kastellani87 ($127.78 in chips) 
Seat 4: BB_dont_cry ($76.51 in chips) 
Seat 5: Rhythmicstep ($51.50 in chips) 
Seat 6: Mc57Arnold ($59.96 in chips) 
Seat 7: maximusse73 ($62.91 in chips) 
Seat 8: christyirish ($121.18 in chips) 
maximusse73: posts small blind $0.25
christyirish: posts big blind $0.50
84d83473r: sits out 
*** HOLE CARDS ***
kastellani87: folds 
BB_dont_cry: folds 
Rhythmicstep: folds 
Apple857 joins the table at seat #1 
Mc57Arnold has timed out
Mc57Arnold: folds 
maximusse73: folds 
Uncalled bet ($0.25) returned to christyirish
christyirish collected $0.50 from pot
*** SUMMARY ***
Total pot $0.50 | Rake $0 
Seat 3: kastellani87 folded before Flop (didn't bet)
Seat 4: BB_dont_cry folded before Flop (didn't bet)
Seat 5: Rhythmicstep folded before Flop (didn't bet)
Seat 6: Mc57Arnold (button) folded before Flop (didn't bet)
Seat 7: maximusse73 (small blind) folded before Flop
Seat 8: christyirish (big blind) collected ($0.50)



PokerStars Hand #228694854011:  Hold'em No Limit ($0.25/$0.50 USD) - 2021/07/30 21:05:22 ET
Table 'Gorgo III' 9-max Seat #7 is the button
Seat 3: kastellani87 ($127.78 in chips) 
Seat 4: BB_dont_cry ($76.51 in chips) 
Seat 5: Rhythmicstep ($51.50 in chips) 
Seat 6: Mc57Arnold ($59.96 in chips) 
Seat 7: maximusse73 ($62.66 in chips) 
Seat 8: christyirish ($121.43 in chips) 
Seat 9: 84d83473r ($25 in chips) 
christyirish: posts small blind $0.25
84d83473r: posts big blind $0.50
Apple857: sits out 
*** HOLE CARDS ***
kastellani87: folds 
BB_dont_cry: folds 
Rhythmicstep has timed out
Rhythmicstep: folds 
Mc57Arnold: folds 
maximusse73: folds 
christyirish: raises $1 to $1.50
84d83473r: calls $1
*** FLOP *** [Kc 5h 6h]
christyirish: checks 
84d83473r: bets $1.43
christyirish: calls $1.43
*** TURN *** [Kc 5h 6h] [7s]
christyirish: checks 
84d83473r: checks 
*** RIVER *** [Kc 5h 6h 7s] [2s]
christyirish: checks 
84d83473r: bets $3
christyirish: calls $3
*** SHOW DOWN ***
84d83473r: shows [6c 2c] (two pair, Sixes and Deuces)
christyirish: mucks hand 
84d83473r collected $11.27 from pot
*** SUMMARY ***
Total pot $11.86 | Rake $0.59 
Board [Kc 5h 6h 7s 2s]
Seat 3: kastellani87 folded before Flop (didn't bet)
Seat 4: BB_dont_cry folded before Flop (didn't bet)
Seat 5: Rhythmicstep folded before Flop (didn't bet)
Seat 6: Mc57Arnold folded before Flop (didn't bet)
Seat 7: maximusse73 (button) folded before Flop (didn't bet)
Seat 8: christyirish (small blind) mucked
Seat 9: 84d83473r (big blind) showed [6c 2c] and won ($11.27) with two pair, Sixes and Deuces



PokerStars Hand #228694872944:  Hold'em No Limit ($0.25/$0.50 USD) - 2021/07/30 21:06:35 ET
Table 'Gorgo III' 9-max Seat #8 is the button
Seat 1: Apple857 ($20 in chips) 
Seat 3: kastellani87 ($127.78 in chips) 
Seat 4: BB_dont_cry ($76.51 in chips) 
Seat 5: Rhythmicstep ($51.50 in chips) 
Seat 6: Mc57Arnold ($59.96 in chips) 
Seat 7: maximusse73 ($62.66 in chips) 
Seat 8: christyirish ($115.50 in chips) 
Seat 9: 84d83473r ($30.34 in chips) 
84d83473r: posts small blind $0.25
Apple857: posts big blind $0.50
*** HOLE CARDS ***
kastellani87: calls $0.50
BB_dont_cry: folds 
Rhythmicstep: folds 
Mc57Arnold: folds 
maximusse73: folds 
christyirish: folds 
84d83473r: folds 
Apple857: checks 
*** FLOP *** [7s Qs 5h]
Apple857: checks 
kastellani87: checks 
*** TURN *** [7s Qs 5h] [6s]
Apple857: checks 
kastellani87: checks 
*** RIVER *** [7s Qs 5h 6s] [Jh]
Apple857: checks 
kastellani87: checks 
*** SHOW DOWN ***
Apple857: shows [3h 8s] (high card Queen)
kastellani87: shows [3c Kc] (high card King)
kastellani87 collected $1.19 from pot
*** SUMMARY ***
Total pot $1.25 | Rake $0.06 
Board [7s Qs 5h 6s Jh]
Seat 1: Apple857 (big blind) showed [3h 8s] and lost with high card Queen
Seat 3: kastellani87 showed [3c Kc] and won ($1.19) with high card King
Seat 4: BB_dont_cry folded before Flop (didn't bet)
Seat 5: Rhythmicstep folded before Flop (didn't bet)
Seat 6: Mc57Arnold folded before Flop (didn't bet)
Seat 7: maximusse73 folded before Flop (didn't bet)
Seat 8: christyirish (button) folded before Flop (didn't bet)
Seat 9: 84d83473r (small blind) folded before Flop



PokerStars Hand #228694881414:  Hold'em No Limit ($0.25/$0.50 USD) - 2021/07/30 21:07:08 ET
Table 'Gorgo III' 9-max Seat #9 is the button
Seat 1: Apple857 ($19.50 in chips) 
Seat 3: kastellani87 ($128.47 in chips) 
Seat 4: BB_dont_cry ($76.51 in chips) 
Seat 5: Rhythmicstep ($51.50 in chips) 
Seat 6: Mc57Arnold ($59.96 in chips) 
Seat 7: maximusse73 ($62.66 in chips) 
Seat 8: christyirish ($115.50 in chips) 
Seat 9: 84d83473r ($30.09 in chips) 
Apple857: posts small blind $0.25
kastellani87: posts big blind $0.50
*** HOLE CARDS ***
BB_dont_cry: folds 
Rhythmicstep: folds 
Mc57Arnold: raises $0.85 to $1.35
maximusse73: folds 
christyirish: calls $1.35
84d83473r: folds 
Apple857: folds 
kastellani87: calls $0.85
*** FLOP *** [7c Qc Ah]
kastellani87: checks 
Mc57Arnold: bets $2.04
christyirish: folds 
kastellani87: folds 
Uncalled bet ($2.04) returned to Mc57Arnold
Mc57Arnold collected $4.08 from pot
Mc57Arnold: doesn't show hand 
*** SUMMARY ***
Total pot $4.30 | Rake $0.22 
Board [7c Qc Ah]
Seat 1: Apple857 (small blind) folded before Flop
Seat 3: kastellani87 (big blind) folded on the Flop
Seat 4: BB_dont_cry folded before Flop (didn't bet)
Seat 5: Rhythmicstep folded before Flop (didn't bet)
Seat 6: Mc57Arnold collected ($4.08)
Seat 7: maximusse73 folded before Flop (didn't bet)
Seat 8: christyirish folded on the Flop
Seat 9: 84d83473r (button) folded before Flop (didn't bet)



PokerStars Hand #228694891161:  Hold'em No Limit ($0.25/$0.50 USD) - 2021/07/30 21:07:45 ET
Table 'Gorgo III' 9-max Seat #1 is the button
Seat 1: Apple857 ($19.25 in chips) 
Seat 3: kastellani87 ($127.12 in chips) 
Seat 4: BB_dont_cry ($76.51 in chips) 
Seat 5: Rhythmicstep ($51.50 in chips) 
Seat 6: Mc57Arnold ($62.69 in chips) 
Seat 7: maximusse73 ($62.66 in chips) 
Seat 8: christyirish ($114.15 in chips) 
Seat 9: 84d83473r ($30.09 in chips) 
kastellani87: posts small blind $0.25
BB_dont_cry: posts big blind $0.50
*** HOLE CARDS ***
Rhythmicstep: folds 
Mc57Arnold: folds 
maximusse73: folds 
christyirish: raises $1 to $1.50
84d83473r: folds 
Apple857: folds 
kastellani87: calls $1.25
BB_dont_cry: raises $5 to $6.50
christyirish: folds 
kastellani87: calls $5
*** FLOP *** [5c 5s Jc]
kastellani87: checks 
BB_dont_cry: checks 
*** TURN *** [5c 5s Jc] [Ad]
kastellani87: checks 
BB_dont_cry: bets $3.50
kastellani87: calls $3.50
*** RIVER *** [5c 5s Jc Ad] [7s]
kastellani87: checks 
BB_dont_cry: checks 
*** SHOW DOWN ***
kastellani87: shows [Ah Th] (two pair, Aces and Fives)
BB_dont_cry: mucks hand 
kastellani87 collected $20.42 from pot
*** SUMMARY ***
Total pot $21.50 | Rake $1.08 
Board [5c 5s Jc Ad 7s]
Seat 1: Apple857 (button) folded before Flop (didn't bet)
Seat 3: kastellani87 (small blind) showed [Ah Th] and won ($20.42) with two pair, Aces and Fives
Seat 4: BB_dont_cry (big blind) mucked
Seat 5: Rhythmicstep folded before Flop (didn't bet)
Seat 6: Mc57Arnold folded before Flop (didn't bet)
Seat 7: maximusse73 folded before Flop (didn't bet)
Seat 8: christyirish folded before Flop
Seat 9: 84d83473r folded before Flop (didn't bet)



PokerStars Hand #228694914077:  Hold'em No Limit ($0.25/$0.50 USD) - 2021/07/30 21:09:13 ET
Table 'Gorgo III' 9-max Seat #3 is the button
Seat 1: Apple857 ($19.25 in chips) 
Seat 3: kastellani87 ($137.54 in chips) 
Seat 4: BB_dont_cry ($66.51 in chips) 
Seat 5: Rhythmicstep ($51.50 in chips) 
Seat 6: Mc57Arnold ($62.69 in chips) 
Seat 7: maximusse73 ($62.66 in chips) 
Seat 9: 84d83473r ($30.09 in chips) 
BB_dont_cry: posts small blind $0.25
Rhythmicstep: posts big blind $0.50
*** HOLE CARDS ***
Mc57Arnold: folds 
maximusse73: folds 
84d83473r: folds 
Apple857: raises $1 to $1.50
kastellani87: folds 
BB_dont_cry: folds 
Rhythmicstep: calls $1
*** FLOP *** [Ad Qs 6h]
Rhythmicstep: checks 
Apple857: bets $1.04
Rhythmicstep: folds 
Uncalled bet ($1.04) returned to Apple857
Apple857 collected $3.09 from pot
Apple857: doesn't show hand 
*** SUMMARY ***
Total pot $3.25 | Rake $0.16 
Board [Ad Qs 6h]
Seat 1: Apple857 collected ($3.09)
Seat 3: kastellani87 (button) folded before Flop (didn't bet)
Seat 4: BB_dont_cry (small blind) folded before Flop
Seat 5: Rhythmicstep (big blind) folded on the Flop
Seat 6: Mc57Arnold folded before Flop (didn't bet)
Seat 7: maximusse73 folded before Flop (didn't bet)
Seat 9: 84d83473r folded before Flop (didn't bet)



PokerStars Hand #228694924688:  Hold'em No Limit ($0.25/$0.50 USD) - 2021/07/30 21:09:55 ET
Table 'Gorgo III' 9-max Seat #4 is the button
Seat 1: Apple857 ($20.84 in chips) 
Seat 3: kastellani87 ($137.54 in chips) 
Seat 4: BB_dont_cry ($66.26 in chips) 
Seat 5: Rhythmicstep ($50 in chips) 
Seat 6: Mc57Arnold ($62.69 in chips) 
Seat 7: maximusse73 ($62.66 in chips) 
Seat 9: 84d83473r ($30.09 in chips) 
Rhythmicstep: posts small blind $0.25
Mc57Arnold: posts big blind $0.50
pudge.3096: sits out 
*** HOLE CARDS ***
maximusse73: folds 
84d83473r: folds 
Apple857: folds 
maximusse73 leaves the table
kastellani87: folds 
BB_dont_cry: folds 
Rhythmicstep: raises $1 to $1.50
Mc57Arnold: folds 
Uncalled bet ($1) returned to Rhythmicstep
Rhythmicstep collected $1 from pot
Rhythmicstep: doesn't show hand 
*** SUMMARY ***
Total pot $1 | Rake $0 
Seat 1: Apple857 folded before Flop (didn't bet)
Seat 3: kastellani87 folded before Flop (didn't bet)
Seat 4: BB_dont_cry (button) folded before Flop (didn't bet)
Seat 5: Rhythmicstep (small blind) collected ($1)
Seat 6: Mc57Arnold (big blind) folded before Flop
Seat 7: maximusse73 folded before Flop (didn't bet)
Seat 9: 84d83473r folded before Flop (didn't bet)



PokerStars Hand #228694929935:  Hold'em No Limit ($0.25/$0.50 USD) - 2021/07/30 21:10:15 ET
Table 'Gorgo III' 9-max Seat #5 is the button
Seat 1: Apple857 ($20.84 in chips) 
Seat 3: kastellani87 ($137.54 in chips) 
Seat 4: BB_dont_cry ($66.26 in chips) 
Seat 5: Rhythmicstep ($50.50 in chips) 
Seat 6: Mc57Arnold ($62.19 in chips) 
Seat 9: 84d83473r ($30.09 in chips) 
Mc57Arnold: posts small blind $0.25
MonplDCmax joins the table at seat #7 
84d83473r: posts big blind $0.50
pudge.3096: sits out 
*** HOLE CARDS ***
Apple857: folds 
kastellani87: folds 
BB_dont_cry: raises $1.25 to $1.75
Rhythmicstep: folds 
Mc57Arnold: folds 
84d83473r: folds 
Uncalled bet ($1.25) returned to BB_dont_cry
BB_dont_cry collected $1.25 from pot
*** SUMMARY ***
Total pot $1.25 | Rake $0 
Seat 1: Apple857 folded before Flop (didn't bet)
Seat 3: kastellani87 folded before Flop (didn't bet)
Seat 4: BB_dont_cry collected ($1.25)
Seat 5: Rhythmicstep (button) folded before Flop (didn't bet)
Seat 6: Mc57Arnold (small blind) folded before Flop
Seat 9: 84d83473r (big blind) folded before Flop



PokerStars Hand #228694941726:  Hold'em No Limit ($0.25/$0.50 USD) - 2021/07/30 21:11:01 ET
Table 'Gorgo III' 9-max Seat #6 is the button
Seat 1: Apple857 ($20.84 in chips) 
Seat 3: kastellani87 ($137.54 in chips) 
Seat 4: BB_dont_cry ($67.01 in chips) 
Seat 5: Rhythmicstep ($50.50 in chips) 
Seat 6: Mc57Arnold ($61.94 in chips) 
Seat 9: 84d83473r ($29.59 in chips) 
84d83473r: posts small blind $0.25
Apple857: posts big blind $0.50
pudge.3096: sits out 
*** HOLE CARDS ***
kastellani87: calls $0.50
BB_dont_cry: calls $0.50
Rhythmicstep: raises $2 to $2.50
Mc57Arnold: folds 
84d83473r: calls $2.25
Apple857: folds 
kastellani87: folds 
BB_dont_cry: calls $2
*** FLOP *** [7h 9s 3h]
84d83473r: checks 
BB_dont_cry: checks 
Rhythmicstep: bets $4.44
84d83473r: folds 
BB_dont_cry: calls $4.44
*** TURN *** [7h 9s 3h] [Jh]
BB_dont_cry: checks 
Rhythmicstep: bets $11.75
BB_dont_cry: calls $11.75
*** RIVER *** [7h 9s 3h Jh] [Jc]
BB_dont_cry: checks 
Rhythmicstep: bets $31.81 and is all-in
BB_dont_cry: calls $31.81
*** SHOW DOWN ***
Rhythmicstep: shows [Ah 9h] (a flush, Ace high)
BB_dont_cry: shows [8c Tc] (a straight, Seven to Jack)
Rhythmicstep collected $102.50 from pot
*** SUMMARY ***
Total pot $104.50 | Rake $2 
Board [7h 9s 3h Jh Jc]
Seat 1: Apple857 (big blind) folded before Flop
Seat 3: kastellani87 folded before Flop
Seat 4: BB_dont_cry showed [8c Tc] and lost with a straight, Seven to Jack
Seat 5: Rhythmicstep showed [Ah 9h] and won ($102.50) with a flush, Ace high
Seat 6: Mc57Arnold (button) folded before Flop (didn't bet)
Seat 9: 84d83473r (small blind) folded on the Flop



PokerStars Hand #228694967868:  Hold'em No Limit ($0.25/$0.50 USD) - 2021/07/30 21:12:43 ET
Table 'Gorgo III' 9-max Seat #9 is the button
Seat 1: Apple857 ($20.34 in chips) 
Seat 2: pudge.3096 ($55.94 in chips) 
Seat 3: kastellani87 ($137.04 in chips) 
Seat 4: BB_dont_cry ($16.51 in chips) 
Seat 5: Rhythmicstep ($102.50 in chips) 
Seat 6: Mc57Arnold ($61.94 in chips) 
Seat 9: 84d83473r ($27.09 in chips) 
Apple857: posts small blind $0.25
pudge.3096: posts big blind $0.50
MonplDCmax: sits out 
*** HOLE CARDS ***
kastellani87 has timed out
kastellani87: folds 
BB_dont_cry: folds 
BB_dont_cry leaves the table
Rhythmicstep: folds 
Mc57Arnold: folds 
84d83473r: raises $1 to $1.50
Apple857: folds 
pudge.3096: folds 
Uncalled bet ($1) returned to 84d83473r
84d83473r collected $1.25 from pot
84d83473r: doesn't show hand 
*** SUMMARY ***
Total pot $1.25 | Rake $0 
Seat 1: Apple857 (small blind) folded before Flop
Seat 2: pudge.3096 (big blind) folded before Flop
Seat 3: kastellani87 folded before Flop (didn't bet)
Seat 4: BB_dont_cry folded before Flop (didn't bet)
Seat 5: Rhythmicstep folded before Flop (didn't bet)
Seat 6: Mc57Arnold folded before Flop (didn't bet)
Seat 9: 84d83473r (button) collected ($1.25)



PokerStars Hand #228694973330:  Hold'em No Limit ($0.25/$0.50 USD) - 2021/07/30 21:13:04 ET
Table 'Gorgo III' 9-max Seat #1 is the button
Seat 1: Apple857 ($20.09 in chips) 
Seat 2: pudge.3096 ($55.44 in chips) 
Seat 3: kastellani87 ($137.04 in chips) 
Seat 5: Rhythmicstep ($102.50 in chips) 
Seat 6: Mc57Arnold ($61.94 in chips) 
Seat 9: 84d83473r ($27.84 in chips) 
pudge.3096: posts small blind $0.25
kastellani87: posts big blind $0.50
MonplDCmax: sits out 
*** HOLE CARDS ***
Rhythmicstep: raises $1 to $1.50
Mc57Arnold: folds 
84d83473r: raises $2.50 to $4
Apple857: folds 
pudge.3096: raises $7 to $11
kastellani87: folds 
Rhythmicstep: folds 
84d83473r: calls $7
*** FLOP *** [7d 4c 6s]
pudge.3096: bets $6.16
84d83473r: raises $10.68 to $16.84 and is all-in
pudge.3096: calls $10.68
*** TURN *** [7d 4c 6s] [2s]
*** RIVER *** [7d 4c 6s 2s] [Td]
*** SHOW DOWN ***
pudge.3096: shows [Ad As] (a pair of Aces)
84d83473r: shows [8h 6h] (a pair of Sixes)
pudge.3096 collected $55.68 from pot
*** SUMMARY ***
Total pot $57.68 | Rake $2 
Board [7d 4c 6s 2s Td]
Seat 1: Apple857 (button) folded before Flop (didn't bet)
Seat 2: pudge.3096 (small blind) showed [Ad As] and won ($55.68) with a pair of Aces
Seat 3: kastellani87 (big blind) folded before Flop
Seat 5: Rhythmicstep folded before Flop
Seat 6: Mc57Arnold folded before Flop (didn't bet)
Seat 9: 84d83473r showed [8h 6h] and lost with a pair of Sixes



PokerStars Hand #228694990182:  Hold'em No Limit ($0.25/$0.50 USD) - 2021/07/30 21:13:56 ET
Table 'Gorgo III' 9-max Seat #2 is the button
Seat 1: Apple857 ($20.09 in chips) 
Seat 2: pudge.3096 ($83.28 in chips) 
Seat 3: kastellani87 ($136.54 in chips) 
Seat 5: Rhythmicstep ($101 in chips) 
Seat 6: Mc57Arnold ($61.94 in chips) 
kastellani87: posts small blind $0.25
Rhythmicstep: posts big blind $0.50
MonplDCmax: sits out 
*** HOLE CARDS ***
Mc57Arnold: folds 
Apple857: folds 
pudge.3096: folds 
kastellani87: folds 
Uncalled bet ($0.25) returned to Rhythmicstep
Rhythmicstep collected $0.50 from pot
Rhythmicstep: doesn't show hand 
*** SUMMARY ***
Total pot $0.50 | Rake $0 
Seat 1: Apple857 folded before Flop (didn't bet)
Seat 2: pudge.3096 (button) folded before Flop (didn't bet)
Seat 3: kastellani87 (small blind) folded before Flop
Seat 5: Rhythmicstep (big blind) collected ($0.50)
Seat 6: Mc57Arnold folded before Flop (didn't bet)



PokerStars Hand #228695000055:  Hold'em No Limit ($0.25/$0.50 USD) - 2021/07/30 21:14:07 ET
Table 'Gorgo III' 9-max Seat #3 is the button
Seat 1: Apple857 ($20.09 in chips) 
Seat 2: pudge.3096 ($83.28 in chips) 
Seat 3: kastellani87 ($136.29 in chips) 
Seat 5: Rhythmicstep ($101.25 in chips) 
Seat 6: Mc57Arnold ($61.94 in chips) 
Seat 9: 84d83473r ($25 in chips) 
Rhythmicstep: posts small blind $0.25
Mc57Arnold: posts big blind $0.50
MonplDCmax: sits out 
*** HOLE CARDS ***
84d83473r: folds 
Apple857: folds 
pudge.3096: raises $0.75 to $1.25
kastellani87: raises $3.25 to $4.50
Rhythmicstep: folds 
Mc57Arnold: folds 
pudge.3096: calls $3.25
*** FLOP *** [3s 4c Ts]
pudge.3096: checks 
kastellani87: bets $9.26
pudge.3096: calls $9.26
*** TURN *** [3s 4c Ts] [2c]
pudge.3096: checks 
kastellani87: bets $13.43
pudge.3096: folds 
Uncalled bet ($13.43) returned to kastellani87
kastellani87 collected $26.86 from pot
kastellani87: doesn't show hand 
*** SUMMARY ***
Total pot $28.27 | Rake $1.41 
Board [3s 4c Ts 2c]
Seat 1: Apple857 folded before Flop (didn't bet)
Seat 2: pudge.3096 folded on the Turn
Seat 3: kastellani87 (button) collected ($26.86)
Seat 5: Rhythmicstep (small blind) folded before Flop
Seat 6: Mc57Arnold (big blind) folded before Flop
Seat 9: 84d83473r folded before Flop (didn't bet)



PokerStars Hand #228695010967:  Hold'em No Limit ($0.25/$0.50 USD) - 2021/07/30 21:14:51 ET
Table 'Gorgo III' 9-max Seat #5 is the button
Seat 1: Apple857 ($20.09 in chips) 
Seat 2: pudge.3096 ($69.52 in chips) 
Seat 3: kastellani87 ($149.39 in chips) 
Seat 5: Rhythmicstep ($101 in chips) 
Seat 6: Mc57Arnold ($61.44 in chips) 
Seat 7: MonplDCmax ($53.55 in chips) 
Seat 9: 84d83473r ($25 in chips) 
Mc57Arnold: posts small blind $0.25
MonplDCmax: posts big blind $0.50
*** HOLE CARDS ***
84d83473r: calls $0.50
Apple857: folds 
pudge.3096: folds 
kastellani87: raises $1 to $1.50
Rhythmicstep: folds 
Mc57Arnold: folds 
MonplDCmax: folds 
84d83473r: calls $1
*** FLOP *** [3s 8c 2s]
84d83473r: bets $1.78
kastellani87: calls $1.78
*** TURN *** [3s 8c 2s] [5c]
84d83473r: bets $3.47
kastellani87: calls $3.47
*** RIVER *** [3s 8c 2s 5c] [7h]
84d83473r: bets $6.77
kastellani87: folds 
Uncalled bet ($6.77) returned to 84d83473r
84d83473r collected $13.54 from pot
84d83473r: doesn't show hand 
*** SUMMARY ***
Total pot $14.25 | Rake $0.71 
Board [3s 8c 2s 5c 7h]
Seat 1: Apple857 folded before Flop (didn't bet)
Seat 2: pudge.3096 folded before Flop (didn't bet)
Seat 3: kastellani87 folded on the River
Seat 5: Rhythmicstep (button) folded before Flop (didn't bet)
Seat 6: Mc57Arnold (small blind) folded before Flop
Seat 7: MonplDCmax (big blind) folded before Flop
Seat 9: 84d83473r collected ($13.54)



PokerStars Hand #228695029163:  Hold'em No Limit ($0.25/$0.50 USD) - 2021/07/30 21:16:02 ET
Table 'Gorgo III' 9-max Seat #6 is the button
Seat 1: Apple857 ($20.09 in chips) 
Seat 2: pudge.3096 ($69.52 in chips) 
Seat 3: kastellani87 ($142.64 in chips) 
Seat 5: Rhythmicstep ($101 in chips) 
Seat 6: Mc57Arnold ($61.19 in chips) 
Seat 7: MonplDCmax ($53.05 in chips) 
Seat 9: 84d83473r ($31.79 in chips) 
MonplDCmax: posts small blind $0.25
84d83473r: posts big blind $0.50
*** HOLE CARDS ***
Apple857: folds 
pudge.3096: folds 
kastellani87: calls $0.50
Rhythmicstep: folds 
Mc57Arnold: folds 
MonplDCmax: raises $1.62 to $2.12
84d83473r: folds 
kastellani87: calls $1.62
*** FLOP *** [5s 4h Jd]
MonplDCmax: checks 
kastellani87: bets $2.25
MonplDCmax: calls $2.25
*** TURN *** [5s 4h Jd] [6h]
MonplDCmax: checks 
kastellani87: bets $4.39
MonplDCmax: calls $4.39
*** RIVER *** [5s 4h Jd 6h] [9h]
MonplDCmax: checks 
kastellani87: checks 
*** SHOW DOWN ***
MonplDCmax: shows [8h 8s] (a pair of Eights)
kastellani87: shows [Td Js] (a pair of Jacks)
kastellani87 collected $17.12 from pot
*** SUMMARY ***
Total pot $18.02 | Rake $0.90 
Board [5s 4h Jd 6h 9h]
Seat 1: Apple857 folded before Flop (didn't bet)
Seat 2: pudge.3096 folded before Flop (didn't bet)
Seat 3: kastellani87 showed [Td Js] and won ($17.12) with a pair of Jacks
Seat 5: Rhythmicstep folded before Flop (didn't bet)
Seat 6: Mc57Arnold (button) folded before Flop (didn't bet)
Seat 7: MonplDCmax (small blind) showed [8h 8s] and lost with a pair of Eights
Seat 9: 84d83473r (big blind) folded before Flop



PokerStars Hand #228695051394:  Hold'em No Limit ($0.25/$0.50 USD) - 2021/07/30 21:17:30 ET
Table 'Gorgo III' 9-max Seat #7 is the button
Seat 1: Apple857 ($20.09 in chips) 
Seat 2: pudge.3096 ($69.52 in chips) 
Seat 3: kastellani87 ($151 in chips) 
Seat 5: Rhythmicstep ($101 in chips) 
Seat 6: Mc57Arnold ($61.19 in chips) 
Seat 7: MonplDCmax ($50 in chips) 
Seat 9: 84d83473r ($31.29 in chips) 
84d83473r: posts small blind $0.25
Apple857: posts big blind $0.50
*** HOLE CARDS ***
pudge.3096: folds 
kastellani87: calls $0.50
Rhythmicstep: folds 
Mc57Arnold has timed out
Mc57Arnold: folds 
MonplDCmax: folds 
84d83473r: calls $0.25
$lavik88 joins the table at seat #4 
Apple857: checks 
*** FLOP *** [9h 2s 8d]
84d83473r: checks 
Apple857: bets $1
kastellani87: raises $3.42 to $4.42
84d83473r: folds 
Apple857: folds 
Uncalled bet ($3.42) returned to kastellani87
kastellani87 collected $3.32 from pot
kastellani87: doesn't show hand 
*** SUMMARY ***
Total pot $3.50 | Rake $0.18 
Board [9h 2s 8d]
Seat 1: Apple857 (big blind) folded on the Flop
Seat 2: pudge.3096 folded before Flop (didn't bet)
Seat 3: kastellani87 collected ($3.32)
Seat 5: Rhythmicstep folded before Flop (didn't bet)
Seat 6: Mc57Arnold folded before Flop (didn't bet)
Seat 7: MonplDCmax (button) folded before Flop (didn't bet)
Seat 9: 84d83473r (small blind) folded on the Flop



PokerStars Hand #228695073658:  Hold'em No Limit ($0.25/$0.50 USD) - 2021/07/30 21:18:58 ET
Table 'Gorgo III' 9-max Seat #9 is the button
Seat 1: Apple857 ($18.59 in chips) 
Seat 2: pudge.3096 ($69.52 in chips) 
Seat 3: kastellani87 ($152.82 in chips) 
Seat 5: Rhythmicstep ($101 in chips) 
Seat 6: Mc57Arnold ($61.19 in chips) 
Seat 7: MonplDCmax ($50 in chips) 
Seat 8: christyirish ($112.65 in chips) 
Seat 9: 84d83473r ($30.79 in chips) 
Apple857: posts small blind $0.25
pudge.3096: posts big blind $0.50
$lavik88: sits out 
christyirish: posts small & big blinds $0.75
*** HOLE CARDS ***
kastellani87: folds 
Rhythmicstep: folds 
Mc57Arnold: folds 
MonplDCmax: folds 
christyirish: checks 
84d83473r: raises $1.50 to $2
Apple857: folds 
pudge.3096: folds 
christyirish: folds 
Uncalled bet ($1.50) returned to 84d83473r
84d83473r collected $2 from pot
84d83473r: doesn't show hand 
*** SUMMARY ***
Total pot $2 | Rake $0 
Seat 1: Apple857 (small blind) folded before Flop
Seat 2: pudge.3096 (big blind) folded before Flop
Seat 3: kastellani87 folded before Flop (didn't bet)
Seat 5: Rhythmicstep folded before Flop (didn't bet)
Seat 6: Mc57Arnold folded before Flop (didn't bet)
Seat 7: MonplDCmax folded before Flop (didn't bet)
Seat 8: christyirish folded before Flop (didn't bet)
Seat 9: 84d83473r (button) collected ($2)



PokerStars Hand #228695082515:  Hold'em No Limit ($0.25/$0.50 USD) - 2021/07/30 21:19:33 ET
Table 'Gorgo III' 9-max Seat #1 is the button
Seat 1: Apple857 ($18.34 in chips) 
Seat 2: pudge.3096 ($69.02 in chips) 
Seat 3: kastellani87 ($152.82 in chips) 
Seat 5: Rhythmicstep ($101 in chips) 
Seat 6: Mc57Arnold ($61.19 in chips) 
Seat 7: MonplDCmax ($50 in chips) 
Seat 8: christyirish ($111.90 in chips) 
Seat 9: 84d83473r ($32.29 in chips) 
pudge.3096: posts small blind $0.25
kastellani87: posts big blind $0.50
$lavik88: sits out 
*** HOLE CARDS ***
Rhythmicstep: folds 
Mc57Arnold has timed out
Mc57Arnold: folds 
MonplDCmax: folds 
christyirish: folds 
84d83473r: folds 
Apple857: folds 
pudge.3096: folds 
Uncalled bet ($0.25) returned to kastellani87
kastellani87 collected $0.50 from pot
kastellani87: doesn't show hand 
*** SUMMARY ***
Total pot $0.50 | Rake $0 
Seat 1: Apple857 (button) folded before Flop (didn't bet)
Seat 2: pudge.3096 (small blind) folded before Flop
Seat 3: kastellani87 (big blind) collected ($0.50)
Seat 5: Rhythmicstep folded before Flop (didn't bet)
Seat 6: Mc57Arnold folded before Flop (didn't bet)
Seat 7: MonplDCmax folded before Flop (didn't bet)
Seat 8: christyirish folded before Flop (didn't bet)
Seat 9: 84d83473r folded before Flop (didn't bet)



PokerStars Hand #228695087285:  Hold'em No Limit ($0.25/$0.50 USD) - 2021/07/30 21:19:52 ET
Table 'Gorgo III' 9-max Seat #2 is the button
Seat 1: Apple857 ($18.34 in chips) 
Seat 2: pudge.3096 ($68.77 in chips) 
Seat 3: kastellani87 ($153.07 in chips) 
Seat 4: $lavik88 ($50 in chips) 
Seat 5: Rhythmicstep ($101 in chips) 
Seat 6: Mc57Arnold ($61.19 in chips) 
Seat 7: MonplDCmax ($50 in chips) 
Seat 8: christyirish ($111.90 in chips) 
Seat 9: 84d83473r ($32.29 in chips) 
kastellani87: posts small blind $0.25
$lavik88: posts big blind $0.50
*** HOLE CARDS ***
Rhythmicstep: folds 
Mc57Arnold: folds 
MonplDCmax: folds 
christyirish: folds 
84d83473r: folds 
Apple857: folds 
pudge.3096: raises $0.75 to $1.25
kastellani87: folds 
$lavik88: folds 
Uncalled bet ($0.75) returned to pudge.3096
pudge.3096 collected $1.25 from pot
pudge.3096: doesn't show hand 
*** SUMMARY ***
Total pot $1.25 | Rake $0 
Seat 1: Apple857 folded before Flop (didn't bet)
Seat 2: pudge.3096 (button) collected ($1.25)
Seat 3: kastellani87 (small blind) folded before Flop
Seat 4: $lavik88 (big blind) folded before Flop
Seat 5: Rhythmicstep folded before Flop (didn't bet)
Seat 6: Mc57Arnold folded before Flop (didn't bet)
Seat 7: MonplDCmax folded before Flop (didn't bet)
Seat 8: christyirish folded before Flop (didn't bet)
Seat 9: 84d83473r folded before Flop (didn't bet)



PokerStars Hand #228695095252:  Hold'em No Limit ($0.25/$0.50 USD) - 2021/07/30 21:20:24 ET
Table 'Gorgo III' 9-max Seat #3 is the button
Seat 1: Apple857 ($18.34 in chips) 
Seat 2: pudge.3096 ($69.52 in chips) 
Seat 3: kastellani87 ($152.82 in chips) 
Seat 4: $lavik88 ($50 in chips) 
Seat 6: Mc57Arnold ($61.19 in chips) 
Seat 7: MonplDCmax ($50 in chips) 
Seat 8: christyirish ($111.90 in chips) 
Seat 9: 84d83473r ($32.29 in chips) 
$lavik88: posts small blind $0.25
Rhythmicstep: is sitting out 
Mc57Arnold: posts big blind $0.50
*** HOLE CARDS ***
Rhythmicstep leaves the table
MonplDCmax: raises $0.81 to $1.31
christyirish: folds 
84d83473r: folds 
Apple857: folds 
pudge.3096: folds 
kastellani87: calls $1.31
$lavik88: folds 
Mc57Arnold: folds 
*** FLOP *** [7h Qc 3s]
MonplDCmax: bets $1.50
kastellani87: folds 
Uncalled bet ($1.50) returned to MonplDCmax
MonplDCmax collected $3.20 from pot
MonplDCmax: doesn't show hand 
*** SUMMARY ***
Total pot $3.37 | Rake $0.17 
Board [7h Qc 3s]
Seat 1: Apple857 folded before Flop (didn't bet)
Seat 2: pudge.3096 folded before Flop (didn't bet)
Seat 3: kastellani87 (button) folded on the Flop
Seat 4: $lavik88 (small blind) folded before Flop
Seat 6: Mc57Arnold (big blind) folded before Flop
Seat 7: MonplDCmax collected ($3.20)
Seat 8: christyirish folded before Flop (didn't bet)
Seat 9: 84d83473r folded before Flop (didn't bet)



PokerStars Hand #228695101324:  Hold'em No Limit ($0.25/$0.50 USD) - 2021/07/30 21:20:48 ET
Table 'Gorgo III' 9-max Seat #4 is the button
Seat 1: Apple857 ($18.34 in chips) 
Seat 2: pudge.3096 ($69.52 in chips) 
Seat 3: kastellani87 ($151.51 in chips) 
Seat 4: $lavik88 ($50 in chips) 
Seat 6: Mc57Arnold ($60.69 in chips) 
Seat 7: MonplDCmax ($51.89 in chips) 
Seat 8: christyirish ($111.90 in chips) 
Seat 9: 84d83473r ($32.29 in chips) 
Mc57Arnold: posts small blind $0.25
MonplDCmax: posts big blind $0.50
*** HOLE CARDS ***
christyirish: folds 
84d83473r: folds 
Apple857: folds 
pudge.3096: folds 
kastellani87: folds 
$lavik88: raises $0.70 to $1.20
Mc57Arnold: folds 
MonplDCmax: calls $0.70
*** FLOP *** [6d Ac 8c]
MonplDCmax: checks 
$lavik88: bets $0.76
MonplDCmax: calls $0.76
*** TURN *** [6d Ac 8c] [Ts]
MonplDCmax: checks 
$lavik88: bets $2.97
MonplDCmax: calls $2.97
*** RIVER *** [6d Ac 8c Ts] [2h]
MonplDCmax: checks 
$lavik88: checks 
*** SHOW DOWN ***
MonplDCmax: shows [5c As] (a pair of Aces)
$lavik88: mucks hand 
MonplDCmax collected $9.60 from pot
*** SUMMARY ***
Total pot $10.11 | Rake $0.51 
Board [6d Ac 8c Ts 2h]
Seat 1: Apple857 folded before Flop (didn't bet)
Seat 2: pudge.3096 folded before Flop (didn't bet)
Seat 3: kastellani87 folded before Flop (didn't bet)
Seat 4: $lavik88 (button) mucked
Seat 6: Mc57Arnold (small blind) folded before Flop
Seat 7: MonplDCmax (big blind) showed [5c As] and won ($9.60) with a pair of Aces
Seat 8: christyirish folded before Flop (didn't bet)
Seat 9: 84d83473r folded before Flop (didn't bet)



PokerStars Hand #228695125869:  Hold'em No Limit ($0.25/$0.50 USD) - 2021/07/30 21:22:00 ET
Table 'Gorgo III' 9-max Seat #6 is the button
Seat 1: Apple857 ($18.34 in chips) 
Seat 2: pudge.3096 ($69.52 in chips) 
Seat 3: kastellani87 ($151.51 in chips) 
Seat 4: $lavik88 ($50 in chips) 
Seat 6: Mc57Arnold ($60.44 in chips) 
Seat 7: MonplDCmax ($56.56 in chips) 
Seat 8: christyirish ($111.90 in chips) 
Seat 9: 84d83473r ($32.29 in chips) 
MonplDCmax: posts small blind $0.25
christyirish: posts big blind $0.50
*** HOLE CARDS ***
84d83473r: folds 
Apple857: folds 
pudge.3096: folds 
kastellani87: calls $0.50
$lavik88: folds 
Mc57Arnold: raises $2 to $2.50
MonplDCmax: folds 
christyirish: folds 
kastellani87: calls $2
*** FLOP *** [5h 7c 6d]
kastellani87: bets $2.73
Mc57Arnold: calls $2.73
*** TURN *** [5h 7c 6d] [Qc]
kastellani87: checks 
Mc57Arnold: bets $5.33
kastellani87: folds 
Uncalled bet ($5.33) returned to Mc57Arnold
Mc57Arnold collected $10.65 from pot
Mc57Arnold: doesn't show hand 
*** SUMMARY ***
Total pot $11.21 | Rake $0.56 
Board [5h 7c 6d Qc]
Seat 1: Apple857 folded before Flop (didn't bet)
Seat 2: pudge.3096 folded before Flop (didn't bet)
Seat 3: kastellani87 folded on the Turn
Seat 4: $lavik88 folded before Flop (didn't bet)
Seat 6: Mc57Arnold (button) collected ($10.65)
Seat 7: MonplDCmax (small blind) folded before Flop
Seat 8: christyirish (big blind) folded before Flop
Seat 9: 84d83473r folded before Flop (didn't bet)



PokerStars Hand #228695145392:  Hold'em No Limit ($0.25/$0.50 USD) - 2021/07/30 21:23:18 ET
Table 'Gorgo III' 9-max Seat #7 is the button
Seat 1: Apple857 ($18.34 in chips) 
Seat 2: pudge.3096 ($69.52 in chips) 
Seat 3: kastellani87 ($146.28 in chips) 
Seat 4: $lavik88 ($50 in chips) 
Seat 6: Mc57Arnold ($65.86 in chips) 
Seat 7: MonplDCmax ($56.31 in chips) 
Seat 8: christyirish ($111.40 in chips) 
Seat 9: 84d83473r ($32.29 in chips) 
christyirish: posts small blind $0.25
84d83473r: posts big blind $0.50
*** HOLE CARDS ***
Apple857: folds 
pudge.3096: folds 
Apple857 leaves the table
kastellani87: folds 
$lavik88: folds 
Mc57Arnold: folds 
MonplDCmax: folds 
christyirish: calls $0.25
84d83473r: checks 
*** FLOP *** [7c 6h 9c]
christyirish: checks 
84d83473r: checks 
*** TURN *** [7c 6h 9c] [Qh]
christyirish: bets $0.50
84d83473r: calls $0.50
*** RIVER *** [7c 6h 9c Qh] [Js]
christyirish: checks 
84d83473r: bets $0.95
christyirish: folds 
Uncalled bet ($0.95) returned to 84d83473r
84d83473r collected $1.90 from pot
84d83473r: doesn't show hand 
*** SUMMARY ***
Total pot $2 | Rake $0.10 
Board [7c 6h 9c Qh Js]
Seat 1: Apple857 folded before Flop (didn't bet)
Seat 2: pudge.3096 folded before Flop (didn't bet)
Seat 3: kastellani87 folded before Flop (didn't bet)
Seat 4: $lavik88 folded before Flop (didn't bet)
Seat 6: Mc57Arnold folded before Flop (didn't bet)
Seat 7: MonplDCmax (button) folded before Flop (didn't bet)
Seat 8: christyirish (small blind) folded on the River
Seat 9: 84d83473r (big blind) collected ($1.90)



PokerStars Hand #228695158868:  Hold'em No Limit ($0.25/$0.50 USD) - 2021/07/30 21:24:12 ET
Table 'Gorgo III' 9-max Seat #8 is the button
Seat 2: pudge.3096 ($69.52 in chips) 
Seat 3: kastellani87 ($146.28 in chips) 
Seat 4: $lavik88 ($50 in chips) 
Seat 6: Mc57Arnold ($65.86 in chips) 
Seat 7: MonplDCmax ($56.31 in chips) 
Seat 8: christyirish ($110.40 in chips) 
Seat 9: 84d83473r ($33.19 in chips) 
84d83473r: posts small blind $0.25
pudge.3096: posts big blind $0.50
*** HOLE CARDS ***
kastellani87: calls $0.50
$lavik88: folds 
Mc57Arnold: folds 
MonplDCmax: folds 
christyirish: folds 
84d83473r: calls $0.25
pudge.3096: raises $2 to $2.50
kastellani87: calls $2
84d83473r: folds 
*** FLOP *** [7c Js 9d]
pudge.3096: checks 
kastellani87: checks 
*** TURN *** [7c Js 9d] [8s]
pudge.3096: checks 
kastellani87: checks 
*** RIVER *** [7c Js 9d 8s] [5h]
pudge.3096: bets $4.07
kastellani87: folds 
Uncalled bet ($4.07) returned to pudge.3096
pudge.3096 collected $5.22 from pot
pudge.3096: doesn't show hand 
*** SUMMARY ***
Total pot $5.50 | Rake $0.28 
Board [7c Js 9d 8s 5h]
Seat 2: pudge.3096 (big blind) collected ($5.22)
Seat 3: kastellani87 folded on the River
Seat 4: $lavik88 folded before Flop (didn't bet)
Seat 6: Mc57Arnold folded before Flop (didn't bet)
Seat 7: MonplDCmax folded before Flop (didn't bet)
Seat 8: christyirish (button) folded before Flop (didn't bet)
Seat 9: 84d83473r (small blind) folded before Flop



PokerStars Hand #228695174115:  Hold'em No Limit ($0.25/$0.50 USD) - 2021/07/30 21:25:13 ET
Table 'Gorgo III' 9-max Seat #9 is the button
Seat 2: pudge.3096 ($72.24 in chips) 
Seat 3: kastellani87 ($143.78 in chips) 
Seat 4: $lavik88 ($50 in chips) 
Seat 6: Mc57Arnold ($65.86 in chips) 
Seat 7: MonplDCmax ($56.31 in chips) 
Seat 8: christyirish ($110.40 in chips) 
Seat 9: 84d83473r ($32.69 in chips) 
pudge.3096: posts small blind $0.25
kastellani87: posts big blind $0.50
*** HOLE CARDS ***
$lavik88: folds 
Mc57Arnold: folds 
MonplDCmax: folds 
christyirish: raises $1 to $1.50
84d83473r: folds 
pudge.3096: folds 
kastellani87: calls $1
*** FLOP *** [Ah 7c Js]
kastellani87: checks 
christyirish: bets $1.55
kastellani87: folds 
Uncalled bet ($1.55) returned to christyirish
christyirish collected $3.09 from pot
*** SUMMARY ***
Total pot $3.25 | Rake $0.16 
Board [Ah 7c Js]
Seat 2: pudge.3096 (small blind) folded before Flop
Seat 3: kastellani87 (big blind) folded on the Flop
Seat 4: $lavik88 folded before Flop (didn't bet)
Seat 6: Mc57Arnold folded before Flop (didn't bet)
Seat 7: MonplDCmax folded before Flop (didn't bet)
Seat 8: christyirish collected ($3.09)
Seat 9: 84d83473r (button) folded before Flop (didn't bet)



PokerStars Hand #228695181684:  Hold'em No Limit ($0.25/$0.50 USD) - 2021/07/30 21:25:43 ET
Table 'Gorgo III' 9-max Seat #2 is the button
Seat 2: pudge.3096 ($71.99 in chips) 
Seat 3: kastellani87 ($142.28 in chips) 
Seat 4: $lavik88 ($50 in chips) 
Seat 6: Mc57Arnold ($65.86 in chips) 
Seat 7: MonplDCmax ($56.31 in chips) 
Seat 8: christyirish ($111.99 in chips) 
Seat 9: 84d83473r ($32.69 in chips) 
kastellani87: posts small blind $0.25
$lavik88: posts big blind $0.50
*** HOLE CARDS ***
Mc57Arnold: raises $0.85 to $1.35
MonplDCmax: folds 
christyirish: folds 
84d83473r: folds 
pudge.3096: folds 
kastellani87: folds 
Dragonclawss joins the table at seat #1 
$lavik88: folds 
Uncalled bet ($0.85) returned to Mc57Arnold
Mc57Arnold collected $1.25 from pot
Mc57Arnold: doesn't show hand 
*** SUMMARY ***
Total pot $1.25 | Rake $0 
Seat 2: pudge.3096 (button) folded before Flop (didn't bet)
Seat 3: kastellani87 (small blind) folded before Flop
Seat 4: $lavik88 (big blind) folded before Flop
Seat 6: Mc57Arnold collected ($1.25)
Seat 7: MonplDCmax folded before Flop (didn't bet)
Seat 8: christyirish folded before Flop (didn't bet)
Seat 9: 84d83473r folded before Flop (didn't bet)



PokerStars Hand #228695189236:  Hold'em No Limit ($0.25/$0.50 USD) - 2021/07/30 21:26:14 ET
Table 'Gorgo III' 9-max Seat #3 is the button
Seat 2: pudge.3096 ($71.99 in chips) 
Seat 3: kastellani87 ($142.03 in chips) 
Seat 4: $lavik88 ($50 in chips) 
Seat 6: Mc57Arnold ($66.61 in chips) 
Seat 7: MonplDCmax ($56.31 in chips) 
Seat 8: christyirish ($111.99 in chips) 
Seat 9: 84d83473r ($32.69 in chips) 
$lavik88: posts small blind $0.25
Mc57Arnold: posts big blind $0.50
Dragonclawss: sits out 
*** HOLE CARDS ***
MonplDCmax: folds 
christyirish: raises $1 to $1.50
84d83473r: folds 
pudge.3096: folds 
kastellani87: calls $1.50
$lavik88: raises $5 to $6.50
Mc57Arnold: folds 
Dragonclawss leaves the table
christyirish: raises $9.50 to $16
kastellani87: folds 
$lavik88: folds 
Uncalled bet ($9.50) returned to christyirish
christyirish collected $15 from pot
christyirish: doesn't show hand 
*** SUMMARY ***
Total pot $15 | Rake $0 
Seat 2: pudge.3096 folded before Flop (didn't bet)
Seat 3: kastellani87 (button) folded before Flop
Seat 4: $lavik88 (small blind) folded before Flop
Seat 6: Mc57Arnold (big blind) folded before Flop
Seat 7: MonplDCmax folded before Flop (didn't bet)
Seat 8: christyirish collected ($15)
Seat 9: 84d83473r folded before Flop (didn't bet)



PokerStars Hand #228695199490:  Hold'em No Limit ($0.25/$0.50 USD) - 2021/07/30 21:26:55 ET
Table 'Gorgo III' 9-max Seat #4 is the button
Seat 2: pudge.3096 ($71.99 in chips) 
Seat 3: kastellani87 ($140.53 in chips) 
Seat 4: $lavik88 ($50 in chips) 
Seat 6: Mc57Arnold ($66.11 in chips) 
Seat 7: MonplDCmax ($56.31 in chips) 
Seat 8: christyirish ($120.49 in chips) 
Seat 9: 84d83473r ($32.69 in chips) 
Mc57Arnold: posts small blind $0.25
MonplDCmax: posts big blind $0.50
*** HOLE CARDS ***
christyirish: folds 
84d83473r: folds 
pudge.3096: folds 
kastellani87: folds 
$lavik88: raises $0.70 to $1.20
Mc57Arnold: folds 
MonplDCmax: folds 
Uncalled bet ($0.70) returned to $lavik88
$lavik88 collected $1.25 from pot
$lavik88: doesn't show hand 
*** SUMMARY ***
Total pot $1.25 | Rake $0 
Seat 2: pudge.3096 folded before Flop (didn't bet)
Seat 3: kastellani87 folded before Flop (didn't bet)
Seat 4: $lavik88 (button) collected ($1.25)
Seat 6: Mc57Arnold (small blind) folded before Flop
Seat 7: MonplDCmax (big blind) folded before Flop
Seat 8: christyirish folded before Flop (didn't bet)
Seat 9: 84d83473r folded before Flop (didn't bet)



PokerStars Hand #228695202682:  Hold'em No Limit ($0.25/$0.50 USD) - 2021/07/30 21:27:09 ET
Table 'Gorgo III' 9-max Seat #6 is the button
Seat 2: pudge.3096 ($71.99 in chips) 
Seat 3: kastellani87 ($140.53 in chips) 
Seat 4: $lavik88 ($50.75 in chips) 
Seat 6: Mc57Arnold ($65.86 in chips) 
Seat 7: MonplDCmax ($55.81 in chips) 
Seat 8: christyirish ($120.49 in chips) 
Seat 9: 84d83473r ($32.69 in chips) 
MonplDCmax: posts small blind $0.25
christyirish: posts big blind $0.50
*** HOLE CARDS ***
84d83473r: folds 
pudge.3096: folds 
kastellani87: raises $0.50 to $1
$lavik88: folds 
Mc57Arnold: folds 
Myles.M31 joins the table at seat #1 
AndyLu)|(ynski joins the table at seat #5 
MonplDCmax: folds 
christyirish: folds 
Uncalled bet ($0.50) returned to kastellani87
kastellani87 collected $1.25 from pot
kastellani87: doesn't show hand 
*** SUMMARY ***
Total pot $1.25 | Rake $0 
Seat 2: pudge.3096 folded before Flop (didn't bet)
Seat 3: kastellani87 collected ($1.25)
Seat 4: $lavik88 folded before Flop (didn't bet)
Seat 6: Mc57Arnold (button) folded before Flop (didn't bet)
Seat 7: MonplDCmax (small blind) folded before Flop
Seat 8: christyirish (big blind) folded before Flop
Seat 9: 84d83473r folded before Flop (didn't bet)



PokerStars Hand #228695206566:  Hold'em No Limit ($0.25/$0.50 USD) - 2021/07/30 21:27:24 ET
Table 'Gorgo III' 9-max Seat #7 is the button
Seat 2: pudge.3096 ($71.99 in chips) 
Seat 3: kastellani87 ($141.28 in chips) 
Seat 4: $lavik88 ($50.75 in chips) 
Seat 6: Mc57Arnold ($65.86 in chips) 
Seat 7: MonplDCmax ($55.56 in chips) 
Seat 8: christyirish ($119.99 in chips) 
Seat 9: 84d83473r ($32.69 in chips) 
christyirish: posts small blind $0.25
84d83473r: posts big blind $0.50
Myles.M31: is sitting out 
Myles.M31 leaves the table
AndyLu)|(ynski: sits out 
*** HOLE CARDS ***
pudge.3096: folds 
kastellani87: calls $0.50
$lavik88: folds 
Mc57Arnold: folds 
MonplDCmax: raises $1.50 to $2
christyirish: raises $5 to $7
84d83473r: folds 
AndyLu)|(ynski leaves the table
Myles.M31 joins the table at seat #1 
kastellani87: folds 
MonplDCmax: folds 
Uncalled bet ($5) returned to christyirish
christyirish collected $5 from pot
*** SUMMARY ***
Total pot $5 | Rake $0 
Seat 2: pudge.3096 folded before Flop (didn't bet)
Seat 3: kastellani87 folded before Flop
Seat 4: $lavik88 folded before Flop (didn't bet)
Seat 6: Mc57Arnold folded before Flop (didn't bet)
Seat 7: MonplDCmax (button) folded before Flop
Seat 8: christyirish (small blind) collected ($5)
Seat 9: 84d83473r (big blind) folded before Flop



PokerStars Hand #228695212720:  Hold'em No Limit ($0.25/$0.50 USD) - 2021/07/30 21:27:49 ET
Table 'Gorgo III' 9-max Seat #8 is the button
Seat 1: Myles.M31 ($50 in chips) 
Seat 2: pudge.3096 ($71.99 in chips) 
Seat 3: kastellani87 ($140.78 in chips) 
Seat 4: $lavik88 ($50.75 in chips) 
Seat 6: Mc57Arnold ($65.86 in chips) 
Seat 7: MonplDCmax ($53.56 in chips) 
Seat 8: christyirish ($122.99 in chips) 
Seat 9: 84d83473r ($32.19 in chips) 
84d83473r: posts small blind $0.25
Myles.M31: posts big blind $0.50
*** HOLE CARDS ***
pudge.3096: folds 
kastellani87: calls $0.50
$lavik88: folds 
Mc57Arnold: raises $1.50 to $2
MonplDCmax: folds 
christyirish: calls $2
gjiovano joins the table at seat #5 
84d83473r: folds 
Myles.M31: calls $1.50
kastellani87: calls $1.50
*** FLOP *** [Qc Js 8h]
Myles.M31: checks 
kastellani87: checks 
Mc57Arnold: checks 
christyirish: checks 
*** TURN *** [Qc Js 8h] [5s]
Myles.M31: checks 
kastellani87: checks 
Mc57Arnold: bets $3.92
christyirish: calls $3.92
Myles.M31: calls $3.92
kastellani87: folds 
*** RIVER *** [Qc Js 8h 5s] [Qs]
Myles.M31: checks 
Mc57Arnold: checks 
christyirish: bets $14.26
Myles.M31: folds 
Mc57Arnold: folds 
Uncalled bet ($14.26) returned to christyirish
christyirish collected $19.01 from pot
christyirish: doesn't show hand 
*** SUMMARY ***
Total pot $20.01 | Rake $1 
Board [Qc Js 8h 5s Qs]
Seat 1: Myles.M31 (big blind) folded on the River
Seat 2: pudge.3096 folded before Flop (didn't bet)
Seat 3: kastellani87 folded on the Turn
Seat 4: $lavik88 folded before Flop (didn't bet)
Seat 6: Mc57Arnold folded on the River
Seat 7: MonplDCmax folded before Flop (didn't bet)
Seat 8: christyirish (button) collected ($19.01)
Seat 9: 84d83473r (small blind) folded before Flop



PokerStars Hand #228695242437:  Hold'em No Limit ($0.25/$0.50 USD) - 2021/07/30 21:29:12 ET
Table 'Gorgo III' 9-max Seat #9 is the button
Seat 1: Myles.M31 ($44.08 in chips) 
Seat 2: pudge.3096 ($71.99 in chips) 
Seat 3: kastellani87 ($138.78 in chips) 
Seat 4: $lavik88 ($50.75 in chips) 
Seat 5: gjiovano ($28.23 in chips) 
Seat 6: Mc57Arnold ($59.94 in chips) 
Seat 7: MonplDCmax ($53.56 in chips) 
Seat 8: christyirish ($136.08 in chips) 
Seat 9: 84d83473r ($31.94 in chips) 
Myles.M31: posts small blind $0.25
pudge.3096: posts big blind $0.50
gjiovano: posts big blind $0.50
*** HOLE CARDS ***
kastellani87: calls $0.50
$lavik88: folds 
gjiovano: raises $1.75 to $2.25
Mc57Arnold: folds 
MonplDCmax: folds 
christyirish: folds 
84d83473r: calls $2.25
Myles.M31: calls $2
pudge.3096: calls $1.75
kastellani87: folds 
*** FLOP *** [9h Jc 2s]
Myles.M31: checks 
pudge.3096: checks 
gjiovano: bets $4.51
84d83473r: folds 
Myles.M31: calls $4.51
pudge.3096: folds 
*** TURN *** [9h Jc 2s] [Qs]
Myles.M31: checks 
gjiovano: checks 
*** RIVER *** [9h Jc 2s Qs] [4h]
Myles.M31: checks 
gjiovano: checks 
*** SHOW DOWN ***
Myles.M31: shows [7h Js] (a pair of Jacks)
gjiovano: mucks hand 
Myles.M31 collected $17.59 from pot
*** SUMMARY ***
Total pot $18.52 | Rake $0.93 
Board [9h Jc 2s Qs 4h]
Seat 1: Myles.M31 (small blind) showed [7h Js] and won ($17.59) with a pair of Jacks
Seat 2: pudge.3096 (big blind) folded on the Flop
Seat 3: kastellani87 folded before Flop
Seat 4: $lavik88 folded before Flop (didn't bet)
Seat 5: gjiovano mucked
Seat 6: Mc57Arnold folded before Flop (didn't bet)
Seat 7: MonplDCmax folded before Flop (didn't bet)
Seat 8: christyirish folded before Flop (didn't bet)
Seat 9: 84d83473r (button) folded on the Flop



PokerStars Hand #228695259992:  Hold'em No Limit ($0.25/$0.50 USD) - 2021/07/30 21:30:23 ET
Table 'Gorgo III' 9-max Seat #1 is the button
Seat 1: Myles.M31 ($54.91 in chips) 
Seat 2: pudge.3096 ($69.74 in chips) 
Seat 3: kastellani87 ($138.28 in chips) 
Seat 4: $lavik88 ($50.75 in chips) 
Seat 5: gjiovano ($21.47 in chips) 
Seat 6: Mc57Arnold ($59.94 in chips) 
Seat 7: MonplDCmax ($53.56 in chips) 
Seat 8: christyirish ($136.08 in chips) 
Seat 9: 84d83473r ($29.69 in chips) 
pudge.3096: posts small blind $0.25
kastellani87: posts big blind $0.50
*** HOLE CARDS ***
$lavik88: folds 
gjiovano: folds 
Mc57Arnold: folds 
MonplDCmax: folds 
christyirish: raises $1 to $1.50
84d83473r: folds 
Myles.M31: folds 
pudge.3096: folds 
kastellani87: folds 
Uncalled bet ($1) returned to christyirish
christyirish collected $1.25 from pot
christyirish: doesn't show hand 
*** SUMMARY ***
Total pot $1.25 | Rake $0 
Seat 1: Myles.M31 (button) folded before Flop (didn't bet)
Seat 2: pudge.3096 (small blind) folded before Flop
Seat 3: kastellani87 (big blind) folded before Flop
Seat 4: $lavik88 folded before Flop (didn't bet)
Seat 5: gjiovano folded before Flop (didn't bet)
Seat 6: Mc57Arnold folded before Flop (didn't bet)
Seat 7: MonplDCmax folded before Flop (didn't bet)
Seat 8: christyirish collected ($1.25)
Seat 9: 84d83473r folded before Flop (didn't bet)



PokerStars Hand #228695264108:  Hold'em No Limit ($0.25/$0.50 USD) - 2021/07/30 21:30:39 ET
Table 'Gorgo III' 9-max Seat #2 is the button
Seat 1: Myles.M31 ($54.91 in chips) 
Seat 2: pudge.3096 ($69.49 in chips) 
Seat 3: kastellani87 ($137.78 in chips) 
Seat 4: $lavik88 ($50.75 in chips) 
Seat 5: gjiovano ($21.47 in chips) 
Seat 6: Mc57Arnold ($59.94 in chips) 
Seat 7: MonplDCmax ($53.56 in chips) 
Seat 8: christyirish ($136.83 in chips) 
Seat 9: 84d83473r ($29.69 in chips) 
kastellani87: posts small blind $0.25
$lavik88: posts big blind $0.50
*** HOLE CARDS ***
gjiovano: raises $1.25 to $1.75
Mc57Arnold: folds 
MonplDCmax: folds 
christyirish: folds 
84d83473r: folds 
Myles.M31: calls $1.75
pudge.3096: folds 
kastellani87: folds 
$lavik88: calls $1.25
*** FLOP *** [Jd 8d 7s]
$lavik88: checks 
gjiovano: bets $2.61
Myles.M31: calls $2.61
$lavik88: raises $7.39 to $10
gjiovano: calls $7.39
Myles.M31: calls $7.39
*** TURN *** [Jd 8d 7s] [6c]
$lavik88: bets $39 and is all-in
gjiovano: folds 
Myles.M31: calls $39
*** RIVER *** [Jd 8d 7s 6c] [Ts]
*** SHOW DOWN ***
$lavik88: shows [Jc 7c] (two pair, Jacks and Sevens)
Myles.M31: shows [Jh 2h] (a pair of Jacks)
$lavik88 collected $111.50 from pot
*** SUMMARY ***
Total pot $113.50 | Rake $2 
Board [Jd 8d 7s 6c Ts]
Seat 1: Myles.M31 showed [Jh 2h] and lost with a pair of Jacks
Seat 2: pudge.3096 (button) folded before Flop (didn't bet)
Seat 3: kastellani87 (small blind) folded before Flop
Seat 4: $lavik88 (big blind) showed [Jc 7c] and won ($111.50) with two pair, Jacks and Sevens
Seat 5: gjiovano folded on the Turn
Seat 6: Mc57Arnold folded before Flop (didn't bet)
Seat 7: MonplDCmax folded before Flop (didn't bet)
Seat 8: christyirish folded before Flop (didn't bet)
Seat 9: 84d83473r folded before Flop (didn't bet)



PokerStars Hand #228695279141:  Hold'em No Limit ($0.25/$0.50 USD) - 2021/07/30 21:31:40 ET
Table 'Gorgo III' 9-max Seat #3 is the button
Seat 1: Myles.M31 ($4.16 in chips) 
Seat 2: pudge.3096 ($69.49 in chips) 
Seat 3: kastellani87 ($137.53 in chips) 
Seat 4: $lavik88 ($111.50 in chips) 
Seat 5: gjiovano ($9.72 in chips) 
Seat 6: Mc57Arnold ($59.94 in chips) 
Seat 7: MonplDCmax ($53.56 in chips) 
Seat 8: christyirish ($136.83 in chips) 
Seat 9: 84d83473r ($29.69 in chips) 
$lavik88: posts small blind $0.25
gjiovano: posts big blind $0.50
*** HOLE CARDS ***
Mc57Arnold: folds 
MonplDCmax: folds 
christyirish: raises $1 to $1.50
84d83473r: folds 
Myles.M31: raises $2.66 to $4.16 and is all-in
pudge.3096: folds 
kastellani87: folds 
$lavik88: folds 
gjiovano: calls $3.66
christyirish: calls $2.66
*** FLOP *** [Qh 7d 3s]
gjiovano: checks 
christyirish: bets $12.09
gjiovano: folds 
Uncalled bet ($12.09) returned to christyirish
*** TURN *** [Qh 7d 3s] [Qc]
*** RIVER *** [Qh 7d 3s Qc] [9d]
*** SHOW DOWN ***
christyirish: shows [5d 5c] (two pair, Queens and Fives)
Myles.M31: shows [Jd 2d] (a pair of Queens)
christyirish collected $12.09 from pot
*** SUMMARY ***
Total pot $12.73 | Rake $0.64 
Board [Qh 7d 3s Qc 9d]
Seat 1: Myles.M31 showed [Jd 2d] and lost with a pair of Queens
Seat 2: pudge.3096 folded before Flop (didn't bet)
Seat 3: kastellani87 (button) folded before Flop (didn't bet)
Seat 4: $lavik88 (small blind) folded before Flop
Seat 5: gjiovano (big blind) folded on the Flop
Seat 6: Mc57Arnold folded before Flop (didn't bet)
Seat 7: MonplDCmax folded before Flop (didn't bet)
Seat 8: christyirish showed [5d 5c] and won ($12.09) with two pair, Queens and Fives
Seat 9: 84d83473r folded before Flop (didn't bet)



PokerStars Hand #228695288784:  Hold'em No Limit ($0.25/$0.50 USD) - 2021/07/30 21:32:19 ET
Table 'Gorgo III' 9-max Seat #4 is the button
Seat 2: pudge.3096 ($69.49 in chips) 
Seat 3: kastellani87 ($137.53 in chips) 
Seat 4: $lavik88 ($111.25 in chips) 
Seat 5: gjiovano ($5.56 in chips) 
Seat 6: Mc57Arnold ($59.94 in chips) 
Seat 7: MonplDCmax ($53.56 in chips) 
Seat 8: christyirish ($144.76 in chips) 
Seat 9: 84d83473r ($29.69 in chips) 
gjiovano: posts small blind $0.25
Mc57Arnold: posts big blind $0.50
*** HOLE CARDS ***
Myles.M31 leaves the table
MonplDCmax has timed out
MonplDCmax: folds 
christyirish: folds 
84d83473r: folds 
pudge.3096: folds 
kastellani87: calls $0.50
$lavik88: folds 
gjiovano: raises $5.06 to $5.56 and is all-in
Mc57Arnold: folds 
kastellani87: folds 
Uncalled bet ($5.06) returned to gjiovano
gjiovano collected $1.50 from pot
*** SUMMARY ***
Total pot $1.50 | Rake $0 
Seat 2: pudge.3096 folded before Flop (didn't bet)
Seat 3: kastellani87 folded before Flop
Seat 4: $lavik88 (button) folded before Flop (didn't bet)
Seat 5: gjiovano (small blind) collected ($1.50)
Seat 6: Mc57Arnold (big blind) folded before Flop
Seat 7: MonplDCmax folded before Flop (didn't bet)
Seat 8: christyirish folded before Flop (didn't bet)
Seat 9: 84d83473r folded before Flop (didn't bet)



PokerStars Hand #228695298442:  Hold'em No Limit ($0.25/$0.50 USD) - 2021/07/30 21:32:58 ET
Table 'Gorgo III' 9-max Seat #5 is the button
Seat 2: pudge.3096 ($69.49 in chips) 
Seat 3: kastellani87 ($137.03 in chips) 
Seat 4: $lavik88 ($111.25 in chips) 
Seat 5: gjiovano ($6.56 in chips) 
Seat 6: Mc57Arnold ($59.44 in chips) 
Seat 7: MonplDCmax ($53.56 in chips) 
Seat 8: christyirish ($144.76 in chips) 
Seat 9: 84d83473r ($29.69 in chips) 
Mc57Arnold: posts small blind $0.25
MonplDCmax: posts big blind $0.50
*** HOLE CARDS ***
christyirish: folds 
UPERAD joins the table at seat #1 
84d83473r: folds 
pudge.3096: folds 
kastellani87: folds 
$lavik88: folds 
gjiovano: raises $6.06 to $6.56 and is all-in
Mc57Arnold: calls $6.31
MonplDCmax: folds 
*** FLOP *** [9s 2d 5h]
*** TURN *** [9s 2d 5h] [Ks]
*** RIVER *** [9s 2d 5h Ks] [Jh]
*** SHOW DOWN ***
Mc57Arnold: shows [Qd Ad] (high card Ace)
gjiovano: shows [Kh 8h] (a pair of Kings)
gjiovano collected $12.77 from pot
Mc57Arnold cashed out the hand for $8.03 | Cash Out Fee $0.08
*** SUMMARY ***
Total pot $13.62 | Rake $0.85 
Board [9s 2d 5h Ks Jh]
Seat 2: pudge.3096 folded before Flop (didn't bet)
Seat 3: kastellani87 folded before Flop (didn't bet)
Seat 4: $lavik88 folded before Flop (didn't bet)
Seat 5: gjiovano (button) showed [Kh 8h] and won ($12.77) with a pair of Kings
Seat 6: Mc57Arnold (small blind) showed [Qd Ad] and lost with high card Ace (cashed out).
Seat 7: MonplDCmax (big blind) folded before Flop
Seat 8: christyirish folded before Flop (didn't bet)
Seat 9: 84d83473r folded before Flop (didn't bet)



PokerStars Hand #228695304492:  Hold'em No Limit ($0.25/$0.50 USD) - 2021/07/30 21:33:23 ET
Table 'Gorgo III' 9-max Seat #6 is the button
Seat 2: pudge.3096 ($69.49 in chips) 
Seat 3: kastellani87 ($137.03 in chips) 
Seat 4: $lavik88 ($111.25 in chips) 
Seat 5: gjiovano ($12.77 in chips) 
Seat 6: Mc57Arnold ($60.91 in chips) 
Seat 7: MonplDCmax ($53.06 in chips) 
Seat 8: christyirish ($144.76 in chips) 
Seat 9: 84d83473r ($29.69 in chips) 
MonplDCmax: posts small blind $0.25
christyirish: posts big blind $0.50
UPERAD: sits out 
*** HOLE CARDS ***
84d83473r: calls $0.50
pudge.3096: folds 
kastellani87: folds 
$lavik88: folds 
gjiovano: raises $12.27 to $12.77 and is all-in
Mc57Arnold: calls $12.77
MonplDCmax: folds 
christyirish: folds 
84d83473r: folds 
*** FLOP *** [Kc 7h 6s]
*** TURN *** [Kc 7h 6s] [7s]
*** RIVER *** [Kc 7h 6s 7s] [5h]
*** SHOW DOWN ***
gjiovano: shows [As 9c] (a pair of Sevens)
Mc57Arnold: shows [Tc Th] (two pair, Tens and Sevens)
Mc57Arnold cashed out the hand for $18.28 | Cash Out Fee $0.18
*** SUMMARY ***
Total pot $26.79 | Rake $1.34 
Board [Kc 7h 6s 7s 5h]
Seat 2: pudge.3096 folded before Flop (didn't bet)
Seat 3: kastellani87 folded before Flop (didn't bet)
Seat 4: $lavik88 folded before Flop (didn't bet)
Seat 5: gjiovano showed [As 9c] and lost with a pair of Sevens
Seat 6: Mc57Arnold (button) showed [Tc Th] and won ($25.45) with two pair, Tens and Sevens (pot not awarded as player cashed out)
Seat 7: MonplDCmax (small blind) folded before Flop
Seat 8: christyirish (big blind) folded before Flop
Seat 9: 84d83473r folded before Flop



PokerStars Hand #228695315133:  Hold'em No Limit ($0.25/$0.50 USD) - 2021/07/30 21:33:53 ET
Table 'Gorgo III' 9-max Seat #7 is the button
Seat 2: pudge.3096 ($69.49 in chips) 
Seat 3: kastellani87 ($137.03 in chips) 
Seat 4: $lavik88 ($111.25 in chips) 
Seat 6: Mc57Arnold ($66.42 in chips) 
Seat 7: MonplDCmax ($52.81 in chips) 
Seat 8: christyirish ($144.26 in chips) 
Seat 9: 84d83473r ($29.19 in chips) 
christyirish: posts small blind $0.25
84d83473r: posts big blind $0.50
UPERAD: sits out 
*** HOLE CARDS ***
gjiovano is disconnected 
pudge.3096: raises $0.75 to $1.25
kastellani87: calls $1.25
$lavik88: folds 
Mc57Arnold: folds 
MonplDCmax: folds 
christyirish: calls $1
84d83473r: calls $0.75
*** FLOP *** [Ad Kd As]
christyirish: checks 
84d83473r: bets $2.50
pudge.3096: calls $2.50
kastellani87: calls $2.50
christyirish: folds 
*** TURN *** [Ad Kd As] [6s]
84d83473r: bets $7
pudge.3096: calls $7
kastellani87: calls $7
*** RIVER *** [Ad Kd As 6s] [8d]
84d83473r: checks 
pudge.3096: checks 
kastellani87: bets $15.91
UPERAD leaves the table
84d83473r: calls $15.91
pudge.3096: folds 
*** SHOW DOWN ***
kastellani87: shows [Td Jd] (a flush, Ace high)
84d83473r: mucks hand 
kastellani87 collected $63.32 from pot
*** SUMMARY ***
Total pot $65.32 | Rake $2 
Board [Ad Kd As 6s 8d]
Seat 2: pudge.3096 folded on the River
Seat 3: kastellani87 showed [Td Jd] and won ($63.32) with a flush, Ace high
Seat 4: $lavik88 folded before Flop (didn't bet)
Seat 6: Mc57Arnold folded before Flop (didn't bet)
Seat 7: MonplDCmax (button) folded before Flop (didn't bet)
Seat 8: christyirish (small blind) folded on the Flop
Seat 9: 84d83473r (big blind) mucked



PokerStars Hand #228695339034:  Hold'em No Limit ($0.25/$0.50 USD) - 2021/07/30 21:35:14 ET
Table 'Gorgo III' 9-max Seat #8 is the button
Seat 2: pudge.3096 ($58.74 in chips) 
Seat 3: kastellani87 ($173.69 in chips) 
Seat 4: $lavik88 ($111.25 in chips) 
Seat 6: Mc57Arnold ($66.42 in chips) 
Seat 7: MonplDCmax ($52.81 in chips) 
Seat 8: christyirish ($143.01 in chips) 
Seat 9: 84d83473r ($2.53 in chips) 
84d83473r: posts small blind $0.25
pudge.3096: posts big blind $0.50
*** HOLE CARDS ***
kastellani87: folds 
$lavik88: folds 
Mc57Arnold: folds 
MonplDCmax: raises $0.81 to $1.31
christyirish: folds 
84d83473r: folds 
pudge.3096: calls $0.81
*** FLOP *** [6s Qd 7s]
oudine2 joins the table at seat #1 
pudge.3096: checks 
MonplDCmax: bets $1.33
pudge.3096: calls $1.33
*** TURN *** [6s Qd 7s] [3h]
pudge.3096: checks 
MonplDCmax: checks 
*** RIVER *** [6s Qd 7s 3h] [Ts]
pudge.3096: checks 
MonplDCmax: bets $3
pudge.3096: folds 
Uncalled bet ($3) returned to MonplDCmax
MonplDCmax collected $5.25 from pot
MonplDCmax: doesn't show hand 
*** SUMMARY ***
Total pot $5.53 | Rake $0.28 
Board [6s Qd 7s 3h Ts]
Seat 2: pudge.3096 (big blind) folded on the River
Seat 3: kastellani87 folded before Flop (didn't bet)
Seat 4: $lavik88 folded before Flop (didn't bet)
Seat 6: Mc57Arnold folded before Flop (didn't bet)
Seat 7: MonplDCmax collected ($5.25)
Seat 8: christyirish (button) folded before Flop (didn't bet)
Seat 9: 84d83473r (small blind) folded before Flop



PokerStars Hand #228695356616:  Hold'em No Limit ($0.25/$0.50 USD) - 2021/07/30 21:36:24 ET
Table 'Gorgo III' 9-max Seat #9 is the button
Seat 2: pudge.3096 ($56.10 in chips) 
Seat 3: kastellani87 ($173.69 in chips) 
Seat 4: $lavik88 ($111.25 in chips) 
Seat 6: Mc57Arnold ($66.42 in chips) 
Seat 7: MonplDCmax ($55.42 in chips) 
Seat 8: christyirish ($143.01 in chips) 
Seat 9: 84d83473r ($2.28 in chips) 
pudge.3096: posts small blind $0.25
kastellani87: posts big blind $0.50
*** HOLE CARDS ***
$lavik88: folds 
Mc57Arnold: folds 
MonplDCmax: folds 
christyirish: folds 
84d83473r: folds 
pudge.3096: folds 
Uncalled bet ($0.25) returned to kastellani87
kastellani87 collected $0.50 from pot
kastellani87: doesn't show hand 
*** SUMMARY ***
Total pot $0.50 | Rake $0 
Seat 2: pudge.3096 (small blind) folded before Flop
Seat 3: kastellani87 (big blind) collected ($0.50)
Seat 4: $lavik88 folded before Flop (didn't bet)
Seat 6: Mc57Arnold folded before Flop (didn't bet)
Seat 7: MonplDCmax folded before Flop (didn't bet)
Seat 8: christyirish folded before Flop (didn't bet)
Seat 9: 84d83473r (button) folded before Flop (didn't bet)



PokerStars Hand #228695359223:  Hold'em No Limit ($0.25/$0.50 USD) - 2021/07/30 21:36:34 ET
Table 'Gorgo III' 9-max Seat #2 is the button
Seat 2: pudge.3096 ($55.85 in chips) 
Seat 3: kastellani87 ($173.94 in chips) 
Seat 4: $lavik88 ($111.25 in chips) 
Seat 6: Mc57Arnold ($66.42 in chips) 
Seat 7: MonplDCmax ($55.42 in chips) 
Seat 8: christyirish ($143.01 in chips) 
Seat 9: 84d83473r ($2.28 in chips) 
kastellani87: posts small blind $0.25
$lavik88: posts big blind $0.50
oudine2: sits out 
*** HOLE CARDS ***
Mc57Arnold: raises $0.85 to $1.35
MonplDCmax: folds 
christyirish: folds 
84d83473r: folds 
pudge.3096: folds 
kastellani87: calls $1.10
$lavik88: folds 
*** FLOP *** [3c Td Th]
kastellani87: checks 
Mc57Arnold: bets $1.52
kastellani87: folds 
Uncalled bet ($1.52) returned to Mc57Arnold
Mc57Arnold collected $3.04 from pot
Mc57Arnold: doesn't show hand 
*** SUMMARY ***
Total pot $3.20 | Rake $0.16 
Board [3c Td Th]
Seat 2: pudge.3096 (button) folded before Flop (didn't bet)
Seat 3: kastellani87 (small blind) folded on the Flop
Seat 4: $lavik88 (big blind) folded before Flop
Seat 6: Mc57Arnold collected ($3.04)
Seat 7: MonplDCmax folded before Flop (didn't bet)
Seat 8: christyirish folded before Flop (didn't bet)
Seat 9: 84d83473r folded before Flop (didn't bet)



PokerStars Hand #228695369146:  Hold'em No Limit ($0.25/$0.50 USD) - 2021/07/30 21:37:13 ET
Table 'Gorgo III' 9-max Seat #3 is the button
Seat 2: pudge.3096 ($55.85 in chips) 
Seat 3: kastellani87 ($172.59 in chips) 
Seat 4: $lavik88 ($110.75 in chips) 
Seat 6: Mc57Arnold ($68.11 in chips) 
Seat 7: MonplDCmax ($55.42 in chips) 
Seat 8: christyirish ($143.01 in chips) 
Seat 9: 84d83473r ($2.28 in chips) 
$lavik88: posts small blind $0.25
Mc57Arnold: posts big blind $0.50
oudine2: sits out 
*** HOLE CARDS ***
MonplDCmax: folds 
christyirish: folds 
84d83473r: folds 
pudge.3096: raises $0.75 to $1.25
kastellani87: folds 
$lavik88: folds 
Mc57Arnold: folds 
Uncalled bet ($0.75) returned to pudge.3096
pudge.3096 collected $1.25 from pot
pudge.3096: doesn't show hand 
*** SUMMARY ***
Total pot $1.25 | Rake $0 
Seat 2: pudge.3096 collected ($1.25)
Seat 3: kastellani87 (button) folded before Flop (didn't bet)
Seat 4: $lavik88 (small blind) folded before Flop
Seat 6: Mc57Arnold (big blind) folded before Flop
Seat 7: MonplDCmax folded before Flop (didn't bet)
Seat 8: christyirish folded before Flop (didn't bet)
Seat 9: 84d83473r folded before Flop (didn't bet)



PokerStars Hand #228695373062:  Hold'em No Limit ($0.25/$0.50 USD) - 2021/07/30 21:37:29 ET
Table 'Gorgo III' 9-max Seat #4 is the button
Seat 2: pudge.3096 ($56.60 in chips) 
Seat 3: kastellani87 ($172.59 in chips) 
Seat 4: $lavik88 ($110.50 in chips) 
Seat 6: Mc57Arnold ($67.61 in chips) 
Seat 7: MonplDCmax ($55.42 in chips) 
Seat 8: christyirish ($143.01 in chips) 
Seat 9: 84d83473r ($2.28 in chips) 
Mc57Arnold: posts small blind $0.25
MonplDCmax: posts big blind $0.50
oudine2: sits out 
*** HOLE CARDS ***
christyirish: raises $1 to $1.50
84d83473r: folds 
pudge.3096: folds 
kastellani87: folds 
$lavik88: folds 
Mc57Arnold: folds 
MonplDCmax: folds 
Uncalled bet ($1) returned to christyirish
christyirish collected $1.25 from pot
christyirish: doesn't show hand 
*** SUMMARY ***
Total pot $1.25 | Rake $0 
Seat 2: pudge.3096 folded before Flop (didn't bet)
Seat 3: kastellani87 folded before Flop (didn't bet)
Seat 4: $lavik88 (button) folded before Flop (didn't bet)
Seat 6: Mc57Arnold (small blind) folded before Flop
Seat 7: MonplDCmax (big blind) folded before Flop
Seat 8: christyirish collected ($1.25)
Seat 9: 84d83473r folded before Flop (didn't bet)



PokerStars Hand #228695379055:  Hold'em No Limit ($0.25/$0.50 USD) - 2021/07/30 21:37:53 ET
Table 'Gorgo III' 9-max Seat #6 is the button
Seat 2: pudge.3096 ($56.60 in chips) 
Seat 3: kastellani87 ($172.59 in chips) 
Seat 4: $lavik88 ($110.50 in chips) 
Seat 6: Mc57Arnold ($67.36 in chips) 
Seat 7: MonplDCmax ($54.92 in chips) 
Seat 8: christyirish ($143.76 in chips) 
Seat 9: 84d83473r ($2.28 in chips) 
MonplDCmax: posts small blind $0.25
christyirish: posts big blind $0.50
oudine2: sits out 
*** HOLE CARDS ***
84d83473r: folds 
pudge.3096: raises $0.75 to $1.25
kastellani87: calls $1.25
$lavik88: folds 
Mc57Arnold: folds 
MonplDCmax: folds 
christyirish: calls $0.75
*** FLOP *** [3d 5s 4s]
christyirish: checks 
pudge.3096: checks 
kastellani87: checks 
*** TURN *** [3d 5s 4s] [Ac]
christyirish: checks 
pudge.3096: checks 
kastellani87: checks 
*** RIVER *** [3d 5s 4s Ac] [2d]
christyirish: checks 
pudge.3096: checks 
kastellani87: checks 
*** SHOW DOWN ***
christyirish: shows [Kh 5h] (a straight, Ace to Five)
pudge.3096: shows [9d Jd] (a straight, Ace to Five)
kastellani87: shows [Kd Qs] (a straight, Ace to Five)
christyirish collected $1.27 from pot
pudge.3096 collected $1.27 from pot
kastellani87 collected $1.26 from pot
*** SUMMARY ***
Total pot $4 | Rake $0.20 
Board [3d 5s 4s Ac 2d]
Seat 2: pudge.3096 showed [9d Jd] and won ($1.27) with a straight, Ace to Five
Seat 3: kastellani87 showed [Kd Qs] and won ($1.26) with a straight, Ace to Five
Seat 4: $lavik88 folded before Flop (didn't bet)
Seat 6: Mc57Arnold (button) folded before Flop (didn't bet)
Seat 7: MonplDCmax (small blind) folded before Flop
Seat 8: christyirish (big blind) showed [Kh 5h] and won ($1.27) with a straight, Ace to Five
Seat 9: 84d83473r folded before Flop (didn't bet)



PokerStars Hand #228695395820:  Hold'em No Limit ($0.25/$0.50 USD) - 2021/07/30 21:39:01 ET
Table 'Gorgo III' 9-max Seat #7 is the button
Seat 2: pudge.3096 ($56.62 in chips) 
Seat 3: kastellani87 ($172.60 in chips) 
Seat 4: $lavik88 ($110.50 in chips) 
Seat 6: Mc57Arnold ($67.36 in chips) 
Seat 7: MonplDCmax ($54.67 in chips) 
Seat 8: christyirish ($143.78 in chips) 
Seat 9: 84d83473r ($2.28 in chips) 
christyirish: posts small blind $0.25
84d83473r: posts big blind $0.50
oudine2: sits out 
*** HOLE CARDS ***
pudge.3096: folds 
kastellani87: folds 
$lavik88: folds 
Mc57Arnold: folds 
MonplDCmax: folds 
christyirish: raises $1 to $1.50
84d83473r: raises $0.78 to $2.28 and is all-in
christyirish: calls $0.78
*** FLOP *** [7d 7c 9h]
*** TURN *** [7d 7c 9h] [6h]
*** RIVER *** [7d 7c 9h 6h] [6s]
*** SHOW DOWN ***
christyirish: shows [Qs Qc] (two pair, Queens and Sevens)
84d83473r: shows [Kh Td] (two pair, Sevens and Sixes)
christyirish collected $4.33 from pot
*** SUMMARY ***
Total pot $4.56 | Rake $0.23 
Board [7d 7c 9h 6h 6s]
Seat 2: pudge.3096 folded before Flop (didn't bet)
Seat 3: kastellani87 folded before Flop (didn't bet)
Seat 4: $lavik88 folded before Flop (didn't bet)
Seat 6: Mc57Arnold folded before Flop (didn't bet)
Seat 7: MonplDCmax (button) folded before Flop (didn't bet)
Seat 8: christyirish (small blind) showed [Qs Qc] and won ($4.33) with two pair, Queens and Sevens
Seat 9: 84d83473r (big blind) showed [Kh Td] and lost with two pair, Sevens and Sixes



PokerStars Hand #228695405951:  Hold'em No Limit ($0.25/$0.50 USD) - 2021/07/30 21:39:41 ET
Table 'Gorgo III' 9-max Seat #8 is the button
Seat 2: pudge.3096 ($56.62 in chips) 
Seat 3: kastellani87 ($172.60 in chips) 
Seat 4: $lavik88 ($110.50 in chips) 
Seat 6: Mc57Arnold ($67.36 in chips) 
Seat 7: MonplDCmax ($54.67 in chips) 
Seat 8: christyirish ($145.83 in chips) 
pudge.3096: posts small blind $0.25
kastellani87: posts big blind $0.50
*** HOLE CARDS ***
$lavik88: folds 
Mc57Arnold: raises $0.85 to $1.35
MonplDCmax: folds 
christyirish: folds 
pudge.3096: folds 
84d83473r leaves the table
kastellani87: calls $0.85
*** FLOP *** [Js Tc Ah]
kastellani87: checks 
Mc57Arnold: bets $1.88
WrongButton joins the table at seat #9 
kastellani87: folds 
Uncalled bet ($1.88) returned to Mc57Arnold
Mc57Arnold collected $2.80 from pot
Mc57Arnold: doesn't show hand 
*** SUMMARY ***
Total pot $2.95 | Rake $0.15 
Board [Js Tc Ah]
Seat 2: pudge.3096 (small blind) folded before Flop
Seat 3: kastellani87 (big blind) folded on the Flop
Seat 4: $lavik88 folded before Flop (didn't bet)
Seat 6: Mc57Arnold collected ($2.80)
Seat 7: MonplDCmax folded before Flop (didn't bet)
Seat 8: christyirish (button) folded before Flop (didn't bet)



PokerStars Hand #228695411950:  Hold'em No Limit ($0.25/$0.50 USD) - 2021/07/30 21:40:05 ET
Table 'Gorgo III' 9-max Seat #2 is the button
Seat 2: pudge.3096 ($56.37 in chips) 
Seat 3: kastellani87 ($171.25 in chips) 
Seat 4: $lavik88 ($110.50 in chips) 
Seat 6: Mc57Arnold ($68.81 in chips) 
Seat 7: MonplDCmax ($54.67 in chips) 
Seat 8: christyirish ($145.83 in chips) 
kastellani87: posts small blind $0.25
$lavik88: posts big blind $0.50
WrongButton: sits out 
oudine2: sits out 
*** HOLE CARDS ***
Mc57Arnold: raises $0.85 to $1.35
WrongButton leaves the table
MonplDCmax: calls $1.35
christyirish: folds 
pudge.3096: folds 
kastellani87: calls $1.10
$lavik88: folds 
*** FLOP *** [9c 4d Td]
kastellani87: checks 
Mc57Arnold: checks 
MonplDCmax: checks 
*** TURN *** [9c 4d Td] [5s]
kastellani87: checks 
Mc57Arnold: checks 
MonplDCmax: checks 
*** RIVER *** [9c 4d Td 5s] [Jd]
kastellani87: checks 
Mc57Arnold: checks 
MonplDCmax: checks 
*** SHOW DOWN ***
kastellani87: shows [6d 6s] (a pair of Sixes)
Mc57Arnold: shows [7h 7c] (a pair of Sevens)
MonplDCmax: shows [Qh Jh] (a pair of Jacks)
MonplDCmax collected $4.32 from pot
*** SUMMARY ***
Total pot $4.55 | Rake $0.23 
Board [9c 4d Td 5s Jd]
Seat 2: pudge.3096 (button) folded before Flop (didn't bet)
Seat 3: kastellani87 (small blind) showed [6d 6s] and lost with a pair of Sixes
Seat 4: $lavik88 (big blind) folded before Flop
Seat 6: Mc57Arnold showed [7h 7c] and lost with a pair of Sevens
Seat 7: MonplDCmax showed [Qh Jh] and won ($4.32) with a pair of Jacks
Seat 8: christyirish folded before Flop (didn't bet)



PokerStars Hand #228695429454:  Hold'em No Limit ($0.25/$0.50 USD) - 2021/07/30 21:41:15 ET
Table 'Gorgo III' 9-max Seat #3 is the button
Seat 2: pudge.3096 ($56.37 in chips) 
Seat 3: kastellani87 ($169.90 in chips) 
Seat 4: $lavik88 ($110 in chips) 
Seat 6: Mc57Arnold ($67.46 in chips) 
Seat 7: MonplDCmax ($57.64 in chips) 
Seat 8: christyirish ($145.83 in chips) 
$lavik88: posts small blind $0.25
Mc57Arnold: posts big blind $0.50
oudine2: sits out 
*** HOLE CARDS ***
fragonik joins the table at seat #9 
MonplDCmax: folds 
christyirish: folds 
pudge.3096: folds 
kastellani87: calls $0.50
$lavik88: calls $0.25
Mc57Arnold: checks 
*** FLOP *** [2h Ks 6d]
$lavik88: checks 
Mc57Arnold: checks 
kastellani87: checks 
*** TURN *** [2h Ks 6d] [Tc]
$lavik88: checks 
Mc57Arnold: checks 
kastellani87: checks 
*** RIVER *** [2h Ks 6d Tc] [4c]
$lavik88: checks 
Mc57Arnold: checks 
kastellani87: checks 
*** SHOW DOWN ***
$lavik88: shows [Jh 3h] (high card King)
Mc57Arnold: mucks hand 
kastellani87: shows [Ac 6s] (a pair of Sixes)
kastellani87 collected $1.42 from pot
*** SUMMARY ***
Total pot $1.50 | Rake $0.08 
Board [2h Ks 6d Tc 4c]
Seat 2: pudge.3096 folded before Flop (didn't bet)
Seat 3: kastellani87 (button) showed [Ac 6s] and won ($1.42) with a pair of Sixes
Seat 4: $lavik88 (small blind) showed [Jh 3h] and lost with high card King
Seat 6: Mc57Arnold (big blind) mucked
Seat 7: MonplDCmax folded before Flop (didn't bet)
Seat 8: christyirish folded before Flop (didn't bet)



PokerStars Hand #228695450451:  Hold'em No Limit ($0.25/$0.50 USD) - 2021/07/30 21:42:11 ET
Table 'Gorgo III' 9-max Seat #4 is the button
Seat 2: pudge.3096 ($56.37 in chips) 
Seat 3: kastellani87 ($170.82 in chips) 
Seat 4: $lavik88 ($109.50 in chips) 
Seat 6: Mc57Arnold ($66.96 in chips) 
Seat 7: MonplDCmax ($57.64 in chips) 
Seat 8: christyirish ($145.83 in chips) 
Mc57Arnold: posts small blind $0.25
MonplDCmax: posts big blind $0.50
fragonik: sits out 
oudine2: sits out 
*** HOLE CARDS ***
christyirish: raises $1 to $1.50
pudge.3096: folds 
kastellani87: folds 
$lavik88: folds 
Mc57Arnold: folds 
MonplDCmax: folds 
Uncalled bet ($1) returned to christyirish
christyirish collected $1.25 from pot
*** SUMMARY ***
Total pot $1.25 | Rake $0 
Seat 2: pudge.3096 folded before Flop (didn't bet)
Seat 3: kastellani87 folded before Flop (didn't bet)
Seat 4: $lavik88 (button) folded before Flop (didn't bet)
Seat 6: Mc57Arnold (small blind) folded before Flop
Seat 7: MonplDCmax (big blind) folded before Flop
Seat 8: christyirish collected ($1.25)



PokerStars Hand #228695455003:  Hold'em No Limit ($0.25/$0.50 USD) - 2021/07/30 21:42:29 ET
Table 'Gorgo III' 9-max Seat #6 is the button
Seat 2: pudge.3096 ($56.37 in chips) 
Seat 3: kastellani87 ($170.82 in chips) 
Seat 4: $lavik88 ($109.50 in chips) 
Seat 6: Mc57Arnold ($66.71 in chips) 
Seat 7: MonplDCmax ($57.14 in chips) 
Seat 8: christyirish ($146.58 in chips) 
MonplDCmax: posts small blind $0.25
christyirish: posts big blind $0.50
fragonik: sits out 
oudine2: sits out 
*** HOLE CARDS ***
pudge.3096: raises $0.75 to $1.25
kastellani87: folds 
$lavik88: folds 
Mc57Arnold: folds 
MonplDCmax: folds 
christyirish: folds 
Uncalled bet ($0.75) returned to pudge.3096
pudge.3096 collected $1.25 from pot
pudge.3096: doesn't show hand 
*** SUMMARY ***
Total pot $1.25 | Rake $0 
Seat 2: pudge.3096 collected ($1.25)
Seat 3: kastellani87 folded before Flop (didn't bet)
Seat 4: $lavik88 folded before Flop (didn't bet)
Seat 6: Mc57Arnold (button) folded before Flop (didn't bet)
Seat 7: MonplDCmax (small blind) folded before Flop
Seat 8: christyirish (big blind) folded before Flop



PokerStars Hand #228695470937:  Hold'em No Limit ($0.25/$0.50 USD) - 2021/07/30 21:42:54 ET
Table 'Gorgo III' 9-max Seat #7 is the button
Seat 2: pudge.3096 ($57.12 in chips) 
Seat 3: kastellani87 ($170.82 in chips) 
Seat 4: $lavik88 ($109.50 in chips) 
Seat 6: Mc57Arnold ($66.71 in chips) 
Seat 7: MonplDCmax ($56.89 in chips) 
Seat 8: christyirish ($146.08 in chips) 
Seat 9: fragonik ($74.33 in chips) 
christyirish: posts small blind $0.25
fragonik: posts big blind $0.50
oudine2: sits out 
*** HOLE CARDS ***
pudge.3096: folds 
kastellani87: calls $0.50
$lavik88: folds 
Mc57Arnold: folds 
MonplDCmax: folds 
christyirish: folds 
fragonik: checks 
*** FLOP *** [Th 8c Qh]
fragonik: bets $0.58
kastellani87: folds 
Uncalled bet ($0.58) returned to fragonik
fragonik collected $1.19 from pot
*** SUMMARY ***
Total pot $1.25 | Rake $0.06 
Board [Th 8c Qh]
Seat 2: pudge.3096 folded before Flop (didn't bet)
Seat 3: kastellani87 folded on the Flop
Seat 4: $lavik88 folded before Flop (didn't bet)
Seat 6: Mc57Arnold folded before Flop (didn't bet)
Seat 7: MonplDCmax (button) folded before Flop (didn't bet)
Seat 8: christyirish (small blind) folded before Flop
Seat 9: fragonik (big blind) collected ($1.19)



PokerStars Hand #228695476898:  Hold'em No Limit ($0.25/$0.50 USD) - 2021/07/30 21:43:18 ET
Table 'Gorgo III' 9-max Seat #8 is the button
Seat 1: oudine2 ($50 in chips) 
Seat 2: pudge.3096 ($57.12 in chips) 
Seat 3: kastellani87 ($170.32 in chips) 
Seat 4: $lavik88 ($109.50 in chips) 
Seat 6: Mc57Arnold ($66.71 in chips) 
Seat 7: MonplDCmax ($56.89 in chips) 
Seat 8: christyirish ($145.83 in chips) 
Seat 9: fragonik ($75.02 in chips) 
fragonik: posts small blind $0.25
oudine2: posts big blind $0.50
*** HOLE CARDS ***
pudge.3096: folds 
kastellani87: folds 
$lavik88: folds 
Mc57Arnold: folds 
MonplDCmax: folds 
christyirish: folds 
fragonik: raises $1 to $1.50
oudine2: folds 
Uncalled bet ($1) returned to fragonik
fragonik collected $1 from pot
*** SUMMARY ***
Total pot $1 | Rake $0 
Seat 1: oudine2 (big blind) folded before Flop
Seat 2: pudge.3096 folded before Flop (didn't bet)
Seat 3: kastellani87 folded before Flop (didn't bet)
Seat 4: $lavik88 folded before Flop (didn't bet)
Seat 6: Mc57Arnold folded before Flop (didn't bet)
Seat 7: MonplDCmax folded before Flop (didn't bet)
Seat 8: christyirish (button) folded before Flop (didn't bet)
Seat 9: fragonik (small blind) collected ($1)



PokerStars Hand #228695482685:  Hold'em No Limit ($0.25/$0.50 USD) - 2021/07/30 21:43:42 ET
Table 'Gorgo III' 9-max Seat #9 is the button
Seat 1: oudine2 ($50 in chips) 
Seat 2: pudge.3096 ($57.12 in chips) 
Seat 3: kastellani87 ($170.32 in chips) 
Seat 4: $lavik88 ($109.50 in chips) 
Seat 6: Mc57Arnold ($66.71 in chips) 
Seat 7: MonplDCmax ($56.89 in chips) 
Seat 8: christyirish ($145.83 in chips) 
Seat 9: fragonik ($75.52 in chips) 
oudine2: posts small blind $0.25
pudge.3096: posts big blind $0.50
*** HOLE CARDS ***
kastellani87: calls $0.50
$lavik88: folds 
Mc57Arnold: raises $1.50 to $2
gjiovano was removed from the table for failing to post
gjiovano leaves the table
MonplDCmax: folds 
christyirish: folds 
fragonik: folds 
oudine2: folds 
Lago Madjore joins the table at seat #5 
pudge.3096: folds 
kastellani87: calls $1.50
*** FLOP *** [8c 5h 2h]
kastellani87: checks 
Mc57Arnold: bets $3.02
kastellani87: folds 
Uncalled bet ($3.02) returned to Mc57Arnold
Mc57Arnold collected $4.51 from pot
Mc57Arnold: doesn't show hand 
*** SUMMARY ***
Total pot $4.75 | Rake $0.24 
Board [8c 5h 2h]
Seat 1: oudine2 (small blind) folded before Flop
Seat 2: pudge.3096 (big blind) folded before Flop
Seat 3: kastellani87 folded on the Flop
Seat 4: $lavik88 folded before Flop (didn't bet)
Seat 6: Mc57Arnold collected ($4.51)
Seat 7: MonplDCmax folded before Flop (didn't bet)
Seat 8: christyirish folded before Flop (didn't bet)
Seat 9: fragonik (button) folded before Flop (didn't bet)



PokerStars Hand #228695498662:  Hold'em No Limit ($0.25/$0.50 USD) - 2021/07/30 21:44:46 ET
Table 'Gorgo III' 9-max Seat #1 is the button
Seat 1: oudine2 ($50 in chips) 
Seat 2: pudge.3096 ($56.62 in chips) 
Seat 3: kastellani87 ($168.32 in chips) 
Seat 4: $lavik88 ($109.50 in chips) 
Seat 6: Mc57Arnold ($69.22 in chips) 
Seat 7: MonplDCmax ($56.89 in chips) 
Seat 8: christyirish ($145.83 in chips) 
Seat 9: fragonik ($75.52 in chips) 
pudge.3096: posts small blind $0.25
kastellani87: posts big blind $0.50
Lago Madjore: sits out 
*** HOLE CARDS ***
$lavik88: folds 
Mc57Arnold: folds 
MonplDCmax: folds 
christyirish has timed out
christyirish: folds 
fragonik: raises $0.75 to $1.25
oudine2: folds 
pudge.3096: folds 
kastellani87: raises $2.75 to $4
fragonik: calls $2.75
*** FLOP *** [4d 9c Qh]
kastellani87: checks 
fragonik: checks 
*** TURN *** [4d 9c Qh] [Tc]
kastellani87: checks 
fragonik: bets $3.84
kastellani87: raises $3.84 to $7.68
fragonik: calls $3.84
*** RIVER *** [4d 9c Qh Tc] [8h]
kastellani87: bets $22.43
fragonik: calls $22.43
*** SHOW DOWN ***
kastellani87: shows [Kc Jd] (a straight, Nine to King)
fragonik: mucks hand 
kastellani87 collected $66.47 from pot
*** SUMMARY ***
Total pot $68.47 | Rake $2 
Board [4d 9c Qh Tc 8h]
Seat 1: oudine2 (button) folded before Flop (didn't bet)
Seat 2: pudge.3096 (small blind) folded before Flop
Seat 3: kastellani87 (big blind) showed [Kc Jd] and won ($66.47) with a straight, Nine to King
Seat 4: $lavik88 folded before Flop (didn't bet)
Seat 6: Mc57Arnold folded before Flop (didn't bet)
Seat 7: MonplDCmax folded before Flop (didn't bet)
Seat 8: christyirish folded before Flop (didn't bet)
Seat 9: fragonik mucked



PokerStars Hand #228695526602:  Hold'em No Limit ($0.25/$0.50 USD) - 2021/07/30 21:46:40 ET
Table 'Gorgo III' 9-max Seat #2 is the button
Seat 1: oudine2 ($50 in chips) 
Seat 2: pudge.3096 ($56.37 in chips) 
Seat 3: kastellani87 ($200.68 in chips) 
Seat 4: $lavik88 ($109.50 in chips) 
Seat 6: Mc57Arnold ($69.22 in chips) 
Seat 7: MonplDCmax ($56.89 in chips) 
Seat 8: christyirish ($145.83 in chips) 
Seat 9: fragonik ($50 in chips) 
kastellani87: posts small blind $0.25
$lavik88: posts big blind $0.50
Lago Madjore: sits out 
*** HOLE CARDS ***
Mc57Arnold: folds 
Mc57Arnold leaves the table
MonplDCmax: folds 
christyirish: folds 
fragonik: raises $0.75 to $1.25
oudine2: folds 
pudge.3096: folds 
kastellani87: folds 
$lavik88: folds 
Uncalled bet ($0.75) returned to fragonik
fragonik collected $1.25 from pot
*** SUMMARY ***
Total pot $1.25 | Rake $0 
Seat 1: oudine2 folded before Flop (didn't bet)
Seat 2: pudge.3096 (button) folded before Flop (didn't bet)
Seat 3: kastellani87 (small blind) folded before Flop
Seat 4: $lavik88 (big blind) folded before Flop
Seat 6: Mc57Arnold folded before Flop (didn't bet)
Seat 7: MonplDCmax folded before Flop (didn't bet)
Seat 8: christyirish folded before Flop (didn't bet)
Seat 9: fragonik collected ($1.25)



PokerStars Hand #228695531872:  Hold'em No Limit ($0.25/$0.50 USD) - 2021/07/30 21:47:01 ET
Table 'Gorgo III' 9-max Seat #3 is the button
Seat 1: oudine2 ($50 in chips) 
Seat 2: pudge.3096 ($56.37 in chips) 
Seat 3: kastellani87 ($200.43 in chips) 
Seat 4: $lavik88 ($109 in chips) 
Seat 5: Lago Madjore ($50 in chips) 
Seat 7: MonplDCmax ($56.89 in chips) 
Seat 8: christyirish ($145.83 in chips) 
Seat 9: fragonik ($50.75 in chips) 
$lavik88: posts small blind $0.25
Lago Madjore: posts big blind $0.50
*** HOLE CARDS ***
MonplDCmax: folds 
christyirish: folds 
fragonik: folds 
oudine2: folds 
pudge.3096: raises $0.75 to $1.25
kastellani87: folds 
$lavik88: folds 
Lago Madjore: folds 
Uncalled bet ($0.75) returned to pudge.3096
pudge.3096 collected $1.25 from pot
pudge.3096: doesn't show hand 
*** SUMMARY ***
Total pot $1.25 | Rake $0 
Seat 1: oudine2 folded before Flop (didn't bet)
Seat 2: pudge.3096 collected ($1.25)
Seat 3: kastellani87 (button) folded before Flop (didn't bet)
Seat 4: $lavik88 (small blind) folded before Flop
Seat 5: Lago Madjore (big blind) folded before Flop
Seat 7: MonplDCmax folded before Flop (didn't bet)
Seat 8: christyirish folded before Flop (didn't bet)
Seat 9: fragonik folded before Flop (didn't bet)



PokerStars Hand #228695537018:  Hold'em No Limit ($0.25/$0.50 USD) - 2021/07/30 21:47:22 ET
Table 'Gorgo III' 9-max Seat #4 is the button
Seat 1: oudine2 ($50 in chips) 
Seat 2: pudge.3096 ($57.12 in chips) 
Seat 3: kastellani87 ($200.43 in chips) 
Seat 4: $lavik88 ($108.75 in chips) 
Seat 5: Lago Madjore ($50 in chips) 
Seat 8: christyirish ($145.83 in chips) 
Seat 9: fragonik ($50.75 in chips) 
Lago Madjore: posts small blind $0.25
MonplDCmax: is sitting out 
christyirish: posts big blind $0.50
*** HOLE CARDS ***
fragonik: folds 
oudine2: folds 
pudge.3096: folds 
MonplDCmax leaves the table
kastellani87: calls $0.50
$lavik88: folds 
Lago Madjore: folds 
christyirish: checks 
*** FLOP *** [Jd 7s 4c]
christyirish: checks 
kastellani87: checks 
*** TURN *** [Jd 7s 4c] [6d]
christyirish: checks 
kastellani87: checks 
*** RIVER *** [Jd 7s 4c 6d] [Qs]
christyirish: checks 
kastellani87: checks 
*** SHOW DOWN ***
christyirish: shows [8h 2h] (high card Queen)
kastellani87: shows [5c Ad] (high card Ace)
kastellani87 collected $1.19 from pot
*** SUMMARY ***
Total pot $1.25 | Rake $0.06 
Board [Jd 7s 4c 6d Qs]
Seat 1: oudine2 folded before Flop (didn't bet)
Seat 2: pudge.3096 folded before Flop (didn't bet)
Seat 3: kastellani87 showed [5c Ad] and won ($1.19) with high card Ace
Seat 4: $lavik88 (button) folded before Flop (didn't bet)
Seat 5: Lago Madjore (small blind) folded before Flop
Seat 8: christyirish (big blind) showed [8h 2h] and lost with high card Queen
Seat 9: fragonik folded before Flop (didn't bet)



PokerStars Hand #228695547003:  Hold'em No Limit ($0.25/$0.50 USD) - 2021/07/30 21:48:03 ET
Table 'Gorgo III' 9-max Seat #5 is the button
Seat 1: oudine2 ($50 in chips) 
Seat 2: pudge.3096 ($57.12 in chips) 
Seat 3: kastellani87 ($201.12 in chips) 
Seat 4: $lavik88 ($108.75 in chips) 
Seat 5: Lago Madjore ($50 in chips) 
Seat 8: christyirish ($145.33 in chips) 
Seat 9: fragonik ($50.75 in chips) 
christyirish: posts small blind $0.25
fragonik: posts big blind $0.50
*** HOLE CARDS ***
oudine2: folds 
pudge.3096: folds 
kastellani87: raises $0.50 to $1
$lavik88: folds 
Lago Madjore: folds 
christyirish: folds 
fragonik: folds 
Uncalled bet ($0.50) returned to kastellani87
kastellani87 collected $1.25 from pot
kastellani87: doesn't show hand 
*** SUMMARY ***
Total pot $1.25 | Rake $0 
Seat 1: oudine2 folded before Flop (didn't bet)
Seat 2: pudge.3096 folded before Flop (didn't bet)
Seat 3: kastellani87 collected ($1.25)
Seat 4: $lavik88 folded before Flop (didn't bet)
Seat 5: Lago Madjore (button) folded before Flop (didn't bet)
Seat 8: christyirish (small blind) folded before Flop
Seat 9: fragonik (big blind) folded before Flop



PokerStars Hand #228695553105:  Hold'em No Limit ($0.25/$0.50 USD) - 2021/07/30 21:48:28 ET
Table 'Gorgo III' 9-max Seat #8 is the button
Seat 2: pudge.3096 ($57.12 in chips) 
Seat 3: kastellani87 ($201.87 in chips) 
Seat 4: $lavik88 ($108.75 in chips) 
Seat 5: Lago Madjore ($50 in chips) 
Seat 8: christyirish ($145.08 in chips) 
Seat 9: fragonik ($50.25 in chips) 
fragonik: posts small blind $0.25
oudine2: is sitting out 
pudge.3096: posts big blind $0.50
*** HOLE CARDS ***
oudine2 leaves the table
kastellani87: folds 
$lavik88: folds 
Lago Madjore: raises $0.62 to $1.12
christyirish: folds 
fragonik: folds 
pudge.3096: folds 
Uncalled bet ($0.62) returned to Lago Madjore
Lago Madjore collected $1.25 from pot
*** SUMMARY ***
Total pot $1.25 | Rake $0 
Seat 2: pudge.3096 (big blind) folded before Flop
Seat 3: kastellani87 folded before Flop (didn't bet)
Seat 4: $lavik88 folded before Flop (didn't bet)
Seat 5: Lago Madjore collected ($1.25)
Seat 8: christyirish (button) folded before Flop (didn't bet)
Seat 9: fragonik (small blind) folded before Flop



PokerStars Hand #228695563594:  Hold'em No Limit ($0.25/$0.50 USD) - 2021/07/30 21:49:11 ET
Table 'Gorgo III' 9-max Seat #9 is the button
Seat 2: pudge.3096 ($56.62 in chips) 
Seat 3: kastellani87 ($201.87 in chips) 
Seat 4: $lavik88 ($108.75 in chips) 
Seat 5: Lago Madjore ($50.75 in chips) 
Seat 8: christyirish ($145.08 in chips) 
Seat 9: fragonik ($50 in chips) 
pudge.3096: posts small blind $0.25
kastellani87: posts big blind $0.50
*** HOLE CARDS ***
$lavik88: folds 
Lago Madjore: folds 
christyirish: folds 
fragonik: raises $0.75 to $1.25
pudge.3096: folds 
kastellani87: folds 
Uncalled bet ($0.75) returned to fragonik
fragonik collected $1.25 from pot
*** SUMMARY ***
Total pot $1.25 | Rake $0 
Seat 2: pudge.3096 (small blind) folded before Flop
Seat 3: kastellani87 (big blind) folded before Flop
Seat 4: $lavik88 folded before Flop (didn't bet)
Seat 5: Lago Madjore folded before Flop (didn't bet)
Seat 8: christyirish folded before Flop (didn't bet)
Seat 9: fragonik (button) collected ($1.25)



PokerStars Hand #228695565986:  Hold'em No Limit ($0.25/$0.50 USD) - 2021/07/30 21:49:21 ET
Table 'Gorgo III' 9-max Seat #2 is the button
Seat 2: pudge.3096 ($56.37 in chips) 
Seat 3: kastellani87 ($201.37 in chips) 
Seat 4: $lavik88 ($108.75 in chips) 
Seat 5: Lago Madjore ($50.75 in chips) 
Seat 8: christyirish ($145.08 in chips) 
Seat 9: fragonik ($50.75 in chips) 
kastellani87: posts small blind $0.25
$lavik88: posts big blind $0.50
*** HOLE CARDS ***
Lago Madjore: folds 
christyirish: folds 
fragonik: folds 
Lago Madjore leaves the table
pudge.3096: folds 
kastellani87: calls $0.25
$lavik88: raises $1.50 to $2
kastellani87: folds 
Uncalled bet ($1.50) returned to $lavik88
$lavik88 collected $1 from pot
$lavik88: doesn't show hand 
*** SUMMARY ***
Total pot $1 | Rake $0 
Seat 2: pudge.3096 (button) folded before Flop (didn't bet)
Seat 3: kastellani87 (small blind) folded before Flop
Seat 4: $lavik88 (big blind) collected ($1)
Seat 5: Lago Madjore folded before Flop (didn't bet)
Seat 8: christyirish folded before Flop (didn't bet)
Seat 9: fragonik folded before Flop (didn't bet)



PokerStars Hand #228695571888:  Hold'em No Limit ($0.25/$0.50 USD) - 2021/07/30 21:49:45 ET
Table 'Gorgo III' 9-max Seat #3 is the button
Seat 2: pudge.3096 ($56.37 in chips) 
Seat 3: kastellani87 ($200.87 in chips) 
Seat 4: $lavik88 ($109.25 in chips) 
Seat 8: christyirish ($145.08 in chips) 
Seat 9: fragonik ($50.75 in chips) 
$lavik88: posts small blind $0.25
christyirish: posts big blind $0.50
*** HOLE CARDS ***
fragonik: folds 
pudge.3096: folds 
kastellani87: folds 
$lavik88: folds 
Uncalled bet ($0.25) returned to christyirish
christyirish collected $0.50 from pot
*** SUMMARY ***
Total pot $0.50 | Rake $0 
Seat 2: pudge.3096 folded before Flop (didn't bet)
Seat 3: kastellani87 (button) folded before Flop (didn't bet)
Seat 4: $lavik88 (small blind) folded before Flop
Seat 8: christyirish (big blind) collected ($0.50)
Seat 9: fragonik folded before Flop (didn't bet)



PokerStars Hand #228695573449:  Hold'em No Limit ($0.25/$0.50 USD) - 2021/07/30 21:49:51 ET
Table 'Gorgo III' 9-max Seat #4 is the button
Seat 2: pudge.3096 ($56.37 in chips) 
Seat 3: kastellani87 ($200.87 in chips) 
Seat 4: $lavik88 ($109 in chips) 
Seat 8: christyirish ($145.33 in chips) 
Seat 9: fragonik ($50.75 in chips) 
christyirish: posts small blind $0.25
fragonik: posts big blind $0.50
*** HOLE CARDS ***
pudge.3096: raises $0.75 to $1.25
kastellani87: folds 
$lavik88: folds 
christyirish: folds 
fragonik: folds 
Uncalled bet ($0.75) returned to pudge.3096
pudge.3096 collected $1.25 from pot
pudge.3096: doesn't show hand 
*** SUMMARY ***
Total pot $1.25 | Rake $0 
Seat 2: pudge.3096 collected ($1.25)
Seat 3: kastellani87 folded before Flop (didn't bet)
Seat 4: $lavik88 (button) folded before Flop (didn't bet)
Seat 8: christyirish (small blind) folded before Flop
Seat 9: fragonik (big blind) folded before Flop



PokerStars Hand #228695577337:  Hold'em No Limit ($0.25/$0.50 USD) - 2021/07/30 21:50:07 ET
Table 'Gorgo III' 9-max Seat #8 is the button
Seat 2: pudge.3096 ($57.12 in chips) 
Seat 3: kastellani87 ($200.87 in chips) 
Seat 4: $lavik88 ($109 in chips) 
Seat 8: christyirish ($145.08 in chips) 
Seat 9: fragonik ($50.25 in chips) 
fragonik: posts small blind $0.25
pudge.3096: posts big blind $0.50
*** HOLE CARDS ***
kastellani87: calls $0.50
$lavik88: folds 
christyirish: folds 
fragonik: raises $1.75 to $2.25
pudge.3096: folds 
kastellani87: raises $7.75 to $10
fragonik: folds 
Uncalled bet ($7.75) returned to kastellani87
kastellani87 collected $5 from pot
kastellani87: doesn't show hand 
*** SUMMARY ***
Total pot $5 | Rake $0 
Seat 2: pudge.3096 (big blind) folded before Flop
Seat 3: kastellani87 collected ($5)
Seat 4: $lavik88 folded before Flop (didn't bet)
Seat 8: christyirish (button) folded before Flop (didn't bet)
Seat 9: fragonik (small blind) folded before Flop



PokerStars Hand #228695587994:  Hold'em No Limit ($0.25/$0.50 USD) - 2021/07/30 21:50:50 ET
Table 'Gorgo III' 9-max Seat #9 is the button
Seat 2: pudge.3096 ($56.62 in chips) 
Seat 3: kastellani87 ($203.62 in chips) 
Seat 4: $lavik88 ($109 in chips) 
Seat 8: christyirish ($145.08 in chips) 
Seat 9: fragonik ($50 in chips) 
pudge.3096: posts small blind $0.25
kastellani87: posts big blind $0.50
*** HOLE CARDS ***
$lavik88: folds 
christyirish: raises $1 to $1.50
fragonik: folds 
pudge.3096: folds 
kastellani87: folds 
Uncalled bet ($1) returned to christyirish
christyirish collected $1.25 from pot
*** SUMMARY ***
Total pot $1.25 | Rake $0 
Seat 2: pudge.3096 (small blind) folded before Flop
Seat 3: kastellani87 (big blind) folded before Flop
Seat 4: $lavik88 folded before Flop (didn't bet)
Seat 8: christyirish collected ($1.25)
Seat 9: fragonik (button) folded before Flop (didn't bet)



PokerStars Hand #228695590874:  Hold'em No Limit ($0.25/$0.50 USD) - 2021/07/30 21:51:02 ET
Table 'Gorgo III' 9-max Seat #2 is the button
Seat 2: pudge.3096 ($56.37 in chips) 
Seat 3: kastellani87 ($203.12 in chips) 
Seat 4: $lavik88 ($109 in chips) 
Seat 8: christyirish ($145.83 in chips) 
Seat 9: fragonik ($50 in chips) 
kastellani87: posts small blind $0.25
$lavik88: posts big blind $0.50
*** HOLE CARDS ***
christyirish: folds 
fragonik: raises $0.75 to $1.25
pudge.3096: folds 
kastellani87: calls $1
$lavik88: folds 
*** FLOP *** [9c 7c Js]
kastellani87: checks 
fragonik: checks 
*** TURN *** [9c 7c Js] [As]
kastellani87: checks 
fragonik: bets $2.25
kastellani87: folds 
Uncalled bet ($2.25) returned to fragonik
fragonik collected $2.85 from pot
*** SUMMARY ***
Total pot $3 | Rake $0.15 
Board [9c 7c Js As]
Seat 2: pudge.3096 (button) folded before Flop (didn't bet)
Seat 3: kastellani87 (small blind) folded on the Turn
Seat 4: $lavik88 (big blind) folded before Flop
Seat 8: christyirish folded before Flop (didn't bet)
Seat 9: fragonik collected ($2.85)



PokerStars Hand #228695600243:  Hold'em No Limit ($0.25/$0.50 USD) - 2021/07/30 21:51:41 ET
Table 'Gorgo III' 9-max Seat #3 is the button
Seat 2: pudge.3096 ($56.37 in chips) 
Seat 3: kastellani87 ($201.87 in chips) 
Seat 4: $lavik88 ($108.50 in chips) 
Seat 8: christyirish ($145.83 in chips) 
Seat 9: fragonik ($51.60 in chips) 
$lavik88: posts small blind $0.25
christyirish: posts big blind $0.50
*** HOLE CARDS ***
fragonik: folds 
pudge.3096: folds 
kastellani87: calls $0.50
$lavik88: folds 
christyirish: checks 
*** FLOP *** [5h 8d Td]
christyirish: checks 
kastellani87: bets $1.19
christyirish: folds 
Uncalled bet ($1.19) returned to kastellani87
kastellani87 collected $1.19 from pot
kastellani87: doesn't show hand 
*** SUMMARY ***
Total pot $1.25 | Rake $0.06 
Board [5h 8d Td]
Seat 2: pudge.3096 folded before Flop (didn't bet)
Seat 3: kastellani87 (button) collected ($1.19)
Seat 4: $lavik88 (small blind) folded before Flop
Seat 8: christyirish (big blind) folded on the Flop
Seat 9: fragonik folded before Flop (didn't bet)



PokerStars Hand #228695605769:  Hold'em No Limit ($0.25/$0.50 USD) - 2021/07/30 21:52:03 ET
Table 'Gorgo III' 9-max Seat #4 is the button
Seat 2: pudge.3096 ($56.37 in chips) 
Seat 3: kastellani87 ($202.56 in chips) 
Seat 4: $lavik88 ($108.25 in chips) 
Seat 8: christyirish ($145.33 in chips) 
Seat 9: fragonik ($51.60 in chips) 
christyirish: posts small blind $0.25
fragonik: posts big blind $0.50
*** HOLE CARDS ***
pudge.3096: folds 
kastellani87: calls $0.50
$lavik88: folds 
christyirish: calls $0.25
fragonik: raises $2.25 to $2.75
kastellani87: folds 
christyirish: folds 
Uncalled bet ($2.25) returned to fragonik
fragonik collected $1.50 from pot
*** SUMMARY ***
Total pot $1.50 | Rake $0 
Seat 2: pudge.3096 folded before Flop (didn't bet)
Seat 3: kastellani87 folded before Flop
Seat 4: $lavik88 (button) folded before Flop (didn't bet)
Seat 8: christyirish (small blind) folded before Flop
Seat 9: fragonik (big blind) collected ($1.50)



PokerStars Hand #228695612836:  Hold'em No Limit ($0.25/$0.50 USD) - 2021/07/30 21:52:32 ET
Table 'Gorgo III' 9-max Seat #8 is the button
Seat 2: pudge.3096 ($56.37 in chips) 
Seat 3: kastellani87 ($202.06 in chips) 
Seat 4: $lavik88 ($108.25 in chips) 
Seat 8: christyirish ($144.83 in chips) 
Seat 9: fragonik ($52.60 in chips) 
fragonik: posts small blind $0.25
pudge.3096: posts big blind $0.50
*** HOLE CARDS ***
kastellani87: folds 
$lavik88: folds 
christyirish: raises $1 to $1.50
fragonik: folds 
pudge.3096: folds 
Uncalled bet ($1) returned to christyirish
christyirish collected $1.25 from pot
*** SUMMARY ***
Total pot $1.25 | Rake $0 
Seat 2: pudge.3096 (big blind) folded before Flop
Seat 3: kastellani87 folded before Flop (didn't bet)
Seat 4: $lavik88 folded before Flop (didn't bet)
Seat 8: christyirish (button) collected ($1.25)
Seat 9: fragonik (small blind) folded before Flop



PokerStars Hand #228695616079:  Hold'em No Limit ($0.25/$0.50 USD) - 2021/07/30 21:52:45 ET
Table 'Gorgo III' 9-max Seat #9 is the button
Seat 2: pudge.3096 ($55.87 in chips) 
Seat 3: kastellani87 ($202.06 in chips) 
Seat 4: $lavik88 ($108.25 in chips) 
Seat 8: christyirish ($145.58 in chips) 
Seat 9: fragonik ($52.35 in chips) 
pudge.3096: posts small blind $0.25
kastellani87: posts big blind $0.50
*** HOLE CARDS ***
$lavik88: folds 
christyirish: folds 
fragonik: folds 
pudge.3096: raises $1 to $1.50
kastellani87: raises $1 to $2.50
pudge.3096: calls $1
*** FLOP *** [8d Qs 7d]
pudge.3096: checks 
kastellani87: bets $2.38
pudge.3096: folds 
Uncalled bet ($2.38) returned to kastellani87
kastellani87 collected $4.75 from pot
kastellani87: doesn't show hand 
*** SUMMARY ***
Total pot $5 | Rake $0.25 
Board [8d Qs 7d]
Seat 2: pudge.3096 (small blind) folded on the Flop
Seat 3: kastellani87 (big blind) collected ($4.75)
Seat 4: $lavik88 folded before Flop (didn't bet)
Seat 8: christyirish folded before Flop (didn't bet)
Seat 9: fragonik (button) folded before Flop (didn't bet)



PokerStars Hand #228695629123:  Hold'em No Limit ($0.25/$0.50 USD) - 2021/07/30 21:53:39 ET
Table 'Gorgo III' 9-max Seat #2 is the button
Seat 2: pudge.3096 ($53.37 in chips) 
Seat 3: kastellani87 ($204.31 in chips) 
Seat 4: $lavik88 ($108.25 in chips) 
Seat 8: christyirish ($145.58 in chips) 
Seat 9: fragonik ($52.35 in chips) 
kastellani87: posts small blind $0.25
$lavik88: posts big blind $0.50
*** HOLE CARDS ***
christyirish: folds 
fragonik: raises $0.75 to $1.25
pudge.3096: folds 
kastellani87: folds 
$lavik88: folds 
Uncalled bet ($0.75) returned to fragonik
fragonik collected $1.25 from pot
*** SUMMARY ***
Total pot $1.25 | Rake $0 
Seat 2: pudge.3096 (button) folded before Flop (didn't bet)
Seat 3: kastellani87 (small blind) folded before Flop
Seat 4: $lavik88 (big blind) folded before Flop
Seat 8: christyirish folded before Flop (didn't bet)
Seat 9: fragonik collected ($1.25)



PokerStars Hand #228695633942:  Hold'em No Limit ($0.25/$0.50 USD) - 2021/07/30 21:53:58 ET
Table 'Gorgo III' 9-max Seat #3 is the button
Seat 2: pudge.3096 ($53.37 in chips) 
Seat 3: kastellani87 ($204.06 in chips) 
Seat 4: $lavik88 ($107.75 in chips) 
Seat 8: christyirish ($145.58 in chips) 
Seat 9: fragonik ($53.10 in chips) 
$lavik88: posts small blind $0.25
christyirish: posts big blind $0.50
*** HOLE CARDS ***
fragonik: folds 
pudge.3096: raises $0.75 to $1.25
kastellani87: folds 
$lavik88: folds 
christyirish: folds 
Uncalled bet ($0.75) returned to pudge.3096
pudge.3096 collected $1.25 from pot
pudge.3096: doesn't show hand 
*** SUMMARY ***
Total pot $1.25 | Rake $0 
Seat 2: pudge.3096 collected ($1.25)
Seat 3: kastellani87 (button) folded before Flop (didn't bet)
Seat 4: $lavik88 (small blind) folded before Flop
Seat 8: christyirish (big blind) folded before Flop
Seat 9: fragonik folded before Flop (didn't bet)



PokerStars Hand #228695637180:  Hold'em No Limit ($0.25/$0.50 USD) - 2021/07/30 21:54:12 ET
Table 'Gorgo III' 9-max Seat #4 is the button
Seat 2: pudge.3096 ($54.12 in chips) 
Seat 3: kastellani87 ($204.06 in chips) 
Seat 4: $lavik88 ($107.50 in chips) 
Seat 8: christyirish ($145.08 in chips) 
Seat 9: fragonik ($53.10 in chips) 
christyirish: posts small blind $0.25
fragonik: posts big blind $0.50
*** HOLE CARDS ***
pudge.3096: folds 
kastellani87: folds 
$lavik88: folds 
christyirish: folds 
Uncalled bet ($0.25) returned to fragonik
fragonik collected $0.50 from pot
*** SUMMARY ***
Total pot $0.50 | Rake $0 
Seat 2: pudge.3096 folded before Flop (didn't bet)
Seat 3: kastellani87 folded before Flop (didn't bet)
Seat 4: $lavik88 (button) folded before Flop (didn't bet)
Seat 8: christyirish (small blind) folded before Flop
Seat 9: fragonik (big blind) collected ($0.50)



PokerStars Hand #228695640939:  Hold'em No Limit ($0.25/$0.50 USD) - 2021/07/30 21:54:27 ET
Table 'Gorgo III' 9-max Seat #8 is the button
Seat 2: pudge.3096 ($54.12 in chips) 
Seat 3: kastellani87 ($204.06 in chips) 
Seat 4: $lavik88 ($107.50 in chips) 
Seat 8: christyirish ($144.83 in chips) 
Seat 9: fragonik ($53.35 in chips) 
fragonik: posts small blind $0.25
pudge.3096: posts big blind $0.50
*** HOLE CARDS ***
kastellani87: folds 
$lavik88: folds 
christyirish: folds 
fragonik: raises $1 to $1.50
pudge.3096: folds 
Uncalled bet ($1) returned to fragonik
fragonik collected $1 from pot
*** SUMMARY ***
Total pot $1 | Rake $0 
Seat 2: pudge.3096 (big blind) folded before Flop
Seat 3: kastellani87 folded before Flop (didn't bet)
Seat 4: $lavik88 folded before Flop (didn't bet)
Seat 8: christyirish (button) folded before Flop (didn't bet)
Seat 9: fragonik (small blind) collected ($1)



PokerStars Hand #228695644732:  Hold'em No Limit ($0.25/$0.50 USD) - 2021/07/30 21:54:43 ET
Table 'Gorgo III' 9-max Seat #9 is the button
Seat 2: pudge.3096 ($53.62 in chips) 
Seat 3: kastellani87 ($204.06 in chips) 
Seat 4: $lavik88 ($107.50 in chips) 
Seat 8: christyirish ($144.83 in chips) 
Seat 9: fragonik ($53.85 in chips) 
pudge.3096: posts small blind $0.25
kastellani87: posts big blind $0.50
*** HOLE CARDS ***
$lavik88: folds 
christyirish: raises $0.75 to $1.25
fragonik: folds 
pudge.3096: folds 
kastellani87: calls $0.75
*** FLOP *** [9s 8s Td]
kastellani87: checks 
christyirish: bets $2.61
kastellani87: folds 
Uncalled bet ($2.61) returned to christyirish
christyirish collected $2.61 from pot
christyirish: shows [5d 4s] (high card Ten)
*** SUMMARY ***
Total pot $2.75 | Rake $0.14 
Board [9s 8s Td]
Seat 2: pudge.3096 (small blind) folded before Flop
Seat 3: kastellani87 (big blind) folded on the Flop
Seat 4: $lavik88 folded before Flop (didn't bet)
Seat 8: christyirish collected ($2.61)
Seat 9: fragonik (button) folded before Flop (didn't bet)



PokerStars Hand #228695649821:  Hold'em No Limit ($0.25/$0.50 USD) - 2021/07/30 21:55:04 ET
Table 'Gorgo III' 9-max Seat #2 is the button
Seat 2: pudge.3096 ($53.37 in chips) 
Seat 3: kastellani87 ($202.81 in chips) 
Seat 4: $lavik88 ($107.50 in chips) 
Seat 8: christyirish ($146.19 in chips) 
Seat 9: fragonik ($53.85 in chips) 
kastellani87: posts small blind $0.25
$lavik88: posts big blind $0.50
*** HOLE CARDS ***
christyirish: raises $0.75 to $1.25
fragonik: folds 
pudge.3096: folds 
kastellani87: folds 
$lavik88: folds 
Uncalled bet ($0.75) returned to christyirish
christyirish collected $1.25 from pot
*** SUMMARY ***
Total pot $1.25 | Rake $0 
Seat 2: pudge.3096 (button) folded before Flop (didn't bet)
Seat 3: kastellani87 (small blind) folded before Flop
Seat 4: $lavik88 (big blind) folded before Flop
Seat 8: christyirish collected ($1.25)
Seat 9: fragonik folded before Flop (didn't bet)



PokerStars Hand #228695652830:  Hold'em No Limit ($0.25/$0.50 USD) - 2021/07/30 21:55:18 ET
Table 'Gorgo III' 9-max Seat #3 is the button
Seat 2: pudge.3096 ($53.37 in chips) 
Seat 3: kastellani87 ($202.56 in chips) 
Seat 4: $lavik88 ($107 in chips) 
Seat 8: christyirish ($146.94 in chips) 
Seat 9: fragonik ($53.85 in chips) 
$lavik88: posts small blind $0.25
christyirish: posts big blind $0.50
*** HOLE CARDS ***
cartman177 joins the table at seat #5 
fragonik: folds 
pudge.3096: raises $0.75 to $1.25
kastellani87: calls $1.25
$lavik88: folds 
christyirish: calls $0.75
*** FLOP *** [5c 3d Ad]
christyirish: checks 
pudge.3096: checks 
kastellani87: bets $3.80
christyirish: folds 
pudge.3096: folds 
Uncalled bet ($3.80) returned to kastellani87
kastellani87 collected $3.80 from pot
kastellani87: doesn't show hand 
*** SUMMARY ***
Total pot $4 | Rake $0.20 
Board [5c 3d Ad]
Seat 2: pudge.3096 folded on the Flop
Seat 3: kastellani87 (button) collected ($3.80)
Seat 4: $lavik88 (small blind) folded before Flop
Seat 8: christyirish (big blind) folded on the Flop
Seat 9: fragonik folded before Flop (didn't bet)



PokerStars Hand #228695657191:  Hold'em No Limit ($0.25/$0.50 USD) - 2021/07/30 21:55:41 ET
Table 'Gorgo III' 9-max Seat #4 is the button
Seat 2: pudge.3096 ($52.12 in chips) 
Seat 3: kastellani87 ($205.11 in chips) 
Seat 4: $lavik88 ($106.75 in chips) 
Seat 8: christyirish ($145.69 in chips) 
Seat 9: fragonik ($53.85 in chips) 
christyirish: posts small blind $0.25
fragonik: posts big blind $0.50
*** HOLE CARDS ***
pudge.3096: folds 
kastellani87: raises $1 to $1.50
$lavik88: folds 
christyirish: folds 
fragonik: folds 
Uncalled bet ($1) returned to kastellani87
kastellani87 collected $1.25 from pot
kastellani87: doesn't show hand 
*** SUMMARY ***
Total pot $1.25 | Rake $0 
Seat 2: pudge.3096 folded before Flop (didn't bet)
Seat 3: kastellani87 collected ($1.25)
Seat 4: $lavik88 (button) folded before Flop (didn't bet)
Seat 8: christyirish (small blind) folded before Flop
Seat 9: fragonik (big blind) folded before Flop



PokerStars Hand #228695662084:  Hold'em No Limit ($0.25/$0.50 USD) - 2021/07/30 21:56:07 ET
Table 'Gorgo III' 9-max Seat #8 is the button
Seat 2: pudge.3096 ($52.12 in chips) 
Seat 3: kastellani87 ($205.86 in chips) 
Seat 4: $lavik88 ($106.75 in chips) 
Seat 8: christyirish ($145.44 in chips) 
Seat 9: fragonik ($53.35 in chips) 
fragonik: posts small blind $0.25
pudge.3096: posts big blind $0.50
cartman177: sits out 
*** HOLE CARDS ***
kastellani87: folds 
$lavik88: folds 
christyirish: folds 
fragonik: folds 
Uncalled bet ($0.25) returned to pudge.3096
pudge.3096 collected $0.50 from pot
pudge.3096: doesn't show hand 
*** SUMMARY ***
Total pot $0.50 | Rake $0 
Seat 2: pudge.3096 (big blind) collected ($0.50)
Seat 3: kastellani87 folded before Flop (didn't bet)
Seat 4: $lavik88 folded before Flop (didn't bet)
Seat 8: christyirish (button) folded before Flop (didn't bet)
Seat 9: fragonik (small blind) folded before Flop



PokerStars Hand #228695664259:  Hold'em No Limit ($0.25/$0.50 USD) - 2021/07/30 21:56:18 ET
Table 'Gorgo III' 9-max Seat #9 is the button
Seat 2: pudge.3096 ($52.37 in chips) 
Seat 3: kastellani87 ($205.86 in chips) 
Seat 4: $lavik88 ($106.75 in chips) 
Seat 8: christyirish ($145.44 in chips) 
Seat 9: fragonik ($53.10 in chips) 
pudge.3096: posts small blind $0.25
kastellani87: posts big blind $0.50
cartman177: sits out 
*** HOLE CARDS ***
cartman177 leaves the table
$lavik88 has timed out
$lavik88: folds 
christyirish: raises $0.75 to $1.25
fragonik: raises $2.50 to $3.75
pudge.3096: folds 
kastellani87: calls $3.25
christyirish: folds 
*** FLOP *** [Ac Ts 7s]
kastellani87: checks 
fragonik: checks 
*** TURN *** [Ac Ts 7s] [Kd]
kastellani87: checks 
fragonik: checks 
*** RIVER *** [Ac Ts 7s Kd] [Ks]
kastellani87: bets $8.55
fragonik: folds 
Uncalled bet ($8.55) returned to kastellani87
kastellani87 collected $8.55 from pot
kastellani87: doesn't show hand 
*** SUMMARY ***
Total pot $9 | Rake $0.45 
Board [Ac Ts 7s Kd Ks]
Seat 2: pudge.3096 (small blind) folded before Flop
Seat 3: kastellani87 (big blind) collected ($8.55)
Seat 4: $lavik88 folded before Flop (didn't bet)
Seat 8: christyirish folded before Flop
Seat 9: fragonik (button) folded on the River



PokerStars Hand #228695683212:  Hold'em No Limit ($0.25/$0.50 USD) - 2021/07/30 21:57:27 ET
Table 'Gorgo III' 9-max Seat #2 is the button
Seat 2: pudge.3096 ($52.12 in chips) 
Seat 3: kastellani87 ($210.66 in chips) 
Seat 4: $lavik88 ($106.75 in chips) 
Seat 8: christyirish ($144.19 in chips) 
Seat 9: fragonik ($50 in chips) 
kastellani87: posts small blind $0.25
$lavik88: posts big blind $0.50
*** HOLE CARDS ***
christyirish: folds 
fragonik: folds 
pudge.3096: folds 
kastellani87: calls $0.25
$lavik88: checks 
*** FLOP *** [Ac 3d 2d]
kastellani87: checks 
$lavik88: checks 
*** TURN *** [Ac 3d 2d] [Qc]
kastellani87: checks 
$lavik88: bets $0.50
kastellani87: folds 
Uncalled bet ($0.50) returned to $lavik88
$lavik88 collected $0.95 from pot
$lavik88: doesn't show hand 
*** SUMMARY ***
Total pot $1 | Rake $0.05 
Board [Ac 3d 2d Qc]
Seat 2: pudge.3096 (button) folded before Flop (didn't bet)
Seat 3: kastellani87 (small blind) folded on the Turn
Seat 4: $lavik88 (big blind) collected ($0.95)
Seat 8: christyirish folded before Flop (didn't bet)
Seat 9: fragonik folded before Flop (didn't bet)



PokerStars Hand #228695690415:  Hold'em No Limit ($0.25/$0.50 USD) - 2021/07/30 21:58:04 ET
Table 'Gorgo III' 9-max Seat #3 is the button
Seat 2: pudge.3096 ($52.12 in chips) 
Seat 3: kastellani87 ($210.16 in chips) 
Seat 4: $lavik88 ($107.20 in chips) 
Seat 8: christyirish ($144.19 in chips) 
Seat 9: fragonik ($50 in chips) 
$lavik88: posts small blind $0.25
christyirish: posts big blind $0.50
*** HOLE CARDS ***
fragonik: folds 
pudge.3096: raises $0.75 to $1.25
kastellani87: folds 
kastellani87 leaves the table
$lavik88: folds 
christyirish: calls $0.75
*** FLOP *** [7h 8h 3s]
christyirish: checks 
pudge.3096: bets $1.70
christyirish: calls $1.70
*** TURN *** [7h 8h 3s] [6d]
christyirish: checks 
pudge.3096: bets $4.44
christyirish: folds 
Uncalled bet ($4.44) returned to pudge.3096
pudge.3096 collected $5.84 from pot
pudge.3096: doesn't show hand 
*** SUMMARY ***
Total pot $6.15 | Rake $0.31 
Board [7h 8h 3s 6d]
Seat 2: pudge.3096 collected ($5.84)
Seat 3: kastellani87 (button) folded before Flop (didn't bet)
Seat 4: $lavik88 (small blind) folded before Flop
Seat 8: christyirish (big blind) folded on the Turn
Seat 9: fragonik folded before Flop (didn't bet)



PokerStars Hand #228695697633:  Hold'em No Limit ($0.25/$0.50 USD) - 2021/07/30 21:58:42 ET
Table 'Gorgo III' 9-max Seat #4 is the button
Seat 2: pudge.3096 ($55.01 in chips) 
Seat 4: $lavik88 ($106.95 in chips) 
Seat 8: christyirish ($141.24 in chips) 
Seat 9: fragonik ($50 in chips) 
christyirish: posts small blind $0.25
fragonik: posts big blind $0.50
*** HOLE CARDS ***
pudge.3096: folds 
$lavik88: raises $0.70 to $1.20
christyirish: raises $2.90 to $4.10
fragonik: folds 
$lavik88: folds 
Uncalled bet ($2.90) returned to christyirish
christyirish collected $2.90 from pot
*** SUMMARY ***
Total pot $2.90 | Rake $0 
Seat 2: pudge.3096 folded before Flop (didn't bet)
Seat 4: $lavik88 (button) folded before Flop
Seat 8: christyirish (small blind) collected ($2.90)
Seat 9: fragonik (big blind) folded before Flop



PokerStars Hand #228695701790:  Hold'em No Limit ($0.25/$0.50 USD) - 2021/07/30 21:59:04 ET
Table 'Gorgo III' 9-max Seat #9 is the button
Seat 8: christyirish ($142.94 in chips) 
Seat 9: fragonik ($50 in chips) 
fragonik: posts small blind $0.25
$lavik88: is sitting out 
christyirish: posts big blind $0.50
*** HOLE CARDS ***
pudge.3096 leaves the table
fragonik: folds 
Uncalled bet ($0.25) returned to christyirish
christyirish collected $0.50 from pot
*** SUMMARY ***
Total pot $0.50 | Rake $0 
Seat 8: christyirish (big blind) collected ($0.50)
Seat 9: fragonik (button) (small blind) folded before Flop



PokerStars Hand #228695702834:  Hold'em No Limit ($0.25/$0.50 USD) - 2021/07/30 21:59:09 ET
Table 'Gorgo III' 9-max Seat #8 is the button
Seat 8: christyirish ($143.19 in chips) 
Seat 9: fragonik ($50 in chips) 
christyirish: posts small blind $0.25
fragonik: posts big blind $0.50
*** HOLE CARDS ***
$lavik88 leaves the table
christyirish: raises $0.75 to $1.25
fragonik: folds 
Uncalled bet ($0.75) returned to christyirish
christyirish collected $1 from pot
*** SUMMARY ***
Total pot $1 | Rake $0 
Seat 8: christyirish (button) (small blind) collected ($1)
Seat 9: fragonik (big blind) folded before Flop



PokerStars Hand #228696013675:  Hold'em No Limit ($0.25/$0.50 USD) - 2021/07/30 22:19:32 ET
Table 'Gorgo III' 9-max Seat #2 is the button
Seat 2: maxetizer ($20 in chips) 
Seat 3: Zager.v ($50 in chips) 
maxetizer: posts small blind $0.25
Zager.v: posts big blind $0.50
*** HOLE CARDS ***
maxetizer: calls $0.25
Zager.v: checks 
*** FLOP *** [7s 4s 8s]
Zager.v: checks 
maxetizer: bets $1
Zager.v: folds 
Uncalled bet ($1) returned to maxetizer
maxetizer collected $0.95 from pot
maxetizer: doesn't show hand 
*** SUMMARY ***
Total pot $1 | Rake $0.05 
Board [7s 4s 8s]
Seat 2: maxetizer (button) (small blind) collected ($0.95)
Seat 3: Zager.v (big blind) folded on the Flop



PokerStars Hand #228696017464:  Hold'em No Limit ($0.25/$0.50 USD) - 2021/07/30 22:19:48 ET
Table 'Gorgo III' 9-max Seat #3 is the button
Seat 2: maxetizer ($20.45 in chips) 
Seat 3: Zager.v ($50 in chips) 
Zager.v: posts small blind $0.25
maxetizer: posts big blind $0.50
*** HOLE CARDS ***
Zager.v: folds 
Uncalled bet ($0.25) returned to maxetizer
maxetizer collected $0.50 from pot
maxetizer: doesn't show hand 
*** SUMMARY ***
Total pot $0.50 | Rake $0 
Seat 2: maxetizer (big blind) collected ($0.50)
Seat 3: Zager.v (button) (small blind) folded before Flop



PokerStars Hand #228696018520:  Hold'em No Limit ($0.25/$0.50 USD) - 2021/07/30 22:19:53 ET
Table 'Gorgo III' 9-max Seat #2 is the button
Seat 2: maxetizer ($20.70 in chips) 
Seat 3: Zager.v ($50 in chips) 
maxetizer: posts small blind $0.25
Zager.v: posts big blind $0.50
*** HOLE CARDS ***
Lago Madjore joins the table at seat #4 
daria130399 joins the table at seat #5 
maxetizer: calls $0.25
Zager.v: checks 
*** FLOP *** [Th 9s Kd]
Zager.v: checks 
maxetizer: checks 
*** TURN *** [Th 9s Kd] [5d]
Zager.v: checks 
maxetizer: bets $1
Zager.v: calls $1
*** RIVER *** [Th 9s Kd 5d] [8h]
Zager.v: checks 
maxetizer: checks 
*** SHOW DOWN ***
Zager.v: shows [6h Td] (a pair of Tens)
maxetizer: mucks hand 
Zager.v collected $2.85 from pot
*** SUMMARY ***
Total pot $3 | Rake $0.15 
Board [Th 9s Kd 5d 8h]
Seat 2: maxetizer (button) (small blind) mucked
Seat 3: Zager.v (big blind) showed [6h Td] and won ($2.85) with a pair of Tens



PokerStars Hand #228696026792:  Hold'em No Limit ($0.25/$0.50 USD) - 2021/07/30 22:20:28 ET
Table 'Gorgo III' 9-max Seat #2 is the button
Seat 2: maxetizer ($19.20 in chips) 
Seat 3: Zager.v ($51.35 in chips) 
Seat 4: Lago Madjore ($50.75 in chips) 
Zager.v: posts small blind $0.25
Lago Madjore: posts big blind $0.50
daria130399: sits out 
*** HOLE CARDS ***
maxetizer: calls $0.50
Zager.v: folds 
Lago Madjore: checks 
*** FLOP *** [9h Tc 7s]
Lago Madjore: checks 
maxetizer: bets $0.50
Lago Madjore: calls $0.50
*** TURN *** [9h Tc 7s] [6s]
Lago Madjore: bets $1.46
maxetizer: raises $1.46 to $2.92
Lago Madjore: raises $46.83 to $49.75 and is all-in
maxetizer: calls $15.28 and is all-in
Uncalled bet ($31.55) returned to Lago Madjore
*** RIVER *** [9h Tc 7s 6s] [Qc]
*** SHOW DOWN ***
Lago Madjore: shows [8d 3h] (a straight, Six to Ten)
maxetizer: shows [8c Jc] (a straight, Eight to Queen)
maxetizer collected $37.90 from pot
*** SUMMARY ***
Total pot $38.65 | Rake $0.75 
Board [9h Tc 7s 6s Qc]
Seat 2: maxetizer (button) showed [8c Jc] and won ($37.90) with a straight, Eight to Queen
Seat 3: Zager.v (small blind) folded before Flop
Seat 4: Lago Madjore (big blind) showed [8d 3h] and lost with a straight, Six to Ten



PokerStars Hand #228696036607:  Hold'em No Limit ($0.25/$0.50 USD) - 2021/07/30 22:21:10 ET
Table 'Gorgo III' 9-max Seat #3 is the button
Seat 2: maxetizer ($37.90 in chips) 
Seat 3: Zager.v ($51.10 in chips) 
Seat 4: Lago Madjore ($50 in chips) 
Seat 5: daria130399 ($50 in chips) 
MaximUSNG joins the table at seat #6 
Lago Madjore: posts small blind $0.25
daria130399: posts big blind $0.50
*** HOLE CARDS ***
maxetizer: folds 
Zager.v: raises $0.56 to $1.06
Lago Madjore: folds 
daria130399: folds 
Uncalled bet ($0.56) returned to Zager.v
Zager.v collected $1.25 from pot
Zager.v: doesn't show hand 
*** SUMMARY ***
Total pot $1.25 | Rake $0 
Seat 2: maxetizer folded before Flop (didn't bet)
Seat 3: Zager.v (button) collected ($1.25)
Seat 4: Lago Madjore (small blind) folded before Flop
Seat 5: daria130399 (big blind) folded before Flop



PokerStars Hand #228696039631:  Hold'em No Limit ($0.25/$0.50 USD) - 2021/07/30 22:21:24 ET
Table 'Gorgo III' 9-max Seat #4 is the button
Seat 2: maxetizer ($37.90 in chips) 
Seat 3: Zager.v ($51.85 in chips) 
Seat 4: Lago Madjore ($50 in chips) 
Seat 5: daria130399 ($50 in chips) 
Seat 6: MaximUSNG ($50 in chips) 
daria130399: posts small blind $0.25
MaximUSNG: posts big blind $0.50
SuneSt: sits out 
*** HOLE CARDS ***
xobit26 joins the table at seat #7 
maxetizer: calls $0.50
Zager.v: folds 
Lago Madjore: folds 
daria130399: raises $1.25 to $1.75
MaximUSNG: raises $4 to $5.75
maxetizer: folds 
daria130399: folds 
Uncalled bet ($4) returned to MaximUSNG
MaximUSNG collected $4 from pot
MaximUSNG: doesn't show hand 
*** SUMMARY ***
Total pot $4 | Rake $0 
Seat 2: maxetizer folded before Flop
Seat 3: Zager.v folded before Flop (didn't bet)
Seat 4: Lago Madjore (button) folded before Flop (didn't bet)
Seat 5: daria130399 (small blind) folded before Flop
Seat 6: MaximUSNG (big blind) collected ($4)



PokerStars Hand #228696049085:  Hold'em No Limit ($0.25/$0.50 USD) - 2021/07/30 22:22:04 ET
Table 'Gorgo III' 9-max Seat #5 is the button
Seat 2: maxetizer ($37.40 in chips) 
Seat 3: Zager.v ($51.85 in chips) 
Seat 4: Lago Madjore ($50 in chips) 
Seat 5: daria130399 ($50 in chips) 
Seat 6: MaximUSNG ($52.25 in chips) 
Seat 7: xobit26 ($50 in chips) 
MaximUSNG: posts small blind $0.25
xobit26: posts big blind $0.50
SuneSt: sits out 
*** HOLE CARDS ***
maxetizer: calls $0.50
Zager.v: folds 
Lago Madjore: folds 
daria130399: raises $1.50 to $2
MaximUSNG: folds 
xobit26: folds 
maxetizer: calls $1.50
*** FLOP *** [4c Qd 6d]
maxetizer: checks 
daria130399: bets $1.49
maxetizer: folds 
Uncalled bet ($1.49) returned to daria130399
daria130399 collected $4.51 from pot
daria130399: doesn't show hand 
*** SUMMARY ***
Total pot $4.75 | Rake $0.24 
Board [4c Qd 6d]
Seat 2: maxetizer folded on the Flop
Seat 3: Zager.v folded before Flop (didn't bet)
Seat 4: Lago Madjore folded before Flop (didn't bet)
Seat 5: daria130399 (button) collected ($4.51)
Seat 6: MaximUSNG (small blind) folded before Flop
Seat 7: xobit26 (big blind) folded before Flop



PokerStars Hand #228696055207:  Hold'em No Limit ($0.25/$0.50 USD) - 2021/07/30 22:22:31 ET
Table 'Gorgo III' 9-max Seat #6 is the button
Seat 1: SuneSt ($50 in chips) 
Seat 2: maxetizer ($35.40 in chips) 
Seat 3: Zager.v ($51.85 in chips) 
Seat 4: Lago Madjore ($50 in chips) 
Seat 5: daria130399 ($52.51 in chips) 
Seat 6: MaximUSNG ($52 in chips) 
Seat 7: xobit26 ($50 in chips) 
xobit26: posts small blind $0.25
SuneSt: posts big blind $0.50
*** HOLE CARDS ***
maxetizer: folds 
Zager.v: folds 
Lago Madjore: folds 
daria130399: raises $0.75 to $1.25
MaximUSNG: folds 
xobit26: folds 
SuneSt: folds 
Uncalled bet ($0.75) returned to daria130399
daria130399 collected $1.25 from pot
daria130399: doesn't show hand 
*** SUMMARY ***
Total pot $1.25 | Rake $0 
Seat 1: SuneSt (big blind) folded before Flop
Seat 2: maxetizer folded before Flop (didn't bet)
Seat 3: Zager.v folded before Flop (didn't bet)
Seat 4: Lago Madjore folded before Flop (didn't bet)
Seat 5: daria130399 collected ($1.25)
Seat 6: MaximUSNG (button) folded before Flop (didn't bet)
Seat 7: xobit26 (small blind) folded before Flop



PokerStars Hand #228696059530:  Hold'em No Limit ($0.25/$0.50 USD) - 2021/07/30 22:22:49 ET
Table 'Gorgo III' 9-max Seat #7 is the button
Seat 1: SuneSt ($50 in chips) 
Seat 2: maxetizer ($35.40 in chips) 
Seat 3: Zager.v ($51.85 in chips) 
Seat 4: Lago Madjore ($50 in chips) 
Seat 5: daria130399 ($53.26 in chips) 
Seat 6: MaximUSNG ($52 in chips) 
Seat 7: xobit26 ($50 in chips) 
SuneSt: posts small blind $0.25
maxetizer: posts big blind $0.50
*** HOLE CARDS ***
Zager.v: raises $0.56 to $1.06
Lago Madjore: folds 
daria130399: calls $1.06
MaximUSNG: folds 
xobit26: folds 
SuneSt: folds 
maxetizer: calls $0.56
*** FLOP *** [3s 4s Kd]
maxetizer: bets $1
Zager.v: folds 
daria130399: calls $1
*** TURN *** [3s 4s Kd] [Qd]
maxetizer: bets $1.50
daria130399: calls $1.50
*** RIVER *** [3s 4s Kd Qd] [Kc]
maxetizer: bets $1
daria130399: calls $1
*** SHOW DOWN ***
maxetizer: shows [9s 9c] (two pair, Kings and Nines)
daria130399: mucks hand 
maxetizer collected $9.91 from pot
*** SUMMARY ***
Total pot $10.43 | Rake $0.52 
Board [3s 4s Kd Qd Kc]
Seat 1: SuneSt (small blind) folded before Flop
Seat 2: maxetizer (big blind) showed [9s 9c] and won ($9.91) with two pair, Kings and Nines
Seat 3: Zager.v folded on the Flop
Seat 4: Lago Madjore folded before Flop (didn't bet)
Seat 5: daria130399 mucked
Seat 6: MaximUSNG folded before Flop (didn't bet)
Seat 7: xobit26 (button) folded before Flop (didn't bet)



PokerStars Hand #228696075978:  Hold'em No Limit ($0.25/$0.50 USD) - 2021/07/30 22:24:01 ET
Table 'Gorgo III' 9-max Seat #1 is the button
Seat 1: SuneSt ($50 in chips) 
Seat 2: maxetizer ($40.75 in chips) 
Seat 3: Zager.v ($50.79 in chips) 
Seat 4: Lago Madjore ($50 in chips) 
Seat 5: daria130399 ($50 in chips) 
Seat 6: MaximUSNG ($52 in chips) 
Seat 7: xobit26 ($50 in chips) 
maxetizer: posts small blind $0.25
Zager.v: posts big blind $0.50
*** HOLE CARDS ***
Lago Madjore: raises $1 to $1.50
daria130399: folds 
MaximUSNG: folds 
xobit26: folds 
SuneSt: folds 
maxetizer: folds 
Zager.v: folds 
Uncalled bet ($1) returned to Lago Madjore
Lago Madjore collected $1.25 from pot
*** SUMMARY ***
Total pot $1.25 | Rake $0 
Seat 1: SuneSt (button) folded before Flop (didn't bet)
Seat 2: maxetizer (small blind) folded before Flop
Seat 3: Zager.v (big blind) folded before Flop
Seat 4: Lago Madjore collected ($1.25)
Seat 5: daria130399 folded before Flop (didn't bet)
Seat 6: MaximUSNG folded before Flop (didn't bet)
Seat 7: xobit26 folded before Flop (didn't bet)



PokerStars Hand #228696078508:  Hold'em No Limit ($0.25/$0.50 USD) - 2021/07/30 22:24:12 ET
Table 'Gorgo III' 9-max Seat #2 is the button
Seat 1: SuneSt ($50 in chips) 
Seat 2: maxetizer ($40.50 in chips) 
Seat 3: Zager.v ($50.29 in chips) 
Seat 4: Lago Madjore ($50.75 in chips) 
Seat 5: daria130399 ($50 in chips) 
Seat 6: MaximUSNG ($52 in chips) 
Seat 7: xobit26 ($50 in chips) 
Zager.v: posts small blind $0.25
Lago Madjore: posts big blind $0.50
*** HOLE CARDS ***
daria130399: raises $1 to $1.50
MaximUSNG: folds 
xobit26: raises $3 to $4.50
SuneSt: folds 
maxetizer: folds 
Zager.v: folds 
Lago Madjore: folds 
daria130399: calls $3
*** FLOP *** [Qs Ks Jh]
daria130399: checks 
xobit26: checks 
*** TURN *** [Qs Ks Jh] [Kc]
mazefaka007 joins the table at seat #9 
jumbo69 joins the table at seat #8 
daria130399 has timed out
daria130399: checks 
xobit26: checks 
*** RIVER *** [Qs Ks Jh Kc] [6d]
daria130399 has timed out
daria130399: checks 
xobit26: checks 
*** SHOW DOWN ***
daria130399: shows [7s 7c] (two pair, Kings and Sevens)
xobit26: shows [8c 8h] (two pair, Kings and Eights)
xobit26 collected $9.26 from pot
*** SUMMARY ***
Total pot $9.75 | Rake $0.49 
Board [Qs Ks Jh Kc 6d]
Seat 1: SuneSt folded before Flop (didn't bet)
Seat 2: maxetizer (button) folded before Flop (didn't bet)
Seat 3: Zager.v (small blind) folded before Flop
Seat 4: Lago Madjore (big blind) folded before Flop
Seat 5: daria130399 showed [7s 7c] and lost with two pair, Kings and Sevens
Seat 6: MaximUSNG folded before Flop (didn't bet)
Seat 7: xobit26 showed [8c 8h] and won ($9.26) with two pair, Kings and Eights



PokerStars Hand #228696099056:  Hold'em No Limit ($0.25/$0.50 USD) - 2021/07/30 22:25:43 ET
Table 'Gorgo III' 9-max Seat #3 is the button
Seat 1: SuneSt ($50 in chips) 
Seat 2: maxetizer ($40.50 in chips) 
Seat 3: Zager.v ($50.04 in chips) 
Seat 4: Lago Madjore ($50.25 in chips) 
Seat 5: daria130399 ($50 in chips) 
Seat 6: MaximUSNG ($52 in chips) 
Seat 7: xobit26 ($54.76 in chips) 
Seat 8: jumbo69 ($32.37 in chips) 
Lago Madjore: posts small blind $0.25
daria130399: posts big blind $0.50
jumbo69: posts big blind $0.50
mazefaka007: sits out 
*** HOLE CARDS ***
MaximUSNG: folds 
xobit26: folds 
jumbo69: checks 
SuneSt: folds 
maxetizer: calls $0.50
Zager.v: folds 
Lago Madjore: folds 
daria130399: checks 
*** FLOP *** [9d 8h Ks]
daria130399: checks 
jumbo69: bets $0.83
maxetizer: folds 
daria130399: folds 
Uncalled bet ($0.83) returned to jumbo69
jumbo69 collected $1.66 from pot
*** SUMMARY ***
Total pot $1.75 | Rake $0.09 
Board [9d 8h Ks]
Seat 1: SuneSt folded before Flop (didn't bet)
Seat 2: maxetizer folded on the Flop
Seat 3: Zager.v (button) folded before Flop (didn't bet)
Seat 4: Lago Madjore (small blind) folded before Flop
Seat 5: daria130399 (big blind) folded on the Flop
Seat 6: MaximUSNG folded before Flop (didn't bet)
Seat 7: xobit26 folded before Flop (didn't bet)
Seat 8: jumbo69 collected ($1.66)



PokerStars Hand #228696106397:  Hold'em No Limit ($0.25/$0.50 USD) - 2021/07/30 22:26:16 ET
Table 'Gorgo III' 9-max Seat #4 is the button
Seat 1: SuneSt ($50 in chips) 
Seat 2: maxetizer ($40 in chips) 
Seat 3: Zager.v ($50.04 in chips) 
Seat 4: Lago Madjore ($50 in chips) 
Seat 5: daria130399 ($50 in chips) 
Seat 6: MaximUSNG ($52 in chips) 
Seat 7: xobit26 ($54.76 in chips) 
Seat 8: jumbo69 ($33.53 in chips) 
daria130399: posts small blind $0.25
MaximUSNG: posts big blind $0.50
mazefaka007: sits out 
*** HOLE CARDS ***
xobit26: folds 
jumbo69: folds 
SuneSt: folds 
maxetizer: calls $0.50
Zager.v: folds 
Lago Madjore: raises $1.50 to $2
daria130399: folds 
MaximUSNG: folds 
maxetizer: calls $1.50
*** FLOP *** [Kc 7s 9c]
maxetizer: bets $1.50
Lago Madjore: raises $5.11 to $6.61
maxetizer: calls $5.11
*** TURN *** [Kc 7s 9c] [5h]
maxetizer: checks 
Lago Madjore: bets $41.39 and is all-in
maxetizer: folds 
Uncalled bet ($41.39) returned to Lago Madjore
Lago Madjore collected $17.07 from pot
*** SUMMARY ***
Total pot $17.97 | Rake $0.90 
Board [Kc 7s 9c 5h]
Seat 1: SuneSt folded before Flop (didn't bet)
Seat 2: maxetizer folded on the Turn
Seat 3: Zager.v folded before Flop (didn't bet)
Seat 4: Lago Madjore (button) collected ($17.07)
Seat 5: daria130399 (small blind) folded before Flop
Seat 6: MaximUSNG (big blind) folded before Flop
Seat 7: xobit26 folded before Flop (didn't bet)
Seat 8: jumbo69 folded before Flop (didn't bet)



PokerStars Hand #228696118486:  Hold'em No Limit ($0.25/$0.50 USD) - 2021/07/30 22:26:56 ET
Table 'Gorgo III' 9-max Seat #5 is the button
Seat 1: SuneSt ($50 in chips) 
Seat 2: maxetizer ($31.39 in chips) 
Seat 3: Zager.v ($50.04 in chips) 
Seat 4: Lago Madjore ($58.46 in chips) 
Seat 5: daria130399 ($50 in chips) 
Seat 6: MaximUSNG ($51.50 in chips) 
Seat 7: xobit26 ($54.76 in chips) 
Seat 8: jumbo69 ($33.53 in chips) 
MaximUSNG: posts small blind $0.25
xobit26: posts big blind $0.50
mazefaka007: sits out 
*** HOLE CARDS ***
jumbo69: folds 
mazefaka007 leaves the table
SuneSt: raises $1 to $1.50
maxetizer: folds 
Zager.v: folds 
Lago Madjore: folds 
daria130399: folds 
MaximUSNG: folds 
xobit26: folds 
Uncalled bet ($1) returned to SuneSt
SuneSt collected $1.25 from pot
SuneSt: doesn't show hand 
*** SUMMARY ***
Total pot $1.25 | Rake $0 
Seat 1: SuneSt collected ($1.25)
Seat 2: maxetizer folded before Flop (didn't bet)
Seat 3: Zager.v folded before Flop (didn't bet)
Seat 4: Lago Madjore folded before Flop (didn't bet)
Seat 5: daria130399 (button) folded before Flop (didn't bet)
Seat 6: MaximUSNG (small blind) folded before Flop
Seat 7: xobit26 (big blind) folded before Flop
Seat 8: jumbo69 folded before Flop (didn't bet)



PokerStars Hand #228696122849:  Hold'em No Limit ($0.25/$0.50 USD) - 2021/07/30 22:27:16 ET
Table 'Gorgo III' 9-max Seat #6 is the button
Seat 1: SuneSt ($50.75 in chips) 
Seat 2: maxetizer ($31.39 in chips) 
Seat 3: Zager.v ($50.04 in chips) 
Seat 4: Lago Madjore ($58.46 in chips) 
Seat 5: daria130399 ($50 in chips) 
Seat 6: MaximUSNG ($51.25 in chips) 
Seat 7: xobit26 ($54.26 in chips) 
Seat 8: jumbo69 ($33.53 in chips) 
xobit26: posts small blind $0.25
jumbo69: posts big blind $0.50
*** HOLE CARDS ***
SuneSt: folds 
maxetizer: folds 
Zager.v: folds 
Lago Madjore: folds 
daria130399 has timed out
daria130399: folds 
MaximUSNG: folds 
xobit26: raises $1 to $1.50
jumbo69: calls $1
*** FLOP *** [5h 2c Kd]
xobit26: checks 
jumbo69: bets $1.43
xobit26: folds 
Uncalled bet ($1.43) returned to jumbo69
jumbo69 collected $2.85 from pot
*** SUMMARY ***
Total pot $3 | Rake $0.15 
Board [5h 2c Kd]
Seat 1: SuneSt folded before Flop (didn't bet)
Seat 2: maxetizer folded before Flop (didn't bet)
Seat 3: Zager.v folded before Flop (didn't bet)
Seat 4: Lago Madjore folded before Flop (didn't bet)
Seat 5: daria130399 folded before Flop (didn't bet)
Seat 6: MaximUSNG (button) folded before Flop (didn't bet)
Seat 7: xobit26 (small blind) folded on the Flop
Seat 8: jumbo69 (big blind) collected ($2.85)



PokerStars Hand #228696139322:  Hold'em No Limit ($0.25/$0.50 USD) - 2021/07/30 22:28:30 ET
Table 'Gorgo III' 9-max Seat #7 is the button
Seat 1: SuneSt ($50.75 in chips) 
Seat 2: maxetizer ($31.39 in chips) 
Seat 3: Zager.v ($50.04 in chips) 
Seat 4: Lago Madjore ($58.46 in chips) 
Seat 6: MaximUSNG ($51.25 in chips) 
Seat 7: xobit26 ($52.76 in chips) 
Seat 8: jumbo69 ($34.88 in chips) 
jumbo69: posts small blind $0.25
SuneSt: posts big blind $0.50
*** HOLE CARDS ***
maxetizer: calls $0.50
Zager.v: folds 
Lago Madjore: folds 
MaximUSNG: raises $1.36 to $1.86
Obormid joins the table at seat #9 
xobit26: folds 
jumbo69: folds 
SuneSt: folds 
maxetizer: calls $1.36
*** FLOP *** [2h As 8s]
maxetizer: bets $1.50
MaximUSNG: calls $1.50
*** TURN *** [2h As 8s] [Qc]
maxetizer: bets $6
MaximUSNG: raises $9.74 to $15.74
maxetizer: calls $9.74
*** RIVER *** [2h As 8s Qc] [Ad]
maxetizer: bets $12.29 and is all-in
MaximUSNG: calls $12.29
*** SHOW DOWN ***
maxetizer: shows [Js Ac] (three of a kind, Aces)
MaximUSNG: shows [2d 2s] (a full house, Deuces full of Aces)
MaximUSNG collected $61.53 from pot
*** SUMMARY ***
Total pot $63.53 | Rake $2 
Board [2h As 8s Qc Ad]
Seat 1: SuneSt (big blind) folded before Flop
Seat 2: maxetizer showed [Js Ac] and lost with three of a kind, Aces
Seat 3: Zager.v folded before Flop (didn't bet)
Seat 4: Lago Madjore folded before Flop (didn't bet)
Seat 6: MaximUSNG showed [2d 2s] and won ($61.53) with a full house, Deuces full of Aces
Seat 7: xobit26 (button) folded before Flop (didn't bet)
Seat 8: jumbo69 (small blind) folded before Flop



PokerStars Hand #228696157808:  Hold'em No Limit ($0.25/$0.50 USD) - 2021/07/30 22:29:53 ET
Table 'Gorgo III' 9-max Seat #8 is the button
Seat 1: SuneSt ($50.25 in chips) 
Seat 3: Zager.v ($50.04 in chips) 
Seat 4: Lago Madjore ($58.46 in chips) 
Seat 5: daria130399 ($50 in chips) 
Seat 6: MaximUSNG ($81.39 in chips) 
Seat 7: xobit26 ($52.76 in chips) 
Seat 8: jumbo69 ($34.63 in chips) 
SuneSt: posts small blind $0.25
Zager.v: posts big blind $0.50
*** HOLE CARDS ***
Lago Madjore: folds 
daria130399: folds 
MaximUSNG: folds 
xobit26: raises $0.75 to $1.25
maxetizer leaves the table
jumbo69: folds 
Lago Madjore leaves the table
SuneSt: raises $3.75 to $5
Zager.v: folds 
xobit26: folds 
Uncalled bet ($3.75) returned to SuneSt
SuneSt collected $3 from pot
SuneSt: doesn't show hand 
*** SUMMARY ***
Total pot $3 | Rake $0 
Seat 1: SuneSt (small blind) collected ($3)
Seat 3: Zager.v (big blind) folded before Flop
Seat 4: Lago Madjore folded before Flop (didn't bet)
Seat 5: daria130399 folded before Flop (didn't bet)
Seat 6: MaximUSNG folded before Flop (didn't bet)
Seat 7: xobit26 folded before Flop
Seat 8: jumbo69 (button) folded before Flop (didn't bet)



PokerStars Hand #228696168036:  Hold'em No Limit ($0.25/$0.50 USD) - 2021/07/30 22:30:39 ET
Table 'Gorgo III' 9-max Seat #1 is the button
Seat 1: SuneSt ($52 in chips) 
Seat 3: Zager.v ($50 in chips) 
Seat 5: daria130399 ($50 in chips) 
Seat 6: MaximUSNG ($81.39 in chips) 
Seat 7: xobit26 ($51.51 in chips) 
Seat 8: jumbo69 ($34.63 in chips) 
Zager.v: posts small blind $0.25
daria130399: posts big blind $0.50
*** HOLE CARDS ***
MaximUSNG: folds 
Obormid leaves the table
xobit26: folds 
jumbo69: folds 
SuneSt: raises $0.75 to $1.25
Zager.v: folds 
daria130399: calls $0.75
*** FLOP *** [8h 2d Kd]
daria130399: checks 
SuneSt: checks 
*** TURN *** [8h 2d Kd] [6s]
jumbo69 leaves the table
MiniCats321 joins the table at seat #2 
daria130399: bets $0.86
SuneSt: folds 
Uncalled bet ($0.86) returned to daria130399
daria130399 collected $2.61 from pot
daria130399: doesn't show hand 
*** SUMMARY ***
Total pot $2.75 | Rake $0.14 
Board [8h 2d Kd 6s]
Seat 1: SuneSt (button) folded on the Turn
Seat 3: Zager.v (small blind) folded before Flop
Seat 5: daria130399 (big blind) collected ($2.61)
Seat 6: MaximUSNG folded before Flop (didn't bet)
Seat 7: xobit26 folded before Flop (didn't bet)
Seat 8: jumbo69 folded before Flop (didn't bet)



PokerStars Hand #228696181953:  Hold'em No Limit ($0.25/$0.50 USD) - 2021/07/30 22:31:42 ET
Table 'Gorgo III' 9-max Seat #3 is the button
Seat 1: SuneSt ($50.75 in chips) 
Seat 3: Zager.v ($50 in chips) 
Seat 5: daria130399 ($51.36 in chips) 
Seat 7: xobit26 ($51.51 in chips) 
daria130399: posts small blind $0.25
MaximUSNG: is sitting out 
xobit26: posts big blind $0.50
MiniCats321: sits out 
*** HOLE CARDS ***
jumbo69 joins the table at seat #8 
SuneSt: raises $0.75 to $1.25
Zager.v: raises $2.99 to $4.24
Obormid joins the table at seat #4 
MaximUSNG leaves the table
daria130399: folds 
xobit26: raises $6.76 to $11
SuneSt: raises $39.75 to $50.75 and is all-in
Zager.v: folds 
xobit26 has timed out
xobit26: folds 
Uncalled bet ($39.75) returned to SuneSt
SuneSt collected $26.49 from pot
SuneSt: doesn't show hand 
*** SUMMARY ***
Total pot $26.49 | Rake $0 
Seat 1: SuneSt collected ($26.49)
Seat 3: Zager.v (button) folded before Flop
Seat 5: daria130399 (small blind) folded before Flop
Seat 7: xobit26 (big blind) folded before Flop



PokerStars Hand #228696203771:  Hold'em No Limit ($0.25/$0.50 USD) - 2021/07/30 22:32:35 ET
Table 'Gorgo III' 9-max Seat #5 is the button
Seat 1: SuneSt ($66.24 in chips) 
Seat 3: Zager.v ($50 in chips) 
Seat 4: Obormid ($40.28 in chips) 
Seat 5: daria130399 ($51.11 in chips) 
Seat 7: xobit26 ($50 in chips) 
Seat 8: jumbo69 ($34.63 in chips) 
xobit26: posts small blind $0.25
jumbo69: posts big blind $0.50
MiniCats321: sits out 
Obormid: posts big blind $0.50
*** HOLE CARDS ***
SwimmingPooI joins the table at seat #6 
SuneSt: raises $0.75 to $1.25
Zager.v: folds 
Obormid: folds 
daria130399: folds 
xobit26: folds 
jumbo69: calls $0.75
*** FLOP *** [7h 5c 8c]
xobit26 leaves the table
jumbo69: checks 
SuneSt: bets $1.67
jumbo69: raises $2.33 to $4
SuneSt: calls $2.33
*** TURN *** [7h 5c 8c] [7s]
jumbo69: bets $6.95
SuneSt: folds 
Uncalled bet ($6.95) returned to jumbo69
jumbo69 collected $10.69 from pot
*** SUMMARY ***
Total pot $11.25 | Rake $0.56 
Board [7h 5c 8c 7s]
Seat 1: SuneSt folded on the Turn
Seat 3: Zager.v folded before Flop (didn't bet)
Seat 4: Obormid folded before Flop (didn't bet)
Seat 5: daria130399 (button) folded before Flop (didn't bet)
Seat 7: xobit26 (small blind) folded before Flop
Seat 8: jumbo69 (big blind) collected ($10.69)



PokerStars Hand #228696221340:  Hold'em No Limit ($0.25/$0.50 USD) - 2021/07/30 22:33:25 ET
Table 'Gorgo III' 9-max Seat #8 is the button
Seat 1: SuneSt ($60.99 in chips) 
Seat 2: MiniCats321 ($40 in chips) 
Seat 3: Zager.v ($50 in chips) 
Seat 4: Obormid ($39.78 in chips) 
Seat 5: daria130399 ($51.11 in chips) 
Seat 8: jumbo69 ($40.07 in chips) 
SuneSt: posts small blind $0.25
MiniCats321: posts big blind $0.50
SwimmingPooI: sits out 
*** HOLE CARDS ***
Zager.v: folds 
Obormid: folds 
Zager.v leaves the table
daria130399: folds 
jumbo69: folds 
SuneSt: folds 
Uncalled bet ($0.25) returned to MiniCats321
MiniCats321 collected $0.50 from pot
MiniCats321: doesn't show hand 
*** SUMMARY ***
Total pot $0.50 | Rake $0 
Seat 1: SuneSt (small blind) folded before Flop
Seat 2: MiniCats321 (big blind) collected ($0.50)
Seat 3: Zager.v folded before Flop (didn't bet)
Seat 4: Obormid folded before Flop (didn't bet)
Seat 5: daria130399 folded before Flop (didn't bet)
Seat 8: jumbo69 (button) folded before Flop (didn't bet)



PokerStars Hand #228696225830:  Hold'em No Limit ($0.25/$0.50 USD) - 2021/07/30 22:33:45 ET
Table 'Gorgo III' 9-max Seat #1 is the button
Seat 1: SuneSt ($60.74 in chips) 
Seat 2: MiniCats321 ($40.25 in chips) 
Seat 4: Obormid ($39.78 in chips) 
Seat 5: daria130399 ($51.11 in chips) 
Seat 8: jumbo69 ($40.07 in chips) 
MiniCats321: posts small blind $0.25
Obormid: posts big blind $0.50
SwimmingPooI: sits out 
*** HOLE CARDS ***
daria130399: folds 
jumbo69: folds 
SuneSt: folds 
MiniCats321: folds 
Uncalled bet ($0.25) returned to Obormid
Obormid collected $0.50 from pot
Obormid: doesn't show hand 
*** SUMMARY ***
Total pot $0.50 | Rake $0 
Seat 1: SuneSt (button) folded before Flop (didn't bet)
Seat 2: MiniCats321 (small blind) folded before Flop
Seat 4: Obormid (big blind) collected ($0.50)
Seat 5: daria130399 folded before Flop (didn't bet)
Seat 8: jumbo69 folded before Flop (didn't bet)



PokerStars Hand #228696228785:  Hold'em No Limit ($0.25/$0.50 USD) - 2021/07/30 22:33:58 ET
Table 'Gorgo III' 9-max Seat #2 is the button
Seat 1: SuneSt ($60.74 in chips) 
Seat 2: MiniCats321 ($40 in chips) 
Seat 4: Obormid ($40.03 in chips) 
Seat 5: daria130399 ($51.11 in chips) 
Seat 8: jumbo69 ($40.07 in chips) 
Obormid: posts small blind $0.25
daria130399: posts big blind $0.50
SwimmingPooI: sits out 
*** HOLE CARDS ***
jumbo69: folds 
SuneSt: folds 
MiniCats321: calls $0.50
Obormid: calls $0.25
daria130399: checks 
*** FLOP *** [7d 4s Qc]
SparkYLive joins the table at seat #7 
AndyLu)|(ynski joins the table at seat #9 
Obormid: bets $1.50
SwimmingPooI was removed from the table for failing to post
SwimmingPooI leaves the table
daria130399: folds 
MiniCats321: folds 
Uncalled bet ($1.50) returned to Obormid
Obormid collected $1.42 from pot
Obormid: doesn't show hand 
*** SUMMARY ***
Total pot $1.50 | Rake $0.08 
Board [7d 4s Qc]
Seat 1: SuneSt folded before Flop (didn't bet)
Seat 2: MiniCats321 (button) folded on the Flop
Seat 4: Obormid (small blind) collected ($1.42)
Seat 5: daria130399 (big blind) folded on the Flop
Seat 8: jumbo69 folded before Flop (didn't bet)



PokerStars Hand #228696237748:  Hold'em No Limit ($0.25/$0.50 USD) - 2021/07/30 22:34:38 ET
Table 'Gorgo III' 9-max Seat #4 is the button
Seat 1: SuneSt ($60.74 in chips) 
Seat 2: MiniCats321 ($39.50 in chips) 
Seat 4: Obormid ($40.95 in chips) 
Seat 5: daria130399 ($50.61 in chips) 
Seat 7: SparkYLive ($50 in chips) 
Seat 8: jumbo69 ($40.07 in chips) 
daria130399: posts small blind $0.25
SparkYLive: posts big blind $0.50
*** HOLE CARDS ***
jumbo69: folds 
SuneSt: folds 
MiniCats321: folds 
Obormid: folds 
daria130399: raises $0.75 to $1.25
Dr. Margil joins the table at seat #3 
AndyLu)|(ynski leaves the table
SparkYLive: calls $0.75
*** FLOP *** [Js 6c 9d]
daria130399: bets $0.79
SparkYLive: calls $0.79
*** TURN *** [Js 6c 9d] [7d]
daria130399: bets $5.25
SparkYLive: calls $5.25
*** RIVER *** [Js 6c 9d 7d] [Ts]
oudine2 joins the table at seat #6 
daria130399: checks 
SparkYLive: bets $6.93
daria130399 has timed out
daria130399: folds 
Uncalled bet ($6.93) returned to SparkYLive
SparkYLive collected $13.85 from pot
SparkYLive: doesn't show hand 
*** SUMMARY ***
Total pot $14.58 | Rake $0.73 
Board [Js 6c 9d 7d Ts]
Seat 1: SuneSt folded before Flop (didn't bet)
Seat 2: MiniCats321 folded before Flop (didn't bet)
Seat 4: Obormid (button) folded before Flop (didn't bet)
Seat 5: daria130399 (small blind) folded on the River
Seat 7: SparkYLive (big blind) collected ($13.85)
Seat 8: jumbo69 folded before Flop (didn't bet)



PokerStars Hand #228696264830:  Hold'em No Limit ($0.25/$0.50 USD) - 2021/07/30 22:36:41 ET
Table 'Gorgo III' 9-max Seat #7 is the button
Seat 2: MiniCats321 ($39.50 in chips) 
Seat 4: Obormid ($40.95 in chips) 
Seat 7: SparkYLive ($56.56 in chips) 
Seat 8: jumbo69 ($40.07 in chips) 
jumbo69: posts small blind $0.25
SuneSt: is sitting out 
MiniCats321: posts big blind $0.50
Dr. Margil: sits out 
oudine2: sits out 
*** HOLE CARDS ***
Obormid: folds 
SuneSt leaves the table
SparkYLive: raises $0.85 to $1.35
jumbo69: raises $3.20 to $4.55
MiniCats321: folds 
TeddyKGB865 joins the table at seat #1 
SparkYLive: folds 
Uncalled bet ($3.20) returned to jumbo69
jumbo69 collected $3.20 from pot
*** SUMMARY ***
Total pot $3.20 | Rake $0 
Seat 2: MiniCats321 (big blind) folded before Flop
Seat 4: Obormid folded before Flop (didn't bet)
Seat 7: SparkYLive (button) folded before Flop
Seat 8: jumbo69 (small blind) collected ($3.20)



PokerStars Hand #228696270268:  Hold'em No Limit ($0.25/$0.50 USD) - 2021/07/30 22:37:05 ET
Table 'Gorgo III' 9-max Seat #8 is the button
Seat 2: MiniCats321 ($39 in chips) 
Seat 3: Dr. Margil ($40 in chips) 
Seat 4: Obormid ($40.95 in chips) 
Seat 5: daria130399 ($50 in chips) 
Seat 7: SparkYLive ($55.21 in chips) 
Seat 8: jumbo69 ($41.92 in chips) 
MiniCats321: posts small blind $0.25
Dr. Margil: posts big blind $0.50
oudine2: sits out 
*** HOLE CARDS ***
Obormid: folds 
daria130399: folds 
SparkYLive: folds 
jumbo69: raises $0.68 to $1.18
MiniCats321: folds 
Dr. Margil: calls $0.68
*** FLOP *** [2s 6h As]
Dr. Margil: checks 
jumbo69: bets $1.24
Dr. Margil: folds 
Uncalled bet ($1.24) returned to jumbo69
jumbo69 collected $2.48 from pot
*** SUMMARY ***
Total pot $2.61 | Rake $0.13 
Board [2s 6h As]
Seat 2: MiniCats321 (small blind) folded before Flop
Seat 3: Dr. Margil (big blind) folded on the Flop
Seat 4: Obormid folded before Flop (didn't bet)
Seat 5: daria130399 folded before Flop (didn't bet)
Seat 7: SparkYLive folded before Flop (didn't bet)
Seat 8: jumbo69 (button) collected ($2.48)



PokerStars Hand #228696277816:  Hold'em No Limit ($0.25/$0.50 USD) - 2021/07/30 22:37:39 ET
Table 'Gorgo III' 9-max Seat #2 is the button
Seat 1: TeddyKGB865 ($40 in chips) 
Seat 2: MiniCats321 ($38.75 in chips) 
Seat 3: Dr. Margil ($38.82 in chips) 
Seat 4: Obormid ($40.95 in chips) 
Seat 5: daria130399 ($50 in chips) 
Seat 7: SparkYLive ($55.21 in chips) 
Seat 8: jumbo69 ($43.22 in chips) 
Dr. Margil: posts small blind $0.25
Obormid: posts big blind $0.50
oudine2: sits out 
TeddyKGB865: posts big blind $0.50
*** HOLE CARDS ***
daria130399: folds 
SparkYLive: folds 
jumbo69: calls $0.50
daria130399 leaves the table
TeddyKGB865: checks 
MiniCats321: folds 
Dr. Margil: folds 
Obormid: checks 
*** FLOP *** [Th 3d 5d]
Obormid: checks 
KABAL_ua joins the table at seat #5 
jumbo69: bets $0.83
TeddyKGB865: folds 
Obormid: calls $0.83
*** TURN *** [Th 3d 5d] [6s]
Obormid: checks 
jumbo69: checks 
*** RIVER *** [Th 3d 5d 6s] [7c]
Obormid: bets $1.12
jumbo69: calls $1.12
*** SHOW DOWN ***
Obormid: shows [6c 4h] (a straight, Three to Seven)
jumbo69: mucks hand 
Obormid collected $5.37 from pot
*** SUMMARY ***
Total pot $5.65 | Rake $0.28 
Board [Th 3d 5d 6s 7c]
Seat 1: TeddyKGB865 folded on the Flop (didn't bet)
Seat 2: MiniCats321 (button) folded before Flop (didn't bet)
Seat 3: Dr. Margil (small blind) folded before Flop
Seat 4: Obormid (big blind) showed [6c 4h] and won ($5.37) with a straight, Three to Seven
Seat 5: daria130399 folded before Flop (didn't bet)
Seat 7: SparkYLive folded before Flop (didn't bet)
Seat 8: jumbo69 mucked



PokerStars Hand #228696290737:  Hold'em No Limit ($0.25/$0.50 USD) - 2021/07/30 22:38:38 ET
Table 'Gorgo III' 9-max Seat #3 is the button
Seat 1: TeddyKGB865 ($39.50 in chips) 
Seat 2: MiniCats321 ($38.75 in chips) 
Seat 3: Dr. Margil ($38.57 in chips) 
Seat 4: Obormid ($43.87 in chips) 
Seat 5: KABAL_ua ($50 in chips) 
Seat 7: SparkYLive ($55.21 in chips) 
Seat 8: jumbo69 ($40.77 in chips) 
Obormid: posts small blind $0.25
KABAL_ua: posts big blind $0.50
oudine2: sits out 
*** HOLE CARDS ***
SparkYLive: raises $1 to $1.50
jumbo69: folds 
TeddyKGB865: folds 
MiniCats321: raises $2.50 to $4
Dr. Margil: folds 
Obormid: folds 
KABAL_ua: folds 
chekita1965 joins the table at seat #9 
SparkYLive: folds 
Uncalled bet ($2.50) returned to MiniCats321
MiniCats321 collected $3.75 from pot
MiniCats321: doesn't show hand 
*** SUMMARY ***
Total pot $3.75 | Rake $0 
Seat 1: TeddyKGB865 folded before Flop (didn't bet)
Seat 2: MiniCats321 collected ($3.75)
Seat 3: Dr. Margil (button) folded before Flop (didn't bet)
Seat 4: Obormid (small blind) folded before Flop
Seat 5: KABAL_ua (big blind) folded before Flop
Seat 7: SparkYLive folded before Flop
Seat 8: jumbo69 folded before Flop (didn't bet)



PokerStars Hand #228696297433:  Hold'em No Limit ($0.25/$0.50 USD) - 2021/07/30 22:39:09 ET
Table 'Gorgo III' 9-max Seat #4 is the button
Seat 1: TeddyKGB865 ($39.50 in chips) 
Seat 2: MiniCats321 ($41 in chips) 
Seat 3: Dr. Margil ($38.57 in chips) 
Seat 4: Obormid ($43.62 in chips) 
Seat 5: KABAL_ua ($50 in chips) 
Seat 6: oudine2 ($50 in chips) 
Seat 7: SparkYLive ($53.71 in chips) 
Seat 8: jumbo69 ($40.77 in chips) 
KABAL_ua: posts small blind $0.25
oudine2: posts big blind $0.50
chekita1965: sits out 
*** HOLE CARDS ***
SparkYLive: folds 
jumbo69: folds 
TeddyKGB865: folds 
MiniCats321: raises $0.50 to $1
Dr. Margil: folds 
Obormid: calls $1
KABAL_ua: folds 
oudine2: folds 
*** FLOP *** [Ac Ah Qh]
MiniCats321: checks 
Obormid: bets $0.50
MiniCats321: calls $0.50
*** TURN *** [Ac Ah Qh] [Th]
MiniCats321: checks 
Obormid: bets $1
MiniCats321: calls $1
*** RIVER *** [Ac Ah Qh Th] [3c]
MiniCats321: checks 
Obormid: bets $2
MiniCats321: calls $2
*** SHOW DOWN ***
Obormid: shows [As 3s] (a full house, Aces full of Threes)
MiniCats321: mucks hand 
Obormid collected $9.26 from pot
*** SUMMARY ***
Total pot $9.75 | Rake $0.49 
Board [Ac Ah Qh Th 3c]
Seat 1: TeddyKGB865 folded before Flop (didn't bet)
Seat 2: MiniCats321 mucked
Seat 3: Dr. Margil folded before Flop (didn't bet)
Seat 4: Obormid (button) showed [As 3s] and won ($9.26) with a full house, Aces full of Threes
Seat 5: KABAL_ua (small blind) folded before Flop
Seat 6: oudine2 (big blind) folded before Flop
Seat 7: SparkYLive folded before Flop (didn't bet)
Seat 8: jumbo69 folded before Flop (didn't bet)



PokerStars Hand #228696307909:  Hold'em No Limit ($0.25/$0.50 USD) - 2021/07/30 22:39:57 ET
Table 'Gorgo III' 9-max Seat #5 is the button
Seat 1: TeddyKGB865 ($39.50 in chips) 
Seat 2: MiniCats321 ($36.50 in chips) 
Seat 3: Dr. Margil ($38.57 in chips) 
Seat 4: Obormid ($48.38 in chips) 
Seat 5: KABAL_ua ($50 in chips) 
Seat 6: oudine2 ($50 in chips) 
Seat 7: SparkYLive ($53.71 in chips) 
Seat 8: jumbo69 ($40.77 in chips) 
oudine2: posts small blind $0.25
SparkYLive: posts big blind $0.50
chekita1965: sits out 
*** HOLE CARDS ***
jumbo69: folds 
TeddyKGB865: folds 
MiniCats321: calls $0.50
Dr. Margil: folds 
Obormid: folds 
KABAL_ua: folds 
oudine2: folds 
SparkYLive: raises $2 to $2.50
MiniCats321: folds 
Uncalled bet ($2) returned to SparkYLive
SparkYLive collected $1.25 from pot
SparkYLive: doesn't show hand 
*** SUMMARY ***
Total pot $1.25 | Rake $0 
Seat 1: TeddyKGB865 folded before Flop (didn't bet)
Seat 2: MiniCats321 folded before Flop
Seat 3: Dr. Margil folded before Flop (didn't bet)
Seat 4: Obormid folded before Flop (didn't bet)
Seat 5: KABAL_ua (button) folded before Flop (didn't bet)
Seat 6: oudine2 (small blind) folded before Flop
Seat 7: SparkYLive (big blind) collected ($1.25)
Seat 8: jumbo69 folded before Flop (didn't bet)



PokerStars Hand #228696316142:  Hold'em No Limit ($0.25/$0.50 USD) - 2021/07/30 22:40:35 ET
Table 'Gorgo III' 9-max Seat #6 is the button
Seat 1: TeddyKGB865 ($39.50 in chips) 
Seat 2: MiniCats321 ($36 in chips) 
Seat 3: Dr. Margil ($38.57 in chips) 
Seat 4: Obormid ($48.38 in chips) 
Seat 5: KABAL_ua ($50 in chips) 
Seat 6: oudine2 ($50 in chips) 
Seat 7: SparkYLive ($54.46 in chips) 
Seat 8: jumbo69 ($40.77 in chips) 
SparkYLive: posts small blind $0.25
jumbo69: posts big blind $0.50
chekita1965: sits out 
*** HOLE CARDS ***
TeddyKGB865: folds 
MiniCats321: folds 
Dr. Margil: folds 
Obormid: folds 
KABAL_ua: raises $0.74 to $1.24
oudine2: folds 
SparkYLive: folds 
jumbo69: folds 
Uncalled bet ($0.74) returned to KABAL_ua
KABAL_ua collected $1.25 from pot
KABAL_ua: doesn't show hand 
*** SUMMARY ***
Total pot $1.25 | Rake $0 
Seat 1: TeddyKGB865 folded before Flop (didn't bet)
Seat 2: MiniCats321 folded before Flop (didn't bet)
Seat 3: Dr. Margil folded before Flop (didn't bet)
Seat 4: Obormid folded before Flop (didn't bet)
Seat 5: KABAL_ua collected ($1.25)
Seat 6: oudine2 (button) folded before Flop (didn't bet)
Seat 7: SparkYLive (small blind) folded before Flop
Seat 8: jumbo69 (big blind) folded before Flop



PokerStars Hand #228696319974:  Hold'em No Limit ($0.25/$0.50 USD) - 2021/07/30 22:40:53 ET
Table 'Gorgo III' 9-max Seat #7 is the button
Seat 1: TeddyKGB865 ($39.50 in chips) 
Seat 2: MiniCats321 ($36 in chips) 
Seat 3: Dr. Margil ($38.57 in chips) 
Seat 4: Obormid ($48.38 in chips) 
Seat 5: KABAL_ua ($50.75 in chips) 
Seat 6: oudine2 ($50 in chips) 
Seat 7: SparkYLive ($54.21 in chips) 
Seat 8: jumbo69 ($40.27 in chips) 
Seat 9: chekita1965 ($50 in chips) 
jumbo69: posts small blind $0.25
chekita1965: posts big blind $0.50
*** HOLE CARDS ***
TeddyKGB865: folds 
MiniCats321: folds 
Dr. Margil: folds 
Obormid: folds 
KABAL_ua: folds 
oudine2: folds 
SparkYLive: folds 
jumbo69: raises $0.50 to $1
chekita1965: calls $0.50
*** FLOP *** [Kh Js 8c]
jumbo69: bets $1.24
chekita1965: calls $1.24
*** TURN *** [Kh Js 8c] [Td]
jumbo69: bets $1.49
chekita1965: calls $1.49
*** RIVER *** [Kh Js 8c Td] [2h]
jumbo69: bets $2.48
chekita1965: calls $2.48
*** SHOW DOWN ***
jumbo69: shows [Kc Qd] (a pair of Kings)
chekita1965: mucks hand 
jumbo69 collected $11.80 from pot
*** SUMMARY ***
Total pot $12.42 | Rake $0.62 
Board [Kh Js 8c Td 2h]
Seat 1: TeddyKGB865 folded before Flop (didn't bet)
Seat 2: MiniCats321 folded before Flop (didn't bet)
Seat 3: Dr. Margil folded before Flop (didn't bet)
Seat 4: Obormid folded before Flop (didn't bet)
Seat 5: KABAL_ua folded before Flop (didn't bet)
Seat 6: oudine2 folded before Flop (didn't bet)
Seat 7: SparkYLive (button) folded before Flop (didn't bet)
Seat 8: jumbo69 (small blind) showed [Kc Qd] and won ($11.80) with a pair of Kings
Seat 9: chekita1965 (big blind) mucked



PokerStars Hand #228696328699:  Hold'em No Limit ($0.25/$0.50 USD) - 2021/07/30 22:41:33 ET
Table 'Gorgo III' 9-max Seat #8 is the button
Seat 1: TeddyKGB865 ($39.50 in chips) 
Seat 2: MiniCats321 ($36 in chips) 
Seat 3: Dr. Margil ($38.57 in chips) 
Seat 4: Obormid ($48.38 in chips) 
Seat 5: KABAL_ua ($50.75 in chips) 
Seat 6: oudine2 ($50 in chips) 
Seat 7: SparkYLive ($54.21 in chips) 
Seat 8: jumbo69 ($45.86 in chips) 
Seat 9: chekita1965 ($43.79 in chips) 
chekita1965: posts small blind $0.25
TeddyKGB865: posts big blind $0.50
*** HOLE CARDS ***
MiniCats321: folds 
Dr. Margil: folds 
Obormid: folds 
KABAL_ua: folds 
oudine2: folds 
SparkYLive: folds 
jumbo69: raises $0.50 to $1
chekita1965: raises $42.79 to $43.79 and is all-in
TeddyKGB865: folds 
jumbo69: folds 
Uncalled bet ($42.79) returned to chekita1965
chekita1965 collected $2.50 from pot
chekita1965: doesn't show hand 
*** SUMMARY ***
Total pot $2.50 | Rake $0 
Seat 1: TeddyKGB865 (big blind) folded before Flop
Seat 2: MiniCats321 folded before Flop (didn't bet)
Seat 3: Dr. Margil folded before Flop (didn't bet)
Seat 4: Obormid folded before Flop (didn't bet)
Seat 5: KABAL_ua folded before Flop (didn't bet)
Seat 6: oudine2 folded before Flop (didn't bet)
Seat 7: SparkYLive folded before Flop (didn't bet)
Seat 8: jumbo69 (button) folded before Flop
Seat 9: chekita1965 (small blind) collected ($2.50)



PokerStars Hand #228696334759:  Hold'em No Limit ($0.25/$0.50 USD) - 2021/07/30 22:42:01 ET
Table 'Gorgo III' 9-max Seat #9 is the button
Seat 1: TeddyKGB865 ($39 in chips) 
Seat 2: MiniCats321 ($36 in chips) 
Seat 3: Dr. Margil ($38.57 in chips) 
Seat 4: Obormid ($48.38 in chips) 
Seat 5: KABAL_ua ($50.75 in chips) 
Seat 6: oudine2 ($50 in chips) 
Seat 7: SparkYLive ($54.21 in chips) 
Seat 8: jumbo69 ($44.86 in chips) 
Seat 9: chekita1965 ($45.29 in chips) 
TeddyKGB865: posts small blind $0.25
MiniCats321: posts big blind $0.50
*** HOLE CARDS ***
Dr. Margil: folds 
Obormid: folds 
KABAL_ua: raises $0.74 to $1.24
oudine2: folds 
SparkYLive: folds 
jumbo69: folds 
chekita1965: folds 
TeddyKGB865: folds 
MiniCats321: calls $0.74
*** FLOP *** [Ts Ks 2h]
MiniCats321: checks 
KABAL_ua: bets $1.17
MiniCats321: calls $1.17
*** TURN *** [Ts Ks 2h] [4s]
MiniCats321: checks 
KABAL_ua: bets $3.62
MiniCats321: calls $3.62
*** RIVER *** [Ts Ks 2h 4s] [6h]
MiniCats321: checks 
KABAL_ua: checks 
*** SHOW DOWN ***
MiniCats321: shows [Th Js] (a pair of Tens)
KABAL_ua: shows [Kh Qs] (a pair of Kings)
KABAL_ua collected $11.69 from pot
*** SUMMARY ***
Total pot $12.31 | Rake $0.62 
Board [Ts Ks 2h 4s 6h]
Seat 1: TeddyKGB865 (small blind) folded before Flop
Seat 2: MiniCats321 (big blind) showed [Th Js] and lost with a pair of Tens
Seat 3: Dr. Margil folded before Flop (didn't bet)
Seat 4: Obormid folded before Flop (didn't bet)
Seat 5: KABAL_ua showed [Kh Qs] and won ($11.69) with a pair of Kings
Seat 6: oudine2 folded before Flop (didn't bet)
Seat 7: SparkYLive folded before Flop (didn't bet)
Seat 8: jumbo69 folded before Flop (didn't bet)
Seat 9: chekita1965 (button) folded before Flop (didn't bet)



PokerStars Hand #228696345312:  Hold'em No Limit ($0.25/$0.50 USD) - 2021/07/30 22:42:51 ET
Table 'Gorgo III' 9-max Seat #1 is the button
Seat 1: TeddyKGB865 ($38.75 in chips) 
Seat 2: MiniCats321 ($29.97 in chips) 
Seat 3: Dr. Margil ($38.57 in chips) 
Seat 4: Obormid ($48.38 in chips) 
Seat 5: KABAL_ua ($56.41 in chips) 
Seat 6: oudine2 ($50 in chips) 
Seat 7: SparkYLive ($54.21 in chips) 
Seat 8: jumbo69 ($44.86 in chips) 
Seat 9: chekita1965 ($45.29 in chips) 
MiniCats321: posts small blind $0.25
Dr. Margil: posts big blind $0.50
*** HOLE CARDS ***
Obormid: folds 
KABAL_ua: raises $0.74 to $1.24
oudine2: folds 
SparkYLive: folds 
jumbo69: folds 
chekita1965: folds 
TeddyKGB865: folds 
MiniCats321: folds 
Dr. Margil: folds 
Uncalled bet ($0.74) returned to KABAL_ua
KABAL_ua collected $1.25 from pot
KABAL_ua: doesn't show hand 
*** SUMMARY ***
Total pot $1.25 | Rake $0 
Seat 1: TeddyKGB865 (button) folded before Flop (didn't bet)
Seat 2: MiniCats321 (small blind) folded before Flop
Seat 3: Dr. Margil (big blind) folded before Flop
Seat 4: Obormid folded before Flop (didn't bet)
Seat 5: KABAL_ua collected ($1.25)
Seat 6: oudine2 folded before Flop (didn't bet)
Seat 7: SparkYLive folded before Flop (didn't bet)
Seat 8: jumbo69 folded before Flop (didn't bet)
Seat 9: chekita1965 folded before Flop (didn't bet)



PokerStars Hand #228696349253:  Hold'em No Limit ($0.25/$0.50 USD) - 2021/07/30 22:43:09 ET
Table 'Gorgo III' 9-max Seat #2 is the button
Seat 1: TeddyKGB865 ($38.75 in chips) 
Seat 2: MiniCats321 ($29.72 in chips) 
Seat 3: Dr. Margil ($38.07 in chips) 
Seat 4: Obormid ($48.38 in chips) 
Seat 5: KABAL_ua ($57.16 in chips) 
Seat 6: oudine2 ($50 in chips) 
Seat 7: SparkYLive ($54.21 in chips) 
Seat 8: jumbo69 ($44.86 in chips) 
Seat 9: chekita1965 ($45.29 in chips) 
Dr. Margil: posts small blind $0.25
Obormid: posts big blind $0.50
*** HOLE CARDS ***
KABAL_ua: folds 
oudine2: raises $1 to $1.50
SparkYLive: raises $3 to $4.50
jumbo69: folds 
chekita1965: folds 
TeddyKGB865: folds 
MiniCats321: folds 
Dr. Margil: folds 
Obormid: folds 
oudine2: calls $3
*** FLOP *** [Ad Js Jd]
oudine2: checks 
SparkYLive: checks 
*** TURN *** [Ad Js Jd] [4c]
oudine2: checks 
SparkYLive: bets $3.50
oudine2: folds 
Uncalled bet ($3.50) returned to SparkYLive
SparkYLive collected $9.26 from pot
SparkYLive: doesn't show hand 
*** SUMMARY ***
Total pot $9.75 | Rake $0.49 
Board [Ad Js Jd 4c]
Seat 1: TeddyKGB865 folded before Flop (didn't bet)
Seat 2: MiniCats321 (button) folded before Flop (didn't bet)
Seat 3: Dr. Margil (small blind) folded before Flop
Seat 4: Obormid (big blind) folded before Flop
Seat 5: KABAL_ua folded before Flop (didn't bet)
Seat 6: oudine2 folded on the Turn
Seat 7: SparkYLive collected ($9.26)
Seat 8: jumbo69 folded before Flop (didn't bet)
Seat 9: chekita1965 folded before Flop (didn't bet)



PokerStars Hand #228696357356:  Hold'em No Limit ($0.25/$0.50 USD) - 2021/07/30 22:43:46 ET
Table 'Gorgo III' 9-max Seat #3 is the button
Seat 1: TeddyKGB865 ($38.75 in chips) 
Seat 2: MiniCats321 ($29.72 in chips) 
Seat 3: Dr. Margil ($37.82 in chips) 
Seat 4: Obormid ($47.88 in chips) 
Seat 5: KABAL_ua ($57.16 in chips) 
Seat 6: oudine2 ($50 in chips) 
Seat 7: SparkYLive ($58.97 in chips) 
Seat 8: jumbo69 ($44.86 in chips) 
Seat 9: chekita1965 ($45.29 in chips) 
Obormid: posts small blind $0.25
KABAL_ua: posts big blind $0.50
*** HOLE CARDS ***
oudine2: folds 
SparkYLive: folds 
jumbo69: folds 
chekita1965: folds 
TeddyKGB865: calls $0.50
MiniCats321: calls $0.50
Dr. Margil: folds 
Obormid: folds 
KABAL_ua: checks 
*** FLOP *** [As 4c 8h]
KABAL_ua: checks 
TeddyKGB865: bets $0.83
MiniCats321: raises $0.83 to $1.66
KABAL_ua: folds 
TeddyKGB865: calls $0.83
*** TURN *** [As 4c 8h] [Kc]
TeddyKGB865: checks 
MiniCats321: bets $6
TeddyKGB865: folds [Ad]
Uncalled bet ($6) returned to MiniCats321
MiniCats321 collected $4.82 from pot
MiniCats321: doesn't show hand 
*** SUMMARY ***
Total pot $5.07 | Rake $0.25 
Board [As 4c 8h Kc]
Seat 1: TeddyKGB865 folded on the Turn
Seat 2: MiniCats321 collected ($4.82)
Seat 3: Dr. Margil (button) folded before Flop (didn't bet)
Seat 4: Obormid (small blind) folded before Flop
Seat 5: KABAL_ua (big blind) folded on the Flop
Seat 6: oudine2 folded before Flop (didn't bet)
Seat 7: SparkYLive folded before Flop (didn't bet)
Seat 8: jumbo69 folded before Flop (didn't bet)
Seat 9: chekita1965 folded before Flop (didn't bet)



PokerStars Hand #228696367640:  Hold'em No Limit ($0.25/$0.50 USD) - 2021/07/30 22:44:33 ET
Table 'Gorgo III' 9-max Seat #4 is the button
Seat 1: TeddyKGB865 ($36.59 in chips) 
Seat 2: MiniCats321 ($32.38 in chips) 
Seat 3: Dr. Margil ($37.82 in chips) 
Seat 4: Obormid ($47.63 in chips) 
Seat 5: KABAL_ua ($56.66 in chips) 
Seat 6: oudine2 ($50 in chips) 
Seat 7: SparkYLive ($58.97 in chips) 
Seat 8: jumbo69 ($44.86 in chips) 
Seat 9: chekita1965 ($45.29 in chips) 
KABAL_ua: posts small blind $0.25
oudine2: posts big blind $0.50
*** HOLE CARDS ***
SparkYLive: raises $1 to $1.50
jumbo69: folds 
chekita1965: calls $1.50
TeddyKGB865: folds 
MiniCats321: folds 
Dr. Margil: folds 
Obormid: folds 
KABAL_ua: folds 
oudine2: folds 
*** FLOP *** [4s Qd 7d]
SparkYLive: checks 
chekita1965: bets $2.78
SparkYLive: calls $2.78
*** TURN *** [4s Qd 7d] [4h]
SparkYLive: checks 
chekita1965: bets $4.42
SparkYLive: folds 
Uncalled bet ($4.42) returned to chekita1965
chekita1965 collected $8.84 from pot
chekita1965: doesn't show hand 
*** SUMMARY ***
Total pot $9.31 | Rake $0.47 
Board [4s Qd 7d 4h]
Seat 1: TeddyKGB865 folded before Flop (didn't bet)
Seat 2: MiniCats321 folded before Flop (didn't bet)
Seat 3: Dr. Margil folded before Flop (didn't bet)
Seat 4: Obormid (button) folded before Flop (didn't bet)
Seat 5: KABAL_ua (small blind) folded before Flop
Seat 6: oudine2 (big blind) folded before Flop
Seat 7: SparkYLive folded on the Turn
Seat 8: jumbo69 folded before Flop (didn't bet)
Seat 9: chekita1965 collected ($8.84)



PokerStars Hand #228696380518:  Hold'em No Limit ($0.25/$0.50 USD) - 2021/07/30 22:45:33 ET
Table 'Gorgo III' 9-max Seat #5 is the button
Seat 1: TeddyKGB865 ($36.59 in chips) 
Seat 2: MiniCats321 ($32.38 in chips) 
Seat 3: Dr. Margil ($37.82 in chips) 
Seat 4: Obormid ($47.63 in chips) 
Seat 5: KABAL_ua ($56.41 in chips) 
Seat 6: oudine2 ($50 in chips) 
Seat 8: jumbo69 ($44.86 in chips) 
Seat 9: chekita1965 ($49.85 in chips) 
oudine2: posts small blind $0.25
SparkYLive: is sitting out 
jumbo69: posts big blind $0.50
*** HOLE CARDS ***
chekita1965: folds 
TeddyKGB865: folds 
MiniCats321: raises $0.50 to $1
Dr. Margil: calls $1
Obormid: folds 
KABAL_ua: folds 
oudine2: folds 
jumbo69: calls $0.50
*** FLOP *** [Tc Td Qs]
jumbo69: checks 
MiniCats321: bets $2
Dr. Margil: calls $2
jumbo69: folds 
*** TURN *** [Tc Td Qs] [3s]
MiniCats321: bets $5.50
Dr. Margil: folds 
Uncalled bet ($5.50) returned to MiniCats321
MiniCats321 collected $6.89 from pot
MiniCats321: doesn't show hand 
*** SUMMARY ***
Total pot $7.25 | Rake $0.36 
Board [Tc Td Qs 3s]
Seat 1: TeddyKGB865 folded before Flop (didn't bet)
Seat 2: MiniCats321 collected ($6.89)
Seat 3: Dr. Margil folded on the Turn
Seat 4: Obormid folded before Flop (didn't bet)
Seat 5: KABAL_ua (button) folded before Flop (didn't bet)
Seat 6: oudine2 (small blind) folded before Flop
Seat 8: jumbo69 (big blind) folded on the Flop
Seat 9: chekita1965 folded before Flop (didn't bet)



PokerStars Hand #228696393472:  Hold'em No Limit ($0.25/$0.50 USD) - 2021/07/30 22:46:34 ET
Table 'Gorgo III' 9-max Seat #6 is the button
Seat 1: TeddyKGB865 ($36.59 in chips) 
Seat 2: MiniCats321 ($36.27 in chips) 
Seat 3: Dr. Margil ($34.82 in chips) 
Seat 4: Obormid ($47.63 in chips) 
Seat 5: KABAL_ua ($56.41 in chips) 
Seat 6: oudine2 ($50 in chips) 
Seat 8: jumbo69 ($43.86 in chips) 
Seat 9: chekita1965 ($49.85 in chips) 
jumbo69: posts small blind $0.25
chekita1965: posts big blind $0.50
*** HOLE CARDS ***
TeddyKGB865: folds 
MiniCats321: folds 
Dr. Margil: folds 
Obormid: folds 
KABAL_ua: folds 
oudine2: folds 
jumbo69: folds 
Uncalled bet ($0.25) returned to chekita1965
chekita1965 collected $0.50 from pot
chekita1965: doesn't show hand 
*** SUMMARY ***
Total pot $0.50 | Rake $0 
Seat 1: TeddyKGB865 folded before Flop (didn't bet)
Seat 2: MiniCats321 folded before Flop (didn't bet)
Seat 3: Dr. Margil folded before Flop (didn't bet)
Seat 4: Obormid folded before Flop (didn't bet)
Seat 5: KABAL_ua folded before Flop (didn't bet)
Seat 6: oudine2 (button) folded before Flop (didn't bet)
Seat 8: jumbo69 (small blind) folded before Flop
Seat 9: chekita1965 (big blind) collected ($0.50)



PokerStars Hand #228696395920:  Hold'em No Limit ($0.25/$0.50 USD) - 2021/07/30 22:46:45 ET
Table 'Gorgo III' 9-max Seat #8 is the button
Seat 1: TeddyKGB865 ($36.59 in chips) 
Seat 2: MiniCats321 ($36.27 in chips) 
Seat 3: Dr. Margil ($34.82 in chips) 
Seat 4: Obormid ($47.63 in chips) 
Seat 5: KABAL_ua ($56.41 in chips) 
Seat 6: oudine2 ($50 in chips) 
Seat 8: jumbo69 ($43.61 in chips) 
Seat 9: chekita1965 ($50.10 in chips) 
chekita1965: posts small blind $0.25
TeddyKGB865: posts big blind $0.50
*** HOLE CARDS ***
MiniCats321: folds 
Dr. Margil: folds 
Obormid: folds 
KABAL_ua: folds 
oudine2: folds 
jumbo69: raises $0.68 to $1.18
chekita1965: folds 
TeddyKGB865: folds 
Uncalled bet ($0.68) returned to jumbo69
jumbo69 collected $1.25 from pot
*** SUMMARY ***
Total pot $1.25 | Rake $0 
Seat 1: TeddyKGB865 (big blind) folded before Flop
Seat 2: MiniCats321 folded before Flop (didn't bet)
Seat 3: Dr. Margil folded before Flop (didn't bet)
Seat 4: Obormid folded before Flop (didn't bet)
Seat 5: KABAL_ua folded before Flop (didn't bet)
Seat 6: oudine2 folded before Flop (didn't bet)
Seat 8: jumbo69 (button) collected ($1.25)
Seat 9: chekita1965 (small blind) folded before Flop



PokerStars Hand #228696402261:  Hold'em No Limit ($0.25/$0.50 USD) - 2021/07/30 22:47:08 ET
Table 'Gorgo III' 9-max Seat #9 is the button
Seat 1: TeddyKGB865 ($36.09 in chips) 
Seat 2: MiniCats321 ($36.27 in chips) 
Seat 3: Dr. Margil ($34.82 in chips) 
Seat 4: Obormid ($47.63 in chips) 
Seat 5: KABAL_ua ($56.41 in chips) 
Seat 6: oudine2 ($50 in chips) 
Seat 8: jumbo69 ($44.36 in chips) 
Seat 9: chekita1965 ($49.85 in chips) 
TeddyKGB865: posts small blind $0.25
MiniCats321: posts big blind $0.50
*** HOLE CARDS ***
Dr. Margil: folds 
Obormid: folds 
KABAL_ua: folds 
oudine2: folds 
jumbo69: folds 
chekita1965: folds 
TeddyKGB865: calls $0.25
MiniCats321: raises $1 to $1.50
TeddyKGB865: folds 
Uncalled bet ($1) returned to MiniCats321
MiniCats321 collected $1 from pot
MiniCats321: doesn't show hand 
*** SUMMARY ***
Total pot $1 | Rake $0 
Seat 1: TeddyKGB865 (small blind) folded before Flop
Seat 2: MiniCats321 (big blind) collected ($1)
Seat 3: Dr. Margil folded before Flop (didn't bet)
Seat 4: Obormid folded before Flop (didn't bet)
Seat 5: KABAL_ua folded before Flop (didn't bet)
Seat 6: oudine2 folded before Flop (didn't bet)
Seat 8: jumbo69 folded before Flop (didn't bet)
Seat 9: chekita1965 (button) folded before Flop (didn't bet)



PokerStars Hand #228696410544:  Hold'em No Limit ($0.25/$0.50 USD) - 2021/07/30 22:47:46 ET
Table 'Gorgo III' 9-max Seat #1 is the button
Seat 1: TeddyKGB865 ($35.59 in chips) 
Seat 2: MiniCats321 ($36.77 in chips) 
Seat 3: Dr. Margil ($34.82 in chips) 
Seat 4: Obormid ($47.63 in chips) 
Seat 5: KABAL_ua ($56.41 in chips) 
Seat 6: oudine2 ($50 in chips) 
Seat 8: jumbo69 ($44.36 in chips) 
Seat 9: chekita1965 ($49.85 in chips) 
MiniCats321: posts small blind $0.25
Dr. Margil: posts big blind $0.50
*** HOLE CARDS ***
Obormid: folds 
KABAL_ua: folds 
oudine2: folds 
jumbo69: folds 
chekita1965: folds 
TeddyKGB865: raises $2 to $2.50
MiniCats321: folds 
Dr. Margil: folds 
Uncalled bet ($2) returned to TeddyKGB865
TeddyKGB865 collected $1.25 from pot
TeddyKGB865: doesn't show hand 
*** SUMMARY ***
Total pot $1.25 | Rake $0 
Seat 1: TeddyKGB865 (button) collected ($1.25)
Seat 2: MiniCats321 (small blind) folded before Flop
Seat 3: Dr. Margil (big blind) folded before Flop
Seat 4: Obormid folded before Flop (didn't bet)
Seat 5: KABAL_ua folded before Flop (didn't bet)
Seat 6: oudine2 folded before Flop (didn't bet)
Seat 8: jumbo69 folded before Flop (didn't bet)
Seat 9: chekita1965 folded before Flop (didn't bet)



PokerStars Hand #228696414324:  Hold'em No Limit ($0.25/$0.50 USD) - 2021/07/30 22:48:05 ET
Table 'Gorgo III' 9-max Seat #2 is the button
Seat 1: TeddyKGB865 ($36.34 in chips) 
Seat 2: MiniCats321 ($36.52 in chips) 
Seat 3: Dr. Margil ($34.32 in chips) 
Seat 4: Obormid ($47.63 in chips) 
Seat 5: KABAL_ua ($56.41 in chips) 
Seat 6: oudine2 ($50 in chips) 
Seat 8: jumbo69 ($44.36 in chips) 
Seat 9: chekita1965 ($49.85 in chips) 
Dr. Margil: posts small blind $0.25
Obormid: posts big blind $0.50
*** HOLE CARDS ***
KABAL_ua: folds 
oudine2: folds 
jumbo69: folds 
chekita1965: folds 
TeddyKGB865: folds 
MiniCats321: raises $0.50 to $1
Dr. Margil: folds 
Obormid: raises $2 to $3
MiniCats321: folds 
Uncalled bet ($2) returned to Obormid
Obormid collected $2.25 from pot
Obormid: doesn't show hand 
*** SUMMARY ***
Total pot $2.25 | Rake $0 
Seat 1: TeddyKGB865 folded before Flop (didn't bet)
Seat 2: MiniCats321 (button) folded before Flop
Seat 3: Dr. Margil (small blind) folded before Flop
Seat 4: Obormid (big blind) collected ($2.25)
Seat 5: KABAL_ua folded before Flop (didn't bet)
Seat 6: oudine2 folded before Flop (didn't bet)
Seat 8: jumbo69 folded before Flop (didn't bet)
Seat 9: chekita1965 folded before Flop (didn't bet)



PokerStars Hand #228696421117:  Hold'em No Limit ($0.25/$0.50 USD) - 2021/07/30 22:48:37 ET
Table 'Gorgo III' 9-max Seat #3 is the button
Seat 1: TeddyKGB865 ($36.34 in chips) 
Seat 2: MiniCats321 ($35.52 in chips) 
Seat 3: Dr. Margil ($34.07 in chips) 
Seat 4: Obormid ($48.88 in chips) 
Seat 6: oudine2 ($50 in chips) 
Seat 8: jumbo69 ($44.36 in chips) 
Seat 9: chekita1965 ($49.85 in chips) 
Obormid: posts small blind $0.25
KABAL_ua: is sitting out 
oudine2: posts big blind $0.50
*** HOLE CARDS ***
jumbo69: folds 
KABAL_ua leaves the table
Stingg joins the table at seat #5 
chekita1965 has timed out
chekita1965: folds 
TeddyKGB865: folds 
MiniCats321: folds 
Dr. Margil: folds 
Obormid: folds 
Uncalled bet ($0.25) returned to oudine2
oudine2 collected $0.50 from pot
oudine2: doesn't show hand 
*** SUMMARY ***
Total pot $0.50 | Rake $0 
Seat 1: TeddyKGB865 folded before Flop (didn't bet)
Seat 2: MiniCats321 folded before Flop (didn't bet)
Seat 3: Dr. Margil (button) folded before Flop (didn't bet)
Seat 4: Obormid (small blind) folded before Flop
Seat 6: oudine2 (big blind) collected ($0.50)
Seat 8: jumbo69 folded before Flop (didn't bet)
Seat 9: chekita1965 folded before Flop (didn't bet)



PokerStars Hand #228696427530:  Hold'em No Limit ($0.25/$0.50 USD) - 2021/07/30 22:49:07 ET
Table 'Gorgo III' 9-max Seat #4 is the button
Seat 1: TeddyKGB865 ($36.34 in chips) 
Seat 2: MiniCats321 ($35.52 in chips) 
Seat 3: Dr. Margil ($34.07 in chips) 
Seat 4: Obormid ($48.63 in chips) 
Seat 6: oudine2 ($50.25 in chips) 
Seat 8: jumbo69 ($44.36 in chips) 
Seat 9: chekita1965 ($49.85 in chips) 
oudine2: posts small blind $0.25
jumbo69: posts big blind $0.50
*** HOLE CARDS ***
chekita1965: calls $0.50
TeddyKGB865: raises $2.50 to $3
MiniCats321: folds 
Dr. Margil: folds 
Obormid: folds 
oudine2: folds 
jumbo69: folds 
chekita1965: raises $46.85 to $49.85 and is all-in
TeddyKGB865: calls $33.34 and is all-in
Uncalled bet ($13.51) returned to chekita1965
*** FLOP *** [7h 4s Ad]
*** TURN *** [7h 4s Ad] [Tc]
*** RIVER *** [7h 4s Ad Tc] [9d]
*** SHOW DOWN ***
chekita1965: shows [Qs Qc] (a pair of Queens)
TeddyKGB865: shows [Jd Js] (a pair of Jacks)
TeddyKGB865 cashed out the hand for $12.75 | Cash Out Fee $0.13
chekita1965 cashed out the hand for $57.96 | Cash Out Fee $0.59
*** SUMMARY ***
Total pot $73.43 | Rake $2 
Board [7h 4s Ad Tc 9d]
Seat 1: TeddyKGB865 showed [Jd Js] and lost with a pair of Jacks (cashed out).
Seat 2: MiniCats321 folded before Flop (didn't bet)
Seat 3: Dr. Margil folded before Flop (didn't bet)
Seat 4: Obormid (button) folded before Flop (didn't bet)
Seat 6: oudine2 (small blind) folded before Flop
Seat 8: jumbo69 (big blind) folded before Flop
Seat 9: chekita1965 showed [Qs Qc] and won ($71.43) with a pair of Queens (pot not awarded as player cashed out)



PokerStars Hand #228696440342:  Hold'em No Limit ($0.25/$0.50 USD) - 2021/07/30 22:50:08 ET
Table 'Gorgo III' 9-max Seat #6 is the button
Seat 1: TeddyKGB865 ($12.75 in chips) 
Seat 2: MiniCats321 ($35.52 in chips) 
Seat 3: Dr. Margil ($34.07 in chips) 
Seat 4: Obormid ($48.63 in chips) 
Seat 6: oudine2 ($50 in chips) 
Seat 8: jumbo69 ($43.86 in chips) 
Seat 9: chekita1965 ($71.47 in chips) 
jumbo69: posts small blind $0.25
chekita1965: posts big blind $0.50
Stingg: sits out 
*** HOLE CARDS ***
TeddyKGB865: calls $0.50
MiniCats321: folds 
Dr. Margil: folds 
Obormid: folds 
oudine2: folds 
jumbo69: raises $1.50 to $2
chekita1965: folds 
TeddyKGB865: calls $1.50
*** FLOP *** [Td 4s 9s]
jumbo69: checks 
TeddyKGB865: bets $2.14
jumbo69: folds 
Uncalled bet ($2.14) returned to TeddyKGB865
TeddyKGB865 collected $4.28 from pot
TeddyKGB865: doesn't show hand 
*** SUMMARY ***
Total pot $4.50 | Rake $0.22 
Board [Td 4s 9s]
Seat 1: TeddyKGB865 collected ($4.28)
Seat 2: MiniCats321 folded before Flop (didn't bet)
Seat 3: Dr. Margil folded before Flop (didn't bet)
Seat 4: Obormid folded before Flop (didn't bet)
Seat 6: oudine2 (button) folded before Flop (didn't bet)
Seat 8: jumbo69 (small blind) folded on the Flop
Seat 9: chekita1965 (big blind) folded before Flop



PokerStars Hand #228696449830:  Hold'em No Limit ($0.25/$0.50 USD) - 2021/07/30 22:50:54 ET
Table 'Gorgo III' 9-max Seat #8 is the button
Seat 1: TeddyKGB865 ($15.03 in chips) 
Seat 2: MiniCats321 ($35.52 in chips) 
Seat 3: Dr. Margil ($34.07 in chips) 
Seat 4: Obormid ($48.63 in chips) 
Seat 6: oudine2 ($50 in chips) 
Seat 8: jumbo69 ($41.86 in chips) 
Seat 9: chekita1965 ($70.97 in chips) 
chekita1965: posts small blind $0.25
TeddyKGB865: posts big blind $0.50
Stingg: sits out 
*** HOLE CARDS ***
MiniCats321: calls $0.50
Dr. Margil: folds 
Obormid: folds 
oudine2: folds 
jumbo69: folds 
chekita1965: folds 
TeddyKGB865: raises $14.53 to $15.03 and is all-in
MiniCats321: folds 
Uncalled bet ($14.53) returned to TeddyKGB865
TeddyKGB865 collected $1.25 from pot
TeddyKGB865: doesn't show hand 
*** SUMMARY ***
Total pot $1.25 | Rake $0 
Seat 1: TeddyKGB865 (big blind) collected ($1.25)
Seat 2: MiniCats321 folded before Flop
Seat 3: Dr. Margil folded before Flop (didn't bet)
Seat 4: Obormid folded before Flop (didn't bet)
Seat 6: oudine2 folded before Flop (didn't bet)
Seat 8: jumbo69 (button) folded before Flop (didn't bet)
Seat 9: chekita1965 (small blind) folded before Flop



PokerStars Hand #228696461852:  Hold'em No Limit ($0.25/$0.50 USD) - 2021/07/30 22:51:23 ET
Table 'Gorgo III' 9-max Seat #9 is the button
Seat 1: TeddyKGB865 ($15.78 in chips) 
Seat 2: MiniCats321 ($35.02 in chips) 
Seat 3: Dr. Margil ($34.07 in chips) 
Seat 4: Obormid ($48.63 in chips) 
Seat 6: oudine2 ($50 in chips) 
Seat 8: jumbo69 ($41.86 in chips) 
Seat 9: chekita1965 ($70.72 in chips) 
TeddyKGB865: posts small blind $0.25
MiniCats321: posts big blind $0.50
Stingg: sits out 
*** HOLE CARDS ***
Dr. Margil: calls $0.50
Obormid: folds 
oudine2: folds 
jumbo69: folds 
chekita1965: folds 
TeddyKGB865: calls $0.25
MiniCats321: checks 
*** FLOP *** [Qh 8d Ks]
TeddyKGB865: bets $2
MiniCats321: raises $3 to $5
Dr. Margil: folds 
TeddyKGB865: raises $10.28 to $15.28 and is all-in
MiniCats321: calls $10.28
*** TURN *** [Qh 8d Ks] [4s]
*** RIVER *** [Qh 8d Ks 4s] [Qc]
*** SHOW DOWN ***
TeddyKGB865: shows [Kh 5h] (two pair, Kings and Queens)
MiniCats321: shows [Kd 5d] (two pair, Kings and Queens)
TeddyKGB865 collected $15.23 from pot
MiniCats321 collected $15.23 from pot
*** SUMMARY ***
Total pot $32.06 | Rake $1.60 
Board [Qh 8d Ks 4s Qc]
Seat 1: TeddyKGB865 (small blind) showed [Kh 5h] and won ($15.23) with two pair, Kings and Queens
Seat 2: MiniCats321 (big blind) showed [Kd 5d] and won ($15.23) with two pair, Kings and Queens
Seat 3: Dr. Margil folded on the Flop
Seat 4: Obormid folded before Flop (didn't bet)
Seat 6: oudine2 folded before Flop (didn't bet)
Seat 8: jumbo69 folded before Flop (didn't bet)
Seat 9: chekita1965 (button) folded before Flop (didn't bet)



PokerStars Hand #228696471238:  Hold'em No Limit ($0.25/$0.50 USD) - 2021/07/30 22:52:08 ET
Table 'Gorgo III' 9-max Seat #1 is the button
Seat 1: TeddyKGB865 ($15.23 in chips) 
Seat 2: MiniCats321 ($34.47 in chips) 
Seat 3: Dr. Margil ($33.57 in chips) 
Seat 4: Obormid ($48.63 in chips) 
Seat 6: oudine2 ($50 in chips) 
Seat 8: jumbo69 ($41.86 in chips) 
Seat 9: chekita1965 ($70.72 in chips) 
MiniCats321: posts small blind $0.25
Dr. Margil: posts big blind $0.50
Stingg: sits out 
*** HOLE CARDS ***
Obormid: folds 
oudine2: folds 
jumbo69: raises $0.68 to $1.18
chekita1965: folds 
TeddyKGB865: folds 
MiniCats321: folds 
Dr. Margil: folds 
Uncalled bet ($0.68) returned to jumbo69
jumbo69 collected $1.25 from pot
*** SUMMARY ***
Total pot $1.25 | Rake $0 
Seat 1: TeddyKGB865 (button) folded before Flop (didn't bet)
Seat 2: MiniCats321 (small blind) folded before Flop
Seat 3: Dr. Margil (big blind) folded before Flop
Seat 4: Obormid folded before Flop (didn't bet)
Seat 6: oudine2 folded before Flop (didn't bet)
Seat 8: jumbo69 collected ($1.25)
Seat 9: chekita1965 folded before Flop (didn't bet)



PokerStars Hand #228696477925:  Hold'em No Limit ($0.25/$0.50 USD) - 2021/07/30 22:52:40 ET
Table 'Gorgo III' 9-max Seat #2 is the button
Seat 1: TeddyKGB865 ($15.23 in chips) 
Seat 2: MiniCats321 ($34.22 in chips) 
Seat 3: Dr. Margil ($33.07 in chips) 
Seat 5: Stingg ($50 in chips) 
Seat 6: oudine2 ($50 in chips) 
Seat 8: jumbo69 ($42.61 in chips) 
Seat 9: chekita1965 ($70.72 in chips) 
Dr. Margil: posts small blind $0.25
Obormid has timed out
Obormid: is sitting out 
Stingg: posts big blind $0.50
*** HOLE CARDS ***
oudine2: folds 
jumbo69: raises $0.68 to $1.18
Obormid is disconnected 
chekita1965: folds 
TeddyKGB865: raises $2.82 to $4
MiniCats321: folds 
Dr. Margil: folds 
Stingg: folds 
jumbo69: folds 
Uncalled bet ($2.82) returned to TeddyKGB865
TeddyKGB865 collected $3.11 from pot
TeddyKGB865: doesn't show hand 
*** SUMMARY ***
Total pot $3.11 | Rake $0 
Seat 1: TeddyKGB865 collected ($3.11)
Seat 2: MiniCats321 (button) folded before Flop (didn't bet)
Seat 3: Dr. Margil (small blind) folded before Flop
Seat 5: Stingg (big blind) folded before Flop
Seat 6: oudine2 folded before Flop (didn't bet)
Seat 8: jumbo69 folded before Flop
Seat 9: chekita1965 folded before Flop (didn't bet)



PokerStars Hand #228696493916:  Hold'em No Limit ($0.25/$0.50 USD) - 2021/07/30 22:53:23 ET
Table 'Gorgo III' 9-max Seat #3 is the button
Seat 1: TeddyKGB865 ($17.16 in chips) 
Seat 2: MiniCats321 ($34.22 in chips) 
Seat 3: Dr. Margil ($32.82 in chips) 
Seat 5: Stingg ($50 in chips) 
Seat 6: oudine2 ($50 in chips) 
Seat 8: jumbo69 ($41.43 in chips) 
Seat 9: chekita1965 ($70.72 in chips) 
Stingg: posts small blind $0.25
oudine2: posts big blind $0.50
*** HOLE CARDS ***
jumbo69: folds 
chekita1965: folds 
TeddyKGB865: folds 
MiniCats321: folds 
Dr. Margil: folds 
Stingg: folds 
Uncalled bet ($0.25) returned to oudine2
oudine2 collected $0.50 from pot
oudine2: doesn't show hand 
*** SUMMARY ***
Total pot $0.50 | Rake $0 
Seat 1: TeddyKGB865 folded before Flop (didn't bet)
Seat 2: MiniCats321 folded before Flop (didn't bet)
Seat 3: Dr. Margil (button) folded before Flop (didn't bet)
Seat 5: Stingg (small blind) folded before Flop
Seat 6: oudine2 (big blind) collected ($0.50)
Seat 8: jumbo69 folded before Flop (didn't bet)
Seat 9: chekita1965 folded before Flop (didn't bet)



PokerStars Hand #228696496593:  Hold'em No Limit ($0.25/$0.50 USD) - 2021/07/30 22:53:37 ET
Table 'Gorgo III' 9-max Seat #5 is the button
Seat 1: TeddyKGB865 ($17.16 in chips) 
Seat 2: MiniCats321 ($34.22 in chips) 
Seat 3: Dr. Margil ($32.82 in chips) 
Seat 4: Obormid ($48.63 in chips) 
Seat 5: Stingg ($50 in chips) 
Seat 6: oudine2 ($50.25 in chips) 
Seat 8: jumbo69 ($41.43 in chips) 
Seat 9: chekita1965 ($70.72 in chips) 
oudine2: posts small blind $0.25
jumbo69: posts big blind $0.50
Obormid: posts small & big blinds $0.75
*** HOLE CARDS ***
chekita1965: folds 
TeddyKGB865: folds 
MiniCats321: calls $0.50
Dr. Margil: folds 
Obormid: checks 
Stingg: raises $2.50 to $3
oudine2: folds 
jumbo69: folds 
MiniCats321: folds 
Obormid: folds 
Uncalled bet ($2.50) returned to Stingg
Stingg collected $2.50 from pot
Stingg: doesn't show hand 
*** SUMMARY ***
Total pot $2.50 | Rake $0 
Seat 1: TeddyKGB865 folded before Flop (didn't bet)
Seat 2: MiniCats321 folded before Flop
Seat 3: Dr. Margil folded before Flop (didn't bet)
Seat 4: Obormid folded before Flop (didn't bet)
Seat 5: Stingg (button) collected ($2.50)
Seat 6: oudine2 (small blind) folded before Flop
Seat 8: jumbo69 (big blind) folded before Flop
Seat 9: chekita1965 folded before Flop (didn't bet)



PokerStars Hand #228696502760:  Hold'em No Limit ($0.25/$0.50 USD) - 2021/07/30 22:54:06 ET
Table 'Gorgo III' 9-max Seat #6 is the button
Seat 1: TeddyKGB865 ($17.16 in chips) 
Seat 2: MiniCats321 ($33.72 in chips) 
Seat 3: Dr. Margil ($32.82 in chips) 
Seat 4: Obormid ($47.88 in chips) 
Seat 5: Stingg ($52 in chips) 
Seat 6: oudine2 ($50 in chips) 
Seat 8: jumbo69 ($40.93 in chips) 
jumbo69: posts small blind $0.25
chekita1965: is sitting out 
TeddyKGB865: posts big blind $0.50
*** HOLE CARDS ***
MiniCats321: calls $0.50
Dr. Margil: folds 
Obormid: folds 
Stingg: folds 
oudine2: folds 
jumbo69: calls $0.25
TeddyKGB865: checks 
*** FLOP *** [Ts 5c 6c]
chekita1965 is disconnected 
jumbo69: bets $0.71
TeddyKGB865: raises $3.79 to $4.50
MiniCats321: folds 
jumbo69: folds 
Uncalled bet ($3.79) returned to TeddyKGB865
TeddyKGB865 collected $2.77 from pot
TeddyKGB865: doesn't show hand 
*** SUMMARY ***
Total pot $2.92 | Rake $0.15 
Board [Ts 5c 6c]
Seat 1: TeddyKGB865 (big blind) collected ($2.77)
Seat 2: MiniCats321 folded on the Flop
Seat 3: Dr. Margil folded before Flop (didn't bet)
Seat 4: Obormid folded before Flop (didn't bet)
Seat 5: Stingg folded before Flop (didn't bet)
Seat 6: oudine2 (button) folded before Flop (didn't bet)
Seat 8: jumbo69 (small blind) folded on the Flop



PokerStars Hand #228696509918:  Hold'em No Limit ($0.25/$0.50 USD) - 2021/07/30 22:54:41 ET
Table 'Gorgo III' 9-max Seat #8 is the button
Seat 1: TeddyKGB865 ($18.72 in chips) 
Seat 2: MiniCats321 ($33.22 in chips) 
Seat 3: Dr. Margil ($32.82 in chips) 
Seat 4: Obormid ($47.88 in chips) 
Seat 5: Stingg ($52 in chips) 
Seat 6: oudine2 ($50 in chips) 
Seat 8: jumbo69 ($39.72 in chips) 
TeddyKGB865: posts small blind $0.25
MiniCats321: posts big blind $0.50
*** HOLE CARDS ***
Dr. Margil: raises $0.50 to $1
Obormid: folds 
Stingg: folds 
oudine2: folds 
jumbo69: folds 
TeddyKGB865: folds 
MiniCats321: calls $0.50
*** FLOP *** [3s 4d 6s]
MiniCats321: checks 
Dr. Margil: checks 
*** TURN *** [3s 4d 6s] [4h]
MiniCats321: checks 
Dr. Margil: bets $1.50
MiniCats321: folds 
Uncalled bet ($1.50) returned to Dr. Margil
Dr. Margil collected $2.14 from pot
Dr. Margil: doesn't show hand 
*** SUMMARY ***
Total pot $2.25 | Rake $0.11 
Board [3s 4d 6s 4h]
Seat 1: TeddyKGB865 (small blind) folded before Flop
Seat 2: MiniCats321 (big blind) folded on the Turn
Seat 3: Dr. Margil collected ($2.14)
Seat 4: Obormid folded before Flop (didn't bet)
Seat 5: Stingg folded before Flop (didn't bet)
Seat 6: oudine2 folded before Flop (didn't bet)
Seat 8: jumbo69 (button) folded before Flop (didn't bet)



PokerStars Hand #228696516213:  Hold'em No Limit ($0.25/$0.50 USD) - 2021/07/30 22:55:11 ET
Table 'Gorgo III' 9-max Seat #1 is the button
Seat 1: TeddyKGB865 ($18.47 in chips) 
Seat 2: MiniCats321 ($32.22 in chips) 
Seat 3: Dr. Margil ($33.96 in chips) 
Seat 4: Obormid ($47.88 in chips) 
Seat 5: Stingg ($52 in chips) 
Seat 6: oudine2 ($50 in chips) 
Seat 8: jumbo69 ($39.72 in chips) 
MiniCats321: posts small blind $0.25
Dr. Margil: posts big blind $0.50
*** HOLE CARDS ***
Obormid: folds 
Stingg: folds 
oudine2: folds 
jumbo69: raises $0.68 to $1.18
TeddyKGB865: folds 
MiniCats321: folds 
Dr. Margil: folds 
Uncalled bet ($0.68) returned to jumbo69
jumbo69 collected $1.25 from pot
*** SUMMARY ***
Total pot $1.25 | Rake $0 
Seat 1: TeddyKGB865 (button) folded before Flop (didn't bet)
Seat 2: MiniCats321 (small blind) folded before Flop
Seat 3: Dr. Margil (big blind) folded before Flop
Seat 4: Obormid folded before Flop (didn't bet)
Seat 5: Stingg folded before Flop (didn't bet)
Seat 6: oudine2 folded before Flop (didn't bet)
Seat 8: jumbo69 collected ($1.25)



PokerStars Hand #228696519032:  Hold'em No Limit ($0.25/$0.50 USD) - 2021/07/30 22:55:28 ET
Table 'Gorgo III' 9-max Seat #2 is the button
Seat 1: TeddyKGB865 ($18.47 in chips) 
Seat 2: MiniCats321 ($31.97 in chips) 
Seat 3: Dr. Margil ($33.46 in chips) 
Seat 4: Obormid ($47.88 in chips) 
Seat 5: Stingg ($52 in chips) 
Seat 6: oudine2 ($50 in chips) 
Seat 8: jumbo69 ($40.47 in chips) 
Dr. Margil: posts small blind $0.25
Obormid: posts big blind $0.50
*** HOLE CARDS ***
Stingg: folds 
oudine2: folds 
jumbo69: folds 
TeddyKGB865: raises $3.50 to $4
MiniCats321: folds 
Dr. Margil: folds 
Obormid: folds 
Uncalled bet ($3.50) returned to TeddyKGB865
TeddyKGB865 collected $1.25 from pot
TeddyKGB865: doesn't show hand 
*** SUMMARY ***
Total pot $1.25 | Rake $0 
Seat 1: TeddyKGB865 collected ($1.25)
Seat 2: MiniCats321 (button) folded before Flop (didn't bet)
Seat 3: Dr. Margil (small blind) folded before Flop
Seat 4: Obormid (big blind) folded before Flop
Seat 5: Stingg folded before Flop (didn't bet)
Seat 6: oudine2 folded before Flop (didn't bet)
Seat 8: jumbo69 folded before Flop (didn't bet)



PokerStars Hand #228696522014:  Hold'em No Limit ($0.25/$0.50 USD) - 2021/07/30 22:55:45 ET
Table 'Gorgo III' 9-max Seat #3 is the button
Seat 1: TeddyKGB865 ($19.22 in chips) 
Seat 2: MiniCats321 ($31.97 in chips) 
Seat 3: Dr. Margil ($33.21 in chips) 
Seat 4: Obormid ($47.38 in chips) 
Seat 5: Stingg ($52 in chips) 
Seat 6: oudine2 ($50 in chips) 
Seat 8: jumbo69 ($40.47 in chips) 
Obormid: posts small blind $0.25
Stingg: posts big blind $0.50
*** HOLE CARDS ***
oudine2: folds 
jumbo69: folds 
TeddyKGB865: calls $0.50
MiniCats321: folds 
Dr. Margil: raises $2 to $2.50
Obormid: raises $3 to $5.50
Stingg: folds 
TeddyKGB865: folds 
Dr. Margil: calls $3
*** FLOP *** [7h Qc 9h]
Obormid: bets $11.40
Dr. Margil: folds 
Uncalled bet ($11.40) returned to Obormid
Obormid collected $11.40 from pot
*** SUMMARY ***
Total pot $12 | Rake $0.60 
Board [7h Qc 9h]
Seat 1: TeddyKGB865 folded before Flop
Seat 2: MiniCats321 folded before Flop (didn't bet)
Seat 3: Dr. Margil (button) folded on the Flop
Seat 4: Obormid (small blind) collected ($11.40)
Seat 5: Stingg (big blind) folded before Flop
Seat 6: oudine2 folded before Flop (didn't bet)
Seat 8: jumbo69 folded before Flop (didn't bet)



PokerStars Hand #228696536346:  Hold'em No Limit ($0.25/$0.50 USD) - 2021/07/30 22:56:29 ET
Table 'Gorgo III' 9-max Seat #4 is the button
Seat 1: TeddyKGB865 ($18.72 in chips) 
Seat 2: MiniCats321 ($31.97 in chips) 
Seat 3: Dr. Margil ($27.71 in chips) 
Seat 4: Obormid ($53.28 in chips) 
Seat 5: Stingg ($51.50 in chips) 
Seat 8: jumbo69 ($40.47 in chips) 
Stingg: posts small blind $0.25
oudine2: is sitting out 
jumbo69: posts big blind $0.50
*** HOLE CARDS ***
oudine2 leaves the table
TeddyKGB865: calls $0.50
MiniCats321: folds 
Dr. Margil: folds 
Obormid: folds 
Stingg: calls $0.25
jumbo69: checks 
*** FLOP *** [Jh 9s 9d]
Stingg: checks 
jumbo69: checks 
TeddyKGB865: checks 
*** TURN *** [Jh 9s 9d] [8s]
Stingg: checks 
jumbo69: checks 
TeddyKGB865: bets $1.50
Stingg: folds 
jumbo69: calls $1.50
*** RIVER *** [Jh 9s 9d 8s] [Ah]
jumbo69: checks 
TeddyKGB865: checks 
*** SHOW DOWN ***
jumbo69: shows [3s As] (two pair, Aces and Nines)
TeddyKGB865: mucks hand 
jumbo69 collected $4.28 from pot
*** SUMMARY ***
Total pot $4.50 | Rake $0.22 
Board [Jh 9s 9d 8s Ah]
Seat 1: TeddyKGB865 mucked
Seat 2: MiniCats321 folded before Flop (didn't bet)
Seat 3: Dr. Margil folded before Flop (didn't bet)
Seat 4: Obormid (button) folded before Flop (didn't bet)
Seat 5: Stingg (small blind) folded on the Turn
Seat 8: jumbo69 (big blind) showed [3s As] and won ($4.28) with two pair, Aces and Nines



PokerStars Hand #228696545465:  Hold'em No Limit ($0.25/$0.50 USD) - 2021/07/30 22:57:21 ET
Table 'Gorgo III' 9-max Seat #5 is the button
Seat 1: TeddyKGB865 ($16.72 in chips) 
Seat 2: MiniCats321 ($31.97 in chips) 
Seat 3: Dr. Margil ($27.71 in chips) 
Seat 4: Obormid ($53.28 in chips) 
Seat 5: Stingg ($51 in chips) 
Seat 8: jumbo69 ($42.75 in chips) 
jumbo69: posts small blind $0.25
TeddyKGB865: posts big blind $0.50
*** HOLE CARDS ***
MiniCats321: calls $0.50
Dr. Margil: folds 
Obormid: folds 
Stingg: folds 
jumbo69: raises $0.68 to $1.18
TeddyKGB865: raises $2.82 to $4
MiniCats321: folds 
jumbo69: calls $2.82
*** FLOP *** [6h 4d 7c]
jumbo69: checks 
TeddyKGB865: bets $4.04
jumbo69: calls $4.04
*** TURN *** [6h 4d 7c] [Ts]
jumbo69: checks 
TeddyKGB865: bets $8.68 and is all-in
jumbo69: calls $8.68
LABALAFRE joins the table at seat #6 
*** RIVER *** [6h 4d 7c Ts] [Jc]
*** SHOW DOWN ***
jumbo69: shows [5h 5d] (a pair of Fives)
TeddyKGB865: shows [Ac Kh] (high card Ace)
jumbo69 cashed out the hand for $27.57 | Cash Out Fee $0.28
*** SUMMARY ***
Total pot $33.94 | Rake $1.70 
Board [6h 4d 7c Ts Jc]
Seat 1: TeddyKGB865 (big blind) showed [Ac Kh] and lost with high card Ace
Seat 2: MiniCats321 folded before Flop
Seat 3: Dr. Margil folded before Flop (didn't bet)
Seat 4: Obormid folded before Flop (didn't bet)
Seat 5: Stingg (button) folded before Flop (didn't bet)
Seat 8: jumbo69 (small blind) showed [5h 5d] and won ($32.24) with a pair of Fives (pot not awarded as player cashed out)



PokerStars Hand #228696554222:  Hold'em No Limit ($0.25/$0.50 USD) - 2021/07/30 22:58:12 ET
Table 'Gorgo III' 9-max Seat #8 is the button
Seat 2: MiniCats321 ($31.47 in chips) 
Seat 3: Dr. Margil ($27.71 in chips) 
Seat 4: Obormid ($53.28 in chips) 
Seat 5: Stingg ($51 in chips) 
Seat 6: LABALAFRE ($35.06 in chips) 
Seat 8: jumbo69 ($53.60 in chips) 
MiniCats321: posts small blind $0.25
Dr. Margil: posts big blind $0.50
LABALAFRE: posts big blind $0.50
*** HOLE CARDS ***
Obormid: folds 
Stingg: raises $1.50 to $2
LABALAFRE: calls $1.50
jumbo69: folds 
MiniCats321: folds 
Dr. Margil: folds 
*** FLOP *** [9s 2d 7s]
Stingg: checks 
TeddyKGB865 leaves the table
LABALAFRE: bets $2.25
Stingg: folds 
Uncalled bet ($2.25) returned to LABALAFRE
LABALAFRE collected $4.51 from pot
LABALAFRE: doesn't show hand 
*** SUMMARY ***
Total pot $4.75 | Rake $0.24 
Board [9s 2d 7s]
Seat 2: MiniCats321 (small blind) folded before Flop
Seat 3: Dr. Margil (big blind) folded before Flop
Seat 4: Obormid folded before Flop (didn't bet)
Seat 5: Stingg folded on the Flop
Seat 6: LABALAFRE collected ($4.51)
Seat 8: jumbo69 (button) folded before Flop (didn't bet)



PokerStars Hand #228696562893:  Hold'em No Limit ($0.25/$0.50 USD) - 2021/07/30 22:59:02 ET
Table 'Gorgo III' 9-max Seat #2 is the button
Seat 2: MiniCats321 ($31.22 in chips) 
Seat 3: Dr. Margil ($27.21 in chips) 
Seat 4: Obormid ($53.28 in chips) 
Seat 5: Stingg ($50 in chips) 
Seat 6: LABALAFRE ($37.57 in chips) 
Seat 8: jumbo69 ($53.60 in chips) 
Dr. Margil: posts small blind $0.25
cartman177 joins the table at seat #1 
Obormid: posts big blind $0.50
SparkYLive: sits out 
*** HOLE CARDS ***
Stingg: folds 
LABALAFRE: calls $0.50
jumbo69: raises $1.75 to $2.25
MiniCats321: folds 
Dr. Margil: folds 
Obormid: folds 
LABALAFRE: calls $1.75
*** FLOP *** [6c Jd Js]
LABALAFRE: checks 
jumbo69: bets $2.50
LABALAFRE: folds 
Uncalled bet ($2.50) returned to jumbo69
jumbo69 collected $4.99 from pot
*** SUMMARY ***
Total pot $5.25 | Rake $0.26 
Board [6c Jd Js]
Seat 2: MiniCats321 (button) folded before Flop (didn't bet)
Seat 3: Dr. Margil (small blind) folded before Flop
Seat 4: Obormid (big blind) folded before Flop
Seat 5: Stingg folded before Flop (didn't bet)
Seat 6: LABALAFRE folded on the Flop
Seat 8: jumbo69 collected ($4.99)



PokerStars Hand #228696568382:  Hold'em No Limit ($0.25/$0.50 USD) - 2021/07/30 22:59:34 ET
Table 'Gorgo III' 9-max Seat #3 is the button
Seat 2: MiniCats321 ($31.22 in chips) 
Seat 3: Dr. Margil ($49.96 in chips) 
Seat 4: Obormid ($52.78 in chips) 
Seat 5: Stingg ($50 in chips) 
Seat 6: LABALAFRE ($35.32 in chips) 
Seat 8: jumbo69 ($56.34 in chips) 
Obormid: posts small blind $0.25
Stingg: posts big blind $0.50
SparkYLive: sits out 
cartman177: sits out 
*** HOLE CARDS ***
LABALAFRE: calls $0.50
jumbo69: raises $1.75 to $2.25
MiniCats321: folds 
Dr. Margil: folds 
Obormid: folds 
Stingg: folds 
LABALAFRE: calls $1.75
*** FLOP *** [Ac Kc 2c]
LABALAFRE: checks 
jumbo69: bets $3.24
LABALAFRE: folds 
Uncalled bet ($3.24) returned to jumbo69
jumbo69 collected $4.99 from pot
*** SUMMARY ***
Total pot $5.25 | Rake $0.26 
Board [Ac Kc 2c]
Seat 2: MiniCats321 folded before Flop (didn't bet)
Seat 3: Dr. Margil (button) folded before Flop (didn't bet)
Seat 4: Obormid (small blind) folded before Flop
Seat 5: Stingg (big blind) folded before Flop
Seat 6: LABALAFRE folded on the Flop
Seat 8: jumbo69 collected ($4.99)



PokerStars Hand #228696574796:  Hold'em No Limit ($0.25/$0.50 USD) - 2021/07/30 23:00:10 ET
Table 'Gorgo III' 9-max Seat #4 is the button
Seat 2: MiniCats321 ($31.22 in chips) 
Seat 3: Dr. Margil ($49.96 in chips) 
Seat 4: Obormid ($52.53 in chips) 
Seat 5: Stingg ($50 in chips) 
Seat 6: LABALAFRE ($33.07 in chips) 
Seat 8: jumbo69 ($59.08 in chips) 
Stingg: posts small blind $0.25
LABALAFRE: posts big blind $0.50
SparkYLive: sits out 
cartman177: sits out 
*** HOLE CARDS ***
jumbo69: folds 
MiniCats321: calls $0.50
Dr. Margil: calls $0.50
Obormid: folds 
Stingg: raises $3 to $3.50
LABALAFRE: folds 
MiniCats321: folds 
Dr. Margil: folds 
Uncalled bet ($3) returned to Stingg
Stingg collected $2 from pot
Stingg: doesn't show hand 
*** SUMMARY ***
Total pot $2 | Rake $0 
Seat 2: MiniCats321 folded before Flop
Seat 3: Dr. Margil folded before Flop
Seat 4: Obormid (button) folded before Flop (didn't bet)
Seat 5: Stingg (small blind) collected ($2)
Seat 6: LABALAFRE (big blind) folded before Flop
Seat 8: jumbo69 folded before Flop (didn't bet)



PokerStars Hand #228696579864:  Hold'em No Limit ($0.25/$0.50 USD) - 2021/07/30 23:00:37 ET
Table 'Gorgo III' 9-max Seat #5 is the button
Seat 2: MiniCats321 ($30.72 in chips) 
Seat 3: Dr. Margil ($49.46 in chips) 
Seat 4: Obormid ($52.53 in chips) 
Seat 5: Stingg ($51.50 in chips) 
Seat 6: LABALAFRE ($32.57 in chips) 
Seat 7: SparkYLive ($54.69 in chips) 
Seat 8: jumbo69 ($59.08 in chips) 
LABALAFRE: posts small blind $0.25
SparkYLive: posts big blind $0.50
cartman177: sits out 
*** HOLE CARDS ***
jumbo69: folds 
MiniCats321: folds 
Dr. Margil: folds 
Obormid: folds 
Stingg: folds 
LABALAFRE: calls $0.25
SparkYLive: raises $1.25 to $1.75
LABALAFRE: calls $1.25
*** FLOP *** [Jc 8c Th]
LABALAFRE: checks 
SparkYLive: checks 
*** TURN *** [Jc 8c Th] [Ac]
LABALAFRE: bets $0.50
SparkYLive: calls $0.50
*** RIVER *** [Jc 8c Th Ac] [Qd]
LABALAFRE: bets $4.28
SparkYLive: folds 
Uncalled bet ($4.28) returned to LABALAFRE
LABALAFRE collected $4.28 from pot
LABALAFRE: doesn't show hand 
*** SUMMARY ***
Total pot $4.50 | Rake $0.22 
Board [Jc 8c Th Ac Qd]
Seat 2: MiniCats321 folded before Flop (didn't bet)
Seat 3: Dr. Margil folded before Flop (didn't bet)
Seat 4: Obormid folded before Flop (didn't bet)
Seat 5: Stingg (button) folded before Flop (didn't bet)
Seat 6: LABALAFRE (small blind) collected ($4.28)
Seat 7: SparkYLive (big blind) folded on the River
Seat 8: jumbo69 folded before Flop (didn't bet)



PokerStars Hand #228696591916:  Hold'em No Limit ($0.25/$0.50 USD) - 2021/07/30 23:01:39 ET
Table 'Gorgo III' 9-max Seat #6 is the button
Seat 2: MiniCats321 ($30.72 in chips) 
Seat 3: Dr. Margil ($49.46 in chips) 
Seat 4: Obormid ($52.53 in chips) 
Seat 5: Stingg ($51.50 in chips) 
Seat 6: LABALAFRE ($34.60 in chips) 
Seat 7: SparkYLive ($52.44 in chips) 
Seat 8: jumbo69 ($59.08 in chips) 
SparkYLive: posts small blind $0.25
jumbo69: posts big blind $0.50
cartman177: sits out 
*** HOLE CARDS ***
MiniCats321: calls $0.50
Dr. Margil: folds 
Obormid: folds 
Stingg: folds 
LABALAFRE: calls $0.50
SparkYLive: folds 
jumbo69: checks 
*** FLOP *** [Tc 9s 9h]
jumbo69: checks 
MiniCats321: bets $2
LABALAFRE: calls $2
jumbo69: folds 
*** TURN *** [Tc 9s 9h] [6s]
MiniCats321: checks 
LABALAFRE: bets $5.46
MiniCats321: folds 
Uncalled bet ($5.46) returned to LABALAFRE
LABALAFRE collected $5.46 from pot
LABALAFRE: doesn't show hand 
*** SUMMARY ***
Total pot $5.75 | Rake $0.29 
Board [Tc 9s 9h 6s]
Seat 2: MiniCats321 folded on the Turn
Seat 3: Dr. Margil folded before Flop (didn't bet)
Seat 4: Obormid folded before Flop (didn't bet)
Seat 5: Stingg folded before Flop (didn't bet)
Seat 6: LABALAFRE (button) collected ($5.46)
Seat 7: SparkYLive (small blind) folded before Flop
Seat 8: jumbo69 (big blind) folded on the Flop



PokerStars Hand #228696605299:  Hold'em No Limit ($0.25/$0.50 USD) - 2021/07/30 23:02:44 ET
Table 'Gorgo III' 9-max Seat #7 is the button
Seat 1: cartman177 ($50 in chips) 
Seat 2: MiniCats321 ($28.22 in chips) 
Seat 3: Dr. Margil ($49.46 in chips) 
Seat 4: Obormid ($52.53 in chips) 
Seat 5: Stingg ($51.50 in chips) 
Seat 6: LABALAFRE ($37.56 in chips) 
Seat 7: SparkYLive ($52.19 in chips) 
Seat 8: jumbo69 ($58.58 in chips) 
jumbo69: posts small blind $0.25
cartman177: posts big blind $0.50
*** HOLE CARDS ***
MiniCats321: folds 
Dr. Margil: folds 
Obormid: folds 
Stingg: folds 
LABALAFRE: calls $0.50
SparkYLive: folds 
jumbo69: calls $0.25
cartman177: checks 
*** FLOP *** [8h 4d 2s]
jumbo69: bets $0.50
cartman177: folds 
LABALAFRE: folds 
Uncalled bet ($0.50) returned to jumbo69
jumbo69 collected $1.42 from pot
*** SUMMARY ***
Total pot $1.50 | Rake $0.08 
Board [8h 4d 2s]
Seat 1: cartman177 (big blind) folded on the Flop
Seat 2: MiniCats321 folded before Flop (didn't bet)
Seat 3: Dr. Margil folded before Flop (didn't bet)
Seat 4: Obormid folded before Flop (didn't bet)
Seat 5: Stingg folded before Flop (didn't bet)
Seat 6: LABALAFRE folded on the Flop
Seat 7: SparkYLive (button) folded before Flop (didn't bet)
Seat 8: jumbo69 (small blind) collected ($1.42)



PokerStars Hand #228696617755:  Hold'em No Limit ($0.25/$0.50 USD) - 2021/07/30 23:03:45 ET
Table 'Gorgo III' 9-max Seat #8 is the button
Seat 1: cartman177 ($50 in chips) 
Seat 2: MiniCats321 ($33.21 in chips) 
Seat 3: Dr. Margil ($49.46 in chips) 
Seat 4: Obormid ($52.53 in chips) 
Seat 5: Stingg ($51.50 in chips) 
Seat 6: LABALAFRE ($37.06 in chips) 
Seat 7: SparkYLive ($52.19 in chips) 
Seat 8: jumbo69 ($59.50 in chips) 
cartman177: posts small blind $0.25
MiniCats321: posts big blind $0.50
*** HOLE CARDS ***
Dr. Margil: folds 
Obormid: folds 
Stingg: folds 
LABALAFRE: calls $0.50
SparkYLive: folds 
jumbo69: raises $1.75 to $2.25
cartman177: folds 
MiniCats321: folds 
LABALAFRE: calls $1.75
*** FLOP *** [7h Tc 4d]
LABALAFRE: checks 
jumbo69: bets $3.24
LABALAFRE: calls $3.24
*** TURN *** [7h Tc 4d] [8h]
chekita1965 was removed from the table for failing to post
chekita1965 leaves the table
LABALAFRE: checks 
jumbo69: checks 
*** RIVER *** [7h Tc 4d 8h] [Th]
KABAL_ua joins the table at seat #9 
LABALAFRE: bets $11.14
jumbo69: calls $11.14
*** SHOW DOWN ***
LABALAFRE: shows [4s 3s] (two pair, Tens and Fours)
jumbo69: shows [Jh Jc] (two pair, Jacks and Tens)
jumbo69 collected $32.31 from pot
*** SUMMARY ***
Total pot $34.01 | Rake $1.70 
Board [7h Tc 4d 8h Th]
Seat 1: cartman177 (small blind) folded before Flop
Seat 2: MiniCats321 (big blind) folded before Flop
Seat 3: Dr. Margil folded before Flop (didn't bet)
Seat 4: Obormid folded before Flop (didn't bet)
Seat 5: Stingg folded before Flop (didn't bet)
Seat 6: LABALAFRE showed [4s 3s] and lost with two pair, Tens and Fours
Seat 7: SparkYLive folded before Flop (didn't bet)
Seat 8: jumbo69 (button) showed [Jh Jc] and won ($32.31) with two pair, Jacks and Tens



PokerStars Hand #228696633564:  Hold'em No Limit ($0.25/$0.50 USD) - 2021/07/30 23:05:01 ET
Table 'Gorgo III' 9-max Seat #1 is the button
Seat 1: cartman177 ($50 in chips) 
Seat 2: MiniCats321 ($32.71 in chips) 
Seat 3: Dr. Margil ($49.46 in chips) 
Seat 4: Obormid ($52.53 in chips) 
Seat 5: Stingg ($51.50 in chips) 
Seat 6: LABALAFRE ($20.43 in chips) 
Seat 7: SparkYLive ($52.19 in chips) 
Seat 8: jumbo69 ($75.18 in chips) 
MiniCats321: posts small blind $0.25
Dr. Margil: posts big blind $0.50
KABAL_ua: sits out 
*** HOLE CARDS ***
Obormid: folds 
Stingg: folds 
LABALAFRE: folds 
SparkYLive: folds 
jumbo69: folds 
cartman177: folds 
MiniCats321: folds 
Uncalled bet ($0.25) returned to Dr. Margil
Dr. Margil collected $0.50 from pot
Dr. Margil: doesn't show hand 
*** SUMMARY ***
Total pot $0.50 | Rake $0 
Seat 1: cartman177 (button) folded before Flop (didn't bet)
Seat 2: MiniCats321 (small blind) folded before Flop
Seat 3: Dr. Margil (big blind) collected ($0.50)
Seat 4: Obormid folded before Flop (didn't bet)
Seat 5: Stingg folded before Flop (didn't bet)
Seat 6: LABALAFRE folded before Flop (didn't bet)
Seat 7: SparkYLive folded before Flop (didn't bet)
Seat 8: jumbo69 folded before Flop (didn't bet)



PokerStars Hand #228696636393:  Hold'em No Limit ($0.25/$0.50 USD) - 2021/07/30 23:05:15 ET
Table 'Gorgo III' 9-max Seat #2 is the button
Seat 1: cartman177 ($50 in chips) 
Seat 2: MiniCats321 ($32.46 in chips) 
Seat 3: Dr. Margil ($49.71 in chips) 
Seat 4: Obormid ($52.53 in chips) 
Seat 5: Stingg ($51.50 in chips) 
Seat 6: LABALAFRE ($20.43 in chips) 
Seat 7: SparkYLive ($52.19 in chips) 
Seat 8: jumbo69 ($75.18 in chips) 
Dr. Margil: posts small blind $0.25
Obormid: posts big blind $0.50
KABAL_ua: sits out 
*** HOLE CARDS ***
Stingg: folds 
LABALAFRE: calls $0.50
SparkYLive: folds 
jumbo69: folds 
cartman177: folds 
MiniCats321: folds 
Dr. Margil: calls $0.25
Obormid: checks 
*** FLOP *** [Kc As 9d]
Dr. Margil: checks 
Obormid: checks 
LABALAFRE: bets $1.42
Dr. Margil: folds 
Obormid: folds 
Uncalled bet ($1.42) returned to LABALAFRE
LABALAFRE collected $1.42 from pot
LABALAFRE: doesn't show hand 
*** SUMMARY ***
Total pot $1.50 | Rake $0.08 
Board [Kc As 9d]
Seat 1: cartman177 folded before Flop (didn't bet)
Seat 2: MiniCats321 (button) folded before Flop (didn't bet)
Seat 3: Dr. Margil (small blind) folded on the Flop
Seat 4: Obormid (big blind) folded on the Flop
Seat 5: Stingg folded before Flop (didn't bet)
Seat 6: LABALAFRE collected ($1.42)
Seat 7: SparkYLive folded before Flop (didn't bet)
Seat 8: jumbo69 folded before Flop (didn't bet)



PokerStars Hand #228696644131:  Hold'em No Limit ($0.25/$0.50 USD) - 2021/07/30 23:05:52 ET
Table 'Gorgo III' 9-max Seat #3 is the button
Seat 1: cartman177 ($50 in chips) 
Seat 2: MiniCats321 ($32.46 in chips) 
Seat 3: Dr. Margil ($49.21 in chips) 
Seat 4: Obormid ($52.03 in chips) 
Seat 5: Stingg ($51.50 in chips) 
Seat 6: LABALAFRE ($21.35 in chips) 
Seat 7: SparkYLive ($52.19 in chips) 
Seat 8: jumbo69 ($75.18 in chips) 
Obormid: posts small blind $0.25
Stingg: posts big blind $0.50
KABAL_ua: sits out 
*** HOLE CARDS ***
LABALAFRE: raises $0.50 to $1
SparkYLive: folds 
jumbo69: folds 
cartman177: folds 
MiniCats321: folds 
Dr. Margil: folds 
Obormid: folds 
Stingg: folds 
Uncalled bet ($0.50) returned to LABALAFRE
LABALAFRE collected $1.25 from pot
LABALAFRE: doesn't show hand 
*** SUMMARY ***
Total pot $1.25 | Rake $0 
Seat 1: cartman177 folded before Flop (didn't bet)
Seat 2: MiniCats321 folded before Flop (didn't bet)
Seat 3: Dr. Margil (button) folded before Flop (didn't bet)
Seat 4: Obormid (small blind) folded before Flop
Seat 5: Stingg (big blind) folded before Flop
Seat 6: LABALAFRE collected ($1.25)
Seat 7: SparkYLive folded before Flop (didn't bet)
Seat 8: jumbo69 folded before Flop (didn't bet)



PokerStars Hand #228696646931:  Hold'em No Limit ($0.25/$0.50 USD) - 2021/07/30 23:06:06 ET
Table 'Gorgo III' 9-max Seat #4 is the button
Seat 1: cartman177 ($50 in chips) 
Seat 2: MiniCats321 ($32.46 in chips) 
Seat 3: Dr. Margil ($49.21 in chips) 
Seat 4: Obormid ($51.78 in chips) 
Seat 5: Stingg ($51 in chips) 
Seat 6: LABALAFRE ($22.10 in chips) 
Seat 7: SparkYLive ($52.19 in chips) 
Seat 8: jumbo69 ($75.18 in chips) 
Stingg: posts small blind $0.25
LABALAFRE: posts big blind $0.50
KABAL_ua: sits out 
*** HOLE CARDS ***
SparkYLive: folds 
jumbo69: folds 
cartman177: folds 
MiniCats321: folds 
Dr. Margil: raises $1 to $1.50
Obormid: folds 
Stingg: folds 
LABALAFRE: calls $1
*** FLOP *** [Kh 2d 5c]
LABALAFRE: checks 
Dr. Margil: bets $1
LABALAFRE: calls $1
*** TURN *** [Kh 2d 5c] [4d]
LABALAFRE: checks 
Dr. Margil: checks 
*** RIVER *** [Kh 2d 5c 4d] [Td]
LABALAFRE: bets $4.99
Dr. Margil: folds 
Uncalled bet ($4.99) returned to LABALAFRE
LABALAFRE collected $4.99 from pot
LABALAFRE: doesn't show hand 
*** SUMMARY ***
Total pot $5.25 | Rake $0.26 
Board [Kh 2d 5c 4d Td]
Seat 1: cartman177 folded before Flop (didn't bet)
Seat 2: MiniCats321 folded before Flop (didn't bet)
Seat 3: Dr. Margil folded on the River
Seat 4: Obormid (button) folded before Flop (didn't bet)
Seat 5: Stingg (small blind) folded before Flop
Seat 6: LABALAFRE (big blind) collected ($4.99)
Seat 7: SparkYLive folded before Flop (didn't bet)
Seat 8: jumbo69 folded before Flop (didn't bet)



PokerStars Hand #228696653741:  Hold'em No Limit ($0.25/$0.50 USD) - 2021/07/30 23:06:38 ET
Table 'Gorgo III' 9-max Seat #5 is the button
Seat 1: cartman177 ($50 in chips) 
Seat 2: MiniCats321 ($32.46 in chips) 
Seat 3: Dr. Margil ($46.71 in chips) 
Seat 4: Obormid ($51.78 in chips) 
Seat 5: Stingg ($50.75 in chips) 
Seat 6: LABALAFRE ($24.59 in chips) 
Seat 7: SparkYLive ($52.19 in chips) 
Seat 8: jumbo69 ($75.18 in chips) 
LABALAFRE: posts small blind $0.25
SparkYLive: posts big blind $0.50
KABAL_ua: sits out 
*** HOLE CARDS ***
jumbo69 has timed out
jumbo69: folds 
cartman177: raises $1 to $1.50
MiniCats321: folds 
Dr. Margil: folds 
Obormid: folds 
Stingg: folds 
LABALAFRE: calls $1.25
SparkYLive: calls $1
*** FLOP *** [Jd As 2d]
LABALAFRE: checks 
SparkYLive: checks 
cartman177: checks 
*** TURN *** [Jd As 2d] [Kd]
LABALAFRE: bets $4.28
SparkYLive: folds 
cartman177: folds 
Uncalled bet ($4.28) returned to LABALAFRE
LABALAFRE collected $4.28 from pot
LABALAFRE: doesn't show hand 
*** SUMMARY ***
Total pot $4.50 | Rake $0.22 
Board [Jd As 2d Kd]
Seat 1: cartman177 folded on the Turn
Seat 2: MiniCats321 folded before Flop (didn't bet)
Seat 3: Dr. Margil folded before Flop (didn't bet)
Seat 4: Obormid folded before Flop (didn't bet)
Seat 5: Stingg (button) folded before Flop (didn't bet)
Seat 6: LABALAFRE (small blind) collected ($4.28)
Seat 7: SparkYLive (big blind) folded on the Turn
Seat 8: jumbo69 folded before Flop (didn't bet)



PokerStars Hand #228696665765:  Hold'em No Limit ($0.25/$0.50 USD) - 2021/07/30 23:07:37 ET
Table 'Gorgo III' 9-max Seat #6 is the button
Seat 1: cartman177 ($50 in chips) 
Seat 2: MiniCats321 ($32.46 in chips) 
Seat 3: Dr. Margil ($46.71 in chips) 
Seat 4: Obormid ($51.78 in chips) 
Seat 5: Stingg ($50.75 in chips) 
Seat 6: LABALAFRE ($27.37 in chips) 
Seat 7: SparkYLive ($50.69 in chips) 
Seat 8: jumbo69 ($75.18 in chips) 
SparkYLive: posts small blind $0.25
jumbo69: posts big blind $0.50
KABAL_ua: sits out 
*** HOLE CARDS ***
cartman177: folds 
MiniCats321: folds 
Dr. Margil: folds 
Obormid: folds 
Stingg: raises $0.75 to $1.25
LABALAFRE: folds 
LABALAFRE leaves the table
SparkYLive: folds 
jumbo69: calls $0.75
*** FLOP *** [5d 3s 8s]
jumbo69: checks 
Stingg: bets $1.12
crazycarno joins the table at seat #6 
jumbo69: folds 
Uncalled bet ($1.12) returned to Stingg
Stingg collected $2.61 from pot
Stingg: doesn't show hand 
*** SUMMARY ***
Total pot $2.75 | Rake $0.14 
Board [5d 3s 8s]
Seat 1: cartman177 folded before Flop (didn't bet)
Seat 2: MiniCats321 folded before Flop (didn't bet)
Seat 3: Dr. Margil folded before Flop (didn't bet)
Seat 4: Obormid folded before Flop (didn't bet)
Seat 5: Stingg collected ($2.61)
Seat 6: LABALAFRE (button) folded before Flop (didn't bet)
Seat 7: SparkYLive (small blind) folded before Flop
Seat 8: jumbo69 (big blind) folded on the Flop



PokerStars Hand #228696673179:  Hold'em No Limit ($0.25/$0.50 USD) - 2021/07/30 23:08:13 ET
Table 'Gorgo III' 9-max Seat #7 is the button
Seat 1: cartman177 ($50 in chips) 
Seat 2: MiniCats321 ($32.46 in chips) 
Seat 3: Dr. Margil ($46.71 in chips) 
Seat 4: Obormid ($51.78 in chips) 
Seat 5: Stingg ($52.11 in chips) 
Seat 6: crazycarno ($40 in chips) 
Seat 7: SparkYLive ($50.44 in chips) 
Seat 8: jumbo69 ($73.93 in chips) 
Seat 9: KABAL_ua ($56.41 in chips) 
jumbo69: posts small blind $0.25
KABAL_ua: posts big blind $0.50
crazycarno: posts big blind $0.50
*** HOLE CARDS ***
cartman177: folds 
MiniCats321: folds 
Dr. Margil: raises $0.50 to $1
Obormid: folds 
Stingg: folds 
crazycarno: calls $0.50
SparkYLive: folds 
jumbo69: folds 
KABAL_ua: calls $0.50
*** FLOP *** [3h 7d Jd]
KABAL_ua: checks 
Dr. Margil: checks 
crazycarno: checks 
*** TURN *** [3h 7d Jd] [Kd]
KABAL_ua: checks 
Dr. Margil: bets $2
crazycarno: calls $2
KABAL_ua: folds 
*** RIVER *** [3h 7d Jd Kd] [Tc]
Dr. Margil: bets $3.45
crazycarno: calls $3.45
*** SHOW DOWN ***
Dr. Margil: shows [Qd Ac] (a straight, Ten to Ace)
crazycarno: mucks hand 
Dr. Margil collected $13.44 from pot
*** SUMMARY ***
Total pot $14.15 | Rake $0.71 
Board [3h 7d Jd Kd Tc]
Seat 1: cartman177 folded before Flop (didn't bet)
Seat 2: MiniCats321 folded before Flop (didn't bet)
Seat 3: Dr. Margil showed [Qd Ac] and won ($13.44) with a straight, Ten to Ace
Seat 4: Obormid folded before Flop (didn't bet)
Seat 5: Stingg folded before Flop (didn't bet)
Seat 6: crazycarno mucked
Seat 7: SparkYLive (button) folded before Flop (didn't bet)
Seat 8: jumbo69 (small blind) folded before Flop
Seat 9: KABAL_ua (big blind) folded on the Turn



PokerStars Hand #228696682935:  Hold'em No Limit ($0.25/$0.50 USD) - 2021/07/30 23:09:01 ET
Table 'Gorgo III' 9-max Seat #8 is the button
Seat 1: cartman177 ($50 in chips) 
Seat 2: MiniCats321 ($32.46 in chips) 
Seat 3: Dr. Margil ($53.70 in chips) 
Seat 4: Obormid ($51.78 in chips) 
Seat 5: Stingg ($52.11 in chips) 
Seat 6: crazycarno ($33.55 in chips) 
Seat 7: SparkYLive ($50.44 in chips) 
Seat 8: jumbo69 ($73.68 in chips) 
Seat 9: KABAL_ua ($55.41 in chips) 
KABAL_ua: posts small blind $0.25
cartman177: posts big blind $0.50
*** HOLE CARDS ***
MiniCats321: folds 
Dr. Margil: folds 
Obormid: folds 
Stingg: folds 
crazycarno: folds 
SparkYLive: folds 
jumbo69: folds 
KABAL_ua: raises $0.99 to $1.49
cartman177: raises $2.98 to $4.47
KABAL_ua: folds 
Uncalled bet ($2.98) returned to cartman177
cartman177 collected $2.98 from pot
cartman177: doesn't show hand 
*** SUMMARY ***
Total pot $2.98 | Rake $0 
Seat 1: cartman177 (big blind) collected ($2.98)
Seat 2: MiniCats321 folded before Flop (didn't bet)
Seat 3: Dr. Margil folded before Flop (didn't bet)
Seat 4: Obormid folded before Flop (didn't bet)
Seat 5: Stingg folded before Flop (didn't bet)
Seat 6: crazycarno folded before Flop (didn't bet)
Seat 7: SparkYLive folded before Flop (didn't bet)
Seat 8: jumbo69 (button) folded before Flop (didn't bet)
Seat 9: KABAL_ua (small blind) folded before Flop



PokerStars Hand #228696689448:  Hold'em No Limit ($0.25/$0.50 USD) - 2021/07/30 23:09:33 ET
Table 'Gorgo III' 9-max Seat #9 is the button
Seat 1: cartman177 ($51.49 in chips) 
Seat 2: MiniCats321 ($32.46 in chips) 
Seat 3: Dr. Margil ($53.70 in chips) 
Seat 4: Obormid ($51.78 in chips) 
Seat 5: Stingg ($52.11 in chips) 
Seat 6: crazycarno ($33.55 in chips) 
Seat 7: SparkYLive ($50.44 in chips) 
Seat 8: jumbo69 ($73.68 in chips) 
Seat 9: KABAL_ua ($53.92 in chips) 
cartman177: posts small blind $0.25
MiniCats321: posts big blind $0.50
*** HOLE CARDS ***
Dr. Margil: folds 
Obormid: folds 
Stingg: folds 
crazycarno: calls $0.50
SparkYLive: folds 
jumbo69: calls $0.50
KABAL_ua: folds 
cartman177: folds 
MiniCats321: checks 
*** FLOP *** [Jc Td Kc]
MiniCats321: checks 
crazycarno: checks 
jumbo69: bets $0.83
MiniCats321: calls $0.83
crazycarno: calls $0.83
*** TURN *** [Jc Td Kc] [7d]
MiniCats321: checks 
crazycarno: checks 
jumbo69: checks 
*** RIVER *** [Jc Td Kc 7d] [7h]
MiniCats321: bets $4.03
crazycarno: folds 
jumbo69: folds 
Uncalled bet ($4.03) returned to MiniCats321
MiniCats321 collected $4.03 from pot
MiniCats321: doesn't show hand 
*** SUMMARY ***
Total pot $4.24 | Rake $0.21 
Board [Jc Td Kc 7d 7h]
Seat 1: cartman177 (small blind) folded before Flop
Seat 2: MiniCats321 (big blind) collected ($4.03)
Seat 3: Dr. Margil folded before Flop (didn't bet)
Seat 4: Obormid folded before Flop (didn't bet)
Seat 5: Stingg folded before Flop (didn't bet)
Seat 6: crazycarno folded on the River
Seat 7: SparkYLive folded before Flop (didn't bet)
Seat 8: jumbo69 folded on the River
Seat 9: KABAL_ua (button) folded before Flop (didn't bet)



PokerStars Hand #228696705074:  Hold'em No Limit ($0.25/$0.50 USD) - 2021/07/30 23:10:41 ET
Table 'Gorgo III' 9-max Seat #1 is the button
Seat 1: cartman177 ($51.24 in chips) 
Seat 2: MiniCats321 ($35.16 in chips) 
Seat 3: Dr. Margil ($53.70 in chips) 
Seat 4: Obormid ($51.78 in chips) 
Seat 5: Stingg ($52.11 in chips) 
Seat 6: crazycarno ($32.22 in chips) 
Seat 7: SparkYLive ($50.44 in chips) 
Seat 8: jumbo69 ($72.35 in chips) 
Seat 9: KABAL_ua ($53.92 in chips) 
MiniCats321: posts small blind $0.25
Dr. Margil: posts big blind $0.50
*** HOLE CARDS ***
Obormid: folds 
Stingg: folds 
crazycarno: calls $0.50
SparkYLive: folds 
jumbo69: calls $0.50
KABAL_ua: folds 
cartman177: folds 
MiniCats321: folds 
Dr. Margil: checks 
*** FLOP *** [7h 9d 3c]
Dr. Margil: checks 
crazycarno: bets $0.83
jumbo69: folds 
Dr. Margil: folds 
Uncalled bet ($0.83) returned to crazycarno
crazycarno collected $1.66 from pot
crazycarno: doesn't show hand 
*** SUMMARY ***
Total pot $1.75 | Rake $0.09 
Board [7h 9d 3c]
Seat 1: cartman177 (button) folded before Flop (didn't bet)
Seat 2: MiniCats321 (small blind) folded before Flop
Seat 3: Dr. Margil (big blind) folded on the Flop
Seat 4: Obormid folded before Flop (didn't bet)
Seat 5: Stingg folded before Flop (didn't bet)
Seat 6: crazycarno collected ($1.66)
Seat 7: SparkYLive folded before Flop (didn't bet)
Seat 8: jumbo69 folded on the Flop
Seat 9: KABAL_ua folded before Flop (didn't bet)



PokerStars Hand #228696713665:  Hold'em No Limit ($0.25/$0.50 USD) - 2021/07/30 23:11:10 ET
Table 'Gorgo III' 9-max Seat #2 is the button
Seat 1: cartman177 ($51.24 in chips) 
Seat 2: MiniCats321 ($34.91 in chips) 
Seat 3: Dr. Margil ($53.20 in chips) 
Seat 4: Obormid ($51.78 in chips) 
Seat 5: Stingg ($52.11 in chips) 
Seat 6: crazycarno ($33.38 in chips) 
Seat 7: SparkYLive ($50.44 in chips) 
Seat 8: jumbo69 ($71.85 in chips) 
Seat 9: KABAL_ua ($53.92 in chips) 
Dr. Margil: posts small blind $0.25
Obormid: posts big blind $0.50
*** HOLE CARDS ***
Stingg: folds 
crazycarno: calls $0.50
SparkYLive: folds 
jumbo69: folds 
KABAL_ua: raises $1.75 to $2.25
cartman177: raises $4.50 to $6.75
MiniCats321: folds 
Dr. Margil: folds 
Obormid: folds 
crazycarno: folds 
KABAL_ua: raises $8.75 to $15.50
cartman177: folds 
Uncalled bet ($8.75) returned to KABAL_ua
KABAL_ua collected $14.75 from pot
KABAL_ua: doesn't show hand 
*** SUMMARY ***
Total pot $14.75 | Rake $0 
Seat 1: cartman177 folded before Flop
Seat 2: MiniCats321 (button) folded before Flop (didn't bet)
Seat 3: Dr. Margil (small blind) folded before Flop
Seat 4: Obormid (big blind) folded before Flop
Seat 5: Stingg folded before Flop (didn't bet)
Seat 6: crazycarno folded before Flop
Seat 7: SparkYLive folded before Flop (didn't bet)
Seat 8: jumbo69 folded before Flop (didn't bet)
Seat 9: KABAL_ua collected ($14.75)



PokerStars Hand #228696724915:  Hold'em No Limit ($0.25/$0.50 USD) - 2021/07/30 23:12:06 ET
Table 'Gorgo III' 9-max Seat #3 is the button
Seat 1: cartman177 ($50 in chips) 
Seat 2: MiniCats321 ($34.91 in chips) 
Seat 3: Dr. Margil ($52.95 in chips) 
Seat 4: Obormid ($51.28 in chips) 
Seat 5: Stingg ($52.11 in chips) 
Seat 6: crazycarno ($32.88 in chips) 
Seat 7: SparkYLive ($50.44 in chips) 
Seat 8: jumbo69 ($71.85 in chips) 
Seat 9: KABAL_ua ($61.92 in chips) 
Obormid: posts small blind $0.25
Stingg: posts big blind $0.50
*** HOLE CARDS ***
crazycarno: calls $0.50
SparkYLive: folds 
jumbo69: folds 
KABAL_ua: folds 
cartman177: folds 
MiniCats321: folds 
Dr. Margil: folds 
Obormid: calls $0.25
Stingg: checks 
*** FLOP *** [2c 9s Qc]
Obormid: bets $0.71
Stingg: folds 
crazycarno: folds 
Uncalled bet ($0.71) returned to Obormid
Obormid collected $1.42 from pot
Obormid: doesn't show hand 
*** SUMMARY ***
Total pot $1.50 | Rake $0.08 
Board [2c 9s Qc]
Seat 1: cartman177 folded before Flop (didn't bet)
Seat 2: MiniCats321 folded before Flop (didn't bet)
Seat 3: Dr. Margil (button) folded before Flop (didn't bet)
Seat 4: Obormid (small blind) collected ($1.42)
Seat 5: Stingg (big blind) folded on the Flop
Seat 6: crazycarno folded on the Flop
Seat 7: SparkYLive folded before Flop (didn't bet)
Seat 8: jumbo69 folded before Flop (didn't bet)
Seat 9: KABAL_ua folded before Flop (didn't bet)



PokerStars Hand #228696730154:  Hold'em No Limit ($0.25/$0.50 USD) - 2021/07/30 23:12:33 ET
Table 'Gorgo III' 9-max Seat #4 is the button
Seat 1: cartman177 ($50 in chips) 
Seat 2: MiniCats321 ($34.91 in chips) 
Seat 3: Dr. Margil ($52.95 in chips) 
Seat 4: Obormid ($52.20 in chips) 
Seat 5: Stingg ($51.61 in chips) 
Seat 6: crazycarno ($32.38 in chips) 
Seat 7: SparkYLive ($50.44 in chips) 
Seat 8: jumbo69 ($71.85 in chips) 
Seat 9: KABAL_ua ($61.92 in chips) 
Stingg: posts small blind $0.25
crazycarno: posts big blind $0.50
*** HOLE CARDS ***
SparkYLive: folds 
jumbo69: folds 
KABAL_ua: folds 
cartman177: folds 
MiniCats321: raises $0.50 to $1
Dr. Margil: folds 
Obormid: folds 
Stingg: raises $3.50 to $4.50
crazycarno: folds 
MiniCats321: folds 
Uncalled bet ($3.50) returned to Stingg
Stingg collected $2.50 from pot
Stingg: doesn't show hand 
*** SUMMARY ***
Total pot $2.50 | Rake $0 
Seat 1: cartman177 folded before Flop (didn't bet)
Seat 2: MiniCats321 folded before Flop
Seat 3: Dr. Margil folded before Flop (didn't bet)
Seat 4: Obormid (button) folded before Flop (didn't bet)
Seat 5: Stingg (small blind) collected ($2.50)
Seat 6: crazycarno (big blind) folded before Flop
Seat 7: SparkYLive folded before Flop (didn't bet)
Seat 8: jumbo69 folded before Flop (didn't bet)
Seat 9: KABAL_ua folded before Flop (didn't bet)



PokerStars Hand #228696734241:  Hold'em No Limit ($0.25/$0.50 USD) - 2021/07/30 23:12:53 ET
Table 'Gorgo III' 9-max Seat #5 is the button
Seat 1: cartman177 ($50 in chips) 
Seat 2: MiniCats321 ($33.91 in chips) 
Seat 3: Dr. Margil ($52.95 in chips) 
Seat 4: Obormid ($52.20 in chips) 
Seat 5: Stingg ($53.11 in chips) 
Seat 6: crazycarno ($31.88 in chips) 
Seat 7: SparkYLive ($50.44 in chips) 
Seat 8: jumbo69 ($71.85 in chips) 
Seat 9: KABAL_ua ($61.92 in chips) 
crazycarno: posts small blind $0.25
SparkYLive: posts big blind $0.50
*** HOLE CARDS ***
jumbo69: folds 
KABAL_ua: folds 
cartman177: folds 
MiniCats321: folds 
Dr. Margil: calls $0.50
Obormid: folds 
Stingg: folds 
crazycarno: raises $0.50 to $1
SparkYLive: folds 
Dr. Margil: calls $0.50
*** FLOP *** [4s 3d 5d]
crazycarno: bets $1.19
Dr. Margil: calls $1.19
*** TURN *** [4s 3d 5d] [Js]
crazycarno: checks 
Dr. Margil: checks 
*** RIVER *** [4s 3d 5d Js] [3h]
crazycarno: bets $2.32
Dr. Margil: calls $2.32
*** SHOW DOWN ***
crazycarno: shows [As 7h] (a pair of Threes)
Dr. Margil: shows [5h Ah] (two pair, Fives and Threes)
Dr. Margil collected $9.04 from pot
*** SUMMARY ***
Total pot $9.52 | Rake $0.48 
Board [4s 3d 5d Js 3h]
Seat 1: cartman177 folded before Flop (didn't bet)
Seat 2: MiniCats321 folded before Flop (didn't bet)
Seat 3: Dr. Margil showed [5h Ah] and won ($9.04) with two pair, Fives and Threes
Seat 4: Obormid folded before Flop (didn't bet)
Seat 5: Stingg (button) folded before Flop (didn't bet)
Seat 6: crazycarno (small blind) showed [As 7h] and lost with a pair of Threes
Seat 7: SparkYLive (big blind) folded before Flop
Seat 8: jumbo69 folded before Flop (didn't bet)
Seat 9: KABAL_ua folded before Flop (didn't bet)



PokerStars Hand #228696745491:  Hold'em No Limit ($0.25/$0.50 USD) - 2021/07/30 23:13:49 ET
Table 'Gorgo III' 9-max Seat #6 is the button
Seat 1: cartman177 ($50 in chips) 
Seat 2: MiniCats321 ($33.91 in chips) 
Seat 3: Dr. Margil ($57.48 in chips) 
Seat 4: Obormid ($52.20 in chips) 
Seat 5: Stingg ($53.11 in chips) 
Seat 6: crazycarno ($27.37 in chips) 
Seat 7: SparkYLive ($50 in chips) 
Seat 8: jumbo69 ($71.85 in chips) 
Seat 9: KABAL_ua ($61.92 in chips) 
SparkYLive: posts small blind $0.25
jumbo69: posts big blind $0.50
*** HOLE CARDS ***
KABAL_ua: folds 
cartman177: folds 
KABAL_ua leaves the table
MiniCats321: folds 
Dr. Margil: folds 
Obormid: folds 
Stingg: raises $0.75 to $1.25
crazycarno: calls $1.25
SparkYLive: folds 
lexon3 joins the table at seat #9 
jumbo69: calls $0.75
*** FLOP *** [Kh 6d Jh]
jumbo69: checks 
Stingg: bets $2.70
crazycarno: calls $2.70
jumbo69: folds 
*** TURN *** [Kh 6d Jh] [Th]
Stingg: checks 
crazycarno: bets $4.46
Stingg: calls $4.46
*** RIVER *** [Kh 6d Jh Th] [6h]
Stingg: bets $44.70 and is all-in
crazycarno: calls $18.96 and is all-in
Uncalled bet ($25.74) returned to Stingg
*** SHOW DOWN ***
Stingg: shows [Ks 6s] (a full house, Sixes full of Kings)
crazycarno: shows [Js Ts] (two pair, Jacks and Tens)
Stingg collected $54.24 from pot
*** SUMMARY ***
Total pot $56.24 | Rake $2 
Board [Kh 6d Jh Th 6h]
Seat 1: cartman177 folded before Flop (didn't bet)
Seat 2: MiniCats321 folded before Flop (didn't bet)
Seat 3: Dr. Margil folded before Flop (didn't bet)
Seat 4: Obormid folded before Flop (didn't bet)
Seat 5: Stingg showed [Ks 6s] and won ($54.24) with a full house, Sixes full of Kings
Seat 6: crazycarno (button) showed [Js Ts] and lost with two pair, Jacks and Tens
Seat 7: SparkYLive (small blind) folded before Flop
Seat 8: jumbo69 (big blind) folded on the Flop
Seat 9: KABAL_ua folded before Flop (didn't bet)



PokerStars Hand #228696757460:  Hold'em No Limit ($0.25/$0.50 USD) - 2021/07/30 23:14:49 ET
Table 'Gorgo III' 9-max Seat #7 is the button
Seat 1: cartman177 ($50 in chips) 
Seat 2: MiniCats321 ($33.91 in chips) 
Seat 3: Dr. Margil ($57.48 in chips) 
Seat 4: Obormid ($52.20 in chips) 
Seat 5: Stingg ($79.98 in chips) 
Seat 7: SparkYLive ($50 in chips) 
Seat 8: jumbo69 ($70.60 in chips) 
Seat 9: lexon3 ($50 in chips) 
jumbo69: posts small blind $0.25
lexon3: posts big blind $0.50
*** HOLE CARDS ***
cartman177: raises $1 to $1.50
MiniCats321: folds 
Dr. Margil: calls $1.50
Obormid: folds 
Stingg: folds 
SparkYLive: folds 
jumbo69: folds 
lexon3: folds 
*** FLOP *** [Tc Ac 8h]
cartman177: bets $1.78
Dr. Margil: calls $1.78
*** TURN *** [Tc Ac 8h] [4d]
cartman177: bets $4
Dr. Margil: folds 
Uncalled bet ($4) returned to cartman177
cartman177 collected $6.94 from pot
cartman177: doesn't show hand 
*** SUMMARY ***
Total pot $7.31 | Rake $0.37 
Board [Tc Ac 8h 4d]
Seat 1: cartman177 collected ($6.94)
Seat 2: MiniCats321 folded before Flop (didn't bet)
Seat 3: Dr. Margil folded on the Turn
Seat 4: Obormid folded before Flop (didn't bet)
Seat 5: Stingg folded before Flop (didn't bet)
Seat 7: SparkYLive (button) folded before Flop (didn't bet)
Seat 8: jumbo69 (small blind) folded before Flop
Seat 9: lexon3 (big blind) folded before Flop



PokerStars Hand #228696767235:  Hold'em No Limit ($0.25/$0.50 USD) - 2021/07/30 23:15:37 ET
Table 'Gorgo III' 9-max Seat #8 is the button
Seat 1: cartman177 ($53.66 in chips) 
Seat 2: MiniCats321 ($33.91 in chips) 
Seat 3: Dr. Margil ($54.20 in chips) 
Seat 4: Obormid ($52.20 in chips) 
Seat 5: Stingg ($79.98 in chips) 
Seat 6: crazycarno ($37.74 in chips) 
Seat 7: SparkYLive ($50 in chips) 
Seat 8: jumbo69 ($70.35 in chips) 
Seat 9: lexon3 ($50 in chips) 
lexon3: posts small blind $0.25
cartman177: posts big blind $0.50
*** HOLE CARDS ***
MiniCats321: folds 
Dr. Margil: raises $0.50 to $1
Obormid: folds 
Stingg: folds 
crazycarno: calls $1
SparkYLive: folds 
jumbo69: folds 
lexon3: folds 
cartman177: folds 
*** FLOP *** [5s Jh 7h]
Dr. Margil: bets $1.31
crazycarno: calls $1.31
*** TURN *** [5s Jh 7h] [As]
Dr. Margil: checks 
crazycarno: checks 
*** RIVER *** [5s Jh 7h As] [Jd]
Dr. Margil: checks 
crazycarno: bets $2.55
Dr. Margil: raises $5.10 to $7.65
crazycarno: folds 
Uncalled bet ($5.10) returned to Dr. Margil
Dr. Margil collected $9.95 from pot
Dr. Margil: doesn't show hand 
*** SUMMARY ***
Total pot $10.47 | Rake $0.52 
Board [5s Jh 7h As Jd]
Seat 1: cartman177 (big blind) folded before Flop
Seat 2: MiniCats321 folded before Flop (didn't bet)
Seat 3: Dr. Margil collected ($9.95)
Seat 4: Obormid folded before Flop (didn't bet)
Seat 5: Stingg folded before Flop (didn't bet)
Seat 6: crazycarno folded on the River
Seat 7: SparkYLive folded before Flop (didn't bet)
Seat 8: jumbo69 (button) folded before Flop (didn't bet)
Seat 9: lexon3 (small blind) folded before Flop



PokerStars Hand #228696787457:  Hold'em No Limit ($0.25/$0.50 USD) - 2021/07/30 23:16:43 ET
Table 'Gorgo III' 9-max Seat #9 is the button
Seat 1: cartman177 ($53.16 in chips) 
Seat 2: MiniCats321 ($33.91 in chips) 
Seat 3: Dr. Margil ($59.29 in chips) 
Seat 4: Obormid ($52.20 in chips) 
Seat 5: Stingg ($79.98 in chips) 
Seat 6: crazycarno ($32.88 in chips) 
Seat 7: SparkYLive ($50 in chips) 
Seat 8: jumbo69 ($70.35 in chips) 
Seat 9: lexon3 ($50 in chips) 
cartman177: posts small blind $0.25
MiniCats321: posts big blind $0.50
*** HOLE CARDS ***
Dr. Margil: folds 
Obormid: folds 
Stingg: folds 
crazycarno: calls $0.50
SparkYLive: folds 
jumbo69: calls $0.50
lexon3: folds 
cartman177: folds 
MiniCats321: checks 
*** FLOP *** [5s Jd 3d]
MiniCats321: checks 
crazycarno: checks 
jumbo69: bets $1.08
MiniCats321: folds 
crazycarno: folds 
Uncalled bet ($1.08) returned to jumbo69
jumbo69 collected $1.66 from pot
*** SUMMARY ***
Total pot $1.75 | Rake $0.09 
Board [5s Jd 3d]
Seat 1: cartman177 (small blind) folded before Flop
Seat 2: MiniCats321 (big blind) folded on the Flop
Seat 3: Dr. Margil folded before Flop (didn't bet)
Seat 4: Obormid folded before Flop (didn't bet)
Seat 5: Stingg folded before Flop (didn't bet)
Seat 6: crazycarno folded on the Flop
Seat 7: SparkYLive folded before Flop (didn't bet)
Seat 8: jumbo69 collected ($1.66)
Seat 9: lexon3 (button) folded before Flop (didn't bet)



PokerStars Hand #228696795029:  Hold'em No Limit ($0.25/$0.50 USD) - 2021/07/30 23:17:20 ET
Table 'Gorgo III' 9-max Seat #1 is the button
Seat 1: cartman177 ($52.91 in chips) 
Seat 2: MiniCats321 ($33.41 in chips) 
Seat 3: Dr. Margil ($59.29 in chips) 
Seat 4: Obormid ($52.20 in chips) 
Seat 5: Stingg ($79.98 in chips) 
Seat 6: crazycarno ($32.38 in chips) 
Seat 7: SparkYLive ($50 in chips) 
Seat 8: jumbo69 ($71.51 in chips) 
Seat 9: lexon3 ($50 in chips) 
MiniCats321: posts small blind $0.25
Dr. Margil: posts big blind $0.50
*** HOLE CARDS ***
Obormid: folds 
Stingg: folds 
crazycarno: raises $0.50 to $1
SparkYLive: folds 
jumbo69: folds 
lexon3: folds 
cartman177: folds 
MiniCats321: folds 
Dr. Margil: folds 
Uncalled bet ($0.50) returned to crazycarno
crazycarno collected $1.25 from pot
crazycarno: doesn't show hand 
*** SUMMARY ***
Total pot $1.25 | Rake $0 
Seat 1: cartman177 (button) folded before Flop (didn't bet)
Seat 2: MiniCats321 (small blind) folded before Flop
Seat 3: Dr. Margil (big blind) folded before Flop
Seat 4: Obormid folded before Flop (didn't bet)
Seat 5: Stingg folded before Flop (didn't bet)
Seat 6: crazycarno collected ($1.25)
Seat 7: SparkYLive folded before Flop (didn't bet)
Seat 8: jumbo69 folded before Flop (didn't bet)
Seat 9: lexon3 folded before Flop (didn't bet)



PokerStars Hand #228696802715:  Hold'em No Limit ($0.25/$0.50 USD) - 2021/07/30 23:17:48 ET
Table 'Gorgo III' 9-max Seat #2 is the button
Seat 1: cartman177 ($52.91 in chips) 
Seat 2: MiniCats321 ($33.16 in chips) 
Seat 3: Dr. Margil ($58.79 in chips) 
Seat 4: Obormid ($52.20 in chips) 
Seat 5: Stingg ($79.98 in chips) 
Seat 6: crazycarno ($33.13 in chips) 
Seat 7: SparkYLive ($50 in chips) 
Seat 8: jumbo69 ($71.51 in chips) 
Seat 9: lexon3 ($50 in chips) 
Dr. Margil: posts small blind $0.25
Obormid: posts big blind $0.50
*** HOLE CARDS ***
Stingg: folds 
crazycarno: folds 
SparkYLive: folds 
jumbo69: folds 
lexon3: raises $0.75 to $1.25
cartman177: folds 
MiniCats321: folds 
Dr. Margil: folds 
Obormid: folds 
Uncalled bet ($0.75) returned to lexon3
lexon3 collected $1.25 from pot
lexon3: doesn't show hand 
*** SUMMARY ***
Total pot $1.25 | Rake $0 
Seat 1: cartman177 folded before Flop (didn't bet)
Seat 2: MiniCats321 (button) folded before Flop (didn't bet)
Seat 3: Dr. Margil (small blind) folded before Flop
Seat 4: Obormid (big blind) folded before Flop
Seat 5: Stingg folded before Flop (didn't bet)
Seat 6: crazycarno folded before Flop (didn't bet)
Seat 7: SparkYLive folded before Flop (didn't bet)
Seat 8: jumbo69 folded before Flop (didn't bet)
Seat 9: lexon3 collected ($1.25)



PokerStars Hand #228696807332:  Hold'em No Limit ($0.25/$0.50 USD) - 2021/07/30 23:18:11 ET
Table 'Gorgo III' 9-max Seat #3 is the button
Seat 1: cartman177 ($52.91 in chips) 
Seat 2: MiniCats321 ($33.16 in chips) 
Seat 3: Dr. Margil ($58.54 in chips) 
Seat 4: Obormid ($51.70 in chips) 
Seat 5: Stingg ($79.98 in chips) 
Seat 6: crazycarno ($33.13 in chips) 
Seat 7: SparkYLive ($50 in chips) 
Seat 8: jumbo69 ($71.51 in chips) 
Seat 9: lexon3 ($50.75 in chips) 
Obormid: posts small blind $0.25
Stingg: posts big blind $0.50
*** HOLE CARDS ***
crazycarno: calls $0.50
SparkYLive: folds 
jumbo69: folds 
lexon3: raises $1.63 to $2.13
cartman177: folds 
MiniCats321: folds 
Dr. Margil: folds 
Obormid: calls $1.88
Stingg: folds 
crazycarno: calls $1.63
*** FLOP *** [Js 7d 2c]
Obormid: bets $3.27
crazycarno: folds 
lexon3: calls $3.27
*** TURN *** [Js 7d 2c] [As]
Obormid: checks 
lexon3: bets $9.66
Obormid: raises $11.16 to $20.82
lexon3: calls $11.16
*** RIVER *** [Js 7d 2c As] [4h]
Obormid: checks 
lexon3: checks 
*** SHOW DOWN ***
Obormid: shows [Ah Kd] (a pair of Aces)
lexon3: shows [Ac 7c] (two pair, Aces and Sevens)
lexon3 collected $53.07 from pot
*** SUMMARY ***
Total pot $55.07 | Rake $2 
Board [Js 7d 2c As 4h]
Seat 1: cartman177 folded before Flop (didn't bet)
Seat 2: MiniCats321 folded before Flop (didn't bet)
Seat 3: Dr. Margil (button) folded before Flop (didn't bet)
Seat 4: Obormid (small blind) showed [Ah Kd] and lost with a pair of Aces
Seat 5: Stingg (big blind) folded before Flop
Seat 6: crazycarno folded on the Flop
Seat 7: SparkYLive folded before Flop (didn't bet)
Seat 8: jumbo69 folded before Flop (didn't bet)
Seat 9: lexon3 showed [Ac 7c] and won ($53.07) with two pair, Aces and Sevens



PokerStars Hand #228696827079:  Hold'em No Limit ($0.25/$0.50 USD) - 2021/07/30 23:19:50 ET
Table 'Gorgo III' 9-max Seat #4 is the button
Seat 1: cartman177 ($52.91 in chips) 
Seat 2: MiniCats321 ($33.16 in chips) 
Seat 3: Dr. Margil ($58.54 in chips) 
Seat 4: Obormid ($25.48 in chips) 
Seat 5: Stingg ($79.48 in chips) 
Seat 6: crazycarno ($31 in chips) 
Seat 7: SparkYLive ($50 in chips) 
Seat 8: jumbo69 ($71.51 in chips) 
Seat 9: lexon3 ($77.60 in chips) 
Stingg: posts small blind $0.25
crazycarno: posts big blind $0.50
*** HOLE CARDS ***
SparkYLive: folds 
jumbo69: folds 
lexon3: folds 
cartman177: folds 
MiniCats321: folds 
jumbo69 leaves the table
Dr. Margil: folds 
Obormid: raises $1 to $1.50
Stingg: folds 
crazycarno: calls $1
*** FLOP *** [2d 8s Ah]
crazycarno: checks 
Obormid: checks 
*** TURN *** [2d 8s Ah] [Jd]
crazycarno: checks 
Obormid: checks 
*** RIVER *** [2d 8s Ah Jd] [Js]
crazycarno: bets $0.50
Obormid: folds 
Uncalled bet ($0.50) returned to crazycarno
crazycarno collected $3.09 from pot
crazycarno: doesn't show hand 
*** SUMMARY ***
Total pot $3.25 | Rake $0.16 
Board [2d 8s Ah Jd Js]
Seat 1: cartman177 folded before Flop (didn't bet)
Seat 2: MiniCats321 folded before Flop (didn't bet)
Seat 3: Dr. Margil folded before Flop (didn't bet)
Seat 4: Obormid (button) folded on the River
Seat 5: Stingg (small blind) folded before Flop
Seat 6: crazycarno (big blind) collected ($3.09)
Seat 7: SparkYLive folded before Flop (didn't bet)
Seat 8: jumbo69 folded before Flop (didn't bet)
Seat 9: lexon3 folded before Flop (didn't bet)



PokerStars Hand #228696837163:  Hold'em No Limit ($0.25/$0.50 USD) - 2021/07/30 23:20:39 ET
Table 'Gorgo III' 9-max Seat #5 is the button
Seat 1: cartman177 ($52.91 in chips) 
Seat 2: MiniCats321 ($33.16 in chips) 
Seat 3: Dr. Margil ($58.54 in chips) 
Seat 4: Obormid ($23.98 in chips) 
Seat 5: Stingg ($79.23 in chips) 
Seat 6: crazycarno ($32.59 in chips) 
Seat 7: SparkYLive ($50 in chips) 
Seat 9: lexon3 ($77.60 in chips) 
crazycarno: posts small blind $0.25
SparkYLive: posts big blind $0.50
*** HOLE CARDS ***
lexon3: folds 
cartman177: folds 
MiniCats321: folds 
Dr. Margil: folds 
Obormid: folds 
Stingg: raises $0.75 to $1.25
crazycarno: folds 
SparkYLive: folds 
Uncalled bet ($0.75) returned to Stingg
Stingg collected $1.25 from pot
Stingg: doesn't show hand 
*** SUMMARY ***
Total pot $1.25 | Rake $0 
Seat 1: cartman177 folded before Flop (didn't bet)
Seat 2: MiniCats321 folded before Flop (didn't bet)
Seat 3: Dr. Margil folded before Flop (didn't bet)
Seat 4: Obormid folded before Flop (didn't bet)
Seat 5: Stingg (button) collected ($1.25)
Seat 6: crazycarno (small blind) folded before Flop
Seat 7: SparkYLive (big blind) folded before Flop
Seat 9: lexon3 folded before Flop (didn't bet)



PokerStars Hand #228696843707:  Hold'em No Limit ($0.25/$0.50 USD) - 2021/07/30 23:21:12 ET
Table 'Gorgo III' 9-max Seat #6 is the button
Seat 1: cartman177 ($52.91 in chips) 
Seat 2: MiniCats321 ($33.16 in chips) 
Seat 3: Dr. Margil ($58.54 in chips) 
Seat 4: Obormid ($41.16 in chips) 
Seat 5: Stingg ($79.98 in chips) 
Seat 6: crazycarno ($32.34 in chips) 
Seat 7: SparkYLive ($50 in chips) 
Seat 9: lexon3 ($77.60 in chips) 
SparkYLive: posts small blind $0.25
lexon3: posts big blind $0.50
*** HOLE CARDS ***
cartman177: folds 
AndyLu)|(ynski joins the table at seat #8 
MiniCats321 has timed out
MiniCats321: folds 
Dr. Margil: folds 
Obormid: raises $3 to $3.50
Stingg: folds 
crazycarno: folds 
SparkYLive: folds 
lexon3: folds 
Uncalled bet ($3) returned to Obormid
Obormid collected $1.25 from pot
*** SUMMARY ***
Total pot $1.25 | Rake $0 
Seat 1: cartman177 folded before Flop (didn't bet)
Seat 2: MiniCats321 folded before Flop (didn't bet)
Seat 3: Dr. Margil folded before Flop (didn't bet)
Seat 4: Obormid collected ($1.25)
Seat 5: Stingg folded before Flop (didn't bet)
Seat 6: crazycarno (button) folded before Flop (didn't bet)
Seat 7: SparkYLive (small blind) folded before Flop
Seat 9: lexon3 (big blind) folded before Flop



PokerStars Hand #228696850491:  Hold'em No Limit ($0.25/$0.50 USD) - 2021/07/30 23:21:46 ET
Table 'Gorgo III' 9-max Seat #7 is the button
Seat 1: cartman177 ($52.91 in chips) 
Seat 2: MiniCats321 ($33.16 in chips) 
Seat 3: Dr. Margil ($58.54 in chips) 
Seat 4: Obormid ($41.91 in chips) 
Seat 5: Stingg ($79.98 in chips) 
Seat 6: crazycarno ($32.34 in chips) 
Seat 7: SparkYLive ($50 in chips) 
Seat 9: lexon3 ($77.10 in chips) 
lexon3: posts small blind $0.25
cartman177: posts big blind $0.50
*** HOLE CARDS ***
MiniCats321: folds 
Dr. Margil: folds 
Obormid: folds 
Stingg: folds 
crazycarno: calls $0.50
SparkYLive: raises $1.50 to $2
MiniCats321 leaves the table
lexon3: folds 
cartman177: calls $1.50
Lago Madjore joins the table at seat #2 
crazycarno: calls $1.50
*** FLOP *** [9h 2s 7c]
cartman177: checks 
crazycarno: checks 
SparkYLive: checks 
*** TURN *** [9h 2s 7c] [9d]
cartman177: checks 
crazycarno: bets $2.97
SparkYLive: folds 
cartman177: folds 
Uncalled bet ($2.97) returned to crazycarno
crazycarno collected $5.94 from pot
crazycarno: doesn't show hand 
*** SUMMARY ***
Total pot $6.25 | Rake $0.31 
Board [9h 2s 7c 9d]
Seat 1: cartman177 (big blind) folded on the Turn
Seat 2: MiniCats321 folded before Flop (didn't bet)
Seat 3: Dr. Margil folded before Flop (didn't bet)
Seat 4: Obormid folded before Flop (didn't bet)
Seat 5: Stingg folded before Flop (didn't bet)
Seat 6: crazycarno collected ($5.94)
Seat 7: SparkYLive (button) folded on the Turn
Seat 9: lexon3 (small blind) folded before Flop



PokerStars Hand #228696870178:  Hold'em No Limit ($0.25/$0.50 USD) - 2021/07/30 23:23:13 ET
Table 'Gorgo III' 9-max Seat #9 is the button
Seat 1: cartman177 ($50.91 in chips) 
Seat 2: Lago Madjore ($58.46 in chips) 
Seat 3: Dr. Margil ($58.54 in chips) 
Seat 4: Obormid ($41.91 in chips) 
Seat 5: Stingg ($79.98 in chips) 
Seat 6: crazycarno ($36.28 in chips) 
Seat 7: SparkYLive ($50 in chips) 
Seat 9: lexon3 ($76.85 in chips) 
cartman177: posts small blind $0.25
Lago Madjore: posts big blind $0.50
AndyLu)|(ynski: sits out 
*** HOLE CARDS ***
Dr. Margil: folds 
Obormid: raises $1 to $1.50
Stingg: folds 
crazycarno: calls $1.50
SparkYLive: folds 
lexon3: folds 
cartman177: folds 
Lago Madjore: folds 
*** FLOP *** [8s 9c 4d]
lexon3 leaves the table
Obormid: bets $2.50
crazycarno: calls $2.50
*** TURN *** [8s 9c 4d] [Jc]
Obormid: checks 
crazycarno: checks 
*** RIVER *** [8s 9c 4d Jc] [2d]
Alim.A.Tur joins the table at seat #9 
Obormid: checks 
crazycarno: bets $4.15
Obormid: calls $4.15
*** SHOW DOWN ***
crazycarno: shows [Qc Kc] (high card King)
Obormid: shows [Ts Ah] (high card Ace)
Obormid collected $16.20 from pot
*** SUMMARY ***
Total pot $17.05 | Rake $0.85 
Board [8s 9c 4d Jc 2d]
Seat 1: cartman177 (small blind) folded before Flop
Seat 2: Lago Madjore (big blind) folded before Flop
Seat 3: Dr. Margil folded before Flop (didn't bet)
Seat 4: Obormid showed [Ts Ah] and won ($16.20) with high card Ace
Seat 5: Stingg folded before Flop (didn't bet)
Seat 6: crazycarno showed [Qc Kc] and lost with high card King
Seat 7: SparkYLive folded before Flop (didn't bet)
Seat 9: lexon3 (button) folded before Flop (didn't bet)



PokerStars Hand #228696881216:  Hold'em No Limit ($0.25/$0.50 USD) - 2021/07/30 23:24:08 ET
Table 'Gorgo III' 9-max Seat #1 is the button
Seat 1: cartman177 ($50.66 in chips) 
Seat 2: Lago Madjore ($57.96 in chips) 
Seat 3: Dr. Margil ($58.54 in chips) 
Seat 4: Obormid ($49.96 in chips) 
Seat 5: Stingg ($79.98 in chips) 
Seat 6: crazycarno ($28.13 in chips) 
Seat 7: SparkYLive ($50 in chips) 
Lago Madjore: posts small blind $0.25
Dr. Margil: posts big blind $0.50
AndyLu)|(ynski: sits out 
Alim.A.Tur: sits out 
*** HOLE CARDS ***
Obormid: folds 
Stingg: folds 
crazycarno: folds 
SparkYLive: folds 
cartman177: folds 
Lago Madjore: raises $0.75 to $1.25
Dr. Margil: calls $0.75
*** FLOP *** [Th 4s 9d]
Lago Madjore: checks 
Dr. Margil: checks 
*** TURN *** [Th 4s 9d] [Js]
Lago Madjore: checks 
Dr. Margil: checks 
*** RIVER *** [Th 4s 9d Js] [6d]
Lago Madjore: checks 
Dr. Margil: checks 
*** SHOW DOWN ***
Lago Madjore: shows [6h As] (a pair of Sixes)
Dr. Margil: mucks hand 
Lago Madjore collected $2.38 from pot
*** SUMMARY ***
Total pot $2.50 | Rake $0.12 
Board [Th 4s 9d Js 6d]
Seat 1: cartman177 (button) folded before Flop (didn't bet)
Seat 2: Lago Madjore (small blind) showed [6h As] and won ($2.38) with a pair of Sixes
Seat 3: Dr. Margil (big blind) mucked
Seat 4: Obormid folded before Flop (didn't bet)
Seat 5: Stingg folded before Flop (didn't bet)
Seat 6: crazycarno folded before Flop (didn't bet)
Seat 7: SparkYLive folded before Flop (didn't bet)



PokerStars Hand #228696890637:  Hold'em No Limit ($0.25/$0.50 USD) - 2021/07/30 23:24:55 ET
Table 'Gorgo III' 9-max Seat #2 is the button
Seat 1: cartman177 ($50.66 in chips) 
Seat 2: Lago Madjore ($59.09 in chips) 
Seat 3: Dr. Margil ($57.29 in chips) 
Seat 4: Obormid ($49.96 in chips) 
Seat 5: Stingg ($79.98 in chips) 
Seat 6: crazycarno ($28.13 in chips) 
Seat 7: SparkYLive ($50 in chips) 
Dr. Margil: posts small blind $0.25
Obormid: posts big blind $0.50
AndyLu)|(ynski: sits out 
Alim.A.Tur: sits out 
*** HOLE CARDS ***
Stingg: folds 
Stingg leaves the table
crazycarno: calls $0.50
SparkYLive: folds 
cartman177: folds 
Lago Madjore: folds 
Dr. Margil: folds 
Obormid: checks 
*** FLOP *** [7c 5h 2s]
Obormid: checks 
crazycarno: checks 
*** TURN *** [7c 5h 2s] [Qd]
Obormid: bets $0.50
crazycarno: calls $0.50
*** RIVER *** [7c 5h 2s Qd] [Ah]
Obormid: checks 
crazycarno: checks 
*** SHOW DOWN ***
Obormid: shows [As 7h] (two pair, Aces and Sevens)
crazycarno: mucks hand 
Obormid collected $2.14 from pot
*** SUMMARY ***
Total pot $2.25 | Rake $0.11 
Board [7c 5h 2s Qd Ah]
Seat 1: cartman177 folded before Flop (didn't bet)
Seat 2: Lago Madjore (button) folded before Flop (didn't bet)
Seat 3: Dr. Margil (small blind) folded before Flop
Seat 4: Obormid (big blind) showed [As 7h] and won ($2.14) with two pair, Aces and Sevens
Seat 5: Stingg folded before Flop (didn't bet)
Seat 6: crazycarno mucked
Seat 7: SparkYLive folded before Flop (didn't bet)



PokerStars Hand #228696897558:  Hold'em No Limit ($0.25/$0.50 USD) - 2021/07/30 23:25:30 ET
Table 'Gorgo III' 9-max Seat #3 is the button
Seat 1: cartman177 ($50.66 in chips) 
Seat 2: Lago Madjore ($59.09 in chips) 
Seat 3: Dr. Margil ($57.04 in chips) 
Seat 4: Obormid ($51.10 in chips) 
Seat 6: crazycarno ($27.13 in chips) 
Seat 7: SparkYLive ($50 in chips) 
Obormid: posts small blind $0.25
crazycarno: posts big blind $0.50
AndyLu)|(ynski: sits out 
Alim.A.Tur: sits out 
*** HOLE CARDS ***
SparkYLive: folds 
cartman177: folds 
Lago Madjore: folds 
Dr. Margil: folds 
Obormid: folds 
Uncalled bet ($0.25) returned to crazycarno
crazycarno collected $0.50 from pot
crazycarno: doesn't show hand 
*** SUMMARY ***
Total pot $0.50 | Rake $0 
Seat 1: cartman177 folded before Flop (didn't bet)
Seat 2: Lago Madjore folded before Flop (didn't bet)
Seat 3: Dr. Margil (button) folded before Flop (didn't bet)
Seat 4: Obormid (small blind) folded before Flop
Seat 6: crazycarno (big blind) collected ($0.50)
Seat 7: SparkYLive folded before Flop (didn't bet)



PokerStars Hand #228696901341:  Hold'em No Limit ($0.25/$0.50 USD) - 2021/07/30 23:25:49 ET
Table 'Gorgo III' 9-max Seat #4 is the button
Seat 1: cartman177 ($50.66 in chips) 
Seat 2: Lago Madjore ($59.09 in chips) 
Seat 3: Dr. Margil ($57.04 in chips) 
Seat 4: Obormid ($50.85 in chips) 
Seat 6: crazycarno ($27.38 in chips) 
Seat 7: SparkYLive ($50 in chips) 
crazycarno: posts small blind $0.25
SparkYLive: posts big blind $0.50
AndyLu)|(ynski: sits out 
Alim.A.Tur: sits out 
*** HOLE CARDS ***
cartman177: folds 
Lago Madjore: folds 
Dr. Margil: folds 
Obormid: raises $1.50 to $2
xobit26 joins the table at seat #5 
crazycarno: calls $1.75
SparkYLive: folds 
*** FLOP *** [Qs 2c 4d]
crazycarno: checks 
Obormid: checks 
*** TURN *** [Qs 2c 4d] [6s]
crazycarno: bets $2.14
Obormid: folds 
Uncalled bet ($2.14) returned to crazycarno
crazycarno collected $4.28 from pot
crazycarno: doesn't show hand 
*** SUMMARY ***
Total pot $4.50 | Rake $0.22 
Board [Qs 2c 4d 6s]
Seat 1: cartman177 folded before Flop (didn't bet)
Seat 2: Lago Madjore folded before Flop (didn't bet)
Seat 3: Dr. Margil folded before Flop (didn't bet)
Seat 4: Obormid (button) folded on the Turn
Seat 6: crazycarno (small blind) collected ($4.28)
Seat 7: SparkYLive (big blind) folded before Flop



PokerStars Hand #228696907019:  Hold'em No Limit ($0.25/$0.50 USD) - 2021/07/30 23:26:17 ET
Table 'Gorgo III' 9-max Seat #6 is the button
Seat 1: cartman177 ($50.66 in chips) 
Seat 2: Lago Madjore ($59.09 in chips) 
Seat 3: Dr. Margil ($57.04 in chips) 
Seat 4: Obormid ($48.85 in chips) 
Seat 6: crazycarno ($29.66 in chips) 
Seat 7: SparkYLive ($50 in chips) 
Seat 8: AndyLu)|(ynski ($20.50 in chips) 
SparkYLive: posts small blind $0.25
AndyLu)|(ynski: posts big blind $0.50
Alim.A.Tur: sits out 
xobit26: sits out 
*** HOLE CARDS ***
cartman177: folds 
Lago Madjore: folds 
Dr. Margil: folds 
Obormid: folds 
crazycarno: calls $0.50
SparkYLive: folds 
AndyLu)|(ynski: checks 
*** FLOP *** [7d 7s Th]
AndyLu)|(ynski: checks 
crazycarno: checks 
*** TURN *** [7d 7s Th] [Qc]
AndyLu)|(ynski: checks 
crazycarno: bets $0.59
AndyLu)|(ynski: folds 
Uncalled bet ($0.59) returned to crazycarno
crazycarno collected $1.19 from pot
crazycarno: doesn't show hand 
*** SUMMARY ***
Total pot $1.25 | Rake $0.06 
Board [7d 7s Th Qc]
Seat 1: cartman177 folded before Flop (didn't bet)
Seat 2: Lago Madjore folded before Flop (didn't bet)
Seat 3: Dr. Margil folded before Flop (didn't bet)
Seat 4: Obormid folded before Flop (didn't bet)
Seat 6: crazycarno (button) collected ($1.19)
Seat 7: SparkYLive (small blind) folded before Flop
Seat 8: AndyLu)|(ynski (big blind) folded on the Turn



PokerStars Hand #228696914399:  Hold'em No Limit ($0.25/$0.50 USD) - 2021/07/30 23:26:54 ET
Table 'Gorgo III' 9-max Seat #7 is the button
Seat 1: cartman177 ($50.66 in chips) 
Seat 2: Lago Madjore ($59.09 in chips) 
Seat 3: Dr. Margil ($57.04 in chips) 
Seat 4: Obormid ($48.85 in chips) 
Seat 6: crazycarno ($30.35 in chips) 
Seat 7: SparkYLive ($50 in chips) 
Seat 8: AndyLu)|(ynski ($20.50 in chips) 
Seat 9: Alim.A.Tur ($50 in chips) 
AndyLu)|(ynski: posts small blind $0.25
Alim.A.Tur: posts big blind $0.50
xobit26: sits out 
*** HOLE CARDS ***
cartman177: folds 
Lago Madjore: folds 
Dr. Margil: folds 
Obormid: folds 
crazycarno: folds 
SparkYLive: raises $0.85 to $1.35
AndyLu)|(ynski: folds 
Alim.A.Tur: folds 
Uncalled bet ($0.85) returned to SparkYLive
SparkYLive collected $1.25 from pot
SparkYLive: doesn't show hand 
*** SUMMARY ***
Total pot $1.25 | Rake $0 
Seat 1: cartman177 folded before Flop (didn't bet)
Seat 2: Lago Madjore folded before Flop (didn't bet)
Seat 3: Dr. Margil folded before Flop (didn't bet)
Seat 4: Obormid folded before Flop (didn't bet)
Seat 6: crazycarno folded before Flop (didn't bet)
Seat 7: SparkYLive (button) collected ($1.25)
Seat 8: AndyLu)|(ynski (small blind) folded before Flop
Seat 9: Alim.A.Tur (big blind) folded before Flop



PokerStars Hand #228696918167:  Hold'em No Limit ($0.25/$0.50 USD) - 2021/07/30 23:27:13 ET
Table 'Gorgo III' 9-max Seat #8 is the button
Seat 1: cartman177 ($50.66 in chips) 
Seat 2: Lago Madjore ($59.09 in chips) 
Seat 3: Dr. Margil ($57.04 in chips) 
Seat 4: Obormid ($48.85 in chips) 
Seat 6: crazycarno ($30.35 in chips) 
Seat 7: SparkYLive ($50.75 in chips) 
Seat 8: AndyLu)|(ynski ($20.50 in chips) 
Seat 9: Alim.A.Tur ($50 in chips) 
Alim.A.Tur: posts small blind $0.25
cartman177: posts big blind $0.50
xobit26: sits out 
*** HOLE CARDS ***
Lago Madjore: raises $0.56 to $1.06
Dr. Margil: folds 
Obormid: folds 
crazycarno: calls $1.06
SparkYLive: calls $1.06
AndyLu)|(ynski: folds 
Alim.A.Tur: folds 
cartman177: folds 
*** FLOP *** [5s Ts 8h]
Lago Madjore: checks 
crazycarno: checks 
SparkYLive: bets $1.50
Lago Madjore: folds 
crazycarno: calls $1.50
*** TURN *** [5s Ts 8h] [Kh]
crazycarno: checks 
SparkYLive: bets $4.61
crazycarno: folds 
Uncalled bet ($4.61) returned to SparkYLive
SparkYLive collected $6.58 from pot
SparkYLive: doesn't show hand 
*** SUMMARY ***
Total pot $6.93 | Rake $0.35 
Board [5s Ts 8h Kh]
Seat 1: cartman177 (big blind) folded before Flop
Seat 2: Lago Madjore folded on the Flop
Seat 3: Dr. Margil folded before Flop (didn't bet)
Seat 4: Obormid folded before Flop (didn't bet)
Seat 6: crazycarno folded on the Turn
Seat 7: SparkYLive collected ($6.58)
Seat 8: AndyLu)|(ynski (button) folded before Flop (didn't bet)
Seat 9: Alim.A.Tur (small blind) folded before Flop



PokerStars Hand #228696930242:  Hold'em No Limit ($0.25/$0.50 USD) - 2021/07/30 23:28:13 ET
Table 'Gorgo III' 9-max Seat #9 is the button
Seat 1: cartman177 ($50.16 in chips) 
Seat 2: Lago Madjore ($58.03 in chips) 
Seat 3: Dr. Margil ($57.04 in chips) 
Seat 4: Obormid ($48.85 in chips) 
Seat 6: crazycarno ($27.79 in chips) 
Seat 7: SparkYLive ($54.77 in chips) 
Seat 8: AndyLu)|(ynski ($20.50 in chips) 
Seat 9: Alim.A.Tur ($50 in chips) 
cartman177: posts small blind $0.25
Lago Madjore: posts big blind $0.50
xobit26: sits out 
*** HOLE CARDS ***
Dr. Margil: folds 
Obormid: raises $0.50 to $1
crazycarno: calls $1
SparkYLive: folds 
AndyLu)|(ynski: folds 
Alim.A.Tur: folds 
cartman177: folds 
Lago Madjore: folds 
*** FLOP *** [4d 8d 9s]
Obormid: bets $2.61
crazycarno: folds 
Uncalled bet ($2.61) returned to Obormid
Obormid collected $2.61 from pot
Obormid: doesn't show hand 
*** SUMMARY ***
Total pot $2.75 | Rake $0.14 
Board [4d 8d 9s]
Seat 1: cartman177 (small blind) folded before Flop
Seat 2: Lago Madjore (big blind) folded before Flop
Seat 3: Dr. Margil folded before Flop (didn't bet)
Seat 4: Obormid collected ($2.61)
Seat 6: crazycarno folded on the Flop
Seat 7: SparkYLive folded before Flop (didn't bet)
Seat 8: AndyLu)|(ynski folded before Flop (didn't bet)
Seat 9: Alim.A.Tur (button) folded before Flop (didn't bet)



PokerStars Hand #228696938708:  Hold'em No Limit ($0.25/$0.50 USD) - 2021/07/30 23:28:56 ET
Table 'Gorgo III' 9-max Seat #1 is the button
Seat 1: cartman177 ($50 in chips) 
Seat 2: Lago Madjore ($57.53 in chips) 
Seat 3: Dr. Margil ($57.04 in chips) 
Seat 4: Obormid ($50.46 in chips) 
Seat 6: crazycarno ($26.79 in chips) 
Seat 7: SparkYLive ($54.77 in chips) 
Seat 8: AndyLu)|(ynski ($20.50 in chips) 
Seat 9: Alim.A.Tur ($50 in chips) 
Lago Madjore: posts small blind $0.25
Dr. Margil: posts big blind $0.50
xobit26: sits out 
*** HOLE CARDS ***
Obormid: folds 
crazycarno: folds 
SparkYLive: folds 
AndyLu)|(ynski: folds 
Alim.A.Tur: folds 
cartman177: folds 
Lago Madjore: folds 
Uncalled bet ($0.25) returned to Dr. Margil
Dr. Margil collected $0.50 from pot
Dr. Margil: doesn't show hand 
*** SUMMARY ***
Total pot $0.50 | Rake $0 
Seat 1: cartman177 (button) folded before Flop (didn't bet)
Seat 2: Lago Madjore (small blind) folded before Flop
Seat 3: Dr. Margil (big blind) collected ($0.50)
Seat 4: Obormid folded before Flop (didn't bet)
Seat 6: crazycarno folded before Flop (didn't bet)
Seat 7: SparkYLive folded before Flop (didn't bet)
Seat 8: AndyLu)|(ynski folded before Flop (didn't bet)
Seat 9: Alim.A.Tur folded before Flop (didn't bet)



PokerStars Hand #228696941243:  Hold'em No Limit ($0.25/$0.50 USD) - 2021/07/30 23:29:08 ET
Table 'Gorgo III' 9-max Seat #2 is the button
Seat 1: cartman177 ($50 in chips) 
Seat 2: Lago Madjore ($57.28 in chips) 
Seat 3: Dr. Margil ($57.29 in chips) 
Seat 4: Obormid ($50.46 in chips) 
Seat 6: crazycarno ($26.79 in chips) 
Seat 7: SparkYLive ($54.77 in chips) 
Seat 8: AndyLu)|(ynski ($20.50 in chips) 
Seat 9: Alim.A.Tur ($50 in chips) 
Dr. Margil: posts small blind $0.25
Obormid: posts big blind $0.50
xobit26: sits out 
*** HOLE CARDS ***
crazycarno: calls $0.50
SparkYLive: folds 
AndyLu)|(ynski: raises $2.50 to $3
Alim.A.Tur: folds 
cartman177: folds 
Lago Madjore: folds 
Dr. Margil: folds 
Obormid: folds 
crazycarno: folds 
Uncalled bet ($2.50) returned to AndyLu)|(ynski
AndyLu)|(ynski collected $1.75 from pot
AndyLu)|(ynski: doesn't show hand 
*** SUMMARY ***
Total pot $1.75 | Rake $0 
Seat 1: cartman177 folded before Flop (didn't bet)
Seat 2: Lago Madjore (button) folded before Flop (didn't bet)
Seat 3: Dr. Margil (small blind) folded before Flop
Seat 4: Obormid (big blind) folded before Flop
Seat 6: crazycarno folded before Flop
Seat 7: SparkYLive folded before Flop (didn't bet)
Seat 8: AndyLu)|(ynski collected ($1.75)
Seat 9: Alim.A.Tur folded before Flop (didn't bet)



PokerStars Hand #228696944754:  Hold'em No Limit ($0.25/$0.50 USD) - 2021/07/30 23:29:26 ET
Table 'Gorgo III' 9-max Seat #3 is the button
Seat 1: cartman177 ($50 in chips) 
Seat 2: Lago Madjore ($57.28 in chips) 
Seat 3: Dr. Margil ($57.04 in chips) 
Seat 4: Obormid ($49.96 in chips) 
Seat 5: xobit26 ($50 in chips) 
Seat 6: crazycarno ($26.29 in chips) 
Seat 7: SparkYLive ($54.77 in chips) 
Seat 8: AndyLu)|(ynski ($21.75 in chips) 
Seat 9: Alim.A.Tur ($50 in chips) 
Obormid: posts small blind $0.25
xobit26: posts big blind $0.50
*** HOLE CARDS ***
crazycarno: calls $0.50
SparkYLive: folds 
AndyLu)|(ynski: raises $2.50 to $3
Alim.A.Tur: folds 
cartman177: folds 
Lago Madjore: folds 
Dr. Margil: folds 
Obormid: folds 
xobit26: folds 
crazycarno: folds 
Uncalled bet ($2.50) returned to AndyLu)|(ynski
AndyLu)|(ynski collected $1.75 from pot
AndyLu)|(ynski: doesn't show hand 
*** SUMMARY ***
Total pot $1.75 | Rake $0 
Seat 1: cartman177 folded before Flop (didn't bet)
Seat 2: Lago Madjore folded before Flop (didn't bet)
Seat 3: Dr. Margil (button) folded before Flop (didn't bet)
Seat 4: Obormid (small blind) folded before Flop
Seat 5: xobit26 (big blind) folded before Flop
Seat 6: crazycarno folded before Flop
Seat 7: SparkYLive folded before Flop (didn't bet)
Seat 8: AndyLu)|(ynski collected ($1.75)
Seat 9: Alim.A.Tur folded before Flop (didn't bet)



PokerStars Hand #228696957492:  Hold'em No Limit ($0.25/$0.50 USD) - 2021/07/30 23:30:07 ET
Table 'Gorgo III' 9-max Seat #4 is the button
Seat 1: cartman177 ($50 in chips) 
Seat 2: Lago Madjore ($57.28 in chips) 
Seat 3: Dr. Margil ($57.04 in chips) 
Seat 4: Obormid ($49.71 in chips) 
Seat 5: xobit26 ($50 in chips) 
Seat 6: crazycarno ($25.79 in chips) 
Seat 7: SparkYLive ($54.77 in chips) 
Seat 8: AndyLu)|(ynski ($23 in chips) 
Seat 9: Alim.A.Tur ($50 in chips) 
xobit26: posts small blind $0.25
crazycarno: posts big blind $0.50
*** HOLE CARDS ***
SparkYLive: raises $1 to $1.50
AndyLu)|(ynski: folds 
Alim.A.Tur: folds 
cartman177: folds 
Lago Madjore: folds 
Dr. Margil: folds 
Obormid: folds 
xobit26: folds 
crazycarno: calls $1
*** FLOP *** [8h 4h 2h]
crazycarno: bets $1.54
SparkYLive: calls $1.54
*** TURN *** [8h 4h 2h] [6s]
crazycarno: checks 
SparkYLive: bets $3.75
crazycarno: calls $3.75
*** RIVER *** [8h 4h 2h 6s] [Qc]
crazycarno: checks 
SparkYLive: bets $6.57
crazycarno: folds 
Uncalled bet ($6.57) returned to SparkYLive
SparkYLive collected $13.14 from pot
SparkYLive: doesn't show hand 
*** SUMMARY ***
Total pot $13.83 | Rake $0.69 
Board [8h 4h 2h 6s Qc]
Seat 1: cartman177 folded before Flop (didn't bet)
Seat 2: Lago Madjore folded before Flop (didn't bet)
Seat 3: Dr. Margil folded before Flop (didn't bet)
Seat 4: Obormid (button) folded before Flop (didn't bet)
Seat 5: xobit26 (small blind) folded before Flop
Seat 6: crazycarno (big blind) folded on the River
Seat 7: SparkYLive collected ($13.14)
Seat 8: AndyLu)|(ynski folded before Flop (didn't bet)
Seat 9: Alim.A.Tur folded before Flop (didn't bet)



PokerStars Hand #228696972405:  Hold'em No Limit ($0.25/$0.50 USD) - 2021/07/30 23:31:22 ET
Table 'Gorgo III' 9-max Seat #5 is the button
Seat 1: cartman177 ($50 in chips) 
Seat 2: Lago Madjore ($57.28 in chips) 
Seat 3: Dr. Margil ($57.04 in chips) 
Seat 4: Obormid ($49.71 in chips) 
Seat 5: xobit26 ($50 in chips) 
Seat 6: crazycarno ($19 in chips) 
Seat 7: SparkYLive ($61.12 in chips) 
Seat 8: AndyLu)|(ynski ($23 in chips) 
Seat 9: Alim.A.Tur ($50 in chips) 
crazycarno: posts small blind $0.25
SparkYLive: posts big blind $0.50
*** HOLE CARDS ***
AndyLu)|(ynski: folds 
Alim.A.Tur: folds 
cartman177: folds 
Lago Madjore: folds 
Dr. Margil: folds 
Obormid: folds 
xobit26: folds 
crazycarno: calls $0.25
SparkYLive: checks 
*** FLOP *** [7c 8h Kh]
crazycarno: checks 
SparkYLive: bets $0.50
crazycarno: calls $0.50
*** TURN *** [7c 8h Kh] [3h]
crazycarno: bets $0.95
SparkYLive: folds 
Uncalled bet ($0.95) returned to crazycarno
crazycarno collected $1.90 from pot
crazycarno: doesn't show hand 
*** SUMMARY ***
Total pot $2 | Rake $0.10 
Board [7c 8h Kh 3h]
Seat 1: cartman177 folded before Flop (didn't bet)
Seat 2: Lago Madjore folded before Flop (didn't bet)
Seat 3: Dr. Margil folded before Flop (didn't bet)
Seat 4: Obormid folded before Flop (didn't bet)
Seat 5: xobit26 (button) folded before Flop (didn't bet)
Seat 6: crazycarno (small blind) collected ($1.90)
Seat 7: SparkYLive (big blind) folded on the Turn
Seat 8: AndyLu)|(ynski folded before Flop (didn't bet)
Seat 9: Alim.A.Tur folded before Flop (didn't bet)



PokerStars Hand #228696992990:  Hold'em No Limit ($0.25/$0.50 USD) - 2021/07/30 23:33:07 ET
Table 'Gorgo III' 9-max Seat #7 is the button
Seat 1: cartman177 ($50 in chips) 
Seat 2: Lago Madjore ($57.28 in chips) 
Seat 3: Dr. Margil ($57.04 in chips) 
Seat 4: Obormid ($46.21 in chips) 
Seat 5: xobit26 ($50 in chips) 
Seat 6: crazycarno ($23.76 in chips) 
Seat 7: SparkYLive ($59.87 in chips) 
Seat 8: AndyLu)|(ynski ($22.50 in chips) 
Seat 9: Alim.A.Tur ($50 in chips) 
AndyLu)|(ynski: posts small blind $0.25
Alim.A.Tur: posts big blind $0.50
*** HOLE CARDS ***
cartman177: folds 
Lago Madjore: raises $0.56 to $1.06
Dr. Margil: folds 
Obormid: folds 
xobit26: folds 
crazycarno: calls $1.06
SparkYLive: folds 
AndyLu)|(ynski: folds 
Alim.A.Tur: folds 
*** FLOP *** [7d 5d 2c]
Lago Madjore: checks 
crazycarno: bets $1.36
Lago Madjore: calls $1.36
*** TURN *** [7d 5d 2c] [Qd]
Lago Madjore: checks 
crazycarno: bets $2.65
Lago Madjore: raises $4.85 to $7.50
crazycarno: folds 
Uncalled bet ($4.85) returned to Lago Madjore
Lago Madjore collected $10.35 from pot
*** SUMMARY ***
Total pot $10.89 | Rake $0.54 
Board [7d 5d 2c Qd]
Seat 1: cartman177 folded before Flop (didn't bet)
Seat 2: Lago Madjore collected ($10.35)
Seat 3: Dr. Margil folded before Flop (didn't bet)
Seat 4: Obormid folded before Flop (didn't bet)
Seat 5: xobit26 folded before Flop (didn't bet)
Seat 6: crazycarno folded on the Turn
Seat 7: SparkYLive (button) folded before Flop (didn't bet)
Seat 8: AndyLu)|(ynski (small blind) folded before Flop
Seat 9: Alim.A.Tur (big blind) folded before Flop



PokerStars Hand #228697003358:  Hold'em No Limit ($0.25/$0.50 USD) - 2021/07/30 23:34:00 ET
Table 'Gorgo III' 9-max Seat #8 is the button
Seat 1: cartman177 ($50 in chips) 
Seat 2: Lago Madjore ($62.56 in chips) 
Seat 3: Dr. Margil ($57.04 in chips) 
Seat 4: Obormid ($46.21 in chips) 
Seat 5: xobit26 ($50 in chips) 
Seat 6: crazycarno ($18.69 in chips) 
Seat 7: SparkYLive ($59.87 in chips) 
Seat 8: AndyLu)|(ynski ($22.25 in chips) 
Seat 9: Alim.A.Tur ($50 in chips) 
Alim.A.Tur: posts small blind $0.25
cartman177: posts big blind $0.50
*** HOLE CARDS ***
Lago Madjore: folds 
Dr. Margil: folds 
Obormid: folds 
xobit26: folds 
crazycarno: calls $0.50
SparkYLive: folds 
AndyLu)|(ynski: folds 
Alim.A.Tur: folds 
cartman177: checks 
*** FLOP *** [9h Kh 8s]
cartman177: checks 
crazycarno: bets $0.59
cartman177: calls $0.59
*** TURN *** [9h Kh 8s] [7c]
cartman177: checks 
crazycarno: bets $1.15
cartman177: calls $1.15
*** RIVER *** [9h Kh 8s 7c] [Qh]
cartman177: checks 
crazycarno: bets $2.24
cartman177: folds 
Uncalled bet ($2.24) returned to crazycarno
crazycarno collected $4.49 from pot
crazycarno: doesn't show hand 
*** SUMMARY ***
Total pot $4.73 | Rake $0.24 
Board [9h Kh 8s 7c Qh]
Seat 1: cartman177 (big blind) folded on the River
Seat 2: Lago Madjore folded before Flop (didn't bet)
Seat 3: Dr. Margil folded before Flop (didn't bet)
Seat 4: Obormid folded before Flop (didn't bet)
Seat 5: xobit26 folded before Flop (didn't bet)
Seat 6: crazycarno collected ($4.49)
Seat 7: SparkYLive folded before Flop (didn't bet)
Seat 8: AndyLu)|(ynski (button) folded before Flop (didn't bet)
Seat 9: Alim.A.Tur (small blind) folded before Flop



PokerStars Hand #228697013714:  Hold'em No Limit ($0.25/$0.50 USD) - 2021/07/30 23:34:52 ET
Table 'Gorgo III' 9-max Seat #9 is the button
Seat 1: cartman177 ($50 in chips) 
Seat 2: Lago Madjore ($62.56 in chips) 
Seat 3: Dr. Margil ($57.04 in chips) 
Seat 4: Obormid ($46.21 in chips) 
Seat 5: xobit26 ($50 in chips) 
Seat 6: crazycarno ($20.94 in chips) 
Seat 7: SparkYLive ($59.87 in chips) 
Seat 8: AndyLu)|(ynski ($22.25 in chips) 
Seat 9: Alim.A.Tur ($50 in chips) 
cartman177: posts small blind $0.25
Lago Madjore: posts big blind $0.50
*** HOLE CARDS ***
Dr. Margil: folds 
Obormid: folds 
xobit26: folds 
crazycarno: folds 
SparkYLive: folds 
AndyLu)|(ynski: folds 
Alim.A.Tur: raises $0.75 to $1.25
cartman177: raises $4.25 to $5.50
Lago Madjore: folds 
Alim.A.Tur: folds 
Uncalled bet ($4.25) returned to cartman177
cartman177 collected $3 from pot
cartman177: doesn't show hand 
*** SUMMARY ***
Total pot $3 | Rake $0 
Seat 1: cartman177 (small blind) collected ($3)
Seat 2: Lago Madjore (big blind) folded before Flop
Seat 3: Dr. Margil folded before Flop (didn't bet)
Seat 4: Obormid folded before Flop (didn't bet)
Seat 5: xobit26 folded before Flop (didn't bet)
Seat 6: crazycarno folded before Flop (didn't bet)
Seat 7: SparkYLive folded before Flop (didn't bet)
Seat 8: AndyLu)|(ynski folded before Flop (didn't bet)
Seat 9: Alim.A.Tur (button) folded before Flop



PokerStars Hand #228697020027:  Hold'em No Limit ($0.25/$0.50 USD) - 2021/07/30 23:35:24 ET
Table 'Gorgo III' 9-max Seat #1 is the button
Seat 1: cartman177 ($51.75 in chips) 
Seat 2: Lago Madjore ($62.06 in chips) 
Seat 3: Dr. Margil ($57.04 in chips) 
Seat 4: Obormid ($46.21 in chips) 
Seat 5: xobit26 ($50 in chips) 
Seat 6: crazycarno ($20.94 in chips) 
Seat 7: SparkYLive ($59.87 in chips) 
Seat 8: AndyLu)|(ynski ($22.25 in chips) 
Seat 9: Alim.A.Tur ($50 in chips) 
Lago Madjore: posts small blind $0.25
Dr. Margil: posts big blind $0.50
*** HOLE CARDS ***
Obormid: folds 
crazycarno is disconnected 
xobit26: folds 
crazycarno is connected 
crazycarno: folds 
SparkYLive: folds 
AndyLu)|(ynski: folds 
Alim.A.Tur: folds 
cartman177: raises $0.50 to $1
Lago Madjore: folds 
Dr. Margil: folds 
Uncalled bet ($0.50) returned to cartman177
cartman177 collected $1.25 from pot
cartman177: doesn't show hand 
*** SUMMARY ***
Total pot $1.25 | Rake $0 
Seat 1: cartman177 (button) collected ($1.25)
Seat 2: Lago Madjore (small blind) folded before Flop
Seat 3: Dr. Margil (big blind) folded before Flop
Seat 4: Obormid folded before Flop (didn't bet)
Seat 5: xobit26 folded before Flop (didn't bet)
Seat 6: crazycarno folded before Flop (didn't bet)
Seat 7: SparkYLive folded before Flop (didn't bet)
Seat 8: AndyLu)|(ynski folded before Flop (didn't bet)
Seat 9: Alim.A.Tur folded before Flop (didn't bet)



PokerStars Hand #228697034879:  Hold'em No Limit ($0.25/$0.50 USD) - 2021/07/30 23:36:08 ET
Table 'Gorgo III' 9-max Seat #2 is the button
Seat 1: cartman177 ($52.50 in chips) 
Seat 2: Lago Madjore ($61.81 in chips) 
Seat 3: Dr. Margil ($56.54 in chips) 
Seat 4: Obormid ($46.21 in chips) 
Seat 5: xobit26 ($50 in chips) 
Seat 6: crazycarno ($20.94 in chips) 
Seat 7: SparkYLive ($59.87 in chips) 
Seat 8: AndyLu)|(ynski ($22.25 in chips) 
Seat 9: Alim.A.Tur ($50 in chips) 
Dr. Margil: posts small blind $0.25
Obormid: posts big blind $0.50
*** HOLE CARDS ***
xobit26: folds 
crazycarno: calls $0.50
SparkYLive: folds 
AndyLu)|(ynski: raises $2.50 to $3
Alim.A.Tur: folds 
cartman177: folds 
Lago Madjore: folds 
Dr. Margil: folds 
Obormid: folds 
crazycarno: folds 
Uncalled bet ($2.50) returned to AndyLu)|(ynski
AndyLu)|(ynski collected $1.75 from pot
AndyLu)|(ynski: doesn't show hand 
*** SUMMARY ***
Total pot $1.75 | Rake $0 
Seat 1: cartman177 folded before Flop (didn't bet)
Seat 2: Lago Madjore (button) folded before Flop (didn't bet)
Seat 3: Dr. Margil (small blind) folded before Flop
Seat 4: Obormid (big blind) folded before Flop
Seat 5: xobit26 folded before Flop (didn't bet)
Seat 6: crazycarno folded before Flop
Seat 7: SparkYLive folded before Flop (didn't bet)
Seat 8: AndyLu)|(ynski collected ($1.75)
Seat 9: Alim.A.Tur folded before Flop (didn't bet)



PokerStars Hand #228697041974:  Hold'em No Limit ($0.25/$0.50 USD) - 2021/07/30 23:36:44 ET
Table 'Gorgo III' 9-max Seat #3 is the button
Seat 1: cartman177 ($52.50 in chips) 
Seat 2: Lago Madjore ($61.81 in chips) 
Seat 3: Dr. Margil ($56.29 in chips) 
Seat 4: Obormid ($45.71 in chips) 
Seat 5: xobit26 ($50 in chips) 
Seat 6: crazycarno ($20.44 in chips) 
Seat 7: SparkYLive ($59.87 in chips) 
Seat 8: AndyLu)|(ynski ($23.50 in chips) 
Seat 9: Alim.A.Tur ($50 in chips) 
Obormid: posts small blind $0.25
xobit26: posts big blind $0.50
*** HOLE CARDS ***
crazycarno: raises $0.50 to $1
SparkYLive: folds 
AndyLu)|(ynski: folds 
Alim.A.Tur: folds 
cartman177: folds 
Lago Madjore: folds 
Dr. Margil: folds 
Obormid: folds 
xobit26: raises $4.25 to $5.25
crazycarno: folds 
Uncalled bet ($4.25) returned to xobit26
xobit26 collected $2.25 from pot
xobit26: doesn't show hand 
*** SUMMARY ***
Total pot $2.25 | Rake $0 
Seat 1: cartman177 folded before Flop (didn't bet)
Seat 2: Lago Madjore folded before Flop (didn't bet)
Seat 3: Dr. Margil (button) folded before Flop (didn't bet)
Seat 4: Obormid (small blind) folded before Flop
Seat 5: xobit26 (big blind) collected ($2.25)
Seat 6: crazycarno folded before Flop
Seat 7: SparkYLive folded before Flop (didn't bet)
Seat 8: AndyLu)|(ynski folded before Flop (didn't bet)
Seat 9: Alim.A.Tur folded before Flop (didn't bet)



PokerStars Hand #228697049182:  Hold'em No Limit ($0.25/$0.50 USD) - 2021/07/30 23:37:21 ET
Table 'Gorgo III' 9-max Seat #4 is the button
Seat 1: cartman177 ($52.50 in chips) 
Seat 2: Lago Madjore ($61.81 in chips) 
Seat 3: Dr. Margil ($56.29 in chips) 
Seat 4: Obormid ($45.46 in chips) 
Seat 5: xobit26 ($51.25 in chips) 
Seat 6: crazycarno ($19.44 in chips) 
Seat 7: SparkYLive ($59.87 in chips) 
Seat 8: AndyLu)|(ynski ($23.50 in chips) 
Seat 9: Alim.A.Tur ($50 in chips) 
xobit26: posts small blind $0.25
crazycarno: posts big blind $0.50
*** HOLE CARDS ***
SparkYLive: folds 
AndyLu)|(ynski: folds 
Alim.A.Tur: raises $0.75 to $1.25
cartman177: folds 
Lago Madjore: folds 
Dr. Margil: folds 
Obormid: folds 
xobit26: folds 
crazycarno: calls $0.75
*** FLOP *** [6c 5c 9h]
crazycarno: bets $1.30
Alim.A.Tur: raises $3.91 to $5.21
crazycarno: folds 
Uncalled bet ($3.91) returned to Alim.A.Tur
Alim.A.Tur collected $5.08 from pot
Alim.A.Tur: doesn't show hand 
*** SUMMARY ***
Total pot $5.35 | Rake $0.27 
Board [6c 5c 9h]
Seat 1: cartman177 folded before Flop (didn't bet)
Seat 2: Lago Madjore folded before Flop (didn't bet)
Seat 3: Dr. Margil folded before Flop (didn't bet)
Seat 4: Obormid (button) folded before Flop (didn't bet)
Seat 5: xobit26 (small blind) folded before Flop
Seat 6: crazycarno (big blind) folded on the Flop
Seat 7: SparkYLive folded before Flop (didn't bet)
Seat 8: AndyLu)|(ynski folded before Flop (didn't bet)
Seat 9: Alim.A.Tur collected ($5.08)



PokerStars Hand #228697055858:  Hold'em No Limit ($0.25/$0.50 USD) - 2021/07/30 23:37:56 ET
Table 'Gorgo III' 9-max Seat #5 is the button
Seat 1: cartman177 ($52.50 in chips) 
Seat 2: Lago Madjore ($61.81 in chips) 
Seat 3: Dr. Margil ($56.29 in chips) 
Seat 4: Obormid ($45.46 in chips) 
Seat 5: xobit26 ($51 in chips) 
Seat 6: crazycarno ($16.89 in chips) 
Seat 7: SparkYLive ($59.87 in chips) 
Seat 8: AndyLu)|(ynski ($23.50 in chips) 
Seat 9: Alim.A.Tur ($52.53 in chips) 
crazycarno: posts small blind $0.25
SparkYLive: posts big blind $0.50
*** HOLE CARDS ***
AndyLu)|(ynski: raises $1.50 to $2
Alim.A.Tur: folds 
cartman177: folds 
Lago Madjore: folds 
Dr. Margil: folds 
Obormid: folds 
xobit26: folds 
crazycarno: calls $1.75
SparkYLive: folds 
*** FLOP *** [8d 5s Kc]
crazycarno: checks 
AndyLu)|(ynski: bets $0.86
crazycarno: folds 
Uncalled bet ($0.86) returned to AndyLu)|(ynski
AndyLu)|(ynski collected $4.28 from pot
AndyLu)|(ynski: doesn't show hand 
*** SUMMARY ***
Total pot $4.50 | Rake $0.22 
Board [8d 5s Kc]
Seat 1: cartman177 folded before Flop (didn't bet)
Seat 2: Lago Madjore folded before Flop (didn't bet)
Seat 3: Dr. Margil folded before Flop (didn't bet)
Seat 4: Obormid folded before Flop (didn't bet)
Seat 5: xobit26 (button) folded before Flop (didn't bet)
Seat 6: crazycarno (small blind) folded on the Flop
Seat 7: SparkYLive (big blind) folded before Flop
Seat 8: AndyLu)|(ynski collected ($4.28)
Seat 9: Alim.A.Tur folded before Flop (didn't bet)



PokerStars Hand #228697063657:  Hold'em No Limit ($0.25/$0.50 USD) - 2021/07/30 23:38:36 ET
Table 'Gorgo III' 9-max Seat #6 is the button
Seat 1: cartman177 ($52.50 in chips) 
Seat 2: Lago Madjore ($61.81 in chips) 
Seat 3: Dr. Margil ($56.29 in chips) 
Seat 4: Obormid ($45.46 in chips) 
Seat 5: xobit26 ($51 in chips) 
Seat 6: crazycarno ($14.89 in chips) 
Seat 7: SparkYLive ($59.37 in chips) 
Seat 8: AndyLu)|(ynski ($25.78 in chips) 
Seat 9: Alim.A.Tur ($52.53 in chips) 
SparkYLive: posts small blind $0.25
AndyLu)|(ynski: posts big blind $0.50
*** HOLE CARDS ***
Alim.A.Tur: folds 
cartman177: folds 
Lago Madjore: folds 
Dr. Margil: folds 
Obormid: folds 
xobit26: raises $0.75 to $1.25
crazycarno: raises $0.75 to $2
SparkYLive: folds 
AndyLu)|(ynski: folds 
xobit26: folds 
Uncalled bet ($0.75) returned to crazycarno
crazycarno collected $3.25 from pot
crazycarno: doesn't show hand 
*** SUMMARY ***
Total pot $3.25 | Rake $0 
Seat 1: cartman177 folded before Flop (didn't bet)
Seat 2: Lago Madjore folded before Flop (didn't bet)
Seat 3: Dr. Margil folded before Flop (didn't bet)
Seat 4: Obormid folded before Flop (didn't bet)
Seat 5: xobit26 folded before Flop
Seat 6: crazycarno (button) collected ($3.25)
Seat 7: SparkYLive (small blind) folded before Flop
Seat 8: AndyLu)|(ynski (big blind) folded before Flop
Seat 9: Alim.A.Tur folded before Flop (didn't bet)



PokerStars Hand #228697069070:  Hold'em No Limit ($0.25/$0.50 USD) - 2021/07/30 23:39:05 ET
Table 'Gorgo III' 9-max Seat #7 is the button
Seat 1: cartman177 ($52.50 in chips) 
Seat 2: Lago Madjore ($61.81 in chips) 
Seat 3: Dr. Margil ($56.29 in chips) 
Seat 4: Obormid ($45.46 in chips) 
Seat 5: xobit26 ($50 in chips) 
Seat 6: crazycarno ($16.89 in chips) 
Seat 7: SparkYLive ($59.12 in chips) 
Seat 8: AndyLu)|(ynski ($25.28 in chips) 
Seat 9: Alim.A.Tur ($52.53 in chips) 
AndyLu)|(ynski: posts small blind $0.25
Alim.A.Tur: posts big blind $0.50
*** HOLE CARDS ***
cartman177: folds 
Lago Madjore: folds 
Dr. Margil: folds 
Obormid: raises $1 to $1.50
xobit26: folds 
crazycarno: calls $1.50
SparkYLive: folds 
AndyLu)|(ynski: folds 
Alim.A.Tur: calls $1
*** FLOP *** [Ad 6s 8s]
Alim.A.Tur: checks 
Obormid: checks 
crazycarno: bets $4.51
Alim.A.Tur: folds 
Obormid: folds 
Uncalled bet ($4.51) returned to crazycarno
crazycarno collected $4.51 from pot
crazycarno: doesn't show hand 
*** SUMMARY ***
Total pot $4.75 | Rake $0.24 
Board [Ad 6s 8s]
Seat 1: cartman177 folded before Flop (didn't bet)
Seat 2: Lago Madjore folded before Flop (didn't bet)
Seat 3: Dr. Margil folded before Flop (didn't bet)
Seat 4: Obormid folded on the Flop
Seat 5: xobit26 folded before Flop (didn't bet)
Seat 6: crazycarno collected ($4.51)
Seat 7: SparkYLive (button) folded before Flop (didn't bet)
Seat 8: AndyLu)|(ynski (small blind) folded before Flop
Seat 9: Alim.A.Tur (big blind) folded on the Flop



PokerStars Hand #228697082500:  Hold'em No Limit ($0.25/$0.50 USD) - 2021/07/30 23:39:38 ET
Table 'Gorgo III' 9-max Seat #8 is the button
Seat 1: cartman177 ($52.50 in chips) 
Seat 2: Lago Madjore ($61.81 in chips) 
Seat 3: Dr. Margil ($56.29 in chips) 
Seat 4: Obormid ($43.96 in chips) 
Seat 5: xobit26 ($50 in chips) 
Seat 6: crazycarno ($19.90 in chips) 
Seat 7: SparkYLive ($59.12 in chips) 
Seat 8: AndyLu)|(ynski ($25.03 in chips) 
Seat 9: Alim.A.Tur ($51.03 in chips) 
Alim.A.Tur: posts small blind $0.25
cartman177: posts big blind $0.50
*** HOLE CARDS ***
Lago Madjore: folds 
Dr. Margil: calls $0.50
Obormid: raises $1 to $1.50
xobit26: folds 
crazycarno: raises $1 to $2.50
SparkYLive: folds 
AndyLu)|(ynski: folds 
Alim.A.Tur: folds 
cartman177: folds 
Dr. Margil: folds 
Obormid: calls $1
*** FLOP *** [8d Kd 8h]
Obormid: checks 
crazycarno: bets $5.94
Obormid: raises $35.52 to $41.46 and is all-in
crazycarno: folds 
Uncalled bet ($35.52) returned to Obormid
Obormid collected $17.22 from pot
*** SUMMARY ***
Total pot $18.13 | Rake $0.91 
Board [8d Kd 8h]
Seat 1: cartman177 (big blind) folded before Flop
Seat 2: Lago Madjore folded before Flop (didn't bet)
Seat 3: Dr. Margil folded before Flop
Seat 4: Obormid collected ($17.22)
Seat 5: xobit26 folded before Flop (didn't bet)
Seat 6: crazycarno folded on the Flop
Seat 7: SparkYLive folded before Flop (didn't bet)
Seat 8: AndyLu)|(ynski (button) folded before Flop (didn't bet)
Seat 9: Alim.A.Tur (small blind) folded before Flop



PokerStars Hand #228697093710:  Hold'em No Limit ($0.25/$0.50 USD) - 2021/07/30 23:40:36 ET
Table 'Gorgo III' 9-max Seat #9 is the button
Seat 1: cartman177 ($52 in chips) 
Seat 2: Lago Madjore ($61.81 in chips) 
Seat 3: Dr. Margil ($55.79 in chips) 
Seat 4: Obormid ($52.74 in chips) 
Seat 5: xobit26 ($50 in chips) 
Seat 6: crazycarno ($11.46 in chips) 
Seat 7: SparkYLive ($59.12 in chips) 
Seat 8: AndyLu)|(ynski ($25.03 in chips) 
Seat 9: Alim.A.Tur ($50.78 in chips) 
cartman177: posts small blind $0.25
Lago Madjore: posts big blind $0.50
*** HOLE CARDS ***
Dr. Margil: folds 
Obormid: folds 
xobit26: folds 
crazycarno: calls $0.50
SparkYLive: folds 
AndyLu)|(ynski: raises $2.50 to $3
Alim.A.Tur: folds 
cartman177: folds 
Lago Madjore: folds 
crazycarno: folds 
Uncalled bet ($2.50) returned to AndyLu)|(ynski
AndyLu)|(ynski collected $1.75 from pot
AndyLu)|(ynski: doesn't show hand 
*** SUMMARY ***
Total pot $1.75 | Rake $0 
Seat 1: cartman177 (small blind) folded before Flop
Seat 2: Lago Madjore (big blind) folded before Flop
Seat 3: Dr. Margil folded before Flop (didn't bet)
Seat 4: Obormid folded before Flop (didn't bet)
Seat 5: xobit26 folded before Flop (didn't bet)
Seat 6: crazycarno folded before Flop
Seat 7: SparkYLive folded before Flop (didn't bet)
Seat 8: AndyLu)|(ynski collected ($1.75)
Seat 9: Alim.A.Tur (button) folded before Flop (didn't bet)



PokerStars Hand #228697098259:  Hold'em No Limit ($0.25/$0.50 USD) - 2021/07/30 23:41:00 ET
Table 'Gorgo III' 9-max Seat #1 is the button
Seat 1: cartman177 ($51.75 in chips) 
Seat 2: Lago Madjore ($61.31 in chips) 
Seat 3: Dr. Margil ($55.79 in chips) 
Seat 4: Obormid ($52.74 in chips) 
Seat 5: xobit26 ($50 in chips) 
Seat 6: crazycarno ($10.96 in chips) 
Seat 7: SparkYLive ($59.12 in chips) 
Seat 8: AndyLu)|(ynski ($26.28 in chips) 
Seat 9: Alim.A.Tur ($50.78 in chips) 
Lago Madjore: posts small blind $0.25
Dr. Margil: posts big blind $0.50
*** HOLE CARDS ***
Obormid: folds 
xobit26: folds 
crazycarno: folds 
SparkYLive: raises $1 to $1.50
AndyLu)|(ynski: folds 
Alim.A.Tur: folds 
cartman177: folds 
Lago Madjore: folds 
Dr. Margil: calls $1
*** FLOP *** [7c 4d Jd]
Dr. Margil: checks 
SparkYLive: bets $0.93
Dr. Margil: calls $0.93
*** TURN *** [7c 4d Jd] [Qd]
Dr. Margil: checks 
SparkYLive: checks 
*** RIVER *** [7c 4d Jd Qd] [Ad]
crazycarno is disconnected 
Dr. Margil: bets $3.50
SparkYLive: folds 
Uncalled bet ($3.50) returned to Dr. Margil
Dr. Margil collected $4.85 from pot
Dr. Margil: doesn't show hand 
*** SUMMARY ***
Total pot $5.11 | Rake $0.26 
Board [7c 4d Jd Qd Ad]
Seat 1: cartman177 (button) folded before Flop (didn't bet)
Seat 2: Lago Madjore (small blind) folded before Flop
Seat 3: Dr. Margil (big blind) collected ($4.85)
Seat 4: Obormid folded before Flop (didn't bet)
Seat 5: xobit26 folded before Flop (didn't bet)
Seat 6: crazycarno folded before Flop (didn't bet)
Seat 7: SparkYLive folded on the River
Seat 8: AndyLu)|(ynski folded before Flop (didn't bet)
Seat 9: Alim.A.Tur folded before Flop (didn't bet)



PokerStars Hand #228697112400:  Hold'em No Limit ($0.25/$0.50 USD) - 2021/07/30 23:41:40 ET
Table 'Gorgo III' 9-max Seat #2 is the button
Seat 1: cartman177 ($51.75 in chips) 
Seat 2: Lago Madjore ($61.06 in chips) 
Seat 3: Dr. Margil ($58.21 in chips) 
Seat 4: Obormid ($52.74 in chips) 
Seat 5: xobit26 ($50 in chips) 
Seat 6: crazycarno ($10.96 in chips) 
Seat 7: SparkYLive ($56.69 in chips) 
Seat 8: AndyLu)|(ynski ($26.28 in chips) 
Seat 9: Alim.A.Tur ($50.78 in chips) 
Dr. Margil: posts small blind $0.25
Obormid: posts big blind $0.50
*** HOLE CARDS ***
xobit26: folds 
crazycarno has timed out while disconnected
crazycarno: folds 
SparkYLive: folds 
AndyLu)|(ynski: folds 
Alim.A.Tur: folds 
cartman177: folds 
Lago Madjore: raises $0.88 to $1.38
Dr. Margil: raises $4.12 to $5.50
Obormid: folds 
Lago Madjore: raises $7 to $12.50
Dr. Margil: raises $45.71 to $58.21 and is all-in
Lago Madjore: calls $45.71
Dr. Margil:  
Lago Madjore:  
*** FLOP *** [2h 7h 8h]
*** TURN *** [2h 7h 8h] [9d]
*** RIVER *** [2h 7h 8h 9d] [4d]
*** SHOW DOWN ***
Dr. Margil: shows [Qc As] (high card Ace)
Lago Madjore: shows [Ac Kc] (high card Ace - King kicker)
Lago Madjore collected $114.92 from pot
*** SUMMARY ***
Total pot $116.92 | Rake $2 
Board [2h 7h 8h 9d 4d]
Seat 1: cartman177 folded before Flop (didn't bet)
Seat 2: Lago Madjore (button) showed [Ac Kc] and won ($114.92) with high card Ace
Seat 3: Dr. Margil (small blind) showed [Qc As] and lost with high card Ace
Seat 4: Obormid (big blind) folded before Flop
Seat 5: xobit26 folded before Flop (didn't bet)
Seat 6: crazycarno folded before Flop (didn't bet)
Seat 7: SparkYLive folded before Flop (didn't bet)
Seat 8: AndyLu)|(ynski folded before Flop (didn't bet)
Seat 9: Alim.A.Tur folded before Flop (didn't bet)



PokerStars Hand #228697123000:  Hold'em No Limit ($0.25/$0.50 USD) - 2021/07/30 23:42:36 ET
Table 'Gorgo III' 9-max Seat #4 is the button
Seat 1: cartman177 ($51.75 in chips) 
Seat 2: Lago Madjore ($117.77 in chips) 
Seat 4: Obormid ($52.24 in chips) 
Seat 5: xobit26 ($50 in chips) 
Seat 7: SparkYLive ($56.69 in chips) 
Seat 8: AndyLu)|(ynski ($26.28 in chips) 
Seat 9: Alim.A.Tur ($50.78 in chips) 
xobit26: posts small blind $0.25
SparkYLive: posts big blind $0.50
*** HOLE CARDS ***
Dr. Margil leaves the table
AndyLu)|(ynski: raises $1.50 to $2
cartman177 is disconnected 
Alim.A.Tur: folds 
cartman177 is connected 
cartman177: folds 
Lago Madjore: folds 
Obormid: folds 
xobit26: folds 
SparkYLive: folds 
Uncalled bet ($1.50) returned to AndyLu)|(ynski
AndyLu)|(ynski collected $1.25 from pot
AndyLu)|(ynski: doesn't show hand 
*** SUMMARY ***
Total pot $1.25 | Rake $0 
Seat 1: cartman177 folded before Flop (didn't bet)
Seat 2: Lago Madjore folded before Flop (didn't bet)
Seat 4: Obormid (button) folded before Flop (didn't bet)
Seat 5: xobit26 (small blind) folded before Flop
Seat 7: SparkYLive (big blind) folded before Flop
Seat 8: AndyLu)|(ynski collected ($1.25)
Seat 9: Alim.A.Tur folded before Flop (didn't bet)



PokerStars Hand #228697136008:  Hold'em No Limit ($0.25/$0.50 USD) - 2021/07/30 23:43:44 ET
Table 'Gorgo III' 9-max Seat #9 is the button
Seat 3: Zargmen ($19.21 in chips) 
Seat 4: Obormid ($53.38 in chips) 
Seat 5: xobit26 ($50 in chips) 
Seat 7: SparkYLive ($55.94 in chips) 
Seat 9: Alim.A.Tur ($50.03 in chips) 
Zargmen: posts small blind $0.25
Obormid: posts big blind $0.50
*** HOLE CARDS ***
xobit26: raises $0.75 to $1.25
SparkYLive: folds 
Alim.A.Tur: folds 
Zargmen: folds 
Obormid: calls $0.75
*** FLOP *** [4h 7c 7h]
Obormid: bets $2.30
xobit26: calls $2.30
*** TURN *** [4h 7c 7h] [7s]
Obormid: bets $2
xobit26: folds 
Uncalled bet ($2) returned to Obormid
Obormid collected $6.98 from pot
*** SUMMARY ***
Total pot $7.35 | Rake $0.37 
Board [4h 7c 7h 7s]
Seat 3: Zargmen (small blind) folded before Flop
Seat 4: Obormid (big blind) collected ($6.98)
Seat 5: xobit26 folded on the Turn
Seat 7: SparkYLive folded before Flop (didn't bet)
Seat 9: Alim.A.Tur (button) folded before Flop (didn't bet)



PokerStars Hand #228697146014:  Hold'em No Limit ($0.25/$0.50 USD) - 2021/07/30 23:44:36 ET
Table 'Gorgo III' 9-max Seat #3 is the button
Seat 3: Zargmen ($18.96 in chips) 
Seat 4: Obormid ($56.81 in chips) 
Seat 5: xobit26 ($50 in chips) 
Seat 7: SparkYLive ($55.94 in chips) 
Seat 9: Alim.A.Tur ($50.03 in chips) 
Obormid: posts small blind $0.25
xobit26: posts big blind $0.50
Cuca Moruca: sits out 
SamuraiKrypton: sits out 
*** HOLE CARDS ***
SparkYLive: folds 
Alim.A.Tur: folds 
Zargmen: folds 
Obormid: calls $0.25
xobit26: checks 
*** FLOP *** [9s 6d 5c]
Alim.A.Tur leaves the table
Obormid: bets $1
xobit26: folds 
Uncalled bet ($1) returned to Obormid
Obormid collected $0.95 from pot
Obormid: doesn't show hand 
*** SUMMARY ***
Total pot $1 | Rake $0.05 
Board [9s 6d 5c]
Seat 3: Zargmen (button) folded before Flop (didn't bet)
Seat 4: Obormid (small blind) collected ($0.95)
Seat 5: xobit26 (big blind) folded on the Flop
Seat 7: SparkYLive folded before Flop (didn't bet)
Seat 9: Alim.A.Tur folded before Flop (didn't bet)



PokerStars Hand #228697150448:  Hold'em No Limit ($0.25/$0.50 USD) - 2021/07/30 23:45:00 ET
Table 'Gorgo III' 9-max Seat #4 is the button
Seat 1: Cuca Moruca ($50 in chips) 
Seat 3: Zargmen ($18.96 in chips) 
Seat 4: Obormid ($57.26 in chips) 
Seat 5: xobit26 ($50 in chips) 
xobit26: posts small blind $0.25
SparkYLive: is sitting out 
Cuca Moruca: posts big blind $0.50
SamuraiKrypton: sits out 
*** HOLE CARDS ***
Zargmen: folds 
Obormid: folds 
xobit26: raises $1 to $1.50
kars0n joins the table at seat #9 
Cuca Moruca: folds 
Uncalled bet ($1) returned to xobit26
xobit26 collected $1 from pot
xobit26: doesn't show hand 
*** SUMMARY ***
Total pot $1 | Rake $0 
Seat 1: Cuca Moruca (big blind) folded before Flop
Seat 3: Zargmen folded before Flop (didn't bet)
Seat 4: Obormid (button) folded before Flop (didn't bet)
Seat 5: xobit26 (small blind) collected ($1)



PokerStars Hand #228697155279:  Hold'em No Limit ($0.25/$0.50 USD) - 2021/07/30 23:45:26 ET
Table 'Gorgo III' 9-max Seat #5 is the button
Seat 1: Cuca Moruca ($49.50 in chips) 
Seat 2: SamuraiKrypton ($50 in chips) 
Seat 3: Zargmen ($18.96 in chips) 
Seat 4: Obormid ($57.26 in chips) 
Seat 5: xobit26 ($50.50 in chips) 
Cuca Moruca: posts small blind $0.25
SamuraiKrypton: posts big blind $0.50
*** HOLE CARDS ***
Zargmen: folds 
Obormid: folds 
xobit26: raises $0.75 to $1.25
Cuca Moruca: folds 
SamuraiKrypton: calls $0.75
*** FLOP *** [4h Qs 5s]
SamuraiKrypton: checks 
crazycarno was removed from the table for failing to post
crazycarno leaves the table
xobit26: bets $0.87
SamuraiKrypton: calls $0.87
*** TURN *** [4h Qs 5s] [3h]
SamuraiKrypton: checks 
xobit26: bets $3.23
SamuraiKrypton: raises $3.77 to $7
SparkYLive leaves the table
xobit26: folds 
Uncalled bet ($3.77) returned to SamuraiKrypton
SamuraiKrypton collected $10.40 from pot
SamuraiKrypton: doesn't show hand 
*** SUMMARY ***
Total pot $10.95 | Rake $0.55 
Board [4h Qs 5s 3h]
Seat 1: Cuca Moruca (small blind) folded before Flop
Seat 2: SamuraiKrypton (big blind) collected ($10.40)
Seat 3: Zargmen folded before Flop (didn't bet)
Seat 4: Obormid folded before Flop (didn't bet)
Seat 5: xobit26 (button) folded on the Turn



PokerStars Hand #228697168113:  Hold'em No Limit ($0.25/$0.50 USD) - 2021/07/30 23:46:34 ET
Table 'Gorgo III' 9-max Seat #1 is the button
Seat 1: Cuca Moruca ($49.25 in chips) 
Seat 2: SamuraiKrypton ($55.05 in chips) 
Seat 3: Zargmen ($18.96 in chips) 
Seat 4: Obormid ($57.26 in chips) 
Seat 5: xobit26 ($50 in chips) 
SamuraiKrypton: posts small blind $0.25
Zargmen: posts big blind $0.50
kars0n: sits out 
*** HOLE CARDS ***
Obormid: raises $1 to $1.50
xobit26: folds 
Cuca Moruca: folds 
SamuraiKrypton: folds 
Zargmen: folds 
Uncalled bet ($1) returned to Obormid
Obormid collected $1.25 from pot
Obormid: doesn't show hand 
*** SUMMARY ***
Total pot $1.25 | Rake $0 
Seat 1: Cuca Moruca (button) folded before Flop (didn't bet)
Seat 2: SamuraiKrypton (small blind) folded before Flop
Seat 3: Zargmen (big blind) folded before Flop
Seat 4: Obormid collected ($1.25)
Seat 5: xobit26 folded before Flop (didn't bet)



PokerStars Hand #228697173209:  Hold'em No Limit ($0.25/$0.50 USD) - 2021/07/30 23:47:02 ET
Table 'Gorgo III' 9-max Seat #2 is the button
Seat 1: Cuca Moruca ($49.25 in chips) 
Seat 2: SamuraiKrypton ($54.80 in chips) 
Seat 3: Zargmen ($18.46 in chips) 
Seat 4: Obormid ($58.01 in chips) 
Seat 5: xobit26 ($50 in chips) 
Zargmen: posts small blind $0.25
Obormid: posts big blind $0.50
kars0n: sits out 
*** HOLE CARDS ***
xobit26: folds 
Cuca Moruca: raises $1 to $1.50
SamuraiKrypton: calls $1.50
Zargmen: calls $1.25
Obormid: calls $1
*** FLOP *** [4h 9d 5h]
Zargmen: checks 
Obormid: checks 
Cuca Moruca: checks 
SamuraiKrypton: checks 
*** TURN *** [4h 9d 5h] [4d]
Zargmen: checks 
sw_iceman joins the table at seat #6 
Obormid: bets $2.85
Cuca Moruca: folds 
SamuraiKrypton: calls $2.85
Zargmen: folds 
*** RIVER *** [4h 9d 5h 4d] [Ah]
Obormid: checks 
SamuraiKrypton: checks 
*** SHOW DOWN ***
Obormid: shows [7d 5d] (two pair, Fives and Fours)
SamuraiKrypton: shows [3d Ad] (two pair, Aces and Fours)
SamuraiKrypton collected $11.12 from pot
*** SUMMARY ***
Total pot $11.70 | Rake $0.58 
Board [4h 9d 5h 4d Ah]
Seat 1: Cuca Moruca folded on the Turn
Seat 2: SamuraiKrypton (button) showed [3d Ad] and won ($11.12) with two pair, Aces and Fours
Seat 3: Zargmen (small blind) folded on the Turn
Seat 4: Obormid (big blind) showed [7d 5d] and lost with two pair, Fives and Fours
Seat 5: xobit26 folded before Flop (didn't bet)



