PokerStars Hand #228683510351:  Hold'em No Limit ($0.25/$0.50 USD) - 2021/07/30 13:18:05 ET
Table 'Bok II' 9-max Seat #4 is the button
Seat 1: MartinHoney ($19.50 in chips) 
Seat 2: goldenpig666 ($50 in chips) 
Seat 3: Rulet345 ($50 in chips) 
Seat 4: lonely fire ($50.75 in chips) 
MartinHoney: posts small blind $0.25
goldenpig666: posts big blind $0.50
*** HOLE CARDS ***
Rulet345: folds 
lonely fire: raises $0.75 to $1.25
MartinHoney: calls $1
goldenpig666: folds 
*** FLOP *** [6s 6d 4s]
MartinHoney: checks 
lonely fire: bets $0.94
MartinHoney: calls $0.94
*** TURN *** [6s 6d 4s] [Js]
MartinHoney: checks 
Mmago24 joins the table at seat #7 
lonely fire: checks 
*** RIVER *** [6s 6d 4s Js] [2s]
MartinHoney: checks 
lonely fire: checks 
*** SHOW DOWN ***
MartinHoney: shows [9h As] (a flush, Ace high)
lonely fire: mucks hand 
MartinHoney collected $4.64 from pot
*** SUMMARY ***
Total pot $4.88 | Rake $0.24 
Board [6s 6d 4s Js 2s]
Seat 1: MartinHoney (small blind) showed [9h As] and won ($4.64) with a flush, Ace high
Seat 2: goldenpig666 (big blind) folded before Flop
Seat 3: Rulet345 folded before Flop (didn't bet)
Seat 4: lonely fire (button) mucked



PokerStars Hand #228683526361:  Hold'em No Limit ($0.25/$0.50 USD) - 2021/07/30 13:18:44 ET
Table 'Bok II' 9-max Seat #1 is the button
Seat 1: MartinHoney ($21.95 in chips) 
Seat 2: goldenpig666 ($50 in chips) 
Seat 3: Rulet345 ($50 in chips) 
Seat 4: lonely fire ($50 in chips) 
goldenpig666: posts small blind $0.25
Rulet345: posts big blind $0.50
StudentRB: sits out 
Mmago24: sits out 
*** HOLE CARDS ***
lonely fire: folds 
MartinHoney: raises $2 to $2.50
goldenpig666: folds 
Rulet345: folds 
Uncalled bet ($2) returned to MartinHoney
MartinHoney collected $1.25 from pot
MartinHoney: doesn't show hand 
*** SUMMARY ***
Total pot $1.25 | Rake $0 
Seat 1: MartinHoney (button) collected ($1.25)
Seat 2: goldenpig666 (small blind) folded before Flop
Seat 3: Rulet345 (big blind) folded before Flop
Seat 4: lonely fire folded before Flop (didn't bet)



PokerStars Hand #228683533131:  Hold'em No Limit ($0.25/$0.50 USD) - 2021/07/30 13:19:02 ET
Table 'Bok II' 9-max Seat #2 is the button
Seat 1: MartinHoney ($22.70 in chips) 
Seat 2: goldenpig666 ($50 in chips) 
Seat 3: Rulet345 ($50 in chips) 
Seat 4: lonely fire ($50 in chips) 
Rulet345: posts small blind $0.25
lonely fire: posts big blind $0.50
StudentRB: sits out 
Mmago24: sits out 
*** HOLE CARDS ***
MartinHoney: calls $0.50
goldenpig666: folds 
Rulet345: folds 
lonely fire: checks 
*** FLOP *** [6s 3d 9h]
lonely fire: checks 
MartinHoney: bets $0.50
lonely fire: folds 
Uncalled bet ($0.50) returned to MartinHoney
MartinHoney collected $1.19 from pot
MartinHoney: doesn't show hand 
*** SUMMARY ***
Total pot $1.25 | Rake $0.06 
Board [6s 3d 9h]
Seat 1: MartinHoney collected ($1.19)
Seat 2: goldenpig666 (button) folded before Flop (didn't bet)
Seat 3: Rulet345 (small blind) folded before Flop
Seat 4: lonely fire (big blind) folded on the Flop



PokerStars Hand #228683540397:  Hold'em No Limit ($0.25/$0.50 USD) - 2021/07/30 13:19:19 ET
Table 'Bok II' 9-max Seat #3 is the button
Seat 1: MartinHoney ($23.39 in chips) 
Seat 2: goldenpig666 ($50 in chips) 
Seat 3: Rulet345 ($50 in chips) 
Seat 4: lonely fire ($50 in chips) 
Seat 5: StudentRB ($50 in chips) 
lonely fire: posts small blind $0.25
StudentRB: posts big blind $0.50
Mmago24: sits out 
*** HOLE CARDS ***
MartinHoney: calls $0.50
goldenpig666: folds 
Rulet345: folds 
lonely fire: folds 
StudentRB: checks 
*** FLOP *** [Ks 5d 9s]
StudentRB: checks 
MartinHoney: bets $1
StudentRB: folds 
Uncalled bet ($1) returned to MartinHoney
MartinHoney collected $1.19 from pot
MartinHoney: doesn't show hand 
*** SUMMARY ***
Total pot $1.25 | Rake $0.06 
Board [Ks 5d 9s]
Seat 1: MartinHoney collected ($1.19)
Seat 2: goldenpig666 folded before Flop (didn't bet)
Seat 3: Rulet345 (button) folded before Flop (didn't bet)
Seat 4: lonely fire (small blind) folded before Flop
Seat 5: StudentRB (big blind) folded on the Flop



PokerStars Hand #228683547753:  Hold'em No Limit ($0.25/$0.50 USD) - 2021/07/30 13:19:38 ET
Table 'Bok II' 9-max Seat #4 is the button
Seat 1: MartinHoney ($24.08 in chips) 
Seat 2: goldenpig666 ($50 in chips) 
Seat 3: Rulet345 ($50 in chips) 
Seat 4: lonely fire ($50 in chips) 
Seat 5: StudentRB ($50 in chips) 
Seat 7: Mmago24 ($50 in chips) 
StudentRB: posts small blind $0.25
Mmago24: posts big blind $0.50
*** HOLE CARDS ***
MartinHoney: folds 
goldenpig666: folds 
Rulet345: folds 
lonely fire: folds 
StudentRB: folds 
Uncalled bet ($0.25) returned to Mmago24
Mmago24 collected $0.50 from pot
Mmago24: doesn't show hand 
*** SUMMARY ***
Total pot $0.50 | Rake $0 
Seat 1: MartinHoney folded before Flop (didn't bet)
Seat 2: goldenpig666 folded before Flop (didn't bet)
Seat 3: Rulet345 folded before Flop (didn't bet)
Seat 4: lonely fire (button) folded before Flop (didn't bet)
Seat 5: StudentRB (small blind) folded before Flop
Seat 7: Mmago24 (big blind) collected ($0.50)



PokerStars Hand #228683551064:  Hold'em No Limit ($0.25/$0.50 USD) - 2021/07/30 13:19:46 ET
Table 'Bok II' 9-max Seat #5 is the button
Seat 1: MartinHoney ($24.08 in chips) 
Seat 2: goldenpig666 ($50 in chips) 
Seat 3: Rulet345 ($50 in chips) 
Seat 4: lonely fire ($50 in chips) 
Seat 5: StudentRB ($50 in chips) 
Seat 7: Mmago24 ($50.25 in chips) 
Mmago24: posts small blind $0.25
MartinHoney: posts big blind $0.50
*** HOLE CARDS ***
goldenpig666: folds 
Rulet345: folds 
lonely fire: folds 
StudentRB: raises $0.75 to $1.25
Mmago24: folds 
ReZo1utioN joins the table at seat #6 
MartinHoney: folds 
Uncalled bet ($0.75) returned to StudentRB
StudentRB collected $1.25 from pot
StudentRB: doesn't show hand 
*** SUMMARY ***
Total pot $1.25 | Rake $0 
Seat 1: MartinHoney (big blind) folded before Flop
Seat 2: goldenpig666 folded before Flop (didn't bet)
Seat 3: Rulet345 folded before Flop (didn't bet)
Seat 4: lonely fire folded before Flop (didn't bet)
Seat 5: StudentRB (button) collected ($1.25)
Seat 7: Mmago24 (small blind) folded before Flop



PokerStars Hand #228683558872:  Hold'em No Limit ($0.25/$0.50 USD) - 2021/07/30 13:20:05 ET
Table 'Bok II' 9-max Seat #7 is the button
Seat 1: MartinHoney ($23.58 in chips) 
Seat 2: goldenpig666 ($50 in chips) 
Seat 3: Rulet345 ($50 in chips) 
Seat 4: lonely fire ($50 in chips) 
Seat 5: StudentRB ($50.75 in chips) 
Seat 7: Mmago24 ($50 in chips) 
MartinHoney: posts small blind $0.25
goldenpig666: posts big blind $0.50
ReZo1utioN: sits out 
*** HOLE CARDS ***
Rulet345: folds 
lonely fire: folds 
StudentRB: raises $0.75 to $1.25
Mmago24: folds 
MartinHoney: folds 
goldenpig666: folds 
Uncalled bet ($0.75) returned to StudentRB
StudentRB collected $1.25 from pot
StudentRB: doesn't show hand 
*** SUMMARY ***
Total pot $1.25 | Rake $0 
Seat 1: MartinHoney (small blind) folded before Flop
Seat 2: goldenpig666 (big blind) folded before Flop
Seat 3: Rulet345 folded before Flop (didn't bet)
Seat 4: lonely fire folded before Flop (didn't bet)
Seat 5: StudentRB collected ($1.25)
Seat 7: Mmago24 (button) folded before Flop (didn't bet)



PokerStars Hand #228683564885:  Hold'em No Limit ($0.25/$0.50 USD) - 2021/07/30 13:20:20 ET
Table 'Bok II' 9-max Seat #1 is the button
Seat 1: MartinHoney ($23.33 in chips) 
Seat 2: goldenpig666 ($50 in chips) 
Seat 3: Rulet345 ($50 in chips) 
Seat 4: lonely fire ($50 in chips) 
Seat 5: StudentRB ($51.50 in chips) 
Seat 7: Mmago24 ($50 in chips) 
ReZo1utioN leaves the table
goldenpig666: posts small blind $0.25
Rulet345: posts big blind $0.50
*** HOLE CARDS ***
lonely fire: raises $1 to $1.50
StudentRB: folds 
Mmago24: folds 
MartinHoney: folds 
goldenpig666: folds 
Rulet345: folds 
Uncalled bet ($1) returned to lonely fire
lonely fire collected $1.25 from pot
lonely fire: doesn't show hand 
*** SUMMARY ***
Total pot $1.25 | Rake $0 
Seat 1: MartinHoney (button) folded before Flop (didn't bet)
Seat 2: goldenpig666 (small blind) folded before Flop
Seat 3: Rulet345 (big blind) folded before Flop
Seat 4: lonely fire collected ($1.25)
Seat 5: StudentRB folded before Flop (didn't bet)
Seat 7: Mmago24 folded before Flop (didn't bet)



PokerStars Hand #228683569115:  Hold'em No Limit ($0.25/$0.50 USD) - 2021/07/30 13:20:30 ET
Table 'Bok II' 9-max Seat #2 is the button
Seat 1: MartinHoney ($23.33 in chips) 
Seat 2: goldenpig666 ($50 in chips) 
Seat 3: Rulet345 ($50 in chips) 
Seat 4: lonely fire ($50.75 in chips) 
Seat 5: StudentRB ($51.50 in chips) 
Seat 7: Mmago24 ($50 in chips) 
Rulet345: posts small blind $0.25
lonely fire: posts big blind $0.50
*** HOLE CARDS ***
StudentRB: folds 
Mmago24: folds 
MartinHoney: calls $0.50
goldenpig666: raises $1.50 to $2
Rulet345: folds 
lonely fire: calls $1.50
MartinHoney: folds 
*** FLOP *** [8d 6h 9h]
lonely fire: checks 
goldenpig666: bets $2.93
lonely fire: folds 
Uncalled bet ($2.93) returned to goldenpig666
goldenpig666 collected $4.45 from pot
goldenpig666: doesn't show hand 
*** SUMMARY ***
Total pot $4.75 | Rake $0.30 
Board [8d 6h 9h]
Seat 1: MartinHoney folded before Flop
Seat 2: goldenpig666 (button) collected ($4.45)
Seat 3: Rulet345 (small blind) folded before Flop
Seat 4: lonely fire (big blind) folded on the Flop
Seat 5: StudentRB folded before Flop (didn't bet)
Seat 7: Mmago24 folded before Flop (didn't bet)



PokerStars Hand #228683580430:  Hold'em No Limit ($0.25/$0.50 USD) - 2021/07/30 13:20:58 ET
Table 'Bok II' 9-max Seat #3 is the button
Seat 1: MartinHoney ($22.83 in chips) 
Seat 2: goldenpig666 ($52.45 in chips) 
Seat 3: Rulet345 ($50 in chips) 
Seat 4: lonely fire ($50 in chips) 
Seat 5: StudentRB ($51.50 in chips) 
Seat 7: Mmago24 ($50 in chips) 
lonely fire: posts small blind $0.25
StudentRB: posts big blind $0.50
*** HOLE CARDS ***
Kasselbanki joins the table at seat #6 
Mmago24: folds 
MartinHoney: calls $0.50
bountyhun31 joins the table at seat #8 
goldenpig666: folds 
Rulet345: folds 
Hunt133 joins the table at seat #9 
lonely fire: calls $0.25
StudentRB: checks 
*** FLOP *** [Jd 8h 2s]
lonely fire: checks 
StudentRB: bets $1
MartinHoney: calls $1
lonely fire: folds 
*** TURN *** [Jd 8h 2s] [2h]
StudentRB: bets $2.49
MartinHoney: folds 
Uncalled bet ($2.49) returned to StudentRB
StudentRB collected $3.32 from pot
StudentRB: doesn't show hand 
*** SUMMARY ***
Total pot $3.50 | Rake $0.18 
Board [Jd 8h 2s 2h]
Seat 1: MartinHoney folded on the Turn
Seat 2: goldenpig666 folded before Flop (didn't bet)
Seat 3: Rulet345 (button) folded before Flop (didn't bet)
Seat 4: lonely fire (small blind) folded on the Flop
Seat 5: StudentRB (big blind) collected ($3.32)
Seat 7: Mmago24 folded before Flop (didn't bet)



PokerStars Hand #228683594353:  Hold'em No Limit ($0.25/$0.50 USD) - 2021/07/30 13:21:32 ET
Table 'Bok II' 9-max Seat #4 is the button
Seat 1: MartinHoney ($21.33 in chips) 
Seat 2: goldenpig666 ($52.45 in chips) 
Seat 3: Rulet345 ($50 in chips) 
Seat 4: lonely fire ($50 in chips) 
Seat 5: StudentRB ($53.32 in chips) 
Seat 6: Kasselbanki ($40 in chips) 
Seat 7: Mmago24 ($50 in chips) 
StudentRB: posts small blind $0.25
Kasselbanki: posts big blind $0.50
bountyhun31: sits out 
Hunt133: sits out 
*** HOLE CARDS ***
Mmago24: folds 
MartinHoney: folds 
goldenpig666: folds 
Rulet345: folds 
lonely fire: folds 
StudentRB: folds 
Uncalled bet ($0.25) returned to Kasselbanki
Kasselbanki collected $0.50 from pot
Kasselbanki: doesn't show hand 
*** SUMMARY ***
Total pot $0.50 | Rake $0 
Seat 1: MartinHoney folded before Flop (didn't bet)
Seat 2: goldenpig666 folded before Flop (didn't bet)
Seat 3: Rulet345 folded before Flop (didn't bet)
Seat 4: lonely fire (button) folded before Flop (didn't bet)
Seat 5: StudentRB (small blind) folded before Flop
Seat 6: Kasselbanki (big blind) collected ($0.50)
Seat 7: Mmago24 folded before Flop (didn't bet)



PokerStars Hand #228683599848:  Hold'em No Limit ($0.25/$0.50 USD) - 2021/07/30 13:21:46 ET
Table 'Bok II' 9-max Seat #5 is the button
Seat 1: MartinHoney ($21.33 in chips) 
Seat 2: goldenpig666 ($52.45 in chips) 
Seat 3: Rulet345 ($50 in chips) 
Seat 4: lonely fire ($50 in chips) 
Seat 5: StudentRB ($53.07 in chips) 
Seat 6: Kasselbanki ($40.25 in chips) 
Seat 7: Mmago24 ($50 in chips) 
Kasselbanki: posts small blind $0.25
Mmago24: posts big blind $0.50
bountyhun31: sits out 
Hunt133: sits out 
*** HOLE CARDS ***
MartinHoney: calls $0.50
goldenpig666: folds 
Rulet345: folds 
lonely fire: folds 
StudentRB: folds 
Kasselbanki: folds 
Mmago24: checks 
*** FLOP *** [Ts Js Ad]
Mmago24: bets $0.63
MartinHoney: folds 
Uncalled bet ($0.63) returned to Mmago24
Mmago24 collected $1.19 from pot
Mmago24: doesn't show hand 
*** SUMMARY ***
Total pot $1.25 | Rake $0.06 
Board [Ts Js Ad]
Seat 1: MartinHoney folded on the Flop
Seat 2: goldenpig666 folded before Flop (didn't bet)
Seat 3: Rulet345 folded before Flop (didn't bet)
Seat 4: lonely fire folded before Flop (didn't bet)
Seat 5: StudentRB (button) folded before Flop (didn't bet)
Seat 6: Kasselbanki (small blind) folded before Flop
Seat 7: Mmago24 (big blind) collected ($1.19)



PokerStars Hand #228683611912:  Hold'em No Limit ($0.25/$0.50 USD) - 2021/07/30 13:22:15 ET
Table 'Bok II' 9-max Seat #6 is the button
Seat 1: MartinHoney ($20.83 in chips) 
Seat 2: goldenpig666 ($52.45 in chips) 
Seat 3: Rulet345 ($50 in chips) 
Seat 4: lonely fire ($50 in chips) 
Seat 5: StudentRB ($53.07 in chips) 
Seat 6: Kasselbanki ($40 in chips) 
Seat 7: Mmago24 ($50.69 in chips) 
Seat 8: bountyhun31 ($32.91 in chips) 
Mmago24: posts small blind $0.25
bountyhun31: posts big blind $0.50
Hunt133: sits out 
*** HOLE CARDS ***
Hunt133 is disconnected 
MartinHoney: raises $1 to $1.50
goldenpig666: folds 
Rulet345: folds 
lonely fire: folds 
StudentRB: folds 
Kasselbanki: folds 
Mmago24: folds 
bountyhun31 has timed out
bountyhun31: folds 
Uncalled bet ($1) returned to MartinHoney
MartinHoney collected $1.25 from pot
MartinHoney: doesn't show hand 
*** SUMMARY ***
Total pot $1.25 | Rake $0 
Seat 1: MartinHoney collected ($1.25)
Seat 2: goldenpig666 folded before Flop (didn't bet)
Seat 3: Rulet345 folded before Flop (didn't bet)
Seat 4: lonely fire folded before Flop (didn't bet)
Seat 5: StudentRB folded before Flop (didn't bet)
Seat 6: Kasselbanki (button) folded before Flop (didn't bet)
Seat 7: Mmago24 (small blind) folded before Flop
Seat 8: bountyhun31 (big blind) folded before Flop



PokerStars Hand #228683631988:  Hold'em No Limit ($0.25/$0.50 USD) - 2021/07/30 13:23:00 ET
Table 'Bok II' 9-max Seat #7 is the button
Seat 1: MartinHoney ($21.58 in chips) 
Seat 2: goldenpig666 ($52.45 in chips) 
Seat 3: Rulet345 ($50 in chips) 
Seat 4: lonely fire ($50 in chips) 
Seat 5: StudentRB ($53.07 in chips) 
Seat 6: Kasselbanki ($40 in chips) 
Seat 7: Mmago24 ($50.44 in chips) 
Seat 8: bountyhun31 ($32.41 in chips) 
Seat 9: Hunt133 ($50 in chips) 
bountyhun31: posts small blind $0.25
Hunt133: posts big blind $0.50
*** HOLE CARDS ***
MartinHoney: folds 
goldenpig666: folds 
Rulet345: folds 
lonely fire: folds 
StudentRB: folds 
Kasselbanki: folds 
Mmago24: folds 
bountyhun31: folds 
Uncalled bet ($0.25) returned to Hunt133
Hunt133 collected $0.50 from pot
*** SUMMARY ***
Total pot $0.50 | Rake $0 
Seat 1: MartinHoney folded before Flop (didn't bet)
Seat 2: goldenpig666 folded before Flop (didn't bet)
Seat 3: Rulet345 folded before Flop (didn't bet)
Seat 4: lonely fire folded before Flop (didn't bet)
Seat 5: StudentRB folded before Flop (didn't bet)
Seat 6: Kasselbanki folded before Flop (didn't bet)
Seat 7: Mmago24 (button) folded before Flop (didn't bet)
Seat 8: bountyhun31 (small blind) folded before Flop
Seat 9: Hunt133 (big blind) collected ($0.50)



PokerStars Hand #228683640022:  Hold'em No Limit ($0.25/$0.50 USD) - 2021/07/30 13:23:20 ET
Table 'Bok II' 9-max Seat #8 is the button
Seat 1: MartinHoney ($21.58 in chips) 
Seat 2: goldenpig666 ($52.45 in chips) 
Seat 3: Rulet345 ($50 in chips) 
Seat 4: lonely fire ($50 in chips) 
Seat 5: StudentRB ($53.07 in chips) 
Seat 6: Kasselbanki ($40 in chips) 
Seat 7: Mmago24 ($50.44 in chips) 
Seat 8: bountyhun31 ($32.16 in chips) 
Seat 9: Hunt133 ($50.25 in chips) 
Hunt133: posts small blind $0.25
MartinHoney: posts big blind $0.50
*** HOLE CARDS ***
goldenpig666: folds 
Rulet345: folds 
lonely fire: raises $1 to $1.50
StudentRB: folds 
Kasselbanki: folds 
Mmago24: folds 
bountyhun31: folds 
Hunt133: folds 
MartinHoney: folds 
Uncalled bet ($1) returned to lonely fire
lonely fire collected $1.25 from pot
lonely fire: doesn't show hand 
*** SUMMARY ***
Total pot $1.25 | Rake $0 
Seat 1: MartinHoney (big blind) folded before Flop
Seat 2: goldenpig666 folded before Flop (didn't bet)
Seat 3: Rulet345 folded before Flop (didn't bet)
Seat 4: lonely fire collected ($1.25)
Seat 5: StudentRB folded before Flop (didn't bet)
Seat 6: Kasselbanki folded before Flop (didn't bet)
Seat 7: Mmago24 folded before Flop (didn't bet)
Seat 8: bountyhun31 (button) folded before Flop (didn't bet)
Seat 9: Hunt133 (small blind) folded before Flop



PokerStars Hand #228683659479:  Hold'em No Limit ($0.25/$0.50 USD) - 2021/07/30 13:24:08 ET
Table 'Bok II' 9-max Seat #9 is the button
Seat 1: MartinHoney ($21.08 in chips) 
Seat 2: goldenpig666 ($52.45 in chips) 
Seat 3: Rulet345 ($50 in chips) 
Seat 4: lonely fire ($50.75 in chips) 
Seat 5: StudentRB ($53.07 in chips) 
Seat 6: Kasselbanki ($40 in chips) 
Seat 7: Mmago24 ($50.44 in chips) 
Seat 8: bountyhun31 ($32.16 in chips) 
Seat 9: Hunt133 ($50 in chips) 
MartinHoney: posts small blind $0.25
goldenpig666: posts big blind $0.50
*** HOLE CARDS ***
Rulet345: folds 
lonely fire: folds 
StudentRB: folds 
Kasselbanki: folds 
Mmago24: folds 
bountyhun31 has timed out
bountyhun31: folds 
Hunt133: raises $0.75 to $1.25
MartinHoney: folds 
goldenpig666: folds 
Uncalled bet ($0.75) returned to Hunt133
Hunt133 collected $1.25 from pot
*** SUMMARY ***
Total pot $1.25 | Rake $0 
Seat 1: MartinHoney (small blind) folded before Flop
Seat 2: goldenpig666 (big blind) folded before Flop
Seat 3: Rulet345 folded before Flop (didn't bet)
Seat 4: lonely fire folded before Flop (didn't bet)
Seat 5: StudentRB folded before Flop (didn't bet)
Seat 6: Kasselbanki folded before Flop (didn't bet)
Seat 7: Mmago24 folded before Flop (didn't bet)
Seat 8: bountyhun31 folded before Flop (didn't bet)
Seat 9: Hunt133 (button) collected ($1.25)



PokerStars Hand #228683672702:  Hold'em No Limit ($0.25/$0.50 USD) - 2021/07/30 13:24:41 ET
Table 'Bok II' 9-max Seat #1 is the button
Seat 1: MartinHoney ($20.83 in chips) 
Seat 2: goldenpig666 ($51.95 in chips) 
Seat 3: Rulet345 ($50 in chips) 
Seat 4: lonely fire ($50.75 in chips) 
Seat 5: StudentRB ($53.07 in chips) 
Seat 6: Kasselbanki ($40 in chips) 
Seat 7: Mmago24 ($50.44 in chips) 
Seat 9: Hunt133 ($50.75 in chips) 
goldenpig666: posts small blind $0.25
Rulet345: posts big blind $0.50
*** HOLE CARDS ***
lonely fire: folds 
StudentRB: folds 
Kasselbanki: folds 
Mmago24: folds 
Hunt133: folds 
MartinHoney: folds 
goldenpig666: folds 
Uncalled bet ($0.25) returned to Rulet345
Rulet345 collected $0.50 from pot
Rulet345: doesn't show hand 
*** SUMMARY ***
Total pot $0.50 | Rake $0 
Seat 1: MartinHoney (button) folded before Flop (didn't bet)
Seat 2: goldenpig666 (small blind) folded before Flop
Seat 3: Rulet345 (big blind) collected ($0.50)
Seat 4: lonely fire folded before Flop (didn't bet)
Seat 5: StudentRB folded before Flop (didn't bet)
Seat 6: Kasselbanki folded before Flop (didn't bet)
Seat 7: Mmago24 folded before Flop (didn't bet)
Seat 9: Hunt133 folded before Flop (didn't bet)



PokerStars Hand #228683679536:  Hold'em No Limit ($0.25/$0.50 USD) - 2021/07/30 13:24:58 ET
Table 'Bok II' 9-max Seat #2 is the button
Seat 1: MartinHoney ($20.83 in chips) 
Seat 2: goldenpig666 ($51.70 in chips) 
Seat 3: Rulet345 ($50.25 in chips) 
Seat 4: lonely fire ($50.75 in chips) 
Seat 5: StudentRB ($53.07 in chips) 
Seat 6: Kasselbanki ($40 in chips) 
Seat 7: Mmago24 ($50.44 in chips) 
Seat 8: bountyhun31 ($32.16 in chips) 
Seat 9: Hunt133 ($50.75 in chips) 
Rulet345: posts small blind $0.25
lonely fire: posts big blind $0.50
*** HOLE CARDS ***
StudentRB: folds 
Kasselbanki: folds 
Mmago24: raises $0.72 to $1.22
bountyhun31 has timed out
bountyhun31: folds 
Hunt133: folds 
MartinHoney: calls $1.22
goldenpig666: folds 
Rulet345: folds 
lonely fire: folds 
*** FLOP *** [Js Ad 3d]
Mmago24: bets $2.02
MartinHoney: folds 
Uncalled bet ($2.02) returned to Mmago24
Mmago24 collected $3.03 from pot
Mmago24: doesn't show hand 
*** SUMMARY ***
Total pot $3.19 | Rake $0.16 
Board [Js Ad 3d]
Seat 1: MartinHoney folded on the Flop
Seat 2: goldenpig666 (button) folded before Flop (didn't bet)
Seat 3: Rulet345 (small blind) folded before Flop
Seat 4: lonely fire (big blind) folded before Flop
Seat 5: StudentRB folded before Flop (didn't bet)
Seat 6: Kasselbanki folded before Flop (didn't bet)
Seat 7: Mmago24 collected ($3.03)
Seat 8: bountyhun31 folded before Flop (didn't bet)
Seat 9: Hunt133 folded before Flop (didn't bet)



PokerStars Hand #228683702769:  Hold'em No Limit ($0.25/$0.50 USD) - 2021/07/30 13:25:38 ET
Table 'Bok II' 9-max Seat #3 is the button
Seat 1: MartinHoney ($19.61 in chips) 
Seat 2: goldenpig666 ($51.70 in chips) 
Seat 3: Rulet345 ($50 in chips) 
Seat 4: lonely fire ($50.25 in chips) 
Seat 5: StudentRB ($53.07 in chips) 
Seat 6: Kasselbanki ($40 in chips) 
Seat 7: Mmago24 ($52.25 in chips) 
Seat 9: Hunt133 ($50.75 in chips) 
lonely fire: posts small blind $0.25
StudentRB: posts big blind $0.50
*** HOLE CARDS ***
Kasselbanki: folds 
Mmago24: folds 
Hunt133: folds 
MartinHoney: folds 
goldenpig666: folds 
Rulet345: folds 
lonely fire: folds 
Uncalled bet ($0.25) returned to StudentRB
StudentRB collected $0.50 from pot
StudentRB: doesn't show hand 
*** SUMMARY ***
Total pot $0.50 | Rake $0 
Seat 1: MartinHoney folded before Flop (didn't bet)
Seat 2: goldenpig666 folded before Flop (didn't bet)
Seat 3: Rulet345 (button) folded before Flop (didn't bet)
Seat 4: lonely fire (small blind) folded before Flop
Seat 5: StudentRB (big blind) collected ($0.50)
Seat 6: Kasselbanki folded before Flop (didn't bet)
Seat 7: Mmago24 folded before Flop (didn't bet)
Seat 9: Hunt133 folded before Flop (didn't bet)



PokerStars Hand #228683707520:  Hold'em No Limit ($0.25/$0.50 USD) - 2021/07/30 13:25:50 ET
Table 'Bok II' 9-max Seat #4 is the button
Seat 1: MartinHoney ($19.61 in chips) 
Seat 2: goldenpig666 ($51.70 in chips) 
Seat 3: Rulet345 ($50 in chips) 
Seat 4: lonely fire ($50 in chips) 
Seat 5: StudentRB ($53.32 in chips) 
Seat 6: Kasselbanki ($40 in chips) 
Seat 7: Mmago24 ($52.25 in chips) 
Seat 9: Hunt133 ($50.75 in chips) 
StudentRB: posts small blind $0.25
Kasselbanki: posts big blind $0.50
*** HOLE CARDS ***
Mmago24: folds 
Hunt133: folds 
MartinHoney: calls $0.50
goldenpig666: folds 
Rulet345: folds 
lonely fire: raises $1.50 to $2
StudentRB: folds 
Kasselbanki: calls $1.50
MartinHoney: calls $1.50
*** FLOP *** [3d Tc 3h]
Kasselbanki: checks 
MartinHoney: checks 
lonely fire: bets $1.75
Kasselbanki: calls $1.75
MartinHoney: folds 
*** TURN *** [3d Tc 3h] [Qs]
Kasselbanki: checks 
lonely fire: checks 
*** RIVER *** [3d Tc 3h Qs] [Qh]
Kasselbanki: bets $1.50
lonely fire: calls $1.50
*** SHOW DOWN ***
Kasselbanki: shows [6s 6d] (two pair, Queens and Sixes)
lonely fire: mucks hand 
Kasselbanki collected $11.95 from pot
*** SUMMARY ***
Total pot $12.75 | Rake $0.80 
Board [3d Tc 3h Qs Qh]
Seat 1: MartinHoney folded on the Flop
Seat 2: goldenpig666 folded before Flop (didn't bet)
Seat 3: Rulet345 folded before Flop (didn't bet)
Seat 4: lonely fire (button) mucked
Seat 5: StudentRB (small blind) folded before Flop
Seat 6: Kasselbanki (big blind) showed [6s 6d] and won ($11.95) with two pair, Queens and Sixes
Seat 7: Mmago24 folded before Flop (didn't bet)
Seat 9: Hunt133 folded before Flop (didn't bet)



PokerStars Hand #228684754840:  Hold'em No Limit ($0.25/$0.50 USD) - 2021/07/30 14:08:34 ET
Table 'Bok II' 9-max Seat #3 is the button
Seat 1: Nestle170 ($81.55 in chips) 
Seat 2: bateman225 ($37.53 in chips) 
Seat 3: Rulet345 ($60.55 in chips) 
Seat 4: KerilTheBoss ($50 in chips) 
Seat 5: EBISU01 ($41.56 in chips) 
Seat 6: Kasselbanki ($43.27 in chips) 
Seat 7: Mmago24 ($58.65 in chips) 
Seat 8: bountyhun31 ($40.63 in chips) 
Seat 9: Zhud19 ($50 in chips) 
KerilTheBoss: posts small blind $0.25
EBISU01: posts big blind $0.50
*** HOLE CARDS ***
Kasselbanki: folds 
Mmago24: folds 
bountyhun31: calls $0.50
Zhud19: folds 
Nestle170: raises $1.50 to $2
bateman225: folds 
Rulet345: folds 
KerilTheBoss: folds 
EBISU01: calls $1.50
bountyhun31: calls $1.50
*** FLOP *** [3d 5d 2c]
EBISU01: checks 
bountyhun31: bets $5.94
Nestle170: folds 
EBISU01: folds 
Uncalled bet ($5.94) returned to bountyhun31
bountyhun31 collected $5.94 from pot
bountyhun31: doesn't show hand 
*** SUMMARY ***
Total pot $6.25 | Rake $0.31 
Board [3d 5d 2c]
Seat 1: Nestle170 folded on the Flop
Seat 2: bateman225 folded before Flop (didn't bet)
Seat 3: Rulet345 (button) folded before Flop (didn't bet)
Seat 4: KerilTheBoss (small blind) folded before Flop
Seat 5: EBISU01 (big blind) folded on the Flop
Seat 6: Kasselbanki folded before Flop (didn't bet)
Seat 7: Mmago24 folded before Flop (didn't bet)
Seat 8: bountyhun31 collected ($5.94)
Seat 9: Zhud19 folded before Flop (didn't bet)



PokerStars Hand #228684779999:  Hold'em No Limit ($0.25/$0.50 USD) - 2021/07/30 14:09:24 ET
Table 'Bok II' 9-max Seat #4 is the button
Seat 1: Nestle170 ($79.55 in chips) 
Seat 2: bateman225 ($37.53 in chips) 
Seat 3: Rulet345 ($60.55 in chips) 
Seat 4: KerilTheBoss ($50 in chips) 
Seat 5: EBISU01 ($39.56 in chips) 
Seat 6: Kasselbanki ($43.27 in chips) 
Seat 7: Mmago24 ($58.65 in chips) 
Seat 8: bountyhun31 ($44.57 in chips) 
Seat 9: Zhud19 ($50 in chips) 
EBISU01: posts small blind $0.25
Kasselbanki: posts big blind $0.50
*** HOLE CARDS ***
Mmago24: folds 
bountyhun31: calls $0.50
Zhud19: folds 
Nestle170: folds 
bateman225: folds 
Rulet345: raises $1.50 to $2
KerilTheBoss: raises $5 to $7
EBISU01: folds 
Kasselbanki: folds 
bountyhun31: folds 
Rulet345: folds 
Uncalled bet ($5) returned to KerilTheBoss
KerilTheBoss collected $5.25 from pot
KerilTheBoss: doesn't show hand 
*** SUMMARY ***
Total pot $5.25 | Rake $0 
Seat 1: Nestle170 folded before Flop (didn't bet)
Seat 2: bateman225 folded before Flop (didn't bet)
Seat 3: Rulet345 folded before Flop
Seat 4: KerilTheBoss (button) collected ($5.25)
Seat 5: EBISU01 (small blind) folded before Flop
Seat 6: Kasselbanki (big blind) folded before Flop
Seat 7: Mmago24 folded before Flop (didn't bet)
Seat 8: bountyhun31 folded before Flop
Seat 9: Zhud19 folded before Flop (didn't bet)



PokerStars Hand #228684790791:  Hold'em No Limit ($0.25/$0.50 USD) - 2021/07/30 14:09:50 ET
Table 'Bok II' 9-max Seat #5 is the button
Seat 1: Nestle170 ($79.55 in chips) 
Seat 2: bateman225 ($37.53 in chips) 
Seat 3: Rulet345 ($58.55 in chips) 
Seat 4: KerilTheBoss ($53.25 in chips) 
Seat 5: EBISU01 ($39.31 in chips) 
Seat 6: Kasselbanki ($42.77 in chips) 
Seat 7: Mmago24 ($58.65 in chips) 
Seat 8: bountyhun31 ($44.07 in chips) 
Seat 9: Zhud19 ($50 in chips) 
Kasselbanki: posts small blind $0.25
Mmago24: posts big blind $0.50
*** HOLE CARDS ***
bountyhun31: folds 
Zhud19: folds 
Nestle170: folds 
bateman225: folds 
Rulet345: folds 
KerilTheBoss: folds 
EBISU01: folds 
Kasselbanki: folds 
Uncalled bet ($0.25) returned to Mmago24
Mmago24 collected $0.50 from pot
Mmago24: doesn't show hand 
*** SUMMARY ***
Total pot $0.50 | Rake $0 
Seat 1: Nestle170 folded before Flop (didn't bet)
Seat 2: bateman225 folded before Flop (didn't bet)
Seat 3: Rulet345 folded before Flop (didn't bet)
Seat 4: KerilTheBoss folded before Flop (didn't bet)
Seat 5: EBISU01 (button) folded before Flop (didn't bet)
Seat 6: Kasselbanki (small blind) folded before Flop
Seat 7: Mmago24 (big blind) collected ($0.50)
Seat 8: bountyhun31 folded before Flop (didn't bet)
Seat 9: Zhud19 folded before Flop (didn't bet)



PokerStars Hand #228684797166:  Hold'em No Limit ($0.25/$0.50 USD) - 2021/07/30 14:10:05 ET
Table 'Bok II' 9-max Seat #6 is the button
Seat 1: Nestle170 ($79.55 in chips) 
Seat 2: bateman225 ($37.53 in chips) 
Seat 3: Rulet345 ($58.55 in chips) 
Seat 4: KerilTheBoss ($53.25 in chips) 
Seat 5: EBISU01 ($39.31 in chips) 
Seat 6: Kasselbanki ($42.52 in chips) 
Seat 7: Mmago24 ($58.90 in chips) 
Seat 8: bountyhun31 ($44.07 in chips) 
Seat 9: Zhud19 ($50 in chips) 
Mmago24: posts small blind $0.25
bountyhun31: posts big blind $0.50
*** HOLE CARDS ***
Zhud19: folds 
Nestle170: folds 
bateman225: folds 
Rulet345: folds 
KerilTheBoss: folds 
EBISU01: raises $1 to $1.50
Kasselbanki: calls $1.50
Mmago24: folds 
bountyhun31: calls $1
*** FLOP *** [Th 3s Qc]
bountyhun31: bets $2.25
EBISU01: calls $2.25
Kasselbanki: folds 
*** TURN *** [Th 3s Qc] [2c]
bountyhun31: bets $1
EBISU01: calls $1
*** RIVER *** [Th 3s Qc 2c] [Ad]
bountyhun31: bets $4
EBISU01: folds 
Uncalled bet ($4) returned to bountyhun31
bountyhun31 collected $10.69 from pot
bountyhun31: doesn't show hand 
*** SUMMARY ***
Total pot $11.25 | Rake $0.56 
Board [Th 3s Qc 2c Ad]
Seat 1: Nestle170 folded before Flop (didn't bet)
Seat 2: bateman225 folded before Flop (didn't bet)
Seat 3: Rulet345 folded before Flop (didn't bet)
Seat 4: KerilTheBoss folded before Flop (didn't bet)
Seat 5: EBISU01 folded on the River
Seat 6: Kasselbanki (button) folded on the Flop
Seat 7: Mmago24 (small blind) folded before Flop
Seat 8: bountyhun31 (big blind) collected ($10.69)
Seat 9: Zhud19 folded before Flop (didn't bet)



PokerStars Hand #228684822222:  Hold'em No Limit ($0.25/$0.50 USD) - 2021/07/30 14:11:03 ET
Table 'Bok II' 9-max Seat #7 is the button
Seat 1: Nestle170 ($79.55 in chips) 
Seat 2: bateman225 ($37.53 in chips) 
Seat 3: Rulet345 ($58.55 in chips) 
Seat 4: KerilTheBoss ($53.25 in chips) 
Seat 5: EBISU01 ($34.56 in chips) 
Seat 6: Kasselbanki ($41.02 in chips) 
Seat 7: Mmago24 ($58.65 in chips) 
Seat 8: bountyhun31 ($50.01 in chips) 
Seat 9: Zhud19 ($50 in chips) 
bountyhun31: posts small blind $0.25
Zhud19: posts big blind $0.50
*** HOLE CARDS ***
Nestle170: folds 
bateman225: raises $1 to $1.50
Rulet345: folds 
KerilTheBoss: folds 
EBISU01: folds 
Kasselbanki: folds 
Mmago24: folds 
bountyhun31: folds 
Zhud19: folds 
Uncalled bet ($1) returned to bateman225
bateman225 collected $1.25 from pot
bateman225: doesn't show hand 
*** SUMMARY ***
Total pot $1.25 | Rake $0 
Seat 1: Nestle170 folded before Flop (didn't bet)
Seat 2: bateman225 collected ($1.25)
Seat 3: Rulet345 folded before Flop (didn't bet)
Seat 4: KerilTheBoss folded before Flop (didn't bet)
Seat 5: EBISU01 folded before Flop (didn't bet)
Seat 6: Kasselbanki folded before Flop (didn't bet)
Seat 7: Mmago24 (button) folded before Flop (didn't bet)
Seat 8: bountyhun31 (small blind) folded before Flop
Seat 9: Zhud19 (big blind) folded before Flop



PokerStars Hand #228684832252:  Hold'em No Limit ($0.25/$0.50 USD) - 2021/07/30 14:11:26 ET
Table 'Bok II' 9-max Seat #8 is the button
Seat 1: Nestle170 ($79.55 in chips) 
Seat 2: bateman225 ($38.28 in chips) 
Seat 3: Rulet345 ($58.55 in chips) 
Seat 4: KerilTheBoss ($53.25 in chips) 
Seat 5: EBISU01 ($34.56 in chips) 
Seat 6: Kasselbanki ($41.02 in chips) 
Seat 7: Mmago24 ($58.65 in chips) 
Seat 8: bountyhun31 ($49.76 in chips) 
Seat 9: Zhud19 ($50 in chips) 
Zhud19: posts small blind $0.25
Nestle170: posts big blind $0.50
*** HOLE CARDS ***
bateman225: folds 
Rulet345: raises $1 to $1.50
KerilTheBoss: folds 
EBISU01: folds 
Kasselbanki: folds 
Mmago24: folds 
bountyhun31: folds 
Zhud19: folds 
Nestle170: folds 
Uncalled bet ($1) returned to Rulet345
Rulet345 collected $1.25 from pot
Rulet345: doesn't show hand 
*** SUMMARY ***
Total pot $1.25 | Rake $0 
Seat 1: Nestle170 (big blind) folded before Flop
Seat 2: bateman225 folded before Flop (didn't bet)
Seat 3: Rulet345 collected ($1.25)
Seat 4: KerilTheBoss folded before Flop (didn't bet)
Seat 5: EBISU01 folded before Flop (didn't bet)
Seat 6: Kasselbanki folded before Flop (didn't bet)
Seat 7: Mmago24 folded before Flop (didn't bet)
Seat 8: bountyhun31 (button) folded before Flop (didn't bet)
Seat 9: Zhud19 (small blind) folded before Flop



PokerStars Hand #228684839482:  Hold'em No Limit ($0.25/$0.50 USD) - 2021/07/30 14:11:43 ET
Table 'Bok II' 9-max Seat #9 is the button
Seat 1: Nestle170 ($79.05 in chips) 
Seat 2: bateman225 ($38.28 in chips) 
Seat 3: Rulet345 ($59.30 in chips) 
Seat 4: KerilTheBoss ($53.25 in chips) 
Seat 5: EBISU01 ($34.56 in chips) 
Seat 6: Kasselbanki ($41.02 in chips) 
Seat 7: Mmago24 ($58.65 in chips) 
Seat 8: bountyhun31 ($49.76 in chips) 
Seat 9: Zhud19 ($50 in chips) 
Nestle170: posts small blind $0.25
bateman225: posts big blind $0.50
*** HOLE CARDS ***
Rulet345: folds 
KerilTheBoss: folds 
EBISU01: folds 
Kasselbanki: folds 
Mmago24: raises $0.72 to $1.22
bountyhun31: calls $1.22
Zhud19: folds 
Nestle170: folds 
bateman225: calls $0.72
*** FLOP *** [Ac Ks 8c]
bateman225: checks 
Mmago24: checks 
bountyhun31: bets $1.85
bateman225: folds 
Mmago24: folds 
Uncalled bet ($1.85) returned to bountyhun31
bountyhun31 collected $3.71 from pot
bountyhun31: doesn't show hand 
*** SUMMARY ***
Total pot $3.91 | Rake $0.20 
Board [Ac Ks 8c]
Seat 1: Nestle170 (small blind) folded before Flop
Seat 2: bateman225 (big blind) folded on the Flop
Seat 3: Rulet345 folded before Flop (didn't bet)
Seat 4: KerilTheBoss folded before Flop (didn't bet)
Seat 5: EBISU01 folded before Flop (didn't bet)
Seat 6: Kasselbanki folded before Flop (didn't bet)
Seat 7: Mmago24 folded on the Flop
Seat 8: bountyhun31 collected ($3.71)
Seat 9: Zhud19 (button) folded before Flop (didn't bet)



PokerStars Hand #228684850442:  Hold'em No Limit ($0.25/$0.50 USD) - 2021/07/30 14:12:09 ET
Table 'Bok II' 9-max Seat #1 is the button
Seat 1: Nestle170 ($78.80 in chips) 
Seat 2: bateman225 ($37.06 in chips) 
Seat 3: Rulet345 ($59.30 in chips) 
Seat 4: KerilTheBoss ($53.25 in chips) 
Seat 5: EBISU01 ($34.56 in chips) 
Seat 6: Kasselbanki ($41.02 in chips) 
Seat 7: Mmago24 ($57.43 in chips) 
Seat 8: bountyhun31 ($52.25 in chips) 
Seat 9: Zhud19 ($50 in chips) 
bateman225: posts small blind $0.25
Rulet345: posts big blind $0.50
*** HOLE CARDS ***
KerilTheBoss: folds 
EBISU01: raises $1 to $1.50
Kasselbanki: folds 
Mmago24: calls $1.50
bountyhun31: folds 
Zhud19: folds 
Nestle170: folds 
bateman225: folds 
Rulet345: raises $5 to $6.50
EBISU01: folds 
Mmago24: calls $5
*** FLOP *** [3s 5s 7d]
Rulet345: bets $7.01
Mmago24: calls $7.01
*** TURN *** [3s 5s 7d] [5h]
Rulet345: checks 
Mmago24: bets $10.50
Rulet345: folds 
Uncalled bet ($10.50) returned to Mmago24
Mmago24 collected $27.33 from pot
Mmago24: doesn't show hand 
*** SUMMARY ***
Total pot $28.77 | Rake $1.44 
Board [3s 5s 7d 5h]
Seat 1: Nestle170 (button) folded before Flop (didn't bet)
Seat 2: bateman225 (small blind) folded before Flop
Seat 3: Rulet345 (big blind) folded on the Turn
Seat 4: KerilTheBoss folded before Flop (didn't bet)
Seat 5: EBISU01 folded before Flop
Seat 6: Kasselbanki folded before Flop (didn't bet)
Seat 7: Mmago24 collected ($27.33)
Seat 8: bountyhun31 folded before Flop (didn't bet)
Seat 9: Zhud19 folded before Flop (didn't bet)



PokerStars Hand #228684902093:  Hold'em No Limit ($0.25/$0.50 USD) - 2021/07/30 14:13:50 ET
Table 'Bok II' 9-max Seat #2 is the button
Seat 1: Nestle170 ($78.80 in chips) 
Seat 2: bateman225 ($36.81 in chips) 
Seat 3: Rulet345 ($50 in chips) 
Seat 4: KerilTheBoss ($53.25 in chips) 
Seat 5: EBISU01 ($33.06 in chips) 
Seat 6: Kasselbanki ($41.02 in chips) 
Seat 7: Mmago24 ($71.25 in chips) 
Seat 8: bountyhun31 ($52.25 in chips) 
Seat 9: Zhud19 ($50 in chips) 
Rulet345: posts small blind $0.25
KerilTheBoss: posts big blind $0.50
*** HOLE CARDS ***
EBISU01: folds 
Kasselbanki has timed out
Kasselbanki: folds 
Mmago24: folds 
bountyhun31: calls $0.50
Zhud19: folds 
Nestle170: folds 
bateman225: folds 
Rulet345: folds 
KerilTheBoss: raises $2 to $2.50
bountyhun31: calls $2
*** FLOP *** [7s 6s 5h]
KerilTheBoss: checks 
bountyhun31: checks 
*** TURN *** [7s 6s 5h] [Th]
KerilTheBoss: checks 
bountyhun31: bets $1
KerilTheBoss: folds 
Uncalled bet ($1) returned to bountyhun31
bountyhun31 collected $4.99 from pot
bountyhun31: doesn't show hand 
*** SUMMARY ***
Total pot $5.25 | Rake $0.26 
Board [7s 6s 5h Th]
Seat 1: Nestle170 folded before Flop (didn't bet)
Seat 2: bateman225 (button) folded before Flop (didn't bet)
Seat 3: Rulet345 (small blind) folded before Flop
Seat 4: KerilTheBoss (big blind) folded on the Turn
Seat 5: EBISU01 folded before Flop (didn't bet)
Seat 6: Kasselbanki folded before Flop (didn't bet)
Seat 7: Mmago24 folded before Flop (didn't bet)
Seat 8: bountyhun31 collected ($4.99)
Seat 9: Zhud19 folded before Flop (didn't bet)



PokerStars Hand #228684921137:  Hold'em No Limit ($0.25/$0.50 USD) - 2021/07/30 14:14:35 ET
Table 'Bok II' 9-max Seat #3 is the button
Seat 1: Nestle170 ($78.80 in chips) 
Seat 2: bateman225 ($36.81 in chips) 
Seat 3: Rulet345 ($50 in chips) 
Seat 4: KerilTheBoss ($50.75 in chips) 
Seat 5: EBISU01 ($33.06 in chips) 
Seat 7: Mmago24 ($71.25 in chips) 
Seat 8: bountyhun31 ($54.74 in chips) 
Seat 9: Zhud19 ($50 in chips) 
KerilTheBoss: posts small blind $0.25
EBISU01: posts big blind $0.50
*** HOLE CARDS ***
Mmago24: raises $0.72 to $1.22
bountyhun31: folds 
Zhud19: raises $2.78 to $4
Nestle170: folds 
bateman225: folds 
Rulet345: folds 
KerilTheBoss: folds 
EBISU01: folds 
Mmago24: raises $8 to $12
Zhud19: folds 
Uncalled bet ($8) returned to Mmago24
Mmago24 collected $8.75 from pot
Mmago24: doesn't show hand 
*** SUMMARY ***
Total pot $8.75 | Rake $0 
Seat 1: Nestle170 folded before Flop (didn't bet)
Seat 2: bateman225 folded before Flop (didn't bet)
Seat 3: Rulet345 (button) folded before Flop (didn't bet)
Seat 4: KerilTheBoss (small blind) folded before Flop
Seat 5: EBISU01 (big blind) folded before Flop
Seat 7: Mmago24 collected ($8.75)
Seat 8: bountyhun31 folded before Flop (didn't bet)
Seat 9: Zhud19 folded before Flop



PokerStars Hand #228684937971:  Hold'em No Limit ($0.25/$0.50 USD) - 2021/07/30 14:15:14 ET
Table 'Bok II' 9-max Seat #4 is the button
Seat 1: Nestle170 ($78.80 in chips) 
Seat 2: bateman225 ($36.81 in chips) 
Seat 3: Rulet345 ($50 in chips) 
Seat 4: KerilTheBoss ($50.50 in chips) 
Seat 5: EBISU01 ($32.56 in chips) 
Seat 7: Mmago24 ($76 in chips) 
Seat 8: bountyhun31 ($54.74 in chips) 
Seat 9: Zhud19 ($50 in chips) 
EBISU01: posts small blind $0.25
Mmago24: posts big blind $0.50
*** HOLE CARDS ***
bountyhun31: folds 
Zhud19: folds 
Nestle170: folds 
bateman225: raises $1 to $1.50
Rulet345: folds 
KerilTheBoss: raises $3 to $4.50
EBISU01: folds 
Mmago24: folds 
bateman225: calls $3
*** FLOP *** [9s Ts 3s]
bateman225: checks 
KerilTheBoss: bets $6.95
bateman225: folds 
Uncalled bet ($6.95) returned to KerilTheBoss
KerilTheBoss collected $9.26 from pot
KerilTheBoss: doesn't show hand 
*** SUMMARY ***
Total pot $9.75 | Rake $0.49 
Board [9s Ts 3s]
Seat 1: Nestle170 folded before Flop (didn't bet)
Seat 2: bateman225 folded on the Flop
Seat 3: Rulet345 folded before Flop (didn't bet)
Seat 4: KerilTheBoss (button) collected ($9.26)
Seat 5: EBISU01 (small blind) folded before Flop
Seat 7: Mmago24 (big blind) folded before Flop
Seat 8: bountyhun31 folded before Flop (didn't bet)
Seat 9: Zhud19 folded before Flop (didn't bet)



PokerStars Hand #228684958709:  Hold'em No Limit ($0.25/$0.50 USD) - 2021/07/30 14:16:03 ET
Table 'Bok II' 9-max Seat #5 is the button
Seat 1: Nestle170 ($78.80 in chips) 
Seat 2: bateman225 ($32.31 in chips) 
Seat 3: Rulet345 ($50 in chips) 
Seat 4: KerilTheBoss ($55.26 in chips) 
Seat 5: EBISU01 ($32.31 in chips) 
Seat 7: Mmago24 ($75.50 in chips) 
Seat 8: bountyhun31 ($54.74 in chips) 
Seat 9: Zhud19 ($50 in chips) 
Mmago24: posts small blind $0.25
bountyhun31: posts big blind $0.50
*** HOLE CARDS ***
Zhud19: folds 
Nestle170: folds 
bateman225: calls $0.50
Rulet345: folds 
KerilTheBoss: folds 
EBISU01: folds 
Mmago24: folds 
bountyhun31: checks 
*** FLOP *** [3c 9h Tc]
bountyhun31: checks 
bateman225: bets $0.50
bountyhun31: calls $0.50
*** TURN *** [3c 9h Tc] [3d]
bountyhun31: checks 
bateman225: bets $1
bountyhun31: folds 
Uncalled bet ($1) returned to bateman225
bateman225 collected $2.14 from pot
bateman225: doesn't show hand 
*** SUMMARY ***
Total pot $2.25 | Rake $0.11 
Board [3c 9h Tc 3d]
Seat 1: Nestle170 folded before Flop (didn't bet)
Seat 2: bateman225 collected ($2.14)
Seat 3: Rulet345 folded before Flop (didn't bet)
Seat 4: KerilTheBoss folded before Flop (didn't bet)
Seat 5: EBISU01 (button) folded before Flop (didn't bet)
Seat 7: Mmago24 (small blind) folded before Flop
Seat 8: bountyhun31 (big blind) folded on the Turn
Seat 9: Zhud19 folded before Flop (didn't bet)



PokerStars Hand #228684973757:  Hold'em No Limit ($0.25/$0.50 USD) - 2021/07/30 14:16:39 ET
Table 'Bok II' 9-max Seat #7 is the button
Seat 1: Nestle170 ($78.80 in chips) 
Seat 2: bateman225 ($33.45 in chips) 
Seat 3: Rulet345 ($50 in chips) 
Seat 4: KerilTheBoss ($55.26 in chips) 
Seat 5: EBISU01 ($32.31 in chips) 
Seat 7: Mmago24 ($75.25 in chips) 
Seat 8: bountyhun31 ($53.74 in chips) 
Seat 9: Zhud19 ($50 in chips) 
bountyhun31: posts small blind $0.25
Zhud19: posts big blind $0.50
Kasselbanki: sits out 
*** HOLE CARDS ***
Nestle170: folds 
bateman225: calls $0.50
Rulet345: folds 
KerilTheBoss: folds 
EBISU01: raises $1 to $1.50
Mmago24: folds 
bountyhun31: calls $1.25
Zhud19: folds 
bateman225: calls $1
*** FLOP *** [4s 3d 3s]
bountyhun31: checks 
bateman225: checks 
EBISU01: checks 
*** TURN *** [4s 3d 3s] [Ah]
bountyhun31: bets $1
bateman225: folds 
EBISU01: raises $6.75 to $7.75
bountyhun31: folds 
Uncalled bet ($6.75) returned to EBISU01
EBISU01 collected $6.65 from pot
EBISU01: doesn't show hand 
*** SUMMARY ***
Total pot $7 | Rake $0.35 
Board [4s 3d 3s Ah]
Seat 1: Nestle170 folded before Flop (didn't bet)
Seat 2: bateman225 folded on the Turn
Seat 3: Rulet345 folded before Flop (didn't bet)
Seat 4: KerilTheBoss folded before Flop (didn't bet)
Seat 5: EBISU01 collected ($6.65)
Seat 7: Mmago24 (button) folded before Flop (didn't bet)
Seat 8: bountyhun31 (small blind) folded on the Turn
Seat 9: Zhud19 (big blind) folded before Flop



PokerStars Hand #228684990372:  Hold'em No Limit ($0.25/$0.50 USD) - 2021/07/30 14:17:18 ET
Table 'Bok II' 9-max Seat #8 is the button
Seat 1: Nestle170 ($78.80 in chips) 
Seat 2: bateman225 ($31.95 in chips) 
Seat 3: Rulet345 ($50 in chips) 
Seat 4: KerilTheBoss ($55.26 in chips) 
Seat 5: EBISU01 ($36.46 in chips) 
Seat 7: Mmago24 ($75.25 in chips) 
Seat 8: bountyhun31 ($51.24 in chips) 
Seat 9: Zhud19 ($50 in chips) 
Zhud19: posts small blind $0.25
Nestle170: posts big blind $0.50
Kasselbanki: sits out 
*** HOLE CARDS ***
bateman225: raises $1.50 to $2
Rulet345: folds 
KerilTheBoss: folds 
EBISU01: folds 
EBISU01 leaves the table
Mmago24: folds 
bountyhun31: folds 
Zhud19: folds 
Nestle170: folds 
Uncalled bet ($1.50) returned to bateman225
bateman225 collected $1.25 from pot
bateman225: doesn't show hand 
*** SUMMARY ***
Total pot $1.25 | Rake $0 
Seat 1: Nestle170 (big blind) folded before Flop
Seat 2: bateman225 collected ($1.25)
Seat 3: Rulet345 folded before Flop (didn't bet)
Seat 4: KerilTheBoss folded before Flop (didn't bet)
Seat 5: EBISU01 folded before Flop (didn't bet)
Seat 7: Mmago24 folded before Flop (didn't bet)
Seat 8: bountyhun31 (button) folded before Flop (didn't bet)
Seat 9: Zhud19 (small blind) folded before Flop



PokerStars Hand #228684997723:  Hold'em No Limit ($0.25/$0.50 USD) - 2021/07/30 14:17:36 ET
Table 'Bok II' 9-max Seat #9 is the button
Seat 1: Nestle170 ($78.30 in chips) 
Seat 2: bateman225 ($32.70 in chips) 
Seat 3: Rulet345 ($50 in chips) 
Seat 4: KerilTheBoss ($55.26 in chips) 
Seat 7: Mmago24 ($75.25 in chips) 
Seat 8: bountyhun31 ($51.24 in chips) 
Seat 9: Zhud19 ($50 in chips) 
Nestle170: posts small blind $0.25
bateman225: posts big blind $0.50
Kasselbanki: sits out 
*** HOLE CARDS ***
Rulet345: folds 
KerilTheBoss: folds 
Mmago24: folds 
bountyhun31: folds 
Zhud19: folds 
RokNRolla joins the table at seat #5 
Nestle170: raises $1 to $1.50
bateman225: folds 
Uncalled bet ($1) returned to Nestle170
Nestle170 collected $1 from pot
Nestle170: doesn't show hand 
*** SUMMARY ***
Total pot $1 | Rake $0 
Seat 1: Nestle170 (small blind) collected ($1)
Seat 2: bateman225 (big blind) folded before Flop
Seat 3: Rulet345 folded before Flop (didn't bet)
Seat 4: KerilTheBoss folded before Flop (didn't bet)
Seat 7: Mmago24 folded before Flop (didn't bet)
Seat 8: bountyhun31 folded before Flop (didn't bet)
Seat 9: Zhud19 (button) folded before Flop (didn't bet)



PokerStars Hand #228685005300:  Hold'em No Limit ($0.25/$0.50 USD) - 2021/07/30 14:17:53 ET
Table 'Bok II' 9-max Seat #1 is the button
Seat 1: Nestle170 ($78.80 in chips) 
Seat 2: bateman225 ($32.20 in chips) 
Seat 3: Rulet345 ($50 in chips) 
Seat 4: KerilTheBoss ($55.26 in chips) 
Seat 7: Mmago24 ($75.25 in chips) 
Seat 8: bountyhun31 ($51.24 in chips) 
Seat 9: Zhud19 ($50 in chips) 
bateman225: posts small blind $0.25
Rulet345: posts big blind $0.50
RokNRolla: sits out 
Kasselbanki: sits out 
*** HOLE CARDS ***
KerilTheBoss: folds 
Mmago24: raises $0.72 to $1.22
bountyhun31: folds 
Zhud19: folds 
Nestle170: folds 
bateman225: folds 
Rulet345: folds 
Uncalled bet ($0.72) returned to Mmago24
Mmago24 collected $1.25 from pot
Mmago24: doesn't show hand 
*** SUMMARY ***
Total pot $1.25 | Rake $0 
Seat 1: Nestle170 (button) folded before Flop (didn't bet)
Seat 2: bateman225 (small blind) folded before Flop
Seat 3: Rulet345 (big blind) folded before Flop
Seat 4: KerilTheBoss folded before Flop (didn't bet)
Seat 7: Mmago24 collected ($1.25)
Seat 8: bountyhun31 folded before Flop (didn't bet)
Seat 9: Zhud19 folded before Flop (didn't bet)



PokerStars Hand #228685012107:  Hold'em No Limit ($0.25/$0.50 USD) - 2021/07/30 14:18:09 ET
Table 'Bok II' 9-max Seat #2 is the button
Seat 1: Nestle170 ($78.80 in chips) 
Seat 2: bateman225 ($31.95 in chips) 
Seat 3: Rulet345 ($50 in chips) 
Seat 4: KerilTheBoss ($55.26 in chips) 
Seat 7: Mmago24 ($76 in chips) 
Seat 8: bountyhun31 ($51.24 in chips) 
Seat 9: Zhud19 ($50 in chips) 
Rulet345: posts small blind $0.25
KerilTheBoss: posts big blind $0.50
RokNRolla: sits out 
Kasselbanki: sits out 
*** HOLE CARDS ***
Mmago24: raises $0.72 to $1.22
bountyhun31: calls $1.22
Zhud19: folds 
Nestle170: folds 
bateman225: calls $1.22
Rulet345: folds 
KerilTheBoss: folds 
*** FLOP *** [7c 8h 2s]
Mmago24: bets $2.22
bountyhun31: calls $2.22
bateman225: calls $2.22
*** TURN *** [7c 8h 2s] [5s]
Mmago24: bets $7.01
bountyhun31: folds 
bateman225: folds 
Uncalled bet ($7.01) returned to Mmago24
Mmago24 collected $10.52 from pot
Mmago24: doesn't show hand 
*** SUMMARY ***
Total pot $11.07 | Rake $0.55 
Board [7c 8h 2s 5s]
Seat 1: Nestle170 folded before Flop (didn't bet)
Seat 2: bateman225 (button) folded on the Turn
Seat 3: Rulet345 (small blind) folded before Flop
Seat 4: KerilTheBoss (big blind) folded before Flop
Seat 7: Mmago24 collected ($10.52)
Seat 8: bountyhun31 folded on the Turn
Seat 9: Zhud19 folded before Flop (didn't bet)



PokerStars Hand #228685032793:  Hold'em No Limit ($0.25/$0.50 USD) - 2021/07/30 14:18:58 ET
Table 'Bok II' 9-max Seat #3 is the button
Seat 1: Nestle170 ($78.80 in chips) 
Seat 2: bateman225 ($28.51 in chips) 
Seat 3: Rulet345 ($50 in chips) 
Seat 4: KerilTheBoss ($54.76 in chips) 
Seat 5: RokNRolla ($46.49 in chips) 
Seat 7: Mmago24 ($83.08 in chips) 
Seat 8: bountyhun31 ($47.80 in chips) 
Seat 9: Zhud19 ($50 in chips) 
KerilTheBoss: posts small blind $0.25
RokNRolla: posts big blind $0.50
Kasselbanki: sits out 
*** HOLE CARDS ***
Mmago24: folds 
bountyhun31: raises $1 to $1.50
Zhud19: folds 
Nestle170: folds 
bateman225: folds 
Rulet345: folds 
KerilTheBoss: folds 
RokNRolla: folds 
Uncalled bet ($1) returned to bountyhun31
bountyhun31 collected $1.25 from pot
bountyhun31: doesn't show hand 
*** SUMMARY ***
Total pot $1.25 | Rake $0 
Seat 1: Nestle170 folded before Flop (didn't bet)
Seat 2: bateman225 folded before Flop (didn't bet)
Seat 3: Rulet345 (button) folded before Flop (didn't bet)
Seat 4: KerilTheBoss (small blind) folded before Flop
Seat 5: RokNRolla (big blind) folded before Flop
Seat 7: Mmago24 folded before Flop (didn't bet)
Seat 8: bountyhun31 collected ($1.25)
Seat 9: Zhud19 folded before Flop (didn't bet)



PokerStars Hand #228685044814:  Hold'em No Limit ($0.25/$0.50 USD) - 2021/07/30 14:19:26 ET
Table 'Bok II' 9-max Seat #4 is the button
Seat 1: Nestle170 ($78.80 in chips) 
Seat 2: bateman225 ($28.51 in chips) 
Seat 3: Rulet345 ($50 in chips) 
Seat 4: KerilTheBoss ($54.51 in chips) 
Seat 5: RokNRolla ($45.99 in chips) 
Seat 6: Kasselbanki ($41.02 in chips) 
Seat 7: Mmago24 ($83.08 in chips) 
Seat 8: bountyhun31 ($48.55 in chips) 
Seat 9: Zhud19 ($50 in chips) 
RokNRolla: posts small blind $0.25
Kasselbanki: posts big blind $0.50
*** HOLE CARDS ***
Mmago24: folds 
bountyhun31: folds 
Zhud19: raises $1 to $1.50
Nestle170: folds 
bateman225: folds 
Rulet345: folds 
KerilTheBoss: folds 
RokNRolla: calls $1.25
Kasselbanki: calls $1
*** FLOP *** [Th Qh Ac]
RokNRolla: checks 
Kasselbanki: checks 
Zhud19: bets $1.28
RokNRolla: folds 
Kasselbanki: folds 
Uncalled bet ($1.28) returned to Zhud19
Zhud19 collected $4.28 from pot
*** SUMMARY ***
Total pot $4.50 | Rake $0.22 
Board [Th Qh Ac]
Seat 1: Nestle170 folded before Flop (didn't bet)
Seat 2: bateman225 folded before Flop (didn't bet)
Seat 3: Rulet345 folded before Flop (didn't bet)
Seat 4: KerilTheBoss (button) folded before Flop (didn't bet)
Seat 5: RokNRolla (small blind) folded on the Flop
Seat 6: Kasselbanki (big blind) folded on the Flop
Seat 7: Mmago24 folded before Flop (didn't bet)
Seat 8: bountyhun31 folded before Flop (didn't bet)
Seat 9: Zhud19 collected ($4.28)



PokerStars Hand #228685066351:  Hold'em No Limit ($0.25/$0.50 USD) - 2021/07/30 14:20:17 ET
Table 'Bok II' 9-max Seat #5 is the button
Seat 1: Nestle170 ($78.80 in chips) 
Seat 2: bateman225 ($28.51 in chips) 
Seat 3: Rulet345 ($50 in chips) 
Seat 4: KerilTheBoss ($54.51 in chips) 
Seat 5: RokNRolla ($44.49 in chips) 
Seat 6: Kasselbanki ($39.52 in chips) 
Seat 7: Mmago24 ($83.08 in chips) 
Seat 8: bountyhun31 ($48.55 in chips) 
Seat 9: Zhud19 ($52.78 in chips) 
Kasselbanki: posts small blind $0.25
Mmago24: posts big blind $0.50
*** HOLE CARDS ***
bountyhun31: folds 
Zhud19: folds 
Nestle170: folds 
bateman225: folds 
Rulet345: folds 
KerilTheBoss: folds 
RokNRolla: folds 
Kasselbanki: raises $1 to $1.50
Mmago24: folds 
Uncalled bet ($1) returned to Kasselbanki
Kasselbanki collected $1 from pot
Kasselbanki: doesn't show hand 
*** SUMMARY ***
Total pot $1 | Rake $0 
Seat 1: Nestle170 folded before Flop (didn't bet)
Seat 2: bateman225 folded before Flop (didn't bet)
Seat 3: Rulet345 folded before Flop (didn't bet)
Seat 4: KerilTheBoss folded before Flop (didn't bet)
Seat 5: RokNRolla (button) folded before Flop (didn't bet)
Seat 6: Kasselbanki (small blind) collected ($1)
Seat 7: Mmago24 (big blind) folded before Flop
Seat 8: bountyhun31 folded before Flop (didn't bet)
Seat 9: Zhud19 folded before Flop (didn't bet)



PokerStars Hand #228685074608:  Hold'em No Limit ($0.25/$0.50 USD) - 2021/07/30 14:20:37 ET
Table 'Bok II' 9-max Seat #6 is the button
Seat 1: Nestle170 ($78.80 in chips) 
Seat 2: bateman225 ($28.51 in chips) 
Seat 3: Rulet345 ($50 in chips) 
Seat 4: KerilTheBoss ($54.51 in chips) 
Seat 5: RokNRolla ($44.49 in chips) 
Seat 6: Kasselbanki ($40.02 in chips) 
Seat 7: Mmago24 ($82.58 in chips) 
Seat 8: bountyhun31 ($48.55 in chips) 
Seat 9: Zhud19 ($52.78 in chips) 
Mmago24: posts small blind $0.25
bountyhun31: posts big blind $0.50
*** HOLE CARDS ***
Zhud19: folds 
Nestle170: raises $1 to $1.50
bateman225: calls $1.50
Rulet345: folds 
KerilTheBoss: folds 
RokNRolla: calls $1.50
Kasselbanki: folds 
Mmago24: calls $1.25
bountyhun31: calls $1
*** FLOP *** [Js 3c Kd]
Mmago24: checks 
bountyhun31: checks 
Nestle170: checks 
bateman225: bets $4.50
RokNRolla: folds 
Mmago24: folds 
bountyhun31: folds 
Nestle170: calls $4.50
*** TURN *** [Js 3c Kd] [3s]
Nestle170: checks 
bateman225: bets $8.34
Nestle170: folds 
Uncalled bet ($8.34) returned to bateman225
bateman225 collected $15.68 from pot
bateman225: doesn't show hand 
*** SUMMARY ***
Total pot $16.50 | Rake $0.82 
Board [Js 3c Kd 3s]
Seat 1: Nestle170 folded on the Turn
Seat 2: bateman225 collected ($15.68)
Seat 3: Rulet345 folded before Flop (didn't bet)
Seat 4: KerilTheBoss folded before Flop (didn't bet)
Seat 5: RokNRolla folded on the Flop
Seat 6: Kasselbanki (button) folded before Flop (didn't bet)
Seat 7: Mmago24 (small blind) folded on the Flop
Seat 8: bountyhun31 (big blind) folded on the Flop
Seat 9: Zhud19 folded before Flop (didn't bet)



PokerStars Hand #228685112452:  Hold'em No Limit ($0.25/$0.50 USD) - 2021/07/30 14:22:06 ET
Table 'Bok II' 9-max Seat #7 is the button
Seat 1: Nestle170 ($72.80 in chips) 
Seat 2: bateman225 ($38.19 in chips) 
Seat 3: Rulet345 ($50 in chips) 
Seat 4: KerilTheBoss ($54.51 in chips) 
Seat 5: RokNRolla ($42.99 in chips) 
Seat 6: Kasselbanki ($40.02 in chips) 
Seat 7: Mmago24 ($81.08 in chips) 
Seat 8: bountyhun31 ($47.05 in chips) 
Seat 9: Zhud19 ($52.78 in chips) 
bountyhun31: posts small blind $0.25
Zhud19: posts big blind $0.50
*** HOLE CARDS ***
Nestle170: raises $1 to $1.50
bateman225: calls $1.50
Rulet345: folds 
KerilTheBoss: folds 
RokNRolla: raises $4 to $5.50
Kasselbanki: folds 
Mmago24: folds 
bountyhun31: folds 
Zhud19: folds 
Nestle170: calls $4
bateman225: calls $4
*** FLOP *** [5s Jc Js]
Nestle170: checks 
bateman225: checks 
RokNRolla: bets $7.70
Nestle170: calls $7.70
bateman225: folds 
*** TURN *** [5s Jc Js] [3s]
Nestle170: checks 
RokNRolla: bets $17.50
Nestle170: raises $42.10 to $59.60 and is all-in
RokNRolla: calls $12.29 and is all-in
Uncalled bet ($29.81) returned to Nestle170
*** RIVER *** [5s Jc Js 3s] [4s]
*** SHOW DOWN ***
Nestle170: shows [Kh Ks] (a flush, King high)
RokNRolla: shows [Ac 2c] (a straight, Ace to Five)
Nestle170 collected $90.23 from pot
*** SUMMARY ***
Total pot $92.23 | Rake $2 
Board [5s Jc Js 3s 4s]
Seat 1: Nestle170 showed [Kh Ks] and won ($90.23) with a flush, King high
Seat 2: bateman225 folded on the Flop
Seat 3: Rulet345 folded before Flop (didn't bet)
Seat 4: KerilTheBoss folded before Flop (didn't bet)
Seat 5: RokNRolla showed [Ac 2c] and lost with a straight, Ace to Five
Seat 6: Kasselbanki folded before Flop (didn't bet)
Seat 7: Mmago24 (button) folded before Flop (didn't bet)
Seat 8: bountyhun31 (small blind) folded before Flop
Seat 9: Zhud19 (big blind) folded before Flop



PokerStars Hand #228685167412:  Hold'em No Limit ($0.25/$0.50 USD) - 2021/07/30 14:24:17 ET
Table 'Bok II' 9-max Seat #8 is the button
Seat 1: Nestle170 ($120.04 in chips) 
Seat 2: bateman225 ($32.69 in chips) 
Seat 3: Rulet345 ($50 in chips) 
Seat 4: KerilTheBoss ($54.51 in chips) 
Seat 6: Kasselbanki ($40.02 in chips) 
Seat 7: Mmago24 ($81.08 in chips) 
Seat 8: bountyhun31 ($46.80 in chips) 
Seat 9: Zhud19 ($52.28 in chips) 
Zhud19: posts small blind $0.25
Nestle170: posts big blind $0.50
*** HOLE CARDS ***
bateman225: folds 
Rulet345: folds 
KerilTheBoss: folds 
RokNRolla leaves the table
Kasselbanki: folds 
Mmago24: raises $0.72 to $1.22
bountyhun31: folds 
Zhud19: folds 
Nestle170: folds 
Uncalled bet ($0.72) returned to Mmago24
Mmago24 collected $1.25 from pot
Mmago24: doesn't show hand 
*** SUMMARY ***
Total pot $1.25 | Rake $0 
Seat 1: Nestle170 (big blind) folded before Flop
Seat 2: bateman225 folded before Flop (didn't bet)
Seat 3: Rulet345 folded before Flop (didn't bet)
Seat 4: KerilTheBoss folded before Flop (didn't bet)
Seat 6: Kasselbanki folded before Flop (didn't bet)
Seat 7: Mmago24 collected ($1.25)
Seat 8: bountyhun31 (button) folded before Flop (didn't bet)
Seat 9: Zhud19 (small blind) folded before Flop



PokerStars Hand #228685173456:  Hold'em No Limit ($0.25/$0.50 USD) - 2021/07/30 14:24:31 ET
Table 'Bok II' 9-max Seat #9 is the button
Seat 1: Nestle170 ($119.54 in chips) 
Seat 2: bateman225 ($32.69 in chips) 
Seat 3: Rulet345 ($50 in chips) 
Seat 4: KerilTheBoss ($54.51 in chips) 
Seat 6: Kasselbanki ($40.02 in chips) 
Seat 7: Mmago24 ($81.83 in chips) 
Seat 8: bountyhun31 ($46.80 in chips) 
Seat 9: Zhud19 ($52.03 in chips) 
Nestle170: posts small blind $0.25
bateman225: posts big blind $0.50
*** HOLE CARDS ***
Rulet345: folds 
KerilTheBoss: folds 
Kasselbanki: folds 
Dihabet joins the table at seat #5 
Mmago24: folds 
bountyhun31: raises $1 to $1.50
Zhud19: raises $3 to $4.50
Nestle170: folds 
bateman225: folds 
bountyhun31: raises $42.30 to $46.80 and is all-in
Zhud19: folds 
Uncalled bet ($42.30) returned to bountyhun31
bountyhun31 collected $9.75 from pot
bountyhun31: doesn't show hand 
*** SUMMARY ***
Total pot $9.75 | Rake $0 
Seat 1: Nestle170 (small blind) folded before Flop
Seat 2: bateman225 (big blind) folded before Flop
Seat 3: Rulet345 folded before Flop (didn't bet)
Seat 4: KerilTheBoss folded before Flop (didn't bet)
Seat 6: Kasselbanki folded before Flop (didn't bet)
Seat 7: Mmago24 folded before Flop (didn't bet)
Seat 8: bountyhun31 collected ($9.75)
Seat 9: Zhud19 (button) folded before Flop



PokerStars Hand #228685187043:  Hold'em No Limit ($0.25/$0.50 USD) - 2021/07/30 14:25:03 ET
Table 'Bok II' 9-max Seat #1 is the button
Seat 1: Nestle170 ($119.29 in chips) 
Seat 2: bateman225 ($32.19 in chips) 
Seat 3: Rulet345 ($50 in chips) 
Seat 4: KerilTheBoss ($54.51 in chips) 
Seat 6: Kasselbanki ($40.02 in chips) 
Seat 7: Mmago24 ($81.83 in chips) 
Seat 8: bountyhun31 ($52.05 in chips) 
Seat 9: Zhud19 ($50 in chips) 
bateman225: posts small blind $0.25
Rulet345: posts big blind $0.50
Dihabet: sits out 
*** HOLE CARDS ***
KerilTheBoss: folds 
Kasselbanki: folds 
Mmago24: folds 
bountyhun31: calls $0.50
Zhud19: folds 
Nestle170: folds 
bateman225: calls $0.25
Rulet345: checks 
*** FLOP *** [Qs Kc 6h]
bateman225: checks 
Rulet345: checks 
bountyhun31: bets $0.50
bateman225: folds 
Rulet345: calls $0.50
*** TURN *** [Qs Kc 6h] [8s]
Rulet345: checks 
bountyhun31: bets $1
Rulet345: raises $1 to $2
bountyhun31: calls $1
*** RIVER *** [Qs Kc 6h 8s] [2c]
Rulet345: checks 
bountyhun31: bets $4
Rulet345: folds 
Uncalled bet ($4) returned to bountyhun31
bountyhun31 collected $6.18 from pot
bountyhun31: doesn't show hand 
*** SUMMARY ***
Total pot $6.50 | Rake $0.32 
Board [Qs Kc 6h 8s 2c]
Seat 1: Nestle170 (button) folded before Flop (didn't bet)
Seat 2: bateman225 (small blind) folded on the Flop
Seat 3: Rulet345 (big blind) folded on the River
Seat 4: KerilTheBoss folded before Flop (didn't bet)
Seat 6: Kasselbanki folded before Flop (didn't bet)
Seat 7: Mmago24 folded before Flop (didn't bet)
Seat 8: bountyhun31 collected ($6.18)
Seat 9: Zhud19 folded before Flop (didn't bet)



PokerStars Hand #228685231133:  Hold'em No Limit ($0.25/$0.50 USD) - 2021/07/30 14:26:48 ET
Table 'Bok II' 9-max Seat #2 is the button
Seat 1: Nestle170 ($119.29 in chips) 
Seat 2: bateman225 ($31.69 in chips) 
Seat 3: Rulet345 ($50 in chips) 
Seat 4: KerilTheBoss ($54.51 in chips) 
Seat 6: Kasselbanki ($40.02 in chips) 
Seat 7: Mmago24 ($81.83 in chips) 
Seat 8: bountyhun31 ($55.23 in chips) 
Seat 9: Zhud19 ($50 in chips) 
Rulet345: posts small blind $0.25
KerilTheBoss: posts big blind $0.50
Dihabet: sits out 
*** HOLE CARDS ***
Kasselbanki: folds 
Mmago24: folds 
bountyhun31: folds 
Zhud19: folds 
Nestle170: raises $0.75 to $1.25
bateman225: folds 
Rulet345: folds 
KerilTheBoss: raises $3.75 to $5
Nestle170: raises $7.50 to $12.50
KerilTheBoss: raises $42.01 to $54.51 and is all-in
Nestle170: folds 
Uncalled bet ($42.01) returned to KerilTheBoss
KerilTheBoss collected $25.25 from pot
KerilTheBoss: doesn't show hand 
*** SUMMARY ***
Total pot $25.25 | Rake $0 
Seat 1: Nestle170 folded before Flop
Seat 2: bateman225 (button) folded before Flop (didn't bet)
Seat 3: Rulet345 (small blind) folded before Flop
Seat 4: KerilTheBoss (big blind) collected ($25.25)
Seat 6: Kasselbanki folded before Flop (didn't bet)
Seat 7: Mmago24 folded before Flop (didn't bet)
Seat 8: bountyhun31 folded before Flop (didn't bet)
Seat 9: Zhud19 folded before Flop (didn't bet)



PokerStars Hand #228683960184:  Hold'em No Limit ($0.25/$0.50 USD) - 2021/07/30 13:35:44 ET
Table 'Bok II' 9-max Seat #3 is the button
Seat 1: akiobenj ($21.48 in chips) 
Seat 2: goldenpig666 ($57.26 in chips) 
Seat 3: Rulet345 ($50 in chips) 
Seat 4: lonely fire ($50.72 in chips) 
Seat 5: StudentRB ($59.70 in chips) 
Seat 6: Kasselbanki ($34.20 in chips) 
Seat 8: bountyhun31 ($25.19 in chips) 
lonely fire: posts small blind $0.25
StudentRB: posts big blind $0.50
Mmago24: sits out 
*** HOLE CARDS ***
Kasselbanki: folds 
bountyhun31: calls $0.50
akiobenj: calls $0.50
goldenpig666: folds 
Rulet345: raises $2 to $2.50
lonely fire: folds 
StudentRB: folds 
bountyhun31: calls $2
akiobenj: calls $2
*** FLOP *** [9d Jc Th]
bountyhun31: checks 
akiobenj: checks 
Rulet345: bets $2.59
bountyhun31: calls $2.59
akiobenj: folds 
*** TURN *** [9d Jc Th] [Jh]
bountyhun31: checks 
Rulet345: checks 
*** RIVER *** [9d Jc Th Jh] [Qd]
bountyhun31: bets $20.10 and is all-in
Rulet345: calls $20.10
*** SHOW DOWN ***
bountyhun31: shows [5s Ks] (a straight, Nine to King)
Rulet345: shows [8c 8h] (a straight, Eight to Queen)
bountyhun31 collected $51.63 from pot
*** SUMMARY ***
Total pot $53.63 | Rake $2 
Board [9d Jc Th Jh Qd]
Seat 1: akiobenj folded on the Flop
Seat 2: goldenpig666 folded before Flop (didn't bet)
Seat 3: Rulet345 (button) showed [8c 8h] and lost with a straight, Eight to Queen
Seat 4: lonely fire (small blind) folded before Flop
Seat 5: StudentRB (big blind) folded before Flop
Seat 6: Kasselbanki folded before Flop (didn't bet)
Seat 8: bountyhun31 showed [5s Ks] and won ($51.63) with a straight, Nine to King



PokerStars Hand #228683989844:  Hold'em No Limit ($0.25/$0.50 USD) - 2021/07/30 13:36:55 ET
Table 'Bok II' 9-max Seat #4 is the button
Seat 1: akiobenj ($18.98 in chips) 
Seat 2: goldenpig666 ($57.26 in chips) 
Seat 3: Rulet345 ($50 in chips) 
Seat 4: lonely fire ($50.47 in chips) 
Seat 5: StudentRB ($59.20 in chips) 
Seat 6: Kasselbanki ($34.20 in chips) 
Seat 8: bountyhun31 ($51.63 in chips) 
Seat 9: Hunt133 ($64.84 in chips) 
StudentRB: posts small blind $0.25
Kasselbanki: posts big blind $0.50
Mmago24: sits out 
*** HOLE CARDS ***
bountyhun31: calls $0.50
Hunt133: folds 
akiobenj: calls $0.50
goldenpig666: folds 
Rulet345: folds 
lonely fire: raises $1.75 to $2.25
StudentRB: folds 
Kasselbanki: folds 
bountyhun31: folds 
akiobenj: calls $1.75
*** FLOP *** [9s 4s 7s]
akiobenj: bets $2.50
lonely fire: folds 
Uncalled bet ($2.50) returned to akiobenj
akiobenj collected $5.46 from pot
akiobenj: doesn't show hand 
*** SUMMARY ***
Total pot $5.75 | Rake $0.29 
Board [9s 4s 7s]
Seat 1: akiobenj collected ($5.46)
Seat 2: goldenpig666 folded before Flop (didn't bet)
Seat 3: Rulet345 folded before Flop (didn't bet)
Seat 4: lonely fire (button) folded on the Flop
Seat 5: StudentRB (small blind) folded before Flop
Seat 6: Kasselbanki (big blind) folded before Flop
Seat 8: bountyhun31 folded before Flop
Seat 9: Hunt133 folded before Flop (didn't bet)



PokerStars Hand #228684002938:  Hold'em No Limit ($0.25/$0.50 USD) - 2021/07/30 13:37:25 ET
Table 'Bok II' 9-max Seat #5 is the button
Seat 1: akiobenj ($22.19 in chips) 
Seat 2: goldenpig666 ($57.26 in chips) 
Seat 3: Rulet345 ($50 in chips) 
Seat 4: lonely fire ($50 in chips) 
Seat 5: StudentRB ($58.95 in chips) 
Seat 6: Kasselbanki ($33.70 in chips) 
Seat 7: Mmago24 ($51.50 in chips) 
Seat 8: bountyhun31 ($51.13 in chips) 
Seat 9: Hunt133 ($64.84 in chips) 
Kasselbanki: posts small blind $0.25
Mmago24: posts big blind $0.50
*** HOLE CARDS ***
bountyhun31: folds 
Hunt133: folds 
akiobenj: folds 
goldenpig666: folds 
Rulet345: folds 
lonely fire: raises $1 to $1.50
StudentRB: folds 
Kasselbanki: folds 
Mmago24: folds 
Uncalled bet ($1) returned to lonely fire
lonely fire collected $1.25 from pot
lonely fire: doesn't show hand 
*** SUMMARY ***
Total pot $1.25 | Rake $0 
Seat 1: akiobenj folded before Flop (didn't bet)
Seat 2: goldenpig666 folded before Flop (didn't bet)
Seat 3: Rulet345 folded before Flop (didn't bet)
Seat 4: lonely fire collected ($1.25)
Seat 5: StudentRB (button) folded before Flop (didn't bet)
Seat 6: Kasselbanki (small blind) folded before Flop
Seat 7: Mmago24 (big blind) folded before Flop
Seat 8: bountyhun31 folded before Flop (didn't bet)
Seat 9: Hunt133 folded before Flop (didn't bet)



PokerStars Hand #228684011915:  Hold'em No Limit ($0.25/$0.50 USD) - 2021/07/30 13:37:47 ET
Table 'Bok II' 9-max Seat #6 is the button
Seat 1: akiobenj ($22.19 in chips) 
Seat 2: goldenpig666 ($57.26 in chips) 
Seat 3: Rulet345 ($50 in chips) 
Seat 4: lonely fire ($50.75 in chips) 
Seat 5: StudentRB ($58.95 in chips) 
Seat 6: Kasselbanki ($33.45 in chips) 
Seat 7: Mmago24 ($51 in chips) 
Seat 8: bountyhun31 ($51.13 in chips) 
Seat 9: Hunt133 ($64.84 in chips) 
Mmago24: posts small blind $0.25
bountyhun31: posts big blind $0.50
*** HOLE CARDS ***
Hunt133: folds 
bountyhun31 is disconnected 
akiobenj: calls $0.50
goldenpig666: folds 
Rulet345: folds 
lonely fire: folds 
StudentRB: raises $2 to $2.50
Kasselbanki: folds 
Mmago24: folds 
bountyhun31: folds 
akiobenj: calls $2
*** FLOP *** [3h Qs 3c]
akiobenj: checks 
StudentRB: bets $1.80
akiobenj: raises $1.80 to $3.60
StudentRB: folds 
Uncalled bet ($1.80) returned to akiobenj
akiobenj collected $8.88 from pot
akiobenj: doesn't show hand 
*** SUMMARY ***
Total pot $9.35 | Rake $0.47 
Board [3h Qs 3c]
Seat 1: akiobenj collected ($8.88)
Seat 2: goldenpig666 folded before Flop (didn't bet)
Seat 3: Rulet345 folded before Flop (didn't bet)
Seat 4: lonely fire folded before Flop (didn't bet)
Seat 5: StudentRB folded on the Flop
Seat 6: Kasselbanki (button) folded before Flop (didn't bet)
Seat 7: Mmago24 (small blind) folded before Flop
Seat 8: bountyhun31 (big blind) folded before Flop
Seat 9: Hunt133 folded before Flop (didn't bet)



PokerStars Hand #228684026133:  Hold'em No Limit ($0.25/$0.50 USD) - 2021/07/30 13:38:20 ET
Table 'Bok II' 9-max Seat #7 is the button
Seat 1: akiobenj ($26.77 in chips) 
Seat 2: goldenpig666 ($57.26 in chips) 
Seat 3: Rulet345 ($50 in chips) 
Seat 4: lonely fire ($50.75 in chips) 
Seat 5: StudentRB ($54.65 in chips) 
Seat 6: Kasselbanki ($33.45 in chips) 
Seat 7: Mmago24 ($50.75 in chips) 
Seat 8: bountyhun31 ($50.63 in chips) 
Seat 9: Hunt133 ($64.84 in chips) 
bountyhun31: posts small blind $0.25
Hunt133: posts big blind $0.50
*** HOLE CARDS ***
akiobenj: folds 
goldenpig666: folds 
Rulet345: raises $1 to $1.50
lonely fire: folds 
StudentRB: folds 
Kasselbanki: folds 
Mmago24: folds 
bountyhun31: calls $1.25
Hunt133: folds 
*** FLOP *** [7s As Ac]
bountyhun31: checks 
Rulet345: bets $1.10
bountyhun31: calls $1.10
*** TURN *** [7s As Ac] [Jh]
bountyhun31: checks 
Rulet345: checks 
*** RIVER *** [7s As Ac Jh] [Td]
bountyhun31: bets $5.42
Rulet345: calls $5.42
*** SHOW DOWN ***
bountyhun31: shows [Ad Kh] (three of a kind, Aces)
Rulet345: mucks hand 
bountyhun31 collected $15.71 from pot
*** SUMMARY ***
Total pot $16.54 | Rake $0.83 
Board [7s As Ac Jh Td]
Seat 1: akiobenj folded before Flop (didn't bet)
Seat 2: goldenpig666 folded before Flop (didn't bet)
Seat 3: Rulet345 mucked
Seat 4: lonely fire folded before Flop (didn't bet)
Seat 5: StudentRB folded before Flop (didn't bet)
Seat 6: Kasselbanki folded before Flop (didn't bet)
Seat 7: Mmago24 (button) folded before Flop (didn't bet)
Seat 8: bountyhun31 (small blind) showed [Ad Kh] and won ($15.71) with three of a kind, Aces
Seat 9: Hunt133 (big blind) folded before Flop



PokerStars Hand #228684046938:  Hold'em No Limit ($0.25/$0.50 USD) - 2021/07/30 13:39:10 ET
Table 'Bok II' 9-max Seat #8 is the button
Seat 1: akiobenj ($26.77 in chips) 
Seat 2: goldenpig666 ($57.26 in chips) 
Seat 3: Rulet345 ($50 in chips) 
Seat 4: lonely fire ($50.75 in chips) 
Seat 5: StudentRB ($54.65 in chips) 
Seat 6: Kasselbanki ($33.45 in chips) 
Seat 7: Mmago24 ($50.75 in chips) 
Seat 8: bountyhun31 ($58.32 in chips) 
Seat 9: Hunt133 ($64.34 in chips) 
Hunt133: posts small blind $0.25
akiobenj: posts big blind $0.50
*** HOLE CARDS ***
goldenpig666: folds 
Rulet345: folds 
lonely fire: folds 
StudentRB: folds 
Kasselbanki: raises $1 to $1.50
Mmago24: folds 
bountyhun31: calls $1.50
Hunt133: folds 
akiobenj: calls $1
*** FLOP *** [9h 6s 7c]
akiobenj: checks 
Kasselbanki: bets $1.50
bountyhun31: calls $1.50
akiobenj: calls $1.50
*** TURN *** [9h 6s 7c] [Td]
akiobenj: checks 
Kasselbanki: checks 
bountyhun31: checks 
*** RIVER *** [9h 6s 7c Td] [3s]
akiobenj: checks 
Kasselbanki: checks 
bountyhun31: checks 
*** SHOW DOWN ***
akiobenj: shows [As 7s] (a pair of Sevens)
Kasselbanki: mucks hand 
bountyhun31: mucks hand 
akiobenj collected $8.79 from pot
*** SUMMARY ***
Total pot $9.25 | Rake $0.46 
Board [9h 6s 7c Td 3s]
Seat 1: akiobenj (big blind) showed [As 7s] and won ($8.79) with a pair of Sevens
Seat 2: goldenpig666 folded before Flop (didn't bet)
Seat 3: Rulet345 folded before Flop (didn't bet)
Seat 4: lonely fire folded before Flop (didn't bet)
Seat 5: StudentRB folded before Flop (didn't bet)
Seat 6: Kasselbanki mucked
Seat 7: Mmago24 folded before Flop (didn't bet)
Seat 8: bountyhun31 (button) mucked
Seat 9: Hunt133 (small blind) folded before Flop



PokerStars Hand #228684067731:  Hold'em No Limit ($0.25/$0.50 USD) - 2021/07/30 13:39:59 ET
Table 'Bok II' 9-max Seat #9 is the button
Seat 1: akiobenj ($32.56 in chips) 
Seat 2: goldenpig666 ($57.26 in chips) 
Seat 3: Rulet345 ($50 in chips) 
Seat 4: lonely fire ($50.75 in chips) 
Seat 5: StudentRB ($54.65 in chips) 
Seat 6: Kasselbanki ($30.45 in chips) 
Seat 7: Mmago24 ($50.75 in chips) 
Seat 8: bountyhun31 ($55.32 in chips) 
Seat 9: Hunt133 ($64.09 in chips) 
akiobenj: posts small blind $0.25
goldenpig666: posts big blind $0.50
*** HOLE CARDS ***
Rulet345: folds 
lonely fire: folds 
StudentRB: raises $0.75 to $1.25
Kasselbanki: calls $1.25
Mmago24: folds 
bountyhun31: calls $1.25
Hunt133: folds 
akiobenj: folds 
goldenpig666: folds 
*** FLOP *** [2d 9s 2c]
StudentRB: bets $1.41
Kasselbanki: calls $1.41
bountyhun31: folds 
*** TURN *** [2d 9s 2c] [6d]
StudentRB: checks 
Kasselbanki: bets $3
StudentRB: calls $3
*** RIVER *** [2d 9s 2c 6d] [2h]
StudentRB: checks 
Kasselbanki: checks 
*** SHOW DOWN ***
StudentRB: shows [6c Ac] (a full house, Deuces full of Sixes)
Kasselbanki: mucks hand 
StudentRB collected $12.65 from pot
*** SUMMARY ***
Total pot $13.32 | Rake $0.67 
Board [2d 9s 2c 6d 2h]
Seat 1: akiobenj (small blind) folded before Flop
Seat 2: goldenpig666 (big blind) folded before Flop
Seat 3: Rulet345 folded before Flop (didn't bet)
Seat 4: lonely fire folded before Flop (didn't bet)
Seat 5: StudentRB showed [6c Ac] and won ($12.65) with a full house, Deuces full of Sixes
Seat 6: Kasselbanki mucked
Seat 7: Mmago24 folded before Flop (didn't bet)
Seat 8: bountyhun31 folded on the Flop
Seat 9: Hunt133 (button) folded before Flop (didn't bet)



PokerStars Hand #228684094394:  Hold'em No Limit ($0.25/$0.50 USD) - 2021/07/30 13:41:03 ET
Table 'Bok II' 9-max Seat #1 is the button
Seat 1: akiobenj ($32.31 in chips) 
Seat 2: goldenpig666 ($56.76 in chips) 
Seat 3: Rulet345 ($50 in chips) 
Seat 4: lonely fire ($50.75 in chips) 
Seat 5: StudentRB ($61.64 in chips) 
Seat 6: Kasselbanki ($24.79 in chips) 
Seat 7: Mmago24 ($50.75 in chips) 
Seat 8: bountyhun31 ($54.07 in chips) 
Seat 9: Hunt133 ($64.09 in chips) 
goldenpig666: posts small blind $0.25
Rulet345: posts big blind $0.50
*** HOLE CARDS ***
lonely fire: folds 
StudentRB: folds 
Kasselbanki: folds 
Mmago24: folds 
bountyhun31: folds 
Hunt133: folds 
akiobenj: folds 
goldenpig666: raises $1 to $1.50
Rulet345: calls $1
*** FLOP *** [6c Jh Ah]
goldenpig666: bets $1
Rulet345: folds 
Uncalled bet ($1) returned to goldenpig666
goldenpig666 collected $2.81 from pot
goldenpig666: doesn't show hand 
*** SUMMARY ***
Total pot $3 | Rake $0.19 
Board [6c Jh Ah]
Seat 1: akiobenj (button) folded before Flop (didn't bet)
Seat 2: goldenpig666 (small blind) collected ($2.81)
Seat 3: Rulet345 (big blind) folded on the Flop
Seat 4: lonely fire folded before Flop (didn't bet)
Seat 5: StudentRB folded before Flop (didn't bet)
Seat 6: Kasselbanki folded before Flop (didn't bet)
Seat 7: Mmago24 folded before Flop (didn't bet)
Seat 8: bountyhun31 folded before Flop (didn't bet)
Seat 9: Hunt133 folded before Flop (didn't bet)



PokerStars Hand #228684108909:  Hold'em No Limit ($0.25/$0.50 USD) - 2021/07/30 13:41:37 ET
Table 'Bok II' 9-max Seat #2 is the button
Seat 1: akiobenj ($32.31 in chips) 
Seat 2: goldenpig666 ($58.07 in chips) 
Seat 3: Rulet345 ($50 in chips) 
Seat 4: lonely fire ($50.75 in chips) 
Seat 5: StudentRB ($61.64 in chips) 
Seat 6: Kasselbanki ($24.79 in chips) 
Seat 7: Mmago24 ($50.75 in chips) 
Seat 8: bountyhun31 ($54.07 in chips) 
Seat 9: Hunt133 ($64.09 in chips) 
Rulet345: posts small blind $0.25
lonely fire: posts big blind $0.50
*** HOLE CARDS ***
StudentRB: raises $0.75 to $1.25
Kasselbanki has timed out
Kasselbanki: folds 
Mmago24: folds 
bountyhun31: folds 
Hunt133: folds 
akiobenj: folds 
goldenpig666: folds 
Rulet345: folds 
lonely fire: folds 
Uncalled bet ($0.75) returned to StudentRB
StudentRB collected $1.25 from pot
StudentRB: doesn't show hand 
*** SUMMARY ***
Total pot $1.25 | Rake $0 
Seat 1: akiobenj folded before Flop (didn't bet)
Seat 2: goldenpig666 (button) folded before Flop (didn't bet)
Seat 3: Rulet345 (small blind) folded before Flop
Seat 4: lonely fire (big blind) folded before Flop
Seat 5: StudentRB collected ($1.25)
Seat 6: Kasselbanki folded before Flop (didn't bet)
Seat 7: Mmago24 folded before Flop (didn't bet)
Seat 8: bountyhun31 folded before Flop (didn't bet)
Seat 9: Hunt133 folded before Flop (didn't bet)



PokerStars Hand #228684119646:  Hold'em No Limit ($0.25/$0.50 USD) - 2021/07/30 13:42:03 ET
Table 'Bok II' 9-max Seat #3 is the button
Seat 1: akiobenj ($32.31 in chips) 
Seat 2: goldenpig666 ($58.07 in chips) 
Seat 3: Rulet345 ($50 in chips) 
Seat 4: lonely fire ($50.25 in chips) 
Seat 5: StudentRB ($62.39 in chips) 
Seat 7: Mmago24 ($50.75 in chips) 
Seat 8: bountyhun31 ($54.07 in chips) 
Seat 9: Hunt133 ($64.09 in chips) 
lonely fire: posts small blind $0.25
StudentRB: posts big blind $0.50
*** HOLE CARDS ***
Mmago24: folds 
bountyhun31: folds 
Hunt133: folds 
akiobenj: calls $0.50
goldenpig666: folds 
Rulet345: folds 
lonely fire: folds 
StudentRB: raises $2 to $2.50
akiobenj: calls $2
*** FLOP *** [Kh 6c Qd]
StudentRB: bets $1.65
akiobenj: calls $1.65
*** TURN *** [Kh 6c Qd] [6s]
StudentRB: checks 
akiobenj: bets $8.12
StudentRB: folds 
Uncalled bet ($8.12) returned to akiobenj
akiobenj collected $8.12 from pot
akiobenj: doesn't show hand 
*** SUMMARY ***
Total pot $8.55 | Rake $0.43 
Board [Kh 6c Qd 6s]
Seat 1: akiobenj collected ($8.12)
Seat 2: goldenpig666 folded before Flop (didn't bet)
Seat 3: Rulet345 (button) folded before Flop (didn't bet)
Seat 4: lonely fire (small blind) folded before Flop
Seat 5: StudentRB (big blind) folded on the Turn
Seat 7: Mmago24 folded before Flop (didn't bet)
Seat 8: bountyhun31 folded before Flop (didn't bet)
Seat 9: Hunt133 folded before Flop (didn't bet)



PokerStars Hand #228684136361:  Hold'em No Limit ($0.25/$0.50 USD) - 2021/07/30 13:42:43 ET
Table 'Bok II' 9-max Seat #4 is the button
Seat 1: akiobenj ($36.28 in chips) 
Seat 2: goldenpig666 ($58.07 in chips) 
Seat 3: Rulet345 ($50 in chips) 
Seat 4: lonely fire ($50 in chips) 
Seat 5: StudentRB ($58.24 in chips) 
Seat 7: Mmago24 ($50.75 in chips) 
Seat 8: bountyhun31 ($54.07 in chips) 
Seat 9: Hunt133 ($64.09 in chips) 
StudentRB: posts small blind $0.25
Mmago24: posts big blind $0.50
*** HOLE CARDS ***
bountyhun31: calls $0.50
Hunt133: folds 
akiobenj: folds 
goldenpig666: folds 
Rulet345: folds 
lonely fire: folds 
StudentRB: calls $0.25
Mmago24: checks 
*** FLOP *** [5d 2h 4d]
StudentRB: checks 
Mmago24: checks 
bountyhun31: bets $1
StudentRB: folds 
Mmago24: folds 
Uncalled bet ($1) returned to bountyhun31
bountyhun31 collected $1.42 from pot
bountyhun31: doesn't show hand 
*** SUMMARY ***
Total pot $1.50 | Rake $0.08 
Board [5d 2h 4d]
Seat 1: akiobenj folded before Flop (didn't bet)
Seat 2: goldenpig666 folded before Flop (didn't bet)
Seat 3: Rulet345 folded before Flop (didn't bet)
Seat 4: lonely fire (button) folded before Flop (didn't bet)
Seat 5: StudentRB (small blind) folded on the Flop
Seat 7: Mmago24 (big blind) folded on the Flop
Seat 8: bountyhun31 collected ($1.42)
Seat 9: Hunt133 folded before Flop (didn't bet)



PokerStars Hand #228684150464:  Hold'em No Limit ($0.25/$0.50 USD) - 2021/07/30 13:43:16 ET
Table 'Bok II' 9-max Seat #5 is the button
Seat 1: akiobenj ($36.28 in chips) 
Seat 2: goldenpig666 ($58.07 in chips) 
Seat 3: Rulet345 ($50 in chips) 
Seat 4: lonely fire ($50 in chips) 
Seat 5: StudentRB ($57.74 in chips) 
Seat 7: Mmago24 ($50.25 in chips) 
Seat 8: bountyhun31 ($54.99 in chips) 
Seat 9: Hunt133 ($64.09 in chips) 
Mmago24: posts small blind $0.25
bountyhun31: posts big blind $0.50
*** HOLE CARDS ***
Hunt133: folds 
akiobenj: folds 
goldenpig666: folds 
Rulet345: folds 
lonely fire: folds 
StudentRB: raises $0.75 to $1.25
Mmago24: folds 
bountyhun31: folds 
Uncalled bet ($0.75) returned to StudentRB
StudentRB collected $1.25 from pot
StudentRB: doesn't show hand 
*** SUMMARY ***
Total pot $1.25 | Rake $0 
Seat 1: akiobenj folded before Flop (didn't bet)
Seat 2: goldenpig666 folded before Flop (didn't bet)
Seat 3: Rulet345 folded before Flop (didn't bet)
Seat 4: lonely fire folded before Flop (didn't bet)
Seat 5: StudentRB (button) collected ($1.25)
Seat 7: Mmago24 (small blind) folded before Flop
Seat 8: bountyhun31 (big blind) folded before Flop
Seat 9: Hunt133 folded before Flop (didn't bet)



PokerStars Hand #228684155284:  Hold'em No Limit ($0.25/$0.50 USD) - 2021/07/30 13:43:27 ET
Table 'Bok II' 9-max Seat #7 is the button
Seat 1: akiobenj ($36.28 in chips) 
Seat 2: goldenpig666 ($58.07 in chips) 
Seat 3: Rulet345 ($50 in chips) 
Seat 4: lonely fire ($50 in chips) 
Seat 5: StudentRB ($58.49 in chips) 
Seat 6: Kasselbanki ($24.79 in chips) 
Seat 7: Mmago24 ($50 in chips) 
Seat 8: bountyhun31 ($54.49 in chips) 
Seat 9: Hunt133 ($64.09 in chips) 
bountyhun31: posts small blind $0.25
Hunt133: posts big blind $0.50
Kasselbanki: posts small & big blinds $0.75
*** HOLE CARDS ***
akiobenj: folds 
goldenpig666: folds 
Rulet345: folds 
lonely fire: folds 
StudentRB: folds 
Kasselbanki: checks 
Mmago24: folds 
bountyhun31: folds 
Hunt133: checks 
*** FLOP *** [Js 7s 8d]
Hunt133: checks 
Kasselbanki: bets $1
Hunt133: folds 
Uncalled bet ($1) returned to Kasselbanki
Kasselbanki collected $1.40 from pot
Kasselbanki: doesn't show hand 
*** SUMMARY ***
Total pot $1.50 | Rake $0.10 
Board [Js 7s 8d]
Seat 1: akiobenj folded before Flop (didn't bet)
Seat 2: goldenpig666 folded before Flop (didn't bet)
Seat 3: Rulet345 folded before Flop (didn't bet)
Seat 4: lonely fire folded before Flop (didn't bet)
Seat 5: StudentRB folded before Flop (didn't bet)
Seat 6: Kasselbanki collected ($1.40)
Seat 7: Mmago24 (button) folded before Flop (didn't bet)
Seat 8: bountyhun31 (small blind) folded before Flop
Seat 9: Hunt133 (big blind) folded on the Flop



PokerStars Hand #228684169046:  Hold'em No Limit ($0.25/$0.50 USD) - 2021/07/30 13:44:00 ET
Table 'Bok II' 9-max Seat #8 is the button
Seat 1: akiobenj ($36.28 in chips) 
Seat 2: goldenpig666 ($58.07 in chips) 
Seat 3: Rulet345 ($50 in chips) 
Seat 4: lonely fire ($50 in chips) 
Seat 5: StudentRB ($58.49 in chips) 
Seat 6: Kasselbanki ($25.44 in chips) 
Seat 7: Mmago24 ($50 in chips) 
Seat 8: bountyhun31 ($54.24 in chips) 
Seat 9: Hunt133 ($63.59 in chips) 
Hunt133: posts small blind $0.25
akiobenj: posts big blind $0.50
*** HOLE CARDS ***
goldenpig666: folds 
Rulet345: folds 
lonely fire: folds 
StudentRB: folds 
Kasselbanki: folds 
Mmago24: raises $0.72 to $1.22
bountyhun31: folds 
Hunt133: raises $3.55 to $4.77
akiobenj: folds 
Mmago24: folds 
Uncalled bet ($3.55) returned to Hunt133
Hunt133 collected $2.94 from pot
*** SUMMARY ***
Total pot $2.94 | Rake $0 
Seat 1: akiobenj (big blind) folded before Flop
Seat 2: goldenpig666 folded before Flop (didn't bet)
Seat 3: Rulet345 folded before Flop (didn't bet)
Seat 4: lonely fire folded before Flop (didn't bet)
Seat 5: StudentRB folded before Flop (didn't bet)
Seat 6: Kasselbanki folded before Flop (didn't bet)
Seat 7: Mmago24 folded before Flop
Seat 8: bountyhun31 (button) folded before Flop (didn't bet)
Seat 9: Hunt133 (small blind) collected ($2.94)



PokerStars Hand #228684179767:  Hold'em No Limit ($0.25/$0.50 USD) - 2021/07/30 13:44:25 ET
Table 'Bok II' 9-max Seat #9 is the button
Seat 1: akiobenj ($35.78 in chips) 
Seat 2: goldenpig666 ($58.07 in chips) 
Seat 3: Rulet345 ($50 in chips) 
Seat 4: lonely fire ($50 in chips) 
Seat 5: StudentRB ($58.49 in chips) 
Seat 6: Kasselbanki ($25.44 in chips) 
Seat 7: Mmago24 ($50 in chips) 
Seat 8: bountyhun31 ($54.24 in chips) 
Seat 9: Hunt133 ($65.31 in chips) 
akiobenj: posts small blind $0.25
goldenpig666: posts big blind $0.50
*** HOLE CARDS ***
Rulet345: folds 
lonely fire: folds 
StudentRB: folds 
Kasselbanki: folds 
Mmago24: folds 
bountyhun31: folds 
Hunt133: folds 
akiobenj: calls $0.25
goldenpig666: checks 
*** FLOP *** [6c 7h Jc]
akiobenj: checks 
goldenpig666: bets $0.50
akiobenj: calls $0.50
*** TURN *** [6c 7h Jc] [5c]
akiobenj: checks 
goldenpig666: checks 
*** RIVER *** [6c 7h Jc 5c] [8c]
akiobenj: checks 
goldenpig666: checks 
*** SHOW DOWN ***
akiobenj: shows [Ks Qs] (high card King)
goldenpig666: shows [8d Ah] (a pair of Eights)
goldenpig666 collected $1.88 from pot
*** SUMMARY ***
Total pot $2 | Rake $0.12 
Board [6c 7h Jc 5c 8c]
Seat 1: akiobenj (small blind) showed [Ks Qs] and lost with high card King
Seat 2: goldenpig666 (big blind) showed [8d Ah] and won ($1.88) with a pair of Eights
Seat 3: Rulet345 folded before Flop (didn't bet)
Seat 4: lonely fire folded before Flop (didn't bet)
Seat 5: StudentRB folded before Flop (didn't bet)
Seat 6: Kasselbanki folded before Flop (didn't bet)
Seat 7: Mmago24 folded before Flop (didn't bet)
Seat 8: bountyhun31 folded before Flop (didn't bet)
Seat 9: Hunt133 (button) folded before Flop (didn't bet)



PokerStars Hand #228684196771:  Hold'em No Limit ($0.25/$0.50 USD) - 2021/07/30 13:45:05 ET
Table 'Bok II' 9-max Seat #1 is the button
Seat 1: akiobenj ($34.78 in chips) 
Seat 2: goldenpig666 ($58.95 in chips) 
Seat 3: Rulet345 ($50 in chips) 
Seat 4: lonely fire ($50 in chips) 
Seat 5: StudentRB ($58.49 in chips) 
Seat 6: Kasselbanki ($25.44 in chips) 
Seat 7: Mmago24 ($50 in chips) 
Seat 8: bountyhun31 ($54.24 in chips) 
Seat 9: Hunt133 ($65.31 in chips) 
goldenpig666: posts small blind $0.25
Rulet345: posts big blind $0.50
*** HOLE CARDS ***
lonely fire: folds 
StudentRB: folds 
Kasselbanki: folds 
Mmago24: folds 
bountyhun31: calls $0.50
Hunt133: folds 
akiobenj: folds 
goldenpig666: folds 
Rulet345: checks 
*** FLOP *** [7d 2d Ts]
Rulet345: checks 
bountyhun31: checks 
*** TURN *** [7d 2d Ts] [As]
Rulet345: checks 
bountyhun31: bets $0.50
Rulet345: calls $0.50
*** RIVER *** [7d 2d Ts As] [Js]
Rulet345: checks 
bountyhun31: checks 
*** SHOW DOWN ***
Rulet345: shows [4d 7h] (a pair of Sevens)
bountyhun31: shows [Ac 5h] (a pair of Aces)
bountyhun31 collected $2.14 from pot
*** SUMMARY ***
Total pot $2.25 | Rake $0.11 
Board [7d 2d Ts As Js]
Seat 1: akiobenj (button) folded before Flop (didn't bet)
Seat 2: goldenpig666 (small blind) folded before Flop
Seat 3: Rulet345 (big blind) showed [4d 7h] and lost with a pair of Sevens
Seat 4: lonely fire folded before Flop (didn't bet)
Seat 5: StudentRB folded before Flop (didn't bet)
Seat 6: Kasselbanki folded before Flop (didn't bet)
Seat 7: Mmago24 folded before Flop (didn't bet)
Seat 8: bountyhun31 showed [Ac 5h] and won ($2.14) with a pair of Aces
Seat 9: Hunt133 folded before Flop (didn't bet)



PokerStars Hand #228684223316:  Hold'em No Limit ($0.25/$0.50 USD) - 2021/07/30 13:46:09 ET
Table 'Bok II' 9-max Seat #2 is the button
Seat 1: akiobenj ($34.78 in chips) 
Seat 2: goldenpig666 ($58.70 in chips) 
Seat 3: Rulet345 ($50 in chips) 
Seat 4: lonely fire ($50 in chips) 
Seat 5: StudentRB ($58.49 in chips) 
Seat 6: Kasselbanki ($25.44 in chips) 
Seat 7: Mmago24 ($50 in chips) 
Seat 8: bountyhun31 ($55.38 in chips) 
Seat 9: Hunt133 ($65.31 in chips) 
Rulet345: posts small blind $0.25
lonely fire: posts big blind $0.50
*** HOLE CARDS ***
StudentRB: folds 
Kasselbanki: folds 
Mmago24: raises $0.72 to $1.22
bountyhun31: folds 
Hunt133: folds 
akiobenj: calls $1.22
goldenpig666: folds 
Rulet345: raises $5.28 to $6.50
lonely fire: folds 
Mmago24: folds 
akiobenj: folds 
Uncalled bet ($5.28) returned to Rulet345
Rulet345 collected $4.16 from pot
Rulet345: doesn't show hand 
*** SUMMARY ***
Total pot $4.16 | Rake $0 
Seat 1: akiobenj folded before Flop
Seat 2: goldenpig666 (button) folded before Flop (didn't bet)
Seat 3: Rulet345 (small blind) collected ($4.16)
Seat 4: lonely fire (big blind) folded before Flop
Seat 5: StudentRB folded before Flop (didn't bet)
Seat 6: Kasselbanki folded before Flop (didn't bet)
Seat 7: Mmago24 folded before Flop
Seat 8: bountyhun31 folded before Flop (didn't bet)
Seat 9: Hunt133 folded before Flop (didn't bet)



PokerStars Hand #228684240799:  Hold'em No Limit ($0.25/$0.50 USD) - 2021/07/30 13:46:50 ET
Table 'Bok II' 9-max Seat #3 is the button
Seat 1: akiobenj ($33.56 in chips) 
Seat 2: goldenpig666 ($58.70 in chips) 
Seat 3: Rulet345 ($52.94 in chips) 
Seat 4: lonely fire ($50 in chips) 
Seat 5: StudentRB ($58.49 in chips) 
Seat 6: Kasselbanki ($25.44 in chips) 
Seat 7: Mmago24 ($50 in chips) 
Seat 8: bountyhun31 ($55.38 in chips) 
Seat 9: Hunt133 ($65.31 in chips) 
lonely fire: posts small blind $0.25
StudentRB: posts big blind $0.50
*** HOLE CARDS ***
Kasselbanki: folds 
Mmago24: folds 
bountyhun31: calls $0.50
Hunt133: folds 
akiobenj: folds 
goldenpig666: folds 
Rulet345: folds 
lonely fire: calls $0.25
StudentRB: checks 
*** FLOP *** [8c 7s Kd]
lonely fire: bets $0.71
StudentRB: folds 
bountyhun31: calls $0.71
*** TURN *** [8c 7s Kd] [5s]
lonely fire: bets $2
bountyhun31: calls $2
*** RIVER *** [8c 7s Kd 5s] [Ad]
lonely fire: bets $1
bountyhun31: folds 
Uncalled bet ($1) returned to lonely fire
lonely fire collected $6.57 from pot
lonely fire: doesn't show hand 
*** SUMMARY ***
Total pot $6.92 | Rake $0.35 
Board [8c 7s Kd 5s Ad]
Seat 1: akiobenj folded before Flop (didn't bet)
Seat 2: goldenpig666 folded before Flop (didn't bet)
Seat 3: Rulet345 (button) folded before Flop (didn't bet)
Seat 4: lonely fire (small blind) collected ($6.57)
Seat 5: StudentRB (big blind) folded on the Flop
Seat 6: Kasselbanki folded before Flop (didn't bet)
Seat 7: Mmago24 folded before Flop (didn't bet)
Seat 8: bountyhun31 folded on the River
Seat 9: Hunt133 folded before Flop (didn't bet)



PokerStars Hand #228684255815:  Hold'em No Limit ($0.25/$0.50 USD) - 2021/07/30 13:47:26 ET
Table 'Bok II' 9-max Seat #4 is the button
Seat 1: akiobenj ($33.56 in chips) 
Seat 2: goldenpig666 ($58.70 in chips) 
Seat 3: Rulet345 ($52.94 in chips) 
Seat 4: lonely fire ($53.36 in chips) 
Seat 5: StudentRB ($57.99 in chips) 
Seat 6: Kasselbanki ($25.44 in chips) 
Seat 7: Mmago24 ($50 in chips) 
Seat 8: bountyhun31 ($52.17 in chips) 
Seat 9: Hunt133 ($65.31 in chips) 
StudentRB: posts small blind $0.25
Kasselbanki: posts big blind $0.50
*** HOLE CARDS ***
Mmago24: folds 
bountyhun31: folds 
Hunt133: folds 
akiobenj: calls $0.50
goldenpig666: folds 
Rulet345: folds 
lonely fire: folds 
StudentRB: folds 
Kasselbanki: raises $1 to $1.50
akiobenj: calls $1
*** FLOP *** [2s 5s 7d]
Kasselbanki: checks 
akiobenj: checks 
*** TURN *** [2s 5s 7d] [3d]
Hunt133 is disconnected 
Kasselbanki: bets $1.50
akiobenj: folds 
Uncalled bet ($1.50) returned to Kasselbanki
Kasselbanki collected $3.05 from pot
Kasselbanki: doesn't show hand 
*** SUMMARY ***
Total pot $3.25 | Rake $0.20 
Board [2s 5s 7d 3d]
Seat 1: akiobenj folded on the Turn
Seat 2: goldenpig666 folded before Flop (didn't bet)
Seat 3: Rulet345 folded before Flop (didn't bet)
Seat 4: lonely fire (button) folded before Flop (didn't bet)
Seat 5: StudentRB (small blind) folded before Flop
Seat 6: Kasselbanki (big blind) collected ($3.05)
Seat 7: Mmago24 folded before Flop (didn't bet)
Seat 8: bountyhun31 folded before Flop (didn't bet)
Seat 9: Hunt133 folded before Flop (didn't bet)



PokerStars Hand #228684268781:  Hold'em No Limit ($0.25/$0.50 USD) - 2021/07/30 13:47:58 ET
Table 'Bok II' 9-max Seat #5 is the button
Seat 1: akiobenj ($32.06 in chips) 
Seat 2: goldenpig666 ($58.70 in chips) 
Seat 3: Rulet345 ($52.94 in chips) 
Seat 4: lonely fire ($53.36 in chips) 
Seat 5: StudentRB ($57.74 in chips) 
Seat 6: Kasselbanki ($26.99 in chips) 
Seat 7: Mmago24 ($50 in chips) 
Seat 8: bountyhun31 ($52.17 in chips) 
Seat 9: Hunt133 ($65.31 in chips) 
Kasselbanki: posts small blind $0.25
Mmago24: posts big blind $0.50
*** HOLE CARDS ***
bountyhun31: calls $0.50
Hunt133 has timed out while disconnected
Hunt133: folds 
akiobenj: raises $1 to $1.50
goldenpig666: folds 
Rulet345: folds 
lonely fire: folds 
StudentRB: folds 
Kasselbanki: folds 
Mmago24: calls $1
bountyhun31: calls $1
*** FLOP *** [3d 8c 9h]
Mmago24: checks 
bountyhun31: checks 
akiobenj: bets $4.51
Mmago24: folds 
bountyhun31: folds 
Uncalled bet ($4.51) returned to akiobenj
akiobenj collected $4.51 from pot
akiobenj: doesn't show hand 
*** SUMMARY ***
Total pot $4.75 | Rake $0.24 
Board [3d 8c 9h]
Seat 1: akiobenj collected ($4.51)
Seat 2: goldenpig666 folded before Flop (didn't bet)
Seat 3: Rulet345 folded before Flop (didn't bet)
Seat 4: lonely fire folded before Flop (didn't bet)
Seat 5: StudentRB (button) folded before Flop (didn't bet)
Seat 6: Kasselbanki (small blind) folded before Flop
Seat 7: Mmago24 (big blind) folded on the Flop
Seat 8: bountyhun31 folded on the Flop
Seat 9: Hunt133 folded before Flop (didn't bet)



PokerStars Hand #228684289338:  Hold'em No Limit ($0.25/$0.50 USD) - 2021/07/30 13:48:46 ET
Table 'Bok II' 9-max Seat #6 is the button
Seat 1: akiobenj ($35.07 in chips) 
Seat 2: goldenpig666 ($58.70 in chips) 
Seat 3: Rulet345 ($52.94 in chips) 
Seat 4: lonely fire ($53.36 in chips) 
Seat 5: StudentRB ($57.74 in chips) 
Seat 6: Kasselbanki ($26.74 in chips) 
Seat 7: Mmago24 ($50 in chips) 
Seat 8: bountyhun31 ($50.67 in chips) 
Mmago24: posts small blind $0.25
bountyhun31: posts big blind $0.50
*** HOLE CARDS ***
akiobenj: folds 
goldenpig666: folds 
Rulet345: folds 
lonely fire: folds 
StudentRB: raises $0.75 to $1.25
Kasselbanki: folds 
Mmago24: folds 
bountyhun31: calls $0.75
*** FLOP *** [4h 7d 8d]
bountyhun31: checks 
StudentRB: checks 
*** TURN *** [4h 7d 8d] [Qd]
bountyhun31: checks 
StudentRB: checks 
*** RIVER *** [4h 7d 8d Qd] [Th]
bountyhun31: bets $0.50
StudentRB: folds 
Uncalled bet ($0.50) returned to bountyhun31
bountyhun31 collected $2.61 from pot
bountyhun31: doesn't show hand 
*** SUMMARY ***
Total pot $2.75 | Rake $0.14 
Board [4h 7d 8d Qd Th]
Seat 1: akiobenj folded before Flop (didn't bet)
Seat 2: goldenpig666 folded before Flop (didn't bet)
Seat 3: Rulet345 folded before Flop (didn't bet)
Seat 4: lonely fire folded before Flop (didn't bet)
Seat 5: StudentRB folded on the River
Seat 6: Kasselbanki (button) folded before Flop (didn't bet)
Seat 7: Mmago24 (small blind) folded before Flop
Seat 8: bountyhun31 (big blind) collected ($2.61)



PokerStars Hand #228684314777:  Hold'em No Limit ($0.25/$0.50 USD) - 2021/07/30 13:49:27 ET
Table 'Bok II' 9-max Seat #7 is the button
Seat 1: akiobenj ($35.07 in chips) 
Seat 2: goldenpig666 ($58.70 in chips) 
Seat 3: Rulet345 ($52.94 in chips) 
Seat 4: lonely fire ($53.36 in chips) 
Seat 5: StudentRB ($56.49 in chips) 
Seat 6: Kasselbanki ($26.74 in chips) 
Seat 7: Mmago24 ($50 in chips) 
Seat 8: bountyhun31 ($52.03 in chips) 
bountyhun31: posts small blind $0.25
akiobenj: posts big blind $0.50
*** HOLE CARDS ***
goldenpig666: folds 
Rulet345: folds 
lonely fire: folds 
StudentRB: raises $1 to $1.50
Kasselbanki: folds 
Mmago24: folds 
bountyhun31: calls $1.25
akiobenj: calls $1
*** FLOP *** [2d Jc 2s]
bountyhun31: checks 
akiobenj: checks 
StudentRB: bets $1.41
bountyhun31: folds 
akiobenj: calls $1.41
*** TURN *** [2d Jc 2s] [8h]
akiobenj: checks 
StudentRB: checks 
*** RIVER *** [2d Jc 2s 8h] [Jd]
akiobenj: bets $3.47
StudentRB: raises $10.53 to $14
akiobenj: folds 
Uncalled bet ($10.53) returned to StudentRB
StudentRB collected $13.55 from pot
StudentRB: doesn't show hand 
*** SUMMARY ***
Total pot $14.26 | Rake $0.71 
Board [2d Jc 2s 8h Jd]
Seat 1: akiobenj (big blind) folded on the River
Seat 2: goldenpig666 folded before Flop (didn't bet)
Seat 3: Rulet345 folded before Flop (didn't bet)
Seat 4: lonely fire folded before Flop (didn't bet)
Seat 5: StudentRB collected ($13.55)
Seat 6: Kasselbanki folded before Flop (didn't bet)
Seat 7: Mmago24 (button) folded before Flop (didn't bet)
Seat 8: bountyhun31 (small blind) folded on the Flop



PokerStars Hand #228684338790:  Hold'em No Limit ($0.25/$0.50 USD) - 2021/07/30 13:50:25 ET
Table 'Bok II' 9-max Seat #8 is the button
Seat 1: akiobenj ($28.69 in chips) 
Seat 2: goldenpig666 ($58.70 in chips) 
Seat 3: Rulet345 ($52.94 in chips) 
Seat 4: lonely fire ($53.36 in chips) 
Seat 5: StudentRB ($63.66 in chips) 
Seat 6: Kasselbanki ($26.74 in chips) 
Seat 7: Mmago24 ($50 in chips) 
Seat 8: bountyhun31 ($50.53 in chips) 
akiobenj: posts small blind $0.25
goldenpig666: posts big blind $0.50
*** HOLE CARDS ***
Rulet345: folds 
lonely fire: raises $1 to $1.50
StudentRB: folds 
Kasselbanki: calls $1.50
Mmago24: folds 
bountyhun31: folds 
akiobenj: raises $1 to $2.50
goldenpig666: folds 
lonely fire: calls $1
Kasselbanki: calls $1
*** FLOP *** [Js 8c Td]
akiobenj: checks 
lonely fire: checks 
Kasselbanki: checks 
*** TURN *** [Js 8c Td] [6d]
akiobenj: bets $7.60
lonely fire: folds 
Kasselbanki: folds 
Uncalled bet ($7.60) returned to akiobenj
akiobenj collected $7.60 from pot
akiobenj: doesn't show hand 
*** SUMMARY ***
Total pot $8 | Rake $0.40 
Board [Js 8c Td 6d]
Seat 1: akiobenj (small blind) collected ($7.60)
Seat 2: goldenpig666 (big blind) folded before Flop
Seat 3: Rulet345 folded before Flop (didn't bet)
Seat 4: lonely fire folded on the Turn
Seat 5: StudentRB folded before Flop (didn't bet)
Seat 6: Kasselbanki folded on the Turn
Seat 7: Mmago24 folded before Flop (didn't bet)
Seat 8: bountyhun31 (button) folded before Flop (didn't bet)



PokerStars Hand #228684355974:  Hold'em No Limit ($0.25/$0.50 USD) - 2021/07/30 13:51:06 ET
Table 'Bok II' 9-max Seat #1 is the button
Seat 1: akiobenj ($33.79 in chips) 
Seat 2: goldenpig666 ($58.20 in chips) 
Seat 3: Rulet345 ($52.94 in chips) 
Seat 4: lonely fire ($50.86 in chips) 
Seat 5: StudentRB ($63.66 in chips) 
Seat 6: Kasselbanki ($24.24 in chips) 
Seat 7: Mmago24 ($50 in chips) 
Seat 8: bountyhun31 ($50.53 in chips) 
goldenpig666: posts small blind $0.25
Rulet345: posts big blind $0.50
*** HOLE CARDS ***
lonely fire: raises $1 to $1.50
StudentRB: folds 
Kasselbanki: folds 
Mmago24: folds 
bountyhun31: folds 
akiobenj: folds 
goldenpig666: folds 
Rulet345: folds 
Uncalled bet ($1) returned to lonely fire
lonely fire collected $1.25 from pot
lonely fire: doesn't show hand 
*** SUMMARY ***
Total pot $1.25 | Rake $0 
Seat 1: akiobenj (button) folded before Flop (didn't bet)
Seat 2: goldenpig666 (small blind) folded before Flop
Seat 3: Rulet345 (big blind) folded before Flop
Seat 4: lonely fire collected ($1.25)
Seat 5: StudentRB folded before Flop (didn't bet)
Seat 6: Kasselbanki folded before Flop (didn't bet)
Seat 7: Mmago24 folded before Flop (didn't bet)
Seat 8: bountyhun31 folded before Flop (didn't bet)



PokerStars Hand #228684363822:  Hold'em No Limit ($0.25/$0.50 USD) - 2021/07/30 13:51:25 ET
Table 'Bok II' 9-max Seat #2 is the button
Seat 1: akiobenj ($33.79 in chips) 
Seat 2: goldenpig666 ($57.95 in chips) 
Seat 3: Rulet345 ($52.44 in chips) 
Seat 4: lonely fire ($51.61 in chips) 
Seat 5: StudentRB ($63.66 in chips) 
Seat 6: Kasselbanki ($24.24 in chips) 
Seat 7: Mmago24 ($50 in chips) 
Seat 8: bountyhun31 ($50.53 in chips) 
Rulet345: posts small blind $0.25
lonely fire: posts big blind $0.50
*** HOLE CARDS ***
StudentRB: folds 
Kasselbanki: folds 
Mmago24: folds 
bountyhun31: folds 
akiobenj: folds 
akiobenj leaves the table
goldenpig666: folds 
Rulet345: raises $1 to $1.50
lonely fire: calls $1
*** FLOP *** [2h 6h 3h]
Rulet345: bets $1.43
lonely fire: folds 
Uncalled bet ($1.43) returned to Rulet345
Rulet345 collected $2.85 from pot
Rulet345: doesn't show hand 
*** SUMMARY ***
Total pot $3 | Rake $0.15 
Board [2h 6h 3h]
Seat 1: akiobenj folded before Flop (didn't bet)
Seat 2: goldenpig666 (button) folded before Flop (didn't bet)
Seat 3: Rulet345 (small blind) collected ($2.85)
Seat 4: lonely fire (big blind) folded on the Flop
Seat 5: StudentRB folded before Flop (didn't bet)
Seat 6: Kasselbanki folded before Flop (didn't bet)
Seat 7: Mmago24 folded before Flop (didn't bet)
Seat 8: bountyhun31 folded before Flop (didn't bet)



PokerStars Hand #228684377797:  Hold'em No Limit ($0.25/$0.50 USD) - 2021/07/30 13:51:58 ET
Table 'Bok II' 9-max Seat #3 is the button
Seat 2: goldenpig666 ($57.95 in chips) 
Seat 3: Rulet345 ($53.79 in chips) 
Seat 4: lonely fire ($50.11 in chips) 
Seat 5: StudentRB ($63.66 in chips) 
Seat 6: Kasselbanki ($24.24 in chips) 
Seat 7: Mmago24 ($50 in chips) 
Seat 8: bountyhun31 ($50.53 in chips) 
lonely fire: posts small blind $0.25
StudentRB: posts big blind $0.50
*** HOLE CARDS ***
Kasselbanki: folds 
Mmago24: folds 
bountyhun31: folds 
goldenpig666: folds 
Rulet345: folds 
lonely fire: raises $0.75 to $1.25
PleBeY95 joins the table at seat #1 
StudentRB: calls $0.75
*** FLOP *** [8s 7c Jh]
PleBeY95 leaves the table
lonely fire: bets $1.19
StudentRB: folds 
Uncalled bet ($1.19) returned to lonely fire
lonely fire collected $2.38 from pot
lonely fire: doesn't show hand 
*** SUMMARY ***
Total pot $2.50 | Rake $0.12 
Board [8s 7c Jh]
Seat 2: goldenpig666 folded before Flop (didn't bet)
Seat 3: Rulet345 (button) folded before Flop (didn't bet)
Seat 4: lonely fire (small blind) collected ($2.38)
Seat 5: StudentRB (big blind) folded on the Flop
Seat 6: Kasselbanki folded before Flop (didn't bet)
Seat 7: Mmago24 folded before Flop (didn't bet)
Seat 8: bountyhun31 folded before Flop (didn't bet)



PokerStars Hand #228684393329:  Hold'em No Limit ($0.25/$0.50 USD) - 2021/07/30 13:52:36 ET
Table 'Bok II' 9-max Seat #4 is the button
Seat 2: goldenpig666 ($57.95 in chips) 
Seat 3: Rulet345 ($53.79 in chips) 
Seat 4: lonely fire ($51.24 in chips) 
Seat 5: StudentRB ($62.41 in chips) 
Seat 6: Kasselbanki ($24.24 in chips) 
Seat 7: Mmago24 ($50 in chips) 
Seat 8: bountyhun31 ($50.53 in chips) 
StudentRB: posts small blind $0.25
Kasselbanki: posts big blind $0.50
*** HOLE CARDS ***
Mmago24: folds 
bountyhun31: folds 
goldenpig666: folds 
Rulet345: folds 
lonely fire: folds 
StudentRB: folds 
Uncalled bet ($0.25) returned to Kasselbanki
Kasselbanki collected $0.50 from pot
Kasselbanki: doesn't show hand 
*** SUMMARY ***
Total pot $0.50 | Rake $0 
Seat 2: goldenpig666 folded before Flop (didn't bet)
Seat 3: Rulet345 folded before Flop (didn't bet)
Seat 4: lonely fire (button) folded before Flop (didn't bet)
Seat 5: StudentRB (small blind) folded before Flop
Seat 6: Kasselbanki (big blind) collected ($0.50)
Seat 7: Mmago24 folded before Flop (didn't bet)
Seat 8: bountyhun31 folded before Flop (didn't bet)



PokerStars Hand #228684402144:  Hold'em No Limit ($0.25/$0.50 USD) - 2021/07/30 13:52:57 ET
Table 'Bok II' 9-max Seat #5 is the button
Seat 2: goldenpig666 ($57.95 in chips) 
Seat 3: Rulet345 ($53.79 in chips) 
Seat 4: lonely fire ($51.24 in chips) 
Seat 5: StudentRB ($62.16 in chips) 
Seat 6: Kasselbanki ($24.49 in chips) 
Seat 7: Mmago24 ($50 in chips) 
Seat 8: bountyhun31 ($50.53 in chips) 
Kasselbanki: posts small blind $0.25
Mmago24: posts big blind $0.50
*** HOLE CARDS ***
bountyhun31: calls $0.50
goldenpig666: folds 
Rulet345: raises $1.50 to $2
lonely fire: folds 
StudentRB: folds 
Kasselbanki: folds 
Mmago24: folds 
teifthapot joins the table at seat #1 
bountyhun31: folds 
Uncalled bet ($1.50) returned to Rulet345
Rulet345 collected $1.75 from pot
Rulet345: doesn't show hand 
*** SUMMARY ***
Total pot $1.75 | Rake $0 
Seat 2: goldenpig666 folded before Flop (didn't bet)
Seat 3: Rulet345 collected ($1.75)
Seat 4: lonely fire folded before Flop (didn't bet)
Seat 5: StudentRB (button) folded before Flop (didn't bet)
Seat 6: Kasselbanki (small blind) folded before Flop
Seat 7: Mmago24 (big blind) folded before Flop
Seat 8: bountyhun31 folded before Flop



PokerStars Hand #228684413297:  Hold'em No Limit ($0.25/$0.50 USD) - 2021/07/30 13:53:24 ET
Table 'Bok II' 9-max Seat #6 is the button
Seat 2: goldenpig666 ($57.95 in chips) 
Seat 3: Rulet345 ($55.04 in chips) 
Seat 4: lonely fire ($51.24 in chips) 
Seat 5: StudentRB ($62.16 in chips) 
Seat 6: Kasselbanki ($24.24 in chips) 
Seat 7: Mmago24 ($50 in chips) 
Seat 8: bountyhun31 ($50.03 in chips) 
Mmago24: posts small blind $0.25
bountyhun31: posts big blind $0.50
teifthapot: sits out 
*** HOLE CARDS ***
goldenpig666: folds 
Rulet345: folds 
lonely fire: folds 
StudentRB: folds 
Kasselbanki: folds 
Mmago24: raises $1 to $1.50
bountyhun31: folds 
Uncalled bet ($1) returned to Mmago24
Mmago24 collected $1 from pot
Mmago24: doesn't show hand 
*** SUMMARY ***
Total pot $1 | Rake $0 
Seat 2: goldenpig666 folded before Flop (didn't bet)
Seat 3: Rulet345 folded before Flop (didn't bet)
Seat 4: lonely fire folded before Flop (didn't bet)
Seat 5: StudentRB folded before Flop (didn't bet)
Seat 6: Kasselbanki (button) folded before Flop (didn't bet)
Seat 7: Mmago24 (small blind) collected ($1)
Seat 8: bountyhun31 (big blind) folded before Flop



PokerStars Hand #228684420977:  Hold'em No Limit ($0.25/$0.50 USD) - 2021/07/30 13:53:43 ET
Table 'Bok II' 9-max Seat #7 is the button
Seat 1: teifthapot ($20 in chips) 
Seat 2: goldenpig666 ($57.95 in chips) 
Seat 3: Rulet345 ($55.04 in chips) 
Seat 4: lonely fire ($51.24 in chips) 
Seat 5: StudentRB ($62.16 in chips) 
Seat 6: Kasselbanki ($24.24 in chips) 
Seat 7: Mmago24 ($50.50 in chips) 
Seat 8: bountyhun31 ($49.53 in chips) 
bountyhun31: posts small blind $0.25
teifthapot: posts big blind $0.50
*** HOLE CARDS ***
goldenpig666: folds 
Rulet345: folds 
lonely fire: folds 
StudentRB: folds 
Kasselbanki: folds 
Mmago24: folds 
bountyhun31: folds 
Uncalled bet ($0.25) returned to teifthapot
teifthapot collected $0.50 from pot
teifthapot: doesn't show hand 
*** SUMMARY ***
Total pot $0.50 | Rake $0 
Seat 1: teifthapot (big blind) collected ($0.50)
Seat 2: goldenpig666 folded before Flop (didn't bet)
Seat 3: Rulet345 folded before Flop (didn't bet)
Seat 4: lonely fire folded before Flop (didn't bet)
Seat 5: StudentRB folded before Flop (didn't bet)
Seat 6: Kasselbanki folded before Flop (didn't bet)
Seat 7: Mmago24 (button) folded before Flop (didn't bet)
Seat 8: bountyhun31 (small blind) folded before Flop



PokerStars Hand #228684427440:  Hold'em No Limit ($0.25/$0.50 USD) - 2021/07/30 13:53:58 ET
Table 'Bok II' 9-max Seat #8 is the button
Seat 1: teifthapot ($20.25 in chips) 
Seat 2: goldenpig666 ($57.95 in chips) 
Seat 3: Rulet345 ($55.04 in chips) 
Seat 4: lonely fire ($51.24 in chips) 
Seat 5: StudentRB ($62.16 in chips) 
Seat 6: Kasselbanki ($24.24 in chips) 
Seat 7: Mmago24 ($50.50 in chips) 
Seat 8: bountyhun31 ($49.28 in chips) 
teifthapot: posts small blind $0.25
goldenpig666: posts big blind $0.50
*** HOLE CARDS ***
Rulet345: folds 
lonely fire: folds 
StudentRB: raises $0.75 to $1.25
Kasselbanki: folds 
Mmago24: folds 
bountyhun31: folds 
teifthapot: folds 
goldenpig666: folds 
Uncalled bet ($0.75) returned to StudentRB
StudentRB collected $1.25 from pot
StudentRB: doesn't show hand 
*** SUMMARY ***
Total pot $1.25 | Rake $0 
Seat 1: teifthapot (small blind) folded before Flop
Seat 2: goldenpig666 (big blind) folded before Flop
Seat 3: Rulet345 folded before Flop (didn't bet)
Seat 4: lonely fire folded before Flop (didn't bet)
Seat 5: StudentRB collected ($1.25)
Seat 6: Kasselbanki folded before Flop (didn't bet)
Seat 7: Mmago24 folded before Flop (didn't bet)
Seat 8: bountyhun31 (button) folded before Flop (didn't bet)



PokerStars Hand #228684433899:  Hold'em No Limit ($0.25/$0.50 USD) - 2021/07/30 13:54:14 ET
Table 'Bok II' 9-max Seat #1 is the button
Seat 1: teifthapot ($20 in chips) 
Seat 2: goldenpig666 ($57.45 in chips) 
Seat 3: Rulet345 ($55.04 in chips) 
Seat 4: lonely fire ($51.24 in chips) 
Seat 5: StudentRB ($62.91 in chips) 
Seat 6: Kasselbanki ($24.24 in chips) 
Seat 7: Mmago24 ($50.50 in chips) 
Seat 8: bountyhun31 ($49.28 in chips) 
goldenpig666: posts small blind $0.25
Rulet345: posts big blind $0.50
*** HOLE CARDS ***
lonely fire: folds 
StudentRB: folds 
Kasselbanki: folds 
Mmago24: folds 
bountyhun31: calls $0.50
teifthapot: folds 
goldenpig666: folds 
Rulet345: checks 
*** FLOP *** [9d 7c 9h]
Rulet345: checks 
bountyhun31: bets $0.50
Rulet345: calls $0.50
*** TURN *** [9d 7c 9h] [5d]
Rulet345: checks 
bountyhun31: checks 
*** RIVER *** [9d 7c 9h 5d] [6h]
Rulet345: checks 
bountyhun31: bets $2.14
Rulet345: folds 
Uncalled bet ($2.14) returned to bountyhun31
bountyhun31 collected $2.14 from pot
bountyhun31: doesn't show hand 
*** SUMMARY ***
Total pot $2.25 | Rake $0.11 
Board [9d 7c 9h 5d 6h]
Seat 1: teifthapot (button) folded before Flop (didn't bet)
Seat 2: goldenpig666 (small blind) folded before Flop
Seat 3: Rulet345 (big blind) folded on the River
Seat 4: lonely fire folded before Flop (didn't bet)
Seat 5: StudentRB folded before Flop (didn't bet)
Seat 6: Kasselbanki folded before Flop (didn't bet)
Seat 7: Mmago24 folded before Flop (didn't bet)
Seat 8: bountyhun31 collected ($2.14)



PokerStars Hand #228684459881:  Hold'em No Limit ($0.25/$0.50 USD) - 2021/07/30 13:55:19 ET
Table 'Bok II' 9-max Seat #2 is the button
Seat 1: teifthapot ($20 in chips) 
Seat 2: goldenpig666 ($57.20 in chips) 
Seat 3: Rulet345 ($54.04 in chips) 
Seat 5: StudentRB ($62.91 in chips) 
Seat 6: Kasselbanki ($24.24 in chips) 
Seat 7: Mmago24 ($50.50 in chips) 
Seat 8: bountyhun31 ($50.42 in chips) 
Rulet345: posts small blind $0.25
lonely fire: is sitting out 
StudentRB: posts big blind $0.50
*** HOLE CARDS ***
Kasselbanki: folds 
Mmago24: folds 
bountyhun31: calls $0.50
teifthapot: folds 
goldenpig666: folds 
Rulet345: folds 
StudentRB: raises $2 to $2.50
bountyhun31: calls $2
*** FLOP *** [9s Js 6d]
StudentRB: checks 
bountyhun31: checks 
*** TURN *** [9s Js 6d] [6s]
StudentRB: bets $3.74
bountyhun31: calls $3.74
*** RIVER *** [9s Js 6d 6s] [2c]
StudentRB: checks 
bountyhun31: checks 
*** SHOW DOWN ***
StudentRB: shows [Ah Jh] (two pair, Jacks and Sixes)
bountyhun31: mucks hand 
StudentRB collected $12.09 from pot
*** SUMMARY ***
Total pot $12.73 | Rake $0.64 
Board [9s Js 6d 6s 2c]
Seat 1: teifthapot folded before Flop (didn't bet)
Seat 2: goldenpig666 (button) folded before Flop (didn't bet)
Seat 3: Rulet345 (small blind) folded before Flop
Seat 5: StudentRB (big blind) showed [Ah Jh] and won ($12.09) with two pair, Jacks and Sixes
Seat 6: Kasselbanki folded before Flop (didn't bet)
Seat 7: Mmago24 folded before Flop (didn't bet)
Seat 8: bountyhun31 mucked



PokerStars Hand #228684474249:  Hold'em No Limit ($0.25/$0.50 USD) - 2021/07/30 13:56:08 ET
Table 'Bok II' 9-max Seat #3 is the button
Seat 1: teifthapot ($20 in chips) 
Seat 2: goldenpig666 ($57.20 in chips) 
Seat 3: Rulet345 ($53.79 in chips) 
Seat 5: StudentRB ($68.76 in chips) 
Seat 6: Kasselbanki ($24.24 in chips) 
Seat 7: Mmago24 ($50.50 in chips) 
Seat 8: bountyhun31 ($44.18 in chips) 
StudentRB: posts small blind $0.25
Kasselbanki: posts big blind $0.50
*** HOLE CARDS ***
Mmago24: folds 
bountyhun31: folds 
teifthapot: folds 
goldenpig666: folds 
Rulet345: raises $0.75 to $1.25
StudentRB: folds 
Kasselbanki: folds 
Uncalled bet ($0.75) returned to Rulet345
Rulet345 collected $1.25 from pot
Rulet345: doesn't show hand 
*** SUMMARY ***
Total pot $1.25 | Rake $0 
Seat 1: teifthapot folded before Flop (didn't bet)
Seat 2: goldenpig666 folded before Flop (didn't bet)
Seat 3: Rulet345 (button) collected ($1.25)
Seat 5: StudentRB (small blind) folded before Flop
Seat 6: Kasselbanki (big blind) folded before Flop
Seat 7: Mmago24 folded before Flop (didn't bet)
Seat 8: bountyhun31 folded before Flop (didn't bet)



PokerStars Hand #228684483004:  Hold'em No Limit ($0.25/$0.50 USD) - 2021/07/30 13:56:38 ET
Table 'Bok II' 9-max Seat #5 is the button
Seat 1: teifthapot ($20 in chips) 
Seat 2: goldenpig666 ($57.20 in chips) 
Seat 3: Rulet345 ($54.54 in chips) 
Seat 4: lonely fire ($51.24 in chips) 
Seat 5: StudentRB ($68.51 in chips) 
Seat 6: Kasselbanki ($23.74 in chips) 
Seat 7: Mmago24 ($50.50 in chips) 
Seat 8: bountyhun31 ($44.18 in chips) 
Kasselbanki: posts small blind $0.25
Mmago24: posts big blind $0.50
lonely fire: posts small & big blinds $0.75
*** HOLE CARDS ***
bountyhun31: calls $0.50
teifthapot: folds 
goldenpig666: folds 
Rulet345: folds 
lonely fire: raises $1.50 to $2
StudentRB: raises $4 to $6
Kasselbanki: folds 
Mmago24: folds 
bountyhun31: folds 
lonely fire: folds 
Uncalled bet ($4) returned to StudentRB
StudentRB collected $5.50 from pot
StudentRB: doesn't show hand 
*** SUMMARY ***
Total pot $5.50 | Rake $0 
Seat 1: teifthapot folded before Flop (didn't bet)
Seat 2: goldenpig666 folded before Flop (didn't bet)
Seat 3: Rulet345 folded before Flop (didn't bet)
Seat 4: lonely fire folded before Flop
Seat 5: StudentRB (button) collected ($5.50)
Seat 6: Kasselbanki (small blind) folded before Flop
Seat 7: Mmago24 (big blind) folded before Flop
Seat 8: bountyhun31 folded before Flop



PokerStars Hand #228684493533:  Hold'em No Limit ($0.25/$0.50 USD) - 2021/07/30 13:57:14 ET
Table 'Bok II' 9-max Seat #6 is the button
Seat 1: teifthapot ($20 in chips) 
Seat 2: goldenpig666 ($57.20 in chips) 
Seat 3: Rulet345 ($54.54 in chips) 
Seat 4: lonely fire ($50 in chips) 
Seat 5: StudentRB ($72.01 in chips) 
Seat 6: Kasselbanki ($23.49 in chips) 
Seat 7: Mmago24 ($50 in chips) 
Seat 8: bountyhun31 ($43.68 in chips) 
Mmago24: posts small blind $0.25
bountyhun31: posts big blind $0.50
*** HOLE CARDS ***
teifthapot: folds 
goldenpig666: folds 
Rulet345: folds 
lonely fire: raises $1 to $1.50
StudentRB: folds 
Kasselbanki: calls $1.50
Mmago24: folds 
bountyhun31: calls $1
*** FLOP *** [6c 6s 4h]
bountyhun31: checks 
lonely fire: bets $1.49
Kasselbanki: folds 
bountyhun31: calls $1.49
*** TURN *** [6c 6s 4h] [4c]
bountyhun31: bets $1
Hunt133 was removed from the table for failing to post
Hunt133 leaves the table
lonely fire: calls $1
*** RIVER *** [6c 6s 4h 4c] [Ad]
bountyhun31: bets $1
Zhud19 joins the table at seat #9 
lonely fire: calls $1
*** SHOW DOWN ***
bountyhun31: shows [As Th] (two pair, Aces and Sixes)
lonely fire: mucks hand 
bountyhun31 collected $11.14 from pot
*** SUMMARY ***
Total pot $11.73 | Rake $0.59 
Board [6c 6s 4h 4c Ad]
Seat 1: teifthapot folded before Flop (didn't bet)
Seat 2: goldenpig666 folded before Flop (didn't bet)
Seat 3: Rulet345 folded before Flop (didn't bet)
Seat 4: lonely fire mucked
Seat 5: StudentRB folded before Flop (didn't bet)
Seat 6: Kasselbanki (button) folded on the Flop
Seat 7: Mmago24 (small blind) folded before Flop
Seat 8: bountyhun31 (big blind) showed [As Th] and won ($11.14) with two pair, Aces and Sixes



PokerStars Hand #228684507570:  Hold'em No Limit ($0.25/$0.50 USD) - 2021/07/30 13:58:00 ET
Table 'Bok II' 9-max Seat #7 is the button
Seat 1: teifthapot ($20 in chips) 
Seat 2: goldenpig666 ($57.20 in chips) 
Seat 3: Rulet345 ($54.54 in chips) 
Seat 4: lonely fire ($50 in chips) 
Seat 5: StudentRB ($72.01 in chips) 
Seat 6: Kasselbanki ($21.99 in chips) 
Seat 7: Mmago24 ($50 in chips) 
Seat 8: bountyhun31 ($49.83 in chips) 
Seat 9: Zhud19 ($50 in chips) 
bountyhun31: posts small blind $0.25
Zhud19: posts big blind $0.50
*** HOLE CARDS ***
teifthapot: calls $0.50
goldenpig666: folds 
Rulet345: folds 
lonely fire: raises $1.50 to $2
StudentRB: folds 
Kasselbanki: calls $2
Mmago24: folds 
bountyhun31: folds 
Zhud19: folds 
teifthapot: raises $4.50 to $6.50
lonely fire: folds 
Kasselbanki: calls $4.50
*** FLOP *** [2c 4s 2s]
teifthapot: bets $13.50 and is all-in
Kasselbanki: calls $13.50
*** TURN *** [2c 4s 2s] [9c]
*** RIVER *** [2c 4s 2s 9c] [Th]
*** SHOW DOWN ***
teifthapot: shows [Kh Ah] (a pair of Deuces)
Kasselbanki: shows [5h 5s] (two pair, Fives and Deuces)
Kasselbanki collected $40.25 from pot
*** SUMMARY ***
Total pot $42.75 | Rake $2.50 
Board [2c 4s 2s 9c Th]
Seat 1: teifthapot showed [Kh Ah] and lost with a pair of Deuces
Seat 2: goldenpig666 folded before Flop (didn't bet)
Seat 3: Rulet345 folded before Flop (didn't bet)
Seat 4: lonely fire folded before Flop
Seat 5: StudentRB folded before Flop (didn't bet)
Seat 6: Kasselbanki showed [5h 5s] and won ($40.25) with two pair, Fives and Deuces
Seat 7: Mmago24 (button) folded before Flop (didn't bet)
Seat 8: bountyhun31 (small blind) folded before Flop
Seat 9: Zhud19 (big blind) folded before Flop



PokerStars Hand #228684520396:  Hold'em No Limit ($0.25/$0.50 USD) - 2021/07/30 13:58:43 ET
Table 'Bok II' 9-max Seat #8 is the button
Seat 2: goldenpig666 ($57.20 in chips) 
Seat 3: Rulet345 ($54.54 in chips) 
Seat 4: lonely fire ($50 in chips) 
Seat 5: StudentRB ($72.01 in chips) 
Seat 6: Kasselbanki ($42.24 in chips) 
Seat 7: Mmago24 ($50 in chips) 
Seat 8: bountyhun31 ($49.58 in chips) 
Seat 9: Zhud19 ($50 in chips) 
Zhud19: posts small blind $0.25
goldenpig666: posts big blind $0.50
*** HOLE CARDS ***
teifthapot leaves the table
Rulet345: raises $1 to $1.50
lonely fire: folds 
StudentRB: folds 
Kasselbanki: folds 
Mmago24: folds 
bountyhun31: folds 
Zhud19: calls $1.25
goldenpig666: folds 
*** FLOP *** [6c 4h Ks]
Zhud19: checks 
Rulet345: bets $1.10
Zhud19: calls $1.10
*** TURN *** [6c 4h Ks] [3s]
Zhud19: checks 
Rulet345: checks 
*** RIVER *** [6c 4h Ks 3s] [7h]
Nestle170 joins the table at seat #1 
Zhud19: checks 
Rulet345: bets $1.79
Zhud19: folds 
Uncalled bet ($1.79) returned to Rulet345
Rulet345 collected $5.42 from pot
Rulet345: doesn't show hand 
*** SUMMARY ***
Total pot $5.70 | Rake $0.28 
Board [6c 4h Ks 3s 7h]
Seat 2: goldenpig666 (big blind) folded before Flop
Seat 3: Rulet345 collected ($5.42)
Seat 4: lonely fire folded before Flop (didn't bet)
Seat 5: StudentRB folded before Flop (didn't bet)
Seat 6: Kasselbanki folded before Flop (didn't bet)
Seat 7: Mmago24 folded before Flop (didn't bet)
Seat 8: bountyhun31 (button) folded before Flop (didn't bet)
Seat 9: Zhud19 (small blind) folded on the River



PokerStars Hand #228684544326:  Hold'em No Limit ($0.25/$0.50 USD) - 2021/07/30 13:59:58 ET
Table 'Bok II' 9-max Seat #9 is the button
Seat 2: goldenpig666 ($56.70 in chips) 
Seat 3: Rulet345 ($57.36 in chips) 
Seat 4: lonely fire ($50 in chips) 
Seat 5: StudentRB ($72.01 in chips) 
Seat 6: Kasselbanki ($42.24 in chips) 
Seat 7: Mmago24 ($50 in chips) 
Seat 8: bountyhun31 ($49.58 in chips) 
Seat 9: Zhud19 ($50 in chips) 
goldenpig666: posts small blind $0.25
Rulet345: posts big blind $0.50
*** HOLE CARDS ***
lonely fire: folds 
StudentRB: folds 
Kasselbanki: folds 
Mmago24: folds 
bountyhun31: folds 
Zhud19: folds 
goldenpig666: raises $1 to $1.50
lonely fire leaves the table
Rulet345: folds 
Uncalled bet ($1) returned to goldenpig666
goldenpig666 collected $1 from pot
goldenpig666: doesn't show hand 
*** SUMMARY ***
Total pot $1 | Rake $0 
Seat 2: goldenpig666 (small blind) collected ($1)
Seat 3: Rulet345 (big blind) folded before Flop
Seat 4: lonely fire folded before Flop (didn't bet)
Seat 5: StudentRB folded before Flop (didn't bet)
Seat 6: Kasselbanki folded before Flop (didn't bet)
Seat 7: Mmago24 folded before Flop (didn't bet)
Seat 8: bountyhun31 folded before Flop (didn't bet)
Seat 9: Zhud19 (button) folded before Flop (didn't bet)



PokerStars Hand #228684551814:  Hold'em No Limit ($0.25/$0.50 USD) - 2021/07/30 14:00:21 ET
Table 'Bok II' 9-max Seat #2 is the button
Seat 2: goldenpig666 ($57.20 in chips) 
Seat 3: Rulet345 ($56.86 in chips) 
Seat 6: Kasselbanki ($42.24 in chips) 
Seat 7: Mmago24 ($50 in chips) 
Seat 8: bountyhun31 ($49.58 in chips) 
Seat 9: Zhud19 ($50 in chips) 
Rulet345: posts small blind $0.25
StudentRB: is sitting out 
Kasselbanki: posts big blind $0.50
Nestle170: sits out 
*** HOLE CARDS ***
Mmago24: folds 
bountyhun31: folds 
Zhud19: folds 
goldenpig666: folds 
Rulet345: raises $1 to $1.50
Kasselbanki: folds 
Uncalled bet ($1) returned to Rulet345
StudentRB leaves the table
Rulet345 collected $1 from pot
Rulet345: doesn't show hand 
*** SUMMARY ***
Total pot $1 | Rake $0 
Seat 2: goldenpig666 (button) folded before Flop (didn't bet)
Seat 3: Rulet345 (small blind) collected ($1)
Seat 6: Kasselbanki (big blind) folded before Flop
Seat 7: Mmago24 folded before Flop (didn't bet)
Seat 8: bountyhun31 folded before Flop (didn't bet)
Seat 9: Zhud19 folded before Flop (didn't bet)



PokerStars Hand #228684554845:  Hold'em No Limit ($0.25/$0.50 USD) - 2021/07/30 14:00:30 ET
Table 'Bok II' 9-max Seat #3 is the button
Seat 2: goldenpig666 ($57.20 in chips) 
Seat 3: Rulet345 ($57.36 in chips) 
Seat 6: Kasselbanki ($41.74 in chips) 
Seat 7: Mmago24 ($50 in chips) 
Seat 8: bountyhun31 ($49.58 in chips) 
Seat 9: Zhud19 ($50 in chips) 
Kasselbanki: posts small blind $0.25
Mmago24: posts big blind $0.50
Nestle170: sits out 
*** HOLE CARDS ***
bountyhun31: folds 
Zhud19: raises $1 to $1.50
goldenpig666: raises $3 to $4.50
Rulet345: folds 
Kasselbanki: folds 
Mmago24: folds 
Zhud19: folds 
Uncalled bet ($3) returned to goldenpig666
goldenpig666 collected $3.75 from pot
goldenpig666: doesn't show hand 
*** SUMMARY ***
Total pot $3.75 | Rake $0 
Seat 2: goldenpig666 collected ($3.75)
Seat 3: Rulet345 (button) folded before Flop (didn't bet)
Seat 6: Kasselbanki (small blind) folded before Flop
Seat 7: Mmago24 (big blind) folded before Flop
Seat 8: bountyhun31 folded before Flop (didn't bet)
Seat 9: Zhud19 folded before Flop



PokerStars Hand #228684561517:  Hold'em No Limit ($0.25/$0.50 USD) - 2021/07/30 14:00:50 ET
Table 'Bok II' 9-max Seat #6 is the button
Seat 2: goldenpig666 ($59.45 in chips) 
Seat 3: Rulet345 ($57.36 in chips) 
Seat 6: Kasselbanki ($41.49 in chips) 
Seat 7: Mmago24 ($50 in chips) 
Seat 8: bountyhun31 ($49.58 in chips) 
Seat 9: Zhud19 ($50 in chips) 
Mmago24: posts small blind $0.25
bountyhun31: posts big blind $0.50
Nestle170: sits out 
*** HOLE CARDS ***
Zhud19: folds 
goldenpig666: folds 
Rulet345: folds 
Kasselbanki: folds 
Mmago24: calls $0.25
bountyhun31: checks 
*** FLOP *** [7c 2c 6s]
Mmago24: bets $0.63
bountyhun31: calls $0.63
*** TURN *** [7c 2c 6s] [Qs]
Mmago24: bets $1.43
bountyhun31: folds 
Uncalled bet ($1.43) returned to Mmago24
Mmago24 collected $2.15 from pot
Mmago24: doesn't show hand 
*** SUMMARY ***
Total pot $2.26 | Rake $0.11 
Board [7c 2c 6s Qs]
Seat 2: goldenpig666 folded before Flop (didn't bet)
Seat 3: Rulet345 folded before Flop (didn't bet)
Seat 6: Kasselbanki (button) folded before Flop (didn't bet)
Seat 7: Mmago24 (small blind) collected ($2.15)
Seat 8: bountyhun31 (big blind) folded on the Turn
Seat 9: Zhud19 folded before Flop (didn't bet)



PokerStars Hand #228684575231:  Hold'em No Limit ($0.25/$0.50 USD) - 2021/07/30 14:01:28 ET
Table 'Bok II' 9-max Seat #7 is the button
Seat 2: goldenpig666 ($59.45 in chips) 
Seat 3: Rulet345 ($57.36 in chips) 
Seat 6: Kasselbanki ($41.49 in chips) 
Seat 7: Mmago24 ($51.02 in chips) 
Seat 8: bountyhun31 ($48.45 in chips) 
Seat 9: Zhud19 ($50 in chips) 
bountyhun31: posts small blind $0.25
Zhud19: posts big blind $0.50
Nestle170: sits out 
*** HOLE CARDS ***
goldenpig666: folds 
Rulet345: folds 
Kasselbanki: folds 
Mmago24: folds 
bountyhun31: folds 
Uncalled bet ($0.25) returned to Zhud19
Zhud19 collected $0.50 from pot
*** SUMMARY ***
Total pot $0.50 | Rake $0 
Seat 2: goldenpig666 folded before Flop (didn't bet)
Seat 3: Rulet345 folded before Flop (didn't bet)
Seat 6: Kasselbanki folded before Flop (didn't bet)
Seat 7: Mmago24 (button) folded before Flop (didn't bet)
Seat 8: bountyhun31 (small blind) folded before Flop
Seat 9: Zhud19 (big blind) collected ($0.50)



PokerStars Hand #228684579869:  Hold'em No Limit ($0.25/$0.50 USD) - 2021/07/30 14:01:40 ET
Table 'Bok II' 9-max Seat #8 is the button
Seat 1: Nestle170 ($50 in chips) 
Seat 2: goldenpig666 ($59.45 in chips) 
Seat 3: Rulet345 ($57.36 in chips) 
Seat 6: Kasselbanki ($41.49 in chips) 
Seat 7: Mmago24 ($51.02 in chips) 
Seat 8: bountyhun31 ($48.20 in chips) 
Seat 9: Zhud19 ($50.25 in chips) 
Zhud19: posts small blind $0.25
Nestle170: posts big blind $0.50
*** HOLE CARDS ***
goldenpig666: folds 
Rulet345: folds 
goldenpig666 leaves the table
Kasselbanki: folds 
Mmago24: raises $0.72 to $1.22
bountyhun31: calls $1.22
Zhud19: folds 
Nestle170: folds 
*** FLOP *** [3c Jd Kh]
Mmago24: bets $1.10
bountyhun31: calls $1.10
*** TURN *** [3c Jd Kh] [Kd]
bateman225 joins the table at seat #2 
KerilTheBoss joins the table at seat #4 
Mmago24: bets $2
Jesuszin joins the table at seat #5 
bountyhun31: folds 
Uncalled bet ($2) returned to Mmago24
Mmago24 collected $5.12 from pot
Mmago24: doesn't show hand 
*** SUMMARY ***
Total pot $5.39 | Rake $0.27 
Board [3c Jd Kh Kd]
Seat 1: Nestle170 (big blind) folded before Flop
Seat 2: goldenpig666 folded before Flop (didn't bet)
Seat 3: Rulet345 folded before Flop (didn't bet)
Seat 6: Kasselbanki folded before Flop (didn't bet)
Seat 7: Mmago24 collected ($5.12)
Seat 8: bountyhun31 (button) folded on the Turn
Seat 9: Zhud19 (small blind) folded before Flop



PokerStars Hand #228684595088:  Hold'em No Limit ($0.25/$0.50 USD) - 2021/07/30 14:02:17 ET
Table 'Bok II' 9-max Seat #9 is the button
Seat 1: Nestle170 ($50 in chips) 
Seat 2: bateman225 ($40 in chips) 
Seat 3: Rulet345 ($57.36 in chips) 
Seat 5: Jesuszin ($33.80 in chips) 
Seat 6: Kasselbanki ($41.49 in chips) 
Seat 7: Mmago24 ($53.82 in chips) 
Seat 8: bountyhun31 ($45.88 in chips) 
Seat 9: Zhud19 ($50 in chips) 
Nestle170: posts small blind $0.25
bateman225: posts big blind $0.50
KerilTheBoss: sits out 
Jesuszin: posts big blind $0.50
*** HOLE CARDS ***
Rulet345: folds 
Jesuszin: checks 
Kasselbanki: folds 
Mmago24: folds 
bountyhun31: folds 
Zhud19: folds 
Nestle170: raises $2 to $2.50
bateman225: folds 
Jesuszin: calls $2
*** FLOP *** [Ac 4h 6h]
Nestle170: checks 
Jesuszin: bets $3
Nestle170: calls $3
*** TURN *** [Ac 4h 6h] [8d]
Nestle170: checks 
Jesuszin: checks 
*** RIVER *** [Ac 4h 6h 8d] [Kd]
Nestle170: bets $6.55
Jesuszin: raises $21.75 to $28.30 and is all-in
Nestle170: calls $21.75
*** SHOW DOWN ***
Jesuszin: shows [Qh Jc] (high card Ace)
Nestle170: shows [2s As] (a pair of Aces)
Nestle170 collected $66.10 from pot
*** SUMMARY ***
Total pot $68.10 | Rake $2 
Board [Ac 4h 6h 8d Kd]
Seat 1: Nestle170 (small blind) showed [2s As] and won ($66.10) with a pair of Aces
Seat 2: bateman225 (big blind) folded before Flop
Seat 3: Rulet345 folded before Flop (didn't bet)
Seat 5: Jesuszin showed [Qh Jc] and lost with high card Ace
Seat 6: Kasselbanki folded before Flop (didn't bet)
Seat 7: Mmago24 folded before Flop (didn't bet)
Seat 8: bountyhun31 folded before Flop (didn't bet)
Seat 9: Zhud19 (button) folded before Flop (didn't bet)



PokerStars Hand #228684624578:  Hold'em No Limit ($0.25/$0.50 USD) - 2021/07/30 14:03:27 ET
Table 'Bok II' 9-max Seat #1 is the button
Seat 1: Nestle170 ($82.30 in chips) 
Seat 2: bateman225 ($39.50 in chips) 
Seat 4: KerilTheBoss ($50 in chips) 
Seat 6: Kasselbanki ($41.49 in chips) 
Seat 7: Mmago24 ($53.82 in chips) 
Seat 8: bountyhun31 ($45.88 in chips) 
Seat 9: Zhud19 ($50 in chips) 
bateman225: posts small blind $0.25
KerilTheBoss: posts big blind $0.50
*** HOLE CARDS ***
Kasselbanki: raises $1 to $1.50
Mmago24: folds 
bountyhun31: folds 
Zhud19: folds 
Nestle170: folds 
bateman225: calls $1.25
Jesuszin leaves the table
KerilTheBoss: folds 
*** FLOP *** [7c Jc 3d]
bateman225: checks 
Kasselbanki: bets $2
bateman225: folds 
Uncalled bet ($2) returned to Kasselbanki
Kasselbanki collected $3.28 from pot
Kasselbanki: doesn't show hand 
*** SUMMARY ***
Total pot $3.50 | Rake $0.22 
Board [7c Jc 3d]
Seat 1: Nestle170 (button) folded before Flop (didn't bet)
Seat 2: bateman225 (small blind) folded on the Flop
Seat 4: KerilTheBoss (big blind) folded before Flop
Seat 6: Kasselbanki collected ($3.28)
Seat 7: Mmago24 folded before Flop (didn't bet)
Seat 8: bountyhun31 folded before Flop (didn't bet)
Seat 9: Zhud19 folded before Flop (didn't bet)



PokerStars Hand #228684641373:  Hold'em No Limit ($0.25/$0.50 USD) - 2021/07/30 14:04:08 ET
Table 'Bok II' 9-max Seat #2 is the button
Seat 1: Nestle170 ($82.30 in chips) 
Seat 2: bateman225 ($38 in chips) 
Seat 4: KerilTheBoss ($50 in chips) 
Seat 6: Kasselbanki ($43.27 in chips) 
Seat 7: Mmago24 ($53.82 in chips) 
Seat 8: bountyhun31 ($45.88 in chips) 
Seat 9: Zhud19 ($50 in chips) 
KerilTheBoss: posts small blind $0.25
Kasselbanki: posts big blind $0.50
*** HOLE CARDS ***
Mmago24: folds 
bountyhun31: folds 
Zhud19: folds 
Nestle170: folds 
bateman225: folds 
KerilTheBoss: raises $1 to $1.50
Kasselbanki: folds 
Uncalled bet ($1) returned to KerilTheBoss
KerilTheBoss collected $1 from pot
KerilTheBoss: doesn't show hand 
*** SUMMARY ***
Total pot $1 | Rake $0 
Seat 1: Nestle170 folded before Flop (didn't bet)
Seat 2: bateman225 (button) folded before Flop (didn't bet)
Seat 4: KerilTheBoss (small blind) collected ($1)
Seat 6: Kasselbanki (big blind) folded before Flop
Seat 7: Mmago24 folded before Flop (didn't bet)
Seat 8: bountyhun31 folded before Flop (didn't bet)
Seat 9: Zhud19 folded before Flop (didn't bet)



PokerStars Hand #228684647683:  Hold'em No Limit ($0.25/$0.50 USD) - 2021/07/30 14:04:23 ET
Table 'Bok II' 9-max Seat #4 is the button
Seat 1: Nestle170 ($82.30 in chips) 
Seat 2: bateman225 ($38 in chips) 
Seat 4: KerilTheBoss ($50.50 in chips) 
Seat 6: Kasselbanki ($42.77 in chips) 
Seat 7: Mmago24 ($53.82 in chips) 
Seat 8: bountyhun31 ($45.88 in chips) 
Seat 9: Zhud19 ($50 in chips) 
Kasselbanki: posts small blind $0.25
Mmago24: posts big blind $0.50
Rulet345: sits out 
*** HOLE CARDS ***
bountyhun31: folds 
Zhud19: folds 
Nestle170: folds 
bateman225: folds 
KerilTheBoss: folds 
Kasselbanki: raises $0.50 to $1
Mmago24: folds 
Uncalled bet ($0.50) returned to Kasselbanki
Kasselbanki collected $1 from pot
Kasselbanki: doesn't show hand 
*** SUMMARY ***
Total pot $1 | Rake $0 
Seat 1: Nestle170 folded before Flop (didn't bet)
Seat 2: bateman225 folded before Flop (didn't bet)
Seat 4: KerilTheBoss (button) folded before Flop (didn't bet)
Seat 6: Kasselbanki (small blind) collected ($1)
Seat 7: Mmago24 (big blind) folded before Flop
Seat 8: bountyhun31 folded before Flop (didn't bet)
Seat 9: Zhud19 folded before Flop (didn't bet)



PokerStars Hand #228684657822:  Hold'em No Limit ($0.25/$0.50 USD) - 2021/07/30 14:04:46 ET
Table 'Bok II' 9-max Seat #6 is the button
Seat 1: Nestle170 ($82.30 in chips) 
Seat 2: bateman225 ($38 in chips) 
Seat 4: KerilTheBoss ($50.50 in chips) 
Seat 6: Kasselbanki ($43.27 in chips) 
Seat 7: Mmago24 ($53.32 in chips) 
Seat 8: bountyhun31 ($45.88 in chips) 
Seat 9: Zhud19 ($50 in chips) 
Mmago24: posts small blind $0.25
bountyhun31: posts big blind $0.50
Rulet345: sits out 
*** HOLE CARDS ***
Zhud19: folds 
Nestle170: folds 
EBISU01 joins the table at seat #5 
bateman225: calls $0.50
KerilTheBoss: folds 
Kasselbanki: folds 
Mmago24: folds 
bountyhun31: checks 
*** FLOP *** [9s 9h Jc]
bountyhun31: checks 
bateman225: bets $0.50
bountyhun31: folds 
Uncalled bet ($0.50) returned to bateman225
bateman225 collected $1.19 from pot
bateman225: doesn't show hand 
*** SUMMARY ***
Total pot $1.25 | Rake $0.06 
Board [9s 9h Jc]
Seat 1: Nestle170 folded before Flop (didn't bet)
Seat 2: bateman225 collected ($1.19)
Seat 4: KerilTheBoss folded before Flop (didn't bet)
Seat 6: Kasselbanki (button) folded before Flop (didn't bet)
Seat 7: Mmago24 (small blind) folded before Flop
Seat 8: bountyhun31 (big blind) folded on the Flop
Seat 9: Zhud19 folded before Flop (didn't bet)



PokerStars Hand #228684678240:  Hold'em No Limit ($0.25/$0.50 USD) - 2021/07/30 14:05:34 ET
Table 'Bok II' 9-max Seat #7 is the button
Seat 1: Nestle170 ($82.30 in chips) 
Seat 2: bateman225 ($38.69 in chips) 
Seat 4: KerilTheBoss ($50.50 in chips) 
Seat 5: EBISU01 ($40 in chips) 
Seat 6: Kasselbanki ($43.27 in chips) 
Seat 7: Mmago24 ($53.07 in chips) 
Seat 8: bountyhun31 ($45.38 in chips) 
Seat 9: Zhud19 ($50 in chips) 
bountyhun31: posts small blind $0.25
Zhud19: posts big blind $0.50
Rulet345: sits out 
EBISU01: posts big blind $0.50
*** HOLE CARDS ***
Nestle170: folds 
bateman225: calls $0.50
KerilTheBoss: folds 
EBISU01: checks 
Kasselbanki: folds 
Mmago24: raises $2 to $2.50
bountyhun31: calls $2.25
Zhud19: folds 
bateman225: calls $2
EBISU01: folds 
*** FLOP *** [2s Ks 3c]
bountyhun31: checks 
bateman225: checks 
Mmago24: bets $2.67
bountyhun31: folds 
bateman225: folds 
Uncalled bet ($2.67) returned to Mmago24
Mmago24 collected $8.08 from pot
Mmago24: doesn't show hand 
*** SUMMARY ***
Total pot $8.50 | Rake $0.42 
Board [2s Ks 3c]
Seat 1: Nestle170 folded before Flop (didn't bet)
Seat 2: bateman225 folded on the Flop
Seat 4: KerilTheBoss folded before Flop (didn't bet)
Seat 5: EBISU01 folded before Flop (didn't bet)
Seat 6: Kasselbanki folded before Flop (didn't bet)
Seat 7: Mmago24 (button) collected ($8.08)
Seat 8: bountyhun31 (small blind) folded on the Flop
Seat 9: Zhud19 (big blind) folded before Flop



PokerStars Hand #228684694054:  Hold'em No Limit ($0.25/$0.50 USD) - 2021/07/30 14:06:11 ET
Table 'Bok II' 9-max Seat #8 is the button
Seat 1: Nestle170 ($82.30 in chips) 
Seat 2: bateman225 ($36.19 in chips) 
Seat 4: KerilTheBoss ($50.50 in chips) 
Seat 5: EBISU01 ($39.50 in chips) 
Seat 6: Kasselbanki ($43.27 in chips) 
Seat 7: Mmago24 ($58.65 in chips) 
Seat 8: bountyhun31 ($42.88 in chips) 
Seat 9: Zhud19 ($50 in chips) 
Zhud19: posts small blind $0.25
Nestle170: posts big blind $0.50
Rulet345: sits out 
*** HOLE CARDS ***
bateman225: folds 
KerilTheBoss: folds 
EBISU01: raises $1 to $1.50
Kasselbanki: folds 
Mmago24: folds 
bountyhun31: calls $1.50
Zhud19: folds 
Nestle170: folds 
*** FLOP *** [6h Kd 9c]
EBISU01: checks 
bountyhun31: checks 
*** TURN *** [6h Kd 9c] [Jd]
EBISU01: bets $3.56
bountyhun31: folds 
Uncalled bet ($3.56) returned to EBISU01
EBISU01 collected $3.56 from pot
EBISU01: doesn't show hand 
*** SUMMARY ***
Total pot $3.75 | Rake $0.19 
Board [6h Kd 9c Jd]
Seat 1: Nestle170 (big blind) folded before Flop
Seat 2: bateman225 folded before Flop (didn't bet)
Seat 4: KerilTheBoss folded before Flop (didn't bet)
Seat 5: EBISU01 collected ($3.56)
Seat 6: Kasselbanki folded before Flop (didn't bet)
Seat 7: Mmago24 folded before Flop (didn't bet)
Seat 8: bountyhun31 (button) folded on the Turn
Seat 9: Zhud19 (small blind) folded before Flop



PokerStars Hand #228684707605:  Hold'em No Limit ($0.25/$0.50 USD) - 2021/07/30 14:06:43 ET
Table 'Bok II' 9-max Seat #9 is the button
Seat 1: Nestle170 ($81.80 in chips) 
Seat 2: bateman225 ($36.19 in chips) 
Seat 4: KerilTheBoss ($50.50 in chips) 
Seat 5: EBISU01 ($41.56 in chips) 
Seat 6: Kasselbanki ($43.27 in chips) 
Seat 7: Mmago24 ($58.65 in chips) 
Seat 8: bountyhun31 ($41.38 in chips) 
Seat 9: Zhud19 ($50 in chips) 
Nestle170: posts small blind $0.25
bateman225: posts big blind $0.50
Rulet345: sits out 
*** HOLE CARDS ***
KerilTheBoss: folds 
EBISU01: folds 
Kasselbanki: folds 
Mmago24: folds 
bountyhun31: calls $0.50
Zhud19: folds 
Nestle170: folds 
bateman225: checks 
*** FLOP *** [2c Kc 9h]
bateman225: bets $0.50
bountyhun31: calls $0.50
*** TURN *** [2c Kc 9h] [4c]
bateman225: bets $0.50
bountyhun31: calls $0.50
*** RIVER *** [2c Kc 9h 4c] [4h]
bateman225: bets $2.04
bountyhun31: folds 
Uncalled bet ($2.04) returned to bateman225
bateman225 collected $3.09 from pot
bateman225: doesn't show hand 
*** SUMMARY ***
Total pot $3.25 | Rake $0.16 
Board [2c Kc 9h 4c 4h]
Seat 1: Nestle170 (small blind) folded before Flop
Seat 2: bateman225 (big blind) collected ($3.09)
Seat 4: KerilTheBoss folded before Flop (didn't bet)
Seat 5: EBISU01 folded before Flop (didn't bet)
Seat 6: Kasselbanki folded before Flop (didn't bet)
Seat 7: Mmago24 folded before Flop (didn't bet)
Seat 8: bountyhun31 folded on the River
Seat 9: Zhud19 (button) folded before Flop (didn't bet)



PokerStars Hand #228684720571:  Hold'em No Limit ($0.25/$0.50 USD) - 2021/07/30 14:07:14 ET
Table 'Bok II' 9-max Seat #1 is the button
Seat 1: Nestle170 ($81.55 in chips) 
Seat 2: bateman225 ($37.78 in chips) 
Seat 3: Rulet345 ($57.36 in chips) 
Seat 4: KerilTheBoss ($50.50 in chips) 
Seat 5: EBISU01 ($41.56 in chips) 
Seat 6: Kasselbanki ($43.27 in chips) 
Seat 7: Mmago24 ($58.65 in chips) 
Seat 8: bountyhun31 ($39.88 in chips) 
Seat 9: Zhud19 ($50 in chips) 
bateman225: posts small blind $0.25
Rulet345: posts big blind $0.50
*** HOLE CARDS ***
KerilTheBoss: raises $1 to $1.50
EBISU01: folds 
Kasselbanki: folds 
Mmago24: folds 
bountyhun31: folds 
Zhud19: folds 
Nestle170: folds 
bateman225: folds 
Rulet345: calls $1
*** FLOP *** [Js Qd Td]
Rulet345: checks 
KerilTheBoss: checks 
*** TURN *** [Js Qd Td] [4d]
Rulet345: bets $2.06
KerilTheBoss: calls $2.06
*** RIVER *** [Js Qd Td 4d] [Qh]
Rulet345: bets $4.67
KerilTheBoss: folds 
Uncalled bet ($4.67) returned to Rulet345
Rulet345 collected $7 from pot
Rulet345: doesn't show hand 
*** SUMMARY ***
Total pot $7.37 | Rake $0.37 
Board [Js Qd Td 4d Qh]
Seat 1: Nestle170 (button) folded before Flop (didn't bet)
Seat 2: bateman225 (small blind) folded before Flop
Seat 3: Rulet345 (big blind) collected ($7)
Seat 4: KerilTheBoss folded on the River
Seat 5: EBISU01 folded before Flop (didn't bet)
Seat 6: Kasselbanki folded before Flop (didn't bet)
Seat 7: Mmago24 folded before Flop (didn't bet)
Seat 8: bountyhun31 folded before Flop (didn't bet)
Seat 9: Zhud19 folded before Flop (didn't bet)



PokerStars Hand #228684747760:  Hold'em No Limit ($0.25/$0.50 USD) - 2021/07/30 14:08:17 ET
Table 'Bok II' 9-max Seat #2 is the button
Seat 1: Nestle170 ($81.55 in chips) 
Seat 2: bateman225 ($37.53 in chips) 
Seat 3: Rulet345 ($60.80 in chips) 
Seat 4: KerilTheBoss ($50 in chips) 
Seat 5: EBISU01 ($41.56 in chips) 
Seat 6: Kasselbanki ($43.27 in chips) 
Seat 7: Mmago24 ($58.65 in chips) 
Seat 8: bountyhun31 ($39.88 in chips) 
Seat 9: Zhud19 ($50 in chips) 
Rulet345: posts small blind $0.25
KerilTheBoss: posts big blind $0.50
*** HOLE CARDS ***
EBISU01: folds 
Kasselbanki: folds 
Mmago24: folds 
bountyhun31: raises $1 to $1.50
Zhud19: folds 
Nestle170: folds 
bateman225: folds 
Rulet345: folds 
KerilTheBoss: folds 
Uncalled bet ($1) returned to bountyhun31
bountyhun31 collected $1.25 from pot
bountyhun31: doesn't show hand 
*** SUMMARY ***
Total pot $1.25 | Rake $0 
Seat 1: Nestle170 folded before Flop (didn't bet)
Seat 2: bateman225 (button) folded before Flop (didn't bet)
Seat 3: Rulet345 (small blind) folded before Flop
Seat 4: KerilTheBoss (big blind) folded before Flop
Seat 5: EBISU01 folded before Flop (didn't bet)
Seat 6: Kasselbanki folded before Flop (didn't bet)
Seat 7: Mmago24 folded before Flop (didn't bet)
Seat 8: bountyhun31 collected ($1.25)
Seat 9: Zhud19 folded before Flop (didn't bet)



PokerStars Hand #228685275391:  Hold'em No Limit ($0.25/$0.50 USD) - 2021/07/30 14:28:24 ET
Table 'Bok II' 9-max Seat #4 is the button
Seat 1: Nestle170 ($106.79 in chips) 
Seat 2: bateman225 ($31.69 in chips) 
Seat 3: Rulet345 ($50 in chips) 
Seat 4: KerilTheBoss ($68.18 in chips) 
Seat 5: Dihabet ($50 in chips) 
Seat 6: Kasselbanki ($40.02 in chips) 
Seat 7: Mmago24 ($81.83 in chips) 
Seat 8: bountyhun31 ($54.73 in chips) 
Seat 9: Zhud19 ($50 in chips) 
Dihabet: posts small blind $0.25
Kasselbanki: posts big blind $0.50
*** HOLE CARDS ***
Mmago24: folds 
bountyhun31: calls $0.50
Zhud19: folds 
Nestle170: folds 
bateman225: raises $0.50 to $1
Rulet345: folds 
KerilTheBoss: folds 
Dihabet: calls $0.75
Kasselbanki: calls $0.50
bountyhun31: calls $0.50
*** FLOP *** [Ks 7d Kd]
Dihabet: checks 
Kasselbanki: checks 
bountyhun31: checks 
bateman225: bets $1.50
Dihabet: folds 
Kasselbanki: folds 
bountyhun31: folds 
Uncalled bet ($1.50) returned to bateman225
bateman225 collected $3.80 from pot
bateman225: doesn't show hand 
*** SUMMARY ***
Total pot $4 | Rake $0.20 
Board [Ks 7d Kd]
Seat 1: Nestle170 folded before Flop (didn't bet)
Seat 2: bateman225 collected ($3.80)
Seat 3: Rulet345 folded before Flop (didn't bet)
Seat 4: KerilTheBoss (button) folded before Flop (didn't bet)
Seat 5: Dihabet (small blind) folded on the Flop
Seat 6: Kasselbanki (big blind) folded on the Flop
Seat 7: Mmago24 folded before Flop (didn't bet)
Seat 8: bountyhun31 folded on the Flop
Seat 9: Zhud19 folded before Flop (didn't bet)



PokerStars Hand #228685297665:  Hold'em No Limit ($0.25/$0.50 USD) - 2021/07/30 14:29:17 ET
Table 'Bok II' 9-max Seat #5 is the button
Seat 1: Nestle170 ($106.79 in chips) 
Seat 2: bateman225 ($34.49 in chips) 
Seat 3: Rulet345 ($50 in chips) 
Seat 4: KerilTheBoss ($68.18 in chips) 
Seat 5: Dihabet ($50 in chips) 
Seat 6: Kasselbanki ($39.02 in chips) 
Seat 7: Mmago24 ($81.83 in chips) 
Seat 8: bountyhun31 ($53.73 in chips) 
Seat 9: Zhud19 ($50 in chips) 
Kasselbanki: posts small blind $0.25
Mmago24: posts big blind $0.50
*** HOLE CARDS ***
bountyhun31: calls $0.50
Zhud19: folds 
Nestle170: folds 
bateman225: folds 
Rulet345: folds 
KerilTheBoss: folds 
Dihabet: raises $2 to $2.50
Kasselbanki: folds 
Mmago24: folds 
bountyhun31: calls $2
*** FLOP *** [Ah 7c 8d]
bountyhun31: bets $0.50
Dihabet: raises $2 to $2.50
bountyhun31: calls $2
*** TURN *** [Ah 7c 8d] [8s]
bountyhun31: bets $1
Dihabet: calls $1
*** RIVER *** [Ah 7c 8d 8s] [2c]
bountyhun31: checks 
Dihabet: bets $7.87
bountyhun31: folds 
Uncalled bet ($7.87) returned to Dihabet
Dihabet collected $12.11 from pot
Dihabet: doesn't show hand 
*** SUMMARY ***
Total pot $12.75 | Rake $0.64 
Board [Ah 7c 8d 8s 2c]
Seat 1: Nestle170 folded before Flop (didn't bet)
Seat 2: bateman225 folded before Flop (didn't bet)
Seat 3: Rulet345 folded before Flop (didn't bet)
Seat 4: KerilTheBoss folded before Flop (didn't bet)
Seat 5: Dihabet (button) collected ($12.11)
Seat 6: Kasselbanki (small blind) folded before Flop
Seat 7: Mmago24 (big blind) folded before Flop
Seat 8: bountyhun31 folded on the River
Seat 9: Zhud19 folded before Flop (didn't bet)



PokerStars Hand #228685319120:  Hold'em No Limit ($0.25/$0.50 USD) - 2021/07/30 14:30:07 ET
Table 'Bok II' 9-max Seat #6 is the button
Seat 1: Nestle170 ($106.79 in chips) 
Seat 2: bateman225 ($34.49 in chips) 
Seat 3: Rulet345 ($50 in chips) 
Seat 4: KerilTheBoss ($68.18 in chips) 
Seat 5: Dihabet ($56.11 in chips) 
Seat 6: Kasselbanki ($38.77 in chips) 
Seat 7: Mmago24 ($81.33 in chips) 
Seat 8: bountyhun31 ($47.73 in chips) 
Seat 9: Zhud19 ($50 in chips) 
Mmago24: posts small blind $0.25
bountyhun31: posts big blind $0.50
*** HOLE CARDS ***
Zhud19: folds 
Nestle170: folds 
Zhud19 leaves the table
bateman225: folds 
Rulet345: folds 
KerilTheBoss: folds 
Dihabet: folds 
Kasselbanki: folds 
theMacGuffin joins the table at seat #9 
Mmago24: raises $1 to $1.50
bountyhun31: calls $1
*** FLOP *** [Td 8h Ah]
Mmago24: checks 
bountyhun31: checks 
*** TURN *** [Td 8h Ah] [6c]
Mmago24: checks 
bountyhun31: checks 
*** RIVER *** [Td 8h Ah 6c] [Tc]
Mmago24: checks 
bountyhun31: checks 
*** SHOW DOWN ***
Mmago24: shows [7h 7c] (two pair, Tens and Sevens)
bountyhun31: mucks hand 
Mmago24 collected $2.85 from pot
*** SUMMARY ***
Total pot $3 | Rake $0.15 
Board [Td 8h Ah 6c Tc]
Seat 1: Nestle170 folded before Flop (didn't bet)
Seat 2: bateman225 folded before Flop (didn't bet)
Seat 3: Rulet345 folded before Flop (didn't bet)
Seat 4: KerilTheBoss folded before Flop (didn't bet)
Seat 5: Dihabet folded before Flop (didn't bet)
Seat 6: Kasselbanki (button) folded before Flop (didn't bet)
Seat 7: Mmago24 (small blind) showed [7h 7c] and won ($2.85) with two pair, Tens and Sevens
Seat 8: bountyhun31 (big blind) mucked
Seat 9: Zhud19 folded before Flop (didn't bet)



PokerStars Hand #228685339867:  Hold'em No Limit ($0.25/$0.50 USD) - 2021/07/30 14:30:56 ET
Table 'Bok II' 9-max Seat #7 is the button
Seat 1: Nestle170 ($106.79 in chips) 
Seat 2: bateman225 ($34.49 in chips) 
Seat 3: Rulet345 ($50 in chips) 
Seat 4: KerilTheBoss ($68.18 in chips) 
Seat 5: Dihabet ($56.11 in chips) 
Seat 6: Kasselbanki ($38.77 in chips) 
Seat 7: Mmago24 ($82.68 in chips) 
Seat 8: bountyhun31 ($46.23 in chips) 
Seat 9: theMacGuffin ($50 in chips) 
bountyhun31: posts small blind $0.25
theMacGuffin: posts big blind $0.50
*** HOLE CARDS ***
Nestle170: folds 
bateman225: folds 
Rulet345: folds 
KerilTheBoss: folds 
Dihabet: folds 
Kasselbanki: raises $1 to $1.50
Mmago24: raises $3 to $4.50
bountyhun31: calls $4.25
theMacGuffin: folds 
Kasselbanki: calls $3
*** FLOP *** [9s Th 9c]
bountyhun31: bets $41.73 and is all-in
Kasselbanki: folds 
Mmago24: folds 
Uncalled bet ($41.73) returned to bountyhun31
bountyhun31 collected $13.30 from pot
bountyhun31: doesn't show hand 
*** SUMMARY ***
Total pot $14 | Rake $0.70 
Board [9s Th 9c]
Seat 1: Nestle170 folded before Flop (didn't bet)
Seat 2: bateman225 folded before Flop (didn't bet)
Seat 3: Rulet345 folded before Flop (didn't bet)
Seat 4: KerilTheBoss folded before Flop (didn't bet)
Seat 5: Dihabet folded before Flop (didn't bet)
Seat 6: Kasselbanki folded on the Flop
Seat 7: Mmago24 (button) folded on the Flop
Seat 8: bountyhun31 (small blind) collected ($13.30)
Seat 9: theMacGuffin (big blind) folded before Flop



PokerStars Hand #228685355559:  Hold'em No Limit ($0.25/$0.50 USD) - 2021/07/30 14:31:33 ET
Table 'Bok II' 9-max Seat #8 is the button
Seat 1: Nestle170 ($106.79 in chips) 
Seat 2: bateman225 ($34.49 in chips) 
Seat 3: Rulet345 ($50 in chips) 
Seat 4: KerilTheBoss ($68.18 in chips) 
Seat 5: Dihabet ($56.11 in chips) 
Seat 6: Kasselbanki ($34.27 in chips) 
Seat 7: Mmago24 ($78.18 in chips) 
Seat 8: bountyhun31 ($55.03 in chips) 
Seat 9: theMacGuffin ($49.50 in chips) 
theMacGuffin: posts small blind $0.25
Nestle170: posts big blind $0.50
*** HOLE CARDS ***
bateman225: folds 
Rulet345: folds 
KerilTheBoss has timed out
KerilTheBoss: folds 
Dihabet: folds 
Kasselbanki: folds 
Mmago24: folds 
bountyhun31: calls $0.50
theMacGuffin: raises $1.50 to $2
Nestle170: calls $1.50
bountyhun31: calls $1.50
*** FLOP *** [Qd Kc 9d]
theMacGuffin: bets $2.85
Nestle170: calls $2.85
bountyhun31: calls $2.85
*** TURN *** [Qd Kc 9d] [6c]
theMacGuffin: checks 
Nestle170: checks 
bountyhun31: checks 
*** RIVER *** [Qd Kc 9d 6c] [7h]
theMacGuffin: checks 
Nestle170: checks 
bountyhun31: checks 
*** SHOW DOWN ***
theMacGuffin: shows [Kd Jh] (a pair of Kings)
Nestle170: mucks hand 
bountyhun31: mucks hand 
theMacGuffin collected $13.82 from pot
*** SUMMARY ***
Total pot $14.55 | Rake $0.73 
Board [Qd Kc 9d 6c 7h]
Seat 1: Nestle170 (big blind) mucked
Seat 2: bateman225 folded before Flop (didn't bet)
Seat 3: Rulet345 folded before Flop (didn't bet)
Seat 4: KerilTheBoss folded before Flop (didn't bet)
Seat 5: Dihabet folded before Flop (didn't bet)
Seat 6: Kasselbanki folded before Flop (didn't bet)
Seat 7: Mmago24 folded before Flop (didn't bet)
Seat 8: bountyhun31 (button) mucked
Seat 9: theMacGuffin (small blind) showed [Kd Jh] and won ($13.82) with a pair of Kings



PokerStars Hand #228685377014:  Hold'em No Limit ($0.25/$0.50 USD) - 2021/07/30 14:32:23 ET
Table 'Bok II' 9-max Seat #9 is the button
Seat 1: Nestle170 ($101.94 in chips) 
Seat 2: bateman225 ($34.49 in chips) 
Seat 3: Rulet345 ($50 in chips) 
Seat 4: KerilTheBoss ($68.18 in chips) 
Seat 5: Dihabet ($56.11 in chips) 
Seat 6: Kasselbanki ($34.27 in chips) 
Seat 7: Mmago24 ($78.18 in chips) 
Seat 8: bountyhun31 ($50.18 in chips) 
Seat 9: theMacGuffin ($58.47 in chips) 
Nestle170: posts small blind $0.25
bateman225: posts big blind $0.50
*** HOLE CARDS ***
Rulet345: folds 
KerilTheBoss: folds 
Dihabet: folds 
Kasselbanki: folds 
Mmago24: folds 
bountyhun31: calls $0.50
theMacGuffin: raises $1.50 to $2
Nestle170: folds 
bateman225: calls $1.50
bountyhun31: calls $1.50
*** FLOP *** [6c 2c 4c]
bateman225: checks 
bountyhun31: checks 
theMacGuffin: bets $2.97
bateman225: raises $3.97 to $6.94
bountyhun31: folds 
theMacGuffin: folds 
Uncalled bet ($3.97) returned to bateman225
bateman225 collected $11.58 from pot
bateman225: doesn't show hand 
*** SUMMARY ***
Total pot $12.19 | Rake $0.61 
Board [6c 2c 4c]
Seat 1: Nestle170 (small blind) folded before Flop
Seat 2: bateman225 (big blind) collected ($11.58)
Seat 3: Rulet345 folded before Flop (didn't bet)
Seat 4: KerilTheBoss folded before Flop (didn't bet)
Seat 5: Dihabet folded before Flop (didn't bet)
Seat 6: Kasselbanki folded before Flop (didn't bet)
Seat 7: Mmago24 folded before Flop (didn't bet)
Seat 8: bountyhun31 folded on the Flop
Seat 9: theMacGuffin (button) folded on the Flop



PokerStars Hand #228685393192:  Hold'em No Limit ($0.25/$0.50 USD) - 2021/07/30 14:33:01 ET
Table 'Bok II' 9-max Seat #1 is the button
Seat 1: Nestle170 ($101.69 in chips) 
Seat 2: bateman225 ($41.10 in chips) 
Seat 3: Rulet345 ($50 in chips) 
Seat 4: KerilTheBoss ($68.18 in chips) 
Seat 5: Dihabet ($56.11 in chips) 
Seat 6: Kasselbanki ($34.27 in chips) 
Seat 7: Mmago24 ($78.18 in chips) 
Seat 8: bountyhun31 ($48.18 in chips) 
Seat 9: theMacGuffin ($53.50 in chips) 
bateman225: posts small blind $0.25
Rulet345: posts big blind $0.50
*** HOLE CARDS ***
KerilTheBoss has timed out
KerilTheBoss: folds 
Dihabet: folds 
Kasselbanki: raises $0.50 to $1
Mmago24: folds 
bountyhun31: folds 
theMacGuffin: calls $1
Nestle170: folds 
bateman225: folds 
Rulet345: folds 
*** FLOP *** [Ks 9c Kc]
Kasselbanki: checks 
theMacGuffin: bets $1.30
Kasselbanki: calls $1.30
*** TURN *** [Ks 9c Kc] [Kh]
Kasselbanki: checks 
theMacGuffin: checks 
*** RIVER *** [Ks 9c Kc Kh] [9s]
Kasselbanki: checks 
theMacGuffin: checks 
*** SHOW DOWN ***
Kasselbanki: shows [Ac Qs] (a full house, Kings full of Nines)
theMacGuffin: shows [Td Qh] (a full house, Kings full of Nines)
Kasselbanki collected $2.51 from pot
theMacGuffin collected $2.54 from pot
*** SUMMARY ***
Total pot $5.35 | Rake $0.30 
Board [Ks 9c Kc Kh 9s]
Seat 1: Nestle170 (button) folded before Flop (didn't bet)
Seat 2: bateman225 (small blind) folded before Flop
Seat 3: Rulet345 (big blind) folded before Flop
Seat 4: KerilTheBoss folded before Flop (didn't bet)
Seat 5: Dihabet folded before Flop (didn't bet)
Seat 6: Kasselbanki showed [Ac Qs] and won ($2.51) with a full house, Kings full of Nines
Seat 7: Mmago24 folded before Flop (didn't bet)
Seat 8: bountyhun31 folded before Flop (didn't bet)
Seat 9: theMacGuffin showed [Td Qh] and won ($2.54) with a full house, Kings full of Nines



PokerStars Hand #228685415623:  Hold'em No Limit ($0.25/$0.50 USD) - 2021/07/30 14:33:53 ET
Table 'Bok II' 9-max Seat #2 is the button
Seat 1: Nestle170 ($101.69 in chips) 
Seat 2: bateman225 ($40.85 in chips) 
Seat 3: Rulet345 ($50 in chips) 
Seat 4: KerilTheBoss ($68.18 in chips) 
Seat 5: Dihabet ($56.11 in chips) 
Seat 6: Kasselbanki ($34.48 in chips) 
Seat 7: Mmago24 ($78.18 in chips) 
Seat 8: bountyhun31 ($48.18 in chips) 
Seat 9: theMacGuffin ($53.74 in chips) 
Rulet345: posts small blind $0.25
KerilTheBoss: posts big blind $0.50
*** HOLE CARDS ***
Dihabet: folds 
Kasselbanki: folds 
Mmago24: raises $0.72 to $1.22
bountyhun31: folds 
theMacGuffin: folds 
Nestle170: folds 
bateman225: folds 
Rulet345: folds 
KerilTheBoss: folds 
Uncalled bet ($0.72) returned to Mmago24
Mmago24 collected $1.25 from pot
Mmago24: doesn't show hand 
*** SUMMARY ***
Total pot $1.25 | Rake $0 
Seat 1: Nestle170 folded before Flop (didn't bet)
Seat 2: bateman225 (button) folded before Flop (didn't bet)
Seat 3: Rulet345 (small blind) folded before Flop
Seat 4: KerilTheBoss (big blind) folded before Flop
Seat 5: Dihabet folded before Flop (didn't bet)
Seat 6: Kasselbanki folded before Flop (didn't bet)
Seat 7: Mmago24 collected ($1.25)
Seat 8: bountyhun31 folded before Flop (didn't bet)
Seat 9: theMacGuffin folded before Flop (didn't bet)



PokerStars Hand #228685422634:  Hold'em No Limit ($0.25/$0.50 USD) - 2021/07/30 14:34:10 ET
Table 'Bok II' 9-max Seat #3 is the button
Seat 1: Nestle170 ($101.69 in chips) 
Seat 2: bateman225 ($40.85 in chips) 
Seat 3: Rulet345 ($50 in chips) 
Seat 4: KerilTheBoss ($67.68 in chips) 
Seat 5: Dihabet ($56.11 in chips) 
Seat 6: Kasselbanki ($34.48 in chips) 
Seat 7: Mmago24 ($78.93 in chips) 
Seat 8: bountyhun31 ($48.18 in chips) 
Seat 9: theMacGuffin ($53.74 in chips) 
KerilTheBoss: posts small blind $0.25
Dihabet: posts big blind $0.50
*** HOLE CARDS ***
Kasselbanki: raises $0.50 to $1
Mmago24: folds 
bountyhun31: calls $1
theMacGuffin: folds 
Nestle170: folds 
bateman225: folds 
Rulet345: folds 
KerilTheBoss: folds 
Dihabet: folds 
*** FLOP *** [8d 6c 4h]
Kasselbanki: checks 
bountyhun31: checks 
*** TURN *** [8d 6c 4h] [As]
Kasselbanki: checks 
bountyhun31: bets $1
Kasselbanki: folds 
Uncalled bet ($1) returned to bountyhun31
bountyhun31 collected $2.61 from pot
bountyhun31: doesn't show hand 
*** SUMMARY ***
Total pot $2.75 | Rake $0.14 
Board [8d 6c 4h As]
Seat 1: Nestle170 folded before Flop (didn't bet)
Seat 2: bateman225 folded before Flop (didn't bet)
Seat 3: Rulet345 (button) folded before Flop (didn't bet)
Seat 4: KerilTheBoss (small blind) folded before Flop
Seat 5: Dihabet (big blind) folded before Flop
Seat 6: Kasselbanki folded on the Turn
Seat 7: Mmago24 folded before Flop (didn't bet)
Seat 8: bountyhun31 collected ($2.61)
Seat 9: theMacGuffin folded before Flop (didn't bet)



PokerStars Hand #228685434009:  Hold'em No Limit ($0.25/$0.50 USD) - 2021/07/30 14:34:37 ET
Table 'Bok II' 9-max Seat #4 is the button
Seat 1: Nestle170 ($101.69 in chips) 
Seat 2: bateman225 ($40.85 in chips) 
Seat 3: Rulet345 ($50 in chips) 
Seat 4: KerilTheBoss ($67.43 in chips) 
Seat 5: Dihabet ($55.61 in chips) 
Seat 6: Kasselbanki ($33.48 in chips) 
Seat 7: Mmago24 ($78.93 in chips) 
Seat 8: bountyhun31 ($49.79 in chips) 
Seat 9: theMacGuffin ($53.74 in chips) 
Dihabet: posts small blind $0.25
Kasselbanki: posts big blind $0.50
*** HOLE CARDS ***
Mmago24: folds 
bountyhun31: raises $1 to $1.50
theMacGuffin: folds 
Nestle170: folds 
bateman225: folds 
Rulet345: folds 
KerilTheBoss: folds 
Dihabet: folds 
Kasselbanki: folds 
Uncalled bet ($1) returned to bountyhun31
bountyhun31 collected $1.25 from pot
bountyhun31: doesn't show hand 
*** SUMMARY ***
Total pot $1.25 | Rake $0 
Seat 1: Nestle170 folded before Flop (didn't bet)
Seat 2: bateman225 folded before Flop (didn't bet)
Seat 3: Rulet345 folded before Flop (didn't bet)
Seat 4: KerilTheBoss (button) folded before Flop (didn't bet)
Seat 5: Dihabet (small blind) folded before Flop
Seat 6: Kasselbanki (big blind) folded before Flop
Seat 7: Mmago24 folded before Flop (didn't bet)
Seat 8: bountyhun31 collected ($1.25)
Seat 9: theMacGuffin folded before Flop (didn't bet)



PokerStars Hand #228685442079:  Hold'em No Limit ($0.25/$0.50 USD) - 2021/07/30 14:34:56 ET
Table 'Bok II' 9-max Seat #5 is the button
Seat 1: Nestle170 ($101.69 in chips) 
Seat 2: bateman225 ($40.85 in chips) 
Seat 3: Rulet345 ($50 in chips) 
Seat 4: KerilTheBoss ($67.43 in chips) 
Seat 5: Dihabet ($55.36 in chips) 
Seat 6: Kasselbanki ($32.98 in chips) 
Seat 7: Mmago24 ($78.93 in chips) 
Seat 8: bountyhun31 ($50.54 in chips) 
Seat 9: theMacGuffin ($53.74 in chips) 
Kasselbanki: posts small blind $0.25
Mmago24: posts big blind $0.50
*** HOLE CARDS ***
bountyhun31: calls $0.50
theMacGuffin: folds 
Nestle170: folds 
bateman225: raises $0.50 to $1
Rulet345: folds 
KerilTheBoss: folds 
Dihabet: folds 
Kasselbanki: folds 
Mmago24: folds 
bountyhun31: calls $0.50
*** FLOP *** [9s 6d Kd]
bountyhun31: checks 
bateman225: bets $1
bountyhun31: folds 
Uncalled bet ($1) returned to bateman225
bateman225 collected $2.61 from pot
bateman225: doesn't show hand 
*** SUMMARY ***
Total pot $2.75 | Rake $0.14 
Board [9s 6d Kd]
Seat 1: Nestle170 folded before Flop (didn't bet)
Seat 2: bateman225 collected ($2.61)
Seat 3: Rulet345 folded before Flop (didn't bet)
Seat 4: KerilTheBoss folded before Flop (didn't bet)
Seat 5: Dihabet (button) folded before Flop (didn't bet)
Seat 6: Kasselbanki (small blind) folded before Flop
Seat 7: Mmago24 (big blind) folded before Flop
Seat 8: bountyhun31 folded on the Flop
Seat 9: theMacGuffin folded before Flop (didn't bet)



PokerStars Hand #228685455952:  Hold'em No Limit ($0.25/$0.50 USD) - 2021/07/30 14:35:29 ET
Table 'Bok II' 9-max Seat #6 is the button
Seat 1: Nestle170 ($101.69 in chips) 
Seat 2: bateman225 ($42.46 in chips) 
Seat 3: Rulet345 ($50 in chips) 
Seat 4: KerilTheBoss ($67.43 in chips) 
Seat 5: Dihabet ($55.36 in chips) 
Seat 6: Kasselbanki ($32.73 in chips) 
Seat 7: Mmago24 ($78.43 in chips) 
Seat 8: bountyhun31 ($49.54 in chips) 
Seat 9: theMacGuffin ($53.74 in chips) 
Mmago24: posts small blind $0.25
bountyhun31: posts big blind $0.50
*** HOLE CARDS ***
theMacGuffin: folds 
Nestle170: folds 
bateman225: calls $0.50
Rulet345: folds 
KerilTheBoss: folds 
Dihabet: folds 
Kasselbanki: folds 
Mmago24: raises $2 to $2.50
bountyhun31: folds 
bateman225: calls $2
*** FLOP *** [7h 4d Qh]
Mmago24: bets $3.48
bateman225: folds 
Uncalled bet ($3.48) returned to Mmago24
Mmago24 collected $5.22 from pot
Mmago24: doesn't show hand 
*** SUMMARY ***
Total pot $5.50 | Rake $0.28 
Board [7h 4d Qh]
Seat 1: Nestle170 folded before Flop (didn't bet)
Seat 2: bateman225 folded on the Flop
Seat 3: Rulet345 folded before Flop (didn't bet)
Seat 4: KerilTheBoss folded before Flop (didn't bet)
Seat 5: Dihabet folded before Flop (didn't bet)
Seat 6: Kasselbanki (button) folded before Flop (didn't bet)
Seat 7: Mmago24 (small blind) collected ($5.22)
Seat 8: bountyhun31 (big blind) folded before Flop
Seat 9: theMacGuffin folded before Flop (didn't bet)



PokerStars Hand #228685475684:  Hold'em No Limit ($0.25/$0.50 USD) - 2021/07/30 14:36:16 ET
Table 'Bok II' 9-max Seat #7 is the button
Seat 1: Nestle170 ($101.69 in chips) 
Seat 2: bateman225 ($39.96 in chips) 
Seat 3: Rulet345 ($50 in chips) 
Seat 4: KerilTheBoss ($67.43 in chips) 
Seat 5: Dihabet ($55.36 in chips) 
Seat 6: Kasselbanki ($32.73 in chips) 
Seat 7: Mmago24 ($81.15 in chips) 
Seat 8: bountyhun31 ($49.04 in chips) 
Seat 9: theMacGuffin ($53.74 in chips) 
bountyhun31: posts small blind $0.25
theMacGuffin: posts big blind $0.50
*** HOLE CARDS ***
Nestle170: folds 
bateman225: folds 
Rulet345: folds 
KerilTheBoss: folds 
Dihabet: raises $0.85 to $1.35
Kasselbanki: calls $1.35
Mmago24: folds 
bountyhun31: folds 
theMacGuffin: folds 
*** FLOP *** [Td Js 9c]
Dihabet: checks 
Kasselbanki: bets $1.50
Dihabet: folds 
Uncalled bet ($1.50) returned to Kasselbanki
theMacGuffin leaves the table
Kasselbanki collected $3.24 from pot
Kasselbanki: doesn't show hand 
*** SUMMARY ***
Total pot $3.45 | Rake $0.21 
Board [Td Js 9c]
Seat 1: Nestle170 folded before Flop (didn't bet)
Seat 2: bateman225 folded before Flop (didn't bet)
Seat 3: Rulet345 folded before Flop (didn't bet)
Seat 4: KerilTheBoss folded before Flop (didn't bet)
Seat 5: Dihabet folded on the Flop
Seat 6: Kasselbanki collected ($3.24)
Seat 7: Mmago24 (button) folded before Flop (didn't bet)
Seat 8: bountyhun31 (small blind) folded before Flop
Seat 9: theMacGuffin (big blind) folded before Flop



PokerStars Hand #228685491055:  Hold'em No Limit ($0.25/$0.50 USD) - 2021/07/30 14:36:52 ET
Table 'Bok II' 9-max Seat #8 is the button
Seat 1: Nestle170 ($101.69 in chips) 
Seat 2: bateman225 ($39.96 in chips) 
Seat 3: Rulet345 ($50 in chips) 
Seat 4: KerilTheBoss ($67.43 in chips) 
Seat 5: Dihabet ($54.01 in chips) 
Seat 6: Kasselbanki ($34.62 in chips) 
Seat 7: Mmago24 ($81.15 in chips) 
Seat 8: bountyhun31 ($48.79 in chips) 
Nestle170: posts small blind $0.25
bateman225: posts big blind $0.50
*** HOLE CARDS ***
Rulet345: folds 
KerilTheBoss: folds 
Dihabet: folds 
Kasselbanki: folds 
Mmago24: folds 
bountyhun31: calls $0.50
Nestle170: folds 
bateman225: checks 
*** FLOP *** [4h Td 4d]
bateman225: checks 
bountyhun31: bets $0.50
bateman225: folds 
Uncalled bet ($0.50) returned to bountyhun31
bountyhun31 collected $1.19 from pot
bountyhun31: doesn't show hand 
*** SUMMARY ***
Total pot $1.25 | Rake $0.06 
Board [4h Td 4d]
Seat 1: Nestle170 (small blind) folded before Flop
Seat 2: bateman225 (big blind) folded on the Flop
Seat 3: Rulet345 folded before Flop (didn't bet)
Seat 4: KerilTheBoss folded before Flop (didn't bet)
Seat 5: Dihabet folded before Flop (didn't bet)
Seat 6: Kasselbanki folded before Flop (didn't bet)
Seat 7: Mmago24 folded before Flop (didn't bet)
Seat 8: bountyhun31 (button) collected ($1.19)



PokerStars Hand #228685501510:  Hold'em No Limit ($0.25/$0.50 USD) - 2021/07/30 14:37:17 ET
Table 'Bok II' 9-max Seat #1 is the button
Seat 1: Nestle170 ($101.44 in chips) 
Seat 2: bateman225 ($39.46 in chips) 
Seat 3: Rulet345 ($50 in chips) 
Seat 4: KerilTheBoss ($67.43 in chips) 
Seat 5: Dihabet ($54.01 in chips) 
Seat 6: Kasselbanki ($34.62 in chips) 
Seat 7: Mmago24 ($81.15 in chips) 
Seat 8: bountyhun31 ($49.48 in chips) 
bateman225: posts small blind $0.25
Rulet345: posts big blind $0.50
*** HOLE CARDS ***
KerilTheBoss: folds 
Dihabet: folds 
Infinities4 joins the table at seat #9 
Kasselbanki: folds 
Mmago24: folds 
bountyhun31: calls $0.50
Nestle170: folds 
bateman225: calls $0.25
Rulet345: checks 
*** FLOP *** [Td Qd Jh]
bateman225: checks 
Rulet345: checks 
bountyhun31: bets $0.50
bateman225: folds 
Rulet345: calls $0.50
*** TURN *** [Td Qd Jh] [6c]
Rulet345: checks 
bountyhun31: bets $0.50
Rulet345: folds 
Uncalled bet ($0.50) returned to bountyhun31
bountyhun31 collected $2.38 from pot
bountyhun31: doesn't show hand 
*** SUMMARY ***
Total pot $2.50 | Rake $0.12 
Board [Td Qd Jh 6c]
Seat 1: Nestle170 (button) folded before Flop (didn't bet)
Seat 2: bateman225 (small blind) folded on the Flop
Seat 3: Rulet345 (big blind) folded on the Turn
Seat 4: KerilTheBoss folded before Flop (didn't bet)
Seat 5: Dihabet folded before Flop (didn't bet)
Seat 6: Kasselbanki folded before Flop (didn't bet)
Seat 7: Mmago24 folded before Flop (didn't bet)
Seat 8: bountyhun31 collected ($2.38)



PokerStars Hand #228685520472:  Hold'em No Limit ($0.25/$0.50 USD) - 2021/07/30 14:38:01 ET
Table 'Bok II' 9-max Seat #2 is the button
Seat 1: Nestle170 ($101.44 in chips) 
Seat 2: bateman225 ($38.96 in chips) 
Seat 3: Rulet345 ($50 in chips) 
Seat 4: KerilTheBoss ($67.43 in chips) 
Seat 5: Dihabet ($54.01 in chips) 
Seat 6: Kasselbanki ($34.62 in chips) 
Seat 7: Mmago24 ($81.15 in chips) 
Seat 8: bountyhun31 ($50.86 in chips) 
Rulet345: posts small blind $0.25
KerilTheBoss: posts big blind $0.50
Infinities4: sits out 
*** HOLE CARDS ***
Dihabet: folds 
Kasselbanki: folds 
Mmago24: folds 
bountyhun31: calls $0.50
Nestle170: folds 
bateman225: calls $0.50
Rulet345: folds 
KerilTheBoss: checks 
*** FLOP *** [9c 7d 2d]
KerilTheBoss: checks 
bountyhun31: checks 
bateman225: bets $0.50
KerilTheBoss: folds 
bountyhun31: folds 
Uncalled bet ($0.50) returned to bateman225
bateman225 collected $1.66 from pot
bateman225: doesn't show hand 
*** SUMMARY ***
Total pot $1.75 | Rake $0.09 
Board [9c 7d 2d]
Seat 1: Nestle170 folded before Flop (didn't bet)
Seat 2: bateman225 (button) collected ($1.66)
Seat 3: Rulet345 (small blind) folded before Flop
Seat 4: KerilTheBoss (big blind) folded on the Flop
Seat 5: Dihabet folded before Flop (didn't bet)
Seat 6: Kasselbanki folded before Flop (didn't bet)
Seat 7: Mmago24 folded before Flop (didn't bet)
Seat 8: bountyhun31 folded on the Flop



PokerStars Hand #228685543910:  Hold'em No Limit ($0.25/$0.50 USD) - 2021/07/30 14:38:56 ET
Table 'Bok II' 9-max Seat #3 is the button
Seat 1: Nestle170 ($101.44 in chips) 
Seat 2: bateman225 ($40.12 in chips) 
Seat 3: Rulet345 ($50 in chips) 
Seat 4: KerilTheBoss ($66.93 in chips) 
Seat 5: Dihabet ($54.01 in chips) 
Seat 6: Kasselbanki ($34.62 in chips) 
Seat 7: Mmago24 ($81.15 in chips) 
Seat 8: bountyhun31 ($50.36 in chips) 
KerilTheBoss: posts small blind $0.25
Dihabet: posts big blind $0.50
Infinities4: sits out 
*** HOLE CARDS ***
Kasselbanki: folds 
Mmago24: folds 
bountyhun31: folds 
Nestle170: folds 
bateman225: folds 
Rulet345: folds 
KerilTheBoss: raises $1 to $1.50
Dihabet: calls $1
*** FLOP *** [Qs 8c Ah]
KerilTheBoss: checks 
Dihabet: checks 
*** TURN *** [Qs 8c Ah] [9d]
KerilTheBoss: bets $0.94
Dihabet: folds 
Uncalled bet ($0.94) returned to KerilTheBoss
KerilTheBoss collected $2.85 from pot
KerilTheBoss: doesn't show hand 
*** SUMMARY ***
Total pot $3 | Rake $0.15 
Board [Qs 8c Ah 9d]
Seat 1: Nestle170 folded before Flop (didn't bet)
Seat 2: bateman225 folded before Flop (didn't bet)
Seat 3: Rulet345 (button) folded before Flop (didn't bet)
Seat 4: KerilTheBoss (small blind) collected ($2.85)
Seat 5: Dihabet (big blind) folded on the Turn
Seat 6: Kasselbanki folded before Flop (didn't bet)
Seat 7: Mmago24 folded before Flop (didn't bet)
Seat 8: bountyhun31 folded before Flop (didn't bet)



PokerStars Hand #228685561375:  Hold'em No Limit ($0.25/$0.50 USD) - 2021/07/30 14:39:36 ET
Table 'Bok II' 9-max Seat #4 is the button
Seat 1: Nestle170 ($101.44 in chips) 
Seat 2: bateman225 ($40.12 in chips) 
Seat 3: Rulet345 ($50 in chips) 
Seat 4: KerilTheBoss ($68.28 in chips) 
Seat 5: Dihabet ($52.51 in chips) 
Seat 6: Kasselbanki ($34.62 in chips) 
Seat 7: Mmago24 ($81.15 in chips) 
Seat 8: bountyhun31 ($50.36 in chips) 
Dihabet: posts small blind $0.25
Kasselbanki: posts big blind $0.50
Infinities4: sits out 
*** HOLE CARDS ***
Mmago24: raises $0.72 to $1.22
bountyhun31: calls $1.22
Nestle170: folds 
bateman225: folds 
Rulet345: folds 
KerilTheBoss: folds 
Dihabet: raises $4.78 to $6
Kasselbanki: folds 
Mmago24: calls $4.78
bountyhun31: folds 
*** FLOP *** [Kc 2s Ts]
Dihabet: checks 
Mmago24: checks 
*** TURN *** [Kc 2s Ts] [6h]
Dihabet: checks 
Mmago24: checks 
*** RIVER *** [Kc 2s Ts 6h] [Td]
Dihabet: bets $3.91
Mmago24: calls $3.91
*** SHOW DOWN ***
Dihabet: shows [Jd Jc] (two pair, Jacks and Tens)
Mmago24: mucks hand 
Dihabet collected $20.46 from pot
*** SUMMARY ***
Total pot $21.54 | Rake $1.08 
Board [Kc 2s Ts 6h Td]
Seat 1: Nestle170 folded before Flop (didn't bet)
Seat 2: bateman225 folded before Flop (didn't bet)
Seat 3: Rulet345 folded before Flop (didn't bet)
Seat 4: KerilTheBoss (button) folded before Flop (didn't bet)
Seat 5: Dihabet (small blind) showed [Jd Jc] and won ($20.46) with two pair, Jacks and Tens
Seat 6: Kasselbanki (big blind) folded before Flop
Seat 7: Mmago24 mucked
Seat 8: bountyhun31 folded before Flop



PokerStars Hand #228685589705:  Hold'em No Limit ($0.25/$0.50 USD) - 2021/07/30 14:40:42 ET
Table 'Bok II' 9-max Seat #5 is the button
Seat 1: Nestle170 ($101.44 in chips) 
Seat 2: bateman225 ($40.12 in chips) 
Seat 3: Rulet345 ($50 in chips) 
Seat 4: KerilTheBoss ($68.28 in chips) 
Seat 5: Dihabet ($63.06 in chips) 
Seat 6: Kasselbanki ($34.12 in chips) 
Seat 7: Mmago24 ($71.24 in chips) 
Seat 8: bountyhun31 ($49.14 in chips) 
Kasselbanki: posts small blind $0.25
Mmago24: posts big blind $0.50
Infinities4: sits out 
*** HOLE CARDS ***
bountyhun31: folds 
Nestle170: raises $1 to $1.50
bateman225: folds 
Rulet345: folds 
KerilTheBoss: folds 
Dihabet: calls $1.50
Kasselbanki: folds 
Mmago24: folds 
*** FLOP *** [7c 3s Ks]
Nestle170: checks 
Dihabet: checks 
*** TURN *** [7c 3s Ks] [8h]
Nestle170: checks 
Dihabet: bets $1.78
Nestle170: raises $3.56 to $5.34
Dihabet: folds 
Uncalled bet ($3.56) returned to Nestle170
Nestle170 collected $6.94 from pot
Nestle170: doesn't show hand 
*** SUMMARY ***
Total pot $7.31 | Rake $0.37 
Board [7c 3s Ks 8h]
Seat 1: Nestle170 collected ($6.94)
Seat 2: bateman225 folded before Flop (didn't bet)
Seat 3: Rulet345 folded before Flop (didn't bet)
Seat 4: KerilTheBoss folded before Flop (didn't bet)
Seat 5: Dihabet (button) folded on the Turn
Seat 6: Kasselbanki (small blind) folded before Flop
Seat 7: Mmago24 (big blind) folded before Flop
Seat 8: bountyhun31 folded before Flop (didn't bet)



PokerStars Hand #228685636336:  Hold'em No Limit ($0.25/$0.50 USD) - 2021/07/30 14:42:32 ET
Table 'Bok II' 9-max Seat #6 is the button
Seat 1: Nestle170 ($105.10 in chips) 
Seat 2: bateman225 ($40.12 in chips) 
Seat 3: Rulet345 ($50 in chips) 
Seat 4: KerilTheBoss ($68.28 in chips) 
Seat 5: Dihabet ($59.78 in chips) 
Seat 6: Kasselbanki ($33.87 in chips) 
Seat 7: Mmago24 ($70.74 in chips) 
Seat 8: bountyhun31 ($49.14 in chips) 
Mmago24: posts small blind $0.25
bountyhun31: posts big blind $0.50
Infinities4: sits out 
*** HOLE CARDS ***
Nestle170: folds 
bateman225: folds 
Rulet345: folds 
KerilTheBoss: raises $1 to $1.50
Dihabet: folds 
Kasselbanki: folds 
Mmago24: folds 
bountyhun31: folds 
Uncalled bet ($1) returned to KerilTheBoss
KerilTheBoss collected $1.25 from pot
KerilTheBoss: doesn't show hand 
*** SUMMARY ***
Total pot $1.25 | Rake $0 
Seat 1: Nestle170 folded before Flop (didn't bet)
Seat 2: bateman225 folded before Flop (didn't bet)
Seat 3: Rulet345 folded before Flop (didn't bet)
Seat 4: KerilTheBoss collected ($1.25)
Seat 5: Dihabet folded before Flop (didn't bet)
Seat 6: Kasselbanki (button) folded before Flop (didn't bet)
Seat 7: Mmago24 (small blind) folded before Flop
Seat 8: bountyhun31 (big blind) folded before Flop



PokerStars Hand #228685643269:  Hold'em No Limit ($0.25/$0.50 USD) - 2021/07/30 14:42:48 ET
Table 'Bok II' 9-max Seat #7 is the button
Seat 1: Nestle170 ($105.10 in chips) 
Seat 2: bateman225 ($40.12 in chips) 
Seat 3: Rulet345 ($50 in chips) 
Seat 4: KerilTheBoss ($69.03 in chips) 
Seat 5: Dihabet ($59.78 in chips) 
Seat 6: Kasselbanki ($33.87 in chips) 
Seat 7: Mmago24 ($70.49 in chips) 
Seat 8: bountyhun31 ($48.64 in chips) 
Seat 9: Infinities4 ($50 in chips) 
bountyhun31: posts small blind $0.25
Infinities4: posts big blind $0.50
*** HOLE CARDS ***
Nestle170: folds 
bateman225: raises $1 to $1.50
Rulet345: folds 
KerilTheBoss: folds 
Dihabet: folds 
Kasselbanki: calls $1.50
Mmago24: folds 
bountyhun31: calls $1.25
Infinities4: folds 
*** FLOP *** [Ac 3h 8s]
bountyhun31: bets $0.50
bateman225: raises $1.50 to $2
Kasselbanki: folds 
bountyhun31: calls $1.50
*** TURN *** [Ac 3h 8s] [6d]
bountyhun31: bets $0.50
bateman225: raises $2.50 to $3
bountyhun31: folds 
Uncalled bet ($2.50) returned to bateman225
bateman225 collected $9.50 from pot
bateman225: doesn't show hand 
*** SUMMARY ***
Total pot $10 | Rake $0.50 
Board [Ac 3h 8s 6d]
Seat 1: Nestle170 folded before Flop (didn't bet)
Seat 2: bateman225 collected ($9.50)
Seat 3: Rulet345 folded before Flop (didn't bet)
Seat 4: KerilTheBoss folded before Flop (didn't bet)
Seat 5: Dihabet folded before Flop (didn't bet)
Seat 6: Kasselbanki folded on the Flop
Seat 7: Mmago24 (button) folded before Flop (didn't bet)
Seat 8: bountyhun31 (small blind) folded on the Turn
Seat 9: Infinities4 (big blind) folded before Flop



PokerStars Hand #228685661095:  Hold'em No Limit ($0.25/$0.50 USD) - 2021/07/30 14:43:29 ET
Table 'Bok II' 9-max Seat #8 is the button
Seat 1: Nestle170 ($105.10 in chips) 
Seat 2: bateman225 ($45.62 in chips) 
Seat 3: Rulet345 ($50 in chips) 
Seat 4: KerilTheBoss ($69.03 in chips) 
Seat 5: Dihabet ($59.78 in chips) 
Seat 6: Kasselbanki ($32.37 in chips) 
Seat 7: Mmago24 ($70.49 in chips) 
Seat 8: bountyhun31 ($44.64 in chips) 
Seat 9: Infinities4 ($50 in chips) 
Infinities4: posts small blind $0.25
Nestle170: posts big blind $0.50
*** HOLE CARDS ***
bateman225: folds 
Rulet345: folds 
KerilTheBoss: folds 
Dihabet: folds 
Kasselbanki: folds 
Mmago24: folds 
bountyhun31: calls $0.50
Infinities4: raises $1.50 to $2
Nestle170: folds 
bountyhun31: calls $1.50
*** FLOP *** [6s 9c As]
Infinities4: bets $1.75
bountyhun31: calls $1.75
*** TURN *** [6s 9c As] [8d]
Infinities4: checks 
bountyhun31: checks 
*** RIVER *** [6s 9c As 8d] [9h]
Infinities4: checks 
bountyhun31: checks 
*** SHOW DOWN ***
Infinities4: shows [2c 2d] (two pair, Nines and Deuces)
bountyhun31: mucks hand 
Infinities4 collected $7.60 from pot
*** SUMMARY ***
Total pot $8 | Rake $0.40 
Board [6s 9c As 8d 9h]
Seat 1: Nestle170 (big blind) folded before Flop
Seat 2: bateman225 folded before Flop (didn't bet)
Seat 3: Rulet345 folded before Flop (didn't bet)
Seat 4: KerilTheBoss folded before Flop (didn't bet)
Seat 5: Dihabet folded before Flop (didn't bet)
Seat 6: Kasselbanki folded before Flop (didn't bet)
Seat 7: Mmago24 folded before Flop (didn't bet)
Seat 8: bountyhun31 (button) mucked
Seat 9: Infinities4 (small blind) showed [2c 2d] and won ($7.60) with two pair, Nines and Deuces



PokerStars Hand #228685675103:  Hold'em No Limit ($0.25/$0.50 USD) - 2021/07/30 14:44:01 ET
Table 'Bok II' 9-max Seat #9 is the button
Seat 1: Nestle170 ($104.60 in chips) 
Seat 2: bateman225 ($45.62 in chips) 
Seat 3: Rulet345 ($50 in chips) 
Seat 4: KerilTheBoss ($69.03 in chips) 
Seat 5: Dihabet ($59.78 in chips) 
Seat 6: Kasselbanki ($32.37 in chips) 
Seat 7: Mmago24 ($70.49 in chips) 
Seat 8: bountyhun31 ($40.89 in chips) 
Seat 9: Infinities4 ($53.85 in chips) 
Nestle170: posts small blind $0.25
bateman225: posts big blind $0.50
*** HOLE CARDS ***
Rulet345: raises $1 to $1.50
KerilTheBoss has timed out
KerilTheBoss: folds 
Dihabet: folds 
Kasselbanki: folds 
Mmago24: folds 
bountyhun31: folds 
Infinities4: raises $3 to $4.50
Nestle170: folds 
bateman225: folds 
Rulet345: folds 
Uncalled bet ($3) returned to Infinities4
Infinities4 collected $3.75 from pot
Infinities4: doesn't show hand 
*** SUMMARY ***
Total pot $3.75 | Rake $0 
Seat 1: Nestle170 (small blind) folded before Flop
Seat 2: bateman225 (big blind) folded before Flop
Seat 3: Rulet345 folded before Flop
Seat 4: KerilTheBoss folded before Flop (didn't bet)
Seat 5: Dihabet folded before Flop (didn't bet)
Seat 6: Kasselbanki folded before Flop (didn't bet)
Seat 7: Mmago24 folded before Flop (didn't bet)
Seat 8: bountyhun31 folded before Flop (didn't bet)
Seat 9: Infinities4 (button) collected ($3.75)



PokerStars Hand #228685692223:  Hold'em No Limit ($0.25/$0.50 USD) - 2021/07/30 14:44:41 ET
Table 'Bok II' 9-max Seat #1 is the button
Seat 1: Nestle170 ($104.35 in chips) 
Seat 2: bateman225 ($45.12 in chips) 
Seat 3: Rulet345 ($50 in chips) 
Seat 4: KerilTheBoss ($69.03 in chips) 
Seat 5: Dihabet ($59.78 in chips) 
Seat 6: Kasselbanki ($32.37 in chips) 
Seat 7: Mmago24 ($70.49 in chips) 
Seat 8: bountyhun31 ($40.89 in chips) 
Seat 9: Infinities4 ($56.10 in chips) 
bateman225: posts small blind $0.25
Rulet345: posts big blind $0.50
*** HOLE CARDS ***
KerilTheBoss: folds 
Dihabet: folds 
Kasselbanki: folds 
Mmago24: raises $0.72 to $1.22
bountyhun31: calls $1.22
Infinities4: folds 
Nestle170: folds 
bateman225: calls $0.97
Rulet345: folds 
*** FLOP *** [Ks Qc Kh]
bateman225: checks 
Mmago24: bets $1.50
bountyhun31: folds 
bateman225: folds 
Uncalled bet ($1.50) returned to Mmago24
Mmago24 collected $3.95 from pot
Mmago24: doesn't show hand 
*** SUMMARY ***
Total pot $4.16 | Rake $0.21 
Board [Ks Qc Kh]
Seat 1: Nestle170 (button) folded before Flop (didn't bet)
Seat 2: bateman225 (small blind) folded on the Flop
Seat 3: Rulet345 (big blind) folded before Flop
Seat 4: KerilTheBoss folded before Flop (didn't bet)
Seat 5: Dihabet folded before Flop (didn't bet)
Seat 6: Kasselbanki folded before Flop (didn't bet)
Seat 7: Mmago24 collected ($3.95)
Seat 8: bountyhun31 folded on the Flop
Seat 9: Infinities4 folded before Flop (didn't bet)



PokerStars Hand #228685718782:  Hold'em No Limit ($0.25/$0.50 USD) - 2021/07/30 14:45:27 ET
Table 'Bok II' 9-max Seat #2 is the button
Seat 1: Nestle170 ($104.35 in chips) 
Seat 2: bateman225 ($43.90 in chips) 
Seat 3: Rulet345 ($50 in chips) 
Seat 4: KerilTheBoss ($69.03 in chips) 
Seat 5: Dihabet ($59.78 in chips) 
Seat 6: Kasselbanki ($32.37 in chips) 
Seat 7: Mmago24 ($73.22 in chips) 
Seat 8: bountyhun31 ($39.67 in chips) 
Seat 9: Infinities4 ($56.10 in chips) 
Rulet345: posts small blind $0.25
KerilTheBoss: posts big blind $0.50
*** HOLE CARDS ***
Dihabet: folds 
Kasselbanki: folds 
Mmago24 has timed out
Mmago24: folds 
bountyhun31: folds 
Infinities4: raises $0.74 to $1.24
Nestle170: folds 
bateman225: folds 
Rulet345: folds 
KerilTheBoss: calls $0.74
*** FLOP *** [9c 2d Qd]
KerilTheBoss: checks 
Infinities4: bets $0.91
KerilTheBoss: calls $0.91
*** TURN *** [9c 2d Qd] [Ks]
KerilTheBoss: checks 
Infinities4: checks 
*** RIVER *** [9c 2d Qd Ks] [Tc]
KerilTheBoss: bets $3.24
Infinities4: calls $3.24
*** SHOW DOWN ***
KerilTheBoss: shows [3s 3d] (a pair of Threes)
Infinities4: shows [Jd Kh] (a straight, Nine to King)
Infinities4 collected $10.48 from pot
*** SUMMARY ***
Total pot $11.03 | Rake $0.55 
Board [9c 2d Qd Ks Tc]
Seat 1: Nestle170 folded before Flop (didn't bet)
Seat 2: bateman225 (button) folded before Flop (didn't bet)
Seat 3: Rulet345 (small blind) folded before Flop
Seat 4: KerilTheBoss (big blind) showed [3s 3d] and lost with a pair of Threes
Seat 5: Dihabet folded before Flop (didn't bet)
Seat 6: Kasselbanki folded before Flop (didn't bet)
Seat 7: Mmago24 folded before Flop (didn't bet)
Seat 8: bountyhun31 folded before Flop (didn't bet)
Seat 9: Infinities4 showed [Jd Kh] and won ($10.48) with a straight, Nine to King



PokerStars Hand #228685759649:  Hold'em No Limit ($0.25/$0.50 USD) - 2021/07/30 14:47:02 ET
Table 'Bok II' 9-max Seat #3 is the button
Seat 1: Nestle170 ($104.35 in chips) 
Seat 2: bateman225 ($43.90 in chips) 
Seat 3: Rulet345 ($50 in chips) 
Seat 4: KerilTheBoss ($63.64 in chips) 
Seat 5: Dihabet ($59.78 in chips) 
Seat 6: Kasselbanki ($32.37 in chips) 
Seat 7: Mmago24 ($73.22 in chips) 
Seat 8: bountyhun31 ($39.67 in chips) 
Seat 9: Infinities4 ($61.19 in chips) 
KerilTheBoss: posts small blind $0.25
Dihabet: posts big blind $0.50
*** HOLE CARDS ***
Kasselbanki: folds 
Mmago24: folds 
bountyhun31: folds 
Infinities4: folds 
Nestle170: folds 
bateman225: folds 
Rulet345: folds 
KerilTheBoss: folds 
Uncalled bet ($0.25) returned to Dihabet
Dihabet collected $0.50 from pot
Dihabet: doesn't show hand 
*** SUMMARY ***
Total pot $0.50 | Rake $0 
Seat 1: Nestle170 folded before Flop (didn't bet)
Seat 2: bateman225 folded before Flop (didn't bet)
Seat 3: Rulet345 (button) folded before Flop (didn't bet)
Seat 4: KerilTheBoss (small blind) folded before Flop
Seat 5: Dihabet (big blind) collected ($0.50)
Seat 6: Kasselbanki folded before Flop (didn't bet)
Seat 7: Mmago24 folded before Flop (didn't bet)
Seat 8: bountyhun31 folded before Flop (didn't bet)
Seat 9: Infinities4 folded before Flop (didn't bet)



PokerStars Hand #228685766695:  Hold'em No Limit ($0.25/$0.50 USD) - 2021/07/30 14:47:19 ET
Table 'Bok II' 9-max Seat #4 is the button
Seat 1: Nestle170 ($104.35 in chips) 
Seat 2: bateman225 ($43.90 in chips) 
Seat 3: Rulet345 ($50 in chips) 
Seat 4: KerilTheBoss ($63.39 in chips) 
Seat 5: Dihabet ($60.03 in chips) 
Seat 6: Kasselbanki ($32.37 in chips) 
Seat 7: Mmago24 ($73.22 in chips) 
Seat 8: bountyhun31 ($39.67 in chips) 
Seat 9: Infinities4 ($61.19 in chips) 
Dihabet: posts small blind $0.25
Kasselbanki: posts big blind $0.50
*** HOLE CARDS ***
Mmago24: folds 
bountyhun31: calls $0.50
Infinities4: folds 
Nestle170: folds 
bateman225: raises $1.50 to $2
Rulet345: folds 
KerilTheBoss: folds 
Dihabet: folds 
Dihabet was removed from the table for failing to post
Dihabet is disconnected 
Kasselbanki: folds 
bountyhun31: calls $1.50
*** FLOP *** [Jc Qh 2d]
Dihabet leaves the table
bountyhun31: checks 
bateman225: bets $2.50
bountyhun31: calls $2.50
*** TURN *** [Jc Qh 2d] [4s]
bountyhun31: checks 
Xamil666 joins the table at seat #5 
bateman225: bets $5
bountyhun31: calls $5
*** RIVER *** [Jc Qh 2d 4s] [9d]
bountyhun31: bets $30.17 and is all-in
bateman225: folds 
Uncalled bet ($30.17) returned to bountyhun31
bountyhun31 collected $18.76 from pot
bountyhun31: doesn't show hand 
*** SUMMARY ***
Total pot $19.75 | Rake $0.99 
Board [Jc Qh 2d 4s 9d]
Seat 1: Nestle170 folded before Flop (didn't bet)
Seat 2: bateman225 folded on the River
Seat 3: Rulet345 folded before Flop (didn't bet)
Seat 4: KerilTheBoss (button) folded before Flop (didn't bet)
Seat 5: Dihabet (small blind) folded before Flop
Seat 6: Kasselbanki (big blind) folded before Flop
Seat 7: Mmago24 folded before Flop (didn't bet)
Seat 8: bountyhun31 collected ($18.76)
Seat 9: Infinities4 folded before Flop (didn't bet)



PokerStars Hand #228685788829:  Hold'em No Limit ($0.25/$0.50 USD) - 2021/07/30 14:48:09 ET
Table 'Bok II' 9-max Seat #6 is the button
Seat 1: Nestle170 ($104.35 in chips) 
Seat 2: bateman225 ($34.40 in chips) 
Seat 3: Rulet345 ($50 in chips) 
Seat 4: KerilTheBoss ($63.39 in chips) 
Seat 6: Kasselbanki ($31.87 in chips) 
Seat 7: Mmago24 ($73.22 in chips) 
Seat 8: bountyhun31 ($48.93 in chips) 
Seat 9: Infinities4 ($61.19 in chips) 
Mmago24: posts small blind $0.25
bountyhun31: posts big blind $0.50
Xamil666: sits out 
*** HOLE CARDS ***
Infinities4: folds 
Nestle170: folds 
bateman225: folds 
Rulet345: folds 
KerilTheBoss: raises $0.75 to $1.25
Kasselbanki: folds 
Mmago24: raises $3.75 to $5
bountyhun31: folds 
KerilTheBoss: folds 
Uncalled bet ($3.75) returned to Mmago24
Mmago24 collected $3 from pot
Mmago24: doesn't show hand 
*** SUMMARY ***
Total pot $3 | Rake $0 
Seat 1: Nestle170 folded before Flop (didn't bet)
Seat 2: bateman225 folded before Flop (didn't bet)
Seat 3: Rulet345 folded before Flop (didn't bet)
Seat 4: KerilTheBoss folded before Flop
Seat 6: Kasselbanki (button) folded before Flop (didn't bet)
Seat 7: Mmago24 (small blind) collected ($3)
Seat 8: bountyhun31 (big blind) folded before Flop
Seat 9: Infinities4 folded before Flop (didn't bet)



PokerStars Hand #228685796799:  Hold'em No Limit ($0.25/$0.50 USD) - 2021/07/30 14:48:28 ET
Table 'Bok II' 9-max Seat #7 is the button
Seat 1: Nestle170 ($104.35 in chips) 
Seat 2: bateman225 ($34.40 in chips) 
Seat 3: Rulet345 ($50 in chips) 
Seat 4: KerilTheBoss ($62.14 in chips) 
Seat 6: Kasselbanki ($31.87 in chips) 
Seat 7: Mmago24 ($74.97 in chips) 
Seat 8: bountyhun31 ($48.43 in chips) 
Seat 9: Infinities4 ($61.19 in chips) 
bountyhun31: posts small blind $0.25
Infinities4: posts big blind $0.50
Xamil666: sits out 
*** HOLE CARDS ***
Nestle170: folds 
bateman225: calls $0.50
Rulet345: folds 
KerilTheBoss: folds 
Kasselbanki: raises $1 to $1.50
Mmago24: folds 
bountyhun31: folds 
Infinities4: folds 
bateman225: calls $1
*** FLOP *** [8d Jc 7s]
bateman225: bets $0.50
Kasselbanki: calls $0.50
*** TURN *** [8d Jc 7s] [5c]
bateman225: bets $1
Kasselbanki: folds 
Uncalled bet ($1) returned to bateman225
bateman225 collected $4.51 from pot
bateman225: doesn't show hand 
*** SUMMARY ***
Total pot $4.75 | Rake $0.24 
Board [8d Jc 7s 5c]
Seat 1: Nestle170 folded before Flop (didn't bet)
Seat 2: bateman225 collected ($4.51)
Seat 3: Rulet345 folded before Flop (didn't bet)
Seat 4: KerilTheBoss folded before Flop (didn't bet)
Seat 6: Kasselbanki folded on the Turn
Seat 7: Mmago24 (button) folded before Flop (didn't bet)
Seat 8: bountyhun31 (small blind) folded before Flop
Seat 9: Infinities4 (big blind) folded before Flop



PokerStars Hand #228685813637:  Hold'em No Limit ($0.25/$0.50 USD) - 2021/07/30 14:49:07 ET
Table 'Bok II' 9-max Seat #8 is the button
Seat 1: Nestle170 ($104.35 in chips) 
Seat 2: bateman225 ($36.91 in chips) 
Seat 3: Rulet345 ($50 in chips) 
Seat 4: KerilTheBoss ($62.14 in chips) 
Seat 6: Kasselbanki ($29.87 in chips) 
Seat 7: Mmago24 ($74.97 in chips) 
Seat 8: bountyhun31 ($48.18 in chips) 
Seat 9: Infinities4 ($60.69 in chips) 
Infinities4: posts small blind $0.25
Nestle170: posts big blind $0.50
Xamil666: sits out 
*** HOLE CARDS ***
bateman225: folds 
Rulet345: folds 
KerilTheBoss: raises $1 to $1.50
Kasselbanki: folds 
Mmago24: folds 
bountyhun31: folds 
Infinities4: raises $4.50 to $6
Nestle170: folds 
KerilTheBoss: folds 
Uncalled bet ($4.50) returned to Infinities4
Infinities4 collected $3.50 from pot
Infinities4: doesn't show hand 
*** SUMMARY ***
Total pot $3.50 | Rake $0 
Seat 1: Nestle170 (big blind) folded before Flop
Seat 2: bateman225 folded before Flop (didn't bet)
Seat 3: Rulet345 folded before Flop (didn't bet)
Seat 4: KerilTheBoss folded before Flop
Seat 6: Kasselbanki folded before Flop (didn't bet)
Seat 7: Mmago24 folded before Flop (didn't bet)
Seat 8: bountyhun31 (button) folded before Flop (didn't bet)
Seat 9: Infinities4 (small blind) collected ($3.50)



PokerStars Hand #228685831230:  Hold'em No Limit ($0.25/$0.50 USD) - 2021/07/30 14:49:48 ET
Table 'Bok II' 9-max Seat #9 is the button
Seat 1: Nestle170 ($103.85 in chips) 
Seat 2: bateman225 ($36.91 in chips) 
Seat 3: Rulet345 ($50 in chips) 
Seat 4: KerilTheBoss ($60.64 in chips) 
Seat 6: Kasselbanki ($29.87 in chips) 
Seat 7: Mmago24 ($74.97 in chips) 
Seat 8: bountyhun31 ($48.18 in chips) 
Seat 9: Infinities4 ($62.69 in chips) 
Nestle170: posts small blind $0.25
bateman225: posts big blind $0.50
Xamil666: sits out 
*** HOLE CARDS ***
Rulet345: folds 
KerilTheBoss: folds 
Kasselbanki: folds 
Mmago24: folds 
bountyhun31: folds 
Infinities4: folds 
Nestle170: folds 
Uncalled bet ($0.25) returned to bateman225
bateman225 collected $0.50 from pot
bateman225: doesn't show hand 
*** SUMMARY ***
Total pot $0.50 | Rake $0 
Seat 1: Nestle170 (small blind) folded before Flop
Seat 2: bateman225 (big blind) collected ($0.50)
Seat 3: Rulet345 folded before Flop (didn't bet)
Seat 4: KerilTheBoss folded before Flop (didn't bet)
Seat 6: Kasselbanki folded before Flop (didn't bet)
Seat 7: Mmago24 folded before Flop (didn't bet)
Seat 8: bountyhun31 folded before Flop (didn't bet)
Seat 9: Infinities4 (button) folded before Flop (didn't bet)



PokerStars Hand #228685836977:  Hold'em No Limit ($0.25/$0.50 USD) - 2021/07/30 14:50:01 ET
Table 'Bok II' 9-max Seat #1 is the button
Seat 1: Nestle170 ($103.60 in chips) 
Seat 2: bateman225 ($37.16 in chips) 
Seat 3: Rulet345 ($50 in chips) 
Seat 4: KerilTheBoss ($60.64 in chips) 
Seat 6: Kasselbanki ($29.87 in chips) 
Seat 7: Mmago24 ($74.97 in chips) 
Seat 8: bountyhun31 ($48.18 in chips) 
Seat 9: Infinities4 ($62.69 in chips) 
bateman225: posts small blind $0.25
Rulet345: posts big blind $0.50
Xamil666: sits out 
*** HOLE CARDS ***
KerilTheBoss: folds 
Kasselbanki: folds 
Mmago24: folds 
bountyhun31: calls $0.50
Infinities4: raises $1.25 to $1.75
Nestle170: folds 
bateman225: calls $1.50
Rulet345: calls $1.25
bountyhun31: calls $1.25
*** FLOP *** [6s 4d 3d]
bateman225: bets $3
Rulet345: folds 
bountyhun31: folds 
Infinities4: folds 
Uncalled bet ($3) returned to bateman225
bateman225 collected $6.65 from pot
bateman225: doesn't show hand 
*** SUMMARY ***
Total pot $7 | Rake $0.35 
Board [6s 4d 3d]
Seat 1: Nestle170 (button) folded before Flop (didn't bet)
Seat 2: bateman225 (small blind) collected ($6.65)
Seat 3: Rulet345 (big blind) folded on the Flop
Seat 4: KerilTheBoss folded before Flop (didn't bet)
Seat 6: Kasselbanki folded before Flop (didn't bet)
Seat 7: Mmago24 folded before Flop (didn't bet)
Seat 8: bountyhun31 folded on the Flop
Seat 9: Infinities4 folded on the Flop



PokerStars Hand #228685852921:  Hold'em No Limit ($0.25/$0.50 USD) - 2021/07/30 14:50:38 ET
Table 'Bok II' 9-max Seat #2 is the button
Seat 1: Nestle170 ($103.60 in chips) 
Seat 2: bateman225 ($42.06 in chips) 
Seat 3: Rulet345 ($50 in chips) 
Seat 4: KerilTheBoss ($60.64 in chips) 
Seat 6: Kasselbanki ($29.87 in chips) 
Seat 7: Mmago24 ($74.97 in chips) 
Seat 8: bountyhun31 ($46.43 in chips) 
Seat 9: Infinities4 ($60.94 in chips) 
Rulet345: posts small blind $0.25
KerilTheBoss: posts big blind $0.50
Xamil666: sits out 
*** HOLE CARDS ***
Kasselbanki: folds 
Mmago24: raises $0.72 to $1.22
bountyhun31: calls $1.22
Infinities4: folds 
Nestle170: folds 
bateman225: folds 
Rulet345: folds 
KerilTheBoss: folds 
*** FLOP *** [2c Js Ad]
Mmago24: bets $1.25
bountyhun31: calls $1.25
*** TURN *** [2c Js Ad] [Kd]
Mmago24: bets $3.20
bountyhun31: calls $3.20
*** RIVER *** [2c Js Ad Kd] [2d]
Mmago24: checks 
bountyhun31: checks 
*** SHOW DOWN ***
Mmago24: shows [As 9s] (two pair, Aces and Deuces)
bountyhun31: mucks hand 
Mmago24 collected $11.49 from pot
*** SUMMARY ***
Total pot $12.09 | Rake $0.60 
Board [2c Js Ad Kd 2d]
Seat 1: Nestle170 folded before Flop (didn't bet)
Seat 2: bateman225 (button) folded before Flop (didn't bet)
Seat 3: Rulet345 (small blind) folded before Flop
Seat 4: KerilTheBoss (big blind) folded before Flop
Seat 6: Kasselbanki folded before Flop (didn't bet)
Seat 7: Mmago24 showed [As 9s] and won ($11.49) with two pair, Aces and Deuces
Seat 8: bountyhun31 mucked
Seat 9: Infinities4 folded before Flop (didn't bet)



PokerStars Hand #228685882408:  Hold'em No Limit ($0.25/$0.50 USD) - 2021/07/30 14:51:46 ET
Table 'Bok II' 9-max Seat #3 is the button
Seat 1: Nestle170 ($103.60 in chips) 
Seat 2: bateman225 ($42.06 in chips) 
Seat 3: Rulet345 ($50 in chips) 
Seat 4: KerilTheBoss ($60.14 in chips) 
Seat 5: Xamil666 ($50 in chips) 
Seat 6: Kasselbanki ($29.87 in chips) 
Seat 7: Mmago24 ($80.79 in chips) 
Seat 8: bountyhun31 ($40.76 in chips) 
Seat 9: Infinities4 ($60.94 in chips) 
KerilTheBoss: posts small blind $0.25
Xamil666: posts big blind $0.50
*** HOLE CARDS ***
Kasselbanki: folds 
Mmago24: folds 
bountyhun31: calls $0.50
Infinities4: folds 
Nestle170: raises $1.50 to $2
bateman225: folds 
Rulet345: folds 
KerilTheBoss: folds 
Xamil666: folds 
bountyhun31: calls $1.50
*** FLOP *** [5c Ac Qh]
bountyhun31: checks 
Nestle170: bets $1.49
bountyhun31: folds 
Uncalled bet ($1.49) returned to Nestle170
Nestle170 collected $4.51 from pot
Nestle170: doesn't show hand 
*** SUMMARY ***
Total pot $4.75 | Rake $0.24 
Board [5c Ac Qh]
Seat 1: Nestle170 collected ($4.51)
Seat 2: bateman225 folded before Flop (didn't bet)
Seat 3: Rulet345 (button) folded before Flop (didn't bet)
Seat 4: KerilTheBoss (small blind) folded before Flop
Seat 5: Xamil666 (big blind) folded before Flop
Seat 6: Kasselbanki folded before Flop (didn't bet)
Seat 7: Mmago24 folded before Flop (didn't bet)
Seat 8: bountyhun31 folded on the Flop
Seat 9: Infinities4 folded before Flop (didn't bet)



PokerStars Hand #228685898497:  Hold'em No Limit ($0.25/$0.50 USD) - 2021/07/30 14:52:24 ET
Table 'Bok II' 9-max Seat #4 is the button
Seat 1: Nestle170 ($106.11 in chips) 
Seat 2: bateman225 ($42.06 in chips) 
Seat 3: Rulet345 ($50 in chips) 
Seat 4: KerilTheBoss ($59.89 in chips) 
Seat 5: Xamil666 ($50 in chips) 
Seat 6: Kasselbanki ($29.87 in chips) 
Seat 7: Mmago24 ($80.79 in chips) 
Seat 8: bountyhun31 ($38.76 in chips) 
Seat 9: Infinities4 ($60.94 in chips) 
Xamil666: posts small blind $0.25
Kasselbanki: posts big blind $0.50
*** HOLE CARDS ***
Mmago24: folds 
bountyhun31: folds 
Infinities4: folds 
Nestle170: folds 
bateman225: folds 
Rulet345: folds 
KerilTheBoss: raises $0.55 to $1.05
Xamil666: raises $4.45 to $5.50
Kasselbanki: folds 
KerilTheBoss: raises $54.39 to $59.89 and is all-in
Xamil666: folds 
Uncalled bet ($54.39) returned to KerilTheBoss
KerilTheBoss collected $11.50 from pot
KerilTheBoss: doesn't show hand 
*** SUMMARY ***
Total pot $11.50 | Rake $0 
Seat 1: Nestle170 folded before Flop (didn't bet)
Seat 2: bateman225 folded before Flop (didn't bet)
Seat 3: Rulet345 folded before Flop (didn't bet)
Seat 4: KerilTheBoss (button) collected ($11.50)
Seat 5: Xamil666 (small blind) folded before Flop
Seat 6: Kasselbanki (big blind) folded before Flop
Seat 7: Mmago24 folded before Flop (didn't bet)
Seat 8: bountyhun31 folded before Flop (didn't bet)
Seat 9: Infinities4 folded before Flop (didn't bet)



PokerStars Hand #228685914812:  Hold'em No Limit ($0.25/$0.50 USD) - 2021/07/30 14:53:02 ET
Table 'Bok II' 9-max Seat #5 is the button
Seat 1: Nestle170 ($106.11 in chips) 
Seat 2: bateman225 ($42.06 in chips) 
Seat 3: Rulet345 ($50 in chips) 
Seat 4: KerilTheBoss ($65.89 in chips) 
Seat 5: Xamil666 ($50 in chips) 
Seat 6: Kasselbanki ($29.37 in chips) 
Seat 7: Mmago24 ($80.79 in chips) 
Seat 8: bountyhun31 ($38.76 in chips) 
Seat 9: Infinities4 ($60.94 in chips) 
Kasselbanki: posts small blind $0.25
Mmago24: posts big blind $0.50
*** HOLE CARDS ***
bountyhun31: folds 
Infinities4: folds 
Nestle170: folds 
bateman225: folds 
Rulet345: raises $1 to $1.50
KerilTheBoss: folds 
Xamil666: folds 
Kasselbanki: folds 
Mmago24: calls $1
*** FLOP *** [3s 7d Kc]
Mmago24: checks 
Rulet345: bets $1.02
Mmago24: raises $2.48 to $3.50
Rulet345: folds 
Uncalled bet ($2.48) returned to Mmago24
Mmago24 collected $5.03 from pot
Mmago24: doesn't show hand 
*** SUMMARY ***
Total pot $5.29 | Rake $0.26 
Board [3s 7d Kc]
Seat 1: Nestle170 folded before Flop (didn't bet)
Seat 2: bateman225 folded before Flop (didn't bet)
Seat 3: Rulet345 folded on the Flop
Seat 4: KerilTheBoss folded before Flop (didn't bet)
Seat 5: Xamil666 (button) folded before Flop (didn't bet)
Seat 6: Kasselbanki (small blind) folded before Flop
Seat 7: Mmago24 (big blind) collected ($5.03)
Seat 8: bountyhun31 folded before Flop (didn't bet)
Seat 9: Infinities4 folded before Flop (didn't bet)



PokerStars Hand #228685937950:  Hold'em No Limit ($0.25/$0.50 USD) - 2021/07/30 14:53:56 ET
Table 'Bok II' 9-max Seat #6 is the button
Seat 1: Nestle170 ($106.11 in chips) 
Seat 2: bateman225 ($42.06 in chips) 
Seat 3: Rulet345 ($50 in chips) 
Seat 4: KerilTheBoss ($65.89 in chips) 
Seat 5: Xamil666 ($50 in chips) 
Seat 6: Kasselbanki ($29.12 in chips) 
Seat 7: Mmago24 ($83.30 in chips) 
Seat 8: bountyhun31 ($38.76 in chips) 
Seat 9: Infinities4 ($60.94 in chips) 
Mmago24: posts small blind $0.25
bountyhun31: posts big blind $0.50
*** HOLE CARDS ***
Infinities4: folds 
Nestle170: folds 
bateman225: calls $0.50
Rulet345: folds 
KerilTheBoss: raises $1.75 to $2.25
Xamil666: folds 
Kasselbanki: folds 
Mmago24: folds 
bountyhun31: folds 
bateman225: folds 
Uncalled bet ($1.75) returned to KerilTheBoss
KerilTheBoss collected $1.75 from pot
KerilTheBoss: doesn't show hand 
*** SUMMARY ***
Total pot $1.75 | Rake $0 
Seat 1: Nestle170 folded before Flop (didn't bet)
Seat 2: bateman225 folded before Flop
Seat 3: Rulet345 folded before Flop (didn't bet)
Seat 4: KerilTheBoss collected ($1.75)
Seat 5: Xamil666 folded before Flop (didn't bet)
Seat 6: Kasselbanki (button) folded before Flop (didn't bet)
Seat 7: Mmago24 (small blind) folded before Flop
Seat 8: bountyhun31 (big blind) folded before Flop
Seat 9: Infinities4 folded before Flop (didn't bet)



PokerStars Hand #228685948225:  Hold'em No Limit ($0.25/$0.50 USD) - 2021/07/30 14:54:20 ET
Table 'Bok II' 9-max Seat #7 is the button
Seat 1: Nestle170 ($106.11 in chips) 
Seat 2: bateman225 ($41.56 in chips) 
Seat 3: Rulet345 ($50 in chips) 
Seat 4: KerilTheBoss ($67.14 in chips) 
Seat 5: Xamil666 ($50 in chips) 
Seat 6: Kasselbanki ($29.12 in chips) 
Seat 7: Mmago24 ($83.05 in chips) 
Seat 8: bountyhun31 ($38.26 in chips) 
Seat 9: Infinities4 ($60.94 in chips) 
bountyhun31: posts small blind $0.25
Infinities4: posts big blind $0.50
*** HOLE CARDS ***
Nestle170: folds 
bateman225: folds 
Rulet345: folds 
KerilTheBoss: folds 
Xamil666: folds 
Kasselbanki: folds 
Mmago24: folds 
bountyhun31: folds 
Uncalled bet ($0.25) returned to Infinities4
Infinities4 collected $0.50 from pot
Infinities4: doesn't show hand 
*** SUMMARY ***
Total pot $0.50 | Rake $0 
Seat 1: Nestle170 folded before Flop (didn't bet)
Seat 2: bateman225 folded before Flop (didn't bet)
Seat 3: Rulet345 folded before Flop (didn't bet)
Seat 4: KerilTheBoss folded before Flop (didn't bet)
Seat 5: Xamil666 folded before Flop (didn't bet)
Seat 6: Kasselbanki folded before Flop (didn't bet)
Seat 7: Mmago24 (button) folded before Flop (didn't bet)
Seat 8: bountyhun31 (small blind) folded before Flop
Seat 9: Infinities4 (big blind) collected ($0.50)



PokerStars Hand #228685956041:  Hold'em No Limit ($0.25/$0.50 USD) - 2021/07/30 14:54:38 ET
Table 'Bok II' 9-max Seat #8 is the button
Seat 1: Nestle170 ($106.11 in chips) 
Seat 2: bateman225 ($41.56 in chips) 
Seat 3: Rulet345 ($50 in chips) 
Seat 4: KerilTheBoss ($67.14 in chips) 
Seat 5: Xamil666 ($50 in chips) 
Seat 6: Kasselbanki ($29.12 in chips) 
Seat 7: Mmago24 ($83.05 in chips) 
Seat 8: bountyhun31 ($38.01 in chips) 
Seat 9: Infinities4 ($61.19 in chips) 
Infinities4: posts small blind $0.25
Nestle170: posts big blind $0.50
*** HOLE CARDS ***
bateman225: folds 
Rulet345: folds 
KerilTheBoss: folds 
Xamil666: folds 
Kasselbanki: raises $0.50 to $1
Mmago24: folds 
bountyhun31: folds 
Infinities4: folds 
Nestle170: folds 
Uncalled bet ($0.50) returned to Kasselbanki
Kasselbanki collected $1.25 from pot
Kasselbanki: doesn't show hand 
*** SUMMARY ***
Total pot $1.25 | Rake $0 
Seat 1: Nestle170 (big blind) folded before Flop
Seat 2: bateman225 folded before Flop (didn't bet)
Seat 3: Rulet345 folded before Flop (didn't bet)
Seat 4: KerilTheBoss folded before Flop (didn't bet)
Seat 5: Xamil666 folded before Flop (didn't bet)
Seat 6: Kasselbanki collected ($1.25)
Seat 7: Mmago24 folded before Flop (didn't bet)
Seat 8: bountyhun31 (button) folded before Flop (didn't bet)
Seat 9: Infinities4 (small blind) folded before Flop



PokerStars Hand #228685963628:  Hold'em No Limit ($0.25/$0.50 USD) - 2021/07/30 14:54:56 ET
Table 'Bok II' 9-max Seat #9 is the button
Seat 1: Nestle170 ($105.61 in chips) 
Seat 2: bateman225 ($41.56 in chips) 
Seat 3: Rulet345 ($50 in chips) 
Seat 4: KerilTheBoss ($67.14 in chips) 
Seat 5: Xamil666 ($50 in chips) 
Seat 6: Kasselbanki ($29.87 in chips) 
Seat 7: Mmago24 ($83.05 in chips) 
Seat 8: bountyhun31 ($38.01 in chips) 
Seat 9: Infinities4 ($60.94 in chips) 
Nestle170: posts small blind $0.25
bateman225: posts big blind $0.50
*** HOLE CARDS ***
Rulet345: folds 
KerilTheBoss: folds 
Xamil666: folds 
Kasselbanki: folds 
Mmago24: raises $0.72 to $1.22
bountyhun31: folds 
Infinities4: folds 
Nestle170: folds 
bateman225: calls $0.72
*** FLOP *** [Kd Ah Td]
bateman225: checks 
Mmago24: bets $1.50
bateman225: folds 
Uncalled bet ($1.50) returned to Mmago24
Mmago24 collected $2.56 from pot
Mmago24: doesn't show hand 
*** SUMMARY ***
Total pot $2.69 | Rake $0.13 
Board [Kd Ah Td]
Seat 1: Nestle170 (small blind) folded before Flop
Seat 2: bateman225 (big blind) folded on the Flop
Seat 3: Rulet345 folded before Flop (didn't bet)
Seat 4: KerilTheBoss folded before Flop (didn't bet)
Seat 5: Xamil666 folded before Flop (didn't bet)
Seat 6: Kasselbanki folded before Flop (didn't bet)
Seat 7: Mmago24 collected ($2.56)
Seat 8: bountyhun31 folded before Flop (didn't bet)
Seat 9: Infinities4 (button) folded before Flop (didn't bet)



PokerStars Hand #228685975180:  Hold'em No Limit ($0.25/$0.50 USD) - 2021/07/30 14:55:27 ET
Table 'Bok II' 9-max Seat #1 is the button
Seat 1: Nestle170 ($105.36 in chips) 
Seat 2: bateman225 ($40.34 in chips) 
Seat 3: Rulet345 ($50 in chips) 
Seat 4: KerilTheBoss ($67.14 in chips) 
Seat 5: Xamil666 ($50 in chips) 
Seat 6: Kasselbanki ($29.87 in chips) 
Seat 7: Mmago24 ($84.39 in chips) 
Seat 8: bountyhun31 ($38.01 in chips) 
Seat 9: Infinities4 ($60.94 in chips) 
bateman225: posts small blind $0.25
Rulet345: posts big blind $0.50
*** HOLE CARDS ***
KerilTheBoss: folds 
Xamil666: folds 
Kasselbanki: folds 
Mmago24: folds 
bountyhun31: folds 
Infinities4: raises $0.74 to $1.24
Nestle170: folds 
bateman225: calls $0.99
Rulet345: folds 
*** FLOP *** [4c 7s 3h]
bateman225: checks 
Infinities4: bets $2.12
bateman225: folds 
Uncalled bet ($2.12) returned to Infinities4
Infinities4 collected $2.83 from pot
Infinities4: doesn't show hand 
*** SUMMARY ***
Total pot $2.98 | Rake $0.15 
Board [4c 7s 3h]
Seat 1: Nestle170 (button) folded before Flop (didn't bet)
Seat 2: bateman225 (small blind) folded on the Flop
Seat 3: Rulet345 (big blind) folded before Flop
Seat 4: KerilTheBoss folded before Flop (didn't bet)
Seat 5: Xamil666 folded before Flop (didn't bet)
Seat 6: Kasselbanki folded before Flop (didn't bet)
Seat 7: Mmago24 folded before Flop (didn't bet)
Seat 8: bountyhun31 folded before Flop (didn't bet)
Seat 9: Infinities4 collected ($2.83)



PokerStars Hand #228685987184:  Hold'em No Limit ($0.25/$0.50 USD) - 2021/07/30 14:56:05 ET
Table 'Bok II' 9-max Seat #2 is the button
Seat 1: Nestle170 ($105.36 in chips) 
Seat 2: bateman225 ($39.10 in chips) 
Seat 3: Rulet345 ($50 in chips) 
Seat 4: KerilTheBoss ($67.14 in chips) 
Seat 5: Xamil666 ($50 in chips) 
Seat 6: Kasselbanki ($29.87 in chips) 
Seat 7: Mmago24 ($84.39 in chips) 
Seat 8: bountyhun31 ($38.01 in chips) 
Seat 9: Infinities4 ($62.53 in chips) 
Rulet345: posts small blind $0.25
KerilTheBoss: posts big blind $0.50
*** HOLE CARDS ***
Xamil666: folds 
Kasselbanki: raises $0.50 to $1
Mmago24: folds 
bountyhun31: calls $1
Infinities4: folds 
Nestle170: folds 
bateman225: folds 
Rulet345: folds 
KerilTheBoss: folds 
*** FLOP *** [3c 8c 3h]
Kasselbanki: checks 
bountyhun31: checks 
*** TURN *** [3c 8c 3h] [2d]
Kasselbanki: bets $1.50
bountyhun31: calls $1.50
*** RIVER *** [3c 8c 3h 2d] [Js]
Kasselbanki: bets $2.73
bountyhun31: folds 
Uncalled bet ($2.73) returned to Kasselbanki
Kasselbanki collected $5.39 from pot
Kasselbanki: doesn't show hand 
*** SUMMARY ***
Total pot $5.75 | Rake $0.36 
Board [3c 8c 3h 2d Js]
Seat 1: Nestle170 folded before Flop (didn't bet)
Seat 2: bateman225 (button) folded before Flop (didn't bet)
Seat 3: Rulet345 (small blind) folded before Flop
Seat 4: KerilTheBoss (big blind) folded before Flop
Seat 5: Xamil666 folded before Flop (didn't bet)
Seat 6: Kasselbanki collected ($5.39)
Seat 7: Mmago24 folded before Flop (didn't bet)
Seat 8: bountyhun31 folded on the River
Seat 9: Infinities4 folded before Flop (didn't bet)



PokerStars Hand #228685999371:  Hold'em No Limit ($0.25/$0.50 USD) - 2021/07/30 14:56:44 ET
Table 'Bok II' 9-max Seat #3 is the button
Seat 1: Nestle170 ($105.36 in chips) 
Seat 2: bateman225 ($39.10 in chips) 
Seat 3: Rulet345 ($50 in chips) 
Seat 4: KerilTheBoss ($66.64 in chips) 
Seat 5: Xamil666 ($50 in chips) 
Seat 6: Kasselbanki ($32.76 in chips) 
Seat 7: Mmago24 ($84.39 in chips) 
Seat 8: bountyhun31 ($35.51 in chips) 
Seat 9: Infinities4 ($62.53 in chips) 
KerilTheBoss: posts small blind $0.25
Xamil666: posts big blind $0.50
*** HOLE CARDS ***
Kasselbanki: folds 
Kasselbanki leaves the table
Mmago24: folds 
bountyhun31: folds 
Infinities4: folds 
Nestle170: raises $1 to $1.50
bateman225: calls $1.50
Rulet345: folds 
KerilTheBoss: folds 
Xamil666: folds 
*** FLOP *** [Tc Kd Ts]
J0hnDee joins the table at seat #6 
Nestle170: bets $1.17
bateman225: raises $2.17 to $3.34
Nestle170: calls $2.17
*** TURN *** [Tc Kd Ts] [7s]
Nestle170: checks 
bateman225: bets $5.45
Nestle170: calls $5.45
*** RIVER *** [Tc Kd Ts 7s] [Qc]
Nestle170: checks 
bateman225: bets $12.13
Nestle170: folds 
Uncalled bet ($12.13) returned to bateman225
bateman225 collected $20.26 from pot
bateman225: doesn't show hand 
*** SUMMARY ***
Total pot $21.33 | Rake $1.07 
Board [Tc Kd Ts 7s Qc]
Seat 1: Nestle170 folded on the River
Seat 2: bateman225 collected ($20.26)
Seat 3: Rulet345 (button) folded before Flop (didn't bet)
Seat 4: KerilTheBoss (small blind) folded before Flop
Seat 5: Xamil666 (big blind) folded before Flop
Seat 6: Kasselbanki folded before Flop (didn't bet)
Seat 7: Mmago24 folded before Flop (didn't bet)
Seat 8: bountyhun31 folded before Flop (didn't bet)
Seat 9: Infinities4 folded before Flop (didn't bet)



PokerStars Hand #228686031764:  Hold'em No Limit ($0.25/$0.50 USD) - 2021/07/30 14:58:25 ET
Table 'Bok II' 9-max Seat #4 is the button
Seat 1: Nestle170 ($95.07 in chips) 
Seat 2: bateman225 ($49.07 in chips) 
Seat 3: Rulet345 ($50 in chips) 
Seat 4: KerilTheBoss ($66.39 in chips) 
Seat 5: Xamil666 ($50 in chips) 
Seat 6: J0hnDee ($50 in chips) 
Seat 7: Mmago24 ($84.39 in chips) 
Seat 8: bountyhun31 ($35.51 in chips) 
Seat 9: Infinities4 ($62.53 in chips) 
Xamil666: posts small blind $0.25
J0hnDee: posts big blind $0.50
*** HOLE CARDS ***
Mmago24: folds 
bountyhun31: calls $0.50
Infinities4: folds 
Nestle170: folds 
bateman225: folds 
Rulet345: folds 
KerilTheBoss: folds 
Xamil666: folds 
J0hnDee: checks 
*** FLOP *** [Ks Kh 2h]
J0hnDee: checks 
bountyhun31: checks 
*** TURN *** [Ks Kh 2h] [6c]
J0hnDee: checks 
bountyhun31: bets $0.50
J0hnDee: folds 
Uncalled bet ($0.50) returned to bountyhun31
bountyhun31 collected $1.19 from pot
bountyhun31: doesn't show hand 
*** SUMMARY ***
Total pot $1.25 | Rake $0.06 
Board [Ks Kh 2h 6c]
Seat 1: Nestle170 folded before Flop (didn't bet)
Seat 2: bateman225 folded before Flop (didn't bet)
Seat 3: Rulet345 folded before Flop (didn't bet)
Seat 4: KerilTheBoss (button) folded before Flop (didn't bet)
Seat 5: Xamil666 (small blind) folded before Flop
Seat 6: J0hnDee (big blind) folded on the Turn
Seat 7: Mmago24 folded before Flop (didn't bet)
Seat 8: bountyhun31 collected ($1.19)
Seat 9: Infinities4 folded before Flop (didn't bet)



PokerStars Hand #228686040119:  Hold'em No Limit ($0.25/$0.50 USD) - 2021/07/30 14:58:51 ET
Table 'Bok II' 9-max Seat #5 is the button
Seat 1: Nestle170 ($95.07 in chips) 
Seat 2: bateman225 ($49.07 in chips) 
Seat 3: Rulet345 ($50 in chips) 
Seat 4: KerilTheBoss ($66.39 in chips) 
Seat 5: Xamil666 ($50 in chips) 
Seat 6: J0hnDee ($49.50 in chips) 
Seat 7: Mmago24 ($84.39 in chips) 
Seat 8: bountyhun31 ($36.20 in chips) 
Seat 9: Infinities4 ($62.53 in chips) 
J0hnDee: posts small blind $0.25
Mmago24: posts big blind $0.50
*** HOLE CARDS ***
bountyhun31: folds 
Infinities4: folds 
Nestle170: folds 
bateman225: folds 
Rulet345: raises $1 to $1.50
KerilTheBoss: folds 
Xamil666: folds 
J0hnDee: folds 
Mmago24: folds 
Uncalled bet ($1) returned to Rulet345
Rulet345 collected $1.25 from pot
Rulet345: doesn't show hand 
*** SUMMARY ***
Total pot $1.25 | Rake $0 
Seat 1: Nestle170 folded before Flop (didn't bet)
Seat 2: bateman225 folded before Flop (didn't bet)
Seat 3: Rulet345 collected ($1.25)
Seat 4: KerilTheBoss folded before Flop (didn't bet)
Seat 5: Xamil666 (button) folded before Flop (didn't bet)
Seat 6: J0hnDee (small blind) folded before Flop
Seat 7: Mmago24 (big blind) folded before Flop
Seat 8: bountyhun31 folded before Flop (didn't bet)
Seat 9: Infinities4 folded before Flop (didn't bet)



PokerStars Hand #228686045807:  Hold'em No Limit ($0.25/$0.50 USD) - 2021/07/30 14:59:09 ET
Table 'Bok II' 9-max Seat #6 is the button
Seat 1: Nestle170 ($95.07 in chips) 
Seat 2: bateman225 ($49.07 in chips) 
Seat 3: Rulet345 ($50.75 in chips) 
Seat 4: KerilTheBoss ($66.39 in chips) 
Seat 5: Xamil666 ($50 in chips) 
Seat 6: J0hnDee ($49.25 in chips) 
Seat 7: Mmago24 ($83.89 in chips) 
Seat 8: bountyhun31 ($36.20 in chips) 
Seat 9: Infinities4 ($62.53 in chips) 
Mmago24: posts small blind $0.25
bountyhun31: posts big blind $0.50
*** HOLE CARDS ***
Infinities4: folds 
Nestle170: folds 
bateman225: calls $0.50
Rulet345: folds 
KerilTheBoss: folds 
Xamil666: raises $1 to $1.50
J0hnDee: folds 
Mmago24: folds 
bountyhun31: folds 
bateman225: calls $1
*** FLOP *** [As Qc 4c]
bateman225: checks 
Xamil666: bets $2.67
bateman225: folds 
Uncalled bet ($2.67) returned to Xamil666
Xamil666 collected $3.56 from pot
*** SUMMARY ***
Total pot $3.75 | Rake $0.19 
Board [As Qc 4c]
Seat 1: Nestle170 folded before Flop (didn't bet)
Seat 2: bateman225 folded on the Flop
Seat 3: Rulet345 folded before Flop (didn't bet)
Seat 4: KerilTheBoss folded before Flop (didn't bet)
Seat 5: Xamil666 collected ($3.56)
Seat 6: J0hnDee (button) folded before Flop (didn't bet)
Seat 7: Mmago24 (small blind) folded before Flop
Seat 8: bountyhun31 (big blind) folded before Flop
Seat 9: Infinities4 folded before Flop (didn't bet)



PokerStars Hand #228686057102:  Hold'em No Limit ($0.25/$0.50 USD) - 2021/07/30 14:59:44 ET
Table 'Bok II' 9-max Seat #7 is the button
Seat 1: Nestle170 ($95.07 in chips) 
Seat 2: bateman225 ($47.57 in chips) 
Seat 3: Rulet345 ($50.75 in chips) 
Seat 4: KerilTheBoss ($66.39 in chips) 
Seat 5: Xamil666 ($52.06 in chips) 
Seat 6: J0hnDee ($49.25 in chips) 
Seat 7: Mmago24 ($83.64 in chips) 
Seat 8: bountyhun31 ($35.70 in chips) 
Seat 9: Infinities4 ($62.53 in chips) 
bountyhun31: posts small blind $0.25
Infinities4: posts big blind $0.50
*** HOLE CARDS ***
Nestle170: folds 
bateman225: folds 
Rulet345: raises $1 to $1.50
KerilTheBoss: folds 
Xamil666: folds 
J0hnDee: calls $1.50
Mmago24: folds 
bountyhun31: raises $1.50 to $3
Infinities4: folds 
Rulet345: calls $1.50
J0hnDee: calls $1.50
*** FLOP *** [Qc 9d Jd]
bountyhun31: bets $9.02
Rulet345: folds 
J0hnDee: calls $9.02
*** TURN *** [Qc 9d Jd] [8c]
bountyhun31: bets $23.68 and is all-in
J0hnDee: calls $23.68
*** RIVER *** [Qc 9d Jd 8c] [3h]
*** SHOW DOWN ***
bountyhun31: shows [Jc Kc] (a pair of Jacks)
J0hnDee: shows [Tc 9c] (a straight, Eight to Queen)
J0hnDee collected $72.90 from pot
*** SUMMARY ***
Total pot $74.90 | Rake $2 
Board [Qc 9d Jd 8c 3h]
Seat 1: Nestle170 folded before Flop (didn't bet)
Seat 2: bateman225 folded before Flop (didn't bet)
Seat 3: Rulet345 folded on the Flop
Seat 4: KerilTheBoss folded before Flop (didn't bet)
Seat 5: Xamil666 folded before Flop (didn't bet)
Seat 6: J0hnDee showed [Tc 9c] and won ($72.90) with a straight, Eight to Queen
Seat 7: Mmago24 (button) folded before Flop (didn't bet)
Seat 8: bountyhun31 (small blind) showed [Jc Kc] and lost with a pair of Jacks
Seat 9: Infinities4 (big blind) folded before Flop



PokerStars Hand #228686080818:  Hold'em No Limit ($0.25/$0.50 USD) - 2021/07/30 15:00:54 ET
Table 'Bok II' 9-max Seat #9 is the button
Seat 1: Nestle170 ($95.07 in chips) 
Seat 2: bateman225 ($47.57 in chips) 
Seat 3: Rulet345 ($50 in chips) 
Seat 4: KerilTheBoss ($66.39 in chips) 
Seat 5: Xamil666 ($52.06 in chips) 
Seat 6: J0hnDee ($86.45 in chips) 
Seat 7: Mmago24 ($83.64 in chips) 
Seat 9: Infinities4 ($62.03 in chips) 
Nestle170: posts small blind $0.25
bateman225: posts big blind $0.50
*** HOLE CARDS ***
Rulet345: raises $1 to $1.50
KerilTheBoss: folds 
Xamil666: folds 
J0hnDee: folds 
Mmago24: folds 
Infinities4: folds 
Nestle170: folds 
bountyhun31 leaves the table
bateman225: folds 
Uncalled bet ($1) returned to Rulet345
SwimmingPooI joins the table at seat #8 
Rulet345 collected $1.25 from pot
Rulet345: doesn't show hand 
*** SUMMARY ***
Total pot $1.25 | Rake $0 
Seat 1: Nestle170 (small blind) folded before Flop
Seat 2: bateman225 (big blind) folded before Flop
Seat 3: Rulet345 collected ($1.25)
Seat 4: KerilTheBoss folded before Flop (didn't bet)
Seat 5: Xamil666 folded before Flop (didn't bet)
Seat 6: J0hnDee folded before Flop (didn't bet)
Seat 7: Mmago24 folded before Flop (didn't bet)
Seat 9: Infinities4 (button) folded before Flop (didn't bet)



PokerStars Hand #228686092063:  Hold'em No Limit ($0.25/$0.50 USD) - 2021/07/30 15:01:16 ET
Table 'Bok II' 9-max Seat #1 is the button
Seat 1: Nestle170 ($94.82 in chips) 
Seat 2: bateman225 ($47.07 in chips) 
Seat 3: Rulet345 ($50.75 in chips) 
Seat 4: KerilTheBoss ($66.39 in chips) 
Seat 5: Xamil666 ($52.06 in chips) 
Seat 6: J0hnDee ($86.45 in chips) 
Seat 7: Mmago24 ($83.64 in chips) 
Seat 9: Infinities4 ($62.03 in chips) 
bateman225: posts small blind $0.25
Rulet345: posts big blind $0.50
SwimmingPooI: sits out 
*** HOLE CARDS ***
KerilTheBoss: folds 
Xamil666: folds 
J0hnDee: raises $0.75 to $1.25
Mmago24: folds 
Mmago24 was removed from the table for failing to post
Mmago24 leaves the table
Infinities4: folds 
Nestle170: folds 
bateman225: calls $1
Rulet345: folds 
*** FLOP *** [6d 6s Jd]
Infinities4 leaves the table
bateman225: bets $0.50
J0hnDee: calls $0.50
*** TURN *** [6d 6s Jd] [2h]
bateman225: bets $1
marshallteem joins the table at seat #7 
J0hnDee: folds 
Uncalled bet ($1) returned to bateman225
bateman225 collected $3.80 from pot
bateman225: doesn't show hand 
*** SUMMARY ***
Total pot $4 | Rake $0.20 
Board [6d 6s Jd 2h]
Seat 1: Nestle170 (button) folded before Flop (didn't bet)
Seat 2: bateman225 (small blind) collected ($3.80)
Seat 3: Rulet345 (big blind) folded before Flop
Seat 4: KerilTheBoss folded before Flop (didn't bet)
Seat 5: Xamil666 folded before Flop (didn't bet)
Seat 6: J0hnDee folded on the Turn
Seat 7: Mmago24 folded before Flop (didn't bet)
Seat 9: Infinities4 folded before Flop (didn't bet)



PokerStars Hand #228686103781:  Hold'em No Limit ($0.25/$0.50 USD) - 2021/07/30 15:01:47 ET
Table 'Bok II' 9-max Seat #2 is the button
Seat 1: Nestle170 ($94.82 in chips) 
Seat 2: bateman225 ($49.12 in chips) 
Seat 3: Rulet345 ($50.25 in chips) 
Seat 5: Xamil666 ($52.06 in chips) 
Seat 6: J0hnDee ($84.70 in chips) 
Seat 7: marshallteem ($30.94 in chips) 
Rulet345: posts small blind $0.25
KerilTheBoss: is sitting out 
Xamil666: posts big blind $0.50
marshallteem: posts big blind $0.50
SwimmingPooI: sits out 
*** HOLE CARDS ***
J0hnDee: raises $1 to $1.50
marshallteem: folds 
goldenpig666 joins the table at seat #9 
Nestle170: folds 
bateman225: calls $1.50
Rulet345: folds 
Xamil666: folds 
*** FLOP *** [4d 7d Jd]
J0hnDee: bets $2.25
bateman225: folds 
Uncalled bet ($2.25) returned to J0hnDee
J0hnDee collected $4.04 from pot
*** SUMMARY ***
Total pot $4.25 | Rake $0.21 
Board [4d 7d Jd]
Seat 1: Nestle170 folded before Flop (didn't bet)
Seat 2: bateman225 (button) folded on the Flop
Seat 3: Rulet345 (small blind) folded before Flop
Seat 5: Xamil666 (big blind) folded before Flop
Seat 6: J0hnDee collected ($4.04)
Seat 7: marshallteem folded before Flop (didn't bet)



PokerStars Hand #228686116660:  Hold'em No Limit ($0.25/$0.50 USD) - 2021/07/30 15:02:18 ET
Table 'Bok II' 9-max Seat #3 is the button
Seat 1: Nestle170 ($94.82 in chips) 
Seat 2: bateman225 ($47.62 in chips) 
Seat 3: Rulet345 ($50 in chips) 
Seat 5: Xamil666 ($51.56 in chips) 
Seat 6: J0hnDee ($87.24 in chips) 
Seat 7: marshallteem ($30.44 in chips) 
Xamil666: posts small blind $0.25
J0hnDee: posts big blind $0.50
SwimmingPooI: sits out 
goldenpig666: sits out 
*** HOLE CARDS ***
marshallteem: calls $0.50
Nestle170: folds 
bateman225: folds 
Rulet345: raises $1.75 to $2.25
Xamil666: folds 
J0hnDee: calls $1.75
marshallteem: calls $1.75
*** FLOP *** [9d 7s 9c]
J0hnDee: checks 
marshallteem: checks 
Rulet345: bets $3.33
J0hnDee: folds 
marshallteem: folds 
Uncalled bet ($3.33) returned to Rulet345
Rulet345 collected $6.65 from pot
Rulet345: doesn't show hand 
*** SUMMARY ***
Total pot $7 | Rake $0.35 
Board [9d 7s 9c]
Seat 1: Nestle170 folded before Flop (didn't bet)
Seat 2: bateman225 folded before Flop (didn't bet)
Seat 3: Rulet345 (button) collected ($6.65)
Seat 5: Xamil666 (small blind) folded before Flop
Seat 6: J0hnDee (big blind) folded on the Flop
Seat 7: marshallteem folded on the Flop



PokerStars Hand #228686136696:  Hold'em No Limit ($0.25/$0.50 USD) - 2021/07/30 15:03:05 ET
Table 'Bok II' 9-max Seat #5 is the button
Seat 1: Nestle170 ($94.82 in chips) 
Seat 2: bateman225 ($47.62 in chips) 
Seat 3: Rulet345 ($54.40 in chips) 
Seat 5: Xamil666 ($51.31 in chips) 
Seat 6: J0hnDee ($84.99 in chips) 
Seat 7: marshallteem ($28.19 in chips) 
J0hnDee: posts small blind $0.25
marshallteem: posts big blind $0.50
SwimmingPooI: sits out 
goldenpig666: sits out 
KerilTheBoss: sits out 
*** HOLE CARDS ***
Nestle170: folds 
bateman225: folds 
Rulet345: folds 
Xamil666: folds 
J0hnDee: raises $1.25 to $1.75
marshallteem: calls $1.25
*** FLOP *** [2s Qh Qc]
J0hnDee: bets $1
marshallteem: folds 
Uncalled bet ($1) returned to J0hnDee
J0hnDee collected $3.32 from pot
*** SUMMARY ***
Total pot $3.50 | Rake $0.18 
Board [2s Qh Qc]
Seat 1: Nestle170 folded before Flop (didn't bet)
Seat 2: bateman225 folded before Flop (didn't bet)
Seat 3: Rulet345 folded before Flop (didn't bet)
Seat 5: Xamil666 (button) folded before Flop (didn't bet)
Seat 6: J0hnDee (small blind) collected ($3.32)
Seat 7: marshallteem (big blind) folded on the Flop



PokerStars Hand #228686147040:  Hold'em No Limit ($0.25/$0.50 USD) - 2021/07/30 15:03:29 ET
Table 'Bok II' 9-max Seat #6 is the button
Seat 1: Nestle170 ($94.82 in chips) 
Seat 2: bateman225 ($47.62 in chips) 
Seat 3: Rulet345 ($54.40 in chips) 
Seat 5: Xamil666 ($51.31 in chips) 
Seat 6: J0hnDee ($86.56 in chips) 
Seat 7: marshallteem ($26.44 in chips) 
Seat 8: SwimmingPooI ($50 in chips) 
marshallteem: posts small blind $0.25
SwimmingPooI: posts big blind $0.50
goldenpig666: sits out 
KerilTheBoss: sits out 
*** HOLE CARDS ***
Nestle170: folds 
bateman225: folds 
Rulet345: folds 
Xamil666: folds 
J0hnDee: folds 
marshallteem: calls $0.25
SwimmingPooI: checks 
*** FLOP *** [4h 8c 7d]
marshallteem: bets $0.50
SwimmingPooI: raises $1.50 to $2
marshallteem: folds 
Uncalled bet ($1.50) returned to SwimmingPooI
SwimmingPooI collected $1.90 from pot
SwimmingPooI: doesn't show hand 
*** SUMMARY ***
Total pot $2 | Rake $0.10 
Board [4h 8c 7d]
Seat 1: Nestle170 folded before Flop (didn't bet)
Seat 2: bateman225 folded before Flop (didn't bet)
Seat 3: Rulet345 folded before Flop (didn't bet)
Seat 5: Xamil666 folded before Flop (didn't bet)
Seat 6: J0hnDee (button) folded before Flop (didn't bet)
Seat 7: marshallteem (small blind) folded on the Flop
Seat 8: SwimmingPooI (big blind) collected ($1.90)



PokerStars Hand #228686160645:  Hold'em No Limit ($0.25/$0.50 USD) - 2021/07/30 15:04:00 ET
Table 'Bok II' 9-max Seat #7 is the button
Seat 1: Nestle170 ($94.82 in chips) 
Seat 2: bateman225 ($47.62 in chips) 
Seat 3: Rulet345 ($54.40 in chips) 
Seat 5: Xamil666 ($51.31 in chips) 
Seat 6: J0hnDee ($86.56 in chips) 
Seat 7: marshallteem ($25.44 in chips) 
Seat 8: SwimmingPooI ($50.90 in chips) 
Seat 9: goldenpig666 ($59.45 in chips) 
SwimmingPooI: posts small blind $0.25
goldenpig666: posts big blind $0.50
KerilTheBoss: sits out 
*** HOLE CARDS ***
Nestle170: raises $1 to $1.50
bateman225: folds 
Rulet345: folds 
Xamil666: folds 
J0hnDee: folds 
marshallteem: raises $1 to $2.50
SwimmingPooI: folds 
goldenpig666: folds 
Nestle170: raises $4 to $6.50
marshallteem: calls $4
*** FLOP *** [3c 2h 8c]
Nestle170: bets $3.26
marshallteem: folds 
Uncalled bet ($3.26) returned to Nestle170
Nestle170 collected $13.06 from pot
Nestle170: doesn't show hand 
*** SUMMARY ***
Total pot $13.75 | Rake $0.69 
Board [3c 2h 8c]
Seat 1: Nestle170 collected ($13.06)
Seat 2: bateman225 folded before Flop (didn't bet)
Seat 3: Rulet345 folded before Flop (didn't bet)
Seat 5: Xamil666 folded before Flop (didn't bet)
Seat 6: J0hnDee folded before Flop (didn't bet)
Seat 7: marshallteem (button) folded on the Flop
Seat 8: SwimmingPooI (small blind) folded before Flop
Seat 9: goldenpig666 (big blind) folded before Flop



PokerStars Hand #228686188507:  Hold'em No Limit ($0.25/$0.50 USD) - 2021/07/30 15:05:02 ET
Table 'Bok II' 9-max Seat #8 is the button
Seat 1: Nestle170 ($101.38 in chips) 
Seat 2: bateman225 ($47.62 in chips) 
Seat 3: Rulet345 ($54.40 in chips) 
Seat 5: Xamil666 ($51.31 in chips) 
Seat 6: J0hnDee ($86.56 in chips) 
Seat 7: marshallteem ($18.94 in chips) 
Seat 8: SwimmingPooI ($50.65 in chips) 
Seat 9: goldenpig666 ($58.95 in chips) 
goldenpig666: posts small blind $0.25
Nestle170: posts big blind $0.50
KerilTheBoss: sits out 
*** HOLE CARDS ***
bateman225: calls $0.50
Rulet345: folds 
Xamil666: folds 
J0hnDee: folds 
marshallteem: folds 
SwimmingPooI: folds 
goldenpig666: folds 
Nestle170: checks 
*** FLOP *** [7c 5h 2c]
Nestle170: checks 
bateman225: checks 
*** TURN *** [7c 5h 2c] [2s]
Nestle170: bets $0.65
bateman225: folds 
Uncalled bet ($0.65) returned to Nestle170
Nestle170 collected $1.19 from pot
Nestle170: doesn't show hand 
*** SUMMARY ***
Total pot $1.25 | Rake $0.06 
Board [7c 5h 2c 2s]
Seat 1: Nestle170 (big blind) collected ($1.19)
Seat 2: bateman225 folded on the Turn
Seat 3: Rulet345 folded before Flop (didn't bet)
Seat 5: Xamil666 folded before Flop (didn't bet)
Seat 6: J0hnDee folded before Flop (didn't bet)
Seat 7: marshallteem folded before Flop (didn't bet)
Seat 8: SwimmingPooI (button) folded before Flop (didn't bet)
Seat 9: goldenpig666 (small blind) folded before Flop



PokerStars Hand #228686207405:  Hold'em No Limit ($0.25/$0.50 USD) - 2021/07/30 15:05:34 ET
Table 'Bok II' 9-max Seat #9 is the button
Seat 1: Nestle170 ($102.07 in chips) 
Seat 2: bateman225 ($47.12 in chips) 
Seat 3: Rulet345 ($54.40 in chips) 
Seat 5: Xamil666 ($51.31 in chips) 
Seat 6: J0hnDee ($86.56 in chips) 
Seat 7: marshallteem ($18.94 in chips) 
Seat 8: SwimmingPooI ($50.65 in chips) 
Seat 9: goldenpig666 ($58.70 in chips) 
Nestle170: posts small blind $0.25
bateman225: posts big blind $0.50
KerilTheBoss: sits out 
*** HOLE CARDS ***
Rulet345: folds 
Xamil666: raises $1 to $1.50
J0hnDee: folds 
marshallteem: folds 
SwimmingPooI: folds 
goldenpig666: folds 
Nestle170: folds 
bateman225: folds 
Uncalled bet ($1) returned to Xamil666
Xamil666 collected $1.25 from pot
*** SUMMARY ***
Total pot $1.25 | Rake $0 
Seat 1: Nestle170 (small blind) folded before Flop
Seat 2: bateman225 (big blind) folded before Flop
Seat 3: Rulet345 folded before Flop (didn't bet)
Seat 5: Xamil666 collected ($1.25)
Seat 6: J0hnDee folded before Flop (didn't bet)
Seat 7: marshallteem folded before Flop (didn't bet)
Seat 8: SwimmingPooI folded before Flop (didn't bet)
Seat 9: goldenpig666 (button) folded before Flop (didn't bet)



PokerStars Hand #228686214682:  Hold'em No Limit ($0.25/$0.50 USD) - 2021/07/30 15:05:50 ET
Table 'Bok II' 9-max Seat #1 is the button
Seat 1: Nestle170 ($101.82 in chips) 
Seat 2: bateman225 ($46.62 in chips) 
Seat 3: Rulet345 ($54.40 in chips) 
Seat 5: Xamil666 ($52.06 in chips) 
Seat 6: J0hnDee ($86.56 in chips) 
Seat 7: marshallteem ($18.94 in chips) 
Seat 8: SwimmingPooI ($50.65 in chips) 
Seat 9: goldenpig666 ($58.70 in chips) 
bateman225: posts small blind $0.25
Rulet345: posts big blind $0.50
KerilTheBoss: sits out 
*** HOLE CARDS ***
Xamil666: folds 
J0hnDee: folds 
marshallteem: folds 
SwimmingPooI: folds 
goldenpig666: raises $0.75 to $1.25
Nestle170: folds 
bateman225: folds 
Rulet345: calls $0.75
*** FLOP *** [Js 6d 7h]
Rulet345: checks 
goldenpig666: checks 
*** TURN *** [Js 6d 7h] [2d]
Rulet345: bets $1.74
goldenpig666: folds 
Uncalled bet ($1.74) returned to Rulet345
Rulet345 collected $2.61 from pot
Rulet345: doesn't show hand 
*** SUMMARY ***
Total pot $2.75 | Rake $0.14 
Board [Js 6d 7h 2d]
Seat 1: Nestle170 (button) folded before Flop (didn't bet)
Seat 2: bateman225 (small blind) folded before Flop
Seat 3: Rulet345 (big blind) collected ($2.61)
Seat 5: Xamil666 folded before Flop (didn't bet)
Seat 6: J0hnDee folded before Flop (didn't bet)
Seat 7: marshallteem folded before Flop (didn't bet)
Seat 8: SwimmingPooI folded before Flop (didn't bet)
Seat 9: goldenpig666 folded on the Turn



PokerStars Hand #228686242932:  Hold'em No Limit ($0.25/$0.50 USD) - 2021/07/30 15:06:52 ET
Table 'Bok II' 9-max Seat #2 is the button
Seat 1: Nestle170 ($101.82 in chips) 
Seat 2: bateman225 ($46.37 in chips) 
Seat 3: Rulet345 ($55.76 in chips) 
Seat 4: KerilTheBoss ($66.39 in chips) 
Seat 5: Xamil666 ($52.06 in chips) 
Seat 6: J0hnDee ($86.56 in chips) 
Seat 7: marshallteem ($18.94 in chips) 
Seat 8: SwimmingPooI ($50.65 in chips) 
Seat 9: goldenpig666 ($57.45 in chips) 
Rulet345: posts small blind $0.25
KerilTheBoss: posts big blind $0.50
*** HOLE CARDS ***
Xamil666: folds 
J0hnDee: folds 
marshallteem: calls $0.50
SwimmingPooI: folds 
goldenpig666: folds 
Nestle170: folds 
bateman225: folds 
Rulet345: folds 
KerilTheBoss: checks 
*** FLOP *** [2h 7s 6d]
KerilTheBoss: checks 
marshallteem: checks 
*** TURN *** [2h 7s 6d] [Kd]
KerilTheBoss: bets $0.75
marshallteem: folds 
Uncalled bet ($0.75) returned to KerilTheBoss
KerilTheBoss collected $1.19 from pot
KerilTheBoss: doesn't show hand 
*** SUMMARY ***
Total pot $1.25 | Rake $0.06 
Board [2h 7s 6d Kd]
Seat 1: Nestle170 folded before Flop (didn't bet)
Seat 2: bateman225 (button) folded before Flop (didn't bet)
Seat 3: Rulet345 (small blind) folded before Flop
Seat 4: KerilTheBoss (big blind) collected ($1.19)
Seat 5: Xamil666 folded before Flop (didn't bet)
Seat 6: J0hnDee folded before Flop (didn't bet)
Seat 7: marshallteem folded on the Turn
Seat 8: SwimmingPooI folded before Flop (didn't bet)
Seat 9: goldenpig666 folded before Flop (didn't bet)



PokerStars Hand #228686255940:  Hold'em No Limit ($0.25/$0.50 USD) - 2021/07/30 15:07:20 ET
Table 'Bok II' 9-max Seat #3 is the button
Seat 1: Nestle170 ($101.82 in chips) 
Seat 2: bateman225 ($46.37 in chips) 
Seat 3: Rulet345 ($55.51 in chips) 
Seat 4: KerilTheBoss ($67.08 in chips) 
Seat 5: Xamil666 ($52.06 in chips) 
Seat 6: J0hnDee ($86.56 in chips) 
Seat 7: marshallteem ($18.44 in chips) 
Seat 8: SwimmingPooI ($50.65 in chips) 
Seat 9: goldenpig666 ($57.45 in chips) 
KerilTheBoss: posts small blind $0.25
Xamil666: posts big blind $0.50
*** HOLE CARDS ***
J0hnDee: folds 
marshallteem: calls $0.50
SwimmingPooI: raises $2 to $2.50
goldenpig666: folds 
Nestle170: folds 
bateman225: folds 
Rulet345: folds 
KerilTheBoss: folds 
Xamil666: folds 
marshallteem: calls $2
*** FLOP *** [2h 9s 7d]
marshallteem: checks 
SwimmingPooI: bets $2.78
marshallteem: folds 
Uncalled bet ($2.78) returned to SwimmingPooI
SwimmingPooI collected $5.46 from pot
SwimmingPooI: doesn't show hand 
*** SUMMARY ***
Total pot $5.75 | Rake $0.29 
Board [2h 9s 7d]
Seat 1: Nestle170 folded before Flop (didn't bet)
Seat 2: bateman225 folded before Flop (didn't bet)
Seat 3: Rulet345 (button) folded before Flop (didn't bet)
Seat 4: KerilTheBoss (small blind) folded before Flop
Seat 5: Xamil666 (big blind) folded before Flop
Seat 6: J0hnDee folded before Flop (didn't bet)
Seat 7: marshallteem folded on the Flop
Seat 8: SwimmingPooI collected ($5.46)
Seat 9: goldenpig666 folded before Flop (didn't bet)



PokerStars Hand #228686269115:  Hold'em No Limit ($0.25/$0.50 USD) - 2021/07/30 15:07:49 ET
Table 'Bok II' 9-max Seat #4 is the button
Seat 1: Nestle170 ($101.82 in chips) 
Seat 2: bateman225 ($46.37 in chips) 
Seat 3: Rulet345 ($55.51 in chips) 
Seat 4: KerilTheBoss ($66.83 in chips) 
Seat 5: Xamil666 ($51.56 in chips) 
Seat 6: J0hnDee ($86.56 in chips) 
Seat 7: marshallteem ($15.94 in chips) 
Seat 8: SwimmingPooI ($53.61 in chips) 
Seat 9: goldenpig666 ($57.45 in chips) 
Xamil666: posts small blind $0.25
J0hnDee: posts big blind $0.50
*** HOLE CARDS ***
marshallteem: calls $0.50
SwimmingPooI: folds 
goldenpig666: folds 
Nestle170: raises $1.50 to $2
bateman225: folds 
Rulet345: folds 
KerilTheBoss: folds 
Xamil666: folds 
J0hnDee: folds 
marshallteem: calls $1.50
*** FLOP *** [7c 9c 9h]
marshallteem: checks 
Nestle170: bets $1.80
marshallteem: calls $1.80
*** TURN *** [7c 9c 9h] [8h]
marshallteem: checks 
Nestle170: checks 
*** RIVER *** [7c 9c 9h 8h] [Tc]
marshallteem: checks 
Nestle170: checks 
*** SHOW DOWN ***
marshallteem: shows [9s Ac] (three of a kind, Nines)
Nestle170: shows [Ah Jc] (a straight, Seven to Jack)
Nestle170 collected $7.93 from pot
*** SUMMARY ***
Total pot $8.35 | Rake $0.42 
Board [7c 9c 9h 8h Tc]
Seat 1: Nestle170 showed [Ah Jc] and won ($7.93) with a straight, Seven to Jack
Seat 2: bateman225 folded before Flop (didn't bet)
Seat 3: Rulet345 folded before Flop (didn't bet)
Seat 4: KerilTheBoss (button) folded before Flop (didn't bet)
Seat 5: Xamil666 (small blind) folded before Flop
Seat 6: J0hnDee (big blind) folded before Flop
Seat 7: marshallteem showed [9s Ac] and lost with three of a kind, Nines
Seat 8: SwimmingPooI folded before Flop (didn't bet)
Seat 9: goldenpig666 folded before Flop (didn't bet)



PokerStars Hand #228686294684:  Hold'em No Limit ($0.25/$0.50 USD) - 2021/07/30 15:08:44 ET
Table 'Bok II' 9-max Seat #5 is the button
Seat 1: Nestle170 ($105.95 in chips) 
Seat 2: bateman225 ($46.37 in chips) 
Seat 3: Rulet345 ($55.51 in chips) 
Seat 4: KerilTheBoss ($66.83 in chips) 
Seat 5: Xamil666 ($51.31 in chips) 
Seat 6: J0hnDee ($86.06 in chips) 
Seat 7: marshallteem ($12.14 in chips) 
Seat 8: SwimmingPooI ($53.61 in chips) 
Seat 9: goldenpig666 ($57.45 in chips) 
J0hnDee: posts small blind $0.25
marshallteem: posts big blind $0.50
*** HOLE CARDS ***
SwimmingPooI: raises $1 to $1.50
goldenpig666: folds 
Nestle170: folds 
bateman225: calls $1.50
Rulet345: folds 
KerilTheBoss: folds 
Xamil666: folds 
J0hnDee: folds 
marshallteem: folds 
*** FLOP *** [Qs Th 9c]
SwimmingPooI: bets $1.82
bateman225: calls $1.82
*** TURN *** [Qs Th 9c] [6d]
SwimmingPooI: bets $4.91
bateman225: raises $7.91 to $12.82
SwimmingPooI: folds 
Uncalled bet ($7.91) returned to bateman225
bateman225 collected $16.35 from pot
bateman225: doesn't show hand 
*** SUMMARY ***
Total pot $17.21 | Rake $0.86 
Board [Qs Th 9c 6d]
Seat 1: Nestle170 folded before Flop (didn't bet)
Seat 2: bateman225 collected ($16.35)
Seat 3: Rulet345 folded before Flop (didn't bet)
Seat 4: KerilTheBoss folded before Flop (didn't bet)
Seat 5: Xamil666 (button) folded before Flop (didn't bet)
Seat 6: J0hnDee (small blind) folded before Flop
Seat 7: marshallteem (big blind) folded before Flop
Seat 8: SwimmingPooI folded on the Turn
Seat 9: goldenpig666 folded before Flop (didn't bet)



PokerStars Hand #228686319560:  Hold'em No Limit ($0.25/$0.50 USD) - 2021/07/30 15:09:38 ET
Table 'Bok II' 9-max Seat #6 is the button
Seat 1: Nestle170 ($105.95 in chips) 
Seat 2: bateman225 ($54.49 in chips) 
Seat 3: Rulet345 ($55.51 in chips) 
Seat 4: KerilTheBoss ($66.83 in chips) 
Seat 5: Xamil666 ($51.31 in chips) 
Seat 6: J0hnDee ($85.81 in chips) 
Seat 7: marshallteem ($11.64 in chips) 
Seat 8: SwimmingPooI ($50 in chips) 
Seat 9: goldenpig666 ($57.45 in chips) 
marshallteem: posts small blind $0.25
SwimmingPooI: posts big blind $0.50
*** HOLE CARDS ***
goldenpig666: folds 
Nestle170: folds 
bateman225: raises $1 to $1.50
Rulet345: folds 
KerilTheBoss: folds 
Xamil666: folds 
J0hnDee: folds 
marshallteem: calls $1.25
SwimmingPooI: folds 
*** FLOP *** [Td Ts Jc]
marshallteem: checks 
bateman225: bets $1.50
marshallteem: folds 
Uncalled bet ($1.50) returned to bateman225
bateman225 collected $3.32 from pot
bateman225: doesn't show hand 
*** SUMMARY ***
Total pot $3.50 | Rake $0.18 
Board [Td Ts Jc]
Seat 1: Nestle170 folded before Flop (didn't bet)
Seat 2: bateman225 collected ($3.32)
Seat 3: Rulet345 folded before Flop (didn't bet)
Seat 4: KerilTheBoss folded before Flop (didn't bet)
Seat 5: Xamil666 folded before Flop (didn't bet)
Seat 6: J0hnDee (button) folded before Flop (didn't bet)
Seat 7: marshallteem (small blind) folded on the Flop
Seat 8: SwimmingPooI (big blind) folded before Flop
Seat 9: goldenpig666 folded before Flop (didn't bet)



PokerStars Hand #228686329947:  Hold'em No Limit ($0.25/$0.50 USD) - 2021/07/30 15:10:01 ET
Table 'Bok II' 9-max Seat #7 is the button
Seat 1: Nestle170 ($105.95 in chips) 
Seat 2: bateman225 ($56.31 in chips) 
Seat 3: Rulet345 ($55.51 in chips) 
Seat 4: KerilTheBoss ($66.83 in chips) 
Seat 5: Xamil666 ($51.31 in chips) 
Seat 6: J0hnDee ($85.81 in chips) 
Seat 7: marshallteem ($10.14 in chips) 
Seat 8: SwimmingPooI ($50 in chips) 
Seat 9: goldenpig666 ($57.45 in chips) 
SwimmingPooI: posts small blind $0.25
goldenpig666: posts big blind $0.50
*** HOLE CARDS ***
Nestle170: folds 
bateman225: folds 
Rulet345: folds 
KerilTheBoss: folds 
Xamil666: folds 
J0hnDee: folds 
marshallteem: folds 
SwimmingPooI: raises $1 to $1.50
goldenpig666: raises $3 to $4.50
SwimmingPooI: folds 
Uncalled bet ($3) returned to goldenpig666
goldenpig666 collected $3 from pot
goldenpig666: doesn't show hand 
*** SUMMARY ***
Total pot $3 | Rake $0 
Seat 1: Nestle170 folded before Flop (didn't bet)
Seat 2: bateman225 folded before Flop (didn't bet)
Seat 3: Rulet345 folded before Flop (didn't bet)
Seat 4: KerilTheBoss folded before Flop (didn't bet)
Seat 5: Xamil666 folded before Flop (didn't bet)
Seat 6: J0hnDee folded before Flop (didn't bet)
Seat 7: marshallteem (button) folded before Flop (didn't bet)
Seat 8: SwimmingPooI (small blind) folded before Flop
Seat 9: goldenpig666 (big blind) collected ($3)



PokerStars Hand #228686340505:  Hold'em No Limit ($0.25/$0.50 USD) - 2021/07/30 15:10:24 ET
Table 'Bok II' 9-max Seat #8 is the button
Seat 1: Nestle170 ($105.95 in chips) 
Seat 2: bateman225 ($56.31 in chips) 
Seat 3: Rulet345 ($55.51 in chips) 
Seat 4: KerilTheBoss ($66.83 in chips) 
Seat 5: Xamil666 ($51.31 in chips) 
Seat 6: J0hnDee ($85.81 in chips) 
Seat 7: marshallteem ($10.14 in chips) 
Seat 8: SwimmingPooI ($50 in chips) 
Seat 9: goldenpig666 ($58.95 in chips) 
goldenpig666: posts small blind $0.25
Nestle170: posts big blind $0.50
*** HOLE CARDS ***
bateman225: folds 
Rulet345: folds 
KerilTheBoss: folds 
Xamil666: folds 
J0hnDee: folds 
marshallteem: folds 
SwimmingPooI: raises $0.75 to $1.25
goldenpig666: folds 
Nestle170: calls $0.75
*** FLOP *** [6h Ts 3s]
Nestle170: checks 
SwimmingPooI: bets $1.33
Nestle170: calls $1.33
*** TURN *** [6h Ts 3s] [Ks]
Nestle170: checks 
SwimmingPooI: bets $3.60
Nestle170: folds 
Uncalled bet ($3.60) returned to SwimmingPooI
SwimmingPooI collected $5.14 from pot
SwimmingPooI: doesn't show hand 
*** SUMMARY ***
Total pot $5.41 | Rake $0.27 
Board [6h Ts 3s Ks]
Seat 1: Nestle170 (big blind) folded on the Turn
Seat 2: bateman225 folded before Flop (didn't bet)
Seat 3: Rulet345 folded before Flop (didn't bet)
Seat 4: KerilTheBoss folded before Flop (didn't bet)
Seat 5: Xamil666 folded before Flop (didn't bet)
Seat 6: J0hnDee folded before Flop (didn't bet)
Seat 7: marshallteem folded before Flop (didn't bet)
Seat 8: SwimmingPooI (button) collected ($5.14)
Seat 9: goldenpig666 (small blind) folded before Flop



PokerStars Hand #228686363877:  Hold'em No Limit ($0.25/$0.50 USD) - 2021/07/30 15:11:14 ET
Table 'Bok II' 9-max Seat #9 is the button
Seat 1: Nestle170 ($103.37 in chips) 
Seat 2: bateman225 ($56.31 in chips) 
Seat 3: Rulet345 ($55.51 in chips) 
Seat 4: KerilTheBoss ($66.83 in chips) 
Seat 5: Xamil666 ($51.31 in chips) 
Seat 6: J0hnDee ($85.81 in chips) 
Seat 7: marshallteem ($10.14 in chips) 
Seat 8: SwimmingPooI ($52.56 in chips) 
Seat 9: goldenpig666 ($58.70 in chips) 
Nestle170: posts small blind $0.25
bateman225: posts big blind $0.50
*** HOLE CARDS ***
Rulet345: raises $1 to $1.50
KerilTheBoss: folds 
Xamil666: folds 
J0hnDee: folds 
marshallteem: calls $1.50
SwimmingPooI: folds 
goldenpig666: raises $5 to $6.50
Nestle170: folds 
bateman225: folds 
Rulet345: folds 
marshallteem: raises $3.64 to $10.14 and is all-in
goldenpig666: calls $3.64
*** FLOP *** [3s Qh Qs]
*** TURN *** [3s Qh Qs] [Td]
*** RIVER *** [3s Qh Qs Td] [2h]
*** SHOW DOWN ***
marshallteem: shows [5c 5s] (two pair, Queens and Fives)
goldenpig666: shows [Ad Ac] (two pair, Aces and Queens)
goldenpig666 collected $21.12 from pot
*** SUMMARY ***
Total pot $22.53 | Rake $1.41 
Board [3s Qh Qs Td 2h]
Seat 1: Nestle170 (small blind) folded before Flop
Seat 2: bateman225 (big blind) folded before Flop
Seat 3: Rulet345 folded before Flop
Seat 4: KerilTheBoss folded before Flop (didn't bet)
Seat 5: Xamil666 folded before Flop (didn't bet)
Seat 6: J0hnDee folded before Flop (didn't bet)
Seat 7: marshallteem showed [5c 5s] and lost with two pair, Queens and Fives
Seat 8: SwimmingPooI folded before Flop (didn't bet)
Seat 9: goldenpig666 (button) showed [Ad Ac] and won ($21.12) with two pair, Aces and Queens



PokerStars Hand #228686382691:  Hold'em No Limit ($0.25/$0.50 USD) - 2021/07/30 15:11:55 ET
Table 'Bok II' 9-max Seat #1 is the button
Seat 1: Nestle170 ($103.12 in chips) 
Seat 2: bateman225 ($55.81 in chips) 
Seat 3: Rulet345 ($54.01 in chips) 
Seat 4: KerilTheBoss ($66.83 in chips) 
Seat 5: Xamil666 ($51.31 in chips) 
Seat 6: J0hnDee ($85.81 in chips) 
Seat 8: SwimmingPooI ($52.56 in chips) 
Seat 9: goldenpig666 ($69.68 in chips) 
bateman225: posts small blind $0.25
Rulet345: posts big blind $0.50
*** HOLE CARDS ***
KerilTheBoss: raises $1 to $1.50
Xamil666: folds 
J0hnDee: raises $2.50 to $4
SwimmingPooI: folds 
goldenpig666: folds 
marshallteem leaves the table
Zazabraza joins the table at seat #7 
Nestle170: folds 
bateman225: folds 
Rulet345: folds 
KerilTheBoss: folds 
Uncalled bet ($2.50) returned to J0hnDee
J0hnDee collected $3.75 from pot
*** SUMMARY ***
Total pot $3.75 | Rake $0 
Seat 1: Nestle170 (button) folded before Flop (didn't bet)
Seat 2: bateman225 (small blind) folded before Flop
Seat 3: Rulet345 (big blind) folded before Flop
Seat 4: KerilTheBoss folded before Flop
Seat 5: Xamil666 folded before Flop (didn't bet)
Seat 6: J0hnDee collected ($3.75)
Seat 8: SwimmingPooI folded before Flop (didn't bet)
Seat 9: goldenpig666 folded before Flop (didn't bet)



PokerStars Hand #228686394904:  Hold'em No Limit ($0.25/$0.50 USD) - 2021/07/30 15:12:21 ET
Table 'Bok II' 9-max Seat #2 is the button
Seat 1: Nestle170 ($103.12 in chips) 
Seat 2: bateman225 ($55.56 in chips) 
Seat 3: Rulet345 ($53.51 in chips) 
Seat 5: Xamil666 ($51.31 in chips) 
Seat 6: J0hnDee ($88.06 in chips) 
Seat 8: SwimmingPooI ($52.56 in chips) 
Seat 9: goldenpig666 ($69.68 in chips) 
Rulet345: posts small blind $0.25
KerilTheBoss: is sitting out 
Xamil666: posts big blind $0.50
Zazabraza: sits out 
*** HOLE CARDS ***
J0hnDee: folds 
KerilTheBoss leaves the table
SwimmingPooI: folds 
goldenpig666: folds 
Nestle170: raises $0.75 to $1.25
bateman225: raises $1.75 to $3
Rulet345: folds 
Xamil666: folds 
aaahaaa1967 joins the table at seat #4 
Nestle170: calls $1.75
*** FLOP *** [3h 6s Ks]
Nestle170: checks 
bateman225: bets $3.50
Nestle170: calls $3.50
*** TURN *** [3h 6s Ks] [3s]
Nestle170: bets $4.31
bateman225: folds 
Uncalled bet ($4.31) returned to Nestle170
Nestle170 collected $13.06 from pot
Nestle170: doesn't show hand 
*** SUMMARY ***
Total pot $13.75 | Rake $0.69 
Board [3h 6s Ks 3s]
Seat 1: Nestle170 collected ($13.06)
Seat 2: bateman225 (button) folded on the Turn
Seat 3: Rulet345 (small blind) folded before Flop
Seat 5: Xamil666 (big blind) folded before Flop
Seat 6: J0hnDee folded before Flop (didn't bet)
Seat 8: SwimmingPooI folded before Flop (didn't bet)
Seat 9: goldenpig666 folded before Flop (didn't bet)



PokerStars Hand #228686424511:  Hold'em No Limit ($0.25/$0.50 USD) - 2021/07/30 15:13:26 ET
Table 'Bok II' 9-max Seat #3 is the button
Seat 1: Nestle170 ($109.68 in chips) 
Seat 2: bateman225 ($49.06 in chips) 
Seat 3: Rulet345 ($53.26 in chips) 
Seat 5: Xamil666 ($50.81 in chips) 
Seat 6: J0hnDee ($88.06 in chips) 
Seat 8: SwimmingPooI ($52.56 in chips) 
Seat 9: goldenpig666 ($69.68 in chips) 
Xamil666: posts small blind $0.25
J0hnDee: posts big blind $0.50
Zazabraza: sits out 
*** HOLE CARDS ***
SwimmingPooI: folds 
goldenpig666: folds 
Nestle170: raises $1 to $1.50
bateman225: folds 
Rulet345: folds 
Xamil666: folds 
J0hnDee: folds 
Uncalled bet ($1) returned to Nestle170
Nestle170 collected $1.25 from pot
Nestle170: doesn't show hand 
*** SUMMARY ***
Total pot $1.25 | Rake $0 
Seat 1: Nestle170 collected ($1.25)
Seat 2: bateman225 folded before Flop (didn't bet)
Seat 3: Rulet345 (button) folded before Flop (didn't bet)
Seat 5: Xamil666 (small blind) folded before Flop
Seat 6: J0hnDee (big blind) folded before Flop
Seat 8: SwimmingPooI folded before Flop (didn't bet)
Seat 9: goldenpig666 folded before Flop (didn't bet)



PokerStars Hand #228686429923:  Hold'em No Limit ($0.25/$0.50 USD) - 2021/07/30 15:13:37 ET
Table 'Bok II' 9-max Seat #5 is the button
Seat 1: Nestle170 ($110.43 in chips) 
Seat 2: bateman225 ($49.06 in chips) 
Seat 3: Rulet345 ($53.26 in chips) 
Seat 4: aaahaaa1967 ($50 in chips) 
Seat 5: Xamil666 ($50.56 in chips) 
Seat 6: J0hnDee ($87.56 in chips) 
Seat 7: Zazabraza ($24.62 in chips) 
Seat 8: SwimmingPooI ($52.56 in chips) 
Seat 9: goldenpig666 ($69.68 in chips) 
J0hnDee: posts small blind $0.25
Zazabraza: posts big blind $0.50
aaahaaa1967: posts big blind $0.50
*** HOLE CARDS ***
SwimmingPooI: raises $1 to $1.50
goldenpig666: folds 
Nestle170: folds 
bateman225: folds 
Rulet345: raises $3.50 to $5
aaahaaa1967: folds 
Xamil666: folds 
J0hnDee: folds 
Zazabraza: folds 
SwimmingPooI: folds 
Uncalled bet ($3.50) returned to Rulet345
Rulet345 collected $4.25 from pot
Rulet345: doesn't show hand 
*** SUMMARY ***
Total pot $4.25 | Rake $0 
Seat 1: Nestle170 folded before Flop (didn't bet)
Seat 2: bateman225 folded before Flop (didn't bet)
Seat 3: Rulet345 collected ($4.25)
Seat 4: aaahaaa1967 folded before Flop (didn't bet)
Seat 5: Xamil666 (button) folded before Flop (didn't bet)
Seat 6: J0hnDee (small blind) folded before Flop
Seat 7: Zazabraza (big blind) folded before Flop
Seat 8: SwimmingPooI folded before Flop
Seat 9: goldenpig666 folded before Flop (didn't bet)



PokerStars Hand #228686452291:  Hold'em No Limit ($0.25/$0.50 USD) - 2021/07/30 15:14:08 ET
Table 'Bok II' 9-max Seat #6 is the button
Seat 1: Nestle170 ($110.43 in chips) 
Seat 2: bateman225 ($49.06 in chips) 
Seat 3: Rulet345 ($56.01 in chips) 
Seat 4: aaahaaa1967 ($49.50 in chips) 
Seat 5: Xamil666 ($50.56 in chips) 
Seat 6: J0hnDee ($87.31 in chips) 
Seat 7: Zazabraza ($24.12 in chips) 
Seat 8: SwimmingPooI ($51.06 in chips) 
Seat 9: goldenpig666 ($69.68 in chips) 
Zazabraza: posts small blind $0.25
SwimmingPooI: posts big blind $0.50
*** HOLE CARDS ***
goldenpig666: folds 
Nestle170: folds 
bateman225: raises $1 to $1.50
Rulet345: folds 
aaahaaa1967: calls $1.50
Xamil666: folds 
J0hnDee: folds 
Zazabraza: folds 
SwimmingPooI: folds 
*** FLOP *** [Tc 9h Td]
bateman225: checks 
aaahaaa1967: checks 
*** TURN *** [Tc 9h Td] [6c]
bateman225: bets $2
aaahaaa1967: calls $2
*** RIVER *** [Tc 9h Td 6c] [Kh]
bateman225: bets $3.50
aaahaaa1967: calls $3.50
*** SHOW DOWN ***
bateman225: shows [Ad Qh] (a pair of Tens)
aaahaaa1967: shows [9d 5d] (two pair, Tens and Nines)
aaahaaa1967 collected $14.01 from pot
*** SUMMARY ***
Total pot $14.75 | Rake $0.74 
Board [Tc 9h Td 6c Kh]
Seat 1: Nestle170 folded before Flop (didn't bet)
Seat 2: bateman225 showed [Ad Qh] and lost with a pair of Tens
Seat 3: Rulet345 folded before Flop (didn't bet)
Seat 4: aaahaaa1967 showed [9d 5d] and won ($14.01) with two pair, Tens and Nines
Seat 5: Xamil666 folded before Flop (didn't bet)
Seat 6: J0hnDee (button) folded before Flop (didn't bet)
Seat 7: Zazabraza (small blind) folded before Flop
Seat 8: SwimmingPooI (big blind) folded before Flop
Seat 9: goldenpig666 folded before Flop (didn't bet)



PokerStars Hand #228686466859:  Hold'em No Limit ($0.25/$0.50 USD) - 2021/07/30 15:14:40 ET
Table 'Bok II' 9-max Seat #7 is the button
Seat 2: bateman225 ($42.06 in chips) 
Seat 3: Rulet345 ($56.01 in chips) 
Seat 4: aaahaaa1967 ($56.51 in chips) 
Seat 5: Xamil666 ($50.56 in chips) 
Seat 6: J0hnDee ($87.31 in chips) 
Seat 7: Zazabraza ($23.87 in chips) 
Seat 8: SwimmingPooI ($50.56 in chips) 
SwimmingPooI: posts small blind $0.25
goldenpig666: is sitting out 
Nestle170: is sitting out 
bateman225: posts big blind $0.50
*** HOLE CARDS ***
goldenpig666 leaves the table
Nestle170 leaves the table
Rulet345: raises $1 to $1.50
aaahaaa1967: calls $1.50
Xamil666: folds 
J0hnDee: folds 
Zazabraza: folds 
SwimmingPooI: folds 
bateman225: folds 
*** FLOP *** [Qh 4s 9h]
Volk_Vetra joins the table at seat #9 
Rulet345: bets $1.78
aaahaaa1967: calls $1.78
*** TURN *** [Qh 4s 9h] [8d]
Rulet345: bets $4.63
aaahaaa1967: folds 
Uncalled bet ($4.63) returned to Rulet345
Rulet345 collected $6.94 from pot
Rulet345: doesn't show hand 
*** SUMMARY ***
Total pot $7.31 | Rake $0.37 
Board [Qh 4s 9h 8d]
Seat 2: bateman225 (big blind) folded before Flop
Seat 3: Rulet345 collected ($6.94)
Seat 4: aaahaaa1967 folded on the Turn
Seat 5: Xamil666 folded before Flop (didn't bet)
Seat 6: J0hnDee folded before Flop (didn't bet)
Seat 7: Zazabraza (button) folded before Flop (didn't bet)
Seat 8: SwimmingPooI (small blind) folded before Flop



PokerStars Hand #228686486599:  Hold'em No Limit ($0.25/$0.50 USD) - 2021/07/30 15:15:22 ET
Table 'Bok II' 9-max Seat #8 is the button
Seat 2: bateman225 ($41.56 in chips) 
Seat 3: Rulet345 ($59.67 in chips) 
Seat 4: aaahaaa1967 ($53.23 in chips) 
Seat 5: Xamil666 ($50.56 in chips) 
Seat 6: J0hnDee ($87.31 in chips) 
Seat 7: Zazabraza ($23.87 in chips) 
Seat 8: SwimmingPooI ($50.31 in chips) 
bateman225: posts small blind $0.25
greenflannel joins the table at seat #1 
Rulet345: posts big blind $0.50
*** HOLE CARDS ***
aaahaaa1967: calls $0.50
Xamil666: folds 
J0hnDee: folds 
Zazabraza has timed out
Zazabraza: folds 
SwimmingPooI: folds 
bateman225: raises $0.50 to $1
Rulet345: folds 
aaahaaa1967: calls $0.50
*** FLOP *** [Jd 4c 5s]
bateman225: bets $1.50
aaahaaa1967: folds 
Uncalled bet ($1.50) returned to bateman225
bateman225 collected $2.38 from pot
bateman225: doesn't show hand 
*** SUMMARY ***
Total pot $2.50 | Rake $0.12 
Board [Jd 4c 5s]
Seat 2: bateman225 (small blind) collected ($2.38)
Seat 3: Rulet345 (big blind) folded before Flop
Seat 4: aaahaaa1967 folded on the Flop
Seat 5: Xamil666 folded before Flop (didn't bet)
Seat 6: J0hnDee folded before Flop (didn't bet)
Seat 7: Zazabraza folded before Flop (didn't bet)
Seat 8: SwimmingPooI (button) folded before Flop (didn't bet)



PokerStars Hand #228686501292:  Hold'em No Limit ($0.25/$0.50 USD) - 2021/07/30 15:15:53 ET
Table 'Bok II' 9-max Seat #2 is the button
Seat 2: bateman225 ($42.94 in chips) 
Seat 3: Rulet345 ($59.17 in chips) 
Seat 4: aaahaaa1967 ($52.23 in chips) 
Seat 5: Xamil666 ($50.56 in chips) 
Seat 6: J0hnDee ($87.31 in chips) 
Seat 7: Zazabraza ($23.87 in chips) 
Seat 8: SwimmingPooI ($50.31 in chips) 
Rulet345: posts small blind $0.25
aaahaaa1967: posts big blind $0.50
Volk_Vetra: sits out 
greenflannel: sits out 
*** HOLE CARDS ***
Xamil666: folds 
J0hnDee: folds 
Zazabraza: calls $0.50
SwimmingPooI: raises $1.50 to $2
bateman225: calls $2
Rulet345: folds 
aaahaaa1967: folds 
Zazabraza: calls $1.50
*** FLOP *** [Kd Ac Qh]
Zazabraza: checks 
SwimmingPooI: checks 
bateman225: checks 
*** TURN *** [Kd Ac Qh] [4h]
Zazabraza: bets $6.41
SwimmingPooI: folds 
bateman225: folds 
Uncalled bet ($6.41) returned to Zazabraza
Zazabraza collected $6.41 from pot
Zazabraza: doesn't show hand 
*** SUMMARY ***
Total pot $6.75 | Rake $0.34 
Board [Kd Ac Qh 4h]
Seat 2: bateman225 (button) folded on the Turn
Seat 3: Rulet345 (small blind) folded before Flop
Seat 4: aaahaaa1967 (big blind) folded before Flop
Seat 5: Xamil666 folded before Flop (didn't bet)
Seat 6: J0hnDee folded before Flop (didn't bet)
Seat 7: Zazabraza collected ($6.41)
Seat 8: SwimmingPooI folded on the Turn



PokerStars Hand #228686523736:  Hold'em No Limit ($0.25/$0.50 USD) - 2021/07/30 15:16:42 ET
Table 'Bok II' 9-max Seat #3 is the button
Seat 2: bateman225 ($40.94 in chips) 
Seat 3: Rulet345 ($58.92 in chips) 
Seat 4: aaahaaa1967 ($51.73 in chips) 
Seat 5: Xamil666 ($50.56 in chips) 
Seat 6: J0hnDee ($87.31 in chips) 
Seat 7: Zazabraza ($28.28 in chips) 
Seat 8: SwimmingPooI ($50 in chips) 
aaahaaa1967: posts small blind $0.25
Xamil666: posts big blind $0.50
Volk_Vetra: sits out 
greenflannel: sits out 
*** HOLE CARDS ***
J0hnDee: folds 
Zazabraza: folds 
SwimmingPooI: folds 
bateman225: raises $1 to $1.50
Rulet345: calls $1.50
aaahaaa1967: folds 
Xamil666: folds 
*** FLOP *** [9h 9c Kh]
bateman225: bets $1.50
Rulet345: folds 
Uncalled bet ($1.50) returned to bateman225
bateman225 collected $3.56 from pot
bateman225: doesn't show hand 
*** SUMMARY ***
Total pot $3.75 | Rake $0.19 
Board [9h 9c Kh]
Seat 2: bateman225 collected ($3.56)
Seat 3: Rulet345 (button) folded on the Flop
Seat 4: aaahaaa1967 (small blind) folded before Flop
Seat 5: Xamil666 (big blind) folded before Flop
Seat 6: J0hnDee folded before Flop (didn't bet)
Seat 7: Zazabraza folded before Flop (didn't bet)
Seat 8: SwimmingPooI folded before Flop (didn't bet)



PokerStars Hand #228686539884:  Hold'em No Limit ($0.25/$0.50 USD) - 2021/07/30 15:17:16 ET
Table 'Bok II' 9-max Seat #4 is the button
Seat 2: bateman225 ($43 in chips) 
Seat 3: Rulet345 ($57.42 in chips) 
Seat 4: aaahaaa1967 ($51.48 in chips) 
Seat 5: Xamil666 ($50.06 in chips) 
Seat 6: J0hnDee ($87.31 in chips) 
Seat 7: Zazabraza ($28.28 in chips) 
Seat 8: SwimmingPooI ($50 in chips) 
Xamil666: posts small blind $0.25
J0hnDee: posts big blind $0.50
Volk_Vetra: sits out 
greenflannel: sits out 
*** HOLE CARDS ***
Zazabraza: calls $0.50
SwimmingPooI: raises $2 to $2.50
bateman225: folds 
Rulet345: folds 
aaahaaa1967: folds 
Xamil666: folds 
J0hnDee: folds 
Zazabraza: folds 
Uncalled bet ($2) returned to SwimmingPooI
SwimmingPooI collected $1.75 from pot
SwimmingPooI: doesn't show hand 
*** SUMMARY ***
Total pot $1.75 | Rake $0 
Seat 2: bateman225 folded before Flop (didn't bet)
Seat 3: Rulet345 folded before Flop (didn't bet)
Seat 4: aaahaaa1967 (button) folded before Flop (didn't bet)
Seat 5: Xamil666 (small blind) folded before Flop
Seat 6: J0hnDee (big blind) folded before Flop
Seat 7: Zazabraza folded before Flop
Seat 8: SwimmingPooI collected ($1.75)



PokerStars Hand #228686550306:  Hold'em No Limit ($0.25/$0.50 USD) - 2021/07/30 15:17:39 ET
Table 'Bok II' 9-max Seat #5 is the button
Seat 2: bateman225 ($43 in chips) 
Seat 3: Rulet345 ($57.42 in chips) 
Seat 4: aaahaaa1967 ($51.48 in chips) 
Seat 5: Xamil666 ($50 in chips) 
Seat 6: J0hnDee ($86.81 in chips) 
Seat 7: Zazabraza ($27.78 in chips) 
Seat 8: SwimmingPooI ($51.25 in chips) 
J0hnDee: posts small blind $0.25
Zazabraza: posts big blind $0.50
Volk_Vetra: sits out 
greenflannel: sits out 
*** HOLE CARDS ***
SwimmingPooI: folds 
bateman225: folds 
Rulet345: folds 
aaahaaa1967: folds 
Xamil666: folds 
J0hnDee: raises $1 to $1.50
Zazabraza: calls $1
*** FLOP *** [8d 7d 9h]
J0hnDee: bets $1.75
Zazabraza: calls $1.75
*** TURN *** [8d 7d 9h] [4s]
J0hnDee: bets $3
Zazabraza: calls $3
*** RIVER *** [8d 7d 9h 4s] [6h]
J0hnDee: checks 
Zazabraza: checks 
*** SHOW DOWN ***
J0hnDee: shows [3d Kd] (high card King)
Zazabraza: shows [6s As] (a pair of Sixes)
Zazabraza collected $11.88 from pot
*** SUMMARY ***
Total pot $12.50 | Rake $0.62 
Board [8d 7d 9h 4s 6h]
Seat 2: bateman225 folded before Flop (didn't bet)
Seat 3: Rulet345 folded before Flop (didn't bet)
Seat 4: aaahaaa1967 folded before Flop (didn't bet)
Seat 5: Xamil666 (button) folded before Flop (didn't bet)
Seat 6: J0hnDee (small blind) showed [3d Kd] and lost with high card King
Seat 7: Zazabraza (big blind) showed [6s As] and won ($11.88) with a pair of Sixes
Seat 8: SwimmingPooI folded before Flop (didn't bet)



PokerStars Hand #228686581303:  Hold'em No Limit ($0.25/$0.50 USD) - 2021/07/30 15:18:24 ET
Table 'Bok II' 9-max Seat #6 is the button
Seat 2: bateman225 ($43 in chips) 
Seat 3: Rulet345 ($57.42 in chips) 
Seat 4: aaahaaa1967 ($51.48 in chips) 
Seat 5: Xamil666 ($50 in chips) 
Seat 6: J0hnDee ($80.56 in chips) 
Seat 7: Zazabraza ($33.41 in chips) 
Seat 8: SwimmingPooI ($51.25 in chips) 
Zazabraza: posts small blind $0.25
SwimmingPooI: posts big blind $0.50
Volk_Vetra: sits out 
greenflannel: sits out 
*** HOLE CARDS ***
bateman225: folds 
Rulet345: folds 
aaahaaa1967: calls $0.50
Xamil666: folds 
J0hnDee: raises $1 to $1.50
Zazabraza: folds 
SwimmingPooI: folds 
aaahaaa1967: calls $1
*** FLOP *** [7h 5d 6c]
aaahaaa1967: checks 
J0hnDee: bets $2
aaahaaa1967: calls $2
*** TURN *** [7h 5d 6c] [3c]
aaahaaa1967: checks 
J0hnDee: bets $4
aaahaaa1967: folds 
Uncalled bet ($4) returned to J0hnDee
J0hnDee collected $7.36 from pot
*** SUMMARY ***
Total pot $7.75 | Rake $0.39 
Board [7h 5d 6c 3c]
Seat 2: bateman225 folded before Flop (didn't bet)
Seat 3: Rulet345 folded before Flop (didn't bet)
Seat 4: aaahaaa1967 folded on the Turn
Seat 5: Xamil666 folded before Flop (didn't bet)
Seat 6: J0hnDee (button) collected ($7.36)
Seat 7: Zazabraza (small blind) folded before Flop
Seat 8: SwimmingPooI (big blind) folded before Flop



PokerStars Hand #228686601368:  Hold'em No Limit ($0.25/$0.50 USD) - 2021/07/30 15:19:07 ET
Table 'Bok II' 9-max Seat #7 is the button
Seat 2: bateman225 ($43 in chips) 
Seat 3: Rulet345 ($57.42 in chips) 
Seat 4: aaahaaa1967 ($47.98 in chips) 
Seat 5: Xamil666 ($50 in chips) 
Seat 6: J0hnDee ($84.42 in chips) 
Seat 7: Zazabraza ($33.16 in chips) 
Seat 8: SwimmingPooI ($50.75 in chips) 
Seat 9: Volk_Vetra ($50 in chips) 
SwimmingPooI: posts small blind $0.25
Volk_Vetra: posts big blind $0.50
greenflannel: sits out 
*** HOLE CARDS ***
greenflannel leaves the table
bateman225: folds 
Rulet345: folds 
aaahaaa1967: folds 
Xamil666: folds 
J0hnDee: folds 
Zazabraza: folds 
SwimmingPooI: folds 
Uncalled bet ($0.25) returned to Volk_Vetra
Volk_Vetra collected $0.50 from pot
*** SUMMARY ***
Total pot $0.50 | Rake $0 
Seat 2: bateman225 folded before Flop (didn't bet)
Seat 3: Rulet345 folded before Flop (didn't bet)
Seat 4: aaahaaa1967 folded before Flop (didn't bet)
Seat 5: Xamil666 folded before Flop (didn't bet)
Seat 6: J0hnDee folded before Flop (didn't bet)
Seat 7: Zazabraza (button) folded before Flop (didn't bet)
Seat 8: SwimmingPooI (small blind) folded before Flop
Seat 9: Volk_Vetra (big blind) collected ($0.50)



PokerStars Hand #228686605011:  Hold'em No Limit ($0.25/$0.50 USD) - 2021/07/30 15:19:15 ET
Table 'Bok II' 9-max Seat #8 is the button
Seat 2: bateman225 ($43 in chips) 
Seat 3: Rulet345 ($57.42 in chips) 
Seat 4: aaahaaa1967 ($47.98 in chips) 
Seat 5: Xamil666 ($50 in chips) 
Seat 6: J0hnDee ($84.42 in chips) 
Seat 7: Zazabraza ($33.16 in chips) 
Seat 8: SwimmingPooI ($50.50 in chips) 
Seat 9: Volk_Vetra ($50.25 in chips) 
Volk_Vetra: posts small blind $0.25
bateman225: posts big blind $0.50
*** HOLE CARDS ***
Rulet345: folds 
aaahaaa1967: folds 
keko gr joins the table at seat #1 
Xamil666: folds 
J0hnDee: folds 
Zazabraza: raises $1 to $1.50
SwimmingPooI: folds 
Volk_Vetra: folds 
bateman225: calls $1
*** FLOP *** [Kh Qs 2c]
bateman225: checks 
Zazabraza: bets $3.09
bateman225: folds 
Uncalled bet ($3.09) returned to Zazabraza
Zazabraza collected $3.09 from pot
Zazabraza: doesn't show hand 
*** SUMMARY ***
Total pot $3.25 | Rake $0.16 
Board [Kh Qs 2c]
Seat 2: bateman225 (big blind) folded on the Flop
Seat 3: Rulet345 folded before Flop (didn't bet)
Seat 4: aaahaaa1967 folded before Flop (didn't bet)
Seat 5: Xamil666 folded before Flop (didn't bet)
Seat 6: J0hnDee folded before Flop (didn't bet)
Seat 7: Zazabraza collected ($3.09)
Seat 8: SwimmingPooI (button) folded before Flop (didn't bet)
Seat 9: Volk_Vetra (small blind) folded before Flop



PokerStars Hand #228686625075:  Hold'em No Limit ($0.25/$0.50 USD) - 2021/07/30 15:19:58 ET
Table 'Bok II' 9-max Seat #9 is the button
Seat 2: bateman225 ($41.50 in chips) 
Seat 3: Rulet345 ($57.42 in chips) 
Seat 4: aaahaaa1967 ($47.98 in chips) 
Seat 5: Xamil666 ($50 in chips) 
Seat 6: J0hnDee ($84.42 in chips) 
Seat 7: Zazabraza ($34.75 in chips) 
Seat 8: SwimmingPooI ($50.50 in chips) 
Seat 9: Volk_Vetra ($50 in chips) 
bateman225: posts small blind $0.25
Rulet345: posts big blind $0.50
*** HOLE CARDS ***
aaahaaa1967: calls $0.50
Xamil666: folds 
J0hnDee: folds 
Zazabraza: calls $0.50
J0hnDee leaves the table
SwimmingPooI: raises $2.50 to $3
Volk_Vetra: folds 
vipbor joins the table at seat #6 
bateman225: folds 
Rulet345: folds 
aaahaaa1967: folds 
Zazabraza: folds 
Uncalled bet ($2.50) returned to SwimmingPooI
SwimmingPooI collected $2.25 from pot
SwimmingPooI: doesn't show hand 
*** SUMMARY ***
Total pot $2.25 | Rake $0 
Seat 2: bateman225 (small blind) folded before Flop
Seat 3: Rulet345 (big blind) folded before Flop
Seat 4: aaahaaa1967 folded before Flop
Seat 5: Xamil666 folded before Flop (didn't bet)
Seat 6: J0hnDee folded before Flop (didn't bet)
Seat 7: Zazabraza folded before Flop
Seat 8: SwimmingPooI collected ($2.25)
Seat 9: Volk_Vetra (button) folded before Flop (didn't bet)



PokerStars Hand #228686635591:  Hold'em No Limit ($0.25/$0.50 USD) - 2021/07/30 15:20:20 ET
Table 'Bok II' 9-max Seat #2 is the button
Seat 2: bateman225 ($41.25 in chips) 
Seat 3: Rulet345 ($56.92 in chips) 
Seat 4: aaahaaa1967 ($47.48 in chips) 
Seat 5: Xamil666 ($50 in chips) 
Seat 7: Zazabraza ($34.25 in chips) 
Seat 8: SwimmingPooI ($52.25 in chips) 
Seat 9: Volk_Vetra ($50 in chips) 
Rulet345: posts small blind $0.25
aaahaaa1967: posts big blind $0.50
vipbor: sits out 
keko gr: sits out 
*** HOLE CARDS ***
Xamil666: folds 
Zazabraza: folds 
SwimmingPooI: folds 
Volk_Vetra: folds 
bateman225: folds 
Rulet345: folds 
Uncalled bet ($0.25) returned to aaahaaa1967
aaahaaa1967 collected $0.50 from pot
aaahaaa1967: doesn't show hand 
*** SUMMARY ***
Total pot $0.50 | Rake $0 
Seat 2: bateman225 (button) folded before Flop (didn't bet)
Seat 3: Rulet345 (small blind) folded before Flop
Seat 4: aaahaaa1967 (big blind) collected ($0.50)
Seat 5: Xamil666 folded before Flop (didn't bet)
Seat 7: Zazabraza folded before Flop (didn't bet)
Seat 8: SwimmingPooI folded before Flop (didn't bet)
Seat 9: Volk_Vetra folded before Flop (didn't bet)



PokerStars Hand #228686640161:  Hold'em No Limit ($0.25/$0.50 USD) - 2021/07/30 15:20:30 ET
Table 'Bok II' 9-max Seat #3 is the button
Seat 1: keko gr ($50 in chips) 
Seat 2: bateman225 ($41.25 in chips) 
Seat 3: Rulet345 ($56.67 in chips) 
Seat 4: aaahaaa1967 ($47.73 in chips) 
Seat 5: Xamil666 ($50 in chips) 
Seat 7: Zazabraza ($34.25 in chips) 
Seat 8: SwimmingPooI ($52.25 in chips) 
Seat 9: Volk_Vetra ($50 in chips) 
aaahaaa1967: posts small blind $0.25
Xamil666: posts big blind $0.50
vipbor: sits out 
keko gr: posts big blind $0.50
*** HOLE CARDS ***
Zazabraza: folds 
SwimmingPooI: folds 
Volk_Vetra: folds 
keko gr: checks 
bateman225: folds 
Rulet345: folds 
aaahaaa1967: folds 
Xamil666: checks 
*** FLOP *** [As 6s Qs]
Xamil666: checks 
keko gr: bets $0.70
Xamil666: folds 
Uncalled bet ($0.70) returned to keko gr
keko gr collected $1.19 from pot
*** SUMMARY ***
Total pot $1.25 | Rake $0.06 
Board [As 6s Qs]
Seat 1: keko gr collected ($1.19)
Seat 2: bateman225 folded before Flop (didn't bet)
Seat 3: Rulet345 (button) folded before Flop (didn't bet)
Seat 4: aaahaaa1967 (small blind) folded before Flop
Seat 5: Xamil666 (big blind) folded on the Flop
Seat 7: Zazabraza folded before Flop (didn't bet)
Seat 8: SwimmingPooI folded before Flop (didn't bet)
Seat 9: Volk_Vetra folded before Flop (didn't bet)



PokerStars Hand #228686655850:  Hold'em No Limit ($0.25/$0.50 USD) - 2021/07/30 15:21:03 ET
Table 'Bok II' 9-max Seat #4 is the button
Seat 1: keko gr ($50.69 in chips) 
Seat 2: bateman225 ($41.25 in chips) 
Seat 3: Rulet345 ($56.67 in chips) 
Seat 4: aaahaaa1967 ($47.48 in chips) 
Seat 5: Xamil666 ($50 in chips) 
Seat 6: vipbor ($50 in chips) 
Seat 7: Zazabraza ($34.25 in chips) 
Seat 8: SwimmingPooI ($52.25 in chips) 
Seat 9: Volk_Vetra ($50 in chips) 
Xamil666: posts small blind $0.25
vipbor: posts big blind $0.50
*** HOLE CARDS ***
Zazabraza: calls $0.50
SwimmingPooI: folds 
Volk_Vetra: folds 
keko gr: folds 
bateman225: folds 
Rulet345: folds 
aaahaaa1967: calls $0.50
Xamil666: folds 
vipbor: checks 
*** FLOP *** [2c 6c 3h]
vipbor: checks 
Zazabraza: checks 
aaahaaa1967: bets $1.66
vipbor: folds 
Zazabraza: folds 
Uncalled bet ($1.66) returned to aaahaaa1967
aaahaaa1967 collected $1.66 from pot
aaahaaa1967: doesn't show hand 
*** SUMMARY ***
Total pot $1.75 | Rake $0.09 
Board [2c 6c 3h]
Seat 1: keko gr folded before Flop (didn't bet)
Seat 2: bateman225 folded before Flop (didn't bet)
Seat 3: Rulet345 folded before Flop (didn't bet)
Seat 4: aaahaaa1967 (button) collected ($1.66)
Seat 5: Xamil666 (small blind) folded before Flop
Seat 6: vipbor (big blind) folded on the Flop
Seat 7: Zazabraza folded on the Flop
Seat 8: SwimmingPooI folded before Flop (didn't bet)
Seat 9: Volk_Vetra folded before Flop (didn't bet)



PokerStars Hand #228686672469:  Hold'em No Limit ($0.25/$0.50 USD) - 2021/07/30 15:21:39 ET
Table 'Bok II' 9-max Seat #5 is the button
Seat 1: keko gr ($50.69 in chips) 
Seat 2: bateman225 ($41.25 in chips) 
Seat 3: Rulet345 ($56.67 in chips) 
Seat 4: aaahaaa1967 ($48.64 in chips) 
Seat 5: Xamil666 ($50 in chips) 
Seat 6: vipbor ($50 in chips) 
Seat 7: Zazabraza ($33.75 in chips) 
Seat 8: SwimmingPooI ($52.25 in chips) 
Seat 9: Volk_Vetra ($50 in chips) 
vipbor: posts small blind $0.25
Zazabraza: posts big blind $0.50
*** HOLE CARDS ***
SwimmingPooI has timed out
SwimmingPooI: folds 
Volk_Vetra: folds 
keko gr: folds 
bateman225: folds 
Rulet345: folds 
aaahaaa1967: calls $0.50
Xamil666: folds 
vipbor: raises $2 to $2.50
Zazabraza: folds 
aaahaaa1967: calls $2
*** FLOP *** [2h 7c 3s]
vipbor: bets $2.87
aaahaaa1967: calls $2.87
*** TURN *** [2h 7c 3s] [Qs]
vipbor: checks 
aaahaaa1967: checks 
*** RIVER *** [2h 7c 3s Qs] [Td]
vipbor: checks 
aaahaaa1967: checks 
*** SHOW DOWN ***
vipbor: shows [Jd Ah] (high card Ace)
aaahaaa1967: shows [7s 8h] (a pair of Sevens)
aaahaaa1967 collected $10.68 from pot
*** SUMMARY ***
Total pot $11.24 | Rake $0.56 
Board [2h 7c 3s Qs Td]
Seat 1: keko gr folded before Flop (didn't bet)
Seat 2: bateman225 folded before Flop (didn't bet)
Seat 3: Rulet345 folded before Flop (didn't bet)
Seat 4: aaahaaa1967 showed [7s 8h] and won ($10.68) with a pair of Sevens
Seat 5: Xamil666 (button) folded before Flop (didn't bet)
Seat 6: vipbor (small blind) showed [Jd Ah] and lost with high card Ace
Seat 7: Zazabraza (big blind) folded before Flop
Seat 8: SwimmingPooI folded before Flop (didn't bet)
Seat 9: Volk_Vetra folded before Flop (didn't bet)



PokerStars Hand #228686699110:  Hold'em No Limit ($0.25/$0.50 USD) - 2021/07/30 15:22:36 ET
Table 'Bok II' 9-max Seat #6 is the button
Seat 1: keko gr ($50.69 in chips) 
Seat 2: bateman225 ($41.25 in chips) 
Seat 3: Rulet345 ($56.67 in chips) 
Seat 4: aaahaaa1967 ($53.95 in chips) 
Seat 5: Xamil666 ($50 in chips) 
Seat 6: vipbor ($50 in chips) 
Seat 7: Zazabraza ($33.25 in chips) 
Seat 8: SwimmingPooI ($52.25 in chips) 
Seat 9: Volk_Vetra ($50 in chips) 
Zazabraza: posts small blind $0.25
SwimmingPooI: posts big blind $0.50
*** HOLE CARDS ***
Volk_Vetra: folds 
keko gr: folds 
bateman225: folds 
Rulet345: folds 
aaahaaa1967: folds 
Xamil666: folds 
vipbor: folds 
Zazabraza: folds 
Uncalled bet ($0.25) returned to SwimmingPooI
SwimmingPooI collected $0.50 from pot
SwimmingPooI: doesn't show hand 
*** SUMMARY ***
Total pot $0.50 | Rake $0 
Seat 1: keko gr folded before Flop (didn't bet)
Seat 2: bateman225 folded before Flop (didn't bet)
Seat 3: Rulet345 folded before Flop (didn't bet)
Seat 4: aaahaaa1967 folded before Flop (didn't bet)
Seat 5: Xamil666 folded before Flop (didn't bet)
Seat 6: vipbor (button) folded before Flop (didn't bet)
Seat 7: Zazabraza (small blind) folded before Flop
Seat 8: SwimmingPooI (big blind) collected ($0.50)
Seat 9: Volk_Vetra folded before Flop (didn't bet)



PokerStars Hand #228686702846:  Hold'em No Limit ($0.25/$0.50 USD) - 2021/07/30 15:22:44 ET
Table 'Bok II' 9-max Seat #7 is the button
Seat 1: keko gr ($50.69 in chips) 
Seat 2: bateman225 ($41.25 in chips) 
Seat 3: Rulet345 ($56.67 in chips) 
Seat 4: aaahaaa1967 ($53.95 in chips) 
Seat 5: Xamil666 ($50 in chips) 
Seat 6: vipbor ($50 in chips) 
Seat 7: Zazabraza ($33 in chips) 
Seat 8: SwimmingPooI ($52.50 in chips) 
Seat 9: Volk_Vetra ($50 in chips) 
SwimmingPooI: posts small blind $0.25
Volk_Vetra: posts big blind $0.50
*** HOLE CARDS ***
keko gr: raises $1 to $1.50
bateman225: folds 
Rulet345: folds 
aaahaaa1967: folds 
Xamil666: folds 
vipbor: folds 
Zazabraza: folds 
SwimmingPooI: folds 
Volk_Vetra: folds 
Uncalled bet ($1) returned to keko gr
keko gr collected $1.25 from pot
*** SUMMARY ***
Total pot $1.25 | Rake $0 
Seat 1: keko gr collected ($1.25)
Seat 2: bateman225 folded before Flop (didn't bet)
Seat 3: Rulet345 folded before Flop (didn't bet)
Seat 4: aaahaaa1967 folded before Flop (didn't bet)
Seat 5: Xamil666 folded before Flop (didn't bet)
Seat 6: vipbor folded before Flop (didn't bet)
Seat 7: Zazabraza (button) folded before Flop (didn't bet)
Seat 8: SwimmingPooI (small blind) folded before Flop
Seat 9: Volk_Vetra (big blind) folded before Flop



PokerStars Hand #228686713127:  Hold'em No Limit ($0.25/$0.50 USD) - 2021/07/30 15:23:07 ET
Table 'Bok II' 9-max Seat #8 is the button
Seat 1: keko gr ($51.44 in chips) 
Seat 2: bateman225 ($41.25 in chips) 
Seat 3: Rulet345 ($56.67 in chips) 
Seat 4: aaahaaa1967 ($53.95 in chips) 
Seat 5: Xamil666 ($50 in chips) 
Seat 6: vipbor ($50 in chips) 
Seat 7: Zazabraza ($33 in chips) 
Seat 8: SwimmingPooI ($52.25 in chips) 
Seat 9: Volk_Vetra ($50 in chips) 
Volk_Vetra: posts small blind $0.25
keko gr: posts big blind $0.50
*** HOLE CARDS ***
bateman225: raises $1 to $1.50
Rulet345: folds 
aaahaaa1967: calls $1.50
Xamil666: folds 
vipbor: folds 
Zazabraza: folds 
SwimmingPooI: folds 
Volk_Vetra: folds 
keko gr: calls $1
*** FLOP *** [6s Kc Ts]
keko gr: checks 
bateman225: checks 
aaahaaa1967: checks 
*** TURN *** [6s Kc Ts] [6c]
keko gr: checks 
bateman225: bets $2
aaahaaa1967: calls $2
keko gr: folds 
*** RIVER *** [6s Kc Ts 6c] [4h]
bateman225: bets $4.50
aaahaaa1967: folds 
Uncalled bet ($4.50) returned to bateman225
bateman225 collected $8.31 from pot
bateman225: doesn't show hand 
*** SUMMARY ***
Total pot $8.75 | Rake $0.44 
Board [6s Kc Ts 6c 4h]
Seat 1: keko gr (big blind) folded on the Turn
Seat 2: bateman225 collected ($8.31)
Seat 3: Rulet345 folded before Flop (didn't bet)
Seat 4: aaahaaa1967 folded on the River
Seat 5: Xamil666 folded before Flop (didn't bet)
Seat 6: vipbor folded before Flop (didn't bet)
Seat 7: Zazabraza folded before Flop (didn't bet)
Seat 8: SwimmingPooI (button) folded before Flop (didn't bet)
Seat 9: Volk_Vetra (small blind) folded before Flop



PokerStars Hand #228686733366:  Hold'em No Limit ($0.25/$0.50 USD) - 2021/07/30 15:23:50 ET
Table 'Bok II' 9-max Seat #9 is the button
Seat 1: keko gr ($49.94 in chips) 
Seat 2: bateman225 ($46.06 in chips) 
Seat 3: Rulet345 ($56.67 in chips) 
Seat 4: aaahaaa1967 ($50.45 in chips) 
Seat 5: Xamil666 ($50 in chips) 
Seat 6: vipbor ($50 in chips) 
Seat 7: Zazabraza ($33 in chips) 
Seat 8: SwimmingPooI ($52.25 in chips) 
Seat 9: Volk_Vetra ($50 in chips) 
keko gr: posts small blind $0.25
bateman225: posts big blind $0.50
*** HOLE CARDS ***
Rulet345: folds 
aaahaaa1967: calls $0.50
Xamil666: folds 
vipbor: folds 
Zazabraza: folds 
SwimmingPooI: folds 
Volk_Vetra: folds 
keko gr: raises $2 to $2.50
bateman225: folds 
aaahaaa1967: calls $2
*** FLOP *** [Kc Ks 3c]
keko gr: bets $1.50
aaahaaa1967: folds 
Uncalled bet ($1.50) returned to keko gr
keko gr collected $5.22 from pot
*** SUMMARY ***
Total pot $5.50 | Rake $0.28 
Board [Kc Ks 3c]
Seat 1: keko gr (small blind) collected ($5.22)
Seat 2: bateman225 (big blind) folded before Flop
Seat 3: Rulet345 folded before Flop (didn't bet)
Seat 4: aaahaaa1967 folded on the Flop
Seat 5: Xamil666 folded before Flop (didn't bet)
Seat 6: vipbor folded before Flop (didn't bet)
Seat 7: Zazabraza folded before Flop (didn't bet)
Seat 8: SwimmingPooI folded before Flop (didn't bet)
Seat 9: Volk_Vetra (button) folded before Flop (didn't bet)



PokerStars Hand #228686751111:  Hold'em No Limit ($0.25/$0.50 USD) - 2021/07/30 15:24:29 ET
Table 'Bok II' 9-max Seat #1 is the button
Seat 1: keko gr ($52.66 in chips) 
Seat 2: bateman225 ($45.56 in chips) 
Seat 3: Rulet345 ($56.67 in chips) 
Seat 4: aaahaaa1967 ($47.95 in chips) 
Seat 5: Xamil666 ($50 in chips) 
Seat 6: vipbor ($50 in chips) 
Seat 7: Zazabraza ($33 in chips) 
Seat 8: SwimmingPooI ($52.25 in chips) 
Seat 9: Volk_Vetra ($50 in chips) 
bateman225: posts small blind $0.25
Rulet345: posts big blind $0.50
*** HOLE CARDS ***
aaahaaa1967: folds 
Xamil666: folds 
vipbor: raises $0.75 to $1.25
Zazabraza: folds 
SwimmingPooI: folds 
Volk_Vetra: folds 
keko gr: raises $3.25 to $4.50
bateman225: folds 
Rulet345: folds 
vipbor: folds 
Uncalled bet ($3.25) returned to keko gr
keko gr collected $3.25 from pot
*** SUMMARY ***
Total pot $3.25 | Rake $0 
Seat 1: keko gr (button) collected ($3.25)
Seat 2: bateman225 (small blind) folded before Flop
Seat 3: Rulet345 (big blind) folded before Flop
Seat 4: aaahaaa1967 folded before Flop (didn't bet)
Seat 5: Xamil666 folded before Flop (didn't bet)
Seat 6: vipbor folded before Flop
Seat 7: Zazabraza folded before Flop (didn't bet)
Seat 8: SwimmingPooI folded before Flop (didn't bet)
Seat 9: Volk_Vetra folded before Flop (didn't bet)



PokerStars Hand #228686769143:  Hold'em No Limit ($0.25/$0.50 USD) - 2021/07/30 15:25:08 ET
Table 'Bok II' 9-max Seat #2 is the button
Seat 1: keko gr ($54.66 in chips) 
Seat 2: bateman225 ($45.31 in chips) 
Seat 3: Rulet345 ($56.17 in chips) 
Seat 4: aaahaaa1967 ($47.95 in chips) 
Seat 5: Xamil666 ($50 in chips) 
Seat 6: vipbor ($50 in chips) 
Seat 7: Zazabraza ($33 in chips) 
Seat 8: SwimmingPooI ($52.25 in chips) 
Seat 9: Volk_Vetra ($50 in chips) 
Rulet345: posts small blind $0.25
aaahaaa1967: posts big blind $0.50
*** HOLE CARDS ***
Xamil666: folds 
vipbor: folds 
Zazabraza: folds 
SwimmingPooI: folds 
Volk_Vetra: raises $1 to $1.50
keko gr: folds 
bateman225: calls $1.50
Rulet345: folds 
aaahaaa1967: folds 
*** FLOP *** [6h 8d Qs]
Volk_Vetra: bets $2
bateman225: raises $3 to $5
Volk_Vetra: folds 
Uncalled bet ($3) returned to bateman225
bateman225 collected $7.36 from pot
bateman225: doesn't show hand 
*** SUMMARY ***
Total pot $7.75 | Rake $0.39 
Board [6h 8d Qs]
Seat 1: keko gr folded before Flop (didn't bet)
Seat 2: bateman225 (button) collected ($7.36)
Seat 3: Rulet345 (small blind) folded before Flop
Seat 4: aaahaaa1967 (big blind) folded before Flop
Seat 5: Xamil666 folded before Flop (didn't bet)
Seat 6: vipbor folded before Flop (didn't bet)
Seat 7: Zazabraza folded before Flop (didn't bet)
Seat 8: SwimmingPooI folded before Flop (didn't bet)
Seat 9: Volk_Vetra folded on the Flop



PokerStars Hand #228686784620:  Hold'em No Limit ($0.25/$0.50 USD) - 2021/07/30 15:25:41 ET
Table 'Bok II' 9-max Seat #3 is the button
Seat 1: keko gr ($54.66 in chips) 
Seat 2: bateman225 ($49.17 in chips) 
Seat 3: Rulet345 ($55.92 in chips) 
Seat 4: aaahaaa1967 ($47.45 in chips) 
Seat 5: Xamil666 ($50 in chips) 
Seat 6: vipbor ($50 in chips) 
Seat 7: Zazabraza ($33 in chips) 
Seat 8: SwimmingPooI ($52.25 in chips) 
Seat 9: Volk_Vetra ($50 in chips) 
aaahaaa1967: posts small blind $0.25
Xamil666: posts big blind $0.50
*** HOLE CARDS ***
vipbor: folds 
Zazabraza: folds 
SwimmingPooI: raises $1 to $1.50
Volk_Vetra: folds 
keko gr: folds 
bateman225: folds 
Rulet345: folds 
aaahaaa1967: calls $1.25
Xamil666: folds 
*** FLOP *** [Ac 6c Tc]
aaahaaa1967: checks 
SwimmingPooI: bets $1.69
aaahaaa1967: calls $1.69
*** TURN *** [Ac 6c Tc] [6s]
aaahaaa1967: checks 
SwimmingPooI: bets $4
aaahaaa1967: calls $4
*** RIVER *** [Ac 6c Tc 6s] [Ks]
aaahaaa1967: checks 
SwimmingPooI: checks 
*** SHOW DOWN ***
aaahaaa1967: shows [Jc As] (two pair, Aces and Sixes)
SwimmingPooI: mucks hand 
aaahaaa1967 collected $14.14 from pot
*** SUMMARY ***
Total pot $14.88 | Rake $0.74 
Board [Ac 6c Tc 6s Ks]
Seat 1: keko gr folded before Flop (didn't bet)
Seat 2: bateman225 folded before Flop (didn't bet)
Seat 3: Rulet345 (button) folded before Flop (didn't bet)
Seat 4: aaahaaa1967 (small blind) showed [Jc As] and won ($14.14) with two pair, Aces and Sixes
Seat 5: Xamil666 (big blind) folded before Flop
Seat 6: vipbor folded before Flop (didn't bet)
Seat 7: Zazabraza folded before Flop (didn't bet)
Seat 8: SwimmingPooI mucked
Seat 9: Volk_Vetra folded before Flop (didn't bet)



PokerStars Hand #228686800429:  Hold'em No Limit ($0.25/$0.50 USD) - 2021/07/30 15:26:16 ET
Table 'Bok II' 9-max Seat #4 is the button
Seat 1: keko gr ($54.66 in chips) 
Seat 2: bateman225 ($49.17 in chips) 
Seat 3: Rulet345 ($55.92 in chips) 
Seat 4: aaahaaa1967 ($54.40 in chips) 
Seat 5: Xamil666 ($50 in chips) 
Seat 6: vipbor ($50 in chips) 
Seat 7: Zazabraza ($33 in chips) 
Seat 8: SwimmingPooI ($50 in chips) 
Seat 9: Volk_Vetra ($50 in chips) 
Xamil666: posts small blind $0.25
vipbor: posts big blind $0.50
*** HOLE CARDS ***
Zazabraza: calls $0.50
SwimmingPooI: folds 
Volk_Vetra: folds 
keko gr: folds 
bateman225: raises $1 to $1.50
Rulet345: calls $1.50
aaahaaa1967: folds 
Xamil666: folds 
vipbor: folds 
Zazabraza: calls $1
*** FLOP *** [Jd Ad Qc]
Zazabraza: checks 
bateman225: bets $2.50
Rulet345: calls $2.50
Zazabraza: calls $2.50
*** TURN *** [Jd Ad Qc] [3h]
Zazabraza: checks 
bateman225: bets $6
Rulet345: folds 
Zazabraza: calls $6
*** RIVER *** [Jd Ad Qc 3h] [3c]
Zazabraza: checks 
bateman225: checks 
*** SHOW DOWN ***
Zazabraza: shows [Qs Kc] (two pair, Queens and Threes)
bateman225: shows [As Ks] (two pair, Aces and Threes)
bateman225 collected $23.51 from pot
*** SUMMARY ***
Total pot $24.75 | Rake $1.24 
Board [Jd Ad Qc 3h 3c]
Seat 1: keko gr folded before Flop (didn't bet)
Seat 2: bateman225 showed [As Ks] and won ($23.51) with two pair, Aces and Threes
Seat 3: Rulet345 folded on the Turn
Seat 4: aaahaaa1967 (button) folded before Flop (didn't bet)
Seat 5: Xamil666 (small blind) folded before Flop
Seat 6: vipbor (big blind) folded before Flop
Seat 7: Zazabraza showed [Qs Kc] and lost with two pair, Queens and Threes
Seat 8: SwimmingPooI folded before Flop (didn't bet)
Seat 9: Volk_Vetra folded before Flop (didn't bet)



PokerStars Hand #228686830617:  Hold'em No Limit ($0.25/$0.50 USD) - 2021/07/30 15:27:21 ET
Table 'Bok II' 9-max Seat #5 is the button
Seat 1: keko gr ($54.66 in chips) 
Seat 2: bateman225 ($62.68 in chips) 
Seat 3: Rulet345 ($51.92 in chips) 
Seat 4: aaahaaa1967 ($54.40 in chips) 
Seat 5: Xamil666 ($50 in chips) 
Seat 6: vipbor ($50 in chips) 
Seat 7: Zazabraza ($23 in chips) 
Seat 8: SwimmingPooI ($50 in chips) 
Seat 9: Volk_Vetra ($50 in chips) 
vipbor: posts small blind $0.25
Zazabraza: posts big blind $0.50
*** HOLE CARDS ***
SwimmingPooI: folds 
Volk_Vetra: folds 
keko gr: raises $0.75 to $1.25
bateman225: calls $1.25
Rulet345: folds 
aaahaaa1967: folds 
Xamil666: raises $4.25 to $5.50
vipbor: folds 
Zazabraza: folds 
keko gr: folds 
bateman225: folds 
Uncalled bet ($4.25) returned to Xamil666
Xamil666 collected $4.50 from pot
*** SUMMARY ***
Total pot $4.50 | Rake $0 
Seat 1: keko gr folded before Flop
Seat 2: bateman225 folded before Flop
Seat 3: Rulet345 folded before Flop (didn't bet)
Seat 4: aaahaaa1967 folded before Flop (didn't bet)
Seat 5: Xamil666 (button) collected ($4.50)
Seat 6: vipbor (small blind) folded before Flop
Seat 7: Zazabraza (big blind) folded before Flop
Seat 8: SwimmingPooI folded before Flop (didn't bet)
Seat 9: Volk_Vetra folded before Flop (didn't bet)



PokerStars Hand #228688175411:  Hold'em No Limit ($0.25/$0.50 USD) - 2021/07/30 16:16:22 ET
Table 'Bok II' 9-max Seat #6 is the button
Seat 1: keko gr ($69.71 in chips) 
Seat 2: bateman225 ($46.57 in chips) 
Seat 3: Rulet345 ($56.77 in chips) 
Seat 4: aaahaaa1967 ($43.46 in chips) 
Seat 5: Xamil666 ($50 in chips) 
Seat 6: vipbor ($53.54 in chips) 
Seat 7: Zazabraza ($23.18 in chips) 
Seat 8: SwimmingPooI ($74.01 in chips) 
Seat 9: Volk_Vetra ($61.24 in chips) 
Zazabraza: posts small blind $0.25
SwimmingPooI: posts big blind $0.50
*** HOLE CARDS ***
Volk_Vetra: folds 
keko gr: folds 
bateman225: folds 
Rulet345: folds 
aaahaaa1967: folds 
Xamil666: folds 
vipbor: folds 
Zazabraza: folds 
Uncalled bet ($0.25) returned to SwimmingPooI
SwimmingPooI collected $0.50 from pot
*** SUMMARY ***
Total pot $0.50 | Rake $0 
Seat 1: keko gr folded before Flop (didn't bet)
Seat 2: bateman225 folded before Flop (didn't bet)
Seat 3: Rulet345 folded before Flop (didn't bet)
Seat 4: aaahaaa1967 folded before Flop (didn't bet)
Seat 5: Xamil666 folded before Flop (didn't bet)
Seat 6: vipbor (button) folded before Flop (didn't bet)
Seat 7: Zazabraza (small blind) folded before Flop
Seat 8: SwimmingPooI (big blind) collected ($0.50)
Seat 9: Volk_Vetra folded before Flop (didn't bet)



PokerStars Hand #228688406028:  Hold'em No Limit ($0.25/$0.50 USD) - 2021/07/30 16:24:16 ET
Table 'Bok II' 9-max Seat #1 is the button
Seat 1: keko gr ($60.21 in chips) 
Seat 2: bateman225 ($40.32 in chips) 
Seat 3: Rulet345 ($61.26 in chips) 
Seat 4: aaahaaa1967 ($39.32 in chips) 
Seat 5: Xamil666 ($52.95 in chips) 
Seat 6: vipbor ($56.83 in chips) 
Seat 7: Zazabraza ($25.79 in chips) 
Seat 8: SwimmingPooI ($87.91 in chips) 
Seat 9: pirog766 ($27.23 in chips) 
bateman225: posts small blind $0.25
Rulet345: posts big blind $0.50
*** HOLE CARDS ***
aaahaaa1967: folds 
Xamil666: folds 
vipbor: raises $0.75 to $1.25
Zazabraza has timed out
Zazabraza: folds 
SwimmingPooI: folds 
pirog766: calls $1.25
keko gr: folds 
bateman225: folds 
Rulet345: calls $0.75
*** FLOP *** [Jd Ts Tc]
Rulet345: checks 
vipbor: bets $1.25
pirog766: calls $1.25
Rulet345: folds 
*** TURN *** [Jd Ts Tc] [Kd]
vipbor: bets $4.75
pirog766: folds 
Uncalled bet ($4.75) returned to vipbor
vipbor collected $6.18 from pot
*** SUMMARY ***
Total pot $6.50 | Rake $0.32 
Board [Jd Ts Tc Kd]
Seat 1: keko gr (button) folded before Flop (didn't bet)
Seat 2: bateman225 (small blind) folded before Flop
Seat 3: Rulet345 (big blind) folded on the Flop
Seat 4: aaahaaa1967 folded before Flop (didn't bet)
Seat 5: Xamil666 folded before Flop (didn't bet)
Seat 6: vipbor collected ($6.18)
Seat 7: Zazabraza folded before Flop (didn't bet)
Seat 8: SwimmingPooI folded before Flop (didn't bet)
Seat 9: pirog766 folded on the Turn



PokerStars Hand #228688439034:  Hold'em No Limit ($0.25/$0.50 USD) - 2021/07/30 16:25:24 ET
Table 'Bok II' 9-max Seat #2 is the button
Seat 1: keko gr ($60.21 in chips) 
Seat 2: bateman225 ($40.07 in chips) 
Seat 3: Rulet345 ($60.01 in chips) 
Seat 4: aaahaaa1967 ($39.32 in chips) 
Seat 5: Xamil666 ($52.95 in chips) 
Seat 6: vipbor ($60.51 in chips) 
Seat 7: Zazabraza ($25.79 in chips) 
Seat 8: SwimmingPooI ($87.91 in chips) 
Seat 9: pirog766 ($24.73 in chips) 
Rulet345: posts small blind $0.25
aaahaaa1967: posts big blind $0.50
*** HOLE CARDS ***
Xamil666: raises $1 to $1.50
vipbor: folds 
Zazabraza: calls $1.50
SwimmingPooI: folds 
pirog766: calls $1.50
keko gr: folds 
bateman225: folds 
Rulet345: folds 
aaahaaa1967: folds 
*** FLOP *** [4h 9c 5d]
Xamil666: checks 
Zazabraza: checks 
pirog766: bets $2.49
Xamil666: folds 
Zazabraza: folds 
Uncalled bet ($2.49) returned to pirog766
pirog766 collected $4.99 from pot
pirog766: doesn't show hand 
*** SUMMARY ***
Total pot $5.25 | Rake $0.26 
Board [4h 9c 5d]
Seat 1: keko gr folded before Flop (didn't bet)
Seat 2: bateman225 (button) folded before Flop (didn't bet)
Seat 3: Rulet345 (small blind) folded before Flop
Seat 4: aaahaaa1967 (big blind) folded before Flop
Seat 5: Xamil666 folded on the Flop
Seat 6: vipbor folded before Flop (didn't bet)
Seat 7: Zazabraza folded on the Flop
Seat 8: SwimmingPooI folded before Flop (didn't bet)
Seat 9: pirog766 collected ($4.99)



PokerStars Hand #228688455063:  Hold'em No Limit ($0.25/$0.50 USD) - 2021/07/30 16:25:57 ET
Table 'Bok II' 9-max Seat #3 is the button
Seat 1: keko gr ($60.21 in chips) 
Seat 2: bateman225 ($40.07 in chips) 
Seat 3: Rulet345 ($59.76 in chips) 
Seat 4: aaahaaa1967 ($38.82 in chips) 
Seat 5: Xamil666 ($51.45 in chips) 
Seat 6: vipbor ($60.51 in chips) 
Seat 7: Zazabraza ($24.29 in chips) 
Seat 8: SwimmingPooI ($87.91 in chips) 
Seat 9: pirog766 ($28.22 in chips) 
aaahaaa1967: posts small blind $0.25
Xamil666: posts big blind $0.50
*** HOLE CARDS ***
vipbor: raises $0.75 to $1.25
Zazabraza: calls $1.25
SwimmingPooI: folds 
pirog766: folds 
keko gr: folds 
bateman225: folds 
Rulet345: folds 
aaahaaa1967: folds 
Xamil666: folds 
*** FLOP *** [7s 6s Qs]
vipbor: checks 
Zazabraza: bets $3.09
vipbor: calls $3.09
*** TURN *** [7s 6s Qs] [Kd]
vipbor: checks 
Zazabraza: checks 
*** RIVER *** [7s 6s Qs Kd] [3s]
vipbor: checks 
Zazabraza: checks 
*** SHOW DOWN ***
vipbor: shows [Kc Kh] (three of a kind, Kings)
Zazabraza: shows [Jh Js] (a flush, Queen high)
Zazabraza collected $8.96 from pot
*** SUMMARY ***
Total pot $9.43 | Rake $0.47 
Board [7s 6s Qs Kd 3s]
Seat 1: keko gr folded before Flop (didn't bet)
Seat 2: bateman225 folded before Flop (didn't bet)
Seat 3: Rulet345 (button) folded before Flop (didn't bet)
Seat 4: aaahaaa1967 (small blind) folded before Flop
Seat 5: Xamil666 (big blind) folded before Flop
Seat 6: vipbor showed [Kc Kh] and lost with three of a kind, Kings
Seat 7: Zazabraza showed [Jh Js] and won ($8.96) with a flush, Queen high
Seat 8: SwimmingPooI folded before Flop (didn't bet)
Seat 9: pirog766 folded before Flop (didn't bet)



PokerStars Hand #228688480464:  Hold'em No Limit ($0.25/$0.50 USD) - 2021/07/30 16:26:49 ET
Table 'Bok II' 9-max Seat #4 is the button
Seat 1: keko gr ($60.21 in chips) 
Seat 2: bateman225 ($40.07 in chips) 
Seat 3: Rulet345 ($59.76 in chips) 
Seat 4: aaahaaa1967 ($38.57 in chips) 
Seat 5: Xamil666 ($50.95 in chips) 
Seat 6: vipbor ($56.17 in chips) 
Seat 7: Zazabraza ($28.91 in chips) 
Seat 8: SwimmingPooI ($87.91 in chips) 
Seat 9: pirog766 ($28.22 in chips) 
Xamil666: posts small blind $0.25
vipbor: posts big blind $0.50
*** HOLE CARDS ***
Zazabraza: folds 
SwimmingPooI: folds 
pirog766: folds 
keko gr: raises $1 to $1.50
bateman225: folds 
Zazabraza leaves the table
Rulet345: folds 
aaahaaa1967: calls $1.50
Xamil666: folds 
vipbor: calls $1
*** FLOP *** [6d 8h Jd]
vipbor: checks 
keko gr: checks 
aaahaaa1967: checks 
*** TURN *** [6d 8h Jd] [Ad]
vipbor: checks 
Popokluev joins the table at seat #7 
keko gr: checks 
aaahaaa1967: checks 
*** RIVER *** [6d 8h Jd Ad] [Jc]
vipbor: checks 
keko gr: checks 
aaahaaa1967: checks 
*** SHOW DOWN ***
vipbor: shows [Tc 9c] (a pair of Jacks)
keko gr: shows [Qh Th] (a pair of Jacks - Ace+Queen kicker)
aaahaaa1967: shows [Kh Ts] (a pair of Jacks - Ace+King kicker)
aaahaaa1967 collected $4.51 from pot
*** SUMMARY ***
Total pot $4.75 | Rake $0.24 
Board [6d 8h Jd Ad Jc]
Seat 1: keko gr showed [Qh Th] and lost with a pair of Jacks
Seat 2: bateman225 folded before Flop (didn't bet)
Seat 3: Rulet345 folded before Flop (didn't bet)
Seat 4: aaahaaa1967 (button) showed [Kh Ts] and won ($4.51) with a pair of Jacks
Seat 5: Xamil666 (small blind) folded before Flop
Seat 6: vipbor (big blind) showed [Tc 9c] and lost with a pair of Jacks
Seat 7: Zazabraza folded before Flop (didn't bet)
Seat 8: SwimmingPooI folded before Flop (didn't bet)
Seat 9: pirog766 folded before Flop (didn't bet)



PokerStars Hand #228688506750:  Hold'em No Limit ($0.25/$0.50 USD) - 2021/07/30 16:27:44 ET
Table 'Bok II' 9-max Seat #5 is the button
Seat 1: keko gr ($58.71 in chips) 
Seat 2: bateman225 ($40.07 in chips) 
Seat 3: Rulet345 ($59.76 in chips) 
Seat 4: aaahaaa1967 ($41.58 in chips) 
Seat 5: Xamil666 ($50.70 in chips) 
Seat 6: vipbor ($54.67 in chips) 
Seat 7: Popokluev ($50 in chips) 
Seat 8: SwimmingPooI ($87.91 in chips) 
Seat 9: pirog766 ($28.22 in chips) 
vipbor: posts small blind $0.25
Popokluev: posts big blind $0.50
*** HOLE CARDS ***
SwimmingPooI: folds 
pirog766: raises $0.50 to $1
keko gr: calls $1
bateman225: folds 
Rulet345: folds 
aaahaaa1967: calls $1
Xamil666: folds 
vipbor: folds 
Popokluev: calls $0.50
*** FLOP *** [Qh Jh 8s]
Popokluev: checks 
pirog766: checks 
keko gr: checks 
aaahaaa1967: checks 
*** TURN *** [Qh Jh 8s] [Kd]
Popokluev: checks 
pirog766: checks 
keko gr: bets $2.69
aaahaaa1967: folds 
Popokluev: folds 
pirog766: calls $2.69
*** RIVER *** [Qh Jh 8s Kd] [7h]
pirog766: checks 
keko gr: checks 
*** SHOW DOWN ***
pirog766: shows [Ts Th] (a pair of Tens)
keko gr: shows [Qd Kc] (two pair, Kings and Queens)
keko gr collected $9.15 from pot
*** SUMMARY ***
Total pot $9.63 | Rake $0.48 
Board [Qh Jh 8s Kd 7h]
Seat 1: keko gr showed [Qd Kc] and won ($9.15) with two pair, Kings and Queens
Seat 2: bateman225 folded before Flop (didn't bet)
Seat 3: Rulet345 folded before Flop (didn't bet)
Seat 4: aaahaaa1967 folded on the Turn
Seat 5: Xamil666 (button) folded before Flop (didn't bet)
Seat 6: vipbor (small blind) folded before Flop
Seat 7: Popokluev (big blind) folded on the Turn
Seat 8: SwimmingPooI folded before Flop (didn't bet)
Seat 9: pirog766 showed [Ts Th] and lost with a pair of Tens



PokerStars Hand #228688528687:  Hold'em No Limit ($0.25/$0.50 USD) - 2021/07/30 16:28:30 ET
Table 'Bok II' 9-max Seat #6 is the button
Seat 1: keko gr ($64.17 in chips) 
Seat 2: bateman225 ($40.07 in chips) 
Seat 3: Rulet345 ($59.76 in chips) 
Seat 4: aaahaaa1967 ($40.58 in chips) 
Seat 5: Xamil666 ($50.70 in chips) 
Seat 6: vipbor ($54.42 in chips) 
Seat 7: Popokluev ($50 in chips) 
Seat 8: SwimmingPooI ($87.91 in chips) 
Seat 9: pirog766 ($24.53 in chips) 
Popokluev: posts small blind $0.25
SwimmingPooI: posts big blind $0.50
*** HOLE CARDS ***
pirog766: folds 
keko gr: folds 
bateman225: folds 
Rulet345: raises $1 to $1.50
aaahaaa1967: folds 
Xamil666: folds 
vipbor: folds 
Popokluev: folds 
SwimmingPooI: folds 
Uncalled bet ($1) returned to Rulet345
Rulet345 collected $1.25 from pot
Rulet345: doesn't show hand 
*** SUMMARY ***
Total pot $1.25 | Rake $0 
Seat 1: keko gr folded before Flop (didn't bet)
Seat 2: bateman225 folded before Flop (didn't bet)
Seat 3: Rulet345 collected ($1.25)
Seat 4: aaahaaa1967 folded before Flop (didn't bet)
Seat 5: Xamil666 folded before Flop (didn't bet)
Seat 6: vipbor (button) folded before Flop (didn't bet)
Seat 7: Popokluev (small blind) folded before Flop
Seat 8: SwimmingPooI (big blind) folded before Flop
Seat 9: pirog766 folded before Flop (didn't bet)



PokerStars Hand #228688538129:  Hold'em No Limit ($0.25/$0.50 USD) - 2021/07/30 16:28:50 ET
Table 'Bok II' 9-max Seat #7 is the button
Seat 1: keko gr ($64.17 in chips) 
Seat 2: bateman225 ($40.07 in chips) 
Seat 3: Rulet345 ($60.51 in chips) 
Seat 4: aaahaaa1967 ($40.58 in chips) 
Seat 5: Xamil666 ($50.70 in chips) 
Seat 6: vipbor ($54.42 in chips) 
Seat 7: Popokluev ($50 in chips) 
Seat 8: SwimmingPooI ($87.41 in chips) 
Seat 9: pirog766 ($24.53 in chips) 
SwimmingPooI: posts small blind $0.25
pirog766: posts big blind $0.50
*** HOLE CARDS ***
keko gr: folds 
bateman225: folds 
Rulet345: folds 
aaahaaa1967: folds 
Xamil666: folds 
vipbor: folds 
Popokluev: folds 
SwimmingPooI: raises $1 to $1.50
pirog766: raises $23.03 to $24.53 and is all-in
SwimmingPooI: folds 
Uncalled bet ($23.03) returned to pirog766
pirog766 collected $3 from pot
pirog766: doesn't show hand 
*** SUMMARY ***
Total pot $3 | Rake $0 
Seat 1: keko gr folded before Flop (didn't bet)
Seat 2: bateman225 folded before Flop (didn't bet)
Seat 3: Rulet345 folded before Flop (didn't bet)
Seat 4: aaahaaa1967 folded before Flop (didn't bet)
Seat 5: Xamil666 folded before Flop (didn't bet)
Seat 6: vipbor folded before Flop (didn't bet)
Seat 7: Popokluev (button) folded before Flop (didn't bet)
Seat 8: SwimmingPooI (small blind) folded before Flop
Seat 9: pirog766 (big blind) collected ($3)



PokerStars Hand #228688546349:  Hold'em No Limit ($0.25/$0.50 USD) - 2021/07/30 16:29:07 ET
Table 'Bok II' 9-max Seat #8 is the button
Seat 1: keko gr ($64.17 in chips) 
Seat 2: bateman225 ($40.07 in chips) 
Seat 3: Rulet345 ($60.51 in chips) 
Seat 4: aaahaaa1967 ($40.58 in chips) 
Seat 5: Xamil666 ($50.70 in chips) 
Seat 6: vipbor ($54.42 in chips) 
Seat 7: Popokluev ($50 in chips) 
Seat 8: SwimmingPooI ($85.91 in chips) 
Seat 9: pirog766 ($26.03 in chips) 
pirog766: posts small blind $0.25
keko gr: posts big blind $0.50
*** HOLE CARDS ***
bateman225: calls $0.50
Rulet345: folds 
aaahaaa1967: folds 
Xamil666: folds 
vipbor: folds 
Popokluev: folds 
SwimmingPooI: folds 
pirog766: folds 
keko gr: raises $2 to $2.50
bateman225: calls $2
*** FLOP *** [Qs Td Js]
keko gr: checks 
bateman225: checks 
*** TURN *** [Qs Td Js] [Ad]
keko gr: checks 
bateman225: checks 
*** RIVER *** [Qs Td Js Ad] [Qd]
keko gr: checks 
bateman225: checks 
*** SHOW DOWN ***
keko gr: shows [Jc Ac] (two pair, Aces and Queens)
bateman225: mucks hand 
keko gr collected $4.99 from pot
*** SUMMARY ***
Total pot $5.25 | Rake $0.26 
Board [Qs Td Js Ad Qd]
Seat 1: keko gr (big blind) showed [Jc Ac] and won ($4.99) with two pair, Aces and Queens
Seat 2: bateman225 mucked
Seat 3: Rulet345 folded before Flop (didn't bet)
Seat 4: aaahaaa1967 folded before Flop (didn't bet)
Seat 5: Xamil666 folded before Flop (didn't bet)
Seat 6: vipbor folded before Flop (didn't bet)
Seat 7: Popokluev folded before Flop (didn't bet)
Seat 8: SwimmingPooI (button) folded before Flop (didn't bet)
Seat 9: pirog766 (small blind) folded before Flop



PokerStars Hand #228688183489:  Hold'em No Limit ($0.25/$0.50 USD) - 2021/07/30 16:16:39 ET
Table 'Bok II' 9-max Seat #7 is the button
Seat 1: keko gr ($69.71 in chips) 
Seat 2: bateman225 ($46.57 in chips) 
Seat 3: Rulet345 ($56.77 in chips) 
Seat 4: aaahaaa1967 ($43.46 in chips) 
Seat 5: Xamil666 ($50 in chips) 
Seat 6: vipbor ($53.54 in chips) 
Seat 7: Zazabraza ($22.93 in chips) 
Seat 8: SwimmingPooI ($74.26 in chips) 
SwimmingPooI: posts small blind $0.25
Volk_Vetra: is sitting out 
keko gr: posts big blind $0.50
*** HOLE CARDS ***
bateman225: calls $0.50
Volk_Vetra leaves the table
Rulet345: folds 
aaahaaa1967: folds 
Xamil666: folds 
vipbor: folds 
Zazabraza: calls $0.50
SwimmingPooI: raises $2.50 to $3
keko gr: folds 
bateman225: folds 
pirog766 joins the table at seat #9 
Zazabraza: folds 
Uncalled bet ($2.50) returned to SwimmingPooI
SwimmingPooI collected $2 from pot
SwimmingPooI: doesn't show hand 
*** SUMMARY ***
Total pot $2 | Rake $0 
Seat 1: keko gr (big blind) folded before Flop
Seat 2: bateman225 folded before Flop
Seat 3: Rulet345 folded before Flop (didn't bet)
Seat 4: aaahaaa1967 folded before Flop (didn't bet)
Seat 5: Xamil666 folded before Flop (didn't bet)
Seat 6: vipbor folded before Flop (didn't bet)
Seat 7: Zazabraza (button) folded before Flop
Seat 8: SwimmingPooI (small blind) collected ($2)



PokerStars Hand #228688195943:  Hold'em No Limit ($0.25/$0.50 USD) - 2021/07/30 16:17:05 ET
Table 'Bok II' 9-max Seat #8 is the button
Seat 1: keko gr ($69.21 in chips) 
Seat 2: bateman225 ($46.07 in chips) 
Seat 3: Rulet345 ($56.77 in chips) 
Seat 4: aaahaaa1967 ($43.46 in chips) 
Seat 5: Xamil666 ($50 in chips) 
Seat 6: vipbor ($53.54 in chips) 
Seat 7: Zazabraza ($22.43 in chips) 
Seat 8: SwimmingPooI ($75.76 in chips) 
keko gr: posts small blind $0.25
bateman225: posts big blind $0.50
*** HOLE CARDS ***
Rulet345: raises $1 to $1.50
aaahaaa1967: calls $1.50
Xamil666: folds 
vipbor: folds 
Zazabraza: calls $1.50
SwimmingPooI: folds 
keko gr: folds 
bateman225: folds 
*** FLOP *** [Tc 6s 6d]
Rulet345: checks 
aaahaaa1967: checks 
Zazabraza: checks 
*** TURN *** [Tc 6s 6d] [2d]
Rulet345: checks 
aaahaaa1967: checks 
Zazabraza: checks 
*** RIVER *** [Tc 6s 6d 2d] [Ad]
Rulet345: bets $2.50
aaahaaa1967: folds 
Zazabraza: calls $2.50
*** SHOW DOWN ***
Rulet345: shows [Ah Qd] (two pair, Aces and Sixes)
Zazabraza: mucks hand 
Rulet345 collected $9.74 from pot
*** SUMMARY ***
Total pot $10.25 | Rake $0.51 
Board [Tc 6s 6d 2d Ad]
Seat 1: keko gr (small blind) folded before Flop
Seat 2: bateman225 (big blind) folded before Flop
Seat 3: Rulet345 showed [Ah Qd] and won ($9.74) with two pair, Aces and Sixes
Seat 4: aaahaaa1967 folded on the River
Seat 5: Xamil666 folded before Flop (didn't bet)
Seat 6: vipbor folded before Flop (didn't bet)
Seat 7: Zazabraza mucked
Seat 8: SwimmingPooI (button) folded before Flop (didn't bet)



PokerStars Hand #228688223290:  Hold'em No Limit ($0.25/$0.50 USD) - 2021/07/30 16:18:01 ET
Table 'Bok II' 9-max Seat #1 is the button
Seat 1: keko gr ($68.96 in chips) 
Seat 2: bateman225 ($45.57 in chips) 
Seat 3: Rulet345 ($62.51 in chips) 
Seat 4: aaahaaa1967 ($41.96 in chips) 
Seat 5: Xamil666 ($50 in chips) 
Seat 6: vipbor ($53.54 in chips) 
Seat 7: Zazabraza ($18.43 in chips) 
Seat 8: SwimmingPooI ($75.76 in chips) 
Seat 9: pirog766 ($31.73 in chips) 
bateman225: posts small blind $0.25
Rulet345: posts big blind $0.50
pirog766: posts big blind $0.50
*** HOLE CARDS ***
aaahaaa1967: calls $0.50
Xamil666: folds 
vipbor: folds 
Zazabraza: folds 
SwimmingPooI: raises $2.50 to $3
pirog766: folds 
keko gr: folds 
bateman225: folds 
Rulet345: folds 
aaahaaa1967: calls $2.50
*** FLOP *** [4h Js 6c]
aaahaaa1967: checks 
SwimmingPooI: bets $3.51
aaahaaa1967: folds 
Uncalled bet ($3.51) returned to SwimmingPooI
SwimmingPooI collected $6.89 from pot
SwimmingPooI: doesn't show hand 
*** SUMMARY ***
Total pot $7.25 | Rake $0.36 
Board [4h Js 6c]
Seat 1: keko gr (button) folded before Flop (didn't bet)
Seat 2: bateman225 (small blind) folded before Flop
Seat 3: Rulet345 (big blind) folded before Flop
Seat 4: aaahaaa1967 folded on the Flop
Seat 5: Xamil666 folded before Flop (didn't bet)
Seat 6: vipbor folded before Flop (didn't bet)
Seat 7: Zazabraza folded before Flop (didn't bet)
Seat 8: SwimmingPooI collected ($6.89)
Seat 9: pirog766 folded before Flop (didn't bet)



PokerStars Hand #228688244060:  Hold'em No Limit ($0.25/$0.50 USD) - 2021/07/30 16:18:43 ET
Table 'Bok II' 9-max Seat #2 is the button
Seat 1: keko gr ($68.96 in chips) 
Seat 2: bateman225 ($45.32 in chips) 
Seat 3: Rulet345 ($62.01 in chips) 
Seat 4: aaahaaa1967 ($38.96 in chips) 
Seat 5: Xamil666 ($50 in chips) 
Seat 6: vipbor ($53.54 in chips) 
Seat 7: Zazabraza ($18.43 in chips) 
Seat 8: SwimmingPooI ($79.65 in chips) 
Seat 9: pirog766 ($31.23 in chips) 
Rulet345: posts small blind $0.25
aaahaaa1967: posts big blind $0.50
*** HOLE CARDS ***
Xamil666: folds 
vipbor: raises $0.75 to $1.25
Zazabraza: folds 
SwimmingPooI: raises $3.25 to $4.50
pirog766: folds 
keko gr: folds 
bateman225: folds 
Rulet345: folds 
aaahaaa1967: folds 
vipbor: calls $3.25
*** FLOP *** [As Ts 9c]
vipbor: checks 
SwimmingPooI: bets $4.72
vipbor: calls $4.72
*** TURN *** [As Ts 9c] [5d]
vipbor: checks 
SwimmingPooI: bets $11.50
vipbor: folds 
Uncalled bet ($11.50) returned to SwimmingPooI
SwimmingPooI collected $18.23 from pot
SwimmingPooI: doesn't show hand 
*** SUMMARY ***
Total pot $19.19 | Rake $0.96 
Board [As Ts 9c 5d]
Seat 1: keko gr folded before Flop (didn't bet)
Seat 2: bateman225 (button) folded before Flop (didn't bet)
Seat 3: Rulet345 (small blind) folded before Flop
Seat 4: aaahaaa1967 (big blind) folded before Flop
Seat 5: Xamil666 folded before Flop (didn't bet)
Seat 6: vipbor folded on the Turn
Seat 7: Zazabraza folded before Flop (didn't bet)
Seat 8: SwimmingPooI collected ($18.23)
Seat 9: pirog766 folded before Flop (didn't bet)



PokerStars Hand #228688270512:  Hold'em No Limit ($0.25/$0.50 USD) - 2021/07/30 16:19:38 ET
Table 'Bok II' 9-max Seat #3 is the button
Seat 1: keko gr ($68.96 in chips) 
Seat 2: bateman225 ($45.32 in chips) 
Seat 3: Rulet345 ($61.76 in chips) 
Seat 4: aaahaaa1967 ($38.46 in chips) 
Seat 5: Xamil666 ($50 in chips) 
Seat 6: vipbor ($50 in chips) 
Seat 7: Zazabraza ($18.43 in chips) 
Seat 8: SwimmingPooI ($88.66 in chips) 
Seat 9: pirog766 ($31.23 in chips) 
aaahaaa1967: posts small blind $0.25
Xamil666: posts big blind $0.50
*** HOLE CARDS ***
vipbor: folds 
Zazabraza: folds 
SwimmingPooI: folds 
pirog766: folds 
keko gr: folds 
bateman225: folds 
Rulet345: raises $0.75 to $1.25
aaahaaa1967: folds 
Xamil666: folds 
Uncalled bet ($0.75) returned to Rulet345
Rulet345 collected $1.25 from pot
Rulet345: doesn't show hand 
*** SUMMARY ***
Total pot $1.25 | Rake $0 
Seat 1: keko gr folded before Flop (didn't bet)
Seat 2: bateman225 folded before Flop (didn't bet)
Seat 3: Rulet345 (button) collected ($1.25)
Seat 4: aaahaaa1967 (small blind) folded before Flop
Seat 5: Xamil666 (big blind) folded before Flop
Seat 6: vipbor folded before Flop (didn't bet)
Seat 7: Zazabraza folded before Flop (didn't bet)
Seat 8: SwimmingPooI folded before Flop (didn't bet)
Seat 9: pirog766 folded before Flop (didn't bet)



PokerStars Hand #228688276629:  Hold'em No Limit ($0.25/$0.50 USD) - 2021/07/30 16:19:50 ET
Table 'Bok II' 9-max Seat #4 is the button
Seat 1: keko gr ($68.96 in chips) 
Seat 2: bateman225 ($45.32 in chips) 
Seat 3: Rulet345 ($62.51 in chips) 
Seat 4: aaahaaa1967 ($38.21 in chips) 
Seat 5: Xamil666 ($50 in chips) 
Seat 6: vipbor ($50 in chips) 
Seat 7: Zazabraza ($18.43 in chips) 
Seat 8: SwimmingPooI ($88.66 in chips) 
Seat 9: pirog766 ($31.23 in chips) 
Xamil666: posts small blind $0.25
vipbor: posts big blind $0.50
*** HOLE CARDS ***
Zazabraza: folds 
SwimmingPooI: folds 
pirog766: folds 
keko gr: folds 
bateman225: folds 
Rulet345: raises $0.75 to $1.25
aaahaaa1967: folds 
Xamil666: folds 
vipbor: raises $4.25 to $5.50
Rulet345: folds 
Uncalled bet ($4.25) returned to vipbor
vipbor collected $2.75 from pot
*** SUMMARY ***
Total pot $2.75 | Rake $0 
Seat 1: keko gr folded before Flop (didn't bet)
Seat 2: bateman225 folded before Flop (didn't bet)
Seat 3: Rulet345 folded before Flop
Seat 4: aaahaaa1967 (button) folded before Flop (didn't bet)
Seat 5: Xamil666 (small blind) folded before Flop
Seat 6: vipbor (big blind) collected ($2.75)
Seat 7: Zazabraza folded before Flop (didn't bet)
Seat 8: SwimmingPooI folded before Flop (didn't bet)
Seat 9: pirog766 folded before Flop (didn't bet)



PokerStars Hand #228688293987:  Hold'em No Limit ($0.25/$0.50 USD) - 2021/07/30 16:20:26 ET
Table 'Bok II' 9-max Seat #5 is the button
Seat 1: keko gr ($68.96 in chips) 
Seat 2: bateman225 ($45.32 in chips) 
Seat 3: Rulet345 ($61.26 in chips) 
Seat 4: aaahaaa1967 ($38.21 in chips) 
Seat 5: Xamil666 ($50 in chips) 
Seat 6: vipbor ($51.50 in chips) 
Seat 7: Zazabraza ($18.43 in chips) 
Seat 8: SwimmingPooI ($88.66 in chips) 
Seat 9: pirog766 ($31.23 in chips) 
vipbor: posts small blind $0.25
Zazabraza: posts big blind $0.50
*** HOLE CARDS ***
SwimmingPooI: folds 
pirog766: folds 
keko gr: folds 
bateman225: folds 
Rulet345: folds 
aaahaaa1967: folds 
Xamil666: raises $0.75 to $1.25
vipbor: folds 
Zazabraza: calls $0.75
*** FLOP *** [Ks 7s 5c]
Zazabraza: checks 
Xamil666: bets $1.96
Zazabraza: folds 
Uncalled bet ($1.96) returned to Xamil666
Xamil666 collected $2.61 from pot
*** SUMMARY ***
Total pot $2.75 | Rake $0.14 
Board [Ks 7s 5c]
Seat 1: keko gr folded before Flop (didn't bet)
Seat 2: bateman225 folded before Flop (didn't bet)
Seat 3: Rulet345 folded before Flop (didn't bet)
Seat 4: aaahaaa1967 folded before Flop (didn't bet)
Seat 5: Xamil666 (button) collected ($2.61)
Seat 6: vipbor (small blind) folded before Flop
Seat 7: Zazabraza (big blind) folded on the Flop
Seat 8: SwimmingPooI folded before Flop (didn't bet)
Seat 9: pirog766 folded before Flop (didn't bet)



PokerStars Hand #228688311166:  Hold'em No Limit ($0.25/$0.50 USD) - 2021/07/30 16:21:01 ET
Table 'Bok II' 9-max Seat #6 is the button
Seat 1: keko gr ($68.96 in chips) 
Seat 2: bateman225 ($45.32 in chips) 
Seat 3: Rulet345 ($61.26 in chips) 
Seat 4: aaahaaa1967 ($38.21 in chips) 
Seat 5: Xamil666 ($51.36 in chips) 
Seat 6: vipbor ($51.25 in chips) 
Seat 7: Zazabraza ($17.18 in chips) 
Seat 8: SwimmingPooI ($88.66 in chips) 
Seat 9: pirog766 ($31.23 in chips) 
Zazabraza: posts small blind $0.25
SwimmingPooI: posts big blind $0.50
*** HOLE CARDS ***
pirog766: folds 
keko gr: folds 
bateman225: calls $0.50
Rulet345: folds 
aaahaaa1967: calls $0.50
Xamil666: folds 
vipbor: folds 
Zazabraza: folds 
SwimmingPooI: checks 
*** FLOP *** [Qc 8h Td]
SwimmingPooI: checks 
bateman225: checks 
aaahaaa1967: checks 
*** TURN *** [Qc 8h Td] [6h]
SwimmingPooI: checks 
bateman225: bets $0.50
aaahaaa1967: calls $0.50
SwimmingPooI: folds 
*** RIVER *** [Qc 8h Td 6h] [Kc]
bateman225: checks 
aaahaaa1967: checks 
*** SHOW DOWN ***
bateman225: shows [4h Ah] (high card Ace)
aaahaaa1967: shows [Kd 9d] (a pair of Kings)
aaahaaa1967 collected $2.61 from pot
*** SUMMARY ***
Total pot $2.75 | Rake $0.14 
Board [Qc 8h Td 6h Kc]
Seat 1: keko gr folded before Flop (didn't bet)
Seat 2: bateman225 showed [4h Ah] and lost with high card Ace
Seat 3: Rulet345 folded before Flop (didn't bet)
Seat 4: aaahaaa1967 showed [Kd 9d] and won ($2.61) with a pair of Kings
Seat 5: Xamil666 folded before Flop (didn't bet)
Seat 6: vipbor (button) folded before Flop (didn't bet)
Seat 7: Zazabraza (small blind) folded before Flop
Seat 8: SwimmingPooI (big blind) folded on the Turn
Seat 9: pirog766 folded before Flop (didn't bet)



PokerStars Hand #228688335695:  Hold'em No Limit ($0.25/$0.50 USD) - 2021/07/30 16:21:51 ET
Table 'Bok II' 9-max Seat #7 is the button
Seat 1: keko gr ($68.96 in chips) 
Seat 2: bateman225 ($44.32 in chips) 
Seat 3: Rulet345 ($61.26 in chips) 
Seat 4: aaahaaa1967 ($39.82 in chips) 
Seat 5: Xamil666 ($51.36 in chips) 
Seat 6: vipbor ($51.25 in chips) 
Seat 7: Zazabraza ($16.93 in chips) 
Seat 8: SwimmingPooI ($88.16 in chips) 
Seat 9: pirog766 ($31.23 in chips) 
SwimmingPooI: posts small blind $0.25
pirog766: posts big blind $0.50
*** HOLE CARDS ***
keko gr: raises $1 to $1.50
bateman225: folds 
Rulet345: folds 
aaahaaa1967: folds 
Xamil666: folds 
vipbor: folds 
Zazabraza: calls $1.50
SwimmingPooI: folds 
pirog766: calls $1
*** FLOP *** [2h Ac Th]
pirog766: checks 
keko gr: checks 
Zazabraza: checks 
*** TURN *** [2h Ac Th] [Td]
pirog766: checks 
keko gr: bets $1.50
Zazabraza: calls $1.50
pirog766: folds 
*** RIVER *** [2h Ac Th Td] [3h]
keko gr: bets $2.50
Zazabraza: raises $2.50 to $5
keko gr: calls $2.50
*** SHOW DOWN ***
Zazabraza: shows [Kh 8h] (a flush, King high)
keko gr: mucks hand 
Zazabraza collected $16.86 from pot
*** SUMMARY ***
Total pot $17.75 | Rake $0.89 
Board [2h Ac Th Td 3h]
Seat 1: keko gr mucked
Seat 2: bateman225 folded before Flop (didn't bet)
Seat 3: Rulet345 folded before Flop (didn't bet)
Seat 4: aaahaaa1967 folded before Flop (didn't bet)
Seat 5: Xamil666 folded before Flop (didn't bet)
Seat 6: vipbor folded before Flop (didn't bet)
Seat 7: Zazabraza (button) showed [Kh 8h] and won ($16.86) with a flush, King high
Seat 8: SwimmingPooI (small blind) folded before Flop
Seat 9: pirog766 (big blind) folded on the Turn



PokerStars Hand #228688370074:  Hold'em No Limit ($0.25/$0.50 USD) - 2021/07/30 16:23:02 ET
Table 'Bok II' 9-max Seat #8 is the button
Seat 1: keko gr ($60.96 in chips) 
Seat 2: bateman225 ($44.32 in chips) 
Seat 3: Rulet345 ($61.26 in chips) 
Seat 4: aaahaaa1967 ($39.82 in chips) 
Seat 5: Xamil666 ($51.36 in chips) 
Seat 6: vipbor ($51.25 in chips) 
Seat 7: Zazabraza ($25.79 in chips) 
Seat 8: SwimmingPooI ($87.91 in chips) 
Seat 9: pirog766 ($29.73 in chips) 
pirog766: posts small blind $0.25
keko gr: posts big blind $0.50
*** HOLE CARDS ***
bateman225: calls $0.50
Rulet345: folds 
aaahaaa1967: calls $0.50
Xamil666: folds 
vipbor: raises $2 to $2.50
Zazabraza: folds 
SwimmingPooI: folds 
pirog766: calls $2.25
keko gr: folds 
bateman225: calls $2
aaahaaa1967: folds 
*** FLOP *** [2c 5s 6h]
pirog766: checks 
bateman225: checks 
vipbor: bets $4.44
pirog766: folds 
bateman225: folds 
Uncalled bet ($4.44) returned to vipbor
vipbor collected $8.08 from pot
*** SUMMARY ***
Total pot $8.50 | Rake $0.42 
Board [2c 5s 6h]
Seat 1: keko gr (big blind) folded before Flop
Seat 2: bateman225 folded on the Flop
Seat 3: Rulet345 folded before Flop (didn't bet)
Seat 4: aaahaaa1967 folded before Flop
Seat 5: Xamil666 folded before Flop (didn't bet)
Seat 6: vipbor collected ($8.08)
Seat 7: Zazabraza folded before Flop (didn't bet)
Seat 8: SwimmingPooI (button) folded before Flop (didn't bet)
Seat 9: pirog766 (small blind) folded on the Flop



PokerStars Hand #228688389451:  Hold'em No Limit ($0.25/$0.50 USD) - 2021/07/30 16:23:42 ET
Table 'Bok II' 9-max Seat #9 is the button
Seat 1: keko gr ($60.46 in chips) 
Seat 2: bateman225 ($41.82 in chips) 
Seat 3: Rulet345 ($61.26 in chips) 
Seat 4: aaahaaa1967 ($39.32 in chips) 
Seat 5: Xamil666 ($51.36 in chips) 
Seat 6: vipbor ($56.83 in chips) 
Seat 7: Zazabraza ($25.79 in chips) 
Seat 8: SwimmingPooI ($87.91 in chips) 
Seat 9: pirog766 ($27.23 in chips) 
keko gr: posts small blind $0.25
bateman225: posts big blind $0.50
*** HOLE CARDS ***
Rulet345: folds 
aaahaaa1967: folds 
Xamil666: raises $1 to $1.50
vipbor: folds 
Zazabraza: folds 
SwimmingPooI: folds 
pirog766: folds 
keko gr: folds 
bateman225: calls $1
*** FLOP *** [6s 5h 4d]
bateman225: checks 
Xamil666: checks 
*** TURN *** [6s 5h 4d] [2c]
bateman225: checks 
Xamil666: checks 
*** RIVER *** [6s 5h 4d 2c] [5s]
bateman225: checks 
Xamil666: checks 
*** SHOW DOWN ***
bateman225: shows [Jc Th] (a pair of Fives)
Xamil666: shows [Kd Jd] (a pair of Fives - King kicker)
Xamil666 collected $3.09 from pot
*** SUMMARY ***
Total pot $3.25 | Rake $0.16 
Board [6s 5h 4d 2c 5s]
Seat 1: keko gr (small blind) folded before Flop
Seat 2: bateman225 (big blind) showed [Jc Th] and lost with a pair of Fives
Seat 3: Rulet345 folded before Flop (didn't bet)
Seat 4: aaahaaa1967 folded before Flop (didn't bet)
Seat 5: Xamil666 showed [Kd Jd] and won ($3.09) with a pair of Fives
Seat 6: vipbor folded before Flop (didn't bet)
Seat 7: Zazabraza folded before Flop (didn't bet)
Seat 8: SwimmingPooI folded before Flop (didn't bet)
Seat 9: pirog766 (button) folded before Flop (didn't bet)



PokerStars Hand #228688658534:  Hold'em No Limit ($0.25/$0.50 USD) - 2021/07/30 16:32:54 ET
Table 'Bok II' 9-max Seat #8 is the button
Seat 1: keko gr ($72.03 in chips) 
Seat 2: bateman225 ($31.73 in chips) 
Seat 3: Rulet345 ($59.01 in chips) 
Seat 4: aaahaaa1967 ($45.08 in chips) 
Seat 5: Xamil666 ($50 in chips) 
Seat 7: Popokluev ($52 in chips) 
Seat 8: SwimmingPooI ($85.16 in chips) 
Seat 9: pirog766 ($25.05 in chips) 
pirog766: posts small blind $0.25
keko gr: posts big blind $0.50
*** HOLE CARDS ***
bateman225: folds 
Rulet345: folds 
aaahaaa1967: folds 
Xamil666: folds 
Popokluev: folds 
SwimmingPooI: raises $0.75 to $1.25
pirog766: folds 
keko gr: calls $0.75
*** FLOP *** [9s Js Ks]
keko gr: checks 
SwimmingPooI: bets $1.33
keko gr: folds 
Uncalled bet ($1.33) returned to SwimmingPooI
SwimmingPooI collected $2.61 from pot
SwimmingPooI: doesn't show hand 
*** SUMMARY ***
Total pot $2.75 | Rake $0.14 
Board [9s Js Ks]
Seat 1: keko gr (big blind) folded on the Flop
Seat 2: bateman225 folded before Flop (didn't bet)
Seat 3: Rulet345 folded before Flop (didn't bet)
Seat 4: aaahaaa1967 folded before Flop (didn't bet)
Seat 5: Xamil666 folded before Flop (didn't bet)
Seat 7: Popokluev folded before Flop (didn't bet)
Seat 8: SwimmingPooI (button) collected ($2.61)
Seat 9: pirog766 (small blind) folded before Flop



PokerStars Hand #228688670359:  Hold'em No Limit ($0.25/$0.50 USD) - 2021/07/30 16:33:19 ET
Table 'Bok II' 9-max Seat #9 is the button
Seat 1: keko gr ($70.78 in chips) 
Seat 2: bateman225 ($31.73 in chips) 
Seat 3: Rulet345 ($59.01 in chips) 
Seat 4: aaahaaa1967 ($45.08 in chips) 
Seat 5: Xamil666 ($50 in chips) 
Seat 7: Popokluev ($52 in chips) 
Seat 8: SwimmingPooI ($86.52 in chips) 
Seat 9: pirog766 ($24.80 in chips) 
keko gr: posts small blind $0.25
bateman225: posts big blind $0.50
*** HOLE CARDS ***
Rulet345: raises $1 to $1.50
aaahaaa1967: folds 
Xamil666: folds 
Popokluev: raises $3 to $4.50
SwimmingPooI: folds 
pirog766: folds 
keko gr: folds 
bateman225: raises $6.50 to $11
Rulet345: folds 
Popokluev: folds 
Uncalled bet ($6.50) returned to bateman225
bateman225 collected $10.75 from pot
bateman225: doesn't show hand 
*** SUMMARY ***
Total pot $10.75 | Rake $0 
Seat 1: keko gr (small blind) folded before Flop
Seat 2: bateman225 (big blind) collected ($10.75)
Seat 3: Rulet345 folded before Flop
Seat 4: aaahaaa1967 folded before Flop (didn't bet)
Seat 5: Xamil666 folded before Flop (didn't bet)
Seat 7: Popokluev folded before Flop
Seat 8: SwimmingPooI folded before Flop (didn't bet)
Seat 9: pirog766 (button) folded before Flop (didn't bet)



PokerStars Hand #228688693027:  Hold'em No Limit ($0.25/$0.50 USD) - 2021/07/30 16:34:06 ET
Table 'Bok II' 9-max Seat #1 is the button
Seat 1: keko gr ($70.53 in chips) 
Seat 2: bateman225 ($37.98 in chips) 
Seat 3: Rulet345 ($57.51 in chips) 
Seat 4: aaahaaa1967 ($45.08 in chips) 
Seat 5: Xamil666 ($50 in chips) 
Seat 7: Popokluev ($50 in chips) 
Seat 8: SwimmingPooI ($86.52 in chips) 
Seat 9: pirog766 ($24.80 in chips) 
bateman225: posts small blind $0.25
Rulet345: posts big blind $0.50
vipbor: sits out 
*** HOLE CARDS ***
aaahaaa1967: folds 
Xamil666: folds 
Popokluev: folds 
SwimmingPooI: folds 
pirog766: raises $0.50 to $1
aaahaaa1967 leaves the table
keko gr: calls $1
bateman225: calls $0.75
Rulet345: folds 
*** FLOP *** [4c 7h 7d]
bateman225: checks 
Xamil666 leaves the table
pirog766: bets $0.50
ssorinacho92 joins the table at seat #4 
keko gr: folds 
bateman225: folds 
Uncalled bet ($0.50) returned to pirog766
pirog766 collected $3.32 from pot
pirog766: doesn't show hand 
*** SUMMARY ***
Total pot $3.50 | Rake $0.18 
Board [4c 7h 7d]
Seat 1: keko gr (button) folded on the Flop
Seat 2: bateman225 (small blind) folded on the Flop
Seat 3: Rulet345 (big blind) folded before Flop
Seat 4: aaahaaa1967 folded before Flop (didn't bet)
Seat 5: Xamil666 folded before Flop (didn't bet)
Seat 7: Popokluev folded before Flop (didn't bet)
Seat 8: SwimmingPooI folded before Flop (didn't bet)
Seat 9: pirog766 collected ($3.32)



PokerStars Hand #228688713168:  Hold'em No Limit ($0.25/$0.50 USD) - 2021/07/30 16:34:48 ET
Table 'Bok II' 9-max Seat #2 is the button
Seat 1: keko gr ($69.53 in chips) 
Seat 2: bateman225 ($36.98 in chips) 
Seat 3: Rulet345 ($57.01 in chips) 
Seat 4: ssorinacho92 ($50 in chips) 
Seat 7: Popokluev ($50 in chips) 
Seat 8: SwimmingPooI ($86.52 in chips) 
Seat 9: pirog766 ($27.12 in chips) 
Rulet345: posts small blind $0.25
ssorinacho92: posts big blind $0.50
vipbor: sits out 
*** HOLE CARDS ***
Popokluev: folds 
SwimmingPooI: folds 
pirog766: folds 
keko gr: folds 
bateman225: raises $0.50 to $1
Rulet345: folds 
ssorinacho92: folds 
Uncalled bet ($0.50) returned to bateman225
bateman225 collected $1.25 from pot
bateman225: doesn't show hand 
*** SUMMARY ***
Total pot $1.25 | Rake $0 
Seat 1: keko gr folded before Flop (didn't bet)
Seat 2: bateman225 (button) collected ($1.25)
Seat 3: Rulet345 (small blind) folded before Flop
Seat 4: ssorinacho92 (big blind) folded before Flop
Seat 7: Popokluev folded before Flop (didn't bet)
Seat 8: SwimmingPooI folded before Flop (didn't bet)
Seat 9: pirog766 folded before Flop (didn't bet)



PokerStars Hand #228688719932:  Hold'em No Limit ($0.25/$0.50 USD) - 2021/07/30 16:35:02 ET
Table 'Bok II' 9-max Seat #3 is the button
Seat 1: keko gr ($69.53 in chips) 
Seat 2: bateman225 ($37.73 in chips) 
Seat 3: Rulet345 ($56.76 in chips) 
Seat 4: ssorinacho92 ($49.50 in chips) 
Seat 6: vipbor ($54.42 in chips) 
Seat 7: Popokluev ($50 in chips) 
Seat 8: SwimmingPooI ($86.52 in chips) 
Seat 9: pirog766 ($27.12 in chips) 
ssorinacho92: posts small blind $0.25
vipbor: posts big blind $0.50
*** HOLE CARDS ***
Popokluev: raises $1 to $1.50
SwimmingPooI: folds 
pirog766: calls $1.50
wildermorph joins the table at seat #5 
keko gr: calls $1.50
bateman225: folds 
Rulet345: folds 
ssorinacho92: raises $6.50 to $8
vipbor: folds 
Popokluev: folds 
pirog766: calls $6.50
keko gr: calls $6.50
*** FLOP *** [Kd 8c 2h]
Popokluev leaves the table
Dragonclawss joins the table at seat #7 
ssorinacho92: checks 
pirog766: checks 
keko gr: checks 
*** TURN *** [Kd 8c 2h] [4d]
ssorinacho92: bets $9.88
pirog766: calls $9.88
keko gr: folds 
*** RIVER *** [Kd 8c 2h 4d] [Qs]
ssorinacho92: bets $17.50
pirog766: calls $9.24 and is all-in
Uncalled bet ($8.26) returned to ssorinacho92
*** SHOW DOWN ***
ssorinacho92: shows [Kh Ks] (three of a kind, Kings)
pirog766: shows [Jh Js] (a pair of Jacks)
ssorinacho92 collected $62.24 from pot
*** SUMMARY ***
Total pot $64.24 | Rake $2 
Board [Kd 8c 2h 4d Qs]
Seat 1: keko gr folded on the Turn
Seat 2: bateman225 folded before Flop (didn't bet)
Seat 3: Rulet345 (button) folded before Flop (didn't bet)
Seat 4: ssorinacho92 (small blind) showed [Kh Ks] and won ($62.24) with three of a kind, Kings
Seat 6: vipbor (big blind) folded before Flop
Seat 7: Popokluev folded before Flop
Seat 8: SwimmingPooI folded before Flop (didn't bet)
Seat 9: pirog766 showed [Jh Js] and lost with a pair of Jacks



PokerStars Hand #228688753989:  Hold'em No Limit ($0.25/$0.50 USD) - 2021/07/30 16:36:13 ET
Table 'Bok II' 9-max Seat #4 is the button
Seat 1: keko gr ($61.53 in chips) 
Seat 2: bateman225 ($37.73 in chips) 
Seat 3: Rulet345 ($56.76 in chips) 
Seat 4: ssorinacho92 ($84.62 in chips) 
Seat 6: vipbor ($53.92 in chips) 
Seat 8: SwimmingPooI ($86.52 in chips) 
vipbor: posts small blind $0.25
SwimmingPooI: posts big blind $0.50
*** HOLE CARDS ***
keko gr: raises $0.75 to $1.25
bateman225: raises $2.75 to $4
Rulet345: folds 
ssorinacho92: folds 
vipbor: folds 
SwimmingPooI: folds 
keko gr: folds 
Uncalled bet ($2.75) returned to bateman225
bateman225 collected $3.25 from pot
bateman225: doesn't show hand 
*** SUMMARY ***
Total pot $3.25 | Rake $0 
Seat 1: keko gr folded before Flop
Seat 2: bateman225 collected ($3.25)
Seat 3: Rulet345 folded before Flop (didn't bet)
Seat 4: ssorinacho92 (button) folded before Flop (didn't bet)
Seat 6: vipbor (small blind) folded before Flop
Seat 8: SwimmingPooI (big blind) folded before Flop



PokerStars Hand #228688768443:  Hold'em No Limit ($0.25/$0.50 USD) - 2021/07/30 16:36:44 ET
Table 'Bok II' 9-max Seat #6 is the button
Seat 1: keko gr ($60.28 in chips) 
Seat 2: bateman225 ($39.73 in chips) 
Seat 3: Rulet345 ($56.76 in chips) 
Seat 4: ssorinacho92 ($84.62 in chips) 
Seat 6: vipbor ($53.67 in chips) 
Seat 8: SwimmingPooI ($86.02 in chips) 
SwimmingPooI: posts small blind $0.25
keko gr: posts big blind $0.50
wildermorph: sits out 
*** HOLE CARDS ***
bateman225: folds 
Rulet345: folds 
ssorinacho92: raises $0.75 to $1.25
vipbor: folds 
pirog766 is disconnected 
SwimmingPooI: folds 
keko gr: folds 
Uncalled bet ($0.75) returned to ssorinacho92
ssorinacho92 collected $1.25 from pot
ssorinacho92: doesn't show hand 
*** SUMMARY ***
Total pot $1.25 | Rake $0 
Seat 1: keko gr (big blind) folded before Flop
Seat 2: bateman225 folded before Flop (didn't bet)
Seat 3: Rulet345 folded before Flop (didn't bet)
Seat 4: ssorinacho92 collected ($1.25)
Seat 6: vipbor (button) folded before Flop (didn't bet)
Seat 8: SwimmingPooI (small blind) folded before Flop



PokerStars Hand #228688776741:  Hold'em No Limit ($0.25/$0.50 USD) - 2021/07/30 16:37:01 ET
Table 'Bok II' 9-max Seat #8 is the button
Seat 1: keko gr ($59.78 in chips) 
Seat 2: bateman225 ($39.73 in chips) 
Seat 3: Rulet345 ($56.76 in chips) 
Seat 4: ssorinacho92 ($85.37 in chips) 
Seat 6: vipbor ($53.67 in chips) 
Seat 8: SwimmingPooI ($85.77 in chips) 
keko gr: posts small blind $0.25
bateman225: posts big blind $0.50
wildermorph: sits out 
Dragonclawss: sits out 
*** HOLE CARDS ***
Rulet345: folds 
ssorinacho92: folds 
vipbor: folds 
SwimmingPooI: raises $0.75 to $1.25
keko gr: folds 
bateman225: calls $0.75
*** FLOP *** [Qs Jc Js]
bateman225: checks 
SwimmingPooI: bets $1.33
bateman225: folds 
Uncalled bet ($1.33) returned to SwimmingPooI
SwimmingPooI collected $2.61 from pot
SwimmingPooI: doesn't show hand 
*** SUMMARY ***
Total pot $2.75 | Rake $0.14 
Board [Qs Jc Js]
Seat 1: keko gr (small blind) folded before Flop
Seat 2: bateman225 (big blind) folded on the Flop
Seat 3: Rulet345 folded before Flop (didn't bet)
Seat 4: ssorinacho92 folded before Flop (didn't bet)
Seat 6: vipbor folded before Flop (didn't bet)
Seat 8: SwimmingPooI (button) collected ($2.61)



PokerStars Hand #228688793201:  Hold'em No Limit ($0.25/$0.50 USD) - 2021/07/30 16:37:36 ET
Table 'Bok II' 9-max Seat #1 is the button
Seat 1: keko gr ($59.53 in chips) 
Seat 2: bateman225 ($38.48 in chips) 
Seat 3: Rulet345 ($56.76 in chips) 
Seat 4: ssorinacho92 ($85.37 in chips) 
Seat 6: vipbor ($53.67 in chips) 
Seat 8: SwimmingPooI ($87.13 in chips) 
bateman225: posts small blind $0.25
Rulet345: posts big blind $0.50
wildermorph: sits out 
Dragonclawss: sits out 
*** HOLE CARDS ***
ssorinacho92: folds 
vipbor: folds 
SwimmingPooI: raises $1 to $1.50
keko gr: calls $1.50
bateman225: folds 
Rulet345: calls $1
*** FLOP *** [As Qc 5s]
Rulet345: checks 
SwimmingPooI: bets $2.30
keko gr: folds 
Rulet345: calls $2.30
*** TURN *** [As Qc 5s] [3s]
Rulet345: checks 
SwimmingPooI: checks 
*** RIVER *** [As Qc 5s 3s] [6h]
Rulet345: checks 
SwimmingPooI: checks 
*** SHOW DOWN ***
Rulet345: shows [7c Ac] (a pair of Aces)
SwimmingPooI: shows [Ah Tc] (a pair of Aces - Queen+Ten kicker)
SwimmingPooI collected $8.88 from pot
*** SUMMARY ***
Total pot $9.35 | Rake $0.47 
Board [As Qc 5s 3s 6h]
Seat 1: keko gr (button) folded on the Flop
Seat 2: bateman225 (small blind) folded before Flop
Seat 3: Rulet345 (big blind) showed [7c Ac] and lost with a pair of Aces
Seat 4: ssorinacho92 folded before Flop (didn't bet)
Seat 6: vipbor folded before Flop (didn't bet)
Seat 8: SwimmingPooI showed [Ah Tc] and won ($8.88) with a pair of Aces



PokerStars Hand #228688825427:  Hold'em No Limit ($0.25/$0.50 USD) - 2021/07/30 16:38:42 ET
Table 'Bok II' 9-max Seat #2 is the button
Seat 1: keko gr ($58.03 in chips) 
Seat 2: bateman225 ($38.23 in chips) 
Seat 3: Rulet345 ($52.96 in chips) 
Seat 4: ssorinacho92 ($85.37 in chips) 
Seat 6: vipbor ($53.67 in chips) 
Seat 8: SwimmingPooI ($92.21 in chips) 
Rulet345: posts small blind $0.25
ssorinacho92: posts big blind $0.50
wildermorph: sits out 
Dragonclawss: sits out 
*** HOLE CARDS ***
vipbor: folds 
SwimmingPooI: folds 
keko gr: folds 
bateman225: folds 
Rulet345: raises $1 to $1.50
ssorinacho92: folds 
Uncalled bet ($1) returned to Rulet345
Rulet345 collected $1 from pot
Rulet345: doesn't show hand 
*** SUMMARY ***
Total pot $1 | Rake $0 
Seat 1: keko gr folded before Flop (didn't bet)
Seat 2: bateman225 (button) folded before Flop (didn't bet)
Seat 3: Rulet345 (small blind) collected ($1)
Seat 4: ssorinacho92 (big blind) folded before Flop
Seat 6: vipbor folded before Flop (didn't bet)
Seat 8: SwimmingPooI folded before Flop (didn't bet)



PokerStars Hand #228688859788:  Hold'em No Limit ($0.25/$0.50 USD) - 2021/07/30 16:39:55 ET
Table 'Bok II' 9-max Seat #5 is the button
Seat 1: keko gr ($58.03 in chips) 
Seat 2: bateman225 ($38.42 in chips) 
Seat 3: Rulet345 ($53.46 in chips) 
Seat 4: ssorinacho92 ($85.87 in chips) 
Seat 5: wildermorph ($49.25 in chips) 
Seat 6: vipbor ($53.17 in chips) 
Seat 7: Dragonclawss ($50 in chips) 
Seat 8: SwimmingPooI ($92.21 in chips) 
vipbor: posts small blind $0.25
Dragonclawss: posts big blind $0.50
*** HOLE CARDS ***
SwimmingPooI: raises $1 to $1.50
keko gr: calls $1.50
bateman225: folds 
Rulet345: folds 
ssorinacho92: folds 
wildermorph: folds 
vipbor: folds 
Dragonclawss: folds 
*** FLOP *** [Ac 4h Kc]
SwimmingPooI: bets $1.82
keko gr: folds 
Uncalled bet ($1.82) returned to SwimmingPooI
SwimmingPooI collected $3.56 from pot
SwimmingPooI: doesn't show hand 
*** SUMMARY ***
Total pot $3.75 | Rake $0.19 
Board [Ac 4h Kc]
Seat 1: keko gr folded on the Flop
Seat 2: bateman225 folded before Flop (didn't bet)
Seat 3: Rulet345 folded before Flop (didn't bet)
Seat 4: ssorinacho92 folded before Flop (didn't bet)
Seat 5: wildermorph (button) folded before Flop (didn't bet)
Seat 6: vipbor (small blind) folded before Flop
Seat 7: Dragonclawss (big blind) folded before Flop
Seat 8: SwimmingPooI collected ($3.56)



PokerStars Hand #228688871706:  Hold'em No Limit ($0.25/$0.50 USD) - 2021/07/30 16:40:20 ET
Table 'Bok II' 9-max Seat #6 is the button
Seat 1: keko gr ($56.53 in chips) 
Seat 2: bateman225 ($38.42 in chips) 
Seat 3: Rulet345 ($53.46 in chips) 
Seat 4: ssorinacho92 ($85.87 in chips) 
Seat 5: wildermorph ($49.25 in chips) 
Seat 6: vipbor ($52.92 in chips) 
Seat 7: Dragonclawss ($50 in chips) 
Seat 8: SwimmingPooI ($94.27 in chips) 
Dragonclawss: posts small blind $0.25
SwimmingPooI: posts big blind $0.50
*** HOLE CARDS ***
keko gr: folds 
bateman225: raises $0.50 to $1
Rulet345: folds 
ssorinacho92: folds 
wildermorph: folds 
vipbor: folds 
Dragonclawss: folds 
SwimmingPooI: folds 
Uncalled bet ($0.50) returned to bateman225
bateman225 collected $1.25 from pot
bateman225: doesn't show hand 
*** SUMMARY ***
Total pot $1.25 | Rake $0 
Seat 1: keko gr folded before Flop (didn't bet)
Seat 2: bateman225 collected ($1.25)
Seat 3: Rulet345 folded before Flop (didn't bet)
Seat 4: ssorinacho92 folded before Flop (didn't bet)
Seat 5: wildermorph folded before Flop (didn't bet)
Seat 6: vipbor (button) folded before Flop (didn't bet)
Seat 7: Dragonclawss (small blind) folded before Flop
Seat 8: SwimmingPooI (big blind) folded before Flop



PokerStars Hand #228688887680:  Hold'em No Limit ($0.25/$0.50 USD) - 2021/07/30 16:40:46 ET
Table 'Bok II' 9-max Seat #7 is the button
Seat 1: keko gr ($56.53 in chips) 
Seat 2: bateman225 ($39.17 in chips) 
Seat 3: Rulet345 ($53.46 in chips) 
Seat 4: ssorinacho92 ($85.87 in chips) 
Seat 5: wildermorph ($49.25 in chips) 
Seat 6: vipbor ($52.92 in chips) 
Seat 7: Dragonclawss ($50 in chips) 
Seat 8: SwimmingPooI ($93.77 in chips) 
SwimmingPooI: posts small blind $0.25
keko gr: posts big blind $0.50
*** HOLE CARDS ***
bateman225: calls $0.50
Rulet345: folds 
ssorinacho92: folds 
wildermorph: folds 
vipbor: folds 
Dragonclawss: calls $0.50
SwimmingPooI: raises $2.50 to $3
keko gr: folds 
bateman225: folds 
Dragonclawss: folds 
Uncalled bet ($2.50) returned to SwimmingPooI
SwimmingPooI collected $2 from pot
SwimmingPooI: doesn't show hand 
*** SUMMARY ***
Total pot $2 | Rake $0 
Seat 1: keko gr (big blind) folded before Flop
Seat 2: bateman225 folded before Flop
Seat 3: Rulet345 folded before Flop (didn't bet)
Seat 4: ssorinacho92 folded before Flop (didn't bet)
Seat 5: wildermorph folded before Flop (didn't bet)
Seat 6: vipbor folded before Flop (didn't bet)
Seat 7: Dragonclawss (button) folded before Flop
Seat 8: SwimmingPooI (small blind) collected ($2)



PokerStars Hand #228688902096:  Hold'em No Limit ($0.25/$0.50 USD) - 2021/07/30 16:41:16 ET
Table 'Bok II' 9-max Seat #8 is the button
Seat 1: keko gr ($56.03 in chips) 
Seat 2: bateman225 ($38.67 in chips) 
Seat 3: Rulet345 ($53.46 in chips) 
Seat 4: ssorinacho92 ($85.87 in chips) 
Seat 5: wildermorph ($49.25 in chips) 
Seat 6: vipbor ($52.92 in chips) 
Seat 7: Dragonclawss ($50 in chips) 
Seat 8: SwimmingPooI ($95.27 in chips) 
keko gr: posts small blind $0.25
bateman225: posts big blind $0.50
*** HOLE CARDS ***
Rulet345: folds 
ssorinacho92: folds 
wildermorph: folds 
vipbor: folds 
Dragonclawss: folds 
SwimmingPooI: raises $0.75 to $1.25
keko gr: folds 
bateman225: calls $0.75
*** FLOP *** [8s Ah Qs]
bateman225: checks 
SwimmingPooI: bets $1.33
bateman225: folds 
Uncalled bet ($1.33) returned to SwimmingPooI
SwimmingPooI collected $2.61 from pot
SwimmingPooI: doesn't show hand 
*** SUMMARY ***
Total pot $2.75 | Rake $0.14 
Board [8s Ah Qs]
Seat 1: keko gr (small blind) folded before Flop
Seat 2: bateman225 (big blind) folded on the Flop
Seat 3: Rulet345 folded before Flop (didn't bet)
Seat 4: ssorinacho92 folded before Flop (didn't bet)
Seat 5: wildermorph folded before Flop (didn't bet)
Seat 6: vipbor folded before Flop (didn't bet)
Seat 7: Dragonclawss folded before Flop (didn't bet)
Seat 8: SwimmingPooI (button) collected ($2.61)



PokerStars Hand #228688913627:  Hold'em No Limit ($0.25/$0.50 USD) - 2021/07/30 16:41:41 ET
Table 'Bok II' 9-max Seat #1 is the button
Seat 1: keko gr ($55.78 in chips) 
Seat 2: bateman225 ($37.42 in chips) 
Seat 3: Rulet345 ($53.46 in chips) 
Seat 4: ssorinacho92 ($85.87 in chips) 
Seat 5: wildermorph ($49.25 in chips) 
Seat 6: vipbor ($52.92 in chips) 
Seat 7: Dragonclawss ($50 in chips) 
Seat 8: SwimmingPooI ($96.63 in chips) 
bateman225: posts small blind $0.25
Rulet345: posts big blind $0.50
*** HOLE CARDS ***
ssorinacho92: folds 
wildermorph: folds 
vipbor: raises $0.75 to $1.25
Dragonclawss: folds 
SwimmingPooI: folds 
keko gr: calls $1.25
bateman225: folds 
Rulet345: raises $5.25 to $6.50
vipbor: calls $5.25
keko gr: folds 
*** FLOP *** [8h 6c 7c]
Rulet345: bets $4.55
vipbor: raises $4.95 to $9.50
Rulet345: raises $37.46 to $46.96 and is all-in
vipbor: calls $36.92 and is all-in
Uncalled bet ($0.54) returned to Rulet345
vipbor:  
Rulet345:  
*** FIRST TURN *** [8h 6c 7c] [Kd]
*** FIRST RIVER *** [8h 6c 7c Kd] [5d]
*** SECOND TURN *** [8h 6c 7c] [Qd]
*** SECOND RIVER *** [8h 6c 7c Qd] [2h]
*** FIRST SHOW DOWN ***
Rulet345: shows [Qc Kc] (a pair of Kings)
vipbor: shows [Ts 9s] (a straight, Six to Ten)
vipbor collected $52.67 from pot
*** SECOND SHOW DOWN ***
Rulet345: shows [Qc Kc] (a pair of Queens)
vipbor: shows [Ts 9s] (a straight, Six to Ten)
vipbor collected $52.67 from pot
*** SUMMARY ***
Total pot $107.34 | Rake $2 
Hand was run twice
FIRST Board [8h 6c 7c Kd 5d]
SECOND Board [8h 6c 7c Qd 2h]
Seat 1: keko gr (button) folded before Flop
Seat 2: bateman225 (small blind) folded before Flop
Seat 3: Rulet345 (big blind) showed [Qc Kc] and lost with a pair of Kings, and lost with a pair of Queens
Seat 4: ssorinacho92 folded before Flop (didn't bet)
Seat 5: wildermorph folded before Flop (didn't bet)
Seat 6: vipbor showed [Ts 9s] and won ($52.67) with a straight, Six to Ten, and won ($52.67) with a straight, Six to Ten
Seat 7: Dragonclawss folded before Flop (didn't bet)
Seat 8: SwimmingPooI folded before Flop (didn't bet)



PokerStars Hand #228688961889:  Hold'em No Limit ($0.25/$0.50 USD) - 2021/07/30 16:43:23 ET
Table 'Bok II' 9-max Seat #2 is the button
Seat 1: keko gr ($54.53 in chips) 
Seat 2: bateman225 ($37.17 in chips) 
Seat 3: Rulet345 ($50 in chips) 
Seat 4: ssorinacho92 ($85.87 in chips) 
Seat 5: wildermorph ($49.25 in chips) 
Seat 6: vipbor ($105.34 in chips) 
Seat 7: Dragonclawss ($50 in chips) 
Seat 8: SwimmingPooI ($96.63 in chips) 
Rulet345: posts small blind $0.25
ssorinacho92: posts big blind $0.50
*** HOLE CARDS ***
wildermorph: folds 
vipbor: folds 
Dragonclawss: folds 
SwimmingPooI: folds 
keko gr: raises $1 to $1.50
bateman225: folds 
Rulet345: folds 
ssorinacho92: folds 
Uncalled bet ($1) returned to keko gr
keko gr collected $1.25 from pot
*** SUMMARY ***
Total pot $1.25 | Rake $0 
Seat 1: keko gr collected ($1.25)
Seat 2: bateman225 (button) folded before Flop (didn't bet)
Seat 3: Rulet345 (small blind) folded before Flop
Seat 4: ssorinacho92 (big blind) folded before Flop
Seat 5: wildermorph folded before Flop (didn't bet)
Seat 6: vipbor folded before Flop (didn't bet)
Seat 7: Dragonclawss folded before Flop (didn't bet)
Seat 8: SwimmingPooI folded before Flop (didn't bet)



PokerStars Hand #228688989052:  Hold'em No Limit ($0.25/$0.50 USD) - 2021/07/30 16:44:21 ET
Table 'Bok II' 9-max Seat #4 is the button
Seat 2: bateman225 ($35.92 in chips) 
Seat 3: Rulet345 ($50 in chips) 
Seat 4: ssorinacho92 ($85.12 in chips) 
Seat 5: wildermorph ($48.75 in chips) 
Seat 6: vipbor ($107.18 in chips) 
Seat 7: Dragonclawss ($50 in chips) 
Seat 8: SwimmingPooI ($96.63 in chips) 
wildermorph: posts small blind $0.25
vipbor: posts big blind $0.50
*** HOLE CARDS ***
Dragonclawss: folds 
SwimmingPooI: folds 
bateman225: folds 
Rulet345: folds 
ssorinacho92: folds 
wildermorph: folds 
Uncalled bet ($0.25) returned to vipbor
vipbor collected $0.50 from pot
*** SUMMARY ***
Total pot $0.50 | Rake $0 
Seat 2: bateman225 folded before Flop (didn't bet)
Seat 3: Rulet345 folded before Flop (didn't bet)
Seat 4: ssorinacho92 (button) folded before Flop (didn't bet)
Seat 5: wildermorph (small blind) folded before Flop
Seat 6: vipbor (big blind) collected ($0.50)
Seat 7: Dragonclawss folded before Flop (didn't bet)
Seat 8: SwimmingPooI folded before Flop (didn't bet)



PokerStars Hand #228688992886:  Hold'em No Limit ($0.25/$0.50 USD) - 2021/07/30 16:44:30 ET
Table 'Bok II' 9-max Seat #5 is the button
Seat 2: bateman225 ($35.92 in chips) 
Seat 3: Rulet345 ($50 in chips) 
Seat 4: ssorinacho92 ($85.12 in chips) 
Seat 5: wildermorph ($48.50 in chips) 
Seat 6: vipbor ($107.43 in chips) 
Seat 8: SwimmingPooI ($96.63 in chips) 
vipbor: posts small blind $0.25
Dragonclawss: is sitting out 
SwimmingPooI: posts big blind $0.50
*** HOLE CARDS ***
Dragonclawss leaves the table
Freak380 joins the table at seat #7 
bateman225: raises $0.50 to $1
Rulet345: calls $1
ssorinacho92: folds 
wildermorph: calls $1
vipbor: folds 
SwimmingPooI: calls $0.50
*** FLOP *** [Qh 9s Kc]
SwimmingPooI: checks 
bateman225: bets $0.50
Rulet345: calls $0.50
wildermorph: calls $0.50
SwimmingPooI: calls $0.50
*** TURN *** [Qh 9s Kc] [2s]
SwimmingPooI: checks 
bateman225: checks 
Rulet345: checks 
wildermorph: checks 
*** RIVER *** [Qh 9s Kc 2s] [Qd]
SwimmingPooI: bets $3.03
bateman225: folds 
Rulet345: folds 
wildermorph: folds 
Uncalled bet ($3.03) returned to SwimmingPooI
SwimmingPooI collected $5.94 from pot
SwimmingPooI: doesn't show hand 
*** SUMMARY ***
Total pot $6.25 | Rake $0.31 
Board [Qh 9s Kc 2s Qd]
Seat 2: bateman225 folded on the River
Seat 3: Rulet345 folded on the River
Seat 4: ssorinacho92 folded before Flop (didn't bet)
Seat 5: wildermorph (button) folded on the River
Seat 6: vipbor (small blind) folded before Flop
Seat 8: SwimmingPooI (big blind) collected ($5.94)



PokerStars Hand #228689036135:  Hold'em No Limit ($0.25/$0.50 USD) - 2021/07/30 16:45:42 ET
Table 'Bok II' 9-max Seat #6 is the button
Seat 2: bateman225 ($34.42 in chips) 
Seat 3: Rulet345 ($50 in chips) 
Seat 4: ssorinacho92 ($85.12 in chips) 
Seat 5: wildermorph ($47 in chips) 
Seat 6: vipbor ($107.18 in chips) 
Seat 8: SwimmingPooI ($101.07 in chips) 
SwimmingPooI: posts small blind $0.25
bateman225: posts big blind $0.50
*** HOLE CARDS ***
Rulet345: folds 
ssorinacho92: raises $0.75 to $1.25
wildermorph: folds 
vipbor: folds 
SwimmingPooI: raises $4.75 to $6
bateman225: folds 
ssorinacho92: calls $4.75
*** FLOP *** [7c 5c Js]
SwimmingPooI: bets $6
ssorinacho92: calls $6
*** TURN *** [7c 5c Js] [Ad]
pirog766 was removed from the table for failing to post
pirog766 leaves the table
SwimmingPooI: checks 
ssorinacho92: bets $9.31
SwimmingPooI: folds 
Uncalled bet ($9.31) returned to ssorinacho92
ssorinacho92 collected $23.28 from pot
ssorinacho92: doesn't show hand 
*** SUMMARY ***
Total pot $24.50 | Rake $1.22 
Board [7c 5c Js Ad]
Seat 2: bateman225 (big blind) folded before Flop
Seat 3: Rulet345 folded before Flop (didn't bet)
Seat 4: ssorinacho92 collected ($23.28)
Seat 5: wildermorph folded before Flop (didn't bet)
Seat 6: vipbor (button) folded before Flop (didn't bet)
Seat 8: SwimmingPooI (small blind) folded on the Turn



PokerStars Hand #228689075834:  Hold'em No Limit ($0.25/$0.50 USD) - 2021/07/30 16:47:04 ET
Table 'Bok II' 9-max Seat #8 is the button
Seat 2: bateman225 ($33.92 in chips) 
Seat 3: Rulet345 ($50 in chips) 
Seat 4: ssorinacho92 ($96.40 in chips) 
Seat 5: wildermorph ($50 in chips) 
Seat 6: vipbor ($107.18 in chips) 
Seat 7: Freak380 ($50 in chips) 
Seat 8: SwimmingPooI ($89.07 in chips) 
Chev_030 joins the table at seat #9 
bateman225: posts small blind $0.25
Rulet345: posts big blind $0.50
Freak380: posts big blind $0.50
*** HOLE CARDS ***
ssorinacho92: folds 
wildermorph: raises $0.50 to $1
vipbor: folds 
Freak380: folds 
SwimmingPooI: folds 
bateman225: folds 
Rulet345: folds 
Uncalled bet ($0.50) returned to wildermorph
wildermorph collected $1.75 from pot
*** SUMMARY ***
Total pot $1.75 | Rake $0 
Seat 2: bateman225 (small blind) folded before Flop
Seat 3: Rulet345 (big blind) folded before Flop
Seat 4: ssorinacho92 folded before Flop (didn't bet)
Seat 5: wildermorph collected ($1.75)
Seat 6: vipbor folded before Flop (didn't bet)
Seat 7: Freak380 folded before Flop (didn't bet)
Seat 8: SwimmingPooI (button) folded before Flop (didn't bet)



PokerStars Hand #228690888250:  Hold'em No Limit ($0.25/$0.50 USD) - 2021/07/30 17:53:23 ET
Table 'Bok II' 9-max Seat #5 is the button
Seat 1: Mc57Arnold ($55.96 in chips) 
Seat 2: Leason22 ($21.19 in chips) 
Seat 3: gvidator ($33.40 in chips) 
Seat 4: Dragonclawss ($50 in chips) 
Seat 5: forestry800 ($53.60 in chips) 
Seat 6: vipbor ($74.63 in chips) 
Seat 7: Freak380 ($76.53 in chips) 
vipbor: posts small blind $0.25
Freak380: posts big blind $0.50
dstrola: sits out 
Seduisant365: sits out 
*** HOLE CARDS ***
Mc57Arnold: raises $0.85 to $1.35
Leason22: calls $1.35
gvidator: folds 
Dragonclawss: raises $4.65 to $6
forestry800: folds 
vipbor: folds 
Freak380: folds 
Mc57Arnold: calls $4.65
Leason22: calls $4.65
*** FLOP *** [9d 9c 8d]
Mc57Arnold: checks 
Leason22: checks 
Dragonclawss: checks 
*** TURN *** [9d 9c 8d] [Qs]
Mc57Arnold: checks 
Leason22: checks 
Dragonclawss: checks 
*** RIVER *** [9d 9c 8d Qs] [Jh]
Mc57Arnold: checks 
Leason22: bets $15.19 and is all-in
Dragonclawss: folds 
Mc57Arnold: folds 
Uncalled bet ($15.19) returned to Leason22
Leason22 collected $17.57 from pot
*** SUMMARY ***
Total pot $18.75 | Rake $1.18 
Board [9d 9c 8d Qs Jh]
Seat 1: Mc57Arnold folded on the River
Seat 2: Leason22 collected ($17.57)
Seat 3: gvidator folded before Flop (didn't bet)
Seat 4: Dragonclawss folded on the River
Seat 5: forestry800 (button) folded before Flop (didn't bet)
Seat 6: vipbor (small blind) folded before Flop
Seat 7: Freak380 (big blind) folded before Flop



PokerStars Hand #228690913767:  Hold'em No Limit ($0.25/$0.50 USD) - 2021/07/30 17:54:23 ET
Table 'Bok II' 9-max Seat #6 is the button
Seat 1: Mc57Arnold ($50 in chips) 
Seat 2: Leason22 ($32.76 in chips) 
Seat 3: gvidator ($33.40 in chips) 
Seat 4: Dragonclawss ($50 in chips) 
Seat 5: forestry800 ($53.60 in chips) 
Seat 6: vipbor ($74.38 in chips) 
Seat 7: Freak380 ($76.03 in chips) 
Seat 8: dstrola ($50 in chips) 
Freak380: posts small blind $0.25
dstrola: posts big blind $0.50
Seduisant365: sits out 
*** HOLE CARDS ***
Mc57Arnold: folds 
Leason22: raises $0.50 to $1
gvidator: calls $1
Dragonclawss: folds 
forestry800: folds 
vipbor: folds 
Freak380: folds 
dstrola: calls $0.50
*** FLOP *** [2h Jh 8s]
dstrola: checks 
Leason22: bets $2
gvidator: calls $2
dstrola: folds 
*** TURN *** [2h Jh 8s] [As]
Leason22: bets $6.50
gvidator: calls $6.50
*** RIVER *** [2h Jh 8s As] [4d]
Leason22: bets $23.26 and is all-in
gvidator: folds 
Uncalled bet ($23.26) returned to Leason22
Leason22 collected $18.99 from pot
*** SUMMARY ***
Total pot $20.25 | Rake $1.26 
Board [2h Jh 8s As 4d]
Seat 1: Mc57Arnold folded before Flop (didn't bet)
Seat 2: Leason22 collected ($18.99)
Seat 3: gvidator folded on the River
Seat 4: Dragonclawss folded before Flop (didn't bet)
Seat 5: forestry800 folded before Flop (didn't bet)
Seat 6: vipbor (button) folded before Flop (didn't bet)
Seat 7: Freak380 (small blind) folded before Flop
Seat 8: dstrola (big blind) folded on the Flop



PokerStars Hand #228690946143:  Hold'em No Limit ($0.25/$0.50 USD) - 2021/07/30 17:55:49 ET
Table 'Bok II' 9-max Seat #7 is the button
Seat 1: Mc57Arnold ($50 in chips) 
Seat 2: Leason22 ($42.25 in chips) 
Seat 3: gvidator ($23.90 in chips) 
Seat 4: Dragonclawss ($50 in chips) 
Seat 5: forestry800 ($53.60 in chips) 
Seat 6: vipbor ($74.38 in chips) 
Seat 7: Freak380 ($75.78 in chips) 
Seat 8: dstrola ($50 in chips) 
Seat 9: Seduisant365 ($50 in chips) 
dstrola: posts small blind $0.25
Seduisant365: posts big blind $0.50
*** HOLE CARDS ***
Mc57Arnold: folds 
Leason22: folds 
gvidator: folds 
Dragonclawss: folds 
forestry800: folds 
vipbor: raises $0.75 to $1.25
Freak380: folds 
dstrola: folds 
Seduisant365: raises $3.75 to $5
vipbor: calls $3.75
*** FLOP *** [5s Jc Jh]
Seduisant365: bets $5.36
vipbor: folds 
Uncalled bet ($5.36) returned to Seduisant365
Seduisant365 collected $9.74 from pot
Seduisant365: doesn't show hand 
*** SUMMARY ***
Total pot $10.25 | Rake $0.51 
Board [5s Jc Jh]
Seat 1: Mc57Arnold folded before Flop (didn't bet)
Seat 2: Leason22 folded before Flop (didn't bet)
Seat 3: gvidator folded before Flop (didn't bet)
Seat 4: Dragonclawss folded before Flop (didn't bet)
Seat 5: forestry800 folded before Flop (didn't bet)
Seat 6: vipbor folded on the Flop
Seat 7: Freak380 (button) folded before Flop (didn't bet)
Seat 8: dstrola (small blind) folded before Flop
Seat 9: Seduisant365 (big blind) collected ($9.74)



PokerStars Hand #228690213277:  Hold'em No Limit ($0.25/$0.50 USD) - 2021/07/30 17:28:08 ET
Table 'Bok II' 9-max Seat #7 is the button
Seat 1: Mc57Arnold ($50 in chips) 
Seat 2: bateman225 ($72 in chips) 
Seat 4: ssorinacho92 ($104.26 in chips) 
Seat 5: RRBAGGIO77 ($65.89 in chips) 
Seat 6: vipbor ($90.45 in chips) 
Seat 7: Freak380 ($51.45 in chips) 
Seat 8: SwimmingPooI ($65.94 in chips) 
Seat 9: Lavitadi ($43.46 in chips) 
SwimmingPooI: posts small blind $0.25
Lavitadi: posts big blind $0.50
se13giuum: sits out 
*** HOLE CARDS ***
Mc57Arnold: folds 
bateman225: folds 
ssorinacho92: folds 
RRBAGGIO77: raises $1 to $1.50
vipbor: calls $1.50
Freak380: folds 
SwimmingPooI: folds 
Lavitadi: folds 
*** FLOP *** [4c 5h Qh]
RRBAGGIO77: bets $2
vipbor: calls $2
*** TURN *** [4c 5h Qh] [Ah]
RRBAGGIO77: bets $4
vipbor: folds 
Uncalled bet ($4) returned to RRBAGGIO77
RRBAGGIO77 collected $7.36 from pot
RRBAGGIO77: doesn't show hand 
*** SUMMARY ***
Total pot $7.75 | Rake $0.39 
Board [4c 5h Qh Ah]
Seat 1: Mc57Arnold folded before Flop (didn't bet)
Seat 2: bateman225 folded before Flop (didn't bet)
Seat 4: ssorinacho92 folded before Flop (didn't bet)
Seat 5: RRBAGGIO77 collected ($7.36)
Seat 6: vipbor folded on the Turn
Seat 7: Freak380 (button) folded before Flop (didn't bet)
Seat 8: SwimmingPooI (small blind) folded before Flop
Seat 9: Lavitadi (big blind) folded before Flop



PokerStars Hand #228690238640:  Hold'em No Limit ($0.25/$0.50 USD) - 2021/07/30 17:29:04 ET
Table 'Bok II' 9-max Seat #8 is the button
Seat 1: Mc57Arnold ($50 in chips) 
Seat 2: bateman225 ($72 in chips) 
Seat 4: ssorinacho92 ($104.26 in chips) 
Seat 5: RRBAGGIO77 ($69.75 in chips) 
Seat 6: vipbor ($86.95 in chips) 
Seat 7: Freak380 ($51.45 in chips) 
Seat 8: SwimmingPooI ($65.69 in chips) 
Seat 9: Lavitadi ($42.96 in chips) 
Lavitadi: posts small blind $0.25
Mc57Arnold: posts big blind $0.50
se13giuum: sits out 
*** HOLE CARDS ***
bateman225: raises $0.50 to $1
ssorinacho92: folds 
RRBAGGIO77: folds 
vipbor: folds 
Freak380: folds 
SwimmingPooI: folds 
Lavitadi: folds 
Mc57Arnold: raises $2.50 to $3.50
bateman225: calls $2.50
*** FLOP *** [7d Kc 5c]
Mc57Arnold: bets $2.07
bateman225: raises $2.07 to $4.14
Mc57Arnold: folds 
Uncalled bet ($2.07) returned to bateman225
bateman225 collected $10.82 from pot
bateman225: doesn't show hand 
*** SUMMARY ***
Total pot $11.39 | Rake $0.57 
Board [7d Kc 5c]
Seat 1: Mc57Arnold (big blind) folded on the Flop
Seat 2: bateman225 collected ($10.82)
Seat 4: ssorinacho92 folded before Flop (didn't bet)
Seat 5: RRBAGGIO77 folded before Flop (didn't bet)
Seat 6: vipbor folded before Flop (didn't bet)
Seat 7: Freak380 folded before Flop (didn't bet)
Seat 8: SwimmingPooI (button) folded before Flop (didn't bet)
Seat 9: Lavitadi (small blind) folded before Flop



PokerStars Hand #228690254007:  Hold'em No Limit ($0.25/$0.50 USD) - 2021/07/30 17:29:38 ET
Table 'Bok II' 9-max Seat #9 is the button
Seat 1: Mc57Arnold ($50 in chips) 
Seat 2: bateman225 ($77.25 in chips) 
Seat 4: ssorinacho92 ($104.26 in chips) 
Seat 5: RRBAGGIO77 ($69.75 in chips) 
Seat 6: vipbor ($86.95 in chips) 
Seat 7: Freak380 ($51.45 in chips) 
Seat 8: SwimmingPooI ($65.69 in chips) 
Seat 9: Lavitadi ($42.71 in chips) 
Mc57Arnold: posts small blind $0.25
bateman225: posts big blind $0.50
se13giuum: sits out 
*** HOLE CARDS ***
ssorinacho92: folds 
RRBAGGIO77: folds 
vipbor: raises $0.75 to $1.25
Freak380: calls $1.25
SwimmingPooI: folds 
Lavitadi: raises $2.25 to $3.50
Mc57Arnold: folds 
bateman225: folds 
vipbor: folds 
Freak380: calls $2.25
*** FLOP *** [9h 3c Jh]
Freak380: checks 
Lavitadi: bets $5.50
Freak380: folds 
Uncalled bet ($5.50) returned to Lavitadi
Lavitadi collected $8.55 from pot
Lavitadi: doesn't show hand 
*** SUMMARY ***
Total pot $9 | Rake $0.45 
Board [9h 3c Jh]
Seat 1: Mc57Arnold (small blind) folded before Flop
Seat 2: bateman225 (big blind) folded before Flop
Seat 4: ssorinacho92 folded before Flop (didn't bet)
Seat 5: RRBAGGIO77 folded before Flop (didn't bet)
Seat 6: vipbor folded before Flop
Seat 7: Freak380 folded on the Flop
Seat 8: SwimmingPooI folded before Flop (didn't bet)
Seat 9: Lavitadi (button) collected ($8.55)



PokerStars Hand #228690274957:  Hold'em No Limit ($0.25/$0.50 USD) - 2021/07/30 17:30:24 ET
Table 'Bok II' 9-max Seat #1 is the button
Seat 1: Mc57Arnold ($50 in chips) 
Seat 2: bateman225 ($76.75 in chips) 
Seat 3: se13giuum ($46.14 in chips) 
Seat 4: ssorinacho92 ($104.26 in chips) 
Seat 5: RRBAGGIO77 ($69.75 in chips) 
Seat 6: vipbor ($85.70 in chips) 
Seat 7: Freak380 ($47.95 in chips) 
Seat 8: SwimmingPooI ($65.69 in chips) 
Seat 9: Lavitadi ($47.76 in chips) 
bateman225: posts small blind $0.25
se13giuum: posts big blind $0.50
*** HOLE CARDS ***
ssorinacho92: folds 
RRBAGGIO77: folds 
vipbor: folds 
RRBAGGIO77 leaves the table
forestry800 joins the table at seat #5 
Freak380 has timed out
Freak380: folds 
SwimmingPooI: folds 
Lavitadi: folds 
Mc57Arnold: raises $0.65 to $1.15
bateman225: calls $0.90
se13giuum: folds 
*** FLOP *** [5h Kc Ks]
bateman225: checks 
Mc57Arnold: bets $0.80
bateman225: folds 
Uncalled bet ($0.80) returned to Mc57Arnold
Mc57Arnold collected $2.66 from pot
Mc57Arnold: doesn't show hand 
*** SUMMARY ***
Total pot $2.80 | Rake $0.14 
Board [5h Kc Ks]
Seat 1: Mc57Arnold (button) collected ($2.66)
Seat 2: bateman225 (small blind) folded on the Flop
Seat 3: se13giuum (big blind) folded before Flop
Seat 4: ssorinacho92 folded before Flop (didn't bet)
Seat 5: RRBAGGIO77 folded before Flop (didn't bet)
Seat 6: vipbor folded before Flop (didn't bet)
Seat 7: Freak380 folded before Flop (didn't bet)
Seat 8: SwimmingPooI folded before Flop (didn't bet)
Seat 9: Lavitadi folded before Flop (didn't bet)



PokerStars Hand #228690296041:  Hold'em No Limit ($0.25/$0.50 USD) - 2021/07/30 17:31:11 ET
Table 'Bok II' 9-max Seat #2 is the button
Seat 1: Mc57Arnold ($51.51 in chips) 
Seat 2: bateman225 ($75.60 in chips) 
Seat 3: se13giuum ($45.64 in chips) 
Seat 4: ssorinacho92 ($104.26 in chips) 
Seat 6: vipbor ($85.70 in chips) 
Seat 7: Freak380 ($47.95 in chips) 
Seat 8: SwimmingPooI ($65.69 in chips) 
Seat 9: Lavitadi ($47.76 in chips) 
se13giuum: posts small blind $0.25
ssorinacho92: posts big blind $0.50
forestry800: sits out 
*** HOLE CARDS ***
vipbor: folds 
Freak380: calls $0.50
SwimmingPooI: folds 
Lavitadi: raises $2.50 to $3
Mc57Arnold: raises $6 to $9
bateman225: folds 
se13giuum: folds 
ssorinacho92: folds 
Freak380: folds 
Lavitadi: folds 
Uncalled bet ($6) returned to Mc57Arnold
Mc57Arnold collected $7.25 from pot
Mc57Arnold: doesn't show hand 
*** SUMMARY ***
Total pot $7.25 | Rake $0 
Seat 1: Mc57Arnold collected ($7.25)
Seat 2: bateman225 (button) folded before Flop (didn't bet)
Seat 3: se13giuum (small blind) folded before Flop
Seat 4: ssorinacho92 (big blind) folded before Flop
Seat 6: vipbor folded before Flop (didn't bet)
Seat 7: Freak380 folded before Flop
Seat 8: SwimmingPooI folded before Flop (didn't bet)
Seat 9: Lavitadi folded before Flop



PokerStars Hand #228690318187:  Hold'em No Limit ($0.25/$0.50 USD) - 2021/07/30 17:32:00 ET
Table 'Bok II' 9-max Seat #3 is the button
Seat 1: Mc57Arnold ($55.76 in chips) 
Seat 2: bateman225 ($75.60 in chips) 
Seat 3: se13giuum ($45.39 in chips) 
Seat 4: ssorinacho92 ($103.76 in chips) 
Seat 5: forestry800 ($50 in chips) 
Seat 6: vipbor ($85.70 in chips) 
Seat 7: Freak380 ($47.45 in chips) 
Seat 8: SwimmingPooI ($65.69 in chips) 
Seat 9: Lavitadi ($44.76 in chips) 
ssorinacho92: posts small blind $0.25
forestry800: posts big blind $0.50
*** HOLE CARDS ***
vipbor: folds 
Freak380: folds 
SwimmingPooI: folds 
Lavitadi: folds 
Mc57Arnold: folds 
bateman225: folds 
bateman225 leaves the table
se13giuum: calls $0.50
xZaKoNaLx joins the table at seat #2 
ssorinacho92: raises $2 to $2.50
forestry800: folds 
se13giuum: calls $2
*** FLOP *** [Qd Js Kh]
xZaKoNaLx leaves the table
ssorinacho92: checks 
se13giuum: bets $2.61
ssorinacho92: folds 
Uncalled bet ($2.61) returned to se13giuum
se13giuum collected $5.22 from pot
se13giuum: doesn't show hand 
*** SUMMARY ***
Total pot $5.50 | Rake $0.28 
Board [Qd Js Kh]
Seat 1: Mc57Arnold folded before Flop (didn't bet)
Seat 2: bateman225 folded before Flop (didn't bet)
Seat 3: se13giuum (button) collected ($5.22)
Seat 4: ssorinacho92 (small blind) folded on the Flop
Seat 5: forestry800 (big blind) folded before Flop
Seat 6: vipbor folded before Flop (didn't bet)
Seat 7: Freak380 folded before Flop (didn't bet)
Seat 8: SwimmingPooI folded before Flop (didn't bet)
Seat 9: Lavitadi folded before Flop (didn't bet)



PokerStars Hand #228690337975:  Hold'em No Limit ($0.25/$0.50 USD) - 2021/07/30 17:32:43 ET
Table 'Bok II' 9-max Seat #4 is the button
Seat 1: Mc57Arnold ($55.76 in chips) 
Seat 3: se13giuum ($48.11 in chips) 
Seat 4: ssorinacho92 ($101.26 in chips) 
Seat 5: forestry800 ($50 in chips) 
Seat 6: vipbor ($85.70 in chips) 
Seat 7: Freak380 ($47.45 in chips) 
Seat 8: SwimmingPooI ($65.69 in chips) 
Seat 9: Lavitadi ($44.76 in chips) 
forestry800: posts small blind $0.25
vipbor: posts big blind $0.50
*** HOLE CARDS ***
Freak380: folds 
SwimmingPooI: folds 
Lavitadi: raises $2 to $2.50
Mc57Arnold: folds 
se13giuum: folds 
ssorinacho92: folds 
forestry800: folds 
vipbor: folds 
Uncalled bet ($2) returned to Lavitadi
Lavitadi collected $1.25 from pot
Lavitadi: doesn't show hand 
*** SUMMARY ***
Total pot $1.25 | Rake $0 
Seat 1: Mc57Arnold folded before Flop (didn't bet)
Seat 3: se13giuum folded before Flop (didn't bet)
Seat 4: ssorinacho92 (button) folded before Flop (didn't bet)
Seat 5: forestry800 (small blind) folded before Flop
Seat 6: vipbor (big blind) folded before Flop
Seat 7: Freak380 folded before Flop (didn't bet)
Seat 8: SwimmingPooI folded before Flop (didn't bet)
Seat 9: Lavitadi collected ($1.25)



PokerStars Hand #228690351063:  Hold'em No Limit ($0.25/$0.50 USD) - 2021/07/30 17:33:12 ET
Table 'Bok II' 9-max Seat #5 is the button
Seat 1: Mc57Arnold ($55.76 in chips) 
Seat 3: se13giuum ($48.11 in chips) 
Seat 4: ssorinacho92 ($101.26 in chips) 
Seat 5: forestry800 ($50 in chips) 
Seat 6: vipbor ($85.20 in chips) 
Seat 7: Freak380 ($47.45 in chips) 
Seat 8: SwimmingPooI ($65.69 in chips) 
Seat 9: Lavitadi ($45.51 in chips) 
vipbor: posts small blind $0.25
Freak380: posts big blind $0.50
*** HOLE CARDS ***
Leason22 joins the table at seat #2 
SwimmingPooI: folds 
Lavitadi: folds 
Mc57Arnold: raises $0.85 to $1.35
se13giuum: folds 
ssorinacho92: folds 
forestry800: folds 
vipbor: folds 
Freak380: calls $0.85
*** FLOP *** [Jd 7d 6c]
Freak380: checks 
Mc57Arnold: bets $1.88
Freak380: folds 
Uncalled bet ($1.88) returned to Mc57Arnold
Mc57Arnold collected $2.80 from pot
Mc57Arnold: doesn't show hand 
*** SUMMARY ***
Total pot $2.95 | Rake $0.15 
Board [Jd 7d 6c]
Seat 1: Mc57Arnold collected ($2.80)
Seat 3: se13giuum folded before Flop (didn't bet)
Seat 4: ssorinacho92 folded before Flop (didn't bet)
Seat 5: forestry800 (button) folded before Flop (didn't bet)
Seat 6: vipbor (small blind) folded before Flop
Seat 7: Freak380 (big blind) folded on the Flop
Seat 8: SwimmingPooI folded before Flop (didn't bet)
Seat 9: Lavitadi folded before Flop (didn't bet)



PokerStars Hand #228690369529:  Hold'em No Limit ($0.25/$0.50 USD) - 2021/07/30 17:33:53 ET
Table 'Bok II' 9-max Seat #6 is the button
Seat 1: Mc57Arnold ($57.21 in chips) 
Seat 3: se13giuum ($48.11 in chips) 
Seat 4: ssorinacho92 ($101.26 in chips) 
Seat 5: forestry800 ($50 in chips) 
Seat 6: vipbor ($84.95 in chips) 
Seat 7: Freak380 ($46.10 in chips) 
Seat 8: SwimmingPooI ($65.69 in chips) 
Seat 9: Lavitadi ($45.51 in chips) 
Freak380: posts small blind $0.25
SwimmingPooI: posts big blind $0.50
Leason22: sits out 
*** HOLE CARDS ***
Lavitadi: folds 
Mc57Arnold: folds 
se13giuum has timed out
se13giuum: folds 
ssorinacho92: folds 
forestry800: folds 
vipbor: folds 
Freak380: raises $1 to $1.50
SwimmingPooI: folds 
Uncalled bet ($1) returned to Freak380
Freak380 collected $1 from pot
*** SUMMARY ***
Total pot $1 | Rake $0 
Seat 1: Mc57Arnold folded before Flop (didn't bet)
Seat 3: se13giuum folded before Flop (didn't bet)
Seat 4: ssorinacho92 folded before Flop (didn't bet)
Seat 5: forestry800 folded before Flop (didn't bet)
Seat 6: vipbor (button) folded before Flop (didn't bet)
Seat 7: Freak380 (small blind) collected ($1)
Seat 8: SwimmingPooI (big blind) folded before Flop
Seat 9: Lavitadi folded before Flop (didn't bet)



PokerStars Hand #228690383816:  Hold'em No Limit ($0.25/$0.50 USD) - 2021/07/30 17:34:25 ET
Table 'Bok II' 9-max Seat #7 is the button
Seat 1: Mc57Arnold ($57.21 in chips) 
Seat 3: se13giuum ($48.11 in chips) 
Seat 4: ssorinacho92 ($101.26 in chips) 
Seat 5: forestry800 ($50 in chips) 
Seat 6: vipbor ($84.95 in chips) 
Seat 7: Freak380 ($46.60 in chips) 
Seat 8: SwimmingPooI ($65.19 in chips) 
Seat 9: Lavitadi ($45.51 in chips) 
SwimmingPooI: posts small blind $0.25
Lavitadi: posts big blind $0.50
Leason22: sits out 
*** HOLE CARDS ***
Mc57Arnold: folds 
se13giuum: raises $1 to $1.50
ssorinacho92: folds 
forestry800: folds 
vipbor: raises $3 to $4.50
Freak380: folds 
SwimmingPooI: folds 
Lavitadi: calls $4
se13giuum: calls $3
*** FLOP *** [2s 8s 8d]
Lavitadi: checks 
se13giuum: bets $6.03
vipbor: calls $6.03
Lavitadi: folds 
*** TURN *** [2s 8s 8d] [3d]
se13giuum: bets $12.76
vipbor: folds 
Uncalled bet ($12.76) returned to se13giuum
se13giuum collected $24.52 from pot
se13giuum: doesn't show hand 
*** SUMMARY ***
Total pot $25.81 | Rake $1.29 
Board [2s 8s 8d 3d]
Seat 1: Mc57Arnold folded before Flop (didn't bet)
Seat 3: se13giuum collected ($24.52)
Seat 4: ssorinacho92 folded before Flop (didn't bet)
Seat 5: forestry800 folded before Flop (didn't bet)
Seat 6: vipbor folded on the Turn
Seat 7: Freak380 (button) folded before Flop (didn't bet)
Seat 8: SwimmingPooI (small blind) folded before Flop
Seat 9: Lavitadi (big blind) folded on the Flop



PokerStars Hand #228690423856:  Hold'em No Limit ($0.25/$0.50 USD) - 2021/07/30 17:35:53 ET
Table 'Bok II' 9-max Seat #8 is the button
Seat 1: Mc57Arnold ($57.21 in chips) 
Seat 3: se13giuum ($62.10 in chips) 
Seat 4: ssorinacho92 ($101.26 in chips) 
Seat 5: forestry800 ($50 in chips) 
Seat 6: vipbor ($74.42 in chips) 
Seat 7: Freak380 ($46.60 in chips) 
Seat 8: SwimmingPooI ($64.94 in chips) 
Seat 9: Lavitadi ($41.01 in chips) 
Lavitadi: posts small blind $0.25
Mc57Arnold: posts big blind $0.50
Leason22: sits out 
*** HOLE CARDS ***
se13giuum: folds 
ssorinacho92: raises $0.75 to $1.25
forestry800: folds 
vipbor: folds 
Freak380: folds 
SwimmingPooI: folds 
Lavitadi: raises $3 to $4.25
Mc57Arnold: folds 
ssorinacho92: calls $3
*** FLOP *** [9s As 4c]
Lavitadi: bets $5.50
se13giuum is disconnected 
ssorinacho92: folds 
Uncalled bet ($5.50) returned to Lavitadi
Lavitadi collected $8.55 from pot
Lavitadi: doesn't show hand 
*** SUMMARY ***
Total pot $9 | Rake $0.45 
Board [9s As 4c]
Seat 1: Mc57Arnold (big blind) folded before Flop
Seat 3: se13giuum folded before Flop (didn't bet)
Seat 4: ssorinacho92 folded on the Flop
Seat 5: forestry800 folded before Flop (didn't bet)
Seat 6: vipbor folded before Flop (didn't bet)
Seat 7: Freak380 folded before Flop (didn't bet)
Seat 8: SwimmingPooI (button) folded before Flop (didn't bet)
Seat 9: Lavitadi (small blind) collected ($8.55)



PokerStars Hand #228690447921:  Hold'em No Limit ($0.25/$0.50 USD) - 2021/07/30 17:36:47 ET
Table 'Bok II' 9-max Seat #9 is the button
Seat 1: Mc57Arnold ($56.71 in chips) 
Seat 2: Leason22 ($25 in chips) 
Seat 3: se13giuum ($62.10 in chips) 
Seat 4: ssorinacho92 ($97.01 in chips) 
Seat 5: forestry800 ($50 in chips) 
Seat 6: vipbor ($74.42 in chips) 
Seat 7: Freak380 ($46.60 in chips) 
Seat 8: SwimmingPooI ($64.94 in chips) 
Seat 9: Lavitadi ($45.31 in chips) 
Mc57Arnold: posts small blind $0.25
Leason22: posts big blind $0.50
*** HOLE CARDS ***
se13giuum has timed out while disconnected
se13giuum: folds 
ssorinacho92: folds 
forestry800: folds 
vipbor: folds 
Freak380: calls $0.50
SwimmingPooI: folds 
Lavitadi: folds 
Mc57Arnold: folds 
Leason22: checks 
*** FLOP *** [9d 2d Qs]
Leason22: checks 
Freak380: checks 
*** TURN *** [9d 2d Qs] [4c]
Leason22: bets $1.50
Freak380: folds 
Uncalled bet ($1.50) returned to Leason22
Leason22 collected $1.17 from pot
*** SUMMARY ***
Total pot $1.25 | Rake $0.08 
Board [9d 2d Qs 4c]
Seat 1: Mc57Arnold (small blind) folded before Flop
Seat 2: Leason22 (big blind) collected ($1.17)
Seat 3: se13giuum folded before Flop (didn't bet)
Seat 4: ssorinacho92 folded before Flop (didn't bet)
Seat 5: forestry800 folded before Flop (didn't bet)
Seat 6: vipbor folded before Flop (didn't bet)
Seat 7: Freak380 folded on the Turn
Seat 8: SwimmingPooI folded before Flop (didn't bet)
Seat 9: Lavitadi (button) folded before Flop (didn't bet)



PokerStars Hand #228690466849:  Hold'em No Limit ($0.25/$0.50 USD) - 2021/07/30 17:37:30 ET
Table 'Bok II' 9-max Seat #1 is the button
Seat 1: Mc57Arnold ($56.46 in chips) 
Seat 2: Leason22 ($25.67 in chips) 
Seat 4: ssorinacho92 ($97.01 in chips) 
Seat 5: forestry800 ($50 in chips) 
Seat 6: vipbor ($74.42 in chips) 
Seat 7: Freak380 ($46.10 in chips) 
Seat 8: SwimmingPooI ($64.94 in chips) 
Seat 9: Lavitadi ($45.31 in chips) 
Leason22: posts small blind $0.25
ssorinacho92: posts big blind $0.50
*** HOLE CARDS ***
forestry800: folds 
vipbor: folds 
Freak380: folds 
SwimmingPooI: folds 
Lavitadi: folds 
Mc57Arnold: folds 
Leason22: raises $1 to $1.50
ssorinacho92: folds 
Uncalled bet ($1) returned to Leason22
Leason22 collected $1 from pot
*** SUMMARY ***
Total pot $1 | Rake $0 
Seat 1: Mc57Arnold (button) folded before Flop (didn't bet)
Seat 2: Leason22 (small blind) collected ($1)
Seat 4: ssorinacho92 (big blind) folded before Flop
Seat 5: forestry800 folded before Flop (didn't bet)
Seat 6: vipbor folded before Flop (didn't bet)
Seat 7: Freak380 folded before Flop (didn't bet)
Seat 8: SwimmingPooI folded before Flop (didn't bet)
Seat 9: Lavitadi folded before Flop (didn't bet)



PokerStars Hand #228690481614:  Hold'em No Limit ($0.25/$0.50 USD) - 2021/07/30 17:37:57 ET
Table 'Bok II' 9-max Seat #2 is the button
Seat 1: Mc57Arnold ($56.46 in chips) 
Seat 2: Leason22 ($26.17 in chips) 
Seat 4: ssorinacho92 ($96.51 in chips) 
Seat 5: forestry800 ($50 in chips) 
Seat 6: vipbor ($74.42 in chips) 
Seat 7: Freak380 ($46.10 in chips) 
Seat 8: SwimmingPooI ($64.94 in chips) 
Seat 9: Lavitadi ($45.31 in chips) 
ssorinacho92: posts small blind $0.25
forestry800: posts big blind $0.50
*** HOLE CARDS ***
vipbor: folds 
Freak380: folds 
SwimmingPooI: folds 
Lavitadi: folds 
Mc57Arnold: folds 
Leason22: folds 
ssorinacho92: folds 
Uncalled bet ($0.25) returned to forestry800
forestry800 collected $0.50 from pot
forestry800: doesn't show hand 
*** SUMMARY ***
Total pot $0.50 | Rake $0 
Seat 1: Mc57Arnold folded before Flop (didn't bet)
Seat 2: Leason22 (button) folded before Flop (didn't bet)
Seat 4: ssorinacho92 (small blind) folded before Flop
Seat 5: forestry800 (big blind) collected ($0.50)
Seat 6: vipbor folded before Flop (didn't bet)
Seat 7: Freak380 folded before Flop (didn't bet)
Seat 8: SwimmingPooI folded before Flop (didn't bet)
Seat 9: Lavitadi folded before Flop (didn't bet)



PokerStars Hand #228690493128:  Hold'em No Limit ($0.25/$0.50 USD) - 2021/07/30 17:38:23 ET
Table 'Bok II' 9-max Seat #4 is the button
Seat 1: Mc57Arnold ($56.46 in chips) 
Seat 2: Leason22 ($26.17 in chips) 
Seat 3: se13giuum ($62.10 in chips) 
Seat 4: ssorinacho92 ($96.26 in chips) 
Seat 5: forestry800 ($50.25 in chips) 
Seat 6: vipbor ($74.42 in chips) 
Seat 7: Freak380 ($46.10 in chips) 
Seat 8: SwimmingPooI ($64.94 in chips) 
Seat 9: Lavitadi ($45.31 in chips) 
forestry800: posts small blind $0.25
vipbor: posts big blind $0.50
se13giuum: posts small & big blinds $0.75
*** HOLE CARDS ***
Freak380: folds 
SwimmingPooI: folds 
Lavitadi: folds 
Mc57Arnold: folds 
Leason22: folds 
se13giuum: checks 
ssorinacho92: folds 
forestry800: folds 
vipbor: checks 
*** FLOP *** [Tc 6s 9s]
vipbor: checks 
se13giuum: checks 
*** TURN *** [Tc 6s 9s] [Jd]
vipbor: checks 
se13giuum: checks 
*** RIVER *** [Tc 6s 9s Jd] [9d]
vipbor: checks 
se13giuum: checks 
*** SHOW DOWN ***
vipbor: shows [Kd 8d] (a pair of Nines)
se13giuum: shows [2d As] (a pair of Nines - Ace kicker)
se13giuum collected $1.42 from pot
*** SUMMARY ***
Total pot $1.50 | Rake $0.08 
Board [Tc 6s 9s Jd 9d]
Seat 1: Mc57Arnold folded before Flop (didn't bet)
Seat 2: Leason22 folded before Flop (didn't bet)
Seat 3: se13giuum showed [2d As] and won ($1.42) with a pair of Nines
Seat 4: ssorinacho92 (button) folded before Flop (didn't bet)
Seat 5: forestry800 (small blind) folded before Flop
Seat 6: vipbor (big blind) showed [Kd 8d] and lost with a pair of Nines
Seat 7: Freak380 folded before Flop (didn't bet)
Seat 8: SwimmingPooI folded before Flop (didn't bet)
Seat 9: Lavitadi folded before Flop (didn't bet)



PokerStars Hand #228690507449:  Hold'em No Limit ($0.25/$0.50 USD) - 2021/07/30 17:38:55 ET
Table 'Bok II' 9-max Seat #5 is the button
Seat 1: Mc57Arnold ($56.46 in chips) 
Seat 2: Leason22 ($26.17 in chips) 
Seat 3: se13giuum ($62.77 in chips) 
Seat 4: ssorinacho92 ($96.26 in chips) 
Seat 5: forestry800 ($50 in chips) 
Seat 6: vipbor ($73.92 in chips) 
Seat 7: Freak380 ($46.10 in chips) 
Seat 8: SwimmingPooI ($64.94 in chips) 
Seat 9: Lavitadi ($45.31 in chips) 
vipbor: posts small blind $0.25
Freak380: posts big blind $0.50
*** HOLE CARDS ***
SwimmingPooI: raises $1 to $1.50
Lavitadi: folds 
Mc57Arnold: folds 
Leason22: folds 
se13giuum: calls $1.50
ssorinacho92: folds 
forestry800: folds 
vipbor: folds 
Freak380: folds 
*** FLOP *** [6h Kc 3c]
SwimmingPooI: checks 
se13giuum: bets $1.78
SwimmingPooI: calls $1.78
*** TURN *** [6h Kc 3c] [Kh]
SwimmingPooI: checks 
se13giuum: bets $3.22
SwimmingPooI: calls $3.22
*** RIVER *** [6h Kc 3c Kh] [2d]
SwimmingPooI: checks 
se13giuum: bets $6.53
SwimmingPooI: calls $6.53
*** SHOW DOWN ***
se13giuum: shows [Ad 8c] (a pair of Kings)
SwimmingPooI: shows [Qh Qc] (two pair, Kings and Queens)
SwimmingPooI collected $25.47 from pot
*** SUMMARY ***
Total pot $26.81 | Rake $1.34 
Board [6h Kc 3c Kh 2d]
Seat 1: Mc57Arnold folded before Flop (didn't bet)
Seat 2: Leason22 folded before Flop (didn't bet)
Seat 3: se13giuum showed [Ad 8c] and lost with a pair of Kings
Seat 4: ssorinacho92 folded before Flop (didn't bet)
Seat 5: forestry800 (button) folded before Flop (didn't bet)
Seat 6: vipbor (small blind) folded before Flop
Seat 7: Freak380 (big blind) folded before Flop
Seat 8: SwimmingPooI showed [Qh Qc] and won ($25.47) with two pair, Kings and Queens
Seat 9: Lavitadi folded before Flop (didn't bet)



PokerStars Hand #228690532897:  Hold'em No Limit ($0.25/$0.50 USD) - 2021/07/30 17:39:52 ET
Table 'Bok II' 9-max Seat #6 is the button
Seat 1: Mc57Arnold ($56.46 in chips) 
Seat 2: Leason22 ($26.17 in chips) 
Seat 3: se13giuum ($49.74 in chips) 
Seat 4: ssorinacho92 ($96.26 in chips) 
Seat 5: forestry800 ($50 in chips) 
Seat 6: vipbor ($73.67 in chips) 
Seat 7: Freak380 ($45.60 in chips) 
Seat 8: SwimmingPooI ($77.38 in chips) 
Seat 9: Lavitadi ($45.31 in chips) 
Freak380: posts small blind $0.25
SwimmingPooI: posts big blind $0.50
*** HOLE CARDS ***
Lavitadi: folds 
Mc57Arnold: folds 
Leason22: folds 
se13giuum: folds 
ssorinacho92: folds 
forestry800: folds 
vipbor has timed out
vipbor: folds 
Freak380: calls $0.25
SwimmingPooI: checks 
*** FLOP *** [Jc 9s Qs]
Freak380: bets $0.50
SwimmingPooI: folds 
Uncalled bet ($0.50) returned to Freak380
Freak380 collected $0.94 from pot
*** SUMMARY ***
Total pot $1 | Rake $0.06 
Board [Jc 9s Qs]
Seat 1: Mc57Arnold folded before Flop (didn't bet)
Seat 2: Leason22 folded before Flop (didn't bet)
Seat 3: se13giuum folded before Flop (didn't bet)
Seat 4: ssorinacho92 folded before Flop (didn't bet)
Seat 5: forestry800 folded before Flop (didn't bet)
Seat 6: vipbor (button) folded before Flop (didn't bet)
Seat 7: Freak380 (small blind) collected ($0.94)
Seat 8: SwimmingPooI (big blind) folded on the Flop
Seat 9: Lavitadi folded before Flop (didn't bet)



PokerStars Hand #228690551645:  Hold'em No Limit ($0.25/$0.50 USD) - 2021/07/30 17:40:35 ET
Table 'Bok II' 9-max Seat #7 is the button
Seat 1: Mc57Arnold ($56.46 in chips) 
Seat 2: Leason22 ($26.17 in chips) 
Seat 3: se13giuum ($49.74 in chips) 
Seat 4: ssorinacho92 ($96.26 in chips) 
Seat 5: forestry800 ($50 in chips) 
Seat 6: vipbor ($73.67 in chips) 
Seat 7: Freak380 ($46.04 in chips) 
Seat 8: SwimmingPooI ($76.88 in chips) 
Seat 9: Lavitadi ($45.31 in chips) 
SwimmingPooI: posts small blind $0.25
Lavitadi: posts big blind $0.50
*** HOLE CARDS ***
Mc57Arnold: folds 
Leason22: folds 
se13giuum is disconnected 
se13giuum has timed out while disconnected
se13giuum: folds 
ssorinacho92: folds 
forestry800: raises $0.75 to $1.25
vipbor: folds 
Freak380: folds 
SwimmingPooI: folds 
Lavitadi: calls $0.75
*** FLOP *** [5s 7h Ad]
Lavitadi: checks 
forestry800: bets $0.84
Lavitadi: folds 
Uncalled bet ($0.84) returned to forestry800
forestry800 collected $2.61 from pot
forestry800: doesn't show hand 
*** SUMMARY ***
Total pot $2.75 | Rake $0.14 
Board [5s 7h Ad]
Seat 1: Mc57Arnold folded before Flop (didn't bet)
Seat 2: Leason22 folded before Flop (didn't bet)
Seat 3: se13giuum folded before Flop (didn't bet)
Seat 4: ssorinacho92 folded before Flop (didn't bet)
Seat 5: forestry800 collected ($2.61)
Seat 6: vipbor folded before Flop (didn't bet)
Seat 7: Freak380 (button) folded before Flop (didn't bet)
Seat 8: SwimmingPooI (small blind) folded before Flop
Seat 9: Lavitadi (big blind) folded on the Flop



PokerStars Hand #228690567756:  Hold'em No Limit ($0.25/$0.50 USD) - 2021/07/30 17:41:11 ET
Table 'Bok II' 9-max Seat #8 is the button
Seat 1: Mc57Arnold ($56.46 in chips) 
Seat 2: Leason22 ($26.17 in chips) 
Seat 4: ssorinacho92 ($96.26 in chips) 
Seat 5: forestry800 ($51.36 in chips) 
Seat 6: vipbor ($73.67 in chips) 
Seat 7: Freak380 ($46.04 in chips) 
Seat 8: SwimmingPooI ($76.63 in chips) 
Seat 9: Lavitadi ($44.06 in chips) 
Lavitadi: posts small blind $0.25
Mc57Arnold: posts big blind $0.50
*** HOLE CARDS ***
Leason22: folds 
ssorinacho92: raises $0.75 to $1.25
forestry800: folds 
vipbor: folds 
Freak380: folds 
SwimmingPooI: folds 
Lavitadi: folds 
Mc57Arnold: raises $3.75 to $5
ssorinacho92: folds 
Uncalled bet ($3.75) returned to Mc57Arnold
Mc57Arnold collected $2.75 from pot
Mc57Arnold: doesn't show hand 
*** SUMMARY ***
Total pot $2.75 | Rake $0 
Seat 1: Mc57Arnold (big blind) collected ($2.75)
Seat 2: Leason22 folded before Flop (didn't bet)
Seat 4: ssorinacho92 folded before Flop
Seat 5: forestry800 folded before Flop (didn't bet)
Seat 6: vipbor folded before Flop (didn't bet)
Seat 7: Freak380 folded before Flop (didn't bet)
Seat 8: SwimmingPooI (button) folded before Flop (didn't bet)
Seat 9: Lavitadi (small blind) folded before Flop



PokerStars Hand #228690589178:  Hold'em No Limit ($0.25/$0.50 USD) - 2021/07/30 17:41:59 ET
Table 'Bok II' 9-max Seat #9 is the button
Seat 1: Mc57Arnold ($57.96 in chips) 
Seat 2: Leason22 ($26.17 in chips) 
Seat 4: ssorinacho92 ($95.01 in chips) 
Seat 5: forestry800 ($51.36 in chips) 
Seat 6: vipbor ($73.67 in chips) 
Seat 7: Freak380 ($46.04 in chips) 
Seat 8: SwimmingPooI ($76.63 in chips) 
Seat 9: Lavitadi ($43.81 in chips) 
Mc57Arnold: posts small blind $0.25
Leason22: posts big blind $0.50
*** HOLE CARDS ***
ssorinacho92: folds 
forestry800: folds 
vipbor: folds 
Freak380: folds 
SwimmingPooI: raises $1 to $1.50
Lavitadi: folds 
Mc57Arnold: folds 
Leason22: folds 
Uncalled bet ($1) returned to SwimmingPooI
SwimmingPooI collected $1.25 from pot
SwimmingPooI: doesn't show hand 
*** SUMMARY ***
Total pot $1.25 | Rake $0 
Seat 1: Mc57Arnold (small blind) folded before Flop
Seat 2: Leason22 (big blind) folded before Flop
Seat 4: ssorinacho92 folded before Flop (didn't bet)
Seat 5: forestry800 folded before Flop (didn't bet)
Seat 6: vipbor folded before Flop (didn't bet)
Seat 7: Freak380 folded before Flop (didn't bet)
Seat 8: SwimmingPooI collected ($1.25)
Seat 9: Lavitadi (button) folded before Flop (didn't bet)



PokerStars Hand #228690597431:  Hold'em No Limit ($0.25/$0.50 USD) - 2021/07/30 17:42:18 ET
Table 'Bok II' 9-max Seat #1 is the button
Seat 1: Mc57Arnold ($57.71 in chips) 
Seat 2: Leason22 ($25.67 in chips) 
Seat 5: forestry800 ($51.36 in chips) 
Seat 6: vipbor ($73.67 in chips) 
Seat 7: Freak380 ($46.04 in chips) 
Seat 8: SwimmingPooI ($77.38 in chips) 
Seat 9: Lavitadi ($43.81 in chips) 
Leason22: posts small blind $0.25
ssorinacho92: is sitting out 
forestry800: posts big blind $0.50
*** HOLE CARDS ***
ssorinacho92 leaves the table
vipbor: folds 
Freak380: calls $0.50
SwimmingPooI: folds 
Lavitadi: folds 
Mc57Arnold: raises $1.50 to $2
Leason22: folds 
forestry800: folds 
Dragonclawss joins the table at seat #4 
Freak380: folds 
Uncalled bet ($1.50) returned to Mc57Arnold
Mc57Arnold collected $1.75 from pot
Mc57Arnold: doesn't show hand 
*** SUMMARY ***
Total pot $1.75 | Rake $0 
Seat 1: Mc57Arnold (button) collected ($1.75)
Seat 2: Leason22 (small blind) folded before Flop
Seat 5: forestry800 (big blind) folded before Flop
Seat 6: vipbor folded before Flop (didn't bet)
Seat 7: Freak380 folded before Flop
Seat 8: SwimmingPooI folded before Flop (didn't bet)
Seat 9: Lavitadi folded before Flop (didn't bet)



PokerStars Hand #228690610889:  Hold'em No Limit ($0.25/$0.50 USD) - 2021/07/30 17:42:48 ET
Table 'Bok II' 9-max Seat #2 is the button
Seat 1: Mc57Arnold ($58.96 in chips) 
Seat 2: Leason22 ($25.42 in chips) 
Seat 5: forestry800 ($50.86 in chips) 
Seat 6: vipbor ($73.67 in chips) 
Seat 7: Freak380 ($45.54 in chips) 
Seat 8: SwimmingPooI ($77.38 in chips) 
Seat 9: Lavitadi ($43.81 in chips) 
forestry800: posts small blind $0.25
vipbor: posts big blind $0.50
*** HOLE CARDS ***
Freak380: raises $1 to $1.50
SwimmingPooI: folds 
Lavitadi: folds 
Mc57Arnold: folds 
Leason22: calls $1.50
forestry800: folds 
vipbor: folds 
*** FLOP *** [Kh Js 4d]
Freak380: bets $2
Leason22: folds 
Uncalled bet ($2) returned to Freak380
Freak380 collected $3.51 from pot
*** SUMMARY ***
Total pot $3.75 | Rake $0.24 
Board [Kh Js 4d]
Seat 1: Mc57Arnold folded before Flop (didn't bet)
Seat 2: Leason22 (button) folded on the Flop
Seat 5: forestry800 (small blind) folded before Flop
Seat 6: vipbor (big blind) folded before Flop
Seat 7: Freak380 collected ($3.51)
Seat 8: SwimmingPooI folded before Flop (didn't bet)
Seat 9: Lavitadi folded before Flop (didn't bet)



PokerStars Hand #228690622243:  Hold'em No Limit ($0.25/$0.50 USD) - 2021/07/30 17:43:14 ET
Table 'Bok II' 9-max Seat #5 is the button
Seat 1: Mc57Arnold ($58.96 in chips) 
Seat 2: Leason22 ($23.92 in chips) 
Seat 5: forestry800 ($50.61 in chips) 
Seat 6: vipbor ($73.17 in chips) 
Seat 7: Freak380 ($47.55 in chips) 
Seat 8: SwimmingPooI ($77.38 in chips) 
Seat 9: Lavitadi ($43.81 in chips) 
vipbor: posts small blind $0.25
Freak380: posts big blind $0.50
Dragonclawss: sits out 
*** HOLE CARDS ***
SwimmingPooI: folds 
Lavitadi: folds 
Mc57Arnold: folds 
Leason22: folds 
forestry800: folds 
vipbor: folds 
Uncalled bet ($0.25) returned to Freak380
Freak380 collected $0.50 from pot
*** SUMMARY ***
Total pot $0.50 | Rake $0 
Seat 1: Mc57Arnold folded before Flop (didn't bet)
Seat 2: Leason22 folded before Flop (didn't bet)
Seat 5: forestry800 (button) folded before Flop (didn't bet)
Seat 6: vipbor (small blind) folded before Flop
Seat 7: Freak380 (big blind) collected ($0.50)
Seat 8: SwimmingPooI folded before Flop (didn't bet)
Seat 9: Lavitadi folded before Flop (didn't bet)



PokerStars Hand #228690630200:  Hold'em No Limit ($0.25/$0.50 USD) - 2021/07/30 17:43:32 ET
Table 'Bok II' 9-max Seat #6 is the button
Seat 1: Mc57Arnold ($58.96 in chips) 
Seat 2: Leason22 ($23.92 in chips) 
Seat 5: forestry800 ($50.61 in chips) 
Seat 6: vipbor ($72.92 in chips) 
Seat 7: Freak380 ($47.80 in chips) 
Seat 8: SwimmingPooI ($77.38 in chips) 
Seat 9: Lavitadi ($43.81 in chips) 
Freak380: posts small blind $0.25
SwimmingPooI: posts big blind $0.50
Dragonclawss: sits out 
*** HOLE CARDS ***
Lavitadi: folds 
Mc57Arnold: folds 
Leason22: folds 
forestry800: raises $0.75 to $1.25
vipbor: folds 
Freak380: calls $1
SwimmingPooI: folds 
*** FLOP *** [Ts Th Td]
Freak380: checks 
forestry800: bets $0.91
Freak380: folds 
Uncalled bet ($0.91) returned to forestry800
forestry800 collected $2.85 from pot
forestry800: doesn't show hand 
*** SUMMARY ***
Total pot $3 | Rake $0.15 
Board [Ts Th Td]
Seat 1: Mc57Arnold folded before Flop (didn't bet)
Seat 2: Leason22 folded before Flop (didn't bet)
Seat 5: forestry800 collected ($2.85)
Seat 6: vipbor (button) folded before Flop (didn't bet)
Seat 7: Freak380 (small blind) folded on the Flop
Seat 8: SwimmingPooI (big blind) folded before Flop
Seat 9: Lavitadi folded before Flop (didn't bet)



PokerStars Hand #228690648405:  Hold'em No Limit ($0.25/$0.50 USD) - 2021/07/30 17:44:14 ET
Table 'Bok II' 9-max Seat #7 is the button
Seat 1: Mc57Arnold ($58.96 in chips) 
Seat 2: Leason22 ($23.92 in chips) 
Seat 5: forestry800 ($52.21 in chips) 
Seat 6: vipbor ($72.92 in chips) 
Seat 7: Freak380 ($46.55 in chips) 
Seat 8: SwimmingPooI ($76.88 in chips) 
Seat 9: Lavitadi ($43.81 in chips) 
SwimmingPooI: posts small blind $0.25
Lavitadi: posts big blind $0.50
Dragonclawss: sits out 
*** HOLE CARDS ***
Mc57Arnold: folds 
Leason22: folds 
forestry800: folds 
vipbor: folds 
Freak380: raises $1 to $1.50
SwimmingPooI: folds 
Lavitadi: folds 
Uncalled bet ($1) returned to Freak380
Freak380 collected $1.25 from pot
*** SUMMARY ***
Total pot $1.25 | Rake $0 
Seat 1: Mc57Arnold folded before Flop (didn't bet)
Seat 2: Leason22 folded before Flop (didn't bet)
Seat 5: forestry800 folded before Flop (didn't bet)
Seat 6: vipbor folded before Flop (didn't bet)
Seat 7: Freak380 (button) collected ($1.25)
Seat 8: SwimmingPooI (small blind) folded before Flop
Seat 9: Lavitadi (big blind) folded before Flop



PokerStars Hand #228690662552:  Hold'em No Limit ($0.25/$0.50 USD) - 2021/07/30 17:44:46 ET
Table 'Bok II' 9-max Seat #8 is the button
Seat 1: Mc57Arnold ($58.96 in chips) 
Seat 2: Leason22 ($23.92 in chips) 
Seat 5: forestry800 ($52.21 in chips) 
Seat 6: vipbor ($72.92 in chips) 
Seat 7: Freak380 ($47.30 in chips) 
Seat 8: SwimmingPooI ($76.63 in chips) 
Seat 9: Lavitadi ($43.31 in chips) 
Lavitadi: posts small blind $0.25
Mc57Arnold: posts big blind $0.50
Dragonclawss: sits out 
*** HOLE CARDS ***
Leason22: folds 
forestry800: folds 
vipbor: raises $0.75 to $1.25
Freak380: folds 
SwimmingPooI: folds 
Lavitadi: folds 
Mc57Arnold: folds 
Uncalled bet ($0.75) returned to vipbor
vipbor collected $1.25 from pot
*** SUMMARY ***
Total pot $1.25 | Rake $0 
Seat 1: Mc57Arnold (big blind) folded before Flop
Seat 2: Leason22 folded before Flop (didn't bet)
Seat 5: forestry800 folded before Flop (didn't bet)
Seat 6: vipbor collected ($1.25)
Seat 7: Freak380 folded before Flop (didn't bet)
Seat 8: SwimmingPooI (button) folded before Flop (didn't bet)
Seat 9: Lavitadi (small blind) folded before Flop



PokerStars Hand #228690671848:  Hold'em No Limit ($0.25/$0.50 USD) - 2021/07/30 17:45:07 ET
Table 'Bok II' 9-max Seat #9 is the button
Seat 1: Mc57Arnold ($58.46 in chips) 
Seat 2: Leason22 ($23.92 in chips) 
Seat 5: forestry800 ($52.21 in chips) 
Seat 6: vipbor ($73.67 in chips) 
Seat 7: Freak380 ($47.30 in chips) 
Seat 8: SwimmingPooI ($76.63 in chips) 
Seat 9: Lavitadi ($43.06 in chips) 
Mc57Arnold: posts small blind $0.25
Leason22: posts big blind $0.50
Dragonclawss: sits out 
*** HOLE CARDS ***
forestry800: folds 
vipbor: folds 
Freak380: folds 
SwimmingPooI: folds 
Lavitadi: raises $1.25 to $1.75
Mc57Arnold: folds 
Leason22: folds 
Uncalled bet ($1.25) returned to Lavitadi
Lavitadi collected $1.25 from pot
Lavitadi: doesn't show hand 
*** SUMMARY ***
Total pot $1.25 | Rake $0 
Seat 1: Mc57Arnold (small blind) folded before Flop
Seat 2: Leason22 (big blind) folded before Flop
Seat 5: forestry800 folded before Flop (didn't bet)
Seat 6: vipbor folded before Flop (didn't bet)
Seat 7: Freak380 folded before Flop (didn't bet)
Seat 8: SwimmingPooI folded before Flop (didn't bet)
Seat 9: Lavitadi (button) collected ($1.25)



PokerStars Hand #228690682316:  Hold'em No Limit ($0.25/$0.50 USD) - 2021/07/30 17:45:32 ET
Table 'Bok II' 9-max Seat #1 is the button
Seat 1: Mc57Arnold ($58.21 in chips) 
Seat 2: Leason22 ($23.42 in chips) 
Seat 4: Dragonclawss ($50 in chips) 
Seat 5: forestry800 ($52.21 in chips) 
Seat 6: vipbor ($73.67 in chips) 
Seat 7: Freak380 ($47.30 in chips) 
Seat 8: SwimmingPooI ($76.63 in chips) 
Seat 9: Lavitadi ($43.81 in chips) 
Leason22: posts small blind $0.25
Dragonclawss: posts big blind $0.50
*** HOLE CARDS ***
forestry800: folds 
vipbor: folds 
Freak380: calls $0.50
SwimmingPooI: folds 
Lavitadi: folds 
Mc57Arnold: raises $1.50 to $2
Leason22: calls $1.75
Dragonclawss: folds 
SwimmingPooI was removed from the table for failing to post
SwimmingPooI leaves the table
Freak380: calls $1.50
*** FLOP *** [3c 3h Kd]
Leason22: checks 
Freak380: bets $3.50
Mc57Arnold: folds 
Heath Tema joins the table at seat #8 
Leason22: calls $3.50
*** TURN *** [3c 3h Kd] [Ah]
Leason22: checks 
Freak380: bets $5
Leason22: raises $5 to $10
Freak380: folds 
Uncalled bet ($5) returned to Leason22
Leason22 collected $22.02 from pot
*** SUMMARY ***
Total pot $23.50 | Rake $1.48 
Board [3c 3h Kd Ah]
Seat 1: Mc57Arnold (button) folded on the Flop
Seat 2: Leason22 (small blind) collected ($22.02)
Seat 4: Dragonclawss (big blind) folded before Flop
Seat 5: forestry800 folded before Flop (didn't bet)
Seat 6: vipbor folded before Flop (didn't bet)
Seat 7: Freak380 folded on the Turn
Seat 8: SwimmingPooI folded before Flop (didn't bet)
Seat 9: Lavitadi folded before Flop (didn't bet)



PokerStars Hand #228690711866:  Hold'em No Limit ($0.25/$0.50 USD) - 2021/07/30 17:46:39 ET
Table 'Bok II' 9-max Seat #2 is the button
Seat 1: Mc57Arnold ($56.21 in chips) 
Seat 2: Leason22 ($34.94 in chips) 
Seat 4: Dragonclawss ($50 in chips) 
Seat 5: forestry800 ($52.21 in chips) 
Seat 6: vipbor ($73.67 in chips) 
Seat 7: Freak380 ($36.80 in chips) 
Seat 8: Heath Tema ($29.97 in chips) 
Seat 9: Lavitadi ($43.81 in chips) 
Dragonclawss: posts small blind $0.25
forestry800: posts big blind $0.50
Heath Tema: posts big blind $0.50
*** HOLE CARDS ***
vipbor: folds 
Freak380: folds 
Heath Tema: checks 
Lavitadi has timed out
Lavitadi: folds 
Mc57Arnold: folds 
Leason22: folds 
Dragonclawss: folds 
forestry800: raises $2 to $2.50
Heath Tema: calls $2
*** FLOP *** [5s 2s 2h]
forestry800: checks 
Heath Tema: checks 
*** TURN *** [5s 2s 2h] [Td]
forestry800: checks 
Heath Tema: checks 
*** RIVER *** [5s 2s 2h Td] [Jd]
forestry800: checks 
Heath Tema: checks 
*** SHOW DOWN ***
forestry800: shows [6d Ad] (a pair of Deuces)
Heath Tema: shows [Jh 9h] (two pair, Jacks and Deuces)
Heath Tema collected $4.99 from pot
*** SUMMARY ***
Total pot $5.25 | Rake $0.26 
Board [5s 2s 2h Td Jd]
Seat 1: Mc57Arnold folded before Flop (didn't bet)
Seat 2: Leason22 (button) folded before Flop (didn't bet)
Seat 4: Dragonclawss (small blind) folded before Flop
Seat 5: forestry800 (big blind) showed [6d Ad] and lost with a pair of Deuces
Seat 6: vipbor folded before Flop (didn't bet)
Seat 7: Freak380 folded before Flop (didn't bet)
Seat 8: Heath Tema showed [Jh 9h] and won ($4.99) with two pair, Jacks and Deuces
Seat 9: Lavitadi folded before Flop (didn't bet)



PokerStars Hand #228690732360:  Hold'em No Limit ($0.25/$0.50 USD) - 2021/07/30 17:47:27 ET
Table 'Bok II' 9-max Seat #4 is the button
Seat 1: Mc57Arnold ($56.21 in chips) 
Seat 2: Leason22 ($34.94 in chips) 
Seat 4: Dragonclawss ($50 in chips) 
Seat 5: forestry800 ($50 in chips) 
Seat 6: vipbor ($73.67 in chips) 
Seat 7: Freak380 ($36.80 in chips) 
Seat 8: Heath Tema ($32.46 in chips) 
forestry800: posts small blind $0.25
vipbor: posts big blind $0.50
*** HOLE CARDS ***
Freak380: raises $0.50 to $1
Heath Tema: folds 
Mc57Arnold: folds 
Leason22: folds 
Dragonclawss: calls $1
forestry800: folds 
vipbor: folds 
*** FLOP *** [5d 6c Qh]
Freak380: bets $1.50
Dragonclawss: folds 
Uncalled bet ($1.50) returned to Freak380
Freak380 collected $2.57 from pot
*** SUMMARY ***
Total pot $2.75 | Rake $0.18 
Board [5d 6c Qh]
Seat 1: Mc57Arnold folded before Flop (didn't bet)
Seat 2: Leason22 folded before Flop (didn't bet)
Seat 4: Dragonclawss (button) folded on the Flop
Seat 5: forestry800 (small blind) folded before Flop
Seat 6: vipbor (big blind) folded before Flop
Seat 7: Freak380 collected ($2.57)
Seat 8: Heath Tema folded before Flop (didn't bet)



PokerStars Hand #228690749279:  Hold'em No Limit ($0.25/$0.50 USD) - 2021/07/30 17:48:06 ET
Table 'Bok II' 9-max Seat #5 is the button
Seat 1: Mc57Arnold ($56.21 in chips) 
Seat 2: Leason22 ($34.94 in chips) 
Seat 4: Dragonclawss ($50 in chips) 
Seat 5: forestry800 ($50 in chips) 
Seat 6: vipbor ($73.17 in chips) 
Seat 7: Freak380 ($38.37 in chips) 
Seat 8: Heath Tema ($32.46 in chips) 
Seat 9: Lavitadi ($43.81 in chips) 
vipbor: posts small blind $0.25
Freak380: posts big blind $0.50
*** HOLE CARDS ***
Heath Tema: calls $0.50
Lavitadi: folds 
Mc57Arnold: folds 
Leason22: folds 
Dragonclawss: folds 
forestry800: folds 
vipbor: folds 
Freak380: raises $1 to $1.50
Heath Tema: raises $30.96 to $32.46 and is all-in
Freak380: folds 
Uncalled bet ($30.96) returned to Heath Tema
Heath Tema collected $3.25 from pot
Heath Tema: doesn't show hand 
*** SUMMARY ***
Total pot $3.25 | Rake $0 
Seat 1: Mc57Arnold folded before Flop (didn't bet)
Seat 2: Leason22 folded before Flop (didn't bet)
Seat 4: Dragonclawss folded before Flop (didn't bet)
Seat 5: forestry800 (button) folded before Flop (didn't bet)
Seat 6: vipbor (small blind) folded before Flop
Seat 7: Freak380 (big blind) folded before Flop
Seat 8: Heath Tema collected ($3.25)
Seat 9: Lavitadi folded before Flop (didn't bet)



PokerStars Hand #228690763343:  Hold'em No Limit ($0.25/$0.50 USD) - 2021/07/30 17:48:39 ET
Table 'Bok II' 9-max Seat #6 is the button
Seat 1: Mc57Arnold ($56.21 in chips) 
Seat 2: Leason22 ($34.94 in chips) 
Seat 4: Dragonclawss ($50 in chips) 
Seat 5: forestry800 ($50 in chips) 
Seat 6: vipbor ($72.92 in chips) 
Seat 7: Freak380 ($36.87 in chips) 
Seat 8: Heath Tema ($34.21 in chips) 
Seat 9: Lavitadi ($43.81 in chips) 
Freak380: posts small blind $0.25
Heath Tema: posts big blind $0.50
*** HOLE CARDS ***
Lavitadi: folds 
Mc57Arnold: folds 
Leason22: folds 
Dragonclawss: raises $1 to $1.50
forestry800: folds 
vipbor: folds 
Freak380: folds 
Heath Tema: folds 
Uncalled bet ($1) returned to Dragonclawss
Dragonclawss collected $1.25 from pot
Dragonclawss: doesn't show hand 
*** SUMMARY ***
Total pot $1.25 | Rake $0 
Seat 1: Mc57Arnold folded before Flop (didn't bet)
Seat 2: Leason22 folded before Flop (didn't bet)
Seat 4: Dragonclawss collected ($1.25)
Seat 5: forestry800 folded before Flop (didn't bet)
Seat 6: vipbor (button) folded before Flop (didn't bet)
Seat 7: Freak380 (small blind) folded before Flop
Seat 8: Heath Tema (big blind) folded before Flop
Seat 9: Lavitadi folded before Flop (didn't bet)



PokerStars Hand #228690772020:  Hold'em No Limit ($0.25/$0.50 USD) - 2021/07/30 17:49:00 ET
Table 'Bok II' 9-max Seat #7 is the button
Seat 1: Mc57Arnold ($56.21 in chips) 
Seat 2: Leason22 ($34.94 in chips) 
Seat 4: Dragonclawss ($50.75 in chips) 
Seat 5: forestry800 ($50 in chips) 
Seat 6: vipbor ($72.92 in chips) 
Seat 7: Freak380 ($36.62 in chips) 
Seat 8: Heath Tema ($33.71 in chips) 
Seat 9: Lavitadi ($43.81 in chips) 
Heath Tema: posts small blind $0.25
Lavitadi: posts big blind $0.50
*** HOLE CARDS ***
Mc57Arnold: folds 
Leason22: folds 
Dragonclawss: folds 
forestry800: folds 
vipbor: folds 
Freak380: raises $1 to $1.50
Heath Tema: calls $1.25
Lavitadi: folds 
*** FLOP *** [Qs 9d 2s]
Heath Tema: checks 
Freak380: bets $2
Heath Tema: calls $2
*** TURN *** [Qs 9d 2s] [4h]
Heath Tema: checks 
Freak380: bets $4
Heath Tema: raises $7.56 to $11.56
Freak380: calls $7.56
*** RIVER *** [Qs 9d 2s 4h] [7d]
Heath Tema: bets $18.65 and is all-in
Freak380: calls $18.65
*** SHOW DOWN ***
Heath Tema: shows [Jh As] (high card Ace)
Freak380: shows [4c 4s] (three of a kind, Fours)
Freak380 collected $65.42 from pot
*** SUMMARY ***
Total pot $67.92 | Rake $2.50 
Board [Qs 9d 2s 4h 7d]
Seat 1: Mc57Arnold folded before Flop (didn't bet)
Seat 2: Leason22 folded before Flop (didn't bet)
Seat 4: Dragonclawss folded before Flop (didn't bet)
Seat 5: forestry800 folded before Flop (didn't bet)
Seat 6: vipbor folded before Flop (didn't bet)
Seat 7: Freak380 (button) showed [4c 4s] and won ($65.42) with three of a kind, Fours
Seat 8: Heath Tema (small blind) showed [Jh As] and lost with high card Ace
Seat 9: Lavitadi (big blind) folded before Flop



PokerStars Hand #228690796415:  Hold'em No Limit ($0.25/$0.50 USD) - 2021/07/30 17:49:57 ET
Table 'Bok II' 9-max Seat #9 is the button
Seat 1: Mc57Arnold ($56.21 in chips) 
Seat 2: Leason22 ($34.94 in chips) 
Seat 4: Dragonclawss ($50.75 in chips) 
Seat 5: forestry800 ($50 in chips) 
Seat 6: vipbor ($72.92 in chips) 
Seat 7: Freak380 ($68.33 in chips) 
Seat 9: Lavitadi ($43.31 in chips) 
Mc57Arnold: posts small blind $0.25
Leason22: posts big blind $0.50
*** HOLE CARDS ***
Dragonclawss: folds 
forestry800: raises $0.75 to $1.25
vipbor: folds 
Freak380: folds 
Lavitadi: folds 
Heath Tema leaves the table
Mc57Arnold: folds 
Leason22: calls $0.75
*** FLOP *** [2h 2d 4d]
Leason22: checks 
forestry800: bets $0.84
Leason22: folds 
Uncalled bet ($0.84) returned to forestry800
SwimmingPooI joins the table at seat #8 
forestry800 collected $2.61 from pot
forestry800: doesn't show hand 
*** SUMMARY ***
Total pot $2.75 | Rake $0.14 
Board [2h 2d 4d]
Seat 1: Mc57Arnold (small blind) folded before Flop
Seat 2: Leason22 (big blind) folded on the Flop
Seat 4: Dragonclawss folded before Flop (didn't bet)
Seat 5: forestry800 collected ($2.61)
Seat 6: vipbor folded before Flop (didn't bet)
Seat 7: Freak380 folded before Flop (didn't bet)
Seat 9: Lavitadi (button) folded before Flop (didn't bet)



PokerStars Hand #228690810506:  Hold'em No Limit ($0.25/$0.50 USD) - 2021/07/30 17:50:30 ET
Table 'Bok II' 9-max Seat #1 is the button
Seat 1: Mc57Arnold ($55.96 in chips) 
Seat 2: Leason22 ($33.69 in chips) 
Seat 4: Dragonclawss ($50.75 in chips) 
Seat 5: forestry800 ($51.36 in chips) 
Seat 6: vipbor ($72.92 in chips) 
Seat 7: Freak380 ($68.33 in chips) 
Seat 9: Lavitadi ($43.31 in chips) 
Leason22: posts small blind $0.25
Dragonclawss: posts big blind $0.50
SwimmingPooI: sits out 
*** HOLE CARDS ***
forestry800: folds 
vipbor: raises $0.75 to $1.25
Freak380: calls $1.25
SwimmingPooI leaves the table
Lavitadi: folds 
Mc57Arnold: folds 
Leason22: calls $1
Dragonclawss: folds 
*** FLOP *** [2d 7s 5h]
Leason22: checks 
se13giuum was removed from the table for failing to post
se13giuum leaves the table
dstrola joins the table at seat #8 
vipbor: checks 
Freak380: checks 
*** TURN *** [2d 7s 5h] [Jh]
Leason22: bets $2.50
vipbor: folds 
Freak380: calls $2.50
*** RIVER *** [2d 7s 5h Jh] [2h]
Leason22: checks 
Freak380: bets $3.75
Leason22: calls $3.75
*** SHOW DOWN ***
Freak380: shows [Qh Jc] (two pair, Jacks and Deuces)
Leason22: mucks hand 
Freak380 collected $15.70 from pot
*** SUMMARY ***
Total pot $16.75 | Rake $1.05 
Board [2d 7s 5h Jh 2h]
Seat 1: Mc57Arnold (button) folded before Flop (didn't bet)
Seat 2: Leason22 (small blind) mucked
Seat 4: Dragonclawss (big blind) folded before Flop
Seat 5: forestry800 folded before Flop (didn't bet)
Seat 6: vipbor folded on the Turn
Seat 7: Freak380 showed [Qh Jc] and won ($15.70) with two pair, Jacks and Deuces
Seat 9: Lavitadi folded before Flop (didn't bet)



PokerStars Hand #228690832567:  Hold'em No Limit ($0.25/$0.50 USD) - 2021/07/30 17:51:22 ET
Table 'Bok II' 9-max Seat #2 is the button
Seat 1: Mc57Arnold ($55.96 in chips) 
Seat 2: Leason22 ($26.19 in chips) 
Seat 4: Dragonclawss ($50.25 in chips) 
Seat 5: forestry800 ($51.36 in chips) 
Seat 6: vipbor ($71.67 in chips) 
Seat 7: Freak380 ($76.53 in chips) 
Seat 9: Lavitadi ($43.31 in chips) 
Dragonclawss: posts small blind $0.25
forestry800: posts big blind $0.50
dstrola: sits out 
*** HOLE CARDS ***
vipbor: folds 
gvidator joins the table at seat #3 
Freak380: folds 
Lavitadi: folds 
Mc57Arnold: folds 
Leason22: raises $0.50 to $1
Dragonclawss: folds 
forestry800: calls $0.50
*** FLOP *** [4h 9d Ts]
Lavitadi leaves the table
forestry800: checks 
Leason22: bets $1.50
forestry800: calls $1.50
*** TURN *** [4h 9d Ts] [2c]
forestry800: checks 
Leason22: checks 
*** RIVER *** [4h 9d Ts 2c] [As]
forestry800: checks 
Leason22: checks 
*** SHOW DOWN ***
forestry800: shows [Td Qc] (a pair of Tens)
Leason22: mucks hand 
forestry800 collected $4.99 from pot
Seduisant365 joins the table at seat #9 
*** SUMMARY ***
Total pot $5.25 | Rake $0.26 
Board [4h 9d Ts 2c As]
Seat 1: Mc57Arnold folded before Flop (didn't bet)
Seat 2: Leason22 (button) mucked
Seat 4: Dragonclawss (small blind) folded before Flop
Seat 5: forestry800 (big blind) showed [Td Qc] and won ($4.99) with a pair of Tens
Seat 6: vipbor folded before Flop (didn't bet)
Seat 7: Freak380 folded before Flop (didn't bet)
Seat 9: Lavitadi folded before Flop (didn't bet)



PokerStars Hand #228690855772:  Hold'em No Limit ($0.25/$0.50 USD) - 2021/07/30 17:52:09 ET
Table 'Bok II' 9-max Seat #4 is the button
Seat 1: Mc57Arnold ($55.96 in chips) 
Seat 2: Leason22 ($23.69 in chips) 
Seat 3: gvidator ($33.90 in chips) 
Seat 4: Dragonclawss ($50 in chips) 
Seat 5: forestry800 ($53.85 in chips) 
Seat 6: vipbor ($71.67 in chips) 
Seat 7: Freak380 ($76.53 in chips) 
forestry800: posts small blind $0.25
vipbor: posts big blind $0.50
dstrola: sits out 
Seduisant365: sits out 
gvidator: posts big blind $0.50
*** HOLE CARDS ***
Freak380: folds 
Mc57Arnold: folds 
Leason22: raises $0.50 to $1
gvidator: folds 
Dragonclawss: folds 
forestry800: folds 
vipbor: calls $0.50
*** FLOP *** [Td 7d Tc]
vipbor: checks 
Leason22: bets $1.50
vipbor: calls $1.50
*** TURN *** [Td 7d Tc] [4c]
vipbor: checks 
Leason22: checks 
*** RIVER *** [Td 7d Tc 4c] [9d]
vipbor: checks 
Leason22: checks 
*** SHOW DOWN ***
vipbor: shows [8s 8d] (two pair, Tens and Eights)
Leason22: mucks hand 
vipbor collected $5.46 from pot
*** SUMMARY ***
Total pot $5.75 | Rake $0.29 
Board [Td 7d Tc 4c 9d]
Seat 1: Mc57Arnold folded before Flop (didn't bet)
Seat 2: Leason22 mucked
Seat 3: gvidator folded before Flop (didn't bet)
Seat 4: Dragonclawss (button) folded before Flop (didn't bet)
Seat 5: forestry800 (small blind) folded before Flop
Seat 6: vipbor (big blind) showed [8s 8d] and won ($5.46) with two pair, Tens and Eights
Seat 7: Freak380 folded before Flop (didn't bet)



PokerStars Hand #228690960025:  Hold'em No Limit ($0.25/$0.50 USD) - 2021/07/30 17:56:32 ET
Table 'Bok II' 9-max Seat #8 is the button
Seat 1: Mc57Arnold ($50 in chips) 
Seat 2: Leason22 ($42.25 in chips) 
Seat 3: gvidator ($23.90 in chips) 
Seat 4: Dragonclawss ($50 in chips) 
Seat 5: forestry800 ($53.60 in chips) 
Seat 6: vipbor ($69.38 in chips) 
Seat 7: Freak380 ($75.78 in chips) 
Seat 8: dstrola ($50 in chips) 
Seat 9: Seduisant365 ($54.74 in chips) 
Seduisant365: posts small blind $0.25
Mc57Arnold: posts big blind $0.50
*** HOLE CARDS ***
Leason22: folds 
gvidator: folds 
Dragonclawss: raises $0.75 to $1.25
forestry800: folds 
vipbor: folds 
Leason22 leaves the table
Freak380: calls $1.25
dstrola: calls $1.25
Seduisant365: folds 
Mc57Arnold: folds 
*** FLOP *** [8c Qd 2h]
Dragonclawss: checks 
Freak380: checks 
dstrola: checks 
*** TURN *** [8c Qd 2h] [7h]
Dragonclawss: checks 
Freak380: checks 
dstrola: bets $3
Dragonclawss: folds 
Freak380: folds 
Uncalled bet ($3) returned to dstrola
dstrola collected $4.28 from pot
*** SUMMARY ***
Total pot $4.50 | Rake $0.22 
Board [8c Qd 2h 7h]
Seat 1: Mc57Arnold (big blind) folded before Flop
Seat 2: Leason22 folded before Flop (didn't bet)
Seat 3: gvidator folded before Flop (didn't bet)
Seat 4: Dragonclawss folded on the Turn
Seat 5: forestry800 folded before Flop (didn't bet)
Seat 6: vipbor folded before Flop (didn't bet)
Seat 7: Freak380 folded on the Turn
Seat 8: dstrola (button) collected ($4.28)
Seat 9: Seduisant365 (small blind) folded before Flop



PokerStars Hand #228690980194:  Hold'em No Limit ($0.25/$0.50 USD) - 2021/07/30 17:57:34 ET
Table 'Bok II' 9-max Seat #9 is the button
Seat 1: Mc57Arnold ($50 in chips) 
Seat 3: gvidator ($23.90 in chips) 
Seat 4: Dragonclawss ($50 in chips) 
Seat 5: forestry800 ($53.60 in chips) 
Seat 6: vipbor ($69.38 in chips) 
Seat 7: Freak380 ($74.53 in chips) 
Seat 8: dstrola ($53.03 in chips) 
Seat 9: Seduisant365 ($54.49 in chips) 
Mc57Arnold: posts small blind $0.25
gvidator: posts big blind $0.50
*** HOLE CARDS ***
Dragonclawss: folds 
forestry800: folds 
vipbor: folds 
Freak380: folds 
dstrola: folds 
dikanmax joins the table at seat #2 
Seduisant365: raises $0.75 to $1.25
Mc57Arnold: folds 
gvidator: folds 
Uncalled bet ($0.75) returned to Seduisant365
Seduisant365 collected $1.25 from pot
Seduisant365: doesn't show hand 
*** SUMMARY ***
Total pot $1.25 | Rake $0 
Seat 1: Mc57Arnold (small blind) folded before Flop
Seat 3: gvidator (big blind) folded before Flop
Seat 4: Dragonclawss folded before Flop (didn't bet)
Seat 5: forestry800 folded before Flop (didn't bet)
Seat 6: vipbor folded before Flop (didn't bet)
Seat 7: Freak380 folded before Flop (didn't bet)
Seat 8: dstrola folded before Flop (didn't bet)
Seat 9: Seduisant365 (button) collected ($1.25)



PokerStars Hand #228691000002:  Hold'em No Limit ($0.25/$0.50 USD) - 2021/07/30 17:57:49 ET
Table 'Bok II' 9-max Seat #1 is the button
Seat 1: Mc57Arnold ($50 in chips) 
Seat 3: gvidator ($23.40 in chips) 
Seat 5: forestry800 ($53.60 in chips) 
Seat 6: vipbor ($69.38 in chips) 
Seat 7: Freak380 ($74.53 in chips) 
Seat 8: dstrola ($53.03 in chips) 
Seat 9: Seduisant365 ($55.24 in chips) 
gvidator: posts small blind $0.25
forestry800: posts big blind $0.50
*** HOLE CARDS ***
vipbor: folds 
Freak380: folds 
dstrola: folds 
Seduisant365: folds 
Mc57Arnold: raises $0.65 to $1.15
gvidator: calls $0.90
forestry800: calls $0.65
*** FLOP *** [Td Js Ah]
gvidator: bets $1.50
forestry800: calls $1.50
Mc57Arnold: calls $1.50
*** TURN *** [Td Js Ah] [5d]
gvidator: checks 
forestry800: bets $5.66
Mc57Arnold: folds 
gvidator: calls $5.66
*** RIVER *** [Td Js Ah 5d] [8s]
gvidator: bets $15.09 and is all-in
forestry800: calls $15.09
*** SHOW DOWN ***
gvidator: shows [8d 9h] (a pair of Eights)
forestry800: shows [Qh Kd] (a straight, Ten to Ace)
forestry800 collected $47.45 from pot
*** SUMMARY ***
Total pot $49.45 | Rake $2 
Board [Td Js Ah 5d 8s]
Seat 1: Mc57Arnold (button) folded on the Turn
Seat 3: gvidator (small blind) showed [8d 9h] and lost with a pair of Eights
Seat 5: forestry800 (big blind) showed [Qh Kd] and won ($47.45) with a straight, Ten to Ace
Seat 6: vipbor folded before Flop (didn't bet)
Seat 7: Freak380 folded before Flop (didn't bet)
Seat 8: dstrola folded before Flop (didn't bet)
Seat 9: Seduisant365 folded before Flop (didn't bet)



PokerStars Hand #228691024671:  Hold'em No Limit ($0.25/$0.50 USD) - 2021/07/30 17:59:05 ET
Table 'Bok II' 9-max Seat #5 is the button
Seat 1: Mc57Arnold ($50 in chips) 
Seat 5: forestry800 ($77.65 in chips) 
Seat 6: vipbor ($69.38 in chips) 
Seat 7: Freak380 ($74.53 in chips) 
Seat 8: dstrola ($53.03 in chips) 
Seat 9: Seduisant365 ($55.24 in chips) 
vipbor: posts small blind $0.25
Freak380: posts big blind $0.50
dikanmax: sits out 
*** HOLE CARDS ***
dstrola has timed out
dstrola: folds 
Seduisant365: folds 
Mc57Arnold: raises $0.85 to $1.35
forestry800: folds 
vipbor: folds 
Freak380: folds 
Uncalled bet ($0.85) returned to Mc57Arnold
Mc57Arnold collected $1.25 from pot
Mc57Arnold: doesn't show hand 
*** SUMMARY ***
Total pot $1.25 | Rake $0 
Seat 1: Mc57Arnold collected ($1.25)
Seat 5: forestry800 (button) folded before Flop (didn't bet)
Seat 6: vipbor (small blind) folded before Flop
Seat 7: Freak380 (big blind) folded before Flop
Seat 8: dstrola folded before Flop (didn't bet)
Seat 9: Seduisant365 folded before Flop (didn't bet)



PokerStars Hand #228691033032:  Hold'em No Limit ($0.25/$0.50 USD) - 2021/07/30 17:59:30 ET
Table 'Bok II' 9-max Seat #6 is the button
Seat 1: Mc57Arnold ($50.75 in chips) 
Seat 5: forestry800 ($77.65 in chips) 
Seat 6: vipbor ($69.13 in chips) 
Seat 7: Freak380 ($74.03 in chips) 
Freak380: posts small blind $0.25
Seduisant365: is sitting out 
Mc57Arnold: posts big blind $0.50
Seduisant365 leaves the table
dikanmax: sits out 
*** HOLE CARDS ***
An1an1 joins the table at seat #9 
forestry800: folds 
Dragonclawss leaves the table
vipbor: raises $0.75 to $1.25
Freak380: calls $1
Mc57Arnold: folds 
*** FLOP *** [Ts 3s 2d]
Freak380: bets $1.50
vipbor: calls $1.50
*** TURN *** [Ts 3s 2d] [5c]
Freak380: bets $3
Infinities4 joins the table at seat #4 
vipbor: calls $3
*** RIVER *** [Ts 3s 2d 5c] [6h]
Freak380: bets $6
vipbor: calls $6
*** SHOW DOWN ***
Freak380: shows [Td As] (a pair of Tens)
vipbor: mucks hand 
Freak380 collected $23.06 from pot
*** SUMMARY ***
Total pot $24 | Rake $0.94 
Board [Ts 3s 2d 5c 6h]
Seat 1: Mc57Arnold (big blind) folded before Flop
Seat 5: forestry800 folded before Flop (didn't bet)
Seat 6: vipbor (button) mucked
Seat 7: Freak380 (small blind) showed [Td As] and won ($23.06) with a pair of Tens



PokerStars Hand #228691050525:  Hold'em No Limit ($0.25/$0.50 USD) - 2021/07/30 18:00:23 ET
Table 'Bok II' 9-max Seat #7 is the button
Seat 1: Mc57Arnold ($50.25 in chips) 
Seat 2: dikanmax ($50 in chips) 
Seat 3: gvidator ($29.90 in chips) 
Seat 5: forestry800 ($77.65 in chips) 
Seat 6: vipbor ($57.38 in chips) 
Seat 7: Freak380 ($85.34 in chips) 
Mc57Arnold: posts small blind $0.25
dikanmax: posts big blind $0.50
Infinities4: sits out 
*** HOLE CARDS ***
gvidator: raises $1 to $1.50
forestry800: folds 
vipbor: folds 
Freak380: calls $1.50
Mc57Arnold: folds 
dikanmax: folds 
*** FLOP *** [6c Jd 9s]
gvidator: checks 
Freak380: checks 
*** TURN *** [6c Jd 9s] [7s]
gvidator: bets $2.40
Freak380: folds 
Uncalled bet ($2.40) returned to gvidator
gvidator collected $3.56 from pot
gvidator: doesn't show hand 
*** SUMMARY ***
Total pot $3.75 | Rake $0.19 
Board [6c Jd 9s 7s]
Seat 1: Mc57Arnold (small blind) folded before Flop
Seat 2: dikanmax (big blind) folded before Flop
Seat 3: gvidator collected ($3.56)
Seat 5: forestry800 folded before Flop (didn't bet)
Seat 6: vipbor folded before Flop (didn't bet)
Seat 7: Freak380 (button) folded on the Turn



PokerStars Hand #228691068988:  Hold'em No Limit ($0.25/$0.50 USD) - 2021/07/30 18:01:13 ET
Table 'Bok II' 9-max Seat #1 is the button
Seat 1: Mc57Arnold ($50 in chips) 
Seat 2: dikanmax ($50 in chips) 
Seat 3: gvidator ($31.96 in chips) 
Seat 5: forestry800 ($77.65 in chips) 
Seat 6: vipbor ($57.38 in chips) 
Seat 7: Freak380 ($83.84 in chips) 
Seat 8: dstrola ($53.03 in chips) 
dikanmax: posts small blind $0.25
gvidator: posts big blind $0.50
Infinities4: sits out 
dstrola: posts small & big blinds $0.75
An1an1: sits out 
*** HOLE CARDS ***
forestry800: folds 
vipbor: folds 
Freak380: folds 
dstrola: checks 
Mc57Arnold: folds 
dikanmax: folds 
gvidator: raises $0.96 to $1.46
dstrola: folds 
Uncalled bet ($0.96) returned to gvidator
gvidator collected $1.50 from pot
gvidator: doesn't show hand 
*** SUMMARY ***
Total pot $1.50 | Rake $0 
Seat 1: Mc57Arnold (button) folded before Flop (didn't bet)
Seat 2: dikanmax (small blind) folded before Flop
Seat 3: gvidator (big blind) collected ($1.50)
Seat 5: forestry800 folded before Flop (didn't bet)
Seat 6: vipbor folded before Flop (didn't bet)
Seat 7: Freak380 folded before Flop (didn't bet)
Seat 8: dstrola folded before Flop (didn't bet)



PokerStars Hand #228691078940:  Hold'em No Limit ($0.25/$0.50 USD) - 2021/07/30 18:01:37 ET
Table 'Bok II' 9-max Seat #2 is the button
Seat 1: Mc57Arnold ($50 in chips) 
Seat 2: dikanmax ($50 in chips) 
Seat 3: gvidator ($32.96 in chips) 
Seat 4: Infinities4 ($50 in chips) 
Seat 5: forestry800 ($77.65 in chips) 
Seat 7: Freak380 ($83.84 in chips) 
Seat 8: dstrola ($52.28 in chips) 
gvidator: posts small blind $0.25
Infinities4: posts big blind $0.50
An1an1: sits out 
*** HOLE CARDS ***
forestry800: folds 
Freak380: folds 
dstrola: raises $0.75 to $1.25
Mc57Arnold: folds 
dikanmax: folds 
gvidator: calls $1
Infinities4: folds 
*** FLOP *** [6d 4h 3c]
gvidator: checks 
dstrola: checks 
*** TURN *** [6d 4h 3c] [9d]
gvidator: bets $1.71
dstrola: folds 
Uncalled bet ($1.71) returned to gvidator
gvidator collected $2.85 from pot
gvidator: doesn't show hand 
*** SUMMARY ***
Total pot $3 | Rake $0.15 
Board [6d 4h 3c 9d]
Seat 1: Mc57Arnold folded before Flop (didn't bet)
Seat 2: dikanmax (button) folded before Flop (didn't bet)
Seat 3: gvidator (small blind) collected ($2.85)
Seat 4: Infinities4 (big blind) folded before Flop
Seat 5: forestry800 folded before Flop (didn't bet)
Seat 7: Freak380 folded before Flop (didn't bet)
Seat 8: dstrola folded on the Turn



PokerStars Hand #228691096768:  Hold'em No Limit ($0.25/$0.50 USD) - 2021/07/30 18:02:20 ET
Table 'Bok II' 9-max Seat #3 is the button
Seat 1: Mc57Arnold ($50 in chips) 
Seat 2: dikanmax ($50 in chips) 
Seat 3: gvidator ($34.56 in chips) 
Seat 4: Infinities4 ($50 in chips) 
Seat 5: forestry800 ($77.65 in chips) 
Seat 7: Freak380 ($83.84 in chips) 
Seat 8: dstrola ($51.03 in chips) 
Infinities4: posts small blind $0.25
forestry800: posts big blind $0.50
An1an1: sits out 
*** HOLE CARDS ***
Freak380: folds 
dstrola: folds 
Mc57Arnold: folds 
dikanmax: raises $1 to $1.50
gvidator: calls $1.50
Infinities4: folds 
forestry800: calls $1
*** FLOP *** [Ac 4s Qc]
forestry800: checks 
dikanmax: checks 
gvidator: checks 
*** TURN *** [Ac 4s Qc] [Ah]
forestry800: checks 
dikanmax: checks 
gvidator: bets $1.06
forestry800: folds 
dikanmax: calls $1.06
*** RIVER *** [Ac 4s Qc Ah] [3s]
dikanmax: checks 
gvidator: bets $3.26
dikanmax: folds 
Uncalled bet ($3.26) returned to gvidator
gvidator collected $6.53 from pot
gvidator: doesn't show hand 
*** SUMMARY ***
Total pot $6.87 | Rake $0.34 
Board [Ac 4s Qc Ah 3s]
Seat 1: Mc57Arnold folded before Flop (didn't bet)
Seat 2: dikanmax folded on the River
Seat 3: gvidator (button) collected ($6.53)
Seat 4: Infinities4 (small blind) folded before Flop
Seat 5: forestry800 (big blind) folded on the Turn
Seat 7: Freak380 folded before Flop (didn't bet)
Seat 8: dstrola folded before Flop (didn't bet)



PokerStars Hand #228691134664:  Hold'em No Limit ($0.25/$0.50 USD) - 2021/07/30 18:03:49 ET
Table 'Bok II' 9-max Seat #4 is the button
Seat 1: Mc57Arnold ($50 in chips) 
Seat 2: dikanmax ($50 in chips) 
Seat 3: gvidator ($38.53 in chips) 
Seat 4: Infinities4 ($50 in chips) 
Seat 5: forestry800 ($76.15 in chips) 
Seat 7: Freak380 ($83.84 in chips) 
Seat 8: dstrola ($51.03 in chips) 
forestry800: posts small blind $0.25
Freak380: posts big blind $0.50
An1an1: sits out 
*** HOLE CARDS ***
dstrola: folds 
Mc57Arnold: folds 
dikanmax: raises $1 to $1.50
gvidator: calls $1.50
Infinities4: raises $5 to $6.50
forestry800: folds 
Freak380: folds 
dikanmax: folds 
gvidator: folds 
Uncalled bet ($5) returned to Infinities4
Infinities4 collected $5.25 from pot
Infinities4: doesn't show hand 
*** SUMMARY ***
Total pot $5.25 | Rake $0 
Seat 1: Mc57Arnold folded before Flop (didn't bet)
Seat 2: dikanmax folded before Flop
Seat 3: gvidator folded before Flop
Seat 4: Infinities4 (button) collected ($5.25)
Seat 5: forestry800 (small blind) folded before Flop
Seat 7: Freak380 (big blind) folded before Flop
Seat 8: dstrola folded before Flop (didn't bet)



PokerStars Hand #228691147627:  Hold'em No Limit ($0.25/$0.50 USD) - 2021/07/30 18:04:20 ET
Table 'Bok II' 9-max Seat #5 is the button
Seat 1: Mc57Arnold ($50 in chips) 
Seat 2: dikanmax ($50 in chips) 
Seat 3: gvidator ($37.03 in chips) 
Seat 4: Infinities4 ($53.75 in chips) 
Seat 5: forestry800 ($75.90 in chips) 
Seat 7: Freak380 ($83.34 in chips) 
Seat 8: dstrola ($51.03 in chips) 
Freak380: posts small blind $0.25
dstrola: posts big blind $0.50
An1an1: sits out 
*** HOLE CARDS ***
Mc57Arnold: folds 
dikanmax: raises $1 to $1.50
gvidator: folds 
Infinities4: folds 
forestry800: folds 
Freak380: folds 
dstrola: folds 
Uncalled bet ($1) returned to dikanmax
dikanmax collected $1.25 from pot
dikanmax: doesn't show hand 
*** SUMMARY ***
Total pot $1.25 | Rake $0 
Seat 1: Mc57Arnold folded before Flop (didn't bet)
Seat 2: dikanmax collected ($1.25)
Seat 3: gvidator folded before Flop (didn't bet)
Seat 4: Infinities4 folded before Flop (didn't bet)
Seat 5: forestry800 (button) folded before Flop (didn't bet)
Seat 7: Freak380 (small blind) folded before Flop
Seat 8: dstrola (big blind) folded before Flop



PokerStars Hand #228691154367:  Hold'em No Limit ($0.25/$0.50 USD) - 2021/07/30 18:04:36 ET
Table 'Bok II' 9-max Seat #7 is the button
Seat 1: Mc57Arnold ($50 in chips) 
Seat 2: dikanmax ($50.75 in chips) 
Seat 3: gvidator ($37.03 in chips) 
Seat 4: Infinities4 ($53.75 in chips) 
Seat 5: forestry800 ($75.90 in chips) 
Seat 7: Freak380 ($83.09 in chips) 
Seat 8: dstrola ($50.53 in chips) 
Seat 9: An1an1 ($50 in chips) 
dstrola: posts small blind $0.25
An1an1: posts big blind $0.50
*** HOLE CARDS ***
Mc57Arnold: folds 
Mc57Arnold leaves the table
dikanmax: raises $1 to $1.50
gvidator: calls $1.50
Infinities4: folds 
forestry800: folds 
Freak380: folds 
dstrola: folds 
An1an1: folds 
*** FLOP *** [7h Qh 9h]
dikanmax: checks 
gvidator: bets $2.53
dikanmax: folds 
Uncalled bet ($2.53) returned to gvidator
gvidator collected $3.56 from pot
gvidator: doesn't show hand 
*** SUMMARY ***
Total pot $3.75 | Rake $0.19 
Board [7h Qh 9h]
Seat 1: Mc57Arnold folded before Flop (didn't bet)
Seat 2: dikanmax folded on the Flop
Seat 3: gvidator collected ($3.56)
Seat 4: Infinities4 folded before Flop (didn't bet)
Seat 5: forestry800 folded before Flop (didn't bet)
Seat 7: Freak380 (button) folded before Flop (didn't bet)
Seat 8: dstrola (small blind) folded before Flop
Seat 9: An1an1 (big blind) folded before Flop



PokerStars Hand #228691167666:  Hold'em No Limit ($0.25/$0.50 USD) - 2021/07/30 18:05:07 ET
Table 'Bok II' 9-max Seat #8 is the button
Seat 2: dikanmax ($50 in chips) 
Seat 3: gvidator ($39.09 in chips) 
Seat 4: Infinities4 ($53.75 in chips) 
Seat 5: forestry800 ($75.90 in chips) 
Seat 7: Freak380 ($83.09 in chips) 
Seat 8: dstrola ($50.28 in chips) 
Seat 9: An1an1 ($50 in chips) 
An1an1: posts small blind $0.25
dikanmax: posts big blind $0.50
*** HOLE CARDS ***
gvidator: folds 
Infinities4: folds 
forestry800: folds 
Freak380: raises $1 to $1.50
dstrola: folds 
An1an1: folds 
dikanmax: folds 
Uncalled bet ($1) returned to Freak380
Freak380 collected $1.25 from pot
*** SUMMARY ***
Total pot $1.25 | Rake $0 
Seat 2: dikanmax (big blind) folded before Flop
Seat 3: gvidator folded before Flop (didn't bet)
Seat 4: Infinities4 folded before Flop (didn't bet)
Seat 5: forestry800 folded before Flop (didn't bet)
Seat 7: Freak380 collected ($1.25)
Seat 8: dstrola (button) folded before Flop (didn't bet)
Seat 9: An1an1 (small blind) folded before Flop



PokerStars Hand #228691179268:  Hold'em No Limit ($0.25/$0.50 USD) - 2021/07/30 18:05:35 ET
Table 'Bok II' 9-max Seat #9 is the button
Seat 2: dikanmax ($50 in chips) 
Seat 3: gvidator ($39.09 in chips) 
Seat 4: Infinities4 ($53.75 in chips) 
Seat 5: forestry800 ($75.90 in chips) 
Seat 7: Freak380 ($83.84 in chips) 
Seat 8: dstrola ($50.28 in chips) 
Seat 9: An1an1 ($50 in chips) 
dikanmax: posts small blind $0.25
gvidator: posts big blind $0.50
*** HOLE CARDS ***
Infinities4: folds 
forestry800: folds 
Freak380: calls $0.50
dstrola: folds 
An1an1: folds 
dikanmax: raises $2.50 to $3
gvidator: calls $2.50
Freak380: calls $2.50
*** FLOP *** [7s 7h Qd]
dikanmax: bets $2.57
gvidator: calls $2.57
Freak380: folds 
*** TURN *** [7s 7h Qd] [7d]
alexrus18 joins the table at seat #1 
dikanmax: checks 
gvidator: checks 
*** RIVER *** [7s 7h Qd 7d] [3d]
dikanmax: checks 
gvidator: bets $33.52 and is all-in
dikanmax: folds 
Uncalled bet ($33.52) returned to gvidator
gvidator collected $13.43 from pot
gvidator: doesn't show hand 
*** SUMMARY ***
Total pot $14.14 | Rake $0.71 
Board [7s 7h Qd 7d 3d]
Seat 2: dikanmax (small blind) folded on the River
Seat 3: gvidator (big blind) collected ($13.43)
Seat 4: Infinities4 folded before Flop (didn't bet)
Seat 5: forestry800 folded before Flop (didn't bet)
Seat 7: Freak380 folded on the Flop
Seat 8: dstrola folded before Flop (didn't bet)
Seat 9: An1an1 (button) folded before Flop (didn't bet)



PokerStars Hand #228691208669:  Hold'em No Limit ($0.25/$0.50 USD) - 2021/07/30 18:06:44 ET
Table 'Bok II' 9-max Seat #2 is the button
Seat 2: dikanmax ($50 in chips) 
Seat 3: gvidator ($46.95 in chips) 
Seat 4: Infinities4 ($53.75 in chips) 
Seat 5: forestry800 ($75.90 in chips) 
Seat 7: Freak380 ($80.84 in chips) 
Seat 8: dstrola ($50.28 in chips) 
Seat 9: An1an1 ($50 in chips) 
gvidator: posts small blind $0.25
Infinities4: posts big blind $0.50
alexrus18: sits out 
*** HOLE CARDS ***
forestry800: folds 
Freak380: folds 
dstrola: folds 
An1an1: folds 
dikanmax: folds 
gvidator: calls $0.25
Infinities4: checks 
*** FLOP *** [Kh 6h Ac]
gvidator: checks 
Infinities4: checks 
*** TURN *** [Kh 6h Ac] [Tc]
gvidator: bets $0.95
Infinities4: folds 
Uncalled bet ($0.95) returned to gvidator
gvidator collected $0.95 from pot
gvidator: doesn't show hand 
*** SUMMARY ***
Total pot $1 | Rake $0.05 
Board [Kh 6h Ac Tc]
Seat 2: dikanmax (button) folded before Flop (didn't bet)
Seat 3: gvidator (small blind) collected ($0.95)
Seat 4: Infinities4 (big blind) folded on the Turn
Seat 5: forestry800 folded before Flop (didn't bet)
Seat 7: Freak380 folded before Flop (didn't bet)
Seat 8: dstrola folded before Flop (didn't bet)
Seat 9: An1an1 folded before Flop (didn't bet)



PokerStars Hand #228691222038:  Hold'em No Limit ($0.25/$0.50 USD) - 2021/07/30 18:07:16 ET
Table 'Bok II' 9-max Seat #3 is the button
Seat 2: dikanmax ($50 in chips) 
Seat 3: gvidator ($47.40 in chips) 
Seat 4: Infinities4 ($53.25 in chips) 
Seat 5: forestry800 ($75.90 in chips) 
Seat 7: Freak380 ($80.84 in chips) 
Seat 8: dstrola ($50.28 in chips) 
Seat 9: An1an1 ($50 in chips) 
Infinities4: posts small blind $0.25
forestry800: posts big blind $0.50
alexrus18: sits out 
*** HOLE CARDS ***
Freak380: folds 
dstrola: folds 
An1an1: raises $0.75 to $1.25
dikanmax: folds 
gvidator: calls $1.25
Infinities4: folds 
forestry800: folds 
*** FLOP *** [9s Kc 5s]
An1an1: checks 
gvidator: bets $1.04
An1an1: calls $1.04
*** TURN *** [9s Kc 5s] [2c]
An1an1: checks 
gvidator: checks 
*** RIVER *** [9s Kc 5s 2c] [3d]
An1an1: checks 
gvidator: checks 
*** SHOW DOWN ***
An1an1: shows [Ac 5c] (a pair of Fives)
gvidator: mucks hand 
An1an1 collected $5.06 from pot
*** SUMMARY ***
Total pot $5.33 | Rake $0.27 
Board [9s Kc 5s 2c 3d]
Seat 2: dikanmax folded before Flop (didn't bet)
Seat 3: gvidator (button) mucked
Seat 4: Infinities4 (small blind) folded before Flop
Seat 5: forestry800 (big blind) folded before Flop
Seat 7: Freak380 folded before Flop (didn't bet)
Seat 8: dstrola folded before Flop (didn't bet)
Seat 9: An1an1 showed [Ac 5c] and won ($5.06) with a pair of Fives



PokerStars Hand #228691251500:  Hold'em No Limit ($0.25/$0.50 USD) - 2021/07/30 18:08:09 ET
Table 'Bok II' 9-max Seat #4 is the button
Seat 2: dikanmax ($50 in chips) 
Seat 3: gvidator ($45.11 in chips) 
Seat 4: Infinities4 ($53 in chips) 
Seat 5: forestry800 ($75.40 in chips) 
Seat 7: Freak380 ($80.84 in chips) 
Seat 8: dstrola ($50.28 in chips) 
Seat 9: An1an1 ($52.77 in chips) 
forestry800: posts small blind $0.25
Freak380: posts big blind $0.50
alexrus18: sits out 
*** HOLE CARDS ***
dstrola: folds 
An1an1: folds 
dikanmax: folds 
gvidator: folds 
Infinities4: raises $0.58 to $1.08
forestry800: folds 
Freak380: folds 
Uncalled bet ($0.58) returned to Infinities4
Infinities4 collected $1.25 from pot
Infinities4: doesn't show hand 
*** SUMMARY ***
Total pot $1.25 | Rake $0 
Seat 2: dikanmax folded before Flop (didn't bet)
Seat 3: gvidator folded before Flop (didn't bet)
Seat 4: Infinities4 (button) collected ($1.25)
Seat 5: forestry800 (small blind) folded before Flop
Seat 7: Freak380 (big blind) folded before Flop
Seat 8: dstrola folded before Flop (didn't bet)
Seat 9: An1an1 folded before Flop (didn't bet)



PokerStars Hand #228691259786:  Hold'em No Limit ($0.25/$0.50 USD) - 2021/07/30 18:08:28 ET
Table 'Bok II' 9-max Seat #5 is the button
Seat 2: dikanmax ($50 in chips) 
Seat 3: gvidator ($45.11 in chips) 
Seat 4: Infinities4 ($53.75 in chips) 
Seat 5: forestry800 ($75.15 in chips) 
Seat 7: Freak380 ($80.34 in chips) 
Seat 8: dstrola ($50.28 in chips) 
Seat 9: An1an1 ($52.77 in chips) 
Freak380: posts small blind $0.25
dstrola: posts big blind $0.50
alexrus18: sits out 
*** HOLE CARDS ***
An1an1: folds 
dikanmax: folds 
gvidator: folds 
Infinities4: raises $0.74 to $1.24
forestry800: folds 
Freak380: calls $0.99
dstrola: folds 
*** FLOP *** [8s 4d Ah]
Freak380: checks 
Infinities4: bets $2.12
Freak380: folds 
Uncalled bet ($2.12) returned to Infinities4
Infinities4 collected $2.83 from pot
Infinities4: doesn't show hand 
*** SUMMARY ***
Total pot $2.98 | Rake $0.15 
Board [8s 4d Ah]
Seat 2: dikanmax folded before Flop (didn't bet)
Seat 3: gvidator folded before Flop (didn't bet)
Seat 4: Infinities4 collected ($2.83)
Seat 5: forestry800 (button) folded before Flop (didn't bet)
Seat 7: Freak380 (small blind) folded on the Flop
Seat 8: dstrola (big blind) folded before Flop
Seat 9: An1an1 folded before Flop (didn't bet)



PokerStars Hand #228691277564:  Hold'em No Limit ($0.25/$0.50 USD) - 2021/07/30 18:09:11 ET
Table 'Bok II' 9-max Seat #7 is the button
Seat 1: alexrus18 ($50 in chips) 
Seat 2: dikanmax ($50 in chips) 
Seat 3: gvidator ($45.11 in chips) 
Seat 4: Infinities4 ($55.34 in chips) 
Seat 5: forestry800 ($75.15 in chips) 
Seat 7: Freak380 ($79.10 in chips) 
Seat 9: An1an1 ($52.77 in chips) 
An1an1: posts small blind $0.25
alexrus18: posts big blind $0.50
*** HOLE CARDS ***
dikanmax: raises $1 to $1.50
gvidator: folds 
Infinities4: folds 
forestry800: raises $3 to $4.50
Freak380: folds 
An1an1: folds 
alexrus18: folds 
dikanmax: raises $7.25 to $11.75
forestry800: folds 
Uncalled bet ($7.25) returned to dikanmax
dikanmax collected $9.75 from pot
dikanmax: doesn't show hand 
*** SUMMARY ***
Total pot $9.75 | Rake $0 
Seat 1: alexrus18 (big blind) folded before Flop
Seat 2: dikanmax collected ($9.75)
Seat 3: gvidator folded before Flop (didn't bet)
Seat 4: Infinities4 folded before Flop (didn't bet)
Seat 5: forestry800 folded before Flop
Seat 7: Freak380 (button) folded before Flop (didn't bet)
Seat 9: An1an1 (small blind) folded before Flop



PokerStars Hand #228691293628:  Hold'em No Limit ($0.25/$0.50 USD) - 2021/07/30 18:09:49 ET
Table 'Bok II' 9-max Seat #9 is the button
Seat 1: alexrus18 ($50 in chips) 
Seat 2: dikanmax ($55.25 in chips) 
Seat 3: gvidator ($45.11 in chips) 
Seat 4: Infinities4 ($55.34 in chips) 
Seat 5: forestry800 ($70.65 in chips) 
Seat 7: Freak380 ($79.10 in chips) 
Seat 9: An1an1 ($52.52 in chips) 
alexrus18: posts small blind $0.25
dikanmax: posts big blind $0.50
vipbor: sits out 
*** HOLE CARDS ***
gvidator: folds 
Infinities4: folds 
forestry800: folds 
Freak380: folds 
An1an1: folds 
alexrus18: folds 
Uncalled bet ($0.25) returned to dikanmax
dikanmax collected $0.50 from pot
dikanmax: doesn't show hand 
*** SUMMARY ***
Total pot $0.50 | Rake $0 
Seat 1: alexrus18 (small blind) folded before Flop
Seat 2: dikanmax (big blind) collected ($0.50)
Seat 3: gvidator folded before Flop (didn't bet)
Seat 4: Infinities4 folded before Flop (didn't bet)
Seat 5: forestry800 folded before Flop (didn't bet)
Seat 7: Freak380 folded before Flop (didn't bet)
Seat 9: An1an1 (button) folded before Flop (didn't bet)



PokerStars Hand #228691296932:  Hold'em No Limit ($0.25/$0.50 USD) - 2021/07/30 18:09:57 ET
Table 'Bok II' 9-max Seat #1 is the button
Seat 1: alexrus18 ($50 in chips) 
Seat 2: dikanmax ($55.50 in chips) 
Seat 3: gvidator ($45.11 in chips) 
Seat 4: Infinities4 ($55.34 in chips) 
Seat 5: forestry800 ($70.65 in chips) 
Seat 7: Freak380 ($79.10 in chips) 
Seat 9: An1an1 ($52.52 in chips) 
dikanmax: posts small blind $0.25
gvidator: posts big blind $0.50
vipbor: sits out 
*** HOLE CARDS ***
Infinities4: raises $0.74 to $1.24
forestry800: folds 
Freak380: folds 
An1an1: folds 
alexrus18: calls $1.24
dikanmax: folds 
gvidator: folds 
*** FLOP *** [5s 9h 4h]
Infinities4: checks 
alexrus18: bets $1.69
Infinities4: calls $1.69
*** TURN *** [5s 9h 4h] [2s]
Infinities4: checks 
alexrus18: checks 
*** RIVER *** [5s 9h 4h 2s] [Qc]
Infinities4: bets $2.20
alexrus18: calls $2.20
*** SHOW DOWN ***
Infinities4: shows [Qs Ah] (a pair of Queens)
alexrus18: mucks hand 
Infinities4 collected $10.46 from pot
*** SUMMARY ***
Total pot $11.01 | Rake $0.55 
Board [5s 9h 4h 2s Qc]
Seat 1: alexrus18 (button) mucked
Seat 2: dikanmax (small blind) folded before Flop
Seat 3: gvidator (big blind) folded before Flop
Seat 4: Infinities4 showed [Qs Ah] and won ($10.46) with a pair of Queens
Seat 5: forestry800 folded before Flop (didn't bet)
Seat 7: Freak380 folded before Flop (didn't bet)
Seat 9: An1an1 folded before Flop (didn't bet)



PokerStars Hand #228691328090:  Hold'em No Limit ($0.25/$0.50 USD) - 2021/07/30 18:11:12 ET
Table 'Bok II' 9-max Seat #2 is the button
Seat 1: alexrus18 ($50 in chips) 
Seat 2: dikanmax ($55.25 in chips) 
Seat 3: gvidator ($44.61 in chips) 
Seat 4: Infinities4 ($60.67 in chips) 
Seat 5: forestry800 ($70.65 in chips) 
Seat 7: Freak380 ($79.10 in chips) 
Seat 9: An1an1 ($52.52 in chips) 
gvidator: posts small blind $0.25
Infinities4: posts big blind $0.50
vipbor: sits out 
*** HOLE CARDS ***
forestry800: folds 
Freak380: folds 
An1an1: folds 
alexrus18: folds 
dikanmax: folds 
gvidator: folds 
Uncalled bet ($0.25) returned to Infinities4
Infinities4 collected $0.50 from pot
Infinities4: doesn't show hand 
*** SUMMARY ***
Total pot $0.50 | Rake $0 
Seat 1: alexrus18 folded before Flop (didn't bet)
Seat 2: dikanmax (button) folded before Flop (didn't bet)
Seat 3: gvidator (small blind) folded before Flop
Seat 4: Infinities4 (big blind) collected ($0.50)
Seat 5: forestry800 folded before Flop (didn't bet)
Seat 7: Freak380 folded before Flop (didn't bet)
Seat 9: An1an1 folded before Flop (didn't bet)



PokerStars Hand #228691333578:  Hold'em No Limit ($0.25/$0.50 USD) - 2021/07/30 18:11:25 ET
Table 'Bok II' 9-max Seat #3 is the button
Seat 1: alexrus18 ($50 in chips) 
Seat 2: dikanmax ($55.25 in chips) 
Seat 3: gvidator ($44.36 in chips) 
Seat 4: Infinities4 ($60.92 in chips) 
Seat 5: forestry800 ($70.65 in chips) 
Seat 7: Freak380 ($79.10 in chips) 
Seat 9: An1an1 ($52.52 in chips) 
Infinities4: posts small blind $0.25
forestry800: posts big blind $0.50
vipbor: sits out 
*** HOLE CARDS ***
Freak380: raises $0.50 to $1
An1an1: folds 
alexrus18: folds 
dikanmax: folds 
gvidator: folds 
Infinities4: folds 
forestry800: folds 
Uncalled bet ($0.50) returned to Freak380
Freak380 collected $1.25 from pot
*** SUMMARY ***
Total pot $1.25 | Rake $0 
Seat 1: alexrus18 folded before Flop (didn't bet)
Seat 2: dikanmax folded before Flop (didn't bet)
Seat 3: gvidator (button) folded before Flop (didn't bet)
Seat 4: Infinities4 (small blind) folded before Flop
Seat 5: forestry800 (big blind) folded before Flop
Seat 7: Freak380 collected ($1.25)
Seat 9: An1an1 folded before Flop (didn't bet)



PokerStars Hand #228691337643:  Hold'em No Limit ($0.25/$0.50 USD) - 2021/07/30 18:11:35 ET
Table 'Bok II' 9-max Seat #4 is the button
Seat 1: alexrus18 ($50 in chips) 
Seat 2: dikanmax ($55.25 in chips) 
Seat 3: gvidator ($44.36 in chips) 
Seat 4: Infinities4 ($60.67 in chips) 
Seat 5: forestry800 ($70.15 in chips) 
Seat 6: vipbor ($57.38 in chips) 
Seat 7: Freak380 ($79.85 in chips) 
Seat 9: An1an1 ($52.52 in chips) 
forestry800: posts small blind $0.25
vipbor: posts big blind $0.50
*** HOLE CARDS ***
Freak380: folds 
An1an1: folds 
alexrus18: folds 
dikanmax: raises $1 to $1.50
gvidator: folds 
Infinities4: folds 
forestry800: folds 
vipbor: folds 
Uncalled bet ($1) returned to dikanmax
dikanmax collected $1.25 from pot
dikanmax: doesn't show hand 
*** SUMMARY ***
Total pot $1.25 | Rake $0 
Seat 1: alexrus18 folded before Flop (didn't bet)
Seat 2: dikanmax collected ($1.25)
Seat 3: gvidator folded before Flop (didn't bet)
Seat 4: Infinities4 (button) folded before Flop (didn't bet)
Seat 5: forestry800 (small blind) folded before Flop
Seat 6: vipbor (big blind) folded before Flop
Seat 7: Freak380 folded before Flop (didn't bet)
Seat 9: An1an1 folded before Flop (didn't bet)



PokerStars Hand #228691348601:  Hold'em No Limit ($0.25/$0.50 USD) - 2021/07/30 18:12:02 ET
Table 'Bok II' 9-max Seat #5 is the button
Seat 1: alexrus18 ($50 in chips) 
Seat 2: dikanmax ($56 in chips) 
Seat 3: gvidator ($44.36 in chips) 
Seat 4: Infinities4 ($60.67 in chips) 
Seat 5: forestry800 ($69.90 in chips) 
Seat 6: vipbor ($56.88 in chips) 
Seat 7: Freak380 ($79.85 in chips) 
Seat 9: An1an1 ($52.52 in chips) 
vipbor: posts small blind $0.25
Freak380: posts big blind $0.50
*** HOLE CARDS ***
An1an1: folds 
alexrus18: folds 
dikanmax: folds 
gvidator: folds 
Infinities4: folds 
forestry800: raises $0.60 to $1.10
vipbor: folds 
Freak380: folds 
Uncalled bet ($0.60) returned to forestry800
forestry800 collected $1.25 from pot
forestry800: doesn't show hand 
*** SUMMARY ***
Total pot $1.25 | Rake $0 
Seat 1: alexrus18 folded before Flop (didn't bet)
Seat 2: dikanmax folded before Flop (didn't bet)
Seat 3: gvidator folded before Flop (didn't bet)
Seat 4: Infinities4 folded before Flop (didn't bet)
Seat 5: forestry800 (button) collected ($1.25)
Seat 6: vipbor (small blind) folded before Flop
Seat 7: Freak380 (big blind) folded before Flop
Seat 9: An1an1 folded before Flop (didn't bet)



PokerStars Hand #228691358687:  Hold'em No Limit ($0.25/$0.50 USD) - 2021/07/30 18:12:27 ET
Table 'Bok II' 9-max Seat #6 is the button
Seat 1: alexrus18 ($50 in chips) 
Seat 2: dikanmax ($56 in chips) 
Seat 3: gvidator ($44.36 in chips) 
Seat 4: Infinities4 ($60.67 in chips) 
Seat 5: forestry800 ($70.65 in chips) 
Seat 6: vipbor ($56.63 in chips) 
Seat 7: Freak380 ($79.35 in chips) 
Seat 9: An1an1 ($52.52 in chips) 
Freak380: posts small blind $0.25
An1an1: posts big blind $0.50
*** HOLE CARDS ***
alexrus18: folds 
dikanmax: folds 
gvidator: calls $0.50
Infinities4: folds 
forestry800: folds 
vipbor: calls $0.50
Freak380: folds 
An1an1: raises $2 to $2.50
gvidator: calls $2
vipbor: calls $2
*** FLOP *** [6s 9s 9d]
An1an1: bets $2.21
gvidator: calls $2.21
vipbor: folds 
*** TURN *** [6s 9s 9d] [Qh]
An1an1: checks 
gvidator: checks 
*** RIVER *** [6s 9s 9d Qh] [3h]
An1an1: bets $8.67
gvidator: calls $8.67
*** SHOW DOWN ***
An1an1: shows [Th Qc] (two pair, Queens and Nines)
gvidator: mucks hand 
An1an1 collected $28.03 from pot
*** SUMMARY ***
Total pot $29.51 | Rake $1.48 
Board [6s 9s 9d Qh 3h]
Seat 1: alexrus18 folded before Flop (didn't bet)
Seat 2: dikanmax folded before Flop (didn't bet)
Seat 3: gvidator mucked
Seat 4: Infinities4 folded before Flop (didn't bet)
Seat 5: forestry800 folded before Flop (didn't bet)
Seat 6: vipbor (button) folded on the Flop
Seat 7: Freak380 (small blind) folded before Flop
Seat 9: An1an1 (big blind) showed [Th Qc] and won ($28.03) with two pair, Queens and Nines



PokerStars Hand #228691385746:  Hold'em No Limit ($0.25/$0.50 USD) - 2021/07/30 18:13:32 ET
Table 'Bok II' 9-max Seat #7 is the button
Seat 1: alexrus18 ($50 in chips) 
Seat 2: dikanmax ($56 in chips) 
Seat 3: gvidator ($30.98 in chips) 
Seat 4: Infinities4 ($60.67 in chips) 
Seat 5: forestry800 ($70.65 in chips) 
Seat 6: vipbor ($54.13 in chips) 
Seat 7: Freak380 ($79.10 in chips) 
Seat 9: An1an1 ($67.17 in chips) 
An1an1: posts small blind $0.25
alexrus18: posts big blind $0.50
*** HOLE CARDS ***
dikanmax: folds 
gvidator: folds 
Infinities4: folds 
forestry800: folds 
vipbor: folds 
Freak380: folds 
An1an1: raises $1 to $1.50
alexrus18: calls $1
*** FLOP *** [8h Kd 4d]
An1an1: checks 
alexrus18: checks 
*** TURN *** [8h Kd 4d] [Js]
An1an1: bets $2.85
alexrus18: calls $2.85
*** RIVER *** [8h Kd 4d Js] [3h]
An1an1: bets $6.20
alexrus18: folds 
Uncalled bet ($6.20) returned to An1an1
An1an1 collected $8.26 from pot
An1an1: doesn't show hand 
*** SUMMARY ***
Total pot $8.70 | Rake $0.44 
Board [8h Kd 4d Js 3h]
Seat 1: alexrus18 (big blind) folded on the River
Seat 2: dikanmax folded before Flop (didn't bet)
Seat 3: gvidator folded before Flop (didn't bet)
Seat 4: Infinities4 folded before Flop (didn't bet)
Seat 5: forestry800 folded before Flop (didn't bet)
Seat 6: vipbor folded before Flop (didn't bet)
Seat 7: Freak380 (button) folded before Flop (didn't bet)
Seat 9: An1an1 (small blind) collected ($8.26)



PokerStars Hand #228691414303:  Hold'em No Limit ($0.25/$0.50 USD) - 2021/07/30 18:14:42 ET
Table 'Bok II' 9-max Seat #9 is the button
Seat 1: alexrus18 ($50 in chips) 
Seat 2: dikanmax ($56 in chips) 
Seat 3: gvidator ($30.98 in chips) 
Seat 4: Infinities4 ($60.67 in chips) 
Seat 5: forestry800 ($70.65 in chips) 
Seat 6: vipbor ($54.13 in chips) 
Seat 7: Freak380 ($79.10 in chips) 
Seat 9: An1an1 ($71.08 in chips) 
alexrus18: posts small blind $0.25
dikanmax: posts big blind $0.50
*** HOLE CARDS ***
gvidator: calls $0.50
Infinities4: folds 
forestry800: folds 
vipbor: folds 
Freak380: folds 
An1an1: folds 
alexrus18: folds 
dikanmax: checks 
*** FLOP *** [Js Ac Kd]
dikanmax: bets $0.50
gvidator: raises $1.10 to $1.60
dikanmax: folds 
Uncalled bet ($1.10) returned to gvidator
gvidator collected $2.14 from pot
gvidator: doesn't show hand 
*** SUMMARY ***
Total pot $2.25 | Rake $0.11 
Board [Js Ac Kd]
Seat 1: alexrus18 (small blind) folded before Flop
Seat 2: dikanmax (big blind) folded on the Flop
Seat 3: gvidator collected ($2.14)
Seat 4: Infinities4 folded before Flop (didn't bet)
Seat 5: forestry800 folded before Flop (didn't bet)
Seat 6: vipbor folded before Flop (didn't bet)
Seat 7: Freak380 folded before Flop (didn't bet)
Seat 9: An1an1 (button) folded before Flop (didn't bet)



PokerStars Hand #228691425264:  Hold'em No Limit ($0.25/$0.50 USD) - 2021/07/30 18:15:09 ET
Table 'Bok II' 9-max Seat #1 is the button
Seat 1: alexrus18 ($50 in chips) 
Seat 2: dikanmax ($55 in chips) 
Seat 3: gvidator ($32.12 in chips) 
Seat 4: Infinities4 ($60.67 in chips) 
Seat 5: forestry800 ($70.65 in chips) 
Seat 6: vipbor ($54.13 in chips) 
Seat 7: Freak380 ($79.10 in chips) 
Seat 9: An1an1 ($71.08 in chips) 
dikanmax: posts small blind $0.25
gvidator: posts big blind $0.50
*** HOLE CARDS ***
Infinities4: folds 
forestry800: folds 
vipbor: folds 
Freak380: folds 
An1an1: folds 
alexrus18: raises $0.75 to $1.25
dikanmax: folds 
gvidator: folds 
Uncalled bet ($0.75) returned to alexrus18
alexrus18 collected $1.25 from pot
alexrus18: doesn't show hand 
*** SUMMARY ***
Total pot $1.25 | Rake $0 
Seat 1: alexrus18 (button) collected ($1.25)
Seat 2: dikanmax (small blind) folded before Flop
Seat 3: gvidator (big blind) folded before Flop
Seat 4: Infinities4 folded before Flop (didn't bet)
Seat 5: forestry800 folded before Flop (didn't bet)
Seat 6: vipbor folded before Flop (didn't bet)
Seat 7: Freak380 folded before Flop (didn't bet)
Seat 9: An1an1 folded before Flop (didn't bet)



PokerStars Hand #228691435520:  Hold'em No Limit ($0.25/$0.50 USD) - 2021/07/30 18:15:34 ET
Table 'Bok II' 9-max Seat #2 is the button
Seat 1: alexrus18 ($50.75 in chips) 
Seat 2: dikanmax ($54.75 in chips) 
Seat 3: gvidator ($31.62 in chips) 
Seat 4: Infinities4 ($60.67 in chips) 
Seat 5: forestry800 ($70.65 in chips) 
Seat 6: vipbor ($54.13 in chips) 
Seat 7: Freak380 ($79.10 in chips) 
Seat 9: An1an1 ($71.08 in chips) 
gvidator: posts small blind $0.25
Infinities4: posts big blind $0.50
*** HOLE CARDS ***
forestry800: folds 
vipbor: folds 
Freak380: folds 
An1an1: folds 
alexrus18: raises $0.75 to $1.25
dikanmax: folds 
gvidator: folds 
Infinities4: folds 
Uncalled bet ($0.75) returned to alexrus18
alexrus18 collected $1.25 from pot
alexrus18: doesn't show hand 
*** SUMMARY ***
Total pot $1.25 | Rake $0 
Seat 1: alexrus18 collected ($1.25)
Seat 2: dikanmax (button) folded before Flop (didn't bet)
Seat 3: gvidator (small blind) folded before Flop
Seat 4: Infinities4 (big blind) folded before Flop
Seat 5: forestry800 folded before Flop (didn't bet)
Seat 6: vipbor folded before Flop (didn't bet)
Seat 7: Freak380 folded before Flop (didn't bet)
Seat 9: An1an1 folded before Flop (didn't bet)



PokerStars Hand #228691450760:  Hold'em No Limit ($0.25/$0.50 USD) - 2021/07/30 18:16:11 ET
Table 'Bok II' 9-max Seat #3 is the button
Seat 1: alexrus18 ($51.50 in chips) 
Seat 2: dikanmax ($54.75 in chips) 
Seat 3: gvidator ($31.37 in chips) 
Seat 4: Infinities4 ($60.17 in chips) 
Seat 5: forestry800 ($70.65 in chips) 
Seat 6: vipbor ($54.13 in chips) 
Seat 7: Freak380 ($79.10 in chips) 
Seat 9: An1an1 ($71.08 in chips) 
Infinities4: posts small blind $0.25
forestry800: posts big blind $0.50
*** HOLE CARDS ***
vipbor: folds 
Freak380: folds 
An1an1: folds 
alexrus18: folds 
dikanmax: raises $1 to $1.50
gvidator: folds 
Infinities4: folds 
forestry800: folds 
Uncalled bet ($1) returned to dikanmax
dikanmax collected $1.25 from pot
dikanmax: doesn't show hand 
*** SUMMARY ***
Total pot $1.25 | Rake $0 
Seat 1: alexrus18 folded before Flop (didn't bet)
Seat 2: dikanmax collected ($1.25)
Seat 3: gvidator (button) folded before Flop (didn't bet)
Seat 4: Infinities4 (small blind) folded before Flop
Seat 5: forestry800 (big blind) folded before Flop
Seat 6: vipbor folded before Flop (didn't bet)
Seat 7: Freak380 folded before Flop (didn't bet)
Seat 9: An1an1 folded before Flop (didn't bet)



PokerStars Hand #228691462042:  Hold'em No Limit ($0.25/$0.50 USD) - 2021/07/30 18:16:39 ET
Table 'Bok II' 9-max Seat #4 is the button
Seat 1: alexrus18 ($51.50 in chips) 
Seat 2: dikanmax ($55.50 in chips) 
Seat 3: gvidator ($31.37 in chips) 
Seat 4: Infinities4 ($59.92 in chips) 
Seat 5: forestry800 ($70.15 in chips) 
Seat 6: vipbor ($54.13 in chips) 
Seat 7: Freak380 ($79.10 in chips) 
Seat 9: An1an1 ($71.08 in chips) 
forestry800: posts small blind $0.25
vipbor: posts big blind $0.50
*** HOLE CARDS ***
Freak380 has timed out
Freak380: folds 
dstrola leaves the table
An1an1: folds 
alexrus18: folds 
dikanmax: folds 
gvidator: folds 
Infinities4: raises $0.58 to $1.08
forestry800: folds 
StudentRB joins the table at seat #8 
vipbor: folds 
Uncalled bet ($0.58) returned to Infinities4
Infinities4 collected $1.25 from pot
Infinities4: doesn't show hand 
*** SUMMARY ***
Total pot $1.25 | Rake $0 
Seat 1: alexrus18 folded before Flop (didn't bet)
Seat 2: dikanmax folded before Flop (didn't bet)
Seat 3: gvidator folded before Flop (didn't bet)
Seat 4: Infinities4 (button) collected ($1.25)
Seat 5: forestry800 (small blind) folded before Flop
Seat 6: vipbor (big blind) folded before Flop
Seat 7: Freak380 folded before Flop (didn't bet)
Seat 9: An1an1 folded before Flop (didn't bet)



PokerStars Hand #228691480565:  Hold'em No Limit ($0.25/$0.50 USD) - 2021/07/30 18:17:24 ET
Table 'Bok II' 9-max Seat #5 is the button
Seat 1: alexrus18 ($51.50 in chips) 
Seat 2: dikanmax ($55.50 in chips) 
Seat 3: gvidator ($31.37 in chips) 
Seat 4: Infinities4 ($60.67 in chips) 
Seat 5: forestry800 ($69.90 in chips) 
Seat 6: vipbor ($53.63 in chips) 
Seat 7: Freak380 ($79.10 in chips) 
Seat 9: An1an1 ($71.08 in chips) 
vipbor: posts small blind $0.25
Freak380: posts big blind $0.50
StudentRB: sits out 
*** HOLE CARDS ***
An1an1: folds 
alexrus18: folds 
dikanmax: folds 
gvidator: raises $1 to $1.50
Infinities4: folds 
forestry800: calls $1.50
vipbor: folds 
Freak380: folds 
*** FLOP *** [3s Ad 7s]
gvidator: bets $1.87
forestry800: folds 
Uncalled bet ($1.87) returned to gvidator
gvidator collected $3.56 from pot
gvidator: doesn't show hand 
*** SUMMARY ***
Total pot $3.75 | Rake $0.19 
Board [3s Ad 7s]
Seat 1: alexrus18 folded before Flop (didn't bet)
Seat 2: dikanmax folded before Flop (didn't bet)
Seat 3: gvidator collected ($3.56)
Seat 4: Infinities4 folded before Flop (didn't bet)
Seat 5: forestry800 (button) folded on the Flop
Seat 6: vipbor (small blind) folded before Flop
Seat 7: Freak380 (big blind) folded before Flop
Seat 9: An1an1 folded before Flop (didn't bet)



PokerStars Hand #228691500875:  Hold'em No Limit ($0.25/$0.50 USD) - 2021/07/30 18:18:14 ET
Table 'Bok II' 9-max Seat #6 is the button
Seat 1: alexrus18 ($51.50 in chips) 
Seat 2: dikanmax ($55.50 in chips) 
Seat 3: gvidator ($33.43 in chips) 
Seat 4: Infinities4 ($60.67 in chips) 
Seat 5: forestry800 ($68.40 in chips) 
Seat 6: vipbor ($53.38 in chips) 
Seat 7: Freak380 ($78.60 in chips) 
Seat 8: StudentRB ($50 in chips) 
Seat 9: An1an1 ($71.08 in chips) 
Freak380: posts small blind $0.25
StudentRB: posts big blind $0.50
*** HOLE CARDS ***
An1an1: folds 
alexrus18: folds 
dikanmax: folds 
gvidator: calls $0.50
Infinities4: folds 
forestry800: folds 
vipbor: folds 
Freak380: calls $0.25
StudentRB: checks 
*** FLOP *** [3h 2c Ad]
Freak380: checks 
StudentRB: checks 
gvidator: bets $0.71
Freak380: folds 
StudentRB: folds 
Uncalled bet ($0.71) returned to gvidator
gvidator collected $1.42 from pot
gvidator: doesn't show hand 
*** SUMMARY ***
Total pot $1.50 | Rake $0.08 
Board [3h 2c Ad]
Seat 1: alexrus18 folded before Flop (didn't bet)
Seat 2: dikanmax folded before Flop (didn't bet)
Seat 3: gvidator collected ($1.42)
Seat 4: Infinities4 folded before Flop (didn't bet)
Seat 5: forestry800 folded before Flop (didn't bet)
Seat 6: vipbor (button) folded before Flop (didn't bet)
Seat 7: Freak380 (small blind) folded on the Flop
Seat 8: StudentRB (big blind) folded on the Flop
Seat 9: An1an1 folded before Flop (didn't bet)



PokerStars Hand #228691514381:  Hold'em No Limit ($0.25/$0.50 USD) - 2021/07/30 18:18:47 ET
Table 'Bok II' 9-max Seat #7 is the button
Seat 1: alexrus18 ($51.50 in chips) 
Seat 2: dikanmax ($55.50 in chips) 
Seat 3: gvidator ($34.35 in chips) 
Seat 4: Infinities4 ($60.67 in chips) 
Seat 5: forestry800 ($68.40 in chips) 
Seat 6: vipbor ($53.38 in chips) 
Seat 7: Freak380 ($78.10 in chips) 
Seat 8: StudentRB ($50 in chips) 
Seat 9: An1an1 ($71.08 in chips) 
StudentRB: posts small blind $0.25
An1an1: posts big blind $0.50
*** HOLE CARDS ***
alexrus18: folds 
dikanmax: folds 
gvidator: folds 
Infinities4: folds 
forestry800: folds 
vipbor: folds 
Freak380: folds 
StudentRB: folds 
Uncalled bet ($0.25) returned to An1an1
An1an1 collected $0.50 from pot
An1an1: doesn't show hand 
*** SUMMARY ***
Total pot $0.50 | Rake $0 
Seat 1: alexrus18 folded before Flop (didn't bet)
Seat 2: dikanmax folded before Flop (didn't bet)
Seat 3: gvidator folded before Flop (didn't bet)
Seat 4: Infinities4 folded before Flop (didn't bet)
Seat 5: forestry800 folded before Flop (didn't bet)
Seat 6: vipbor folded before Flop (didn't bet)
Seat 7: Freak380 (button) folded before Flop (didn't bet)
Seat 8: StudentRB (small blind) folded before Flop
Seat 9: An1an1 (big blind) collected ($0.50)



PokerStars Hand #228691518655:  Hold'em No Limit ($0.25/$0.50 USD) - 2021/07/30 18:18:58 ET
Table 'Bok II' 9-max Seat #8 is the button
Seat 1: alexrus18 ($51.50 in chips) 
Seat 2: dikanmax ($55.50 in chips) 
Seat 3: gvidator ($34.35 in chips) 
Seat 4: Infinities4 ($60.67 in chips) 
Seat 5: forestry800 ($68.40 in chips) 
Seat 6: vipbor ($53.38 in chips) 
Seat 7: Freak380 ($78.10 in chips) 
Seat 8: StudentRB ($50 in chips) 
Seat 9: An1an1 ($71.33 in chips) 
An1an1: posts small blind $0.25
alexrus18: posts big blind $0.50
*** HOLE CARDS ***
dikanmax: folds 
gvidator: folds 
Infinities4: folds 
forestry800: folds 
vipbor: folds 
Freak380: folds 
StudentRB: raises $0.75 to $1.25
An1an1: folds 
alexrus18: folds 
Uncalled bet ($0.75) returned to StudentRB
StudentRB collected $1.25 from pot
StudentRB: doesn't show hand 
*** SUMMARY ***
Total pot $1.25 | Rake $0 
Seat 1: alexrus18 (big blind) folded before Flop
Seat 2: dikanmax folded before Flop (didn't bet)
Seat 3: gvidator folded before Flop (didn't bet)
Seat 4: Infinities4 folded before Flop (didn't bet)
Seat 5: forestry800 folded before Flop (didn't bet)
Seat 6: vipbor folded before Flop (didn't bet)
Seat 7: Freak380 folded before Flop (didn't bet)
Seat 8: StudentRB (button) collected ($1.25)
Seat 9: An1an1 (small blind) folded before Flop



PokerStars Hand #228691525359:  Hold'em No Limit ($0.25/$0.50 USD) - 2021/07/30 18:19:15 ET
Table 'Bok II' 9-max Seat #9 is the button
Seat 1: alexrus18 ($51 in chips) 
Seat 3: gvidator ($34.35 in chips) 
Seat 4: Infinities4 ($60.67 in chips) 
Seat 5: forestry800 ($68.40 in chips) 
Seat 6: vipbor ($53.38 in chips) 
Seat 7: Freak380 ($78.10 in chips) 
Seat 8: StudentRB ($50.75 in chips) 
Seat 9: An1an1 ($71.08 in chips) 
alexrus18: posts small blind $0.25
dikanmax: is sitting out 
gvidator: posts big blind $0.50
*** HOLE CARDS ***
Infinities4: folds 
forestry800: folds 
vipbor: folds 
Freak380: raises $1 to $1.50
StudentRB: folds 
An1an1: folds 
alexrus18: folds 
gvidator: calls $1
*** FLOP *** [Th 2c Ac]
gvidator: checks 
Freak380: checks 
*** TURN *** [Th 2c Ac] [2s]
gvidator: bets $1.85
Freak380: folds 
Uncalled bet ($1.85) returned to gvidator
gvidator collected $3.09 from pot
gvidator: doesn't show hand 
*** SUMMARY ***
Total pot $3.25 | Rake $0.16 
Board [Th 2c Ac 2s]
Seat 1: alexrus18 (small blind) folded before Flop
Seat 3: gvidator (big blind) collected ($3.09)
Seat 4: Infinities4 folded before Flop (didn't bet)
Seat 5: forestry800 folded before Flop (didn't bet)
Seat 6: vipbor folded before Flop (didn't bet)
Seat 7: Freak380 folded on the Turn
Seat 8: StudentRB folded before Flop (didn't bet)
Seat 9: An1an1 (button) folded before Flop (didn't bet)



PokerStars Hand #228691538929:  Hold'em No Limit ($0.25/$0.50 USD) - 2021/07/30 18:19:48 ET
Table 'Bok II' 9-max Seat #1 is the button
Seat 1: alexrus18 ($50.75 in chips) 
Seat 3: gvidator ($35.94 in chips) 
Seat 4: Infinities4 ($60.67 in chips) 
Seat 5: forestry800 ($68.40 in chips) 
Seat 6: vipbor ($53.38 in chips) 
Seat 7: Freak380 ($76.60 in chips) 
Seat 8: StudentRB ($50.75 in chips) 
Seat 9: An1an1 ($71.08 in chips) 
gvidator: posts small blind $0.25
Infinities4: posts big blind $0.50
*** HOLE CARDS ***
forestry800: folds 
vipbor: folds 
Freak380: folds 
StudentRB: folds 
An1an1: folds 
alexrus18: folds 
gvidator: calls $0.25
Infinities4: checks 
*** FLOP *** [3d Qd Qs]
gvidator: bets $0.50
Infinities4: folds 
Uncalled bet ($0.50) returned to gvidator
gvidator collected $0.95 from pot
gvidator: doesn't show hand 
*** SUMMARY ***
Total pot $1 | Rake $0.05 
Board [3d Qd Qs]
Seat 1: alexrus18 (button) folded before Flop (didn't bet)
Seat 3: gvidator (small blind) collected ($0.95)
Seat 4: Infinities4 (big blind) folded on the Flop
Seat 5: forestry800 folded before Flop (didn't bet)
Seat 6: vipbor folded before Flop (didn't bet)
Seat 7: Freak380 folded before Flop (didn't bet)
Seat 8: StudentRB folded before Flop (didn't bet)
Seat 9: An1an1 folded before Flop (didn't bet)



PokerStars Hand #228688565745:  Hold'em No Limit ($0.25/$0.50 USD) - 2021/07/30 16:29:47 ET
Table 'Bok II' 9-max Seat #9 is the button
Seat 1: keko gr ($66.66 in chips) 
Seat 2: bateman225 ($37.57 in chips) 
Seat 3: Rulet345 ($60.51 in chips) 
Seat 4: aaahaaa1967 ($40.58 in chips) 
Seat 5: Xamil666 ($50.70 in chips) 
Seat 6: vipbor ($54.42 in chips) 
Seat 7: Popokluev ($50 in chips) 
Seat 8: SwimmingPooI ($85.91 in chips) 
Seat 9: pirog766 ($25.78 in chips) 
keko gr: posts small blind $0.25
bateman225: posts big blind $0.50
*** HOLE CARDS ***
Rulet345: folds 
aaahaaa1967: folds 
Xamil666: raises $1 to $1.50
vipbor: folds 
Popokluev: folds 
SwimmingPooI: folds 
pirog766: calls $1.50
keko gr: calls $1.25
bateman225: calls $1
*** FLOP *** [3h Ac Jd]
keko gr: checks 
bateman225: checks 
Xamil666: checks 
pirog766: checks 
*** TURN *** [3h Ac Jd] [6h]
aaahaaa1967 is disconnected 
keko gr: bets $3.80
bateman225: folds 
Xamil666: folds 
pirog766: calls $3.80
*** RIVER *** [3h Ac Jd 6h] [Th]
keko gr: bets $6.46
pirog766: folds 
Uncalled bet ($6.46) returned to keko gr
keko gr collected $12.92 from pot
*** SUMMARY ***
Total pot $13.60 | Rake $0.68 
Board [3h Ac Jd 6h Th]
Seat 1: keko gr (small blind) collected ($12.92)
Seat 2: bateman225 (big blind) folded on the Turn
Seat 3: Rulet345 folded before Flop (didn't bet)
Seat 4: aaahaaa1967 folded before Flop (didn't bet)
Seat 5: Xamil666 folded on the Turn
Seat 6: vipbor folded before Flop (didn't bet)
Seat 7: Popokluev folded before Flop (didn't bet)
Seat 8: SwimmingPooI folded before Flop (didn't bet)
Seat 9: pirog766 (button) folded on the River



PokerStars Hand #228688593390:  Hold'em No Limit ($0.25/$0.50 USD) - 2021/07/30 16:30:44 ET
Table 'Bok II' 9-max Seat #1 is the button
Seat 1: keko gr ($74.28 in chips) 
Seat 2: bateman225 ($36.07 in chips) 
Seat 3: Rulet345 ($60.51 in chips) 
Seat 4: aaahaaa1967 ($40.58 in chips) 
Seat 5: Xamil666 ($50 in chips) 
Seat 6: vipbor ($54.42 in chips) 
Seat 7: Popokluev ($50 in chips) 
Seat 8: SwimmingPooI ($85.91 in chips) 
Seat 9: pirog766 ($20.48 in chips) 
bateman225: posts small blind $0.25
Rulet345: posts big blind $0.50
*** HOLE CARDS ***
aaahaaa1967: calls $0.50
Xamil666: folds 
vipbor: folds 
Popokluev: raises $1.75 to $2.25
SwimmingPooI: folds 
pirog766: folds 
keko gr: calls $2.25
bateman225: folds 
Rulet345: folds 
aaahaaa1967: raises $38.33 to $40.58 and is all-in
Popokluev: folds 
keko gr: folds 
Uncalled bet ($38.33) returned to aaahaaa1967
aaahaaa1967 collected $7.50 from pot
aaahaaa1967: doesn't show hand 
*** SUMMARY ***
Total pot $7.50 | Rake $0 
Seat 1: keko gr (button) folded before Flop
Seat 2: bateman225 (small blind) folded before Flop
Seat 3: Rulet345 (big blind) folded before Flop
Seat 4: aaahaaa1967 collected ($7.50)
Seat 5: Xamil666 folded before Flop (didn't bet)
Seat 6: vipbor folded before Flop (didn't bet)
Seat 7: Popokluev folded before Flop
Seat 8: SwimmingPooI folded before Flop (didn't bet)
Seat 9: pirog766 folded before Flop (didn't bet)



PokerStars Hand #228688606157:  Hold'em No Limit ($0.25/$0.50 USD) - 2021/07/30 16:31:10 ET
Table 'Bok II' 9-max Seat #2 is the button
Seat 1: keko gr ($72.03 in chips) 
Seat 2: bateman225 ($35.82 in chips) 
Seat 3: Rulet345 ($60.01 in chips) 
Seat 4: aaahaaa1967 ($45.83 in chips) 
Seat 5: Xamil666 ($50 in chips) 
Seat 7: Popokluev ($50 in chips) 
Seat 8: SwimmingPooI ($85.91 in chips) 
Seat 9: pirog766 ($20.48 in chips) 
Rulet345: posts small blind $0.25
aaahaaa1967: posts big blind $0.50
*** HOLE CARDS ***
Xamil666: raises $1 to $1.50
Popokluev: folds 
SwimmingPooI: folds 
pirog766: folds 
keko gr: folds 
bateman225: folds 
Rulet345: folds 
aaahaaa1967: folds 
Uncalled bet ($1) returned to Xamil666
Xamil666 collected $1.25 from pot
*** SUMMARY ***
Total pot $1.25 | Rake $0 
Seat 1: keko gr folded before Flop (didn't bet)
Seat 2: bateman225 (button) folded before Flop (didn't bet)
Seat 3: Rulet345 (small blind) folded before Flop
Seat 4: aaahaaa1967 (big blind) folded before Flop
Seat 5: Xamil666 collected ($1.25)
Seat 7: Popokluev folded before Flop (didn't bet)
Seat 8: SwimmingPooI folded before Flop (didn't bet)
Seat 9: pirog766 folded before Flop (didn't bet)



PokerStars Hand #228688611461:  Hold'em No Limit ($0.25/$0.50 USD) - 2021/07/30 16:31:21 ET
Table 'Bok II' 9-max Seat #3 is the button
Seat 1: keko gr ($72.03 in chips) 
Seat 2: bateman225 ($35.82 in chips) 
Seat 3: Rulet345 ($59.76 in chips) 
Seat 4: aaahaaa1967 ($45.33 in chips) 
Seat 5: Xamil666 ($50.75 in chips) 
Seat 7: Popokluev ($50 in chips) 
Seat 8: SwimmingPooI ($85.91 in chips) 
Seat 9: pirog766 ($20.48 in chips) 
aaahaaa1967: posts small blind $0.25
Xamil666: posts big blind $0.50
*** HOLE CARDS ***
Popokluev: folds 
SwimmingPooI: folds 
pirog766: folds 
keko gr: folds 
bateman225: folds 
Rulet345: raises $0.75 to $1.25
aaahaaa1967: folds 
Xamil666: folds 
Uncalled bet ($0.75) returned to Rulet345
Rulet345 collected $1.25 from pot
Rulet345: doesn't show hand 
*** SUMMARY ***
Total pot $1.25 | Rake $0 
Seat 1: keko gr folded before Flop (didn't bet)
Seat 2: bateman225 folded before Flop (didn't bet)
Seat 3: Rulet345 (button) collected ($1.25)
Seat 4: aaahaaa1967 (small blind) folded before Flop
Seat 5: Xamil666 (big blind) folded before Flop
Seat 7: Popokluev folded before Flop (didn't bet)
Seat 8: SwimmingPooI folded before Flop (didn't bet)
Seat 9: pirog766 folded before Flop (didn't bet)



PokerStars Hand #228688617877:  Hold'em No Limit ($0.25/$0.50 USD) - 2021/07/30 16:31:34 ET
Table 'Bok II' 9-max Seat #4 is the button
Seat 1: keko gr ($72.03 in chips) 
Seat 2: bateman225 ($35.82 in chips) 
Seat 3: Rulet345 ($60.51 in chips) 
Seat 4: aaahaaa1967 ($45.08 in chips) 
Seat 5: Xamil666 ($50.25 in chips) 
Seat 7: Popokluev ($50 in chips) 
Seat 8: SwimmingPooI ($85.91 in chips) 
Seat 9: pirog766 ($20.48 in chips) 
Xamil666: posts small blind $0.25
Popokluev: posts big blind $0.50
*** HOLE CARDS ***
SwimmingPooI: folds 
pirog766: raises $0.50 to $1
keko gr: folds 
bateman225: calls $1
Rulet345: folds 
aaahaaa1967: folds 
Xamil666: folds 
Popokluev: folds 
*** FLOP *** [2d Ks 8s]
pirog766: bets $1.30
bateman225: calls $1.30
*** TURN *** [2d Ks 8s] [5h]
pirog766: bets $2.54
bateman225: calls $2.54
*** RIVER *** [2d Ks 8s 5h] [5d]
pirog766: bets $4.95
bateman225: folds 
Uncalled bet ($4.95) returned to pirog766
pirog766 collected $9.91 from pot
pirog766: doesn't show hand 
*** SUMMARY ***
Total pot $10.43 | Rake $0.52 
Board [2d Ks 8s 5h 5d]
Seat 1: keko gr folded before Flop (didn't bet)
Seat 2: bateman225 folded on the River
Seat 3: Rulet345 folded before Flop (didn't bet)
Seat 4: aaahaaa1967 (button) folded before Flop (didn't bet)
Seat 5: Xamil666 (small blind) folded before Flop
Seat 7: Popokluev (big blind) folded before Flop
Seat 8: SwimmingPooI folded before Flop (didn't bet)
Seat 9: pirog766 collected ($9.91)



PokerStars Hand #228688634502:  Hold'em No Limit ($0.25/$0.50 USD) - 2021/07/30 16:32:05 ET
Table 'Bok II' 9-max Seat #5 is the button
Seat 1: keko gr ($72.03 in chips) 
Seat 2: bateman225 ($30.98 in chips) 
Seat 3: Rulet345 ($60.51 in chips) 
Seat 4: aaahaaa1967 ($45.08 in chips) 
Seat 5: Xamil666 ($50 in chips) 
Seat 7: Popokluev ($50 in chips) 
Seat 8: SwimmingPooI ($85.91 in chips) 
Seat 9: pirog766 ($25.55 in chips) 
Popokluev: posts small blind $0.25
SwimmingPooI: posts big blind $0.50
*** HOLE CARDS ***
pirog766: folds 
keko gr: folds 
bateman225: folds 
Rulet345: raises $1 to $1.50
aaahaaa1967: folds 
Xamil666: folds 
Popokluev: raises $4.01 to $5.51
SwimmingPooI: folds 
Rulet345: folds 
Uncalled bet ($4.01) returned to Popokluev
Popokluev collected $3.50 from pot
Popokluev: doesn't show hand 
*** SUMMARY ***
Total pot $3.50 | Rake $0 
Seat 1: keko gr folded before Flop (didn't bet)
Seat 2: bateman225 folded before Flop (didn't bet)
Seat 3: Rulet345 folded before Flop
Seat 4: aaahaaa1967 folded before Flop (didn't bet)
Seat 5: Xamil666 (button) folded before Flop (didn't bet)
Seat 7: Popokluev (small blind) collected ($3.50)
Seat 8: SwimmingPooI (big blind) folded before Flop
Seat 9: pirog766 folded before Flop (didn't bet)



PokerStars Hand #228688649310:  Hold'em No Limit ($0.25/$0.50 USD) - 2021/07/30 16:32:35 ET
Table 'Bok II' 9-max Seat #7 is the button
Seat 1: keko gr ($72.03 in chips) 
Seat 2: bateman225 ($30.98 in chips) 
Seat 3: Rulet345 ($59.01 in chips) 
Seat 4: aaahaaa1967 ($45.08 in chips) 
Seat 5: Xamil666 ($50 in chips) 
Seat 7: Popokluev ($52 in chips) 
Seat 8: SwimmingPooI ($85.41 in chips) 
Seat 9: pirog766 ($25.55 in chips) 
SwimmingPooI: posts small blind $0.25
pirog766: posts big blind $0.50
*** HOLE CARDS ***
keko gr: folds 
bateman225: raises $0.50 to $1
Rulet345: folds 
aaahaaa1967: folds 
Xamil666: folds 
Popokluev: folds 
SwimmingPooI: folds 
pirog766: folds 
Uncalled bet ($0.50) returned to bateman225
bateman225 collected $1.25 from pot
bateman225: doesn't show hand 
*** SUMMARY ***
Total pot $1.25 | Rake $0 
Seat 1: keko gr folded before Flop (didn't bet)
Seat 2: bateman225 collected ($1.25)
Seat 3: Rulet345 folded before Flop (didn't bet)
Seat 4: aaahaaa1967 folded before Flop (didn't bet)
Seat 5: Xamil666 folded before Flop (didn't bet)
Seat 7: Popokluev (button) folded before Flop (didn't bet)
Seat 8: SwimmingPooI (small blind) folded before Flop
Seat 9: pirog766 (big blind) folded before Flop



PokerStars Hand #228688837414:  Hold'em No Limit ($0.25/$0.50 USD) - 2021/07/30 16:39:08 ET
Table 'Bok II' 9-max Seat #3 is the button
Seat 1: keko gr ($58.03 in chips) 
Seat 2: bateman225 ($38.23 in chips) 
Seat 3: Rulet345 ($53.46 in chips) 
Seat 4: ssorinacho92 ($84.87 in chips) 
Seat 5: wildermorph ($50 in chips) 
Seat 6: vipbor ($53.67 in chips) 
Seat 8: SwimmingPooI ($92.21 in chips) 
ssorinacho92: posts small blind $0.25
wildermorph: posts big blind $0.50
Dragonclawss: sits out 
*** HOLE CARDS ***
vipbor: folds 
SwimmingPooI: folds 
keko gr: folds 
bateman225: calls $0.50
Rulet345: folds 
ssorinacho92: raises $2 to $2.50
wildermorph: folds 
bateman225: folds 
Uncalled bet ($2) returned to ssorinacho92
ssorinacho92 collected $1.50 from pot
ssorinacho92: doesn't show hand 
*** SUMMARY ***
Total pot $1.50 | Rake $0 
Seat 1: keko gr folded before Flop (didn't bet)
Seat 2: bateman225 folded before Flop
Seat 3: Rulet345 (button) folded before Flop (didn't bet)
Seat 4: ssorinacho92 (small blind) collected ($1.50)
Seat 5: wildermorph (big blind) folded before Flop
Seat 6: vipbor folded before Flop (didn't bet)
Seat 8: SwimmingPooI folded before Flop (didn't bet)



PokerStars Hand #228688846556:  Hold'em No Limit ($0.25/$0.50 USD) - 2021/07/30 16:39:27 ET
Table 'Bok II' 9-max Seat #4 is the button
Seat 1: keko gr ($58.03 in chips) 
Seat 2: bateman225 ($37.73 in chips) 
Seat 3: Rulet345 ($53.46 in chips) 
Seat 4: ssorinacho92 ($85.87 in chips) 
Seat 5: wildermorph ($49.50 in chips) 
Seat 6: vipbor ($53.67 in chips) 
Seat 8: SwimmingPooI ($92.21 in chips) 
wildermorph: posts small blind $0.25
vipbor: posts big blind $0.50
Dragonclawss: sits out 
*** HOLE CARDS ***
SwimmingPooI: folds 
keko gr: folds 
bateman225: calls $0.50
Rulet345: folds 
ssorinacho92: folds 
wildermorph: folds 
vipbor: checks 
*** FLOP *** [7c 7h Th]
vipbor: checks 
bateman225: bets $0.50
vipbor: folds 
Uncalled bet ($0.50) returned to bateman225
bateman225 collected $1.19 from pot
bateman225: doesn't show hand 
*** SUMMARY ***
Total pot $1.25 | Rake $0.06 
Board [7c 7h Th]
Seat 1: keko gr folded before Flop (didn't bet)
Seat 2: bateman225 collected ($1.19)
Seat 3: Rulet345 folded before Flop (didn't bet)
Seat 4: ssorinacho92 (button) folded before Flop (didn't bet)
Seat 5: wildermorph (small blind) folded before Flop
Seat 6: vipbor (big blind) folded on the Flop
Seat 8: SwimmingPooI folded before Flop (didn't bet)



PokerStars Hand #228688970436:  Hold'em No Limit ($0.25/$0.50 USD) - 2021/07/30 16:43:42 ET
Table 'Bok II' 9-max Seat #3 is the button
Seat 1: keko gr ($55.28 in chips) 
Seat 2: bateman225 ($37.17 in chips) 
Seat 3: Rulet345 ($50 in chips) 
Seat 4: ssorinacho92 ($85.37 in chips) 
Seat 5: wildermorph ($49.25 in chips) 
Seat 6: vipbor ($105.34 in chips) 
Seat 7: Dragonclawss ($50 in chips) 
Seat 8: SwimmingPooI ($96.63 in chips) 
ssorinacho92: posts small blind $0.25
wildermorph: posts big blind $0.50
*** HOLE CARDS ***
vipbor: raises $0.75 to $1.25
Dragonclawss: folds 
SwimmingPooI: folds 
keko gr: folds 
bateman225: calls $1.25
Rulet345: folds 
ssorinacho92: folds 
wildermorph: folds 
*** FLOP *** [7d 7c Ac]
vipbor: checks 
bateman225: checks 
*** TURN *** [7d 7c Ac] [7s]
vipbor: bets $1.70
bateman225: folds 
Uncalled bet ($1.70) returned to vipbor
vipbor collected $3.09 from pot
*** SUMMARY ***
Total pot $3.25 | Rake $0.16 
Board [7d 7c Ac 7s]
Seat 1: keko gr folded before Flop (didn't bet)
Seat 2: bateman225 folded on the Turn
Seat 3: Rulet345 (button) folded before Flop (didn't bet)
Seat 4: ssorinacho92 (small blind) folded before Flop
Seat 5: wildermorph (big blind) folded before Flop
Seat 6: vipbor collected ($3.09)
Seat 7: Dragonclawss folded before Flop (didn't bet)
Seat 8: SwimmingPooI folded before Flop (didn't bet)



PokerStars Hand #228689085814:  Hold'em No Limit ($0.25/$0.50 USD) - 2021/07/30 16:47:25 ET
Table 'Bok II' 9-max Seat #2 is the button
Seat 2: bateman225 ($33.67 in chips) 
Seat 3: Rulet345 ($50 in chips) 
Seat 4: ssorinacho92 ($96.40 in chips) 
Seat 5: wildermorph ($51.25 in chips) 
Seat 6: vipbor ($107.18 in chips) 
Seat 7: Freak380 ($49.50 in chips) 
Seat 8: SwimmingPooI ($89.07 in chips) 
Seat 9: Chev_030 ($30 in chips) 
Rulet345: posts small blind $0.25
ssorinacho92: posts big blind $0.50
Chev_030: posts big blind $0.50
*** HOLE CARDS ***
wildermorph: folds 
vipbor: folds 
Freak380: calls $0.50
SwimmingPooI: folds 
Chev_030: checks 
bateman225: raises $1.50 to $2
Rulet345: folds 
ssorinacho92: folds 
Freak380: calls $1.50
Chev_030: folds 
*** FLOP *** [9d 6c 9c]
Freak380: checks 
bateman225: bets $3
Freak380: folds 
Uncalled bet ($3) returned to bateman225
bateman225 collected $4.99 from pot
bateman225: doesn't show hand 
*** SUMMARY ***
Total pot $5.25 | Rake $0.26 
Board [9d 6c 9c]
Seat 2: bateman225 (button) collected ($4.99)
Seat 3: Rulet345 (small blind) folded before Flop
Seat 4: ssorinacho92 (big blind) folded before Flop
Seat 5: wildermorph folded before Flop (didn't bet)
Seat 6: vipbor folded before Flop (didn't bet)
Seat 7: Freak380 folded on the Flop
Seat 8: SwimmingPooI folded before Flop (didn't bet)
Seat 9: Chev_030 folded before Flop (didn't bet)



PokerStars Hand #228689110435:  Hold'em No Limit ($0.25/$0.50 USD) - 2021/07/30 16:48:17 ET
Table 'Bok II' 9-max Seat #3 is the button
Seat 2: bateman225 ($36.66 in chips) 
Seat 3: Rulet345 ($50 in chips) 
Seat 4: ssorinacho92 ($95.90 in chips) 
Seat 5: wildermorph ($51.25 in chips) 
Seat 6: vipbor ($107.18 in chips) 
Seat 7: Freak380 ($47.50 in chips) 
Seat 8: SwimmingPooI ($89.07 in chips) 
Seat 9: Chev_030 ($29.50 in chips) 
ssorinacho92: posts small blind $0.25
wildermorph: posts big blind $0.50
*** HOLE CARDS ***
vipbor: folds 
Freak380: calls $0.50
SwimmingPooI: folds 
Chev_030: folds 
bateman225: folds 
Rulet345: folds 
ssorinacho92: folds 
wildermorph: checks 
*** FLOP *** [Js 8h 6h]
wildermorph: checks 
Freak380: checks 
*** TURN *** [Js 8h 6h] [5c]
wildermorph: checks 
Freak380: checks 
*** RIVER *** [Js 8h 6h 5c] [5h]
wildermorph: checks 
Freak380: checks 
*** SHOW DOWN ***
wildermorph: shows [9d Ts] (a pair of Fives)
Freak380: shows [3s As] (a pair of Fives - Ace kicker)
Freak380 collected $1.17 from pot
*** SUMMARY ***
Total pot $1.25 | Rake $0.08 
Board [Js 8h 6h 5c 5h]
Seat 2: bateman225 folded before Flop (didn't bet)
Seat 3: Rulet345 (button) folded before Flop (didn't bet)
Seat 4: ssorinacho92 (small blind) folded before Flop
Seat 5: wildermorph (big blind) showed [9d Ts] and lost with a pair of Fives
Seat 6: vipbor folded before Flop (didn't bet)
Seat 7: Freak380 showed [3s As] and won ($1.17) with a pair of Fives
Seat 8: SwimmingPooI folded before Flop (didn't bet)
Seat 9: Chev_030 folded before Flop (didn't bet)



PokerStars Hand #228689134434:  Hold'em No Limit ($0.25/$0.50 USD) - 2021/07/30 16:49:07 ET
Table 'Bok II' 9-max Seat #4 is the button
Seat 2: bateman225 ($36.66 in chips) 
Seat 3: Rulet345 ($50 in chips) 
Seat 4: ssorinacho92 ($95.65 in chips) 
Seat 5: wildermorph ($50.75 in chips) 
Seat 6: vipbor ($107.18 in chips) 
Seat 7: Freak380 ($48.17 in chips) 
Seat 8: SwimmingPooI ($89.07 in chips) 
Seat 9: Chev_030 ($29.50 in chips) 
wildermorph: posts small blind $0.25
vipbor: posts big blind $0.50
*** HOLE CARDS ***
Freak380: raises $0.50 to $1
SwimmingPooI: folds 
Chev_030: folds 
bateman225: folds 
Rulet345: folds 
ssorinacho92: folds 
wildermorph: folds 
vipbor: calls $0.50
*** FLOP *** [Ah Kc 5s]
vipbor: checks 
Freak380: checks 
*** TURN *** [Ah Kc 5s] [Td]
vipbor: checks 
Freak380: checks 
*** RIVER *** [Ah Kc 5s Td] [Js]
vipbor: checks 
Freak380: checks 
*** SHOW DOWN ***
vipbor: shows [9h Tc] (a pair of Tens)
Freak380: mucks hand 
vipbor collected $2.14 from pot
*** SUMMARY ***
Total pot $2.25 | Rake $0.11 
Board [Ah Kc 5s Td Js]
Seat 2: bateman225 folded before Flop (didn't bet)
Seat 3: Rulet345 folded before Flop (didn't bet)
Seat 4: ssorinacho92 (button) folded before Flop (didn't bet)
Seat 5: wildermorph (small blind) folded before Flop
Seat 6: vipbor (big blind) showed [9h Tc] and won ($2.14) with a pair of Tens
Seat 7: Freak380 mucked
Seat 8: SwimmingPooI folded before Flop (didn't bet)
Seat 9: Chev_030 folded before Flop (didn't bet)



PokerStars Hand #228689169413:  Hold'em No Limit ($0.25/$0.50 USD) - 2021/07/30 16:50:20 ET
Table 'Bok II' 9-max Seat #5 is the button
Seat 2: bateman225 ($36.66 in chips) 
Seat 3: Rulet345 ($50 in chips) 
Seat 4: ssorinacho92 ($95.65 in chips) 
Seat 5: wildermorph ($50.50 in chips) 
Seat 6: vipbor ($108.32 in chips) 
Seat 7: Freak380 ($47.17 in chips) 
Seat 8: SwimmingPooI ($89.07 in chips) 
Seat 9: Chev_030 ($29.50 in chips) 
vipbor: posts small blind $0.25
Freak380: posts big blind $0.50
*** HOLE CARDS ***
SwimmingPooI: folds 
Chev_030: folds 
bateman225: folds 
Rulet345: folds 
ssorinacho92: raises $0.75 to $1.25
wildermorph: folds 
vipbor: folds 
Chev_030 leaves the table
Freak380: calls $0.75
*** FLOP *** [Tc 4d 6h]
Freak380: bets $1.50
ssorinacho92: calls $1.50
*** TURN *** [Tc 4d 6h] [Ah]
Freak380: bets $3
ssorinacho92: calls $3
*** RIVER *** [Tc 4d 6h Ah] [6s]
Freak380: bets $5
ssorinacho92: calls $5
*** SHOW DOWN ***
Freak380: shows [Th 8d] (two pair, Tens and Sixes)
ssorinacho92: shows [Js Td] (two pair, Tens and Sixes)
Freak380 collected $10.19 from pot
ssorinacho92 collected $10.33 from pot
*** SUMMARY ***
Total pot $21.75 | Rake $1.23 
Board [Tc 4d 6h Ah 6s]
Seat 2: bateman225 folded before Flop (didn't bet)
Seat 3: Rulet345 folded before Flop (didn't bet)
Seat 4: ssorinacho92 showed [Js Td] and won ($10.33) with two pair, Tens and Sixes
Seat 5: wildermorph (button) folded before Flop (didn't bet)
Seat 6: vipbor (small blind) folded before Flop
Seat 7: Freak380 (big blind) showed [Th 8d] and won ($10.19) with two pair, Tens and Sixes
Seat 8: SwimmingPooI folded before Flop (didn't bet)
Seat 9: Chev_030 folded before Flop (didn't bet)



PokerStars Hand #228689193797:  Hold'em No Limit ($0.25/$0.50 USD) - 2021/07/30 16:51:10 ET
Table 'Bok II' 9-max Seat #6 is the button
Seat 2: bateman225 ($36.66 in chips) 
Seat 3: Rulet345 ($50 in chips) 
Seat 4: ssorinacho92 ($95.23 in chips) 
Seat 5: wildermorph ($50.50 in chips) 
Seat 6: vipbor ($108.07 in chips) 
Seat 7: Freak380 ($46.61 in chips) 
Seat 8: SwimmingPooI ($89.07 in chips) 
Freak380: posts small blind $0.25
SwimmingPooI: posts big blind $0.50
*** HOLE CARDS ***
bateman225: folds 
Rulet345: folds 
ssorinacho92: folds 
wildermorph: folds 
vipbor: folds 
Lavitadi joins the table at seat #9 
Freak380: raises $1 to $1.50
SwimmingPooI: folds 
Uncalled bet ($1) returned to Freak380
Freak380 collected $1 from pot
*** SUMMARY ***
Total pot $1 | Rake $0 
Seat 2: bateman225 folded before Flop (didn't bet)
Seat 3: Rulet345 folded before Flop (didn't bet)
Seat 4: ssorinacho92 folded before Flop (didn't bet)
Seat 5: wildermorph folded before Flop (didn't bet)
Seat 6: vipbor (button) folded before Flop (didn't bet)
Seat 7: Freak380 (small blind) collected ($1)
Seat 8: SwimmingPooI (big blind) folded before Flop



PokerStars Hand #228689206772:  Hold'em No Limit ($0.25/$0.50 USD) - 2021/07/30 16:51:37 ET
Table 'Bok II' 9-max Seat #7 is the button
Seat 2: bateman225 ($36.66 in chips) 
Seat 3: Rulet345 ($50 in chips) 
Seat 4: ssorinacho92 ($95.23 in chips) 
Seat 5: wildermorph ($50.50 in chips) 
Seat 6: vipbor ($108.07 in chips) 
Seat 7: Freak380 ($47.11 in chips) 
Seat 8: SwimmingPooI ($88.57 in chips) 
Seat 9: Lavitadi ($50 in chips) 
SwimmingPooI: posts small blind $0.25
Lavitadi: posts big blind $0.50
keko gr: sits out 
*** HOLE CARDS ***
bateman225: folds 
Rulet345: folds 
ssorinacho92: folds 
wildermorph: folds 
vipbor: folds 
Freak380: raises $0.50 to $1
SwimmingPooI: folds 
Lavitadi: folds 
Uncalled bet ($0.50) returned to Freak380
Freak380 collected $1.25 from pot
*** SUMMARY ***
Total pot $1.25 | Rake $0 
Seat 2: bateman225 folded before Flop (didn't bet)
Seat 3: Rulet345 folded before Flop (didn't bet)
Seat 4: ssorinacho92 folded before Flop (didn't bet)
Seat 5: wildermorph folded before Flop (didn't bet)
Seat 6: vipbor folded before Flop (didn't bet)
Seat 7: Freak380 (button) collected ($1.25)
Seat 8: SwimmingPooI (small blind) folded before Flop
Seat 9: Lavitadi (big blind) folded before Flop



PokerStars Hand #228689217998:  Hold'em No Limit ($0.25/$0.50 USD) - 2021/07/30 16:52:01 ET
Table 'Bok II' 9-max Seat #8 is the button
Seat 1: keko gr ($55.28 in chips) 
Seat 2: bateman225 ($36.66 in chips) 
Seat 3: Rulet345 ($50 in chips) 
Seat 4: ssorinacho92 ($95.23 in chips) 
Seat 5: wildermorph ($50.50 in chips) 
Seat 6: vipbor ($108.07 in chips) 
Seat 7: Freak380 ($47.86 in chips) 
Seat 8: SwimmingPooI ($88.32 in chips) 
Seat 9: Lavitadi ($49.50 in chips) 
Lavitadi: posts small blind $0.25
keko gr: posts big blind $0.50
*** HOLE CARDS ***
bateman225: folds 
Rulet345: folds 
ssorinacho92: raises $0.75 to $1.25
wildermorph: folds 
vipbor: folds 
Freak380: folds 
SwimmingPooI: raises $3.75 to $5
Lavitadi: folds 
keko gr: folds 
ssorinacho92: folds 
Uncalled bet ($3.75) returned to SwimmingPooI
SwimmingPooI collected $3.25 from pot
SwimmingPooI: doesn't show hand 
*** SUMMARY ***
Total pot $3.25 | Rake $0 
Seat 1: keko gr (big blind) folded before Flop
Seat 2: bateman225 folded before Flop (didn't bet)
Seat 3: Rulet345 folded before Flop (didn't bet)
Seat 4: ssorinacho92 folded before Flop
Seat 5: wildermorph folded before Flop (didn't bet)
Seat 6: vipbor folded before Flop (didn't bet)
Seat 7: Freak380 folded before Flop (didn't bet)
Seat 8: SwimmingPooI (button) collected ($3.25)
Seat 9: Lavitadi (small blind) folded before Flop



PokerStars Hand #228689230168:  Hold'em No Limit ($0.25/$0.50 USD) - 2021/07/30 16:52:26 ET
Table 'Bok II' 9-max Seat #9 is the button
Seat 1: keko gr ($54.78 in chips) 
Seat 2: bateman225 ($36.66 in chips) 
Seat 3: Rulet345 ($50 in chips) 
Seat 4: ssorinacho92 ($93.98 in chips) 
Seat 5: wildermorph ($50.50 in chips) 
Seat 6: vipbor ($108.07 in chips) 
Seat 7: Freak380 ($47.86 in chips) 
Seat 8: SwimmingPooI ($90.32 in chips) 
Seat 9: Lavitadi ($49.25 in chips) 
keko gr: posts small blind $0.25
bateman225: posts big blind $0.50
*** HOLE CARDS ***
Rulet345: folds 
ssorinacho92: folds 
wildermorph: raises $0.50 to $1
vipbor: raises $3.50 to $4.50
Freak380: folds 
SwimmingPooI: folds 
Lavitadi: folds 
keko gr: folds 
bateman225: folds 
wildermorph: folds 
Uncalled bet ($3.50) returned to vipbor
vipbor collected $2.75 from pot
*** SUMMARY ***
Total pot $2.75 | Rake $0 
Seat 1: keko gr (small blind) folded before Flop
Seat 2: bateman225 (big blind) folded before Flop
Seat 3: Rulet345 folded before Flop (didn't bet)
Seat 4: ssorinacho92 folded before Flop (didn't bet)
Seat 5: wildermorph folded before Flop
Seat 6: vipbor collected ($2.75)
Seat 7: Freak380 folded before Flop (didn't bet)
Seat 8: SwimmingPooI folded before Flop (didn't bet)
Seat 9: Lavitadi (button) folded before Flop (didn't bet)



PokerStars Hand #228689246339:  Hold'em No Limit ($0.25/$0.50 USD) - 2021/07/30 16:53:00 ET
Table 'Bok II' 9-max Seat #1 is the button
Seat 1: keko gr ($54.53 in chips) 
Seat 2: bateman225 ($36.16 in chips) 
Seat 3: Rulet345 ($50 in chips) 
Seat 4: ssorinacho92 ($93.98 in chips) 
Seat 5: wildermorph ($49.50 in chips) 
Seat 6: vipbor ($109.82 in chips) 
Seat 7: Freak380 ($47.86 in chips) 
Seat 8: SwimmingPooI ($90.32 in chips) 
Seat 9: Lavitadi ($49.25 in chips) 
bateman225: posts small blind $0.25
Rulet345: posts big blind $0.50
*** HOLE CARDS ***
ssorinacho92: folds 
wildermorph: folds 
vipbor: folds 
Freak380: raises $1 to $1.50
SwimmingPooI: folds 
Lavitadi: folds 
keko gr: folds 
bateman225: folds 
Rulet345: calls $1
*** FLOP *** [Kc Jd 8s]
Rulet345: checks 
Freak380: bets $2
Rulet345: calls $2
*** TURN *** [Kc Jd 8s] [5s]
Rulet345: checks 
Freak380: checks 
*** RIVER *** [Kc Jd 8s 5s] [Ts]
Rulet345: checks 
Freak380: bets $3.50
Rulet345: folds 
Uncalled bet ($3.50) returned to Freak380
Freak380 collected $6.80 from pot
*** SUMMARY ***
Total pot $7.25 | Rake $0.45 
Board [Kc Jd 8s 5s Ts]
Seat 1: keko gr (button) folded before Flop (didn't bet)
Seat 2: bateman225 (small blind) folded before Flop
Seat 3: Rulet345 (big blind) folded on the River
Seat 4: ssorinacho92 folded before Flop (didn't bet)
Seat 5: wildermorph folded before Flop (didn't bet)
Seat 6: vipbor folded before Flop (didn't bet)
Seat 7: Freak380 collected ($6.80)
Seat 8: SwimmingPooI folded before Flop (didn't bet)
Seat 9: Lavitadi folded before Flop (didn't bet)



PokerStars Hand #228689303059:  Hold'em No Limit ($0.25/$0.50 USD) - 2021/07/30 16:54:41 ET
Table 'Bok II' 9-max Seat #2 is the button
Seat 1: keko gr ($54.53 in chips) 
Seat 2: bateman225 ($35.91 in chips) 
Seat 3: Rulet345 ($50 in chips) 
Seat 4: ssorinacho92 ($93.98 in chips) 
Seat 5: wildermorph ($49.50 in chips) 
Seat 6: vipbor ($109.82 in chips) 
Seat 7: Freak380 ($51.16 in chips) 
Seat 8: SwimmingPooI ($90.32 in chips) 
Seat 9: Lavitadi ($49.25 in chips) 
Rulet345: posts small blind $0.25
ssorinacho92: posts big blind $0.50
*** HOLE CARDS ***
wildermorph: folds 
vipbor: folds 
Freak380: calls $0.50
SwimmingPooI: folds 
Lavitadi: folds 
keko gr: folds 
bateman225: folds 
Rulet345: folds 
ssorinacho92: checks 
*** FLOP *** [3h 3c 2c]
ssorinacho92: checks 
Freak380: checks 
*** TURN *** [3h 3c 2c] [6s]
ssorinacho92: checks 
Freak380: bets $0.75
ssorinacho92: folds 
Uncalled bet ($0.75) returned to Freak380
Freak380 collected $1.17 from pot
*** SUMMARY ***
Total pot $1.25 | Rake $0.08 
Board [3h 3c 2c 6s]
Seat 1: keko gr folded before Flop (didn't bet)
Seat 2: bateman225 (button) folded before Flop (didn't bet)
Seat 3: Rulet345 (small blind) folded before Flop
Seat 4: ssorinacho92 (big blind) folded on the Turn
Seat 5: wildermorph folded before Flop (didn't bet)
Seat 6: vipbor folded before Flop (didn't bet)
Seat 7: Freak380 collected ($1.17)
Seat 8: SwimmingPooI folded before Flop (didn't bet)
Seat 9: Lavitadi folded before Flop (didn't bet)



PokerStars Hand #228689325358:  Hold'em No Limit ($0.25/$0.50 USD) - 2021/07/30 16:55:35 ET
Table 'Bok II' 9-max Seat #3 is the button
Seat 1: keko gr ($54.53 in chips) 
Seat 2: bateman225 ($35.91 in chips) 
Seat 3: Rulet345 ($50 in chips) 
Seat 4: ssorinacho92 ($93.48 in chips) 
Seat 5: wildermorph ($49.50 in chips) 
Seat 6: vipbor ($109.82 in chips) 
Seat 7: Freak380 ($51.83 in chips) 
Seat 8: SwimmingPooI ($90.32 in chips) 
Seat 9: Lavitadi ($49.25 in chips) 
ssorinacho92: posts small blind $0.25
wildermorph: posts big blind $0.50
*** HOLE CARDS ***
vipbor: folds 
Freak380: calls $0.50
SwimmingPooI: folds 
Lavitadi: folds 
keko gr: calls $0.50
bateman225: folds 
Rulet345: raises $2.50 to $3
ssorinacho92: folds 
wildermorph: folds 
Freak380: folds 
keko gr: folds 
Uncalled bet ($2.50) returned to Rulet345
Rulet345 collected $2.25 from pot
Rulet345: doesn't show hand 
*** SUMMARY ***
Total pot $2.25 | Rake $0 
Seat 1: keko gr folded before Flop
Seat 2: bateman225 folded before Flop (didn't bet)
Seat 3: Rulet345 (button) collected ($2.25)
Seat 4: ssorinacho92 (small blind) folded before Flop
Seat 5: wildermorph (big blind) folded before Flop
Seat 6: vipbor folded before Flop (didn't bet)
Seat 7: Freak380 folded before Flop
Seat 8: SwimmingPooI folded before Flop (didn't bet)
Seat 9: Lavitadi folded before Flop (didn't bet)



PokerStars Hand #228689338924:  Hold'em No Limit ($0.25/$0.50 USD) - 2021/07/30 16:56:15 ET
Table 'Bok II' 9-max Seat #4 is the button
Seat 1: keko gr ($54.03 in chips) 
Seat 2: bateman225 ($35.91 in chips) 
Seat 3: Rulet345 ($51.75 in chips) 
Seat 4: ssorinacho92 ($93.23 in chips) 
Seat 5: wildermorph ($49 in chips) 
Seat 6: vipbor ($109.82 in chips) 
Seat 7: Freak380 ($51.33 in chips) 
Seat 8: SwimmingPooI ($90.32 in chips) 
Seat 9: Lavitadi ($49.25 in chips) 
wildermorph: posts small blind $0.25
vipbor: posts big blind $0.50
*** HOLE CARDS ***
Freak380: folds 
SwimmingPooI: folds 
Lavitadi: folds 
keko gr: folds 
bateman225: folds 
Rulet345: folds 
ssorinacho92: folds 
wildermorph: folds 
Uncalled bet ($0.25) returned to vipbor
vipbor collected $0.50 from pot
*** SUMMARY ***
Total pot $0.50 | Rake $0 
Seat 1: keko gr folded before Flop (didn't bet)
Seat 2: bateman225 folded before Flop (didn't bet)
Seat 3: Rulet345 folded before Flop (didn't bet)
Seat 4: ssorinacho92 (button) folded before Flop (didn't bet)
Seat 5: wildermorph (small blind) folded before Flop
Seat 6: vipbor (big blind) collected ($0.50)
Seat 7: Freak380 folded before Flop (didn't bet)
Seat 8: SwimmingPooI folded before Flop (didn't bet)
Seat 9: Lavitadi folded before Flop (didn't bet)



PokerStars Hand #228689345296:  Hold'em No Limit ($0.25/$0.50 USD) - 2021/07/30 16:56:34 ET
Table 'Bok II' 9-max Seat #5 is the button
Seat 1: keko gr ($54.03 in chips) 
Seat 2: bateman225 ($35.91 in chips) 
Seat 3: Rulet345 ($51.75 in chips) 
Seat 4: ssorinacho92 ($93.23 in chips) 
Seat 5: wildermorph ($48.75 in chips) 
Seat 6: vipbor ($110.07 in chips) 
Seat 7: Freak380 ($51.33 in chips) 
Seat 8: SwimmingPooI ($90.32 in chips) 
Seat 9: Lavitadi ($49.25 in chips) 
vipbor: posts small blind $0.25
Freak380: posts big blind $0.50
*** HOLE CARDS ***
SwimmingPooI: folds 
Lavitadi: folds 
keko gr: folds 
bateman225: folds 
Rulet345: folds 
ssorinacho92: folds 
wildermorph: folds 
vipbor: folds 
Uncalled bet ($0.25) returned to Freak380
Freak380 collected $0.50 from pot
*** SUMMARY ***
Total pot $0.50 | Rake $0 
Seat 1: keko gr folded before Flop (didn't bet)
Seat 2: bateman225 folded before Flop (didn't bet)
Seat 3: Rulet345 folded before Flop (didn't bet)
Seat 4: ssorinacho92 folded before Flop (didn't bet)
Seat 5: wildermorph (button) folded before Flop (didn't bet)
Seat 6: vipbor (small blind) folded before Flop
Seat 7: Freak380 (big blind) collected ($0.50)
Seat 8: SwimmingPooI folded before Flop (didn't bet)
Seat 9: Lavitadi folded before Flop (didn't bet)



PokerStars Hand #228689351841:  Hold'em No Limit ($0.25/$0.50 USD) - 2021/07/30 16:56:53 ET
Table 'Bok II' 9-max Seat #6 is the button
Seat 1: keko gr ($54.03 in chips) 
Seat 2: bateman225 ($35.91 in chips) 
Seat 3: Rulet345 ($51.75 in chips) 
Seat 4: ssorinacho92 ($93.23 in chips) 
Seat 5: wildermorph ($48.75 in chips) 
Seat 6: vipbor ($109.82 in chips) 
Seat 7: Freak380 ($51.58 in chips) 
Seat 8: SwimmingPooI ($90.32 in chips) 
Seat 9: Lavitadi ($49.25 in chips) 
Freak380: posts small blind $0.25
SwimmingPooI: posts big blind $0.50
*** HOLE CARDS ***
Lavitadi: folds 
keko gr: folds 
bateman225: folds 
Rulet345: folds 
ssorinacho92: folds 
wildermorph: folds 
vipbor: folds 
Freak380: raises $1 to $1.50
SwimmingPooI: folds 
Uncalled bet ($1) returned to Freak380
Freak380 collected $1 from pot
*** SUMMARY ***
Total pot $1 | Rake $0 
Seat 1: keko gr folded before Flop (didn't bet)
Seat 2: bateman225 folded before Flop (didn't bet)
Seat 3: Rulet345 folded before Flop (didn't bet)
Seat 4: ssorinacho92 folded before Flop (didn't bet)
Seat 5: wildermorph folded before Flop (didn't bet)
Seat 6: vipbor (button) folded before Flop (didn't bet)
Seat 7: Freak380 (small blind) collected ($1)
Seat 8: SwimmingPooI (big blind) folded before Flop
Seat 9: Lavitadi folded before Flop (didn't bet)



PokerStars Hand #228689359131:  Hold'em No Limit ($0.25/$0.50 USD) - 2021/07/30 16:57:14 ET
Table 'Bok II' 9-max Seat #7 is the button
Seat 1: keko gr ($54.03 in chips) 
Seat 2: bateman225 ($35.91 in chips) 
Seat 3: Rulet345 ($51.75 in chips) 
Seat 4: ssorinacho92 ($93.23 in chips) 
Seat 5: wildermorph ($48.75 in chips) 
Seat 6: vipbor ($109.82 in chips) 
Seat 7: Freak380 ($52.08 in chips) 
Seat 8: SwimmingPooI ($89.82 in chips) 
Seat 9: Lavitadi ($49.25 in chips) 
SwimmingPooI: posts small blind $0.25
Lavitadi: posts big blind $0.50
*** HOLE CARDS ***
keko gr: folds 
bateman225: folds 
Rulet345: folds 
ssorinacho92: folds 
wildermorph: folds 
vipbor: raises $0.75 to $1.25
Freak380: folds 
SwimmingPooI: folds 
Lavitadi: folds 
Uncalled bet ($0.75) returned to vipbor
vipbor collected $1.25 from pot
*** SUMMARY ***
Total pot $1.25 | Rake $0 
Seat 1: keko gr folded before Flop (didn't bet)
Seat 2: bateman225 folded before Flop (didn't bet)
Seat 3: Rulet345 folded before Flop (didn't bet)
Seat 4: ssorinacho92 folded before Flop (didn't bet)
Seat 5: wildermorph folded before Flop (didn't bet)
Seat 6: vipbor collected ($1.25)
Seat 7: Freak380 (button) folded before Flop (didn't bet)
Seat 8: SwimmingPooI (small blind) folded before Flop
Seat 9: Lavitadi (big blind) folded before Flop



PokerStars Hand #228689365931:  Hold'em No Limit ($0.25/$0.50 USD) - 2021/07/30 16:57:34 ET
Table 'Bok II' 9-max Seat #8 is the button
Seat 1: keko gr ($54.03 in chips) 
Seat 2: bateman225 ($35.91 in chips) 
Seat 3: Rulet345 ($51.75 in chips) 
Seat 4: ssorinacho92 ($93.23 in chips) 
Seat 5: wildermorph ($48.75 in chips) 
Seat 6: vipbor ($110.57 in chips) 
Seat 7: Freak380 ($52.08 in chips) 
Seat 8: SwimmingPooI ($89.57 in chips) 
Seat 9: Lavitadi ($48.75 in chips) 
Lavitadi: posts small blind $0.25
keko gr: posts big blind $0.50
*** HOLE CARDS ***
bateman225: calls $0.50
Rulet345: folds 
ssorinacho92: folds 
wildermorph: folds 
wildermorph leaves the table
vipbor: folds 
Freak380: folds 
SwimmingPooI: folds 
Lavitadi: folds 
keko gr: checks 
*** FLOP *** [7d 5s 2s]
keko gr: checks 
bateman225: bets $0.50
keko gr: calls $0.50
*** TURN *** [7d 5s 2s] [6c]
keko gr: checks 
bateman225: checks 
*** RIVER *** [7d 5s 2s 6c] [6d]
keko gr: bets $1.61
bateman225: calls $1.61
*** SHOW DOWN ***
keko gr: shows [4h 8c] (a straight, Four to Eight)
bateman225: mucks hand 
keko gr collected $5.20 from pot
*** SUMMARY ***
Total pot $5.47 | Rake $0.27 
Board [7d 5s 2s 6c 6d]
Seat 1: keko gr (big blind) showed [4h 8c] and won ($5.20) with a straight, Four to Eight
Seat 2: bateman225 mucked
Seat 3: Rulet345 folded before Flop (didn't bet)
Seat 4: ssorinacho92 folded before Flop (didn't bet)
Seat 5: wildermorph folded before Flop (didn't bet)
Seat 6: vipbor folded before Flop (didn't bet)
Seat 7: Freak380 folded before Flop (didn't bet)
Seat 8: SwimmingPooI (button) folded before Flop (didn't bet)
Seat 9: Lavitadi (small blind) folded before Flop



PokerStars Hand #228689380088:  Hold'em No Limit ($0.25/$0.50 USD) - 2021/07/30 16:58:15 ET
Table 'Bok II' 9-max Seat #9 is the button
Seat 1: keko gr ($56.62 in chips) 
Seat 2: bateman225 ($33.30 in chips) 
Seat 3: Rulet345 ($51.75 in chips) 
Seat 4: ssorinacho92 ($93.23 in chips) 
Seat 6: vipbor ($110.57 in chips) 
Seat 7: Freak380 ($52.08 in chips) 
Seat 8: SwimmingPooI ($89.57 in chips) 
Seat 9: Lavitadi ($48.50 in chips) 
keko gr: posts small blind $0.25
bateman225: posts big blind $0.50
*** HOLE CARDS ***
Rulet345: folds 
Rulet345 leaves the table
ssorinacho92: folds 
vipbor: folds 
Freak380: calls $0.50
SwimmingPooI: folds 
Lavitadi: raises $1.75 to $2.25
keko gr: folds 
bateman225: folds 
Freak380: calls $1.75
*** FLOP *** [3c Kd 8h]
Freak380: checks 
Lavitadi: checks 
*** TURN *** [3c Kd 8h] [6h]
Freak380: bets $2.50
Valadejer joins the table at seat #3 
Lavitadi: folds 
Uncalled bet ($2.50) returned to Freak380
Freak380 collected $4.93 from pot
*** SUMMARY ***
Total pot $5.25 | Rake $0.32 
Board [3c Kd 8h 6h]
Seat 1: keko gr (small blind) folded before Flop
Seat 2: bateman225 (big blind) folded before Flop
Seat 3: Rulet345 folded before Flop (didn't bet)
Seat 4: ssorinacho92 folded before Flop (didn't bet)
Seat 6: vipbor folded before Flop (didn't bet)
Seat 7: Freak380 collected ($4.93)
Seat 8: SwimmingPooI folded before Flop (didn't bet)
Seat 9: Lavitadi (button) folded on the Turn



PokerStars Hand #228689398423:  Hold'em No Limit ($0.25/$0.50 USD) - 2021/07/30 16:59:08 ET
Table 'Bok II' 9-max Seat #1 is the button
Seat 1: keko gr ($56.37 in chips) 
Seat 2: bateman225 ($32.80 in chips) 
Seat 3: Valadejer ($40 in chips) 
Seat 4: ssorinacho92 ($93.23 in chips) 
Seat 6: vipbor ($110.57 in chips) 
Seat 7: Freak380 ($54.76 in chips) 
Seat 9: Lavitadi ($46.25 in chips) 
bateman225: posts small blind $0.25
Valadejer: posts big blind $0.50
*** HOLE CARDS ***
SkapG47 joins the table at seat #5 
ssorinacho92: folds 
vipbor: folds 
Freak380: folds 
Lavitadi: folds 
keko gr: folds 
bateman225: calls $0.25
Valadejer: checks 
*** FLOP *** [4h 7c 5c]
bateman225: checks 
Valadejer: bets $0.50
bateman225: folds 
Uncalled bet ($0.50) returned to Valadejer
Valadejer collected $0.95 from pot
Valadejer: doesn't show hand 
*** SUMMARY ***
Total pot $1 | Rake $0.05 
Board [4h 7c 5c]
Seat 1: keko gr (button) folded before Flop (didn't bet)
Seat 2: bateman225 (small blind) folded on the Flop
Seat 3: Valadejer (big blind) collected ($0.95)
Seat 4: ssorinacho92 folded before Flop (didn't bet)
Seat 6: vipbor folded before Flop (didn't bet)
Seat 7: Freak380 folded before Flop (didn't bet)
Seat 9: Lavitadi folded before Flop (didn't bet)



PokerStars Hand #228689407779:  Hold'em No Limit ($0.25/$0.50 USD) - 2021/07/30 16:59:35 ET
Table 'Bok II' 9-max Seat #2 is the button
Seat 1: keko gr ($56.37 in chips) 
Seat 2: bateman225 ($32.30 in chips) 
Seat 3: Valadejer ($40.45 in chips) 
Seat 4: ssorinacho92 ($93.23 in chips) 
Seat 6: vipbor ($110.57 in chips) 
Seat 7: Freak380 ($54.76 in chips) 
Seat 9: Lavitadi ($46.25 in chips) 
Valadejer: posts small blind $0.25
ssorinacho92: posts big blind $0.50
SkapG47: sits out 
*** HOLE CARDS ***
vipbor: folds 
Freak380: folds 
Lavitadi: folds 
keko gr: folds 
bateman225: folds 
Valadejer: folds 
Uncalled bet ($0.25) returned to ssorinacho92
ssorinacho92 collected $0.50 from pot
ssorinacho92: doesn't show hand 
*** SUMMARY ***
Total pot $0.50 | Rake $0 
Seat 1: keko gr folded before Flop (didn't bet)
Seat 2: bateman225 (button) folded before Flop (didn't bet)
Seat 3: Valadejer (small blind) folded before Flop
Seat 4: ssorinacho92 (big blind) collected ($0.50)
Seat 6: vipbor folded before Flop (didn't bet)
Seat 7: Freak380 folded before Flop (didn't bet)
Seat 9: Lavitadi folded before Flop (didn't bet)



PokerStars Hand #228689411699:  Hold'em No Limit ($0.25/$0.50 USD) - 2021/07/30 16:59:46 ET
Table 'Bok II' 9-max Seat #3 is the button
Seat 1: keko gr ($56.37 in chips) 
Seat 2: bateman225 ($32.30 in chips) 
Seat 3: Valadejer ($40.20 in chips) 
Seat 4: ssorinacho92 ($93.48 in chips) 
Seat 5: SkapG47 ($50 in chips) 
Seat 6: vipbor ($110.57 in chips) 
Seat 7: Freak380 ($54.76 in chips) 
Seat 9: Lavitadi ($46.25 in chips) 
ssorinacho92: posts small blind $0.25
SkapG47: posts big blind $0.50
*** HOLE CARDS ***
vipbor: folds 
Freak380: calls $0.50
Lavitadi: folds 
keko gr: calls $0.50
bateman225: raises $1.50 to $2
Valadejer: calls $2
ssorinacho92: folds 
SkapG47: calls $1.50
Freak380: calls $1.50
keko gr: calls $1.50
*** FLOP *** [Ac 4s Th]
SkapG47: checks 
Freak380: checks 
keko gr: checks 
bateman225: bets $4
Valadejer: calls $4
SkapG47: folds 
Freak380: folds 
keko gr: calls $4
*** TURN *** [Ac 4s Th] [3s]
keko gr: checks 
bateman225: bets $26.30 and is all-in
Valadejer: folds 
keko gr: calls $26.30
*** RIVER *** [Ac 4s Th 3s] [9d]
*** SHOW DOWN ***
keko gr: shows [7s As] (a pair of Aces)
bateman225: shows [4d 3d] (two pair, Fours and Threes)
bateman225 cashed out the hand for $45.89 | Cash Out Fee $0.46
*** SUMMARY ***
Total pot $74.85 | Rake $2 
Board [Ac 4s Th 3s 9d]
Seat 1: keko gr showed [7s As] and lost with a pair of Aces
Seat 2: bateman225 showed [4d 3d] and won ($72.85) with two pair, Fours and Threes (pot not awarded as player cashed out)
Seat 3: Valadejer (button) folded on the Turn
Seat 4: ssorinacho92 (small blind) folded before Flop
Seat 5: SkapG47 (big blind) folded on the Flop
Seat 6: vipbor folded before Flop (didn't bet)
Seat 7: Freak380 folded on the Flop
Seat 9: Lavitadi folded before Flop (didn't bet)



PokerStars Hand #228689445750:  Hold'em No Limit ($0.25/$0.50 USD) - 2021/07/30 17:01:17 ET
Table 'Bok II' 9-max Seat #4 is the button
Seat 1: keko gr ($50 in chips) 
Seat 2: bateman225 ($45.89 in chips) 
Seat 3: Valadejer ($34.20 in chips) 
Seat 4: ssorinacho92 ($93.23 in chips) 
Seat 5: SkapG47 ($48 in chips) 
Seat 6: vipbor ($110.57 in chips) 
Seat 7: Freak380 ($52.76 in chips) 
Seat 9: Lavitadi ($46.25 in chips) 
SkapG47: posts small blind $0.25
vipbor: posts big blind $0.50
*** HOLE CARDS ***
Freak380: folds 
Lavitadi: raises $0.50 to $1
keko gr: raises $3 to $4
bateman225: folds 
Valadejer: raises $3 to $7
ssorinacho92: folds 
SkapG47: folds 
vipbor: folds 
Lavitadi: folds 
keko gr: raises $43 to $50 and is all-in
Valadejer: calls $27.20 and is all-in
Uncalled bet ($15.80) returned to keko gr
*** FLOP *** [Jd 3c Qd]
*** TURN *** [Jd 3c Qd] [7c]
*** RIVER *** [Jd 3c Qd 7c] [Js]
*** SHOW DOWN ***
keko gr: shows [Ac As] (two pair, Aces and Jacks)
Valadejer: shows [Kd Ks] (two pair, Kings and Jacks)
keko gr collected $68.15 from pot
*** SUMMARY ***
Total pot $70.15 | Rake $2 
Board [Jd 3c Qd 7c Js]
Seat 1: keko gr showed [Ac As] and won ($68.15) with two pair, Aces and Jacks
Seat 2: bateman225 folded before Flop (didn't bet)
Seat 3: Valadejer showed [Kd Ks] and lost with two pair, Kings and Jacks
Seat 4: ssorinacho92 (button) folded before Flop (didn't bet)
Seat 5: SkapG47 (small blind) folded before Flop
Seat 6: vipbor (big blind) folded before Flop
Seat 7: Freak380 folded before Flop (didn't bet)
Seat 9: Lavitadi folded before Flop



PokerStars Hand #228689474240:  Hold'em No Limit ($0.25/$0.50 USD) - 2021/07/30 17:02:19 ET
Table 'Bok II' 9-max Seat #5 is the button
Seat 1: keko gr ($83.95 in chips) 
Seat 2: bateman225 ($45.89 in chips) 
Seat 4: ssorinacho92 ($93.23 in chips) 
Seat 5: SkapG47 ($47.75 in chips) 
Seat 6: vipbor ($110.07 in chips) 
Seat 7: Freak380 ($52.76 in chips) 
Seat 9: Lavitadi ($45.25 in chips) 
vipbor: posts small blind $0.25
Freak380: posts big blind $0.50
*** HOLE CARDS ***
Lavitadi: folds 
keko gr: folds 
Valadejer leaves the table
bateman225: folds 
ssorinacho92: folds 
SkapG47: folds 
An1an1 joins the table at seat #3 
vipbor: raises $1 to $1.50
Freak380: calls $1
*** FLOP *** [8s 9c 3c]
vipbor: checks 
Freak380: bets $1.50
vipbor: folds 
Uncalled bet ($1.50) returned to Freak380
Freak380 collected $2.81 from pot
*** SUMMARY ***
Total pot $3 | Rake $0.19 
Board [8s 9c 3c]
Seat 1: keko gr folded before Flop (didn't bet)
Seat 2: bateman225 folded before Flop (didn't bet)
Seat 4: ssorinacho92 folded before Flop (didn't bet)
Seat 5: SkapG47 (button) folded before Flop (didn't bet)
Seat 6: vipbor (small blind) folded on the Flop
Seat 7: Freak380 (big blind) collected ($2.81)
Seat 9: Lavitadi folded before Flop (didn't bet)



PokerStars Hand #228689490915:  Hold'em No Limit ($0.25/$0.50 USD) - 2021/07/30 17:02:56 ET
Table 'Bok II' 9-max Seat #6 is the button
Seat 1: keko gr ($83.95 in chips) 
Seat 2: bateman225 ($45.89 in chips) 
Seat 4: ssorinacho92 ($93.23 in chips) 
Seat 5: SkapG47 ($47.75 in chips) 
Seat 6: vipbor ($108.57 in chips) 
Seat 7: Freak380 ($54.07 in chips) 
Seat 9: Lavitadi ($45.25 in chips) 
Freak380: posts small blind $0.25
Lavitadi: posts big blind $0.50
An1an1: sits out 
*** HOLE CARDS ***
keko gr: folds 
bateman225 has timed out
bateman225: folds 
ssorinacho92: folds 
SkapG47: folds 
vipbor: raises $0.75 to $1.25
Freak380: folds 
Lavitadi: folds 
Uncalled bet ($0.75) returned to vipbor
vipbor collected $1.25 from pot
*** SUMMARY ***
Total pot $1.25 | Rake $0 
Seat 1: keko gr folded before Flop (didn't bet)
Seat 2: bateman225 folded before Flop (didn't bet)
Seat 4: ssorinacho92 folded before Flop (didn't bet)
Seat 5: SkapG47 folded before Flop (didn't bet)
Seat 6: vipbor (button) collected ($1.25)
Seat 7: Freak380 (small blind) folded before Flop
Seat 9: Lavitadi (big blind) folded before Flop



PokerStars Hand #228689508407:  Hold'em No Limit ($0.25/$0.50 USD) - 2021/07/30 17:03:33 ET
Table 'Bok II' 9-max Seat #7 is the button
Seat 1: keko gr ($83.95 in chips) 
Seat 2: bateman225 ($45.89 in chips) 
Seat 4: ssorinacho92 ($93.23 in chips) 
Seat 5: SkapG47 ($47.75 in chips) 
Seat 6: vipbor ($109.32 in chips) 
Seat 7: Freak380 ($53.82 in chips) 
Seat 9: Lavitadi ($44.75 in chips) 
Lavitadi: posts small blind $0.25
keko gr: posts big blind $0.50
An1an1: sits out 
*** HOLE CARDS ***
bateman225: folds 
ssorinacho92: folds 
SkapG47: folds 
vipbor: folds 
Freak380: raises $1 to $1.50
SkapG47 leaves the table
Lavitadi: folds 
keko gr: folds 
Uncalled bet ($1) returned to Freak380
Freak380 collected $1.25 from pot
*** SUMMARY ***
Total pot $1.25 | Rake $0 
Seat 1: keko gr (big blind) folded before Flop
Seat 2: bateman225 folded before Flop (didn't bet)
Seat 4: ssorinacho92 folded before Flop (didn't bet)
Seat 5: SkapG47 folded before Flop (didn't bet)
Seat 6: vipbor folded before Flop (didn't bet)
Seat 7: Freak380 (button) collected ($1.25)
Seat 9: Lavitadi (small blind) folded before Flop



PokerStars Hand #228689525075:  Hold'em No Limit ($0.25/$0.50 USD) - 2021/07/30 17:04:08 ET
Table 'Bok II' 9-max Seat #9 is the button
Seat 1: keko gr ($83.45 in chips) 
Seat 2: bateman225 ($45.89 in chips) 
Seat 4: ssorinacho92 ($93.23 in chips) 
Seat 6: vipbor ($109.32 in chips) 
Seat 7: Freak380 ($54.57 in chips) 
Seat 9: Lavitadi ($44.50 in chips) 
keko gr: posts small blind $0.25
bateman225: posts big blind $0.50
An1an1: sits out 
*** HOLE CARDS ***
ssorinacho92: folds 
vipbor: raises $0.75 to $1.25
An1an1 leaves the table
Freak380: raises $1.25 to $2.50
Lavitadi: calls $2.50
keko gr: folds 
bateman225: folds 
vipbor: calls $1.25
*** FLOP *** [3d Th Qd]
vipbor: checks 
Freak380: bets $4
Lavitadi: folds 
vipbor: folds 
Uncalled bet ($4) returned to Freak380
Freak380 collected $7.74 from pot
*** SUMMARY ***
Total pot $8.25 | Rake $0.51 
Board [3d Th Qd]
Seat 1: keko gr (small blind) folded before Flop
Seat 2: bateman225 (big blind) folded before Flop
Seat 4: ssorinacho92 folded before Flop (didn't bet)
Seat 6: vipbor folded on the Flop
Seat 7: Freak380 collected ($7.74)
Seat 9: Lavitadi (button) folded on the Flop



PokerStars Hand #228689546832:  Hold'em No Limit ($0.25/$0.50 USD) - 2021/07/30 17:04:49 ET
Table 'Bok II' 9-max Seat #1 is the button
Seat 1: keko gr ($83.20 in chips) 
Seat 2: bateman225 ($45.39 in chips) 
Seat 4: ssorinacho92 ($93.23 in chips) 
Seat 6: vipbor ($106.82 in chips) 
Seat 7: Freak380 ($59.81 in chips) 
Seat 9: Lavitadi ($42 in chips) 
bateman225: posts small blind $0.25
ssorinacho92: posts big blind $0.50
SwimmingPooI: sits out 
*** HOLE CARDS ***
vipbor: folds 
Freak380: folds 
Lavitadi: folds 
keko gr: folds 
bateman225: calls $0.25
ssorinacho92: raises $1.50 to $2
bateman225: calls $1.50
*** FLOP *** [8h 4c 3c]
bateman225: checks 
ssorinacho92: bets $2.28
bateman225: folds 
Uncalled bet ($2.28) returned to ssorinacho92
ssorinacho92 collected $3.80 from pot
ssorinacho92: doesn't show hand 
RRBAGGIO77 joins the table at seat #5 
*** SUMMARY ***
Total pot $4 | Rake $0.20 
Board [8h 4c 3c]
Seat 1: keko gr (button) folded before Flop (didn't bet)
Seat 2: bateman225 (small blind) folded on the Flop
Seat 4: ssorinacho92 (big blind) collected ($3.80)
Seat 6: vipbor folded before Flop (didn't bet)
Seat 7: Freak380 folded before Flop (didn't bet)
Seat 9: Lavitadi folded before Flop (didn't bet)



PokerStars Hand #228689560029:  Hold'em No Limit ($0.25/$0.50 USD) - 2021/07/30 17:05:16 ET
Table 'Bok II' 9-max Seat #2 is the button
Seat 1: keko gr ($83.20 in chips) 
Seat 2: bateman225 ($43.39 in chips) 
Seat 4: ssorinacho92 ($95.03 in chips) 
Seat 5: RRBAGGIO77 ($50 in chips) 
Seat 6: vipbor ($106.82 in chips) 
Seat 7: Freak380 ($59.81 in chips) 
Seat 9: Lavitadi ($42 in chips) 
ssorinacho92: posts small blind $0.25
RRBAGGIO77: posts big blind $0.50
SwimmingPooI: sits out 
*** HOLE CARDS ***
vipbor: raises $0.75 to $1.25
Freak380: folds 
ruQx01 joins the table at seat #3 
Lavitadi: folds 
keko gr: folds 
bateman225: folds 
ssorinacho92: folds 
RRBAGGIO77: calls $0.75
*** FLOP *** [8s 9s 7d]
RRBAGGIO77: checks 
vipbor: checks 
*** TURN *** [8s 9s 7d] [Ac]
RRBAGGIO77: checks 
vipbor: bets $2.61
RRBAGGIO77: folds 
Uncalled bet ($2.61) returned to vipbor
vipbor collected $2.61 from pot
*** SUMMARY ***
Total pot $2.75 | Rake $0.14 
Board [8s 9s 7d Ac]
Seat 1: keko gr folded before Flop (didn't bet)
Seat 2: bateman225 (button) folded before Flop (didn't bet)
Seat 4: ssorinacho92 (small blind) folded before Flop
Seat 5: RRBAGGIO77 (big blind) folded on the Turn
Seat 6: vipbor collected ($2.61)
Seat 7: Freak380 folded before Flop (didn't bet)
Seat 9: Lavitadi folded before Flop (didn't bet)



PokerStars Hand #228689579575:  Hold'em No Limit ($0.25/$0.50 USD) - 2021/07/30 17:05:58 ET
Table 'Bok II' 9-max Seat #4 is the button
Seat 1: keko gr ($83.20 in chips) 
Seat 2: bateman225 ($43.39 in chips) 
Seat 4: ssorinacho92 ($94.78 in chips) 
Seat 5: RRBAGGIO77 ($48.75 in chips) 
Seat 6: vipbor ($108.18 in chips) 
Seat 7: Freak380 ($59.81 in chips) 
Seat 9: Lavitadi ($42 in chips) 
RRBAGGIO77: posts small blind $0.25
vipbor: posts big blind $0.50
SwimmingPooI: sits out 
ruQx01: sits out 
*** HOLE CARDS ***
Freak380: folds 
Lavitadi: folds 
keko gr: folds 
bateman225: calls $0.50
ssorinacho92: calls $0.50
RRBAGGIO77: folds 
vipbor: checks 
*** FLOP *** [5s 3c 2d]
vipbor: checks 
bateman225: bets $0.50
ssorinacho92: calls $0.50
vipbor: folds 
*** TURN *** [5s 3c 2d] [5c]
bateman225: checks 
ssorinacho92: checks 
*** RIVER *** [5s 3c 2d 5c] [Kc]
bateman225: checks 
ssorinacho92: checks 
*** SHOW DOWN ***
bateman225: shows [7h Ah] (a pair of Fives)
ssorinacho92: mucks hand 
bateman225 collected $2.61 from pot
*** SUMMARY ***
Total pot $2.75 | Rake $0.14 
Board [5s 3c 2d 5c Kc]
Seat 1: keko gr folded before Flop (didn't bet)
Seat 2: bateman225 showed [7h Ah] and won ($2.61) with a pair of Fives
Seat 4: ssorinacho92 (button) mucked
Seat 5: RRBAGGIO77 (small blind) folded before Flop
Seat 6: vipbor (big blind) folded on the Flop
Seat 7: Freak380 folded before Flop (didn't bet)
Seat 9: Lavitadi folded before Flop (didn't bet)



PokerStars Hand #228689601896:  Hold'em No Limit ($0.25/$0.50 USD) - 2021/07/30 17:06:44 ET
Table 'Bok II' 9-max Seat #5 is the button
Seat 1: keko gr ($83.20 in chips) 
Seat 2: bateman225 ($45 in chips) 
Seat 4: ssorinacho92 ($93.78 in chips) 
Seat 5: RRBAGGIO77 ($48.50 in chips) 
Seat 6: vipbor ($107.68 in chips) 
Seat 7: Freak380 ($59.81 in chips) 
Seat 9: Lavitadi ($42 in chips) 
vipbor: posts small blind $0.25
Freak380: posts big blind $0.50
SwimmingPooI: sits out 
ruQx01: sits out 
*** HOLE CARDS ***
Lavitadi: folds 
keko gr: folds 
bateman225: raises $0.50 to $1
ssorinacho92: folds 
RRBAGGIO77: calls $1
vipbor: folds 
Freak380: calls $0.50
*** FLOP *** [6h 3h 7s]
Freak380: checks 
bateman225: checks 
RRBAGGIO77: checks 
*** TURN *** [6h 3h 7s] [6c]
Freak380: checks 
bateman225: checks 
RRBAGGIO77: checks 
*** RIVER *** [6h 3h 7s 6c] [6s]
Freak380: checks 
bateman225: checks 
RRBAGGIO77: checks 
*** SHOW DOWN ***
Freak380: shows [9d 5c] (three of a kind, Sixes)
bateman225: shows [Tc Qh] (three of a kind, Sixes - Queen kicker)
RRBAGGIO77: mucks hand 
bateman225 collected $3.09 from pot
*** SUMMARY ***
Total pot $3.25 | Rake $0.16 
Board [6h 3h 7s 6c 6s]
Seat 1: keko gr folded before Flop (didn't bet)
Seat 2: bateman225 showed [Tc Qh] and won ($3.09) with three of a kind, Sixes
Seat 4: ssorinacho92 folded before Flop (didn't bet)
Seat 5: RRBAGGIO77 (button) mucked
Seat 6: vipbor (small blind) folded before Flop
Seat 7: Freak380 (big blind) showed [9d 5c] and lost with three of a kind, Sixes
Seat 9: Lavitadi folded before Flop (didn't bet)



PokerStars Hand #228689629164:  Hold'em No Limit ($0.25/$0.50 USD) - 2021/07/30 17:07:42 ET
Table 'Bok II' 9-max Seat #6 is the button
Seat 1: keko gr ($83.20 in chips) 
Seat 2: bateman225 ($47.09 in chips) 
Seat 4: ssorinacho92 ($93.78 in chips) 
Seat 5: RRBAGGIO77 ($47.50 in chips) 
Seat 6: vipbor ($107.43 in chips) 
Seat 7: Freak380 ($58.81 in chips) 
Seat 8: SwimmingPooI ($89.57 in chips) 
Freak380: posts small blind $0.25
SwimmingPooI: posts big blind $0.50
ruQx01: sits out 
*** HOLE CARDS ***
keko gr: folds 
bateman225: folds 
ssorinacho92: folds 
RRBAGGIO77: folds 
vipbor: raises $0.75 to $1.25
Freak380: calls $1
SwimmingPooI: raises $5.25 to $6.50
vipbor: folds 
Freak380: folds 
Uncalled bet ($5.25) returned to SwimmingPooI
SwimmingPooI collected $3.75 from pot
SwimmingPooI: doesn't show hand 
*** SUMMARY ***
Total pot $3.75 | Rake $0 
Seat 1: keko gr folded before Flop (didn't bet)
Seat 2: bateman225 folded before Flop (didn't bet)
Seat 4: ssorinacho92 folded before Flop (didn't bet)
Seat 5: RRBAGGIO77 folded before Flop (didn't bet)
Seat 6: vipbor (button) folded before Flop
Seat 7: Freak380 (small blind) folded before Flop
Seat 8: SwimmingPooI (big blind) collected ($3.75)



PokerStars Hand #228689646390:  Hold'em No Limit ($0.25/$0.50 USD) - 2021/07/30 17:08:18 ET
Table 'Bok II' 9-max Seat #7 is the button
Seat 1: keko gr ($83.20 in chips) 
Seat 2: bateman225 ($47.09 in chips) 
Seat 4: ssorinacho92 ($93.78 in chips) 
Seat 5: RRBAGGIO77 ($47.50 in chips) 
Seat 6: vipbor ($106.18 in chips) 
Seat 7: Freak380 ($57.56 in chips) 
Seat 8: SwimmingPooI ($92.07 in chips) 
SwimmingPooI: posts small blind $0.25
keko gr: posts big blind $0.50
ruQx01: sits out 
*** HOLE CARDS ***
bateman225: calls $0.50
ssorinacho92: folds 
RRBAGGIO77: folds 
vipbor: folds 
Freak380: folds 
SwimmingPooI: raises $2 to $2.50
keko gr: folds 
bateman225: calls $2
*** FLOP *** [9s 8h 5c]
SwimmingPooI: bets $2.66
bateman225: calls $2.66
*** TURN *** [9s 8h 5c] [6h]
SwimmingPooI: checks 
bateman225: bets $3.50
SwimmingPooI: calls $3.50
*** RIVER *** [9s 8h 5c 6h] [7s]
SwimmingPooI: bets $8.50
bateman225: calls $8.50
*** SHOW DOWN ***
SwimmingPooI: shows [7h 7d] (a straight, Five to Nine)
bateman225: shows [Ts 9d] (a straight, Six to Ten)
bateman225 collected $33.08 from pot
*** SUMMARY ***
Total pot $34.82 | Rake $1.74 
Board [9s 8h 5c 6h 7s]
Seat 1: keko gr (big blind) folded before Flop
Seat 2: bateman225 showed [Ts 9d] and won ($33.08) with a straight, Six to Ten
Seat 4: ssorinacho92 folded before Flop (didn't bet)
Seat 5: RRBAGGIO77 folded before Flop (didn't bet)
Seat 6: vipbor folded before Flop (didn't bet)
Seat 7: Freak380 (button) folded before Flop (didn't bet)
Seat 8: SwimmingPooI (small blind) showed [7h 7d] and lost with a straight, Five to Nine



PokerStars Hand #228689671648:  Hold'em No Limit ($0.25/$0.50 USD) - 2021/07/30 17:09:12 ET
Table 'Bok II' 9-max Seat #8 is the button
Seat 1: keko gr ($82.70 in chips) 
Seat 2: bateman225 ($63.01 in chips) 
Seat 4: ssorinacho92 ($93.78 in chips) 
Seat 5: RRBAGGIO77 ($47.50 in chips) 
Seat 6: vipbor ($106.18 in chips) 
Seat 7: Freak380 ($57.56 in chips) 
Seat 8: SwimmingPooI ($74.91 in chips) 
keko gr: posts small blind $0.25
bateman225: posts big blind $0.50
ruQx01: sits out 
*** HOLE CARDS ***
ssorinacho92: folds 
RRBAGGIO77: folds 
vipbor: folds 
Freak380: folds 
SwimmingPooI: folds 
keko gr: folds 
Uncalled bet ($0.25) returned to bateman225
bateman225 collected $0.50 from pot
bateman225: doesn't show hand 
*** SUMMARY ***
Total pot $0.50 | Rake $0 
Seat 1: keko gr (small blind) folded before Flop
Seat 2: bateman225 (big blind) collected ($0.50)
Seat 4: ssorinacho92 folded before Flop (didn't bet)
Seat 5: RRBAGGIO77 folded before Flop (didn't bet)
Seat 6: vipbor folded before Flop (didn't bet)
Seat 7: Freak380 folded before Flop (didn't bet)
Seat 8: SwimmingPooI (button) folded before Flop (didn't bet)



PokerStars Hand #228689676880:  Hold'em No Limit ($0.25/$0.50 USD) - 2021/07/30 17:09:23 ET
Table 'Bok II' 9-max Seat #1 is the button
Seat 1: keko gr ($82.45 in chips) 
Seat 2: bateman225 ($63.26 in chips) 
Seat 3: ruQx01 ($50 in chips) 
Seat 4: ssorinacho92 ($93.78 in chips) 
Seat 5: RRBAGGIO77 ($47.50 in chips) 
Seat 6: vipbor ($106.18 in chips) 
Seat 7: Freak380 ($57.56 in chips) 
Seat 8: SwimmingPooI ($74.91 in chips) 
bateman225: posts small blind $0.25
ruQx01: posts big blind $0.50
*** HOLE CARDS ***
ssorinacho92: folds 
RRBAGGIO77: folds 
vipbor: folds 
Freak380: folds 
SwimmingPooI: folds 
keko gr: folds 
bateman225: folds 
Uncalled bet ($0.25) returned to ruQx01
ruQx01 collected $0.50 from pot
ruQx01: doesn't show hand 
*** SUMMARY ***
Total pot $0.50 | Rake $0 
Seat 1: keko gr (button) folded before Flop (didn't bet)
Seat 2: bateman225 (small blind) folded before Flop
Seat 3: ruQx01 (big blind) collected ($0.50)
Seat 4: ssorinacho92 folded before Flop (didn't bet)
Seat 5: RRBAGGIO77 folded before Flop (didn't bet)
Seat 6: vipbor folded before Flop (didn't bet)
Seat 7: Freak380 folded before Flop (didn't bet)
Seat 8: SwimmingPooI folded before Flop (didn't bet)



PokerStars Hand #228689683980:  Hold'em No Limit ($0.25/$0.50 USD) - 2021/07/30 17:09:39 ET
Table 'Bok II' 9-max Seat #2 is the button
Seat 1: keko gr ($82.45 in chips) 
Seat 2: bateman225 ($63.01 in chips) 
Seat 3: ruQx01 ($50.25 in chips) 
Seat 4: ssorinacho92 ($93.78 in chips) 
Seat 5: RRBAGGIO77 ($47.50 in chips) 
Seat 6: vipbor ($106.18 in chips) 
Seat 7: Freak380 ($57.56 in chips) 
Seat 8: SwimmingPooI ($74.91 in chips) 
ruQx01: posts small blind $0.25
ssorinacho92: posts big blind $0.50
*** HOLE CARDS ***
RRBAGGIO77: calls $0.50
vipbor: folds 
Freak380: folds 
SwimmingPooI: raises $2 to $2.50
keko gr: folds 
bateman225: folds 
ruQx01: folds 
ssorinacho92: folds 
RRBAGGIO77: calls $2
*** FLOP *** [2h Tc 9c]
RRBAGGIO77: bets $3
SwimmingPooI: raises $4.50 to $7.50
RRBAGGIO77: folds 
Uncalled bet ($4.50) returned to SwimmingPooI
SwimmingPooI collected $11.16 from pot
SwimmingPooI: doesn't show hand 
*** SUMMARY ***
Total pot $11.75 | Rake $0.59 
Board [2h Tc 9c]
Seat 1: keko gr folded before Flop (didn't bet)
Seat 2: bateman225 (button) folded before Flop (didn't bet)
Seat 3: ruQx01 (small blind) folded before Flop
Seat 4: ssorinacho92 (big blind) folded before Flop
Seat 5: RRBAGGIO77 folded on the Flop
Seat 6: vipbor folded before Flop (didn't bet)
Seat 7: Freak380 folded before Flop (didn't bet)
Seat 8: SwimmingPooI collected ($11.16)



PokerStars Hand #228689706737:  Hold'em No Limit ($0.25/$0.50 USD) - 2021/07/30 17:10:27 ET
Table 'Bok II' 9-max Seat #3 is the button
Seat 1: keko gr ($82.45 in chips) 
Seat 2: bateman225 ($63.01 in chips) 
Seat 3: ruQx01 ($50 in chips) 
Seat 4: ssorinacho92 ($93.28 in chips) 
Seat 5: RRBAGGIO77 ($42 in chips) 
Seat 6: vipbor ($106.18 in chips) 
Seat 7: Freak380 ($57.56 in chips) 
Seat 8: SwimmingPooI ($80.57 in chips) 
ssorinacho92: posts small blind $0.25
RRBAGGIO77: posts big blind $0.50
*** HOLE CARDS ***
vipbor: folds 
Freak380: folds 
SwimmingPooI: folds 
keko gr: raises $0.50 to $1
bateman225: calls $1
ruQx01: folds 
ssorinacho92: folds 
RRBAGGIO77: calls $0.50
*** FLOP *** [Td 9d Jc]
RRBAGGIO77: checks 
keko gr: checks 
bateman225: checks 
*** TURN *** [Td 9d Jc] [7d]
RRBAGGIO77: checks 
keko gr: checks 
bateman225: checks 
*** RIVER *** [Td 9d Jc 7d] [Ac]
RRBAGGIO77: checks 
keko gr: checks 
bateman225: checks 
*** SHOW DOWN ***
RRBAGGIO77: shows [2h 3h] (high card Ace)
keko gr: shows [2s 2d] (a pair of Deuces)
bateman225: shows [6h 6s] (a pair of Sixes)
bateman225 collected $3.09 from pot
*** SUMMARY ***
Total pot $3.25 | Rake $0.16 
Board [Td 9d Jc 7d Ac]
Seat 1: keko gr showed [2s 2d] and lost with a pair of Deuces
Seat 2: bateman225 showed [6h 6s] and won ($3.09) with a pair of Sixes
Seat 3: ruQx01 (button) folded before Flop (didn't bet)
Seat 4: ssorinacho92 (small blind) folded before Flop
Seat 5: RRBAGGIO77 (big blind) showed [2h 3h] and lost with high card Ace
Seat 6: vipbor folded before Flop (didn't bet)
Seat 7: Freak380 folded before Flop (didn't bet)
Seat 8: SwimmingPooI folded before Flop (didn't bet)



PokerStars Hand #228689729565:  Hold'em No Limit ($0.25/$0.50 USD) - 2021/07/30 17:11:16 ET
Table 'Bok II' 9-max Seat #4 is the button
Seat 1: keko gr ($81.45 in chips) 
Seat 2: bateman225 ($65.10 in chips) 
Seat 3: ruQx01 ($50 in chips) 
Seat 4: ssorinacho92 ($93.03 in chips) 
Seat 5: RRBAGGIO77 ($49 in chips) 
Seat 6: vipbor ($106.18 in chips) 
Seat 7: Freak380 ($57.56 in chips) 
Seat 8: SwimmingPooI ($80.57 in chips) 
RRBAGGIO77: posts small blind $0.25
vipbor: posts big blind $0.50
*** HOLE CARDS ***
Freak380: folds 
SwimmingPooI: folds 
keko gr: folds 
bateman225: folds 
ruQx01: raises $0.62 to $1.12
ssorinacho92: raises $3.38 to $4.50
RRBAGGIO77: folds 
vipbor: folds 
ruQx01: folds 
Uncalled bet ($3.38) returned to ssorinacho92
ssorinacho92 collected $2.99 from pot
ssorinacho92: doesn't show hand 
*** SUMMARY ***
Total pot $2.99 | Rake $0 
Seat 1: keko gr folded before Flop (didn't bet)
Seat 2: bateman225 folded before Flop (didn't bet)
Seat 3: ruQx01 folded before Flop
Seat 4: ssorinacho92 (button) collected ($2.99)
Seat 5: RRBAGGIO77 (small blind) folded before Flop
Seat 6: vipbor (big blind) folded before Flop
Seat 7: Freak380 folded before Flop (didn't bet)
Seat 8: SwimmingPooI folded before Flop (didn't bet)



PokerStars Hand #228689746885:  Hold'em No Limit ($0.25/$0.50 USD) - 2021/07/30 17:11:54 ET
Table 'Bok II' 9-max Seat #5 is the button
Seat 1: keko gr ($81.45 in chips) 
Seat 2: bateman225 ($65.10 in chips) 
Seat 3: ruQx01 ($50 in chips) 
Seat 4: ssorinacho92 ($94.90 in chips) 
Seat 5: RRBAGGIO77 ($48.75 in chips) 
Seat 6: vipbor ($105.68 in chips) 
Seat 7: Freak380 ($57.56 in chips) 
Seat 8: SwimmingPooI ($80.57 in chips) 
vipbor: posts small blind $0.25
Freak380: posts big blind $0.50
*** HOLE CARDS ***
SwimmingPooI: folds 
keko gr: folds 
bateman225: folds 
ruQx01: folds 
ssorinacho92: folds 
RRBAGGIO77: calls $0.50
vipbor: calls $0.25
Freak380: checks 
*** FLOP *** [3h 7d 7h]
vipbor: checks 
Freak380: checks 
RRBAGGIO77: checks 
*** TURN *** [3h 7d 7h] [9h]
vipbor: bets $1.42
Freak380: calls $1.42
RRBAGGIO77: raises $2.08 to $3.50
vipbor: folds 
Freak380: calls $2.08
*** RIVER *** [3h 7d 7h 9h] [5s]
Freak380: checks 
RRBAGGIO77: bets $8
Freak380: calls $8
*** SHOW DOWN ***
RRBAGGIO77: shows [5h 8h] (a flush, Nine high)
Freak380: mucks hand 
RRBAGGIO77 collected $24.62 from pot
*** SUMMARY ***
Total pot $25.92 | Rake $1.30 
Board [3h 7d 7h 9h 5s]
Seat 1: keko gr folded before Flop (didn't bet)
Seat 2: bateman225 folded before Flop (didn't bet)
Seat 3: ruQx01 folded before Flop (didn't bet)
Seat 4: ssorinacho92 folded before Flop (didn't bet)
Seat 5: RRBAGGIO77 (button) showed [5h 8h] and won ($24.62) with a flush, Nine high
Seat 6: vipbor (small blind) folded on the Turn
Seat 7: Freak380 (big blind) mucked
Seat 8: SwimmingPooI folded before Flop (didn't bet)



PokerStars Hand #228689808498:  Hold'em No Limit ($0.25/$0.50 USD) - 2021/07/30 17:13:45 ET
Table 'Bok II' 9-max Seat #6 is the button
Seat 1: keko gr ($81.45 in chips) 
Seat 2: bateman225 ($65.10 in chips) 
Seat 3: ruQx01 ($50 in chips) 
Seat 4: ssorinacho92 ($94.90 in chips) 
Seat 5: RRBAGGIO77 ($61.37 in chips) 
Seat 6: vipbor ($103.76 in chips) 
Seat 7: Freak380 ($45.56 in chips) 
Seat 8: SwimmingPooI ($80.57 in chips) 
Freak380: posts small blind $0.25
SwimmingPooI: posts big blind $0.50
*** HOLE CARDS ***
keko gr: folds 
bateman225: raises $0.50 to $1
ruQx01: folds 
ssorinacho92: folds 
RRBAGGIO77: folds 
vipbor: folds 
Freak380: calls $0.75
SwimmingPooI: folds 
*** FLOP *** [Jd 4s Th]
Freak380: bets $1.25
bateman225: calls $1.25
*** TURN *** [Jd 4s Th] [Ad]
Freak380: bets $2.50
bateman225: calls $2.50
*** RIVER *** [Jd 4s Th Ad] [3h]
Freak380: checks 
bateman225: checks 
*** SHOW DOWN ***
Freak380: shows [9s Js] (a pair of Jacks)
bateman225: shows [9h Jh] (a pair of Jacks)
Freak380 collected $4.69 from pot
bateman225 collected $4.75 from pot
*** SUMMARY ***
Total pot $10 | Rake $0.56 
Board [Jd 4s Th Ad 3h]
Seat 1: keko gr folded before Flop (didn't bet)
Seat 2: bateman225 showed [9h Jh] and won ($4.75) with a pair of Jacks
Seat 3: ruQx01 folded before Flop (didn't bet)
Seat 4: ssorinacho92 folded before Flop (didn't bet)
Seat 5: RRBAGGIO77 folded before Flop (didn't bet)
Seat 6: vipbor (button) folded before Flop (didn't bet)
Seat 7: Freak380 (small blind) showed [9s Js] and won ($4.69) with a pair of Jacks
Seat 8: SwimmingPooI (big blind) folded before Flop



PokerStars Hand #228689828777:  Hold'em No Limit ($0.25/$0.50 USD) - 2021/07/30 17:14:28 ET
Table 'Bok II' 9-max Seat #7 is the button
Seat 1: keko gr ($81.45 in chips) 
Seat 2: bateman225 ($65.10 in chips) 
Seat 3: ruQx01 ($50 in chips) 
Seat 4: ssorinacho92 ($94.90 in chips) 
Seat 5: RRBAGGIO77 ($61.37 in chips) 
Seat 6: vipbor ($103.76 in chips) 
Seat 7: Freak380 ($45.50 in chips) 
Seat 8: SwimmingPooI ($80.07 in chips) 
SwimmingPooI: posts small blind $0.25
keko gr: posts big blind $0.50
*** HOLE CARDS ***
bateman225: folds 
ruQx01: folds 
ssorinacho92: folds 
RRBAGGIO77 has timed out
RRBAGGIO77: folds 
vipbor: folds 
Freak380: raises $1 to $1.50
SwimmingPooI: folds 
keko gr: folds 
Uncalled bet ($1) returned to Freak380
Freak380 collected $1.25 from pot
*** SUMMARY ***
Total pot $1.25 | Rake $0 
Seat 1: keko gr (big blind) folded before Flop
Seat 2: bateman225 folded before Flop (didn't bet)
Seat 3: ruQx01 folded before Flop (didn't bet)
Seat 4: ssorinacho92 folded before Flop (didn't bet)
Seat 5: RRBAGGIO77 folded before Flop (didn't bet)
Seat 6: vipbor folded before Flop (didn't bet)
Seat 7: Freak380 (button) collected ($1.25)
Seat 8: SwimmingPooI (small blind) folded before Flop



PokerStars Hand #228689846056:  Hold'em No Limit ($0.25/$0.50 USD) - 2021/07/30 17:15:05 ET
Table 'Bok II' 9-max Seat #8 is the button
Seat 1: keko gr ($80.95 in chips) 
Seat 2: bateman225 ($65.10 in chips) 
Seat 3: ruQx01 ($50 in chips) 
Seat 4: ssorinacho92 ($94.90 in chips) 
Seat 5: RRBAGGIO77 ($61.37 in chips) 
Seat 6: vipbor ($103.76 in chips) 
Seat 7: Freak380 ($46.25 in chips) 
Seat 8: SwimmingPooI ($79.82 in chips) 
keko gr: posts small blind $0.25
bateman225: posts big blind $0.50
*** HOLE CARDS ***
ruQx01: folds 
ssorinacho92: folds 
RRBAGGIO77: folds 
vipbor: folds 
Freak380: calls $0.50
SwimmingPooI: raises $2 to $2.50
keko gr: folds 
bateman225: folds 
Freak380: folds 
Uncalled bet ($2) returned to SwimmingPooI
SwimmingPooI collected $1.75 from pot
SwimmingPooI: doesn't show hand 
*** SUMMARY ***
Total pot $1.75 | Rake $0 
Seat 1: keko gr (small blind) folded before Flop
Seat 2: bateman225 (big blind) folded before Flop
Seat 3: ruQx01 folded before Flop (didn't bet)
Seat 4: ssorinacho92 folded before Flop (didn't bet)
Seat 5: RRBAGGIO77 folded before Flop (didn't bet)
Seat 6: vipbor folded before Flop (didn't bet)
Seat 7: Freak380 folded before Flop
Seat 8: SwimmingPooI (button) collected ($1.75)



PokerStars Hand #228689865324:  Hold'em No Limit ($0.25/$0.50 USD) - 2021/07/30 17:15:46 ET
Table 'Bok II' 9-max Seat #1 is the button
Seat 1: keko gr ($80.70 in chips) 
Seat 2: bateman225 ($64.60 in chips) 
Seat 3: ruQx01 ($50 in chips) 
Seat 4: ssorinacho92 ($94.90 in chips) 
Seat 5: RRBAGGIO77 ($61.37 in chips) 
Seat 6: vipbor ($103.76 in chips) 
Seat 7: Freak380 ($45.75 in chips) 
Seat 8: SwimmingPooI ($81.07 in chips) 
bateman225: posts small blind $0.25
ruQx01: posts big blind $0.50
*** HOLE CARDS ***
ssorinacho92: raises $0.75 to $1.25
RRBAGGIO77: folds 
vipbor: folds 
Freak380: folds 
SwimmingPooI: folds 
keko gr: calls $1.25
bateman225: folds 
ruQx01: folds 
*** FLOP *** [Qh 4h Ad]
ssorinacho92: checks 
keko gr: checks 
*** TURN *** [Qh 4h Ad] [7h]
ssorinacho92: bets $1.24
keko gr: folds 
Uncalled bet ($1.24) returned to ssorinacho92
ssorinacho92 collected $3.09 from pot
ssorinacho92: doesn't show hand 
*** SUMMARY ***
Total pot $3.25 | Rake $0.16 
Board [Qh 4h Ad 7h]
Seat 1: keko gr (button) folded on the Turn
Seat 2: bateman225 (small blind) folded before Flop
Seat 3: ruQx01 (big blind) folded before Flop
Seat 4: ssorinacho92 collected ($3.09)
Seat 5: RRBAGGIO77 folded before Flop (didn't bet)
Seat 6: vipbor folded before Flop (didn't bet)
Seat 7: Freak380 folded before Flop (didn't bet)
Seat 8: SwimmingPooI folded before Flop (didn't bet)



PokerStars Hand #228689882010:  Hold'em No Limit ($0.25/$0.50 USD) - 2021/07/30 17:16:22 ET
Table 'Bok II' 9-max Seat #2 is the button
Seat 1: keko gr ($79.45 in chips) 
Seat 2: bateman225 ($64.35 in chips) 
Seat 3: ruQx01 ($50 in chips) 
Seat 4: ssorinacho92 ($96.74 in chips) 
Seat 5: RRBAGGIO77 ($61.37 in chips) 
Seat 6: vipbor ($103.76 in chips) 
Seat 7: Freak380 ($45.75 in chips) 
Seat 8: SwimmingPooI ($81.07 in chips) 
ruQx01: posts small blind $0.25
ssorinacho92: posts big blind $0.50
Lavitadi: sits out 
*** HOLE CARDS ***
RRBAGGIO77: folds 
vipbor: folds 
Freak380: calls $0.50
SwimmingPooI: folds 
keko gr: folds 
bateman225: calls $0.50
ruQx01: calls $0.25
ssorinacho92: checks 
*** FLOP *** [9d Kh 2h]
ruQx01: checks 
ssorinacho92: checks 
Freak380: checks 
bateman225: checks 
*** TURN *** [9d Kh 2h] [Td]
ruQx01: checks 
ssorinacho92: bets $1.52
Freak380: calls $1.52
bateman225: folds 
ruQx01: folds 
*** RIVER *** [9d Kh 2h Td] [8h]
ssorinacho92: checks 
Freak380: bets $2.50
ssorinacho92: calls $2.50
*** SHOW DOWN ***
Freak380: shows [Ts 8s] (two pair, Tens and Eights)
ssorinacho92: shows [Th Ks] (two pair, Kings and Tens)
ssorinacho92 collected $9.54 from pot
*** SUMMARY ***
Total pot $10.04 | Rake $0.50 
Board [9d Kh 2h Td 8h]
Seat 1: keko gr folded before Flop (didn't bet)
Seat 2: bateman225 (button) folded on the Turn
Seat 3: ruQx01 (small blind) folded on the Turn
Seat 4: ssorinacho92 (big blind) showed [Th Ks] and won ($9.54) with two pair, Kings and Tens
Seat 5: RRBAGGIO77 folded before Flop (didn't bet)
Seat 6: vipbor folded before Flop (didn't bet)
Seat 7: Freak380 showed [Ts 8s] and lost with two pair, Tens and Eights
Seat 8: SwimmingPooI folded before Flop (didn't bet)



PokerStars Hand #228689918950:  Hold'em No Limit ($0.25/$0.50 USD) - 2021/07/30 17:17:41 ET
Table 'Bok II' 9-max Seat #3 is the button
Seat 1: keko gr ($79.45 in chips) 
Seat 2: bateman225 ($63.85 in chips) 
Seat 3: ruQx01 ($50 in chips) 
Seat 4: ssorinacho92 ($101.76 in chips) 
Seat 5: RRBAGGIO77 ($61.37 in chips) 
Seat 6: vipbor ($103.76 in chips) 
Seat 7: Freak380 ($41.23 in chips) 
Seat 8: SwimmingPooI ($81.07 in chips) 
ssorinacho92: posts small blind $0.25
RRBAGGIO77: posts big blind $0.50
Lavitadi: sits out 
*** HOLE CARDS ***
vipbor: raises $0.75 to $1.25
Freak380: folds 
SwimmingPooI: folds 
keko gr: folds 
bateman225: calls $1.25
ruQx01: folds 
ssorinacho92: folds 
RRBAGGIO77: folds 
*** FLOP *** [Ac 5h Jd]
vipbor: checks 
bateman225: bets $1
vipbor: calls $1
*** TURN *** [Ac 5h Jd] [8d]
vipbor: checks 
bateman225: bets $2
vipbor: calls $2
*** RIVER *** [Ac 5h Jd 8d] [2h]
vipbor: checks 
bateman225: checks 
*** SHOW DOWN ***
vipbor: shows [Qd Qc] (a pair of Queens)
bateman225: shows [9h Ah] (a pair of Aces)
bateman225 collected $8.79 from pot
*** SUMMARY ***
Total pot $9.25 | Rake $0.46 
Board [Ac 5h Jd 8d 2h]
Seat 1: keko gr folded before Flop (didn't bet)
Seat 2: bateman225 showed [9h Ah] and won ($8.79) with a pair of Aces
Seat 3: ruQx01 (button) folded before Flop (didn't bet)
Seat 4: ssorinacho92 (small blind) folded before Flop
Seat 5: RRBAGGIO77 (big blind) folded before Flop
Seat 6: vipbor showed [Qd Qc] and lost with a pair of Queens
Seat 7: Freak380 folded before Flop (didn't bet)
Seat 8: SwimmingPooI folded before Flop (didn't bet)



PokerStars Hand #228689949830:  Hold'em No Limit ($0.25/$0.50 USD) - 2021/07/30 17:18:47 ET
Table 'Bok II' 9-max Seat #4 is the button
Seat 1: keko gr ($79.45 in chips) 
Seat 2: bateman225 ($68.39 in chips) 
Seat 3: ruQx01 ($50 in chips) 
Seat 4: ssorinacho92 ($101.51 in chips) 
Seat 5: RRBAGGIO77 ($60.87 in chips) 
Seat 6: vipbor ($99.51 in chips) 
Seat 7: Freak380 ($41.23 in chips) 
Seat 8: SwimmingPooI ($81.07 in chips) 
RRBAGGIO77: posts small blind $0.25
vipbor: posts big blind $0.50
Lavitadi: sits out 
*** HOLE CARDS ***
Freak380: calls $0.50
SwimmingPooI: raises $2 to $2.50
keko gr: folds 
bateman225: folds 
ruQx01: folds 
ssorinacho92: folds 
RRBAGGIO77: folds 
vipbor: folds 
Freak380: calls $2
*** FLOP *** [Ts Qc 9h]
Freak380: bets $2.50
SwimmingPooI: calls $2.50
*** TURN *** [Ts Qc 9h] [7s]
Freak380: checks 
SwimmingPooI: bets $5.21
Freak380: folds 
Uncalled bet ($5.21) returned to SwimmingPooI
SwimmingPooI collected $10.21 from pot
SwimmingPooI: doesn't show hand 
*** SUMMARY ***
Total pot $10.75 | Rake $0.54 
Board [Ts Qc 9h 7s]
Seat 1: keko gr folded before Flop (didn't bet)
Seat 2: bateman225 folded before Flop (didn't bet)
Seat 3: ruQx01 folded before Flop (didn't bet)
Seat 4: ssorinacho92 (button) folded before Flop (didn't bet)
Seat 5: RRBAGGIO77 (small blind) folded before Flop
Seat 6: vipbor (big blind) folded before Flop
Seat 7: Freak380 folded on the Turn
Seat 8: SwimmingPooI collected ($10.21)



PokerStars Hand #228689974036:  Hold'em No Limit ($0.25/$0.50 USD) - 2021/07/30 17:19:40 ET
Table 'Bok II' 9-max Seat #5 is the button
Seat 1: keko gr ($79.45 in chips) 
Seat 2: bateman225 ($68.39 in chips) 
Seat 3: ruQx01 ($50 in chips) 
Seat 4: ssorinacho92 ($101.51 in chips) 
Seat 5: RRBAGGIO77 ($60.62 in chips) 
Seat 6: vipbor ($99.01 in chips) 
Seat 7: Freak380 ($36.23 in chips) 
Seat 8: SwimmingPooI ($86.28 in chips) 
vipbor: posts small blind $0.25
Freak380: posts big blind $0.50
Lavitadi: sits out 
*** HOLE CARDS ***
SwimmingPooI: raises $1 to $1.50
keko gr: calls $1.50
bateman225: folds 
ruQx01: folds 
ssorinacho92: folds 
RRBAGGIO77: folds 
vipbor: folds 
Freak380: raises $2 to $3.50
SwimmingPooI: calls $2
keko gr: calls $2
*** FLOP *** [2c Kh 8c]
Freak380: bets $5
SwimmingPooI: calls $5
keko gr: folds 
*** TURN *** [2c Kh 8c] [9c]
Freak380: checks 
SwimmingPooI: bets $10.50
Freak380: calls $10.50
*** RIVER *** [2c Kh 8c 9c] [Jc]
Freak380: checks 
SwimmingPooI: checks 
*** SHOW DOWN ***
Freak380: shows [Qs Qc] (a flush, Queen high)
SwimmingPooI: mucks hand 
Freak380 collected $39.25 from pot
*** SUMMARY ***
Total pot $41.75 | Rake $2.50 
Board [2c Kh 8c 9c Jc]
Seat 1: keko gr folded on the Flop
Seat 2: bateman225 folded before Flop (didn't bet)
Seat 3: ruQx01 folded before Flop (didn't bet)
Seat 4: ssorinacho92 folded before Flop (didn't bet)
Seat 5: RRBAGGIO77 (button) folded before Flop (didn't bet)
Seat 6: vipbor (small blind) folded before Flop
Seat 7: Freak380 (big blind) showed [Qs Qc] and won ($39.25) with a flush, Queen high
Seat 8: SwimmingPooI mucked



PokerStars Hand #228690010809:  Hold'em No Limit ($0.25/$0.50 USD) - 2021/07/30 17:21:00 ET
Table 'Bok II' 9-max Seat #6 is the button
Seat 1: keko gr ($75.95 in chips) 
Seat 2: bateman225 ($68.39 in chips) 
Seat 3: ruQx01 ($50 in chips) 
Seat 4: ssorinacho92 ($101.51 in chips) 
Seat 5: RRBAGGIO77 ($60.62 in chips) 
Seat 6: vipbor ($98.76 in chips) 
Seat 7: Freak380 ($56.48 in chips) 
Seat 8: SwimmingPooI ($67.28 in chips) 
Freak380: posts small blind $0.25
SwimmingPooI: posts big blind $0.50
Lavitadi: sits out 
*** HOLE CARDS ***
keko gr: folds 
bateman225: folds 
ruQx01: folds 
ssorinacho92: folds 
keko gr leaves the table
Mc57Arnold joins the table at seat #1 
RRBAGGIO77: raises $1 to $1.50
vipbor: raises $3 to $4.50
Freak380: folds 
SwimmingPooI: folds 
RRBAGGIO77: calls $3
*** FLOP *** [Ks As 2s]
RRBAGGIO77: checks 
vipbor: bets $3.06
RRBAGGIO77: calls $3.06
*** TURN *** [Ks As 2s] [4s]
RRBAGGIO77: checks 
vipbor: checks 
*** RIVER *** [Ks As 2s 4s] [5c]
RRBAGGIO77: bets $24
vipbor: folds 
Uncalled bet ($24) returned to RRBAGGIO77
RRBAGGIO77 collected $15.08 from pot
RRBAGGIO77: doesn't show hand 
*** SUMMARY ***
Total pot $15.87 | Rake $0.79 
Board [Ks As 2s 4s 5c]
Seat 1: keko gr folded before Flop (didn't bet)
Seat 2: bateman225 folded before Flop (didn't bet)
Seat 3: ruQx01 folded before Flop (didn't bet)
Seat 4: ssorinacho92 folded before Flop (didn't bet)
Seat 5: RRBAGGIO77 collected ($15.08)
Seat 6: vipbor (button) folded on the River
Seat 7: Freak380 (small blind) folded before Flop
Seat 8: SwimmingPooI (big blind) folded before Flop



PokerStars Hand #228690054638:  Hold'em No Limit ($0.25/$0.50 USD) - 2021/07/30 17:22:35 ET
Table 'Bok II' 9-max Seat #7 is the button
Seat 2: bateman225 ($68.39 in chips) 
Seat 3: ruQx01 ($50 in chips) 
Seat 4: ssorinacho92 ($101.51 in chips) 
Seat 5: RRBAGGIO77 ($68.14 in chips) 
Seat 6: vipbor ($91.20 in chips) 
Seat 7: Freak380 ($56.23 in chips) 
Seat 8: SwimmingPooI ($66.78 in chips) 
Seat 9: Lavitadi ($42 in chips) 
SwimmingPooI: posts small blind $0.25
Lavitadi: posts big blind $0.50
Mc57Arnold: sits out 
*** HOLE CARDS ***
bateman225: folds 
ruQx01: folds 
ssorinacho92: folds 
RRBAGGIO77: folds 
vipbor: folds 
Freak380: folds 
SwimmingPooI: folds 
Uncalled bet ($0.25) returned to Lavitadi
Lavitadi collected $0.50 from pot
Lavitadi: doesn't show hand 
*** SUMMARY ***
Total pot $0.50 | Rake $0 
Seat 2: bateman225 folded before Flop (didn't bet)
Seat 3: ruQx01 folded before Flop (didn't bet)
Seat 4: ssorinacho92 folded before Flop (didn't bet)
Seat 5: RRBAGGIO77 folded before Flop (didn't bet)
Seat 6: vipbor folded before Flop (didn't bet)
Seat 7: Freak380 (button) folded before Flop (didn't bet)
Seat 8: SwimmingPooI (small blind) folded before Flop
Seat 9: Lavitadi (big blind) collected ($0.50)



PokerStars Hand #228690059485:  Hold'em No Limit ($0.25/$0.50 USD) - 2021/07/30 17:22:45 ET
Table 'Bok II' 9-max Seat #8 is the button
Seat 1: Mc57Arnold ($50 in chips) 
Seat 2: bateman225 ($68.39 in chips) 
Seat 3: ruQx01 ($50 in chips) 
Seat 4: ssorinacho92 ($101.51 in chips) 
Seat 5: RRBAGGIO77 ($68.14 in chips) 
Seat 6: vipbor ($91.20 in chips) 
Seat 7: Freak380 ($56.23 in chips) 
Seat 8: SwimmingPooI ($66.53 in chips) 
Seat 9: Lavitadi ($42.25 in chips) 
Lavitadi: posts small blind $0.25
Mc57Arnold: posts big blind $0.50
*** HOLE CARDS ***
bateman225: folds 
ruQx01: folds 
ssorinacho92 has timed out
ssorinacho92: folds 
RRBAGGIO77: calls $0.50
vipbor: folds 
Freak380: raises $1.25 to $1.75
SwimmingPooI: folds 
Lavitadi: calls $1.50
Mc57Arnold: folds 
RRBAGGIO77: folds 
*** FLOP *** [Kd Qs 2s]
Lavitadi: checks 
Freak380: checks 
*** TURN *** [Kd Qs 2s] [8h]
Lavitadi: checks 
Freak380: bets $2
Lavitadi: folds 
Uncalled bet ($2) returned to Freak380
Freak380 collected $4.22 from pot
*** SUMMARY ***
Total pot $4.50 | Rake $0.28 
Board [Kd Qs 2s 8h]
Seat 1: Mc57Arnold (big blind) folded before Flop
Seat 2: bateman225 folded before Flop (didn't bet)
Seat 3: ruQx01 folded before Flop (didn't bet)
Seat 4: ssorinacho92 folded before Flop (didn't bet)
Seat 5: RRBAGGIO77 folded before Flop
Seat 6: vipbor folded before Flop (didn't bet)
Seat 7: Freak380 collected ($4.22)
Seat 8: SwimmingPooI (button) folded before Flop (didn't bet)
Seat 9: Lavitadi (small blind) folded on the Turn



PokerStars Hand #228690089002:  Hold'em No Limit ($0.25/$0.50 USD) - 2021/07/30 17:23:49 ET
Table 'Bok II' 9-max Seat #9 is the button
Seat 1: Mc57Arnold ($50 in chips) 
Seat 2: bateman225 ($68.39 in chips) 
Seat 3: ruQx01 ($50 in chips) 
Seat 4: ssorinacho92 ($101.51 in chips) 
Seat 5: RRBAGGIO77 ($67.64 in chips) 
Seat 6: vipbor ($91.20 in chips) 
Seat 7: Freak380 ($58.70 in chips) 
Seat 8: SwimmingPooI ($66.53 in chips) 
Seat 9: Lavitadi ($40.50 in chips) 
Mc57Arnold: posts small blind $0.25
bateman225: posts big blind $0.50
*** HOLE CARDS ***
ruQx01: folds 
ssorinacho92: folds 
RRBAGGIO77: folds 
vipbor: folds 
Freak380: folds 
SwimmingPooI: raises $1 to $1.50
Lavitadi: raises $1 to $2.50
Mc57Arnold: folds 
bateman225: folds 
SwimmingPooI: calls $1
*** FLOP *** [3s Ah 6c]
SwimmingPooI: checks 
Lavitadi: bets $3
SwimmingPooI: folds 
Uncalled bet ($3) returned to Lavitadi
Lavitadi collected $5.46 from pot
Lavitadi: doesn't show hand 
ruQx01 was removed from the table for failing to post
ruQx01 leaves the table
*** SUMMARY ***
Total pot $5.75 | Rake $0.29 
Board [3s Ah 6c]
Seat 1: Mc57Arnold (small blind) folded before Flop
Seat 2: bateman225 (big blind) folded before Flop
Seat 3: ruQx01 folded before Flop (didn't bet)
Seat 4: ssorinacho92 folded before Flop (didn't bet)
Seat 5: RRBAGGIO77 folded before Flop (didn't bet)
Seat 6: vipbor folded before Flop (didn't bet)
Seat 7: Freak380 folded before Flop (didn't bet)
Seat 8: SwimmingPooI folded on the Flop
Seat 9: Lavitadi (button) collected ($5.46)



PokerStars Hand #228690104752:  Hold'em No Limit ($0.25/$0.50 USD) - 2021/07/30 17:24:23 ET
Table 'Bok II' 9-max Seat #1 is the button
Seat 1: Mc57Arnold ($50 in chips) 
Seat 2: bateman225 ($67.89 in chips) 
Seat 4: ssorinacho92 ($101.51 in chips) 
Seat 5: RRBAGGIO77 ($67.64 in chips) 
Seat 6: vipbor ($91.20 in chips) 
Seat 7: Freak380 ($58.70 in chips) 
Seat 8: SwimmingPooI ($64.03 in chips) 
Seat 9: Lavitadi ($43.46 in chips) 
bateman225: posts small blind $0.25
ssorinacho92: posts big blind $0.50
*** HOLE CARDS ***
RRBAGGIO77: folds 
vipbor: folds 
Freak380: folds 
SwimmingPooI: raises $1 to $1.50
Lavitadi: folds 
Mc57Arnold: folds 
bateman225: calls $1.25
Seduisant365 joins the table at seat #3 
ssorinacho92: raises $4.50 to $6
Seduisant365 leaves the table
SwimmingPooI: folds 
bateman225: folds 
Uncalled bet ($4.50) returned to ssorinacho92
ssorinacho92 collected $4.50 from pot
ssorinacho92: doesn't show hand 
*** SUMMARY ***
Total pot $4.50 | Rake $0 
Seat 1: Mc57Arnold (button) folded before Flop (didn't bet)
Seat 2: bateman225 (small blind) folded before Flop
Seat 4: ssorinacho92 (big blind) collected ($4.50)
Seat 5: RRBAGGIO77 folded before Flop (didn't bet)
Seat 6: vipbor folded before Flop (didn't bet)
Seat 7: Freak380 folded before Flop (didn't bet)
Seat 8: SwimmingPooI folded before Flop
Seat 9: Lavitadi folded before Flop (didn't bet)



PokerStars Hand #228690127877:  Hold'em No Limit ($0.25/$0.50 USD) - 2021/07/30 17:25:13 ET
Table 'Bok II' 9-max Seat #2 is the button
Seat 1: Mc57Arnold ($50 in chips) 
Seat 2: bateman225 ($66.39 in chips) 
Seat 4: ssorinacho92 ($104.51 in chips) 
Seat 5: RRBAGGIO77 ($67.64 in chips) 
Seat 6: vipbor ($91.20 in chips) 
Seat 7: Freak380 ($58.70 in chips) 
Seat 8: SwimmingPooI ($62.53 in chips) 
Seat 9: Lavitadi ($43.46 in chips) 
ssorinacho92: posts small blind $0.25
RRBAGGIO77: posts big blind $0.50
*** HOLE CARDS ***
vipbor: folds 
Freak380: folds 
SwimmingPooI: raises $1 to $1.50
Lavitadi: folds 
Mc57Arnold: folds 
bateman225: folds 
ssorinacho92: folds 
RRBAGGIO77: calls $1
*** FLOP *** [Qh 5c Qc]
RRBAGGIO77: checks 
SwimmingPooI: bets $1.50
RRBAGGIO77: folds 
Uncalled bet ($1.50) returned to SwimmingPooI
SwimmingPooI collected $3.09 from pot
SwimmingPooI: doesn't show hand 
*** SUMMARY ***
Total pot $3.25 | Rake $0.16 
Board [Qh 5c Qc]
Seat 1: Mc57Arnold folded before Flop (didn't bet)
Seat 2: bateman225 (button) folded before Flop (didn't bet)
Seat 4: ssorinacho92 (small blind) folded before Flop
Seat 5: RRBAGGIO77 (big blind) folded on the Flop
Seat 6: vipbor folded before Flop (didn't bet)
Seat 7: Freak380 folded before Flop (didn't bet)
Seat 8: SwimmingPooI collected ($3.09)
Seat 9: Lavitadi folded before Flop (didn't bet)



PokerStars Hand #228690146843:  Hold'em No Limit ($0.25/$0.50 USD) - 2021/07/30 17:25:55 ET
Table 'Bok II' 9-max Seat #4 is the button
Seat 1: Mc57Arnold ($50 in chips) 
Seat 2: bateman225 ($66.39 in chips) 
Seat 4: ssorinacho92 ($104.26 in chips) 
Seat 5: RRBAGGIO77 ($66.14 in chips) 
Seat 6: vipbor ($91.20 in chips) 
Seat 7: Freak380 ($58.70 in chips) 
Seat 8: SwimmingPooI ($64.12 in chips) 
Seat 9: Lavitadi ($43.46 in chips) 
RRBAGGIO77: posts small blind $0.25
vipbor: posts big blind $0.50
*** HOLE CARDS ***
Freak380: calls $0.50
SwimmingPooI: folds 
Lavitadi: folds 
Mc57Arnold: folds 
bateman225: raises $1 to $1.50
ssorinacho92: folds 
se13giuum joins the table at seat #3 
RRBAGGIO77: folds 
vipbor: folds 
Freak380: calls $1
*** FLOP *** [2s 7c Tc]
Freak380: checks 
bateman225: bets $1.50
Freak380: calls $1.50
*** TURN *** [2s 7c Tc] [4h]
Freak380: checks 
bateman225: bets $3
Freak380: calls $3
*** RIVER *** [2s 7c Tc 4h] [4s]
Freak380: checks 
bateman225: bets $9.05
Freak380: folds 
Uncalled bet ($9.05) returned to bateman225
bateman225 collected $12.11 from pot
bateman225: doesn't show hand 
*** SUMMARY ***
Total pot $12.75 | Rake $0.64 
Board [2s 7c Tc 4h 4s]
Seat 1: Mc57Arnold folded before Flop (didn't bet)
Seat 2: bateman225 collected ($12.11)
Seat 4: ssorinacho92 (button) folded before Flop (didn't bet)
Seat 5: RRBAGGIO77 (small blind) folded before Flop
Seat 6: vipbor (big blind) folded before Flop
Seat 7: Freak380 folded on the River
Seat 8: SwimmingPooI folded before Flop (didn't bet)
Seat 9: Lavitadi folded before Flop (didn't bet)



PokerStars Hand #228690182459:  Hold'em No Limit ($0.25/$0.50 USD) - 2021/07/30 17:27:01 ET
Table 'Bok II' 9-max Seat #5 is the button
Seat 1: Mc57Arnold ($50 in chips) 
Seat 2: bateman225 ($72.50 in chips) 
Seat 4: ssorinacho92 ($104.26 in chips) 
Seat 5: RRBAGGIO77 ($65.89 in chips) 
Seat 6: vipbor ($90.70 in chips) 
Seat 7: Freak380 ($52.70 in chips) 
Seat 8: SwimmingPooI ($64.12 in chips) 
Seat 9: Lavitadi ($43.46 in chips) 
vipbor: posts small blind $0.25
Freak380: posts big blind $0.50
se13giuum: sits out 
*** HOLE CARDS ***
SwimmingPooI: folds 
Lavitadi: folds 
Mc57Arnold: folds 
bateman225: folds 
ssorinacho92: folds 
RRBAGGIO77: folds 
vipbor: folds 
Uncalled bet ($0.25) returned to Freak380
Freak380 collected $0.50 from pot
*** SUMMARY ***
Total pot $0.50 | Rake $0 
Seat 1: Mc57Arnold folded before Flop (didn't bet)
Seat 2: bateman225 folded before Flop (didn't bet)
Seat 4: ssorinacho92 folded before Flop (didn't bet)
Seat 5: RRBAGGIO77 (button) folded before Flop (didn't bet)
Seat 6: vipbor (small blind) folded before Flop
Seat 7: Freak380 (big blind) collected ($0.50)
Seat 8: SwimmingPooI folded before Flop (didn't bet)
Seat 9: Lavitadi folded before Flop (didn't bet)



PokerStars Hand #228691871697:  Hold'em No Limit ($0.25/$0.50 USD) - 2021/07/30 18:33:33 ET
Table 'Bok II' 9-max Seat #8 is the button
Seat 1: alexrus18 ($50 in chips) 
Seat 3: gvidator ($41.48 in chips) 
Seat 4: Infinities4 ($60.50 in chips) 
Seat 5: forestry800 ($67.41 in chips) 
Seat 6: vipbor ($61.89 in chips) 
Seat 7: Freak380 ($71.99 in chips) 
Seat 8: StudentRB ($50 in chips) 
Seat 9: An1an1 ($66.13 in chips) 
An1an1: posts small blind $0.25
alexrus18: posts big blind $0.50
dikanmax: sits out 
*** HOLE CARDS ***
gvidator: calls $0.50
Infinities4: folds 
forestry800: folds 
vipbor: raises $1.50 to $2
Freak380: folds 
StudentRB: folds 
An1an1: folds 
alexrus18: calls $1.50
gvidator: raises $6.75 to $8.75
vipbor: folds 
alexrus18: folds 
Uncalled bet ($6.75) returned to gvidator
gvidator collected $6.25 from pot
gvidator: doesn't show hand 
*** SUMMARY ***
Total pot $6.25 | Rake $0 
Seat 1: alexrus18 (big blind) folded before Flop
Seat 3: gvidator collected ($6.25)
Seat 4: Infinities4 folded before Flop (didn't bet)
Seat 5: forestry800 folded before Flop (didn't bet)
Seat 6: vipbor folded before Flop
Seat 7: Freak380 folded before Flop (didn't bet)
Seat 8: StudentRB (button) folded before Flop (didn't bet)
Seat 9: An1an1 (small blind) folded before Flop



PokerStars Hand #228691893350:  Hold'em No Limit ($0.25/$0.50 USD) - 2021/07/30 18:34:14 ET
Table 'Bok II' 9-max Seat #9 is the button
Seat 1: alexrus18 ($50 in chips) 
Seat 2: dikanmax ($55.50 in chips) 
Seat 3: gvidator ($45.73 in chips) 
Seat 4: Infinities4 ($60.50 in chips) 
Seat 5: forestry800 ($67.41 in chips) 
Seat 6: vipbor ($59.89 in chips) 
Seat 7: Freak380 ($71.99 in chips) 
Seat 8: StudentRB ($50 in chips) 
Seat 9: An1an1 ($65.88 in chips) 
alexrus18: posts small blind $0.25
dikanmax: posts big blind $0.50
*** HOLE CARDS ***
gvidator: raises $1.25 to $1.75
Infinities4: folds 
forestry800: folds 
vipbor: folds 
Freak380: folds 
StudentRB: calls $1.75
An1an1: folds 
alexrus18: folds 
dikanmax: raises $4.75 to $6.50
gvidator: calls $4.75
StudentRB: calls $4.75
*** FLOP *** [Qc 5h Kc]
dikanmax: checks 
gvidator: bets $3
StudentRB: folds 
dikanmax: calls $3
*** TURN *** [Qc 5h Kc] [As]
dikanmax: checks 
gvidator: checks 
*** RIVER *** [Qc 5h Kc As] [3h]
dikanmax: checks 
gvidator: bets $36.23 and is all-in
dikanmax: folds 
Uncalled bet ($36.23) returned to gvidator
gvidator collected $24.46 from pot
gvidator: doesn't show hand 
*** SUMMARY ***
Total pot $25.75 | Rake $1.29 
Board [Qc 5h Kc As 3h]
Seat 1: alexrus18 (small blind) folded before Flop
Seat 2: dikanmax (big blind) folded on the River
Seat 3: gvidator collected ($24.46)
Seat 4: Infinities4 folded before Flop (didn't bet)
Seat 5: forestry800 folded before Flop (didn't bet)
Seat 6: vipbor folded before Flop (didn't bet)
Seat 7: Freak380 folded before Flop (didn't bet)
Seat 8: StudentRB folded on the Flop
Seat 9: An1an1 (button) folded before Flop (didn't bet)



PokerStars Hand #228691924902:  Hold'em No Limit ($0.25/$0.50 USD) - 2021/07/30 18:35:34 ET
Table 'Bok II' 9-max Seat #1 is the button
Seat 1: alexrus18 ($50 in chips) 
Seat 2: dikanmax ($50 in chips) 
Seat 3: gvidator ($60.69 in chips) 
Seat 4: Infinities4 ($60.50 in chips) 
Seat 5: forestry800 ($67.41 in chips) 
Seat 6: vipbor ($59.89 in chips) 
Seat 7: Freak380 ($71.99 in chips) 
Seat 8: StudentRB ($50 in chips) 
Seat 9: An1an1 ($65.88 in chips) 
dikanmax: posts small blind $0.25
gvidator: posts big blind $0.50
*** HOLE CARDS ***
Infinities4: raises $0.74 to $1.24
forestry800: folds 
vipbor: folds 
Freak380: folds 
StudentRB: folds 
An1an1: folds 
alexrus18: folds 
dikanmax: raises $3.76 to $5
gvidator: calls $4.50
Infinities4: calls $3.76
*** FLOP *** [Kh 6h As]
dikanmax: checks 
gvidator: bets $2.50
Infinities4: calls $2.50
dikanmax: folds 
*** TURN *** [Kh 6h As] [2d]
gvidator: checks 
Infinities4: bets $14
gvidator: folds 
Uncalled bet ($14) returned to Infinities4
Infinities4 collected $19 from pot
Infinities4: doesn't show hand 
*** SUMMARY ***
Total pot $20 | Rake $1 
Board [Kh 6h As 2d]
Seat 1: alexrus18 (button) folded before Flop (didn't bet)
Seat 2: dikanmax (small blind) folded on the Flop
Seat 3: gvidator (big blind) folded on the Turn
Seat 4: Infinities4 collected ($19)
Seat 5: forestry800 folded before Flop (didn't bet)
Seat 6: vipbor folded before Flop (didn't bet)
Seat 7: Freak380 folded before Flop (didn't bet)
Seat 8: StudentRB folded before Flop (didn't bet)
Seat 9: An1an1 folded before Flop (didn't bet)



PokerStars Hand #228691954339:  Hold'em No Limit ($0.25/$0.50 USD) - 2021/07/30 18:36:48 ET
Table 'Bok II' 9-max Seat #2 is the button
Seat 1: alexrus18 ($50 in chips) 
Seat 2: dikanmax ($50 in chips) 
Seat 3: gvidator ($53.19 in chips) 
Seat 4: Infinities4 ($72 in chips) 
Seat 5: forestry800 ($67.41 in chips) 
Seat 6: vipbor ($59.89 in chips) 
Seat 7: Freak380 ($71.99 in chips) 
Seat 8: StudentRB ($50 in chips) 
Seat 9: An1an1 ($65.88 in chips) 
gvidator: posts small blind $0.25
Infinities4: posts big blind $0.50
*** HOLE CARDS ***
forestry800: raises $0.75 to $1.25
vipbor: folds 
Freak380: folds 
StudentRB: folds 
An1an1: folds 
alexrus18: folds 
dikanmax: folds 
gvidator: calls $1
Infinities4: folds 
*** FLOP *** [Ts 9h 3h]
gvidator: checks 
forestry800: bets $0.91
gvidator: calls $0.91
*** TURN *** [Ts 9h 3h] [Jh]
gvidator: bets $1
forestry800: raises $2.17 to $3.17
gvidator: folds 
Uncalled bet ($2.17) returned to forestry800
forestry800 collected $6.48 from pot
forestry800: doesn't show hand 
*** SUMMARY ***
Total pot $6.82 | Rake $0.34 
Board [Ts 9h 3h Jh]
Seat 1: alexrus18 folded before Flop (didn't bet)
Seat 2: dikanmax (button) folded before Flop (didn't bet)
Seat 3: gvidator (small blind) folded on the Turn
Seat 4: Infinities4 (big blind) folded before Flop
Seat 5: forestry800 collected ($6.48)
Seat 6: vipbor folded before Flop (didn't bet)
Seat 7: Freak380 folded before Flop (didn't bet)
Seat 8: StudentRB folded before Flop (didn't bet)
Seat 9: An1an1 folded before Flop (didn't bet)



PokerStars Hand #228691981865:  Hold'em No Limit ($0.25/$0.50 USD) - 2021/07/30 18:37:57 ET
Table 'Bok II' 9-max Seat #3 is the button
Seat 1: alexrus18 ($50 in chips) 
Seat 2: dikanmax ($50 in chips) 
Seat 3: gvidator ($50.03 in chips) 
Seat 4: Infinities4 ($71.50 in chips) 
Seat 5: forestry800 ($70.73 in chips) 
Seat 6: vipbor ($59.89 in chips) 
Seat 7: Freak380 ($71.99 in chips) 
Seat 8: StudentRB ($50 in chips) 
Seat 9: An1an1 ($65.88 in chips) 
Infinities4: posts small blind $0.25
forestry800: posts big blind $0.50
*** HOLE CARDS ***
vipbor: folds 
Freak380: folds 
StudentRB: folds 
An1an1: folds 
alexrus18: folds 
dikanmax: folds 
gvidator: folds 
Infinities4: folds 
Uncalled bet ($0.25) returned to forestry800
forestry800 collected $0.50 from pot
forestry800: doesn't show hand 
*** SUMMARY ***
Total pot $0.50 | Rake $0 
Seat 1: alexrus18 folded before Flop (didn't bet)
Seat 2: dikanmax folded before Flop (didn't bet)
Seat 3: gvidator (button) folded before Flop (didn't bet)
Seat 4: Infinities4 (small blind) folded before Flop
Seat 5: forestry800 (big blind) collected ($0.50)
Seat 6: vipbor folded before Flop (didn't bet)
Seat 7: Freak380 folded before Flop (didn't bet)
Seat 8: StudentRB folded before Flop (didn't bet)
Seat 9: An1an1 folded before Flop (didn't bet)



PokerStars Hand #228691985668:  Hold'em No Limit ($0.25/$0.50 USD) - 2021/07/30 18:38:07 ET
Table 'Bok II' 9-max Seat #4 is the button
Seat 1: alexrus18 ($50 in chips) 
Seat 2: dikanmax ($50 in chips) 
Seat 3: gvidator ($50.03 in chips) 
Seat 4: Infinities4 ($71.25 in chips) 
Seat 5: forestry800 ($70.98 in chips) 
Seat 6: vipbor ($59.89 in chips) 
Seat 7: Freak380 ($71.99 in chips) 
Seat 8: StudentRB ($50 in chips) 
Seat 9: An1an1 ($65.88 in chips) 
forestry800: posts small blind $0.25
vipbor: posts big blind $0.50
*** HOLE CARDS ***
Freak380: raises $0.50 to $1
StudentRB: folds 
An1an1: folds 
alexrus18: folds 
dikanmax: folds 
gvidator: folds 
Infinities4: folds 
forestry800: folds 
vipbor: calls $0.50
*** FLOP *** [Jh 6h 4s]
vipbor: checks 
Freak380: bets $1.25
vipbor: calls $1.25
*** TURN *** [Jh 6h 4s] [6s]
vipbor: checks 
Freak380: bets $2.50
vipbor: calls $2.50
*** RIVER *** [Jh 6h 4s 6s] [2c]
vipbor: checks 
Freak380: bets $5
vipbor: calls $5
*** SHOW DOWN ***
Freak380: shows [Qs Jc] (two pair, Jacks and Sixes)
vipbor: mucks hand 
Freak380 collected $18.51 from pot
*** SUMMARY ***
Total pot $19.75 | Rake $1.24 
Board [Jh 6h 4s 6s 2c]
Seat 1: alexrus18 folded before Flop (didn't bet)
Seat 2: dikanmax folded before Flop (didn't bet)
Seat 3: gvidator folded before Flop (didn't bet)
Seat 4: Infinities4 (button) folded before Flop (didn't bet)
Seat 5: forestry800 (small blind) folded before Flop
Seat 6: vipbor (big blind) mucked
Seat 7: Freak380 showed [Qs Jc] and won ($18.51) with two pair, Jacks and Sixes
Seat 8: StudentRB folded before Flop (didn't bet)
Seat 9: An1an1 folded before Flop (didn't bet)



PokerStars Hand #228692012555:  Hold'em No Limit ($0.25/$0.50 USD) - 2021/07/30 18:39:15 ET
Table 'Bok II' 9-max Seat #5 is the button
Seat 1: alexrus18 ($50 in chips) 
Seat 2: dikanmax ($50 in chips) 
Seat 3: gvidator ($50.03 in chips) 
Seat 4: Infinities4 ($71.25 in chips) 
Seat 5: forestry800 ($70.73 in chips) 
Seat 6: vipbor ($50.14 in chips) 
Seat 7: Freak380 ($80.75 in chips) 
Seat 8: StudentRB ($50 in chips) 
Seat 9: An1an1 ($65.88 in chips) 
vipbor: posts small blind $0.25
Freak380: posts big blind $0.50
*** HOLE CARDS ***
StudentRB: folds 
An1an1: folds 
alexrus18: raises $0.75 to $1.25
dikanmax: folds 
gvidator: raises $1.75 to $3
Infinities4: folds 
forestry800: folds 
vipbor: folds 
Freak380: calls $2.50
alexrus18: calls $1.75
*** FLOP *** [3s 6c Js]
Freak380: bets $4.50
alexrus18: folds 
gvidator: calls $4.50
*** TURN *** [3s 6c Js] [6d]
Freak380: bets $8.75
gvidator: folds 
Uncalled bet ($8.75) returned to Freak380
Freak380 collected $17.11 from pot
*** SUMMARY ***
Total pot $18.25 | Rake $1.14 
Board [3s 6c Js 6d]
Seat 1: alexrus18 folded on the Flop
Seat 2: dikanmax folded before Flop (didn't bet)
Seat 3: gvidator folded on the Turn
Seat 4: Infinities4 folded before Flop (didn't bet)
Seat 5: forestry800 (button) folded before Flop (didn't bet)
Seat 6: vipbor (small blind) folded before Flop
Seat 7: Freak380 (big blind) collected ($17.11)
Seat 8: StudentRB folded before Flop (didn't bet)
Seat 9: An1an1 folded before Flop (didn't bet)



PokerStars Hand #228692029853:  Hold'em No Limit ($0.25/$0.50 USD) - 2021/07/30 18:39:58 ET
Table 'Bok II' 9-max Seat #6 is the button
Seat 1: alexrus18 ($50 in chips) 
Seat 2: dikanmax ($50 in chips) 
Seat 3: gvidator ($42.53 in chips) 
Seat 4: Infinities4 ($71.25 in chips) 
Seat 5: forestry800 ($70.73 in chips) 
Seat 6: vipbor ($50 in chips) 
Seat 7: Freak380 ($90.36 in chips) 
Seat 8: StudentRB ($50 in chips) 
Seat 9: An1an1 ($65.88 in chips) 
Freak380: posts small blind $0.25
StudentRB: posts big blind $0.50
*** HOLE CARDS ***
An1an1: folds 
alexrus18: folds 
dikanmax: folds 
gvidator: folds 
Infinities4: folds 
forestry800: folds 
vipbor: raises $0.75 to $1.25
Freak380: folds 
StudentRB: calls $0.75
*** FLOP *** [3d 2d 3h]
StudentRB: checks 
vipbor: checks 
*** TURN *** [3d 2d 3h] [Th]
StudentRB: checks 
vipbor: checks 
*** RIVER *** [3d 2d 3h Th] [2c]
StudentRB: checks 
vipbor: checks 
*** SHOW DOWN ***
StudentRB: shows [Kc 7h] (two pair, Threes and Deuces)
vipbor: shows [Ac Qh] (two pair, Threes and Deuces - Ace kicker)
vipbor collected $2.61 from pot
*** SUMMARY ***
Total pot $2.75 | Rake $0.14 
Board [3d 2d 3h Th 2c]
Seat 1: alexrus18 folded before Flop (didn't bet)
Seat 2: dikanmax folded before Flop (didn't bet)
Seat 3: gvidator folded before Flop (didn't bet)
Seat 4: Infinities4 folded before Flop (didn't bet)
Seat 5: forestry800 folded before Flop (didn't bet)
Seat 6: vipbor (button) showed [Ac Qh] and won ($2.61) with two pair, Threes and Deuces
Seat 7: Freak380 (small blind) folded before Flop
Seat 8: StudentRB (big blind) showed [Kc 7h] and lost with two pair, Threes and Deuces
Seat 9: An1an1 folded before Flop (didn't bet)



PokerStars Hand #228692046883:  Hold'em No Limit ($0.25/$0.50 USD) - 2021/07/30 18:40:41 ET
Table 'Bok II' 9-max Seat #7 is the button
Seat 1: alexrus18 ($50 in chips) 
Seat 2: dikanmax ($50 in chips) 
Seat 3: gvidator ($42.53 in chips) 
Seat 4: Infinities4 ($71.25 in chips) 
Seat 5: forestry800 ($70.73 in chips) 
Seat 6: vipbor ($51.36 in chips) 
Seat 7: Freak380 ($90.11 in chips) 
Seat 8: StudentRB ($50 in chips) 
Seat 9: An1an1 ($65.88 in chips) 
StudentRB: posts small blind $0.25
An1an1: posts big blind $0.50
*** HOLE CARDS ***
alexrus18: folds 
dikanmax: folds 
gvidator: calls $0.50
Infinities4: folds 
forestry800: folds 
vipbor: folds 
Freak380: folds 
StudentRB: folds 
An1an1: checks 
*** FLOP *** [6c Ac 5c]
An1an1: checks 
gvidator: bets $1.09
An1an1: calls $1.09
*** TURN *** [6c Ac 5c] [2c]
An1an1: checks 
gvidator: checks 
*** RIVER *** [6c Ac 5c 2c] [Jh]
An1an1: bets $2.45
gvidator: folds 
Uncalled bet ($2.45) returned to An1an1
An1an1 collected $3.26 from pot
An1an1: doesn't show hand 
*** SUMMARY ***
Total pot $3.43 | Rake $0.17 
Board [6c Ac 5c 2c Jh]
Seat 1: alexrus18 folded before Flop (didn't bet)
Seat 2: dikanmax folded before Flop (didn't bet)
Seat 3: gvidator folded on the River
Seat 4: Infinities4 folded before Flop (didn't bet)
Seat 5: forestry800 folded before Flop (didn't bet)
Seat 6: vipbor folded before Flop (didn't bet)
Seat 7: Freak380 (button) folded before Flop (didn't bet)
Seat 8: StudentRB (small blind) folded before Flop
Seat 9: An1an1 (big blind) collected ($3.26)



PokerStars Hand #228692062049:  Hold'em No Limit ($0.25/$0.50 USD) - 2021/07/30 18:41:20 ET
Table 'Bok II' 9-max Seat #8 is the button
Seat 1: alexrus18 ($50 in chips) 
Seat 2: dikanmax ($50 in chips) 
Seat 3: gvidator ($40.94 in chips) 
Seat 4: Infinities4 ($71.25 in chips) 
Seat 5: forestry800 ($70.73 in chips) 
Seat 6: vipbor ($51.36 in chips) 
Seat 7: Freak380 ($90.11 in chips) 
Seat 8: StudentRB ($50 in chips) 
Seat 9: An1an1 ($67.55 in chips) 
An1an1: posts small blind $0.25
alexrus18: posts big blind $0.50
*** HOLE CARDS ***
dikanmax: folds 
gvidator: calls $0.50
Infinities4: folds 
forestry800: folds 
vipbor: folds 
Freak380: raises $1 to $1.50
StudentRB: calls $1.50
An1an1: folds 
alexrus18: folds 
gvidator: raises $5.25 to $6.75
Freak380: folds 
StudentRB: folds 
Uncalled bet ($5.25) returned to gvidator
gvidator collected $5.25 from pot
gvidator: doesn't show hand 
*** SUMMARY ***
Total pot $5.25 | Rake $0 
Seat 1: alexrus18 (big blind) folded before Flop
Seat 2: dikanmax folded before Flop (didn't bet)
Seat 3: gvidator collected ($5.25)
Seat 4: Infinities4 folded before Flop (didn't bet)
Seat 5: forestry800 folded before Flop (didn't bet)
Seat 6: vipbor folded before Flop (didn't bet)
Seat 7: Freak380 folded before Flop
Seat 8: StudentRB (button) folded before Flop
Seat 9: An1an1 (small blind) folded before Flop



PokerStars Hand #228692077800:  Hold'em No Limit ($0.25/$0.50 USD) - 2021/07/30 18:42:00 ET
Table 'Bok II' 9-max Seat #9 is the button
Seat 1: alexrus18 ($50 in chips) 
Seat 3: gvidator ($44.69 in chips) 
Seat 4: Infinities4 ($71.25 in chips) 
Seat 5: forestry800 ($70.73 in chips) 
Seat 6: vipbor ($51.36 in chips) 
Seat 7: Freak380 ($88.61 in chips) 
Seat 8: StudentRB ($50 in chips) 
Seat 9: An1an1 ($67.30 in chips) 
alexrus18: posts small blind $0.25
dikanmax: is sitting out 
gvidator: posts big blind $0.50
*** HOLE CARDS ***
Infinities4: folds 
forestry800: raises $0.75 to $1.25
vipbor: folds 
Freak380: folds 
StudentRB: folds 
An1an1: folds 
alexrus18: raises $3.75 to $5
gvidator: calls $4.50
forestry800: folds 
*** FLOP *** [Qc 6d 5s]
alexrus18: bets $3.53
gvidator: calls $3.53
*** TURN *** [Qc 6d 5s] [7h]
alexrus18: checks 
gvidator: bets $3.69
alexrus18: calls $3.69
*** RIVER *** [Qc 6d 5s 7h] [2s]
alexrus18: checks 
gvidator: bets $32.47 and is all-in
alexrus18: folds 
Uncalled bet ($32.47) returned to gvidator
gvidator collected $24.41 from pot
gvidator: doesn't show hand 
*** SUMMARY ***
Total pot $25.69 | Rake $1.28 
Board [Qc 6d 5s 7h 2s]
Seat 1: alexrus18 (small blind) folded on the River
Seat 3: gvidator (big blind) collected ($24.41)
Seat 4: Infinities4 folded before Flop (didn't bet)
Seat 5: forestry800 folded before Flop
Seat 6: vipbor folded before Flop (didn't bet)
Seat 7: Freak380 folded before Flop (didn't bet)
Seat 8: StudentRB folded before Flop (didn't bet)
Seat 9: An1an1 (button) folded before Flop (didn't bet)



PokerStars Hand #228692108131:  Hold'em No Limit ($0.25/$0.50 USD) - 2021/07/30 18:43:18 ET
Table 'Bok II' 9-max Seat #1 is the button
Seat 1: alexrus18 ($50 in chips) 
Seat 3: gvidator ($56.88 in chips) 
Seat 4: Infinities4 ($71.25 in chips) 
Seat 5: forestry800 ($69.48 in chips) 
Seat 6: vipbor ($51.36 in chips) 
Seat 7: Freak380 ($88.61 in chips) 
Seat 8: StudentRB ($50 in chips) 
Seat 9: An1an1 ($67.30 in chips) 
gvidator: posts small blind $0.25
Infinities4: posts big blind $0.50
*** HOLE CARDS ***
forestry800: folds 
vipbor: folds 
Freak380: folds 
dikanmax leaves the table
StudentRB: raises $0.75 to $1.25
An1an1: folds 
alexrus18: folds 
gvidator: folds 
Infinities4: folds 
Uncalled bet ($0.75) returned to StudentRB
StudentRB collected $1.25 from pot
StudentRB: doesn't show hand 
*** SUMMARY ***
Total pot $1.25 | Rake $0 
Seat 1: alexrus18 (button) folded before Flop (didn't bet)
Seat 3: gvidator (small blind) folded before Flop
Seat 4: Infinities4 (big blind) folded before Flop
Seat 5: forestry800 folded before Flop (didn't bet)
Seat 6: vipbor folded before Flop (didn't bet)
Seat 7: Freak380 folded before Flop (didn't bet)
Seat 8: StudentRB collected ($1.25)
Seat 9: An1an1 folded before Flop (didn't bet)



PokerStars Hand #228692113078:  Hold'em No Limit ($0.25/$0.50 USD) - 2021/07/30 18:43:31 ET
Table 'Bok II' 9-max Seat #3 is the button
Seat 1: alexrus18 ($50 in chips) 
Seat 3: gvidator ($56.63 in chips) 
Seat 4: Infinities4 ($70.75 in chips) 
Seat 5: forestry800 ($69.48 in chips) 
Seat 6: vipbor ($51.36 in chips) 
Seat 7: Freak380 ($88.61 in chips) 
Seat 8: StudentRB ($50.75 in chips) 
Seat 9: An1an1 ($67.30 in chips) 
Infinities4: posts small blind $0.25
forestry800: posts big blind $0.50
*** HOLE CARDS ***
vipbor: folds 
Freak380: folds 
StudentRB: folds 
An1an1: folds 
alexrus18: folds 
gvidator: raises $1 to $1.50
Infinities4: folds 
forestry800: raises $3.50 to $5
gvidator: calls $3.50
*** FLOP *** [3c Td 9h]
PleBeY95 joins the table at seat #2 
forestry800: bets $3.12
gvidator: calls $3.12
*** TURN *** [3c Td 9h] [3d]
forestry800: checks 
gvidator: checks 
*** RIVER *** [3c Td 9h 3d] [2h]
forestry800: checks 
gvidator: bets $18.17
forestry800: calls $18.17
*** SHOW DOWN ***
gvidator: shows [Th Qs] (two pair, Tens and Threes)
forestry800: mucks hand 
gvidator collected $50.83 from pot
*** SUMMARY ***
Total pot $52.83 | Rake $2 
Board [3c Td 9h 3d 2h]
Seat 1: alexrus18 folded before Flop (didn't bet)
Seat 3: gvidator (button) showed [Th Qs] and won ($50.83) with two pair, Tens and Threes
Seat 4: Infinities4 (small blind) folded before Flop
Seat 5: forestry800 (big blind) mucked
Seat 6: vipbor folded before Flop (didn't bet)
Seat 7: Freak380 folded before Flop (didn't bet)
Seat 8: StudentRB folded before Flop (didn't bet)
Seat 9: An1an1 folded before Flop (didn't bet)



PokerStars Hand #228692133406:  Hold'em No Limit ($0.25/$0.50 USD) - 2021/07/30 18:44:24 ET
Table 'Bok II' 9-max Seat #4 is the button
Seat 1: alexrus18 ($50 in chips) 
Seat 3: gvidator ($81.17 in chips) 
Seat 4: Infinities4 ($70.50 in chips) 
Seat 5: forestry800 ($50 in chips) 
Seat 6: vipbor ($51.36 in chips) 
Seat 7: Freak380 ($88.61 in chips) 
Seat 8: StudentRB ($50.75 in chips) 
Seat 9: An1an1 ($67.30 in chips) 
forestry800: posts small blind $0.25
vipbor: posts big blind $0.50
PleBeY95: sits out 
*** HOLE CARDS ***
Freak380: raises $0.50 to $1
StudentRB: folds 
An1an1: folds 
alexrus18: folds 
gvidator: folds 
gvidator leaves the table
Infinities4: folds 
forestry800: folds 
vipbor: folds 
Uncalled bet ($0.50) returned to Freak380
Freak380 collected $1.25 from pot
*** SUMMARY ***
Total pot $1.25 | Rake $0 
Seat 1: alexrus18 folded before Flop (didn't bet)
Seat 3: gvidator folded before Flop (didn't bet)
Seat 4: Infinities4 (button) folded before Flop (didn't bet)
Seat 5: forestry800 (small blind) folded before Flop
Seat 6: vipbor (big blind) folded before Flop
Seat 7: Freak380 collected ($1.25)
Seat 8: StudentRB folded before Flop (didn't bet)
Seat 9: An1an1 folded before Flop (didn't bet)



PokerStars Hand #228692139601:  Hold'em No Limit ($0.25/$0.50 USD) - 2021/07/30 18:44:39 ET
Table 'Bok II' 9-max Seat #5 is the button
Seat 1: alexrus18 ($50 in chips) 
Seat 4: Infinities4 ($70.50 in chips) 
Seat 5: forestry800 ($50 in chips) 
Seat 6: vipbor ($50.86 in chips) 
Seat 8: StudentRB ($50.75 in chips) 
Seat 9: An1an1 ($67.30 in chips) 
vipbor: posts small blind $0.25
Freak380: is sitting out 
StudentRB: posts big blind $0.50
PleBeY95: sits out 
*** HOLE CARDS ***
An1an1: folds 
alexrus18: folds 
UPERAD joins the table at seat #3 
UPERAD leaves the table
Infinities4: raises $0.74 to $1.24
forestry800: folds 
vipbor: folds 
Freak380 leaves the table
StudentRB: calls $0.74
*** FLOP *** [Ac 2d Qd]
StudentRB: checks 
PleBeY95 leaves the table
An1an1 leaves the table
Infinities4: checks 
*** TURN *** [Ac 2d Qd] [4d]
StudentRB: bets $1.94
Infinities4: folds 
Uncalled bet ($1.94) returned to StudentRB
StudentRB collected $2.59 from pot
StudentRB: doesn't show hand 
*** SUMMARY ***
Total pot $2.73 | Rake $0.14 
Board [Ac 2d Qd 4d]
Seat 1: alexrus18 folded before Flop (didn't bet)
Seat 4: Infinities4 folded on the Turn
Seat 5: forestry800 (button) folded before Flop (didn't bet)
Seat 6: vipbor (small blind) folded before Flop
Seat 8: StudentRB (big blind) collected ($2.59)
Seat 9: An1an1 folded before Flop (didn't bet)



PokerStars Hand #228692154445:  Hold'em No Limit ($0.25/$0.50 USD) - 2021/07/30 18:45:18 ET
Table 'Bok II' 9-max Seat #6 is the button
Seat 1: alexrus18 ($50 in chips) 
Seat 5: forestry800 ($50 in chips) 
Seat 6: vipbor ($50.61 in chips) 
Seat 8: StudentRB ($52.10 in chips) 
StudentRB: posts small blind $0.25
alexrus18: posts big blind $0.50
*** HOLE CARDS ***
forestry800: folds 
Infinities4 leaves the table
vipbor: raises $0.75 to $1.25
StudentRB: folds 
alexrus18: folds 
Uncalled bet ($0.75) returned to vipbor
vipbor collected $1.25 from pot
*** SUMMARY ***
Total pot $1.25 | Rake $0 
Seat 1: alexrus18 (big blind) folded before Flop
Seat 5: forestry800 folded before Flop (didn't bet)
Seat 6: vipbor (button) collected ($1.25)
Seat 8: StudentRB (small blind) folded before Flop



PokerStars Hand #228692158804:  Hold'em No Limit ($0.25/$0.50 USD) - 2021/07/30 18:45:29 ET
Table 'Bok II' 9-max Seat #8 is the button
Seat 1: alexrus18 ($50 in chips) 
Seat 6: vipbor ($51.36 in chips) 
Seat 8: StudentRB ($51.85 in chips) 
alexrus18: posts small blind $0.25
forestry800: is sitting out 
vipbor: posts big blind $0.50
*** HOLE CARDS ***
StudentRB: folds 
alexrus18: folds 
Uncalled bet ($0.25) returned to vipbor
vipbor collected $0.50 from pot
*** SUMMARY ***
Total pot $0.50 | Rake $0 
Seat 1: alexrus18 (small blind) folded before Flop
Seat 6: vipbor (big blind) collected ($0.50)
Seat 8: StudentRB (button) folded before Flop (didn't bet)



PokerStars Hand #228691806146:  Hold'em No Limit ($0.25/$0.50 USD) - 2021/07/30 18:30:49 ET
Table 'Bok II' 9-max Seat #3 is the button
Seat 1: alexrus18 ($50 in chips) 
Seat 3: gvidator ($40.47 in chips) 
Seat 4: Infinities4 ($59.25 in chips) 
Seat 5: forestry800 ($68.16 in chips) 
Seat 7: Freak380 ($70.69 in chips) 
Seat 8: StudentRB ($50 in chips) 
Seat 9: An1an1 ($66.63 in chips) 
Infinities4: posts small blind $0.25
forestry800: posts big blind $0.50
vipbor: sits out 
*** HOLE CARDS ***
Freak380: folds 
StudentRB: folds 
An1an1: folds 
alexrus18: raises $0.75 to $1.25
gvidator: raises $0.75 to $2
Infinities4: folds 
forestry800: folds 
alexrus18: calls $0.75
*** FLOP *** [8d 5s 3s]
alexrus18: checks 
gvidator: checks 
*** TURN *** [8d 5s 3s] [Ad]
alexrus18: checks 
gvidator: bets $1.50
alexrus18: folds 
Uncalled bet ($1.50) returned to gvidator
gvidator collected $4.51 from pot
gvidator: doesn't show hand 
*** SUMMARY ***
Total pot $4.75 | Rake $0.24 
Board [8d 5s 3s Ad]
Seat 1: alexrus18 folded on the Turn
Seat 3: gvidator (button) collected ($4.51)
Seat 4: Infinities4 (small blind) folded before Flop
Seat 5: forestry800 (big blind) folded before Flop
Seat 7: Freak380 folded before Flop (didn't bet)
Seat 8: StudentRB folded before Flop (didn't bet)
Seat 9: An1an1 folded before Flop (didn't bet)



PokerStars Hand #228691853085:  Hold'em No Limit ($0.25/$0.50 USD) - 2021/07/30 18:32:46 ET
Table 'Bok II' 9-max Seat #6 is the button
Seat 1: alexrus18 ($50 in chips) 
Seat 3: gvidator ($41.48 in chips) 
Seat 4: Infinities4 ($59.75 in chips) 
Seat 5: forestry800 ($67.41 in chips) 
Seat 6: vipbor ($61.89 in chips) 
Seat 7: Freak380 ($72.24 in chips) 
Seat 8: StudentRB ($50 in chips) 
Seat 9: An1an1 ($66.63 in chips) 
Freak380: posts small blind $0.25
StudentRB: posts big blind $0.50
dikanmax: sits out 
*** HOLE CARDS ***
An1an1: folds 
alexrus18: folds 
gvidator: folds 
Infinities4: folds 
forestry800: folds 
vipbor: folds 
Freak380: folds 
Uncalled bet ($0.25) returned to StudentRB
StudentRB collected $0.50 from pot
StudentRB: doesn't show hand 
*** SUMMARY ***
Total pot $0.50 | Rake $0 
Seat 1: alexrus18 folded before Flop (didn't bet)
Seat 3: gvidator folded before Flop (didn't bet)
Seat 4: Infinities4 folded before Flop (didn't bet)
Seat 5: forestry800 folded before Flop (didn't bet)
Seat 6: vipbor (button) folded before Flop (didn't bet)
Seat 7: Freak380 (small blind) folded before Flop
Seat 8: StudentRB (big blind) collected ($0.50)
Seat 9: An1an1 folded before Flop (didn't bet)



PokerStars Hand #228691858745:  Hold'em No Limit ($0.25/$0.50 USD) - 2021/07/30 18:33:00 ET
Table 'Bok II' 9-max Seat #7 is the button
Seat 1: alexrus18 ($50 in chips) 
Seat 3: gvidator ($41.48 in chips) 
Seat 4: Infinities4 ($59.75 in chips) 
Seat 5: forestry800 ($67.41 in chips) 
Seat 6: vipbor ($61.89 in chips) 
Seat 7: Freak380 ($71.99 in chips) 
Seat 8: StudentRB ($50.25 in chips) 
Seat 9: An1an1 ($66.63 in chips) 
StudentRB: posts small blind $0.25
An1an1: posts big blind $0.50
dikanmax: sits out 
*** HOLE CARDS ***
alexrus18: folds 
gvidator: folds 
Infinities4: raises $0.74 to $1.24
forestry800: folds 
vipbor: folds 
Freak380: folds 
StudentRB: folds 
An1an1: folds 
Uncalled bet ($0.74) returned to Infinities4
Infinities4 collected $1.25 from pot
Infinities4: doesn't show hand 
*** SUMMARY ***
Total pot $1.25 | Rake $0 
Seat 1: alexrus18 folded before Flop (didn't bet)
Seat 3: gvidator folded before Flop (didn't bet)
Seat 4: Infinities4 collected ($1.25)
Seat 5: forestry800 folded before Flop (didn't bet)
Seat 6: vipbor folded before Flop (didn't bet)
Seat 7: Freak380 (button) folded before Flop (didn't bet)
Seat 8: StudentRB (small blind) folded before Flop
Seat 9: An1an1 (big blind) folded before Flop



PokerStars Hand #228691552103:  Hold'em No Limit ($0.25/$0.50 USD) - 2021/07/30 18:20:21 ET
Table 'Bok II' 9-max Seat #3 is the button
Seat 1: alexrus18 ($50.75 in chips) 
Seat 3: gvidator ($36.39 in chips) 
Seat 4: Infinities4 ($60.17 in chips) 
Seat 5: forestry800 ($68.40 in chips) 
Seat 6: vipbor ($53.38 in chips) 
Seat 7: Freak380 ($76.60 in chips) 
Seat 8: StudentRB ($50.75 in chips) 
Seat 9: An1an1 ($71.08 in chips) 
Infinities4: posts small blind $0.25
forestry800: posts big blind $0.50
*** HOLE CARDS ***
vipbor: folds 
Freak380: folds 
StudentRB: folds 
An1an1: raises $0.75 to $1.25
alexrus18: calls $1.25
gvidator: folds 
Infinities4: folds 
forestry800: folds 
*** FLOP *** [Tc 8d 6s]
An1an1: checks 
alexrus18: checks 
*** TURN *** [Tc 8d 6s] [Qs]
An1an1: checks 
alexrus18: bets $1.70
An1an1: calls $1.70
*** RIVER *** [Tc 8d 6s Qs] [4h]
An1an1: checks 
alexrus18: bets $3.25
An1an1: folds 
Uncalled bet ($3.25) returned to alexrus18
alexrus18 collected $6.32 from pot
alexrus18: doesn't show hand 
*** SUMMARY ***
Total pot $6.65 | Rake $0.33 
Board [Tc 8d 6s Qs 4h]
Seat 1: alexrus18 collected ($6.32)
Seat 3: gvidator (button) folded before Flop (didn't bet)
Seat 4: Infinities4 (small blind) folded before Flop
Seat 5: forestry800 (big blind) folded before Flop
Seat 6: vipbor folded before Flop (didn't bet)
Seat 7: Freak380 folded before Flop (didn't bet)
Seat 8: StudentRB folded before Flop (didn't bet)
Seat 9: An1an1 folded on the River



PokerStars Hand #228691582818:  Hold'em No Limit ($0.25/$0.50 USD) - 2021/07/30 18:21:37 ET
Table 'Bok II' 9-max Seat #4 is the button
Seat 1: alexrus18 ($54.12 in chips) 
Seat 3: gvidator ($36.39 in chips) 
Seat 4: Infinities4 ($59.92 in chips) 
Seat 5: forestry800 ($67.90 in chips) 
Seat 6: vipbor ($53.38 in chips) 
Seat 7: Freak380 ($76.60 in chips) 
Seat 8: StudentRB ($50.75 in chips) 
Seat 9: An1an1 ($68.13 in chips) 
forestry800: posts small blind $0.25
vipbor: posts big blind $0.50
*** HOLE CARDS ***
Freak380: folds 
StudentRB: folds 
An1an1: folds 
alexrus18: raises $0.75 to $1.25
gvidator: folds 
Infinities4: folds 
forestry800: folds 
vipbor: calls $0.75
*** FLOP *** [Jh 2s 8c]
vipbor: checks 
alexrus18: bets $0.86
vipbor: raises $2.64 to $3.50
alexrus18: folds 
Uncalled bet ($2.64) returned to vipbor
vipbor collected $4.25 from pot
*** SUMMARY ***
Total pot $4.47 | Rake $0.22 
Board [Jh 2s 8c]
Seat 1: alexrus18 folded on the Flop
Seat 3: gvidator folded before Flop (didn't bet)
Seat 4: Infinities4 (button) folded before Flop (didn't bet)
Seat 5: forestry800 (small blind) folded before Flop
Seat 6: vipbor (big blind) collected ($4.25)
Seat 7: Freak380 folded before Flop (didn't bet)
Seat 8: StudentRB folded before Flop (didn't bet)
Seat 9: An1an1 folded before Flop (didn't bet)



PokerStars Hand #228691604173:  Hold'em No Limit ($0.25/$0.50 USD) - 2021/07/30 18:22:30 ET
Table 'Bok II' 9-max Seat #5 is the button
Seat 1: alexrus18 ($52.01 in chips) 
Seat 3: gvidator ($36.39 in chips) 
Seat 4: Infinities4 ($59.92 in chips) 
Seat 5: forestry800 ($67.65 in chips) 
Seat 6: vipbor ($55.52 in chips) 
Seat 7: Freak380 ($76.60 in chips) 
Seat 8: StudentRB ($50.75 in chips) 
Seat 9: An1an1 ($68.13 in chips) 
vipbor: posts small blind $0.25
Freak380: posts big blind $0.50
*** HOLE CARDS ***
StudentRB: folds 
An1an1: folds 
alexrus18: folds 
gvidator: folds 
Infinities4: folds 
forestry800: folds 
vipbor: folds 
Uncalled bet ($0.25) returned to Freak380
Freak380 collected $0.50 from pot
*** SUMMARY ***
Total pot $0.50 | Rake $0 
Seat 1: alexrus18 folded before Flop (didn't bet)
Seat 3: gvidator folded before Flop (didn't bet)
Seat 4: Infinities4 folded before Flop (didn't bet)
Seat 5: forestry800 (button) folded before Flop (didn't bet)
Seat 6: vipbor (small blind) folded before Flop
Seat 7: Freak380 (big blind) collected ($0.50)
Seat 8: StudentRB folded before Flop (didn't bet)
Seat 9: An1an1 folded before Flop (didn't bet)



PokerStars Hand #228691609081:  Hold'em No Limit ($0.25/$0.50 USD) - 2021/07/30 18:22:43 ET
Table 'Bok II' 9-max Seat #6 is the button
Seat 1: alexrus18 ($52.01 in chips) 
Seat 3: gvidator ($36.39 in chips) 
Seat 4: Infinities4 ($59.92 in chips) 
Seat 5: forestry800 ($67.65 in chips) 
Seat 6: vipbor ($55.27 in chips) 
Seat 7: Freak380 ($76.85 in chips) 
Seat 8: StudentRB ($50.75 in chips) 
Seat 9: An1an1 ($68.13 in chips) 
Freak380: posts small blind $0.25
StudentRB: posts big blind $0.50
*** HOLE CARDS ***
An1an1: folds 
alexrus18: folds 
gvidator: folds 
Infinities4: folds 
forestry800: raises $0.75 to $1.25
vipbor: folds 
Freak380: calls $1
StudentRB: folds 
*** FLOP *** [Td 5c Jc]
Freak380: bets $1.50
forestry800: folds 
Uncalled bet ($1.50) returned to Freak380
Freak380 collected $2.81 from pot
*** SUMMARY ***
Total pot $3 | Rake $0.19 
Board [Td 5c Jc]
Seat 1: alexrus18 folded before Flop (didn't bet)
Seat 3: gvidator folded before Flop (didn't bet)
Seat 4: Infinities4 folded before Flop (didn't bet)
Seat 5: forestry800 folded on the Flop
Seat 6: vipbor (button) folded before Flop (didn't bet)
Seat 7: Freak380 (small blind) collected ($2.81)
Seat 8: StudentRB (big blind) folded before Flop
Seat 9: An1an1 folded before Flop (didn't bet)



PokerStars Hand #228691628591:  Hold'em No Limit ($0.25/$0.50 USD) - 2021/07/30 18:23:33 ET
Table 'Bok II' 9-max Seat #7 is the button
Seat 1: alexrus18 ($52.01 in chips) 
Seat 3: gvidator ($36.39 in chips) 
Seat 4: Infinities4 ($59.92 in chips) 
Seat 5: forestry800 ($66.40 in chips) 
Seat 6: vipbor ($55.27 in chips) 
Seat 7: Freak380 ($78.41 in chips) 
Seat 8: StudentRB ($50.25 in chips) 
Seat 9: An1an1 ($68.13 in chips) 
StudentRB: posts small blind $0.25
An1an1: posts big blind $0.50
*** HOLE CARDS ***
alexrus18: raises $0.75 to $1.25
gvidator: calls $1.25
Infinities4: folds 
forestry800: folds 
vipbor: calls $1.25
Freak380: folds 
StudentRB: folds 
An1an1: folds 
*** FLOP *** [7s Ts 5d]
alexrus18: checks 
gvidator: checks 
vipbor: checks 
*** TURN *** [7s Ts 5d] [6d]
alexrus18: bets $2.35
gvidator: calls $2.35
vipbor: raises $8.15 to $10.50
alexrus18: folds 
gvidator: folds 
Uncalled bet ($8.15) returned to vipbor
vipbor collected $10.97 from pot
*** SUMMARY ***
Total pot $11.55 | Rake $0.58 
Board [7s Ts 5d 6d]
Seat 1: alexrus18 folded on the Turn
Seat 3: gvidator folded on the Turn
Seat 4: Infinities4 folded before Flop (didn't bet)
Seat 5: forestry800 folded before Flop (didn't bet)
Seat 6: vipbor collected ($10.97)
Seat 7: Freak380 (button) folded before Flop (didn't bet)
Seat 8: StudentRB (small blind) folded before Flop
Seat 9: An1an1 (big blind) folded before Flop



PokerStars Hand #228691651870:  Hold'em No Limit ($0.25/$0.50 USD) - 2021/07/30 18:24:31 ET
Table 'Bok II' 9-max Seat #8 is the button
Seat 1: alexrus18 ($50 in chips) 
Seat 3: gvidator ($32.79 in chips) 
Seat 4: Infinities4 ($59.92 in chips) 
Seat 5: forestry800 ($66.40 in chips) 
Seat 6: vipbor ($62.64 in chips) 
Seat 7: Freak380 ($78.41 in chips) 
Seat 8: StudentRB ($50 in chips) 
Seat 9: An1an1 ($67.63 in chips) 
An1an1: posts small blind $0.25
alexrus18: posts big blind $0.50
*** HOLE CARDS ***
gvidator: folds 
Infinities4: raises $0.74 to $1.24
forestry800: folds 
vipbor: folds 
Freak380: calls $1.24
StudentRB: folds 
An1an1: folds 
alexrus18: folds 
*** FLOP *** [Kc Ad Ts]
Infinities4: checks 
Freak380: bets $1.75
Infinities4: calls $1.75
*** TURN *** [Kc Ad Ts] [2d]
Infinities4: checks 
Freak380: checks 
*** RIVER *** [Kc Ad Ts 2d] [4d]
Infinities4: bets $4.79
Freak380: calls $4.79
*** SHOW DOWN ***
Infinities4: shows [Jd Kd] (a flush, Ace high)
Freak380: mucks hand 
Infinities4 collected $15.49 from pot
*** SUMMARY ***
Total pot $16.31 | Rake $0.82 
Board [Kc Ad Ts 2d 4d]
Seat 1: alexrus18 (big blind) folded before Flop
Seat 3: gvidator folded before Flop (didn't bet)
Seat 4: Infinities4 showed [Jd Kd] and won ($15.49) with a flush, Ace high
Seat 5: forestry800 folded before Flop (didn't bet)
Seat 6: vipbor folded before Flop (didn't bet)
Seat 7: Freak380 mucked
Seat 8: StudentRB (button) folded before Flop (didn't bet)
Seat 9: An1an1 (small blind) folded before Flop



PokerStars Hand #228691689509:  Hold'em No Limit ($0.25/$0.50 USD) - 2021/07/30 18:26:06 ET
Table 'Bok II' 9-max Seat #9 is the button
Seat 1: alexrus18 ($50 in chips) 
Seat 3: gvidator ($32.79 in chips) 
Seat 4: Infinities4 ($67.63 in chips) 
Seat 5: forestry800 ($66.40 in chips) 
Seat 6: vipbor ($62.64 in chips) 
Seat 7: Freak380 ($70.63 in chips) 
Seat 8: StudentRB ($50 in chips) 
Seat 9: An1an1 ($67.38 in chips) 
alexrus18: posts small blind $0.25
gvidator: posts big blind $0.50
*** HOLE CARDS ***
Infinities4: folds 
forestry800: folds 
vipbor: folds 
Freak380: folds 
StudentRB: folds 
An1an1: folds 
alexrus18: folds 
Uncalled bet ($0.25) returned to gvidator
gvidator collected $0.50 from pot
gvidator: doesn't show hand 
*** SUMMARY ***
Total pot $0.50 | Rake $0 
Seat 1: alexrus18 (small blind) folded before Flop
Seat 3: gvidator (big blind) collected ($0.50)
Seat 4: Infinities4 folded before Flop (didn't bet)
Seat 5: forestry800 folded before Flop (didn't bet)
Seat 6: vipbor folded before Flop (didn't bet)
Seat 7: Freak380 folded before Flop (didn't bet)
Seat 8: StudentRB folded before Flop (didn't bet)
Seat 9: An1an1 (button) folded before Flop (didn't bet)



PokerStars Hand #228691692903:  Hold'em No Limit ($0.25/$0.50 USD) - 2021/07/30 18:26:14 ET
Table 'Bok II' 9-max Seat #1 is the button
Seat 1: alexrus18 ($50 in chips) 
Seat 3: gvidator ($33.04 in chips) 
Seat 4: Infinities4 ($67.63 in chips) 
Seat 5: forestry800 ($66.40 in chips) 
Seat 6: vipbor ($62.64 in chips) 
Seat 7: Freak380 ($70.63 in chips) 
Seat 8: StudentRB ($50 in chips) 
Seat 9: An1an1 ($67.38 in chips) 
gvidator: posts small blind $0.25
Infinities4: posts big blind $0.50
*** HOLE CARDS ***
forestry800: folds 
vipbor: folds 
Freak380: folds 
StudentRB: folds 
An1an1: folds 
alexrus18: folds 
gvidator: raises $0.50 to $1
Infinities4: folds 
Uncalled bet ($0.50) returned to gvidator
gvidator collected $1 from pot
gvidator: doesn't show hand 
*** SUMMARY ***
Total pot $1 | Rake $0 
Seat 1: alexrus18 (button) folded before Flop (didn't bet)
Seat 3: gvidator (small blind) collected ($1)
Seat 4: Infinities4 (big blind) folded before Flop
Seat 5: forestry800 folded before Flop (didn't bet)
Seat 6: vipbor folded before Flop (didn't bet)
Seat 7: Freak380 folded before Flop (didn't bet)
Seat 8: StudentRB folded before Flop (didn't bet)
Seat 9: An1an1 folded before Flop (didn't bet)



PokerStars Hand #228691697981:  Hold'em No Limit ($0.25/$0.50 USD) - 2021/07/30 18:26:27 ET
Table 'Bok II' 9-max Seat #3 is the button
Seat 1: alexrus18 ($50 in chips) 
Seat 3: gvidator ($33.54 in chips) 
Seat 4: Infinities4 ($67.13 in chips) 
Seat 5: forestry800 ($66.40 in chips) 
Seat 6: vipbor ($62.64 in chips) 
Seat 7: Freak380 ($70.63 in chips) 
Seat 8: StudentRB ($50 in chips) 
Seat 9: An1an1 ($67.38 in chips) 
Infinities4: posts small blind $0.25
forestry800: posts big blind $0.50
*** HOLE CARDS ***
vipbor has timed out
vipbor: folds 
Freak380: folds 
StudentRB: folds 
An1an1: folds 
alexrus18: folds 
gvidator: calls $0.50
Infinities4: folds 
forestry800: checks 
*** FLOP *** [3s 3d Js]
forestry800: checks 
gvidator: bets $0.59
forestry800: folds 
Uncalled bet ($0.59) returned to gvidator
gvidator collected $1.19 from pot
gvidator: doesn't show hand 
*** SUMMARY ***
Total pot $1.25 | Rake $0.06 
Board [3s 3d Js]
Seat 1: alexrus18 folded before Flop (didn't bet)
Seat 3: gvidator (button) collected ($1.19)
Seat 4: Infinities4 (small blind) folded before Flop
Seat 5: forestry800 (big blind) folded on the Flop
Seat 6: vipbor folded before Flop (didn't bet)
Seat 7: Freak380 folded before Flop (didn't bet)
Seat 8: StudentRB folded before Flop (didn't bet)
Seat 9: An1an1 folded before Flop (didn't bet)



PokerStars Hand #228691711653:  Hold'em No Limit ($0.25/$0.50 USD) - 2021/07/30 18:27:02 ET
Table 'Bok II' 9-max Seat #4 is the button
Seat 1: alexrus18 ($50 in chips) 
Seat 3: gvidator ($34.23 in chips) 
Seat 4: Infinities4 ($66.88 in chips) 
Seat 5: forestry800 ($65.90 in chips) 
Seat 7: Freak380 ($70.63 in chips) 
Seat 8: StudentRB ($50 in chips) 
Seat 9: An1an1 ($67.38 in chips) 
forestry800: posts small blind $0.25
Freak380: posts big blind $0.50
*** HOLE CARDS ***
StudentRB: folds 
An1an1: folds 
alexrus18: folds 
gvidator: raises $1.25 to $1.75
Infinities4: raises $4.50 to $6.25
forestry800: folds 
Freak380: folds 
gvidator: raises $4.50 to $10.75
Infinities4: folds 
Uncalled bet ($4.50) returned to gvidator
gvidator collected $13.25 from pot
gvidator: doesn't show hand 
*** SUMMARY ***
Total pot $13.25 | Rake $0 
Seat 1: alexrus18 folded before Flop (didn't bet)
Seat 3: gvidator collected ($13.25)
Seat 4: Infinities4 (button) folded before Flop
Seat 5: forestry800 (small blind) folded before Flop
Seat 7: Freak380 (big blind) folded before Flop
Seat 8: StudentRB folded before Flop (didn't bet)
Seat 9: An1an1 folded before Flop (didn't bet)



PokerStars Hand #228691732301:  Hold'em No Limit ($0.25/$0.50 USD) - 2021/07/30 18:27:41 ET
Table 'Bok II' 9-max Seat #5 is the button
Seat 1: alexrus18 ($50 in chips) 
Seat 3: gvidator ($41.23 in chips) 
Seat 4: Infinities4 ($60.63 in chips) 
Seat 5: forestry800 ($65.65 in chips) 
Seat 7: Freak380 ($70.13 in chips) 
Seat 8: StudentRB ($50 in chips) 
Seat 9: An1an1 ($67.38 in chips) 
Freak380: posts small blind $0.25
StudentRB: posts big blind $0.50
*** HOLE CARDS ***
An1an1: folds 
alexrus18: raises $0.75 to $1.25
gvidator: folds 
Infinities4: folds 
forestry800: folds 
Freak380: calls $1
StudentRB: folds 
*** FLOP *** [6s Js Qc]
Freak380: bets $1.75
alexrus18: folds 
Uncalled bet ($1.75) returned to Freak380
Freak380 collected $2.81 from pot
*** SUMMARY ***
Total pot $3 | Rake $0.19 
Board [6s Js Qc]
Seat 1: alexrus18 folded on the Flop
Seat 3: gvidator folded before Flop (didn't bet)
Seat 4: Infinities4 folded before Flop (didn't bet)
Seat 5: forestry800 (button) folded before Flop (didn't bet)
Seat 7: Freak380 (small blind) collected ($2.81)
Seat 8: StudentRB (big blind) folded before Flop
Seat 9: An1an1 folded before Flop (didn't bet)



PokerStars Hand #228691745741:  Hold'em No Limit ($0.25/$0.50 USD) - 2021/07/30 18:28:15 ET
Table 'Bok II' 9-max Seat #7 is the button
Seat 1: alexrus18 ($50 in chips) 
Seat 3: gvidator ($41.23 in chips) 
Seat 4: Infinities4 ($60.63 in chips) 
Seat 5: forestry800 ($65.65 in chips) 
Seat 7: Freak380 ($71.69 in chips) 
Seat 8: StudentRB ($50 in chips) 
Seat 9: An1an1 ($67.38 in chips) 
StudentRB: posts small blind $0.25
An1an1: posts big blind $0.50
*** HOLE CARDS ***
alexrus18: folds 
gvidator: raises $0.50 to $1
Infinities4: folds 
forestry800: folds 
Freak380: calls $1
StudentRB: folds 
An1an1: folds 
*** FLOP *** [7h Ks 9s]
gvidator: checks 
Freak380: checks 
*** TURN *** [7h Ks 9s] [As]
gvidator: bets $1.80
Freak380: folds 
Uncalled bet ($1.80) returned to gvidator
gvidator collected $2.61 from pot
gvidator: doesn't show hand 
*** SUMMARY ***
Total pot $2.75 | Rake $0.14 
Board [7h Ks 9s As]
Seat 1: alexrus18 folded before Flop (didn't bet)
Seat 3: gvidator collected ($2.61)
Seat 4: Infinities4 folded before Flop (didn't bet)
Seat 5: forestry800 folded before Flop (didn't bet)
Seat 7: Freak380 (button) folded on the Turn
Seat 8: StudentRB (small blind) folded before Flop
Seat 9: An1an1 (big blind) folded before Flop



PokerStars Hand #228691757426:  Hold'em No Limit ($0.25/$0.50 USD) - 2021/07/30 18:28:46 ET
Table 'Bok II' 9-max Seat #8 is the button
Seat 1: alexrus18 ($50 in chips) 
Seat 3: gvidator ($42.84 in chips) 
Seat 4: Infinities4 ($60.63 in chips) 
Seat 5: forestry800 ($65.65 in chips) 
Seat 7: Freak380 ($70.69 in chips) 
Seat 8: StudentRB ($50 in chips) 
Seat 9: An1an1 ($66.88 in chips) 
An1an1: posts small blind $0.25
alexrus18: posts big blind $0.50
vipbor: sits out 
*** HOLE CARDS ***
gvidator: calls $0.50
Infinities4: folds 
forestry800: raises $1.50 to $2
Freak380: folds 
StudentRB: folds 
An1an1: folds 
alexrus18: folds 
gvidator: calls $1.50
*** FLOP *** [9d Kc 7h]
gvidator: checks 
forestry800: bets $1.49
gvidator: folds 
Uncalled bet ($1.49) returned to forestry800
forestry800 collected $4.51 from pot
forestry800: doesn't show hand 
*** SUMMARY ***
Total pot $4.75 | Rake $0.24 
Board [9d Kc 7h]
Seat 1: alexrus18 (big blind) folded before Flop
Seat 3: gvidator folded on the Flop
Seat 4: Infinities4 folded before Flop (didn't bet)
Seat 5: forestry800 collected ($4.51)
Seat 7: Freak380 folded before Flop (didn't bet)
Seat 8: StudentRB (button) folded before Flop (didn't bet)
Seat 9: An1an1 (small blind) folded before Flop



PokerStars Hand #228691771167:  Hold'em No Limit ($0.25/$0.50 USD) - 2021/07/30 18:29:21 ET
Table 'Bok II' 9-max Seat #9 is the button
Seat 1: alexrus18 ($50 in chips) 
Seat 3: gvidator ($40.84 in chips) 
Seat 4: Infinities4 ($60.63 in chips) 
Seat 5: forestry800 ($68.16 in chips) 
Seat 7: Freak380 ($70.69 in chips) 
Seat 8: StudentRB ($50 in chips) 
Seat 9: An1an1 ($66.63 in chips) 
alexrus18: posts small blind $0.25
gvidator: posts big blind $0.50
vipbor: sits out 
*** HOLE CARDS ***
Infinities4: raises $0.74 to $1.24
forestry800: folds 
Freak380: folds 
StudentRB: folds 
An1an1: folds 
alexrus18: folds 
gvidator: raises $2.73 to $3.97
Infinities4: calls $2.73
*** FLOP *** [6d Ad 7h]
gvidator: checks 
Infinities4: bets $2.72
gvidator: calls $2.72
*** TURN *** [6d Ad 7h] [9h]
gvidator: bets $2.50
Infinities4: calls $2.50
*** RIVER *** [6d Ad 7h 9h] [8h]
gvidator: bets $31.65 and is all-in
Infinities4: calls $31.65
*** SHOW DOWN ***
gvidator: shows [Tc Th] (a straight, Six to Ten)
Infinities4: shows [Td Kd] (a straight, Six to Ten)
gvidator collected $39.97 from pot
Infinities4 collected $39.96 from pot
*** SUMMARY ***
Total pot $81.93 | Rake $2 
Board [6d Ad 7h 9h 8h]
Seat 1: alexrus18 (small blind) folded before Flop
Seat 3: gvidator (big blind) showed [Tc Th] and won ($39.97) with a straight, Six to Ten
Seat 4: Infinities4 showed [Td Kd] and won ($39.96) with a straight, Six to Ten
Seat 5: forestry800 folded before Flop (didn't bet)
Seat 7: Freak380 folded before Flop (didn't bet)
Seat 8: StudentRB folded before Flop (didn't bet)
Seat 9: An1an1 (button) folded before Flop (didn't bet)



PokerStars Hand #228691796604:  Hold'em No Limit ($0.25/$0.50 USD) - 2021/07/30 18:30:25 ET
Table 'Bok II' 9-max Seat #1 is the button
Seat 1: alexrus18 ($50 in chips) 
Seat 3: gvidator ($39.97 in chips) 
Seat 4: Infinities4 ($59.75 in chips) 
Seat 5: forestry800 ($68.16 in chips) 
Seat 7: Freak380 ($70.69 in chips) 
Seat 8: StudentRB ($50 in chips) 
Seat 9: An1an1 ($66.63 in chips) 
gvidator: posts small blind $0.25
Infinities4: posts big blind $0.50
vipbor: sits out 
*** HOLE CARDS ***
forestry800: folds 
Freak380: folds 
StudentRB: folds 
An1an1: folds 
alexrus18: folds 
gvidator: raises $0.50 to $1
Infinities4: folds 
Uncalled bet ($0.50) returned to gvidator
gvidator collected $1 from pot
gvidator: doesn't show hand 
*** SUMMARY ***
Total pot $1 | Rake $0 
Seat 1: alexrus18 (button) folded before Flop (didn't bet)
Seat 3: gvidator (small blind) collected ($1)
Seat 4: Infinities4 (big blind) folded before Flop
Seat 5: forestry800 folded before Flop (didn't bet)
Seat 7: Freak380 folded before Flop (didn't bet)
Seat 8: StudentRB folded before Flop (didn't bet)
Seat 9: An1an1 folded before Flop (didn't bet)



PokerStars Hand #228691835480:  Hold'em No Limit ($0.25/$0.50 USD) - 2021/07/30 18:32:02 ET
Table 'Bok II' 9-max Seat #4 is the button
Seat 1: alexrus18 ($50 in chips) 
Seat 3: gvidator ($42.98 in chips) 
Seat 4: Infinities4 ($59 in chips) 
Seat 5: forestry800 ($67.66 in chips) 
Seat 6: vipbor ($62.64 in chips) 
Seat 7: Freak380 ($70.69 in chips) 
Seat 8: StudentRB ($50 in chips) 
Seat 9: An1an1 ($66.63 in chips) 
forestry800: posts small blind $0.25
vipbor: posts big blind $0.50
*** HOLE CARDS ***
Freak380: folds 
StudentRB: folds 
An1an1: folds 
alexrus18: folds 
gvidator: folds 
Infinities4: raises $0.58 to $1.08
forestry800: folds 
vipbor: folds 
Uncalled bet ($0.58) returned to Infinities4
Infinities4 collected $1.25 from pot
Infinities4: doesn't show hand 
*** SUMMARY ***
Total pot $1.25 | Rake $0 
Seat 1: alexrus18 folded before Flop (didn't bet)
Seat 3: gvidator folded before Flop (didn't bet)
Seat 4: Infinities4 (button) collected ($1.25)
Seat 5: forestry800 (small blind) folded before Flop
Seat 6: vipbor (big blind) folded before Flop
Seat 7: Freak380 folded before Flop (didn't bet)
Seat 8: StudentRB folded before Flop (didn't bet)
Seat 9: An1an1 folded before Flop (didn't bet)



PokerStars Hand #228691840976:  Hold'em No Limit ($0.25/$0.50 USD) - 2021/07/30 18:32:16 ET
Table 'Bok II' 9-max Seat #5 is the button
Seat 1: alexrus18 ($50 in chips) 
Seat 3: gvidator ($42.98 in chips) 
Seat 4: Infinities4 ($59.75 in chips) 
Seat 5: forestry800 ($67.41 in chips) 
Seat 6: vipbor ($62.14 in chips) 
Seat 7: Freak380 ($70.69 in chips) 
Seat 8: StudentRB ($50 in chips) 
Seat 9: An1an1 ($66.63 in chips) 
vipbor: posts small blind $0.25
Freak380: posts big blind $0.50
dikanmax: sits out 
*** HOLE CARDS ***
StudentRB: folds 
An1an1: folds 
alexrus18: folds 
gvidator: raises $1 to $1.50
Infinities4: folds 
forestry800: folds 
vipbor: folds 
Freak380: calls $1
*** FLOP *** [4s Jd Ts]
Freak380: bets $1.75
gvidator: folds 
Uncalled bet ($1.75) returned to Freak380
Freak380 collected $3.05 from pot
*** SUMMARY ***
Total pot $3.25 | Rake $0.20 
Board [4s Jd Ts]
Seat 1: alexrus18 folded before Flop (didn't bet)
Seat 3: gvidator folded on the Flop
Seat 4: Infinities4 folded before Flop (didn't bet)
Seat 5: forestry800 (button) folded before Flop (didn't bet)
Seat 6: vipbor (small blind) folded before Flop
Seat 7: Freak380 (big blind) collected ($3.05)
Seat 8: StudentRB folded before Flop (didn't bet)
Seat 9: An1an1 folded before Flop (didn't bet)



